Pos	A	C	G	T	Other	Total
1	6	0	1	0	0	7
2	0	2	0	22	0	24
3	0	0	1	52	0	53
4	78	0	0	0	0	78
5	238	0	0	1	0	239
6	250	0	0	0	0	250
7	0	0	268	0	0	268
8	1	0	314	0	0	315
9	0	1	0	396	0	397
10	2	0	0	426	0	428
11	0	0	0	518	0	518
12	1138	0	0	22	0	1160
13	5	13	0	2525	0	2543
14	4636	1	4	94	0	4735
15	14	7508	9	4	0	7535
16	14	13680	6	45	0	13745
17	146	12	5	34355	0	34518
18	151	13	3	37790	0	37957
19	47	49936	31	59	0	50073
20	27	55380	21	53	0	55481
21	23	62853	33	247	0	63156
22	67245	22	40	500	0	67807
23	62	47	67834	4	0	67947
24	65	83	67153	12	0	67313
25	107	13	31	74330	0	74481
26	79390	3	33	393	0	79819
27	80360	4	13	244	0	80621
28	50	79993	37	72	0	80152
29	92908	45	25	677	0	93655
30	99366	21	20	639	0	100046
31	102563	14	19	388	0	102984
32	79	102427	58	68	0	102632
33	27	105831	35	71	0	105964
34	111109	57	12	357	0	111535
35	112351	26	9	361	0	112747
36	73	113126	54	72	0	113325
37	40	120633	61	97	0	120831
38	123023	58	16	337	0	123434
39	123226	28	6	229	0	123489
40	75	123149	56	152	0	123432
41	98	120	2	128860	0	129080
42	98	35	8	130208	0	130349
43	93	30	8	129741	0	129872
44	37	128772	40	148	0	128997
45	105	175	126715	34	0	127029
46	122715	57	97	196	0	123065
47	115	28	16	132555	0	132714
48	53	131370	57	119	0	131599
49	54	96	5	134545	0	134700
50	17	133375	55	153	0	133600
51	49	116	2	135523	0	135690
52	86	40	8	136641	0	136775
53	45	96	136610	136	0	136887
54	155	23	116	134812	0	135106
55	137236	14	36	394	0	137680
56	178	93	134637	51	0	134959
57	132993	23	132	303	0	133451
58	186	20	43	138902	0	139151
59	60	138165	56	232	0	138513
60	88	157	3	140805	0	141053
61	53	124	140106	175	0	140458
62	177	39	155	137767	0	138138
63	84	37	39	141215	0	141375
64	59	141641	84	303	0	142087
65	180	180	10	144257	0	144627
66	260	141481	70	385	0	142196
67	47	192	7	144986	0	145232
68	144394	58	18	584	0	145054
69	141979	39	31	475	0	142524
70	143001	26	22	443	0	143492
71	660	142696	95	231	0	143682
72	296	334	140326	44	0	141000
73	139298	60	267	376	0	140001
74	146559	34	71	360	0	147024
75	477	148728	89	279	0	149573
76	301	606	21	118702	0	119630
77	277	172	15	120801	0	121265
78	322	96	21	111195	0	111634
79	112477	57	30	1790	0	114354
80	113757	44	25	950	0	114776
81	113821	22	20	742	0	114605
82	115677	31	18	599	0	116325
83	1625	35	23	114378	0	116061
84	578	113118	86	1166	0	114948
85	576	933	24	117795	0	119328
86	345	479	117350	1230	0	119404
87	619	145	1089	121011	0	122864
88	250	180	123954	1655	0	126039
89	494	111	1522	124055	0	126182
90	165	175	127544	1852	0	129736
91	220	230	125343	684	0	126477
92	115	130943	2159	573	0	133790
93	475	1732	698	136245	0	139150
94	192	565	140795	1954	0	143506
95	533	287	2072	137727	0	140619
96	159	139818	770	2134	0	142881
97	141452	1925	434	1411	0	145222
98	1882	145702	390	535	0	148509
99	847	2206	241	144408	0	147702
100	329	147343	279	1969	0	149920
101	570	2348	143008	705	0	146631
102	323	914	142257	543	0	144037
103	190	144504	2587	548	0	147829
104	483	2159	859	147972	0	151473
105	260	819	148086	2150	0	151315
106	198	146864	2281	919	0	150262
107	147885	2227	771	1144	0	152027
108	2395	773	580	148986	0	152734
109	746	614	152033	2180	0	155573
110	432	151998	2204	918	0	155552
111	629	2226	737	154592	0	158184
112	570	841	525	155732	0	157668
113	151046	590	429	3519	0	155584
114	2156	553	151295	1083	0	155087
115	1012	409	2188	150726	0	154335
116	484	489	148144	2449	0	151566
117	290	137432	2488	1158	0	141368
118	133961	2276	921	1295	0	138453
119	2004	130964	720	668	0	134356
120	932	2477	528	126814	0	130751
121	467	126320	486	2163	0	129436
122	123851	2531	433	1270	0	128085
123	2172	124454	474	881	0	127981
124	812	2689	121512	526	0	125539
125	536	122828	2244	559	0	126167
126	120555	2682	798	855	0	124890
127	2388	1072	122846	534	0	126840
128	1073	763	2507	123604	0	127947
129	120538	625	922	2780	0	124865
130	2854	574	660	117918	0	122006
131	119748	499	578	3171	0	123996
132	121330	548	435	1383	0	123696
133	3659	516	429	119687	0	124291
134	1558	521	405	121144	0	123628
135	118149	489	356	3852	0	122846
136	118828	501	357	1692	0	121378
137	3734	466	336	115545	0	120081
138	115907	479	390	3358	0	120134
139	117017	466	413	1569	0	119465
140	3723	114511	449	1089	0	119772
141	1754	2660	385	116716	0	121515
142	116660	925	450	3486	0	121521
143	119912	712	418	1581	0	122623
144	3884	544	403	117958	0	122789
145	1784	526	394	120816	0	123520
146	117975	470	422	4019	0	122886
147	3289	117959	413	1781	0	123442
148	1588	2747	370	118658	0	123363
149	1237	1120	117416	3327	0	123100
150	1279	782	2617	115359	0	120037
151	925	116278	987	3384	0	121574
152	852	2695	116571	1602	0	121720
153	1049	1050	2731	115893	0	120723
154	1233	781	1025	114111	0	117150
155	863	695	117008	3854	0	122420
156	111963	519	2865	2166	0	117513
157	3071	118650	1117	1481	0	124319
158	119723	2841	781	1462	0	124807
159	3426	1168	117740	1139	0	123473
160	1599	852	119520	1046	0	123017
161	115360	697	3324	1282	0	120663
162	3238	119630	1340	1042	0	125250
163	119283	2860	865	1277	0	124285
164	3342	119969	806	960	0	125077
165	1617	3114	119484	932	0	125147
166	118295	1308	2856	1180	0	123639
167	3400	946	121860	884	0	127090
168	1727	828	2968	120989	0	126512
169	121577	679	1221	3416	0	126893
170	121661	637	865	1725	0	124888
171	3666	119155	810	1203	0	124834
172	1937	4222	778	115791	0	122728
173	1337	117526	663	2903	0	122429
174	1194	2742	115495	1304	0	120735
175	1410	2259	2572	107353	0	113594
176	1012	106547	1100	2475	0	111134
177	1016	2258	716	104640	0	108630
178	100562	773	575	2563	0	104473
179	2180	552	463	101712	0	104907
180	1002	101050	455	2188	0	104695
181	1056	1748	384	102950	0	106138
182	854	924	449	102771	0	104998
183	778	101386	449	2394	0	105007
184	886	2008	517	102558	0	105969
185	925	756	100140	2189	0	104010
186	710	99516	1690	1008	0	102924
187	93910	1447	641	962	0	96960
188	1766	643	93700	537	0	96646
189	875	536	91686	502	0	93599
190	702	90023	1468	553	0	92746
191	1218	1878	1034	86001	0	90131
192	509	475	84606	1158	0	86748
193	627	72832	1137	692	0	75288
194	615	852	410	77839	0	79716
195	513	425	252	79733	0	80923
196	77687	291	248	1385	0	79611
197	954	78040	247	653	0	79894
198	512	964	74032	418	0	75926
199	416	476	74697	438	0	76027
200	438	378	967	74757	0	76540
201	473	327	427	84135	0	85362
202	433	286	281	85638	0	86638
203	365	87484	308	11392	0	99549
204	321	2013	99178	1161	0	102673
205	580	1079	2031	102499	0	106189
206	278	104401	1108	2840	0	108627
207	268	111598	658	1443	0	113967
208	295	3846	114420	790	0	119351
209	554	1691	3234	112261	0	117740
210	294	875	122825	3534	0	127528
211	662	558	3996	121719	0	126935
212	623	439	1912	127072	0	130046
213	388	488	124313	5330	0	130519
214	258	123266	4041	2581	0	130146
215	122277	3648	1945	1679	0	129549
216	3657	1821	124467	942	0	130887
217	1609	123955	4023	837	0	130424
218	792	129568	2002	784	0	133146
219	613	5311	124149	679	0	130752
220	122161	2443	4185	839	0	129628
221	4249	1451	2080	115777	0	123557
222	1735	124983	1274	3365	0	131357
223	125138	4126	912	1897	0	132073
224	4375	2107	799	120444	0	127725
225	1958	123224	756	4063	0	130001
226	124723	4155	751	2367	0	131996
227	4059	2191	120431	1158	0	127839
228	1933	121337	3890	943	0	128103
229	117541	4144	2196	1096	0	124977
230	3746	118734	1209	854	0	124543
231	115563	4446	801	812	0	121622
232	4426	2520	782	111078	0	118806
233	1992	112002	884	3524	0	118402
234	1451	3948	751	113462	0	119612
235	111482	2012	830	4637	0	118961
236	3721	1366	109364	2452	0	116903
237	2025	1076	111778	1511	0	116390
238	1544	940	5021	107819	0	115324
239	1240	1020	2499	111189	0	115948
240	1240	981	1430	109243	0	112894
241	763	106229	1280	5357	0	113629
242	749	4083	104106	2620	0	111558
243	1024	2336	3779	101630	0	108769
244	760	100456	2163	4068	0	107447
245	929	106471	1360	2212	0	110972
246	873	5017	104631	1447	0	111968
247	857	2827	104908	1079	0	109671
248	903	1797	107617	998	0	111315
249	1042	1392	5612	103186	0	111232
250	836	1363	106171	3963	0	112333
251	1096	1115	4810	104838	0	111859
252	840	1154	105760	4456	0	112210
253	99488	1174	4729	2701	0	108092
254	3974	105979	2536	1629	0	114118
255	2147	114966	1566	1285	0	119964
256	1421	5902	116835	1169	0	125327
257	114244	3013	4685	1375	0	123317
258	119868	1881	2444	1305	0	125498
259	120891	1424	1701	1363	0	125379
260	6730	1245	113241	1201	0	122417
261	3167	1020	117469	1273	0	122929
262	1989	1022	6437	114192	0	123640
263	115577	1093	3219	5409	0	125298
264	117725	1128	2166	3138	0	124157
265	6204	1274	112914	2153	0	122545
266	114169	1362	5471	1770	0	122772
267	5743	1455	3208	112133	0	122539
268	2752	1486	114230	5389	0	123857
269	1745	1468	116202	2942	0	122357
270	109482	1446	7239	2355	0	120522
271	4965	1210	115965	1861	0	124001
272	113245	990	6926	1954	0	123115
273	5591	1129	115720	1792	0	124232
274	2910	109509	6916	1801	0	121136
275	2001	116669	4104	1765	0	124539
276	2068	6230	3127	111045	0	122470
277	1864	3287	2703	117982	0	125836
278	1828	2330	114330	6479	0	124967
279	1905	2013	6189	111949	0	122056
280	1791	108263	3794	5788	0	119636
281	2013	112602	2738	3136	0	120489
282	2152	117354	2399	2016	0	123921
283	2553	7095	2231	112040	0	123919
284	2327	3680	112109	5199	0	123315
285	2174	2505	113991	2874	0	121544
286	2341	2242	7156	110226	0	121965
287	2241	1787	3922	113263	0	121213
288	2538	1648	2743	108950	0	115879
289	2401	109915	2159	6844	0	121319
290	110856	5154	2115	3628	0	121753
291	112322	2952	1879	2734	0	119887
292	7075	110545	1925	2217	0	121762
293	3810	5430	111590	1920	0	122750
294	112816	3075	5592	1935	0	123418
295	6305	2091	113944	1676	0	124016
296	113138	1747	6378	1765	0	123028
297	115446	1554	3855	1890	0	122745
298	115562	1512	2834	2084	0	121992
299	113796	1431	2297	2357	0	119881
300	7327	110261	2202	2354	0	122144
301	101069	4217	1733	2330	0	109349
302	5189	100931	1709	2278	0	110107
303	86670	3608	1526	1485	0	93289
304	3979	84238	1291	1254	0	90762
305	1944	2849	77358	871	0	83022
306	1568	5996	3011	67677	0	78252
307	1061	71112	1701	2431	0	76305
308	991	69557	969	1206	0	72723
309	64163	2784	2132	1627	0	70706
310	59771	796	649	645	0	61861
311	2043	60445	532	403	0	63423
312	1052	1501	595	58816	0	61964
313	795	63141	525	1411	0	65872
314	64495	1594	485	588	0	67162
315	2105	573	63900	351	0	66929
316	1104	752	1703	61713	0	65272
317	901	331	801	62285	0	64318
318	831	343	624	63216	0	65014
319	642	413	61832	1866	0	64753
320	641	60311	1715	698	0	63365
321	691	63435	692	453	0	65271
322	788	1750	594	63772	0	66904
323	662	733	64546	1575	0	67516
324	702	625	1669	63774	0	66770
325	598	579	698	65660	0	67535
326	622	612	521	65362	0	67117
327	592	531	469	65458	0	67050
328	63347	455	418	2279	0	66499
329	1614	64061	485	998	0	67158
330	64227	1672	553	850	0	67302
331	1814	747	64015	625	0	67201
332	713	769	64976	556	0	67014
333	749	626	1807	63118	0	66300
334	571	553	751	64983	0	66858
335	439	65765	678	1956	0	68838
336	435	1638	66040	973	0	69086
337	357	67009	1742	932	0	70040
338	378	1744	67562	804	0	70488
339	64119	642	1749	918	0	67428
340	1608	67918	691	664	0	70881
341	739	1809	68295	559	0	71402
342	828	746	1661	67114	0	70349
343	549	680	68352	1755	0	71336
344	463	67855	1797	762	0	70877
345	617	1698	703	66967	0	69985
346	573	67693	574	1839	0	70679
347	632	1775	67840	747	0	70994
348	781	791	1569	66890	0	70031
349	67127	663	520	1851	0	70161
350	1851	66369	528	674	0	69422
351	961	1766	65176	484	0	68387
352	887	1928	1560	61972	0	66347
353	566	634	64847	1543	0	67590
354	507	540	59031	554	0	60632
355	368	55172	1447	386	0	57373
356	616	743	522	50179	0	52060
357	186	255	250	50630	0	51321
358	209	220	114	50146	0	50689
359	153	168	50892	817	0	52030
360	139	144	50360	291	0	50934
361	47275	134	745	336	0	48490
362	628	130	49892	140	0	50790
363	47252	101	717	215	0	48285
364	644	48986	214	139	0	49983
365	216	655	202	48200	0	49273
366	139	50035	134	575	0	50883
367	77	51489	121	262	0	51949
368	92	680	50362	170	0	51304
369	136	366	637	49596	0	50735
370	77	212	50434	604	0	51327
371	91	164	47356	216	0	47827
372	47638	100	721	283	0	48742
373	555	112	49365	135	0	50167
374	161	120	48295	161	0	48737
375	46899	102	666	254	0	47921
376	547	113	48345	166	0	49171
377	172	119	49380	153	0	49824
378	204	165	684	47365	0	48418
379	75	49123	299	572	0	50069
380	123	561	219	49918	0	50821
381	104	176	188	49275	0	49743
382	49853	156	172	821	0	51002
383	566	126	146	49476	0	50314
384	170	50683	155	691	0	51699
385	50289	580	178	359	0	51406
386	583	219	50389	236	0	51427
387	48980	202	628	264	0	50074
388	671	153	53070	160	0	54054
389	212	139	54099	162	0	54612
390	135	56114	880	169	0	57298
391	57034	712	406	235	0	58387
392	706	57904	284	217	0	59111
393	218	836	57877	179	0	59110
394	286	309	797	54601	0	55993
395	113	59266	313	690	0	60382
396	60038	814	274	306	0	61432
397	60294	276	206	252	0	61028
398	926	60170	218	152	0	61466
399	61387	844	198	173	0	62602
400	948	307	191	59666	0	61112
401	262	60588	235	859	0	61944
402	231	849	205	62543	0	63828
403	185	300	184	65554	0	66223
404	66265	263	185	1168	0	67881
405	65702	180	197	480	0	66559
406	65746	149	199	354	0	66448
407	1217	157	64858	172	0	66404
408	64406	140	937	207	0	65690
409	1193	477	400	65710	0	67780
410	424	157	65871	931	0	67383
411	357	143	63004	351	0	63855
412	157	63366	1063	294	0	64880
413	59093	817	573	233	0	60716
414	743	60486	211	163	0	61603
415	353	716	96	60779	0	61944
416	302	238	109	61662	0	62311
417	216	141	62120	846	0	63323
418	330	205	737	59839	0	61111
419	164	107	62153	765	0	63189
420	166	123	59982	272	0	60543
421	135	61774	846	188	0	62943
422	283	581	327	60627	0	61818
423	186	212	177	60433	0	61008
424	60236	116	117	792	0	61261
425	616	115	59935	257	0	60923
426	293	85	586	61106	0	62070
427	62069	66	237	789	0	63161
428	625	62	62412	297	0	63396
429	61423	75	678	274	0	62450
430	63310	81	279	206	0	63876
431	815	120	64839	125	0	65899
432	396	122	643	63780	0	64941
433	278	96	266	64926	0	65566
434	186	99	66385	797	0	67467
435	65125	100	697	500	0	66422
436	67316	65	315	326	0	68022
437	65988	96	241	278	0	66603
438	66794	117	229	230	0	67370
439	66333	120	226	243	0	66922
440	1035	331	57347	466	0	59179
441	461	194	66285	222	0	67162
442	332	67028	793	234	0	68387
443	310	708	67478	232	0	68728
444	393	361	812	65981	0	67547
445	806	277	536	52645	0	54264
446	417	194	228	67999	0	68838
447	483	159	178	68677	0	69497
448	452	141	68504	929	0	70026
449	379	66999	758	427	0	68563
450	364	70197	342	364	0	71267
451	339	846	270	69189	0	70644
452	257	71593	254	800	0	72904
453	72055	819	192	513	0	73579
454	72010	307	200	464	0	72981
455	1111	74367	198	350	0	76026
456	637	758	207	75032	0	76634
457	458	261	250	77030	0	77999
458	349	173	76964	1166	0	78652
459	72444	162	985	647	0	74238
460	78537	220	453	483	0	79693
461	1199	79932	384	331	0	81846
462	81644	1041	314	408	0	83407
463	1242	468	82819	342	0	84871
464	566	81600	1058	428	0	83652
465	413	84791	457	435	0	86096
466	377	84981	352	448	0	86158
467	464	1303	336	84359	0	86462
468	84141	463	351	1377	0	86332
469	1425	316	339	85772	0	87852
470	670	290	87860	1444	0	90264
471	637	251	1457	88015	0	90360
472	518	284	91419	1637	0	93858
473	582	259	1627	88733	0	91201
474	561	293	611	88313	0	89778
475	437	90813	485	1679	0	93414
476	92919	1407	490	870	0	95686
477	1702	466	449	90696	0	93313
478	734	92028	373	1600	0	94735
479	93033	1467	388	838	0	95726
480	81191	614	552	1083	0	83440
481	93849	394	409	725	0	95377
482	1780	92728	460	666	0	95634
483	688	1468	93157	575	0	95888
484	589	597	1550	93054	0	95790
485	712	811	632	91047	0	93202
486	549	92863	514	1867	0	95793
487	693	1447	92399	791	0	95330
488	558	498	90385	652	0	92093
489	88125	396	1619	569	0	90709
490	1711	636	572	88338	0	91257
491	584	262	90969	1443	0	93258
492	423	92865	1326	629	0	95243
493	655	1461	473	90069	0	92658
494	475	94092	433	1226	0	96226
495	433	1331	93292	484	0	95540
496	89420	466	1317	601	0	91804
497	93328	294	532	492	0	94646
498	1502	93083	386	445	0	95416
499	698	1277	254	93154	0	95383
500	483	428	93215	1304	0	95430
501	429	91928	1327	501	0	94185
502	90905	1325	442	551	0	93223
503	1224	88170	267	319	0	89980
504	353	89400	232	262	0	90247
505	472	1390	225	88036	0	90123
506	227	88973	187	1139	0	90526
507	88858	1236	237	471	0	90802
508	1274	455	172	88077	0	89978
509	339	300	85677	1108	0	87424
510	300	282	81712	338	0	82632
511	317	337	1115	82837	0	84606
512	174	83626	357	1055	0	85212
513	84297	1100	254	460	0	86111
514	1101	372	195	82529	0	84197
515	318	306	82131	1078	0	83833
516	354	248	999	81501	0	83102
517	259	262	270	82374	0	83165
518	81084	241	247	1361	0	82933
519	1100	239	190	80720	0	82249
520	364	209	80288	1159	0	82020
521	307	238	79143	400	0	80088
522	297	197	1145	81320	0	82959
523	299	212	427	82926	0	83864
524	213	232	85002	1256	0	86703
525	78345	225	1100	715	0	80385
526	1089	251	84249	374	0	85963
527	336	83777	1125	353	0	85591
528	337	1078	391	85159	0	86965
529	229	342	85136	1154	0	86861
530	261	259	83296	424	0	84240
531	297	294	1210	81476	0	83277
532	82530	197	438	1346	0	84511
533	1065	239	83414	443	0	85161
534	307	82942	1116	416	0	84781
535	84089	1049	410	547	0	86095
536	1092	367	84142	326	0	85927
537	81396	244	1146	483	0	83269
538	84536	208	396	455	0	85595
539	1222	85696	334	326	0	87578
540	467	1045	311	83158	0	84981
541	327	83935	293	1065	0	85620
542	266	1142	83664	395	0	85467
543	83143	390	1122	486	0	85141
544	86120	288	395	425	0	87228
545	1318	302	85758	260	0	87638
546	572	272	83960	254	0	85058
547	320	87522	1322	259	0	89423
548	89467	1169	539	341	0	91516
549	1359	378	365	88997	0	91099
550	552	259	302	86387	0	87500
551	302	87828	304	1224	0	89658
552	87161	1166	278	620	0	89225
553	1204	448	88172	343	0	90167
554	519	289	1165	92816	0	94789
555	93781	248	449	1776	0	96254
556	1741	95143	391	502	0	97777
557	550	1723	103800	275	0	106348
558	410	485	105516	241	0	106652
559	571	1252	2783	101615	0	106221
560	226	104964	741	2178	0	108109
561	281	2377	106280	467	0	109405
562	453	711	2479	104396	0	108039
563	107067	323	604	2729	0	110723
564	2552	290	109441	533	0	112816
565	765	433	2763	109148	0	113109
566	407	220	111730	2735	0	115092
567	367	206	114010	574	0	115157
568	611	1032	3276	111769	0	116688
569	282	177	114661	2762	0	117882
570	99849	136	2937	885	0	103807
571	2466	129	111047	383	0	114025
572	104657	118	2661	487	0	107923
573	2529	108577	718	229	0	112053
574	111825	2327	469	531	0	115152
575	2494	114307	398	228	0	117427
576	809	2519	288	114681	0	118297
577	631	550	292	119283	0	120756
578	311	335	116429	2944	0	120019
579	240	297	117310	832	0	118679
580	399	167	3080	118605	0	122251
581	238	180	120124	2809	0	123351
582	425	218	3079	115874	0	119596
583	229	115333	1043	2705	0	119310
584	314	122529	670	810	0	124323
585	485	3041	533	120074	0	124133
586	508	829	454	122192	0	123983
587	256	587	119615	3173	0	123631
588	470	488	2690	116990	0	120638
589	240	115588	892	3006	0	119726
590	208	116538	746	1036	0	118528
591	216	118561	632	766	0	120175
592	413	3034	567	111680	0	115694
593	210	112764	601	2679	0	116254
594	111804	2816	551	1032	0	116203
595	2723	764	541	111664	0	115692
596	645	582	110928	2889	0	115044
597	652	466	2857	109772	0	113747
598	403	397	112315	3110	0	116225
599	347	427	112219	989	0	113982
600	363	434	113121	799	0	114717
601	320	111955	3368	789	0	116432
602	379	2752	113981	585	0	117697
603	112515	815	3154	842	0	117326
604	115247	618	1108	761	0	117734
605	116876	554	878	768	0	119076
606	3335	442	727	114836	0	119340
607	114217	429	768	3190	0	118604
608	2801	110415	832	1157	0	115205
609	824	117427	734	1023	0	120008
610	116469	2972	815	1001	0	121257
611	2879	1002	117380	748	0	122009
612	1008	752	2992	116936	0	121688
613	655	686	119042	3029	0	123412
614	521	658	118904	1133	0	121216
615	587	118414	3399	950	0	123350
616	727	2933	1369	112281	0	117310
617	526	930	1017	121571	0	124044
618	118634	739	852	3687	0	123912
619	2790	118221	788	1399	0	123198
620	963	122269	759	1128	0	125119
621	864	3375	120673	1009	0	125921
622	682	122489	2992	866	0	127029
623	120991	3293	1329	1080	0	126693
624	121457	1225	1304	1120	0	125106
625	3123	960	123008	864	0	127955
626	999	827	123946	1008	0	126780
627	900	780	4066	117952	0	123698
628	792	780	1904	119137	0	122613
629	707	119185	1473	3598	0	124963
630	939	3081	1248	119520	0	124788
631	943	1065	1235	121066	0	124309
632	806	118824	1174	3858	0	124662
633	912	3042	1108	119962	0	125024
634	765	1154	1300	117694	0	120913
635	746	115200	1255	4026	0	121227
636	785	2984	115872	1618	0	121259
637	925	1049	3577	118060	0	123611
638	118316	906	1553	3722	0	124497
639	117965	907	1442	1368	0	121682
640	3774	1004	115195	1031	0	121004
641	113147	1074	3191	1291	0	118703
642	117792	1065	1139	1271	0	121267
643	3481	115672	1036	1327	0	121516
644	1270	3066	113592	1386	0	119314
645	861	1246	114333	1376	0	117816
646	880	1271	3685	118431	0	124267
647	119149	903	1740	3878	0	125670
648	125399	826	1407	1566	0	129198
649	3907	853	1101	132828	0	138689
650	143212	953	846	4486	0	149497
651	149327	990	939	1729	0	152985
652	144597	963	1353	1806	0	148719
653	5008	957	141048	1362	0	148375
654	1936	805	141439	1047	0	145227
655	139693	578	3910	1315	0	145496
656	3605	580	140647	941	0	145773
657	920	131155	2722	455	0	135252
658	1306	2780	1669	129315	0	135070
659	589	715	133047	2232	0	136583
660	531	473	130122	749	0	131875
661	834	1227	2841	125673	0	130575
662	452	239	129544	2195	0	132430
663	453	265	125442	730	0	126890
664	376	115349	2520	600	0	118845
665	325	123627	869	290	0	125111
666	123776	2173	687	410	0	127046
667	2201	777	300	121615	0	124893
668	122595	320	239	2045	0	125199
669	2125	237	120305	506	0	123173
670	916	182	1902	119765	0	122765
671	613	255	618	122848	0	124334
672	120836	133	423	2566	0	123958
673	1971	120671	329	895	0	123866
674	837	1924	111387	496	0	114644
675	690	637	115481	305	0	117113
676	328	117759	2262	351	0	120700
677	366	1854	116322	215	0	118757
678	320	115849	2027	267	0	118463
679	338	111923	724	254	0	113239
680	433	2096	112042	204	0	114775
681	109421	637	1889	274	0	112221
682	2035	332	629	114072	0	117068
683	630	115480	462	1740	0	118312
684	628	1631	324	115994	0	118577
685	116162	512	315	2042	0	119031
686	113972	331	317	768	0	115388
687	113696	182	364	604	0	114846
688	2311	223	111291	258	0	114083
689	950	212	1863	109676	0	112701
690	408	112461	783	1656	0	115308
691	117536	1653	513	832	0	120534
692	1991	575	364	118686	0	121616
693	884	433	328	117488	0	119133
694	619	296	303	121980	0	123198
695	453	260	121444	2414	0	124571
696	115300	211	1887	1154	0	118552
697	2076	121336	721	660	0	124793
698	1005	1764	489	122210	0	125468
699	916	582	343	123605	0	125446
700	121909	357	406	2529	0	125201
701	2322	382	114345	920	0	117969
702	928	293	121765	562	0	123548
703	665	120410	2543	505	0	124123
704	513	1926	124376	378	0	127193
705	117856	777	2557	646	0	121836
706	2012	124619	1026	524	0	128181
707	781	2238	125412	479	0	128910
708	119371	779	2458	618	0	123226
709	2262	607	129885	484	0	133238
710	884	130152	2605	539	0	134180
711	891	2194	1099	131042	0	135226
712	772	901	729	133743	0	136145
713	684	737	130548	2657	0	134626
714	822	542	127199	1052	0	129615
715	743	128887	2733	818	0	133181
716	127474	2154	1237	815	0	131680
717	2371	131440	955	616	0	135382
718	1110	2396	681	131736	0	135923
719	875	957	130590	2446	0	134868
720	123000	623	2575	1224	0	127422
721	2667	570	1129	128029	0	132395
722	973	124365	1188	2353	0	128879
723	625	131531	1087	1015	0	134258
724	640	2769	889	131514	0	135812
725	618	1305	782	133531	0	136236
726	131107	1006	741	3012	0	135866
727	2463	796	636	133352	0	137247
728	1109	693	132740	2867	0	137409
729	130750	511	2650	1458	0	135369
730	135975	486	1108	1246	0	138815
731	2997	637	135149	843	0	139626
732	134416	641	2625	904	0	138586
733	3077	640	1035	139993	0	144745
734	1582	638	796	141987	0	145003
735	1256	590	692	143233	0	145771
736	1134	570	711	138951	0	141366
737	711	139825	835	3449	0	144820
738	142474	2720	770	1729	0	147693
739	146455	1189	649	1358	0	149651
740	3582	900	144417	1120	0	150019
741	150450	649	2728	1230	0	155057
742	158768	639	1216	1102	0	161725
743	160664	624	947	1058	0	163293
744	165313	586	839	1022	0	167760
745	4589	161613	686	870	0	167758
746	2061	3859	488	158179	0	164587
747	1236	1173	158534	3374	0	164317
748	1131	920	148966	1328	0	152345
749	134434	2210	4399	1516	0	142559
750	133747	746	2037	795	0	137325
751	2662	128111	579	384	0	131736
752	129752	1862	439	506	0	132559
753	2450	129446	322	398	0	132616
754	1450	2113	291	129726	0	133580
755	131810	753	338	2440	0	135341
756	131123	462	276	1034	0	132895
757	131057	313	215	773	0	132358
758	2869	128389	305	452	0	132015
759	130001	1921	243	566	0	132731
760	2787	784	252	129823	0	133646
761	132009	413	263	2282	0	134967
762	2696	447	127267	744	0	131154
763	1209	128790	1980	530	0	132509
764	129882	1970	737	632	0	133221
765	2504	758	128986	341	0	132589
766	1370	577	1930	128360	0	132237
767	898	390	130982	1966	0	134236
768	880	427	128214	719	0	130240
769	958	343	2459	128798	0	132558
770	772	321	132005	2063	0	135161
771	915	291	2214	131159	0	134579
772	930	297	851	132816	0	134894
773	132815	254	583	2919	0	136571
774	2343	132227	512	1097	0	136179
775	1119	134893	451	707	0	137170
776	810	137907	470	571	0	139758
777	741	2828	135982	474	0	140025
778	1046	1210	2322	133759	0	138337
779	639	674	138234	2332	0	141879
780	131557	481	2487	1218	0	135743
781	136642	394	1072	890	0	138998
782	2872	136380	731	624	0	140607
783	1549	2219	519	134727	0	139014
784	944	137523	528	2246	0	141241
785	138177	2503	437	1128	0	142245
786	2837	1029	389	137871	0	142126
787	1258	768	137676	2460	0	142162
788	894	135482	2369	1124	0	139869
789	872	2416	137834	720	0	141842
790	976	1018	2569	136215	0	140778
791	756	694	136366	2510	0	140326
792	129928	560	2690	1326	0	134504
793	2713	614	136224	775	0	140326
794	1193	136781	2733	750	0	141457
795	1066	2446	1157	137100	0	141769
796	1025	992	855	140327	0	143199
797	137863	692	720	3305	0	142580
798	138595	607	723	1589	0	141514
799	3094	136326	696	1044	0	141160
800	1417	2384	135973	763	0	140537
801	1064	1068	133879	709	0	136720
802	132856	709	3049	876	0	137490
803	2849	657	135374	670	0	139550
804	1359	598	131791	605	0	134353
805	1011	676	132106	629	0	134422
806	919	666	131666	579	0	133830
807	854	131599	3322	649	0	136424
808	132453	2516	1740	846	0	137555
809	2894	1108	1064	129097	0	134163
810	129181	747	948	2520	0	133396
811	2887	127604	871	1069	0	132431
812	128280	2481	789	1028	0	132578
813	2867	131364	871	730	0	135832
814	1556	2685	866	131445	0	136552
815	1097	136133	949	2330	0	140509
816	1023	2827	134350	1000	0	139200
817	909	137924	2909	809	0	142551
818	1073	2912	1407	147495	0	152887
819	148540	1240	1069	3041	0	153890
820	3220	993	918	148557	0	153688
821	1617	935	148291	3086	0	153929
822	1355	796	2918	145285	0	150354
823	953	147487	1455	3153	0	153048
824	997	2969	148139	1413	0	153518
825	145638	1336	3221	1180	0	151375
826	3311	1001	1533	152456	0	158301
827	149340	850	1190	3446	0	154826
828	150498	826	1034	1827	0	154185
829	3673	150973	1048	1166	0	156860
830	147403	2891	969	1411	0	152674
831	151733	1342	920	1230	0	155225
832	3793	149644	997	895	0	155329
833	1851	2951	948	149899	0	155649
834	1397	1366	984	149849	0	153596
835	908	148922	924	3568	0	154322
836	1149	3064	837	152433	0	157483
837	916	1409	150575	3245	0	156145
838	1419	1739	3014	147636	0	153808
839	1207	828	147498	3198	0	152731
840	1186	755	136828	1344	0	140113
841	751	135591	3084	1101	0	140527
842	694	135209	1383	859	0	138145
843	795	138480	1018	737	0	141030
844	1513	2907	999	131276	0	136695
845	492	1085	132549	2072	0	136198
846	128784	650	2115	1142	0	132691
847	2197	508	896	134220	0	137821
848	837	498	133736	2113	0	137184
849	625	554	132132	852	0	134163
850	459	135476	2483	674	0	139092
851	703	2325	1071	134159	0	138258
852	132711	815	731	2278	0	136535
853	1838	130488	592	913	0	133831
854	726	130595	511	680	0	132512
855	483	131196	484	574	0	132737
856	583	2765	500	131184	0	135032
857	367	134407	517	2108	0	137399
858	609	2331	466	141988	0	145394
859	639	982	428	145770	0	147819
860	604	677	142131	3245	0	146657
861	129383	541	2636	1746	0	134306
862	2679	596	144805	636	0	148716
863	1175	1025	2776	143822	0	148798
864	577	589	146175	2815	0	150156
865	401	144616	2874	1173	0	149064
866	144575	2848	1314	1084	0	149821
867	2992	1150	713	141806	0	146661
868	1155	620	551	145646	0	147972
869	143787	477	484	3629	0	148377
870	142874	441	530	1604	0	145449
871	146242	423	465	1164	0	148294
872	3493	486	143238	650	0	147867
873	137244	440	2484	845	0	141013
874	2882	139912	868	637	0	144299
875	1075	143072	539	578	0	145264
876	1041	3033	493	139200	0	143767
877	866	1151	387	137510	0	139914
878	538	137606	397	3090	0	141631
879	747	2674	316	138621	0	142358
880	136882	973	377	3154	0	141386
881	2614	702	136833	1218	0	141367
882	954	136544	2448	910	0	140856
883	131760	2595	889	1091	0	136335
884	2396	135165	628	771	0	138960
885	959	2740	134667	683	0	139049
886	990	1259	2531	133247	0	138027
887	556	778	134274	2689	0	138297
888	547	132847	2613	1135	0	137142
889	766	2660	999	133257	0	137682
890	522	1128	132321	2665	0	136636
891	571	788	131982	1155	0	134496
892	793	742	2888	132772	0	137195
893	132572	570	1184	2888	0	137214
894	133909	509	717	1387	0	136522
895	134195	552	604	1058	0	136409
896	3240	645	134420	707	0	139012
897	1236	134294	2522	760	0	138812
898	923	2547	1018	135249	0	139737
899	751	1077	683	133908	0	136419
900	572	134999	598	3054	0	139223
901	134347	2629	536	1499	0	139011
902	2683	1146	496	136019	0	140344
903	1081	825	135445	2807	0	140158
904	696	135100	2540	1362	0	139698
905	132265	2633	1160	1356	0	137414
906	2475	134447	876	975	0	138773
907	1226	2747	776	133409	0	138158
908	946	1139	748	134577	0	137410
909	864	800	808	135187	0	137659
910	688	800	132635	3394	0	137517
911	871	862	2578	129624	0	133935
912	661	128313	1205	2992	0	133171
913	772	128802	807	1585	0	131966
914	948	2774	124901	1143	0	129766
915	116094	1230	2567	1459	0	121350
916	123644	888	1095	1333	0	126960
917	2954	120975	779	1042	0	125750
918	112003	2105	868	894	0	115870
919	112446	837	497	903	0	114683
920	2581	114497	510	767	0	118355
921	1327	2401	514	115955	0	120197
922	1028	960	118880	2423	0	123291
923	832	911	113830	1061	0	116634
924	116479	815	2738	1188	0	121220
925	2456	118568	1008	1013	0	123045
926	1132	2454	689	119292	0	123567
927	930	1037	565	120360	0	122892
928	972	748	557	120402	0	122679
929	117622	617	587	3500	0	122326
930	2831	635	575	118215	0	122256
931	1401	663	488	119310	0	121862
932	925	630	114430	2989	0	118974
933	107058	596	2311	1589	0	111554
934	2421	112713	1002	1029	0	117165
935	112271	2318	667	1040	0	116296
936	2475	110067	608	792	0	113942
937	1193	2340	640	110757	0	114930
938	111085	874	601	2691	0	115251
939	112669	640	543	1405	0	115257
940	2804	676	109137	849	0	113466
941	111855	555	2144	994	0	115548
942	2763	578	112870	707	0	116918
943	1220	571	110246	637	0	112674
944	851	646	110056	690	0	112243
945	795	637	117640	690	0	119762
946	909	865	3299	119130	0	124203
947	636	556	121626	2983	0	125801
948	806	550	3130	119746	0	124232
949	120485	493	1144	3516	0	125638
950	3114	550	864	120073	0	124601
951	118157	477	724	3634	0	122992
952	3093	117568	694	1434	0	122789
953	1585	3155	649	118596	0	123985
954	1165	1055	116770	3249	0	122239
955	734	120702	2808	1468	0	125712
956	1288	3989	1159	118216	0	124652
957	922	940	118829	3067	0	123758
958	409	114341	2544	1115	0	118409
959	335	117092	932	826	0	119185
960	688	3013	114632	595	0	118928
961	948	1805	2853	110363	0	115969
962	386	669	111535	2545	0	115135
963	106362	329	2766	1059	0	110516
964	111060	168	914	811	0	112953
965	2917	108977	607	408	0	112909
966	110252	2337	338	512	0	113439
967	3066	767	279	110089	0	114201
968	972	509	108864	2513	0	112858
969	104292	300	2448	1115	0	108155
970	2677	285	106814	638	0	110414
971	857	106399	2687	464	0	110407
972	109163	2423	1127	556	0	113269
973	2912	802	628	109001	0	113343
974	930	548	109405	2461	0	113344
975	107752	354	2586	1055	0	111747
976	108872	257	903	830	0	110862
977	110533	246	638	609	0	112026
978	3663	222	441	107578	0	111904
979	1605	217	351	110385	0	112558
980	899	299	107960	3118	0	112276
981	564	107072	2566	1284	0	111486
982	735	2407	895	106397	0	110434
983	631	776	647	110594	0	112648
984	426	573	107989	3207	0	112195
985	463	397	107706	1305	0	109871
986	644	329	3218	107463	0	111654
987	105481	279	1308	3147	0	110215
988	2619	106509	929	1192	0	111249
989	106827	2540	622	1132	0	111121
990	3041	106901	582	711	0	111235
991	1279	2927	106499	561	0	111266
992	925	1061	108110	578	0	110674
993	104842	733	3485	830	0	109890
994	115342	475	1430	882	0	118129
995	3733	113751	1065	760	0	119309
996	1718	3063	111352	713	0	116846
997	1537	1115	3276	110706	0	116634
998	1224	927	1369	109502	0	113022
999	829	111707	1143	3877	0	117556
1000	956	3167	763	113965	0	118851
1001	721	1297	113108	4038	0	119164
1002	110459	1017	3363	1877	0	116716
1003	114002	698	1469	1398	0	117567
1004	112165	630	1170	1152	0	115117
1005	117013	508	903	873	0	119297
1006	5168	513	111582	671	0	117934
1007	112347	376	3585	774	0	117082
1008	4667	449	111929	575	0	117620
1009	2069	110478	4082	645	0	117274
1010	1756	3159	1872	112741	0	119528
1011	114314	1224	1507	3644	0	120689
1012	3918	994	1079	118759	0	124750
1013	1693	752	118628	4365	0	125438
1014	118416	599	3826	2110	0	124951
1015	122880	532	1662	1654	0	126728
1016	5288	548	1259	119991	0	127086
1017	2804	478	987	123341	0	127610
1018	1905	572	118467	5002	0	125946
1019	1347	119783	3753	2396	0	127279
1020	116604	3555	1657	1786	0	123602
1021	4092	1487	110921	1012	0	117512
1022	108826	1064	3579	958	0	114427
1023	4343	110216	1652	771	0	116982
1024	109742	3330	1385	798	0	115255
1025	4424	106476	997	669	0	112566
1026	2224	108512	833	706	0	112275
1027	2056	4136	857	107383	0	114432
1028	1529	1908	729	110981	0	115147
1029	1394	1246	710	111706	0	115056
1030	1263	834	607	112479	0	115183
1031	1002	702	107385	5265	0	114354
1032	106052	581	3438	2699	0	112770
1033	110679	530	1497	1933	0	114639
1034	112706	495	1283	1386	0	115870
1035	5450	495	989	108498	0	115432
1036	3024	479	815	111108	0	115426
1037	109446	522	759	4615	0	115342
1038	110397	598	720	2384	0	114099
1039	111147	578	660	1854	0	114239
1040	5440	869	700	105737	0	112746
1041	2871	825	739	105630	0	110065
1042	2087	547	100577	4220	0	107431
1043	1532	528	98948	2224	0	103232
1044	1361	98993	3727	1665	0	105746
1045	88088	3528	2775	1871	0	96262
1046	87972	1145	1453	1028	0	91598
1047	87766	755	712	1043	0	90276
1048	3618	575	86878	856	0	91927
1049	87073	441	2308	1031	0	90853
1050	89418	346	1029	986	0	91779
1051	90197	405	824	901	0	92327
1052	4043	302	613	86897	0	91855
1053	2389	259	625	87593	0	90866
1054	1933	313	560	87640	0	90446
1055	1327	391	76636	3517	0	81871
1056	76610	361	1774	1874	0	80619
1057	2675	78211	863	1283	0	83032
1058	72413	1614	521	781	0	75329
1059	2456	70219	426	627	0	73728
1060	1312	71688	361	568	0	73929
1061	1496	2242	612	69955	0	74305
1062	1182	1157	583	69490	0	72412
1063	736	68505	306	2109	0	71656
1064	68055	1660	281	1228	0	71224
1065	68788	725	301	1024	0	70838
1066	2288	575	361	67229	0	70453
1067	1397	377	66557	1871	0	70202
1068	1205	288	65036	954	0	67483
1069	1049	288	67305	792	0	69434
1070	1021	302	67125	567	0	69015
1071	64337	592	2557	658	0	68144
1072	64810	254	1125	540	0	66729
1073	2248	217	683	62879	0	66027
1074	1342	217	62060	1733	0	65352
1075	1119	286	1484	63211	0	66100
1076	832	62846	714	1881	0	66273
1077	816	69292	576	925	0	71609
1078	69830	1793	425	994	0	73042
1079	70735	965	320	738	0	72758
1080	71280	670	328	717	0	72995
1081	2404	461	347	69615	0	72827
1082	1409	412	318	71302	0	73441
1083	1221	333	302	71669	0	73525
1084	1162	270	205	71257	0	72894
1085	901	237	69986	2487	0	73611
1086	813	183	1405	70871	0	73272
1087	73317	156	694	2365	0	76532
1088	1878	200	676	74379	0	77133
1089	1082	240	487	75939	0	77748
1090	1081	591	464	74987	0	77123
1091	847	71393	407	2577	0	75224
1092	755	71734	349	1446	0	74284
1093	624	73348	326	1098	0	75396
1094	628	1410	313	67343	0	69694
1095	531	490	294	68284	0	69599
1096	67948	297	186	1688	0	70119
1097	68158	235	174	872	0	69439
1098	68823	234	168	683	0	69908
1099	1668	189	191	67933	0	69981
1100	838	213	176	68043	0	69270
1101	647	66190	205	1484	0	68526
1102	613	69343	149	690	0	70795
1103	68896	1297	137	613	0	70943
1104	1501	526	95	68319	0	70441
1105	68326	232	157	1459	0	70174
1106	70024	176	168	788	0	71156
1107	1598	169	187	68705	0	70659
1108	673	71129	201	1338	0	73341
1109	72691	1038	164	796	0	74689
1110	74362	368	129	715	0	75574
1111	1549	279	74612	488	0	76928
1112	70546	234	759	424	0	71963
1113	1020	70937	266	250	0	72473
1114	504	705	136	73615	0	74960
1115	80287	253	93	1342	0	81975
1116	1243	187	75	80678	0	82183
1117	597	162	51	81316	0	82126
1118	373	81155	76	1297	0	82901
1119	81428	941	53	751	0	83173
1120	81953	337	53	532	0	82875
1121	1355	80208	75	356	0	81994
1122	587	85078	80	240	0	85985
1123	85176	1187	167	398	0	86928
1124	85005	516	46	299	0	85866
1125	1367	339	82720	166	0	84592
1126	687	233	79615	148	0	80683
1127	462	210	83098	155	0	83925
1128	436	117	1275	84346	0	86174
1129	356	107	518	86110	0	87091
1130	246	140	85092	1234	0	86712
1131	83971	131	984	804	0	85890
1132	88844	143	355	511	0	89853
1133	89396	132	235	406	0	90169
1134	88491	99	136	371	0	89097
1135	1628	146	94213	171	0	96158
1136	95669	134	951	513	0	97267
1137	97155	135	464	574	0	98328
1138	97366	123	312	484	0	98285
1139	99571	110	179	405	0	100265
1140	99355	106	148	410	0	100019
1141	1623	179	99526	238	0	101566
1142	820	99190	954	258	0	101222
1143	767	977	365	99142	0	101251
1144	533	440	270	103164	0	104407
1145	417	354	101581	1293	0	103645
1146	95599	188	968	860	0	97615
1147	1338	157	365	101063	0	102923
1148	751	195	101794	1143	0	103883
1149	773	239	95186	541	0	96739
1150	523	102991	1289	480	0	105283
1151	547	1002	583	105833	0	107965
1152	487	441	353	107246	0	108527
1153	502	364	222	106358	0	107446
1154	107118	217	205	1685	0	109225
1155	1321	178	191	107201	0	108891
1156	699	180	105523	1382	0	107784
1157	713	247	98534	722	0	100216
1158	583	244	108218	530	0	109575
1159	688	193	1405	110838	0	113124
1160	113966	206	717	1425	0	116314
1161	1364	228	113581	543	0	115716
1162	112058	156	1118	640	0	113972
1163	125335	146	564	987	0	127032
1164	1761	162	423	127736	0	130082
1165	1050	187	305	128899	0	130441
1166	674	127374	315	1498	0	129861
1167	610	1009	128518	802	0	130939
1168	127288	404	1098	860	0	129650
1169	1490	377	506	133913	0	136286
1170	760	132822	446	1290	0	135318
1171	758	1141	324	135889	0	138112
1172	551	544	135416	1384	0	137895
1173	724	530	1185	132497	0	134936
1174	481	133356	623	1484	0	135944
1175	593	1029	462	134541	0	136625
1176	133984	409	362	1700	0	136455
1177	1404	358	366	131741	0	133869
1178	686	128093	428	1469	0	130676
1179	570	131961	362	757	0	133650
1180	129128	1254	319	926	0	131627
1181	1338	652	132225	455	0	134670
1182	918	438	1147	131349	0	133852
1183	778	321	539	136469	0	138107
1184	630	259	136949	1527	0	139365
1185	513	136484	1246	907	0	139150
1186	506	1073	137265	578	0	139422
1187	577	1031	1256	133761	0	136625
1188	343	138961	632	1066	0	141002
1189	142139	925	402	1060	0	144526
1190	1042	140336	330	490	0	142198
1191	569	142811	300	442	0	144122
1192	145357	1138	400	764	0	147659
1193	147002	478	350	828	0	148658
1194	149717	285	216	717	0	150935
1195	1392	199	230	150107	0	151928
1196	630	228	148762	949	0	150569
1197	147141	138	935	1010	0	149224
1198	156299	118	410	805	0	157632
1199	1662	152	299	160974	0	163087
1200	671	216	161187	1330	0	163404
1201	417	159571	1319	574	0	161881
1202	161036	1222	512	892	0	163662
1203	166957	405	316	1091	0	168769
1204	1593	167817	253	395	0	170058
1205	609	172799	228	279	0	173915
1206	173381	1530	219	799	0	175929
1207	173059	510	158	721	0	174448
1208	171694	325	137	545	0	172701
1209	1968	232	142	170207	0	172549
1210	749	294	172213	1371	0	174627
1211	769	302	1279	167089	0	169439
1212	392	229	169736	1492	0	171849
1213	326	164808	1422	641	0	167197
1214	301	167632	480	470	0	168883
1215	717	1155	355	159261	0	161488
1216	440	243	167	162841	0	163691
1217	481	178	137	159509	0	160305
1218	205	162167	210	1244	0	163826
1219	161778	1019	144	892	0	163833
1220	160362	349	163	786	0	161660
1221	1149	163407	193	317	0	165066
1222	614	1080	90	160335	0	162119
1223	358	161381	116	1026	0	162881
1224	508	1313	70	161542	0	163433
1225	320	162651	94	1073	0	164138
1226	163529	1116	91	936	0	165672
1227	1375	304	97	162183	0	163959
1228	486	319	160756	1129	0	162690
1229	156715	204	1000	1072	0	158991
1230	160373	219	327	944	0	161863
1231	1253	313	159623	323	0	161512
1232	695	268	1015	159697	0	161675
1233	330	358	162260	1207	0	164155
1234	493	314	1024	162432	0	164263
1235	303	385	156020	1264	0	157972
1236	148958	262	1088	1001	0	151309
1237	1315	290	280	154420	0	156305
1238	456	153808	277	1242	0	155783
1239	158487	1242	164	949	0	160842
1240	1506	434	177	160524	0	162641
1241	648	392	141	159963	0	161144
1242	427	434	158298	1552	0	160711
1243	721	348	1185	161329	0	163583
1244	412	386	166658	1827	0	169283
1245	488	428	168664	645	0	170225
1246	732	286	2082	176332	0	179432
1247	469	329	188218	2055	0	191071
1248	184700	240	2575	1416	0	188931
1249	213918	212	842	1162	0	216134
1250	225038	245	462	1259	0	227004
1251	5248	233513	543	599	0	239903
1252	2816	4377	395	237243	0	244831
1253	1932	1679	361	232623	0	236595
1254	837	242413	448	5370	0	249068
1255	242084	4811	333	2825	0	250053
1256	5558	1793	287	242016	0	249654
1257	1957	1193	246137	5154	0	254441
1258	1346	914	234942	2171	0	239373
1259	818	237602	5911	1604	0	245935
1260	240543	4718	2322	1701	0	249284
1261	5162	1864	238620	857	0	246503
1262	227575	1040	5410	1608	0	235633
1263	5419	224922	2334	961	0	233636
1264	2320	4802	228122	693	0	235937
1265	1639	1924	218274	834	0	222671
1266	1265	1269	229494	699	0	232727
1267	988	223427	6848	791	0	232054
1268	1217	4987	225839	644	0	232687
1269	220709	1810	5946	1107	0	229572
1270	6247	1261	2561	212050	0	222119
1271	2722	852	1591	228532	0	233697
1272	2103	778	1054	231358	0	235293
1273	1828	670	756	232737	0	235991
1274	1119	785	228180	7379	0	237463
1275	1577	633	5020	227537	0	234767
1276	1541	613	2039	233180	0	237373
1277	226184	578	1515	7856	0	236133
1278	232136	621	1268	3789	0	237814
1279	219359	747	1223	3344	0	224673
1280	7042	955	223184	1669	0	232850
1281	3128	227166	5305	1484	0	237083
1282	1987	240995	2354	1332	0	246668
1283	225335	6827	1610	2078	0	235850
1284	5545	234562	1469	1225	0	242801
1285	3098	6499	1367	232637	0	243601
1286	2288	2703	1341	239627	0	245959
1287	1399	1876	233471	7262	0	244008
1288	1115	229066	6159	3344	0	239684
1289	1199	5913	225189	2199	0	234500
1290	220717	2306	6562	2424	0	232009
1291	233298	1531	2919	2000	0	239748
1292	7875	1094	2009	228808	0	239786
1293	3606	884	1742	228603	0	234835
1294	2453	845	1598	229446	0	234342
1295	2348	952	1400	230494	0	235194
1296	1524	891	225213	9014	0	236642
1297	2079	1313	5929	223009	0	232330
1298	1355	703	223314	7720	0	233092
1299	1257	743	215173	3890	0	221063
1300	1045	216453	7254	2922	0	227674
1301	216802	5366	3447	2858	0	228473
1302	5793	222470	2308	2047	0	232618
1303	3066	6571	1774	217007	0	228418
1304	1879	2661	224897	6682	0	236119
1305	216937	1705	6596	3578	0	228816
1306	6891	1368	222609	2227	0	233095
1307	222946	1134	7227	2193	0	233500
1308	229553	967	3240	1977	0	235737
1309	9359	1044	2232	230407	0	243042
1310	4646	1041	1898	230472	0	238057
1311	3423	1216	1676	234391	0	240706
1312	2431	1398	224581	9693	0	238103
1313	219192	1390	7052	5103	0	232737
1314	7521	221996	3146	3506	0	236169
1315	4186	6830	2194	225176	0	238386
1316	225347	2918	1998	8714	0	238977
1317	230895	2077	2082	4425	0	239479
1318	232662	1792	1799	3557	0	239810
1319	11416	1876	219808	2820	0	235920
1320	227003	1948	7346	3207	0	239504
1321	231242	2512	3358	3678	0	240790
1322	10602	1750	203423	4274	0	220049
1323	5117	1836	232073	3290	0	242316
1324	4275	2223	9827	229368	0	245693
1325	3661	1382	234560	8523	0	248126
1326	2356	221720	10650	4715	0	239441
1327	2370	234974	6666	2741	0	246751
1328	226667	9347	4704	2642	0	243360
1329	8738	235205	3278	1980	0	249201
1330	5559	8745	3159	235034	0	252497
1331	226186	3855	3535	8974	0	242550
1332	8983	235321	2662	4338	0	251304
1333	4148	9052	2943	234649	0	250792
1334	3326	3387	3735	240613	0	251061
1335	2645	2422	232445	11258	0	248770
1336	3069	2004	9317	232416	0	246806
1337	2696	2233	231198	10961	0	247088
1338	3011	1253	232121	6185	0	242570
1339	3888	1255	9469	226944	0	241556
1340	3044	1114	4231	234224	0	242613
1341	225489	1043	2993	13077	0	242602
1342	8631	240067	2723	7075	0	258496
1343	4717	8089	2307	239033	0	254146
1344	4175	5742	2520	241346	0	253783
1345	228129	2300	1481	13049	0	244959
1346	9686	220060	1556	6557	0	237859
1347	5024	210685	1623	3929	0	221261
1348	3519	202134	1550	2886	0	210089
1349	1922	185463	1409	1772	0	190566
1350	158847	6487	4606	1601	0	171541
1351	157632	2176	1294	1401	0	162503
1352	154546	1311	650	1273	0	157780
1353	154861	936	530	1216	0	157543
1354	6657	812	602	149099	0	157170
1355	2580	862	146639	4777	0	154858
1356	1698	144852	4523	1815	0	152888
1357	1586	4530	1578	144167	0	151861
1358	1203	1547	144044	4837	0	151631
1359	1455	1257	4636	142891	0	150239
1360	1362	830	1584	146187	0	149963
1361	999	803	142200	6033	0	150035
1362	1204	825	4662	142637	0	149328
1363	1813	858	1988	136414	0	141073
1364	142325	723	1203	6536	0	150787
1365	143289	698	1029	2948	0	147964
1366	143501	645	825	2212	0	147183
1367	143807	768	703	1909	0	147187
1368	6804	650	733	138607	0	146794
1369	3087	691	673	142039	0	146490
1370	2364	748	689	142788	0	146589
1371	137939	731	758	6921	0	146349
1372	5746	816	767	139135	0	146464
1373	2838	762	708	142135	0	146443
1374	2179	815	133914	6605	0	143513
1375	2187	1323	4467	132817	0	140794
1376	1773	128246	1711	5940	0	137670
1377	1666	137107	1142	2752	0	142667
1378	131481	5098	929	2212	0	139720
1379	5334	1927	129272	1809	0	138342
1380	2292	125166	4237	1589	0	133284
1381	122730	4239	2215	1518	0	130702
1382	5009	1620	1233	122123	0	129985
1383	2006	1217	121538	4884	0	129645
1384	1894	1563	4181	119062	0	126700
1385	1236	122996	1580	5104	0	130916
1386	121312	4173	1253	2618	0	129356
1387	4448	124081	969	2277	0	131775
1388	124281	4621	846	1823	0	131571
1389	127801	1708	696	1757	0	131962
1390	5824	1407	646	124733	0	132610
1391	2718	1129	630	124144	0	128621
1392	1824	123533	640	5713	0	131710
1393	124851	4265	624	2937	0	132677
1394	5035	1620	122610	2047	0	131312
1395	121254	1312	3978	1870	0	128414
1396	122397	894	1434	1810	0	126535
1397	5499	840	116532	1600	0	124471
1398	2500	1585	3852	113202	0	121139
1399	114449	716	1474	4996	0	121635
1400	4689	798	112882	2205	0	120574
1401	2103	797	109911	1831	0	114642
1402	103117	840	4540	1689	0	110186
1403	4089	102051	1901	1385	0	109426
1404	1689	98512	1166	1139	0	102506
1405	2208	4261	1156	94541	0	102166
1406	1359	1713	94059	3479	0	100610
1407	91069	1187	3302	1733	0	97291
1408	3750	822	91561	1356	0	97489
1409	1589	86526	3105	968	0	92188
1410	86598	3039	1459	1037	0	92133
1411	3495	1278	865	86128	0	91766
1412	86508	936	595	3487	0	91526
1413	3856	679	84570	1499	0	90604
1414	1877	769	2756	83509	0	88911
1415	1374	85393	1124	3057	0	90948
1416	1198	3066	899	85374	0	90537
1417	1205	1566	625	87854	0	91250
1418	1282	1022	85558	3702	0	91564
1419	1290	82169	2877	1872	0	88208
1420	1262	83782	1217	1684	0	87945
1421	1222	2998	80833	1005	0	86058
1422	76174	1454	3042	1001	0	81671
1423	78525	750	1331	1037	0	81643
1424	3638	893	995	75387	0	80913
1425	73410	473	789	2752	0	77424
1426	2915	69293	810	1345	0	74363
1427	1293	73372	642	1218	0	76525
1428	72806	2839	754	1183	0	77582
1429	3187	1587	700	71877	0	77351
1430	73050	726	710	2867	0	77353
1431	75159	461	538	1484	0	77642
1432	3537	565	425	71551	0	76078
1433	1872	594	70386	2698	0	75550
1434	70704	575	2339	1292	0	74910
1435	72778	454	944	1052	0	75228
1436	3521	649	798	69574	0	74542
1437	1713	69465	593	2681	0	74452
1438	1380	2629	577	70217	0	74803
1439	1065	898	69123	2931	0	74017
1440	995	793	68463	1483	0	71734
1441	888	67864	2785	1407	0	72944
1442	1466	1524	1117	49382	0	53489
1443	414	356	597	50008	0	51375
1444	390	274	49187	1188	0	51039
1445	47988	233	1017	602	0	49840
1446	50464	232	381	430	0	51507
1447	50289	183	303	369	0	51144
1448	50580	194	241	358	0	51373
1449	1469	48423	234	286	0	50412
1450	643	50547	228	305	0	51723
1451	51267	1184	214	357	0	53022
1452	1354	492	218	52064	0	54128
1453	620	332	215	53105	0	54272
1454	456	52770	229	1438	0	54893
1455	451	1180	209	53528	0	55368
1456	477	424	176	53125	0	54202
1457	393	52290	199	1544	0	54426
1458	398	1207	52018	657	0	54280
1459	433	450	1130	52587	0	54600
1460	52566	356	415	1422	0	54759
1461	52593	294	335	614	0	53836
1462	1573	279	51006	425	0	53283
1463	740	224	50313	362	0	51639
1464	583	215	50619	337	0	51754
1465	527	379	1420	49617	0	51943
1466	397	225	49846	1233	0	51701
1467	404	253	49455	545	0	50657
1468	502	951	1416	47894	0	50763
1469	390	49541	541	1245	0	51717
1470	362	1119	49880	524	0	51885
1471	351	50179	1147	433	0	52110
1472	49298	1240	510	469	0	51517
1473	1121	49639	350	356	0	51466
1474	545	1164	326	49149	0	51184
1475	49397	396	289	1240	0	51322
1476	1228	311	261	49341	0	51141
1477	593	246	267	50273	0	51379
1478	357	232	50299	1424	0	52312
1479	334	47930	1168	636	0	50068
1480	318	50151	475	448	0	51392
1481	379	1323	392	48337	0	50431
1482	315	412	317	48612	0	49656
1483	300	329	231	47785	0	48645
1484	227	234	46140	1318	0	47919
1485	234	197	44066	545	0	45042
1486	42265	162	1053	461	0	43941
1487	874	142	43080	261	0	44357
1488	294	138	43059	202	0	43693
1489	153	42047	983	180	0	43363
1490	341	942	467	41732	0	43482
1491	170	229	41967	780	0	43146
1492	182	164	789	40954	0	42089
1493	102	109	42641	890	0	43742
1494	178	120	825	42665	0	43788
1495	109	99	44292	896	0	45396
1496	173	103	863	44005	0	45144
1497	137	77	344	44360	0	44918
1498	94	44918	222	977	0	46211
1499	135	728	175	45619	0	46657
1500	84	45757	209	909	0	46959
1501	110	829	161	46679	0	47779
1502	126	282	157	47254	0	47819
1503	45888	150	189	1114	0	47341
1504	811	146	169	46016	0	47142
1505	265	153	45458	1000	0	46876
1506	204	113	824	45433	0	46574
1507	173	87	321	46269	0	46850
1508	110	112	45211	1157	0	46590
1509	115	128	44558	498	0	45299
1510	176	142	979	44258	0	45555
1511	133	128	357	45675	0	46293
1512	111	130	44989	1141	0	46371
1513	90	43144	864	524	0	44622
1514	90	45241	348	376	0	46055
1515	44335	924	245	408	0	45912
1516	860	351	208	44969	0	46388
1517	45609	174	189	1095	0	47067
1518	44948	134	207	533	0	45822
1519	903	45230	220	341	0	46694
1520	45803	793	204	404	0	47204
1521	46279	281	201	347	0	47108
1522	969	187	45364	283	0	46803
1523	378	217	856	45518	0	46969
1524	232	132	46770	917	0	48051
1525	215	284	947	46837	0	48283
1526	130	118	47074	1015	0	48337
1527	140	44656	931	417	0	46144
1528	129	46113	388	302	0	46932
1529	346	989	300	44954	0	46589
1530	44687	254	191	893	0	46025
1531	787	155	160	44756	0	45858
1532	280	114	160	45095	0	45649
1533	168	121	45053	996	0	46338
1534	130	121	44974	412	0	45637
1535	113	115	45382	327	0	45937
1536	165	94	953	44815	0	46027
1537	154	109	391	44610	0	45264
1538	88	44629	267	980	0	45964
1539	85	46730	197	455	0	47467
1540	45662	899	170	388	0	47119
1541	726	46305	192	314	0	47537
1542	228	834	45838	255	0	47155
1543	214	276	840	45388	0	46718
1544	121	178	46979	960	0	48238
1545	99	47028	928	394	0	48449
1546	192	1050	348	47390	0	48980
1547	46160	230	272	983	0	47645
1548	694	187	46763	391	0	48035
1549	214	46914	797	358	0	48283
1550	164	723	46674	258	0	47819
1551	93	46014	789	252	0	47148
1552	383	1027	451	43579	0	45440
1553	44026	196	253	794	0	45269
1554	43673	133	156	341	0	44303
1555	665	43215	167	239	0	44286
1556	43984	586	139	270	0	44979
1557	668	203	122	44025	0	45018
1558	44109	170	152	764	0	45195
1559	699	123	44310	313	0	45445
1560	243	138	44416	241	0	45038
1561	240	129	793	43628	0	44790
1562	170	107	280	46139	0	46696
1563	119	114	45500	890	0	46623
1564	167	115	728	45484	0	46494
1565	45634	112	258	950	0	46954
1566	45866	116	197	417	0	46596
1567	847	44030	172	271	0	45320
1568	270	44576	154	217	0	45217
1569	43449	796	149	254	0	44648
1570	803	251	127	43041	0	44222
1571	42541	164	145	827	0	43677
1572	728	42294	196	256	0	43474
1573	42355	647	143	328	0	43473
1574	770	205	41455	167	0	42597
1575	240	189	41318	188	0	41935
1576	255	309	792	41155	0	42511
1577	198	133	42033	727	0	43091
1578	194	178	687	40508	0	41567
1579	228	121	239	39792	0	40380
1580	156	109	42018	746	0	43029
1581	175	141	693	41973	0	42982
1582	203	129	225	44117	0	44674
1583	136	108	45180	885	0	46309
1584	155	103	44944	289	0	45491
1585	44553	121	875	316	0	45865
1586	836	116	46194	165	0	47311
1587	47548	179	991	208	0	48926
1588	51370	99	309	213	0	51991
1589	1207	107	51967	139	0	53420
1590	454	67	53776	113	0	54410
1591	413	288	1356	51542	0	53599
1592	311	115	511	51062	0	51999
1593	135	51021	352	1194	0	52702
1594	113	52980	241	495	0	53829
1595	118	1192	51576	303	0	53189
1596	50257	389	1125	304	0	52075
1597	51876	234	425	251	0	52786
1598	1305	141	50431	163	0	52040
1599	495	128	50386	134	0	51143
1600	421	110	1277	49050	0	50858
1601	234	49955	520	942	0	51651
1602	269	974	314	50977	0	52534
1603	252	304	224	52117	0	52897
1604	51612	194	167	1360	0	53333
1605	51938	133	157	558	0	52786
1606	1383	121	135	52431	0	54070
1607	537	102	52181	1129	0	53949
1608	50914	76	1036	547	0	52573
1609	1142	52965	409	324	0	54840
1610	53802	963	293	309	0	55367
1611	53378	302	229	301	0	54210
1612	1284	53176	180	187	0	54827
1613	525	54768	175	181	0	55649
1614	408	1270	181	54127	0	55986
1615	308	477	136	54937	0	55858
1616	202	53999	167	1325	0	55693
1617	308	1101	133	54488	0	56030
1618	281	401	130	55616	0	56428
1619	168	264	54024	1484	0	55940
1620	53423	164	1108	692	0	55387
1621	55348	111	411	500	0	56370
1622	55950	101	285	354	0	56690
1623	1722	116	228	54366	0	56432
1624	53660	77	175	1260	0	55172
1625	1372	52573	186	468	0	54599
1626	687	1206	177	50403	0	52473
1627	417	50765	191	1069	0	52442
1628	255	53031	193	392	0	53871
1629	52340	1247	331	371	0	54289
1630	52692	453	220	314	0	53679
1631	52169	264	145	252	0	52830
1632	52217	196	142	231	0	52786
1633	52146	164	142	233	0	52685
1634	1580	155	51058	158	0	52951
1635	51242	119	1016	248	0	52625
1636	1400	124	52169	154	0	53847
1637	50996	125	1142	252	0	52515
1638	52199	86	491	251	0	53027
1639	51589	102	349	276	0	52316
1640	1523	151	50996	203	0	52873
1641	787	336	977	50357	0	52457
1642	473	52765	417	903	0	54558
1643	53955	962	298	418	0	55633
1644	53921	478	256	312	0	54967
1645	1455	53705	239	238	0	55637
1646	54854	1014	209	288	0	56365
1647	1489	370	240	53285	0	55384
1648	594	54146	232	1014	0	55986
1649	54652	1050	179	506	0	56387
1650	55265	418	173	387	0	56243
1651	1553	309	186	54410	0	56458
1652	55168	215	231	1205	0	56819
1653	1465	178	260	55265	0	57168
1654	770	167	248	56112	0	57297
1655	588	217	54969	1446	0	57220
1656	599	215	1060	54758	0	56632
1657	503	255	436	55813	0	57007
1658	411	244	54860	1409	0	56924
1659	419	231	54485	664	0	55799
1660	480	171	1226	55182	0	57059
1661	387	190	55341	1185	0	57103
1662	52970	186	1159	612	0	54927
1663	1119	55698	524	451	0	57792
1664	538	978	304	56980	0	58800
1665	445	389	211	58210	0	59255
1666	463	272	170	58074	0	58979
1667	58105	212	137	1503	0	59957
1668	58320	172	143	732	0	59367
1669	58967	162	140	567	0	59836
1670	1517	57760	127	397	0	59801
1671	851	989	106	58968	0	60914
1672	674	400	86	59777	0	60937
1673	59303	315	80	1330	0	61028
1674	59681	293	69	633	0	60676
1675	1477	303	93	58945	0	60818
1676	699	271	58603	1175	0	60748
1677	58736	263	904	635	0	60538
1678	60366	200	310	520	0	61396
1679	1508	167	59975	378	0	62028
1680	57766	159	942	434	0	59301
1681	1393	154	59698	326	0	61571
1682	59039	111	1015	347	0	60512
1683	1319	981	506	59529	0	62335
1684	683	62651	294	887	0	64515
1685	713	801	64915	381	0	66810
1686	463	63921	1018	370	0	65772
1687	367	60802	371	319	0	61859
1688	62426	1089	556	565	0	64636
1689	862	309	197	61612	0	62980
1690	232	84	44	60853	0	61213
1691	62804	45	60	832	0	63741
1692	673	59	47	63464	0	64243
1693	241	55	42	63446	0	63784
1694	202	42	40	63408	0	63692
1695	159	51	43	62859	0	63112
1696	104	63	62810	720	0	63697
1697	136	66	60815	219	0	61236
1698	92	62125	596	178	0	62991
1699	63766	529	140	307	0	64742
1700	647	125	81	64483	0	65336
1701	187	63667	93	639	0	64586
1702	207	528	64	67864	0	68663
1703	189	126	62	68475	0	68852
1704	177	94	44	68293	0	68608
1705	174	66	50	69468	0	69758
1706	183	79	61	69226	0	69549
1707	118	67913	84	729	0	68844
1708	170	557	60	69275	0	70062
1709	154	179	67875	669	0	68877
1710	128	67937	521	289	0	68875
1711	177	596	99	68973	0	69845
1712	156	235	74	68917	0	69382
1713	96	66998	72	760	0	67926
1714	77	68589	73	315	0	69054
1715	67957	533	69	333	0	68892
1716	500	67267	83	229	0	68079
1717	67422	519	154	296	0	68391
1718	67044	112	114	264	0	67534
1719	568	127	70236	154	0	71085
1720	322	116	485	67901	0	68824
1721	147	97	71521	553	0	72318
1722	80	72601	514	257	0	73452
1723	399	677	133	67985	0	69194
1724	177	142	77	73789	0	74185
1725	162	86	43	74884	0	75175
1726	154	86	47	75614	0	75901
1727	111	87	76743	738	0	77679
1728	183	76	519	76319	0	77097
1729	129	109	77970	687	0	78895
1730	137	110	76414	254	0	76915
1731	75900	72	646	449	0	77067
1732	80653	65	181	347	0	81246
1733	81254	62	104	315	0	81735
1734	672	79027	101	207	0	80007
1735	252	574	74	81019	0	81919
1736	186	163	83404	667	0	84420
1737	294	103	567	82384	0	83348
1738	178	111	86417	677	0	87383
1739	85863	84	671	447	0	87065
1740	87134	65	197	354	0	87750
1741	87175	55	137	285	0	87652
1742	772	96	84228	139	0	85235
1743	315	170	82891	151	0	83527
1744	325	193	687	86900	0	88105
1745	384	86	237	83969	0	84676
1746	162	57	93	89647	0	89959
1747	117	77	89574	721	0	90489
1748	189	186	82047	298	0	82720
1749	87572	56	669	350	0	88647
1750	622	55	207	92558	0	93442
1751	242	45	153	93273	0	93713
1752	95103	47	102	920	0	96172
1753	670	53	103	95097	0	95923
1754	101078	68	89	1183	0	102418
1755	104328	48	99	755	0	105230
1756	104109	51	93	573	0	104826
1757	749	88	105705	195	0	106737
1758	248	105088	625	248	0	106209
1759	110137	545	165	460	0	111307
1760	771	127	126	110707	0	111731
1761	352	90	92	110117	0	110651
1762	181	109910	116	798	0	111005
1763	111016	582	106	467	0	112171
1764	110856	145	99	451	0	111551
1765	112405	99	80	460	0	113044
1766	787	112923	135	205	0	114050
1767	120349	610	95	649	0	121703
1768	120922	156	85	494	0	121657
1769	121310	106	99	374	0	121889
1770	955	64	73	119686	0	120778
1771	362	81	75	121009	0	121527
1772	265	134	122922	833	0	124154
1773	471	98	614	119431	0	120614
1774	455	59	153	119991	0	120658
1775	221	102	122815	815	0	123953
1776	118093	68	577	543	0	119281
1777	124459	69	150	434	0	125112
1778	905	172	120	123259	0	124456
1779	324	120364	139	705	0	121532
1780	231	122608	117	269	0	123225
1781	367	986	121	122434	0	123908
1782	242	249	119956	683	0	121130
1783	465	481	578	115438	0	116962
1784	191	109	118970	615	0	119885
1785	202	170	117181	168	0	117721
1786	295	52	368	122539	0	123254
1787	124761	18	155	764	0	125698
1788	122722	23	84	468	0	123297
1789	517	80	58	126390	0	127045
1790	343	51	58	125730	0	126182
1791	207	35	59	127792	0	128093
1792	194	42	54	127057	0	127347
1793	128834	36	68	815	0	129753
1794	127654	38	62	529	0	128283
1795	127477	36	67	496	0	128076
1796	544	94	127105	110	0	127853
1797	359	41	326	126575	0	127301
1798	257	49	110	130514	0	130930
1799	130396	40	90	741	0	131267
1800	430	128174	120	262	0	128986
1801	129994	326	49	574	0	130943
1802	129672	108	51	498	0	130329
1803	129283	61	71	474	0	129889
1804	128963	50	55	478	0	129546
1805	738	133	131058	124	0	132053
1806	589	310	122274	139	0	123312
1807	135549	52	599	601	0	136801
1808	139371	33	174	440	0	140018
1809	138730	35	110	467	0	139342
1810	139467	43	85	474	0	140069
1811	863	132	143203	142	0	144340
1812	325	147676	922	233	0	149156
1813	783	999	303	156800	0	158885
1814	166618	322	195	2093	0	169228
1815	168811	187	132	1103	0	170233
1816	176231	69	97	834	0	177231
1817	179075	44	96	735	0	179950
1818	180865	45	96	604	0	181610
1819	175042	84	106	585	0	175817
1820	3150	248	162668	368	0	166434
1821	1469	196	166440	155	0	168260
1822	1223	368	2084	165944	0	169619
1823	801	178	171021	1751	0	173751
1824	717	165050	2139	739	0	168645
1825	701	165732	1010	495	0	167938
1826	893	2307	598	173566	0	177364
1827	553	875	178657	1789	0	181874
1828	592	665	166950	803	0	169010
1829	171045	366	2670	1021	0	175102
1830	188815	294	1234	851	0	191194
1831	3498	312	671	190963	0	195444
1832	194768	291	530	3378	0	198967
1833	3789	237	442	194108	0	198576
1834	1902	169	426	195083	0	197580
1835	1065	212	197545	3967	0	202789
1836	927	285	187952	1661	0	190825
1837	1139	175	3786	190570	0	195670
1838	734	233	190881	3404	0	195252
1839	181200	111	3498	2054	0	186863
1840	193511	115	1421	1578	0	196625
1841	4236	195117	948	829	0	201130
1842	198663	3056	694	1211	0	203624
1843	4263	1125	194078	484	0	199950
1844	192453	467	3550	1003	0	197473
1845	198543	248	1480	1006	0	201277
1846	200552	224	901	904	0	202581
1847	5799	288	606	192602	0	199295
1848	2474	193225	675	3199	0	199573
1849	197422	3234	601	1883	0	203140
1850	199161	1126	628	1351	0	202266
1851	5581	610	615	197754	0	204560
1852	197993	371	557	4631	0	203552
1853	4986	198666	623	1864	0	206139
1854	2723	3848	513	196505	0	203589
1855	1770	1462	191691	4362	0	199285
1856	177194	787	4116	2574	0	184671
1857	5027	601	191266	1221	0	198115
1858	2741	798	4488	190070	0	198097
1859	1691	187566	1882	4476	0	195615
1860	1472	203591	1190	1885	0	208138
1861	1947	5784	896	205012	0	213639
1862	1871	197281	1404	5285	0	205841
1863	2340	6455	864	265403	0	275062
1864	2300	2200	806	280672	0	285978
1865	2177	1482	739	287482	0	291880
1866	273251	1121	673	13036	0	288081
1867	10440	949	527	274104	0	286020
1868	3858	1017	266784	11253	0	282912
1869	2705	266927	8582	4836	0	283050
1870	269375	8703	2628	3897	0	284603
1871	11158	2832	1468	269253	0	284711
1872	5351	1695	1139	275070	0	283255
1873	4144	1299	1075	280158	0	286676
1874	2655	1344	267428	13100	0	284527
1875	2269	267178	9166	5585	0	284198
1876	270115	9213	3148	4493	0	286969
1877	10870	3237	2021	260074	0	276202
1878	3846	272665	1754	10345	0	288610
1879	272453	9909	1608	5443	0	289413
1880	10437	3848	268718	3331	0	286334
1881	267548	2525	9895	3379	0	283347
1882	11629	2281	273118	2310	0	289338
1883	5141	2115	272467	2371	0	282094
1884	3382	269421	11658	2601	0	287062
1885	3637	9817	4636	260947	0	279037
1886	2705	3540	263334	10587	0	280166
1887	2374	252284	11113	4681	0	270452
1888	2953	9754	4547	251523	0	268777
1889	1963	254589	3160	10494	0	270206
1890	1850	10718	254266	4714	0	271548
1891	2681	4285	10375	252050	0	269391
1892	1862	3126	255368	11839	0	272195
1893	2852	2277	11136	253937	0	270202
1894	2753	2016	4557	263335	0	272661
1895	1972	2094	253549	14117	0	271732
1896	2902	1748	10954	255186	0	270790
1897	245700	1531	4671	14250	0	266152
1898	10173	248480	3315	6825	0	268793
1899	4517	9943	248473	5248	0	268181
1900	245604	3780	10733	4940	0	265057
1901	12192	2763	4542	241026	0	260523
1902	5286	246870	3380	11211	0	266747
1903	251731	10319	2842	6134	0	271026
1904	259648	4385	2530	4827	0	271390
1905	14175	3247	2346	243379	0	263147
1906	6695	2624	2174	251759	0	263252
1907	4560	2532	2031	253786	0	262909
1908	3930	2430	2014	249922	0	258296
1909	3201	238059	2246	15965	0	259471
1910	4184	13233	2208	231474	0	251099
1911	2819	227907	2076	13634	0	246436
1912	2592	228715	2098	8015	0	241420
1913	2133	228192	2262	6173	0	238760
1914	2505	12402	208099	5355	0	228361
1915	2238	215330	9799	5322	0	232689
1916	200797	11382	4639	5722	0	222540
1917	9401	203352	2984	5533	0	221270
1918	4628	10667	2609	190520	0	208424
1919	3333	204128	2650	11819	0	221930
1920	3551	10905	2758	204251	0	221465
1921	3388	5416	2778	211658	0	223240
1922	3077	4457	201206	13778	0	222518
1923	195903	4034	9683	7961	0	217581
1924	202594	3721	4012	7040	0	217367
1925	202208	3321	3271	6628	0	215428
1926	11785	194974	3294	6504	0	216557
1927	5695	9945	3352	193104	0	212096
1928	4307	4715	188555	12492	0	210069
1929	3662	187204	10039	6791	0	207696
1930	4417	10810	4300	164391	0	183918
1931	3464	175476	3467	9363	0	191770
1932	173737	9694	3304	5357	0	192092
1933	176905	4833	3242	4408	0	189388
1934	180476	3651	3698	3919	0	191744
1935	179472	3275	3776	3493	0	190016
1936	11501	3229	3543	171002	0	189275
1937	5496	3197	3439	172411	0	184543
1938	3964	169489	3276	10753	0	187482
1939	3726	9178	2669	174855	0	190428
1940	2814	4548	168402	11670	0	187434
1941	2482	3873	8381	168429	0	183165
1942	1887	3623	163662	11864	0	181036
1943	1815	160755	9011	7350	0	178931
1944	1930	8854	163132	5462	0	179378
1945	2250	4406	9724	163313	0	179693
1946	2063	3300	164212	11102	0	180677
1947	2201	2972	9777	164126	0	179076
1948	2499	2907	4763	168435	0	178604
1949	2815	2983	3691	168616	0	178105
1950	2933	3122	3207	167912	0	177174
1951	157959	3006	2712	11828	0	175505
1952	8328	159186	2388	6645	0	176547
1953	155936	8309	2061	5770	0	172076
1954	8735	4240	148351	5112	0	166438
1955	151755	3139	6640	5023	0	166557
1956	157811	2909	2767	4909	0	168396
1957	11463	2857	147880	4443	0	166643
1958	7331	2665	145161	4403	0	159560
1959	4300	140112	7582	5037	0	157031
1960	3069	136162	3120	4597	0	146948
1961	3965	7989	123712	4830	0	140496
1962	2353	111778	5840	5037	0	125008
1963	3220	4536	2408	60334	0	70498
1964	56000	633	1055	1537	0	59225
1965	1144	384	227	55629	0	57384
1966	56099	304	152	1279	0	57834
1967	56225	286	166	697	0	57374
1968	1179	56450	210	483	0	58322
1969	56789	864	159	460	0	58272
1970	57192	396	120	444	0	58152
1971	1275	352	137	55910	0	57674
1972	56445	259	151	1099	0	57954
1973	1094	56715	117	533	0	58459
1974	567	862	127	57445	0	59001
1975	57442	344	123	1185	0	59094
1976	970	320	56409	500	0	58199
1977	56238	239	760	444	0	57681
1978	1124	431	292	57184	0	59031
1979	441	175	57142	770	0	58528
1980	376	194	54952	330	0	55852
1981	55112	421	1140	415	0	57088
1982	55520	100	415	377	0	56412
1983	868	86	232	54864	0	56050
1984	444	80	133	55311	0	55968
1985	369	77	63	55338	0	55847
1986	218	55183	97	870	0	56368
1987	55690	604	60	625	0	56979
1988	691	55490	77	339	0	56597
1989	55701	740	69	318	0	56828
1990	826	291	54867	157	0	56141
1991	418	186	615	55588	0	56807
1992	56899	115	241	791	0	58046
1993	843	84	207	56975	0	58109
1994	405	72	160	56567	0	57204
1995	276	54687	120	887	0	55970
1996	56073	638	113	513	0	57337
1997	715	57972	125	348	0	59160
1998	362	818	111	59132	0	60423
1999	293	341	58005	768	0	59407
2000	53806	206	725	515	0	55252
2001	848	164	56908	303	0	58223
2002	54367	125	841	379	0	55712
2003	933	57217	329	251	0	58730
2004	507	805	188	55864	0	57364
2005	282	57277	153	798	0	58510
2006	58138	917	126	458	0	59639
2007	1002	348	103	58451	0	59904
2008	453	234	105	59599	0	60391
2009	355	202	57315	1109	0	58981
2010	55236	140	794	644	0	56814
2011	1004	126	272	58831	0	60233
2012	416	131	57501	1023	0	59071
2013	320	57138	911	429	0	58798
2014	335	807	317	58042	0	59501
2015	58232	308	264	1129	0	59933
2016	988	225	196	58618	0	60027
2017	423	215	58606	1056	0	60300
2018	61096	119	865	599	0	62679
2019	1286	123	304	61932	0	63645
2020	455	156	66311	1307	0	68229
2021	467	122	1330	67333	0	69252
2022	423	120	410	67769	0	68722
2023	252	68224	370	1697	0	70543
2024	67980	1327	210	890	0	70407
2025	1415	68650	167	558	0	70790
2026	69072	1567	134	513	0	71286
2027	1737	525	155	67770	0	70187
2028	666	68553	157	1422	0	70798
2029	587	1441	133	68877	0	71038
2030	348	516	67236	1739	0	69839
2031	65038	376	1357	773	0	67544
2032	1597	252	435	66251	0	68535
2033	691	182	337	66217	0	67427
2034	628	144	225	66928	0	67925
2035	332	196	64420	2141	0	67089
2036	329	203	63656	966	0	65154
2037	277	64214	1665	683	0	66839
2038	371	1459	652	62867	0	65349
2039	62631	457	432	1653	0	65173
2040	1416	63124	280	650	0	65470
2041	707	1499	188	65091	0	67485
2042	65357	483	191	1811	0	67842
2043	65682	366	191	835	0	67074
2044	1817	65015	170	572	0	67574
2045	68689	1492	173	599	0	70953
2046	74024	476	153	515	0	75168
2047	2511	451	147	75673	0	78782
2048	908	75142	217	2223	0	78490
2049	879	1942	196	77526	0	80543
2050	76750	658	167	2691	0	80266
2051	2304	512	76478	1043	0	80337
2052	1076	370	2004	76536	0	79986
2053	971	324	603	78416	0	80314
2054	570	362	76194	3000	0	80126
2055	678	390	2130	76957	0	80155
2056	76278	325	740	3087	0	80430
2057	72104	308	639	1676	0	74727
2058	2786	259	469	75763	0	79277
2059	1163	242	74251	2847	0	78503
2060	837	282	72535	1426	0	75080
2061	674	71432	2564	1152	0	75822
2062	607	74841	1034	943	0	77425
2063	978	2313	730	72042	0	76063
2064	71106	835	513	2545	0	74999
2065	2073	71339	475	1140	0	75027
2066	70588	2153	502	1006	0	74249
2067	2478	859	485	70163	0	73985
2068	1051	730	338	71110	0	73229
2069	68117	547	286	2988	0	71938
2070	2305	68506	299	1348	0	72458
2071	69122	2115	247	1115	0	72599
2072	2567	899	66663	745	0	70874
2073	1127	671	65819	692	0	68309
2074	1069	711	2332	64513	0	68625
2075	711	459	65077	2394	0	68641
2076	754	426	64474	980	0	66634
2077	825	604	2397	61291	0	65117
2078	636	383	62997	2279	0	66295
2079	657	280	2496	61478	0	64911
2080	572	294	1110	62429	0	64405
2081	414	306	62458	2867	0	66045
2082	573	274	2322	61563	0	64732
2083	566	296	1049	61268	0	63179
2084	438	60296	846	2915	0	64495
2085	60459	1888	703	1585	0	64635
2086	2069	694	60164	1298	0	64225
2087	948	580	2125	60131	0	63784
2088	769	376	1045	61881	0	64071
2089	519	423	59520	3008	0	63470
2090	56755	417	2134	1743	0	61049
2091	2039	58938	1002	1271	0	63250
2092	978	1992	757	59327	0	63054
2093	786	859	635	60199	0	62479
2094	540	59250	650	2977	0	63417
2095	618	1972	58910	1660	0	63160
2096	554	59790	2148	1223	0	63715
2097	57463	2348	980	1143	0	61934
2098	2043	987	56818	903	0	60751
2099	946	879	2024	56640	0	60489
2100	750	549	57411	2422	0	61132
2101	637	666	57729	1140	0	60172
2102	560	56779	2496	1036	0	60871
2103	1019	1952	1215	54356	0	58542
2104	54914	764	862	2167	0	58707
2105	55437	574	786	1152	0	57949
2106	2185	54819	728	1080	0	58812
2107	1043	1768	672	55738	0	59221
2108	55058	715	710	2317	0	58800
2109	56426	704	520	1191	0	58841
2110	2333	55387	473	1048	0	59241
2111	56647	1741	516	898	0	59802
2112	2339	752	481	55091	0	58663
2113	1036	55813	506	2140	0	59495
2114	948	1852	507	57289	0	60596
2115	921	1014	462	57787	0	60184
2116	947	1067	464	57650	0	60128
2117	723	537	55246	2658	0	59164
2118	737	497	51091	1278	0	53603
2119	527	51804	1748	1119	0	55198
2120	46238	1396	875	868	0	49377
2121	1249	45470	507	850	0	48076
2122	664	1244	430	45411	0	47749
2123	451	516	46465	1520	0	48952
2124	447	526	1330	45583	0	47886
2125	381	397	670	46802	0	48250
2126	378	441	477	47503	0	48799
2127	46276	381	380	1744	0	48781
2128	1130	385	402	46857	0	48774
2129	436	283	48524	1694	0	50937
2130	46855	251	1339	1014	0	49459
2131	48408	246	594	943	0	50191
2132	49688	231	420	889	0	51228
2133	49864	180	338	807	0	51189
2134	49803	179	364	715	0	51061
2135	1604	48383	400	646	0	51033
2136	911	1031	394	47250	0	49586
2137	799	48024	272	1233	0	50328
2138	48610	1110	220	644	0	50584
2139	48561	427	259	554	0	49801
2140	47374	363	256	527	0	48520
2141	1542	44909	226	476	0	47153
2142	680	44538	231	428	0	45877
2143	574	45388	204	430	0	46596
2144	840	1354	43977	401	0	46572
2145	1174	2454	1114	37330	0	42072
2146	300	34015	226	525	0	35066
2147	43	32466	60	58	0	32627
2148	127	202	102	32289	0	32720
2149	47	48	17	32382	0	32494
2150	33	47	32584	216	0	32880
2151	32470	37	192	164	0	32863
2152	248	23	43	34335	0	34649
2153	83	28	33	34541	0	34685
2154	53	31	34227	265	0	34576
2155	54	48	33122	91	0	33315
2156	42	34980	264	72	0	35358
2157	75	240	90	35540	0	35945
2158	52	58	62	35983	0	36155
2159	40	56	35133	291	0	35520
2160	33438	38	263	154	0	33893
2161	35310	41	68	128	0	35547
2162	327	53	35685	58	0	36123
2163	35715	30	273	146	0	36164
2164	371	47	36414	51	0	36883
2165	36555	45	317	109	0	37026
2166	37334	31	74	137	0	37576
2167	389	43	37674	59	0	38165
2168	211	31	303	37735	0	38280
2169	217	41	85	37217	0	37560
2170	115	35	70	40215	0	40435
2171	39906	32	41	525	0	40504
2172	39883	43	33	248	0	40207
2173	442	55	40334	128	0	40959
2174	163	44	39297	121	0	39625
2175	41615	21	453	193	0	42282
2176	42627	35	139	153	0	42954
2177	503	40	41860	76	0	42479
2178	173	54	41413	76	0	41716
2179	212	47	456	42313	0	43028
2180	99	54	43307	437	0	43897
2181	159	38	498	41948	0	42643
2182	43928	24	141	601	0	44694
2183	562	34	46152	159	0	46907
2184	45348	16	622	234	0	46220
2185	703	23	51014	106	0	51846
2186	338	21	774	50721	0	51854
2187	266	27	227	53414	0	53934
2188	223	29	172	53682	0	54106
2189	138	53963	143	987	0	55231
2190	433	786	110	51025	0	52354
2191	266	151	89	55085	0	55591
2192	54154	91	92	1104	0	55441
2193	907	89	53510	306	0	54812
2194	51541	43	843	344	0	52771
2195	965	71	53095	173	0	54304
2196	49626	51	886	312	0	50875
2197	957	52664	262	151	0	54034
2198	319	717	52762	106	0	53904
2199	235	200	52217	96	0	52748
2200	428	325	1015	47673	0	49441
2201	233	88	283	52096	0	52700
2202	132	50	52485	901	0	53568
2203	130	67	52631	288	0	53116
2204	162	74	56881	196	0	57313
2205	58828	46	1042	399	0	60315
2206	60060	37	388	292	0	60777
2207	60324	36	212	201	0	60773
2208	1058	24	197	58927	0	60206
2209	430	22	165	59645	0	60262
2210	225	48	62002	973	0	63248
2211	267	49	824	60484	0	61624
2212	378	63	284	58030	0	58755
2213	62015	28	199	1158	0	63400
2214	62091	48	151	475	0	62765
2215	63302	42	140	391	0	63875
2216	1121	25	156	62884	0	64186
2217	473	26	164	63187	0	63850
2218	336	32	163	63289	0	63820
2219	62656	35	146	1179	0	64016
2220	967	57	162	61359	0	62545
2221	346	61770	202	871	0	63189
2222	336	755	170	61335	0	62596
2223	214	60777	188	892	0	62071
2224	61375	797	220	435	0	62827
2225	60406	193	195	397	0	61191
2226	939	60403	195	300	0	61837
2227	354	62315	229	249	0	63147
2228	325	921	214	61955	0	63415
2229	228	266	60409	951	0	61854
2230	312	172	864	58702	0	60050
2231	254	134	60660	1035	0	62083
2232	228	60708	932	476	0	62344
2233	274	805	326	61816	0	63221
2234	283	209	251	62850	0	63593
2235	259	167	65028	1136	0	66590
2236	342	116	966	64700	0	66124
2237	279	121	66636	1175	0	68211
2238	66093	100	1012	568	0	67773
2239	68256	93	342	471	0	69162
2240	68992	90	255	464	0	69801
2241	1287	94	242	67829	0	69452
2242	554	87	208	68637	0	69486
2243	364	94	69364	1302	0	71124
2244	432	352	1014	67476	0	69274
2245	298	68012	388	1193	0	69891
2246	326	845	69191	501	0	70863
2247	335	286	67690	403	0	68714
2248	524	417	1094	63682	0	65717
2249	285	174	69318	1102	0	70879
2250	310	194	67852	515	0	68871
2251	65901	159	1126	602	0	67788
2252	931	74040	429	418	0	75818
2253	77404	821	325	680	0	79230
2254	77941	232	262	549	0	78984
2255	79097	196	245	468	0	80006
2256	1227	149	238	78257	0	79871
2257	562	131	243	79687	0	80623
2258	368	155	79221	1202	0	80946
2259	434	130	894	77772	0	79230
2260	261	79228	435	1112	0	81036
2261	80646	748	340	609	0	82343
2262	941	79580	324	365	0	81210
2263	395	80872	272	358	0	81897
2264	382	932	264	81407	0	82985
2265	347	318	82347	969	0	83981
2266	450	264	856	81006	0	82576
2267	272	185	81919	1051	0	83427
2268	272	80758	938	476	0	82444
2269	81583	751	466	564	0	83364
2270	82173	220	288	533	0	83214
2271	84107	144	241	590	0	85082
2272	1057	180	87624	313	0	89174
2273	557	232	81164	324	0	82277
2274	88179	127	909	560	0	89775
2275	90990	122	381	496	0	91989
2276	91858	103	253	438	0	92652
2277	1062	100	180	90813	0	92155
2278	516	125	154	92323	0	93118
2279	92090	84	176	1150	0	93500
2280	90828	91	211	614	0	91744
2281	1009	135	92733	348	0	94225
2282	554	179	87685	294	0	88712
2283	89130	91	617	477	0	90315
2284	643	110	90990	221	0	91964
2285	87084	38	475	382	0	87979
2286	456	85	88377	106	0	89024
2287	230	238	298	86400	0	87166
2288	129	59	91824	224	0	92236
2289	223	69	224	91547	0	92063
2290	140	36	79	93273	0	93528
2291	59	94025	124	287	0	94495
2292	97071	184	54	490	0	97799
2293	253	101	98090	53	0	98497
2294	94370	42	227	335	0	94974
2295	235	99443	132	82	0	99892
2296	104731	203	59	402	0	105395
2297	359	68	39	104623	0	105089
2298	196	33	39	105248	0	105516
2299	74	107911	97	447	0	108529
2300	145	327	34	112572	0	113078
2301	150	113	33	113126	0	113422
2302	152	59	38	114449	0	114698
2303	111964	34	26	1009	0	113033
2304	106716	42	39	559	0	107356
2305	766	98	104998	153	0	106015
2306	276	106226	565	161	0	107228
2307	215	501	185	109882	0	110783
2308	211	177	92	112907	0	113387
2309	140	136	113248	865	0	114389
2310	279	70	729	109424	0	110502
2311	112328	52	246	1191	0	113817
2312	113243	37	118	674	0	114072
2313	114930	34	80	569	0	115613
2314	1266	35	76	116093	0	117470
2315	121472	28	65	1664	0	123229
2316	121838	21	71	875	0	122805
2317	124147	33	69	646	0	124895
2318	1398	40	46	123763	0	125247
2319	651	33	51	124741	0	125476
2320	453	34	49	125537	0	126073
2321	478	52	70	121919	0	122519
2322	460	43	45	122598	0	123146
2323	252	94	121565	1332	0	123243
2324	264	108	118688	516	0	119576
2325	248	118604	1101	379	0	120332
2326	324	822	288	123042	0	124476
2327	336	220	138	124256	0	124950
2328	332	107	92	124780	0	125311
2329	428	148	123072	1402	0	125050
2330	415	79	934	121210	0	122638
2331	203	125	123394	1262	0	124984
2332	359	85	984	121586	0	123014
2333	169	126	127419	1241	0	128955
2334	127	125909	1068	1183	0	128287
2335	267	1055	339	126816	0	128477
2336	173	314	124549	1196	0	126232
2337	111410	183	1107	1131	0	113831
2338	1014	124011	454	417	0	125896
2339	494	998	209	127487	0	129188
2340	176	126252	235	1269	0	127932
2341	433	1087	153	126243	0	127916
2342	128625	305	144	1757	0	130831
2343	1281	191	122	127623	0	129217
2344	353	126611	188	1357	0	128509
2345	128068	1043	126	983	0	130220
2346	1320	324	115	131021	0	132780
2347	580	339	102	132904	0	133925
2348	134066	129	123	2443	0	136761
2349	1861	142	132	143880	0	146015
2350	1120	141	113	174461	0	175835
2351	475	222	177787	4492	0	182976
2352	414	268	174572	1528	0	176782
2353	921	150	5107	174969	0	181147
2354	340	212	177705	4594	0	182851
2355	375	264	173740	1707	0	176086
2356	166372	101	5681	1913	0	174067
2357	4508	217	177930	744	0	183399
2358	1403	175861	5308	806	0	183378
2359	1871	4130	1831	177013	0	184845
2360	181902	1210	1403	5255	0	189770
2361	185703	859	816	2309	0	189687
2362	184995	354	746	2150	0	188245
2363	6490	181430	901	1073	0	189894
2364	3316	4498	747	181672	0	190233
2365	2298	1398	677	186298	0	190671
2366	174574	1096	829	6902	0	183401
2367	184042	483	723	3419	0	188667
2368	185367	438	667	2443	0	188915
2369	7074	514	181284	1299	0	190171
2370	3104	177073	5110	1421	0	186708
2371	2108	199242	2169	1322	0	204841
2372	2324	6797	1665	191302	0	202088
2373	2294	2833	972	200742	0	206841
2374	1338	2000	198117	8480	0	209935
2375	194466	1041	6657	4727	0	206891
2376	204555	766	2663	3397	0	211381
2377	9589	752	2120	199701	0	212162
2378	5478	714	1026	203911	0	211129
2379	4092	486	826	206938	0	212342
2380	201337	579	738	10809	0	213463
2381	8032	707	193766	5042	0	207547
2382	3728	923	197013	3565	0	205229
2383	3466	888	8253	193900	0	206507
2384	1697	814	195715	8251	0	206477
2385	190455	470	8313	4571	0	203809
2386	195191	373	3715	3652	0	202931
2387	199423	338	2831	2563	0	205155
2388	10849	186698	1848	1965	0	201360
2389	190864	6204	1448	2381	0	200897
2390	9907	2738	1185	186327	0	200157
2391	4965	2073	1152	189347	0	197537
2392	4294	937	1197	193015	0	199443
2393	2321	858	182798	11338	0	197315
2394	2674	972	7380	180151	0	191177
2395	2161	180413	3509	9557	0	195640
2396	175970	6065	2914	5419	0	190368
2397	7380	180339	1913	4491	0	194123
2398	3990	7763	177206	3033	0	191992
2399	3745	177512	7215	2680	0	191152
2400	171612	8165	3807	2738	0	186322
2401	7608	173137	3265	2360	0	186370
2402	4453	8077	2175	159433	0	174138
2403	3227	172140	2224	7221	0	184812
2404	171537	7966	1970	4346	0	185819
2405	175934	3499	1904	3630	0	184967
2406	166906	2866	1816	3151	0	174739
2407	10809	2309	168463	2243	0	183824
2408	6017	1986	168127	2090	0	178220
2409	4597	1970	166984	2194	0	175745
2410	165142	1684	10142	2516	0	179484
2411	8952	1921	5150	162376	0	178399
2412	5043	1575	3644	167279	0	177541
2413	4028	1820	160408	9159	0	175415
2414	3250	1946	7052	162118	0	174366
2415	152944	1805	3452	9618	0	167819
2416	8193	153557	2831	4967	0	169548
2417	157700	6645	2186	4190	0	170721
2418	9751	3555	153511	2641	0	169458
2419	156943	2901	7296	2541	0	169681
2420	162100	2100	3860	2386	0	170446
2421	162878	1991	3387	2501	0	170757
2422	11535	1871	152737	2418	0	168561
2423	7174	1524	7131	153720	0	169549
2424	5571	1271	154690	7633	0	169165
2425	4533	1251	8428	155393	0	169605
2426	3811	1393	155944	8870	0	170018
2427	3671	1403	8750	154984	0	168808
2428	3267	1353	4480	161417	0	170517
2429	155775	1146	3549	10287	0	170757
2430	158590	976	2589	6337	0	168492
2431	161887	836	2362	4874	0	169959
2432	11737	871	2512	152055	0	167175
2433	6633	138541	2472	8190	0	155836
2434	5088	151041	2175	4942	0	163246
2435	150189	7406	2035	4333	0	163963
2436	8810	4015	146660	3037	0	162522
2437	149398	2733	7253	3066	0	162450
2438	9677	1787	146013	2809	0	160286
2439	150779	1606	8081	2746	0	163212
2440	143724	1424	4001	3336	0	152485
2441	10473	1222	148159	2638	0	162492
2442	152422	994	7266	3167	0	163849
2443	155110	1177	4030	2843	0	163160
2444	154889	1255	3418	2759	0	162321
2445	11732	147103	2350	2824	0	164009
2446	7166	8142	2774	144794	0	162876
2447	5330	3055	145078	7117	0	160580
2448	4513	2491	145834	4019	0	156857
2449	3933	132873	7728	3311	0	147845
2450	2473	104181	3452	1543	0	111649
2451	3362	3597	3293	94224	0	104476
2452	92379	1838	1592	3395	0	99204
2453	3700	93057	1145	2060	0	99962
2454	2920	3086	1011	92291	0	99308
2455	2433	93323	830	3148	0	99734
2456	93930	3306	777	2105	0	100118
2457	3857	2011	836	92063	0	98767
2458	2455	1618	89994	3199	0	97266
2459	2200	87022	2722	2047	0	93991
2460	1481	88721	1914	1687	0	93803
2461	1748	3454	1552	83048	0	89802
2462	1449	87110	1109	2411	0	92079
2463	1529	3516	1021	86223	0	92289
2464	86255	2076	778	3330	0	92439
2465	87249	1719	752	1972	0	91692
2466	90824	1199	695	1649	0	94367
2467	91546	1041	754	1275	0	94616
2468	4840	1024	88003	996	0	94863
2469	3137	84816	2357	925	0	91235
2470	2356	85852	1437	961	0	90606
2471	830	72919	473	387	0	74609
2472	711	70664	417	324	0	72116
2473	69170	1519	1198	430	0	72317
2474	68709	454	287	292	0	69742
2475	70397	216	111	289	0	71013
2476	70743	150	72	250	0	71215
2477	1369	191	69083	72	0	70715
2478	73550	105	873	313	0	74841
2479	75573	100	378	231	0	76282
2480	76542	105	165	199	0	77011
2481	1446	111	93	75428	0	77078
2482	727	123	94	75822	0	76766
2483	76413	110	143	1283	0	77949
2484	1136	125	66	75476	0	76803
2485	543	74231	97	1011	0	75882
2486	421	889	63	76596	0	77969
2487	364	381	59	76625	0	77429
2488	268	76558	98	1231	0	78155
2489	394	877	73	77787	0	79131
2490	395	399	83	78149	0	79026
2491	77147	192	87	1374	0	78800
2492	1042	221	73922	555	0	75740
2493	73694	139	844	418	0	75095
2494	1120	172	74308	222	0	75822
2495	636	203	71299	205	0	72343
2496	467	194	73302	180	0	74143
2497	73936	124	1269	278	0	75607
2498	1055	163	78072	167	0	79457
2499	77216	177	1098	370	0	78861
2500	79225	95	458	382	0	80160
2501	80062	104	238	338	0	80742
2502	1363	79006	180	166	0	80715
2503	80341	885	124	309	0	81659
2504	1065	81004	132	188	0	82389
2505	659	992	100	82464	0	84215
2506	456	458	106	82706	0	83726
2507	322	81120	153	1209	0	82804
2508	296	81810	147	547	0	82800
2509	269	84104	163	313	0	84849
2510	83847	1206	124	329	0	85506
2511	979	85013	146	173	0	86311
2512	86072	1049	134	354	0	87609
2513	1229	564	83977	129	0	85899
2514	84671	300	863	321	0	86155
2515	87169	217	374	309	0	88069
2516	1423	237	84392	136	0	86188
2517	859	174	876	84454	0	86363
2518	454	205	85921	905	0	87485
2519	446	181	982	85539	0	87148
2520	399	177	454	86515	0	87545
2521	87106	163	236	1444	0	88949
2522	86875	175	171	780	0	88001
2523	1388	85635	173	334	0	87530
2524	87858	957	123	423	0	89361
2525	1304	516	87062	183	0	89065
2526	87506	275	972	386	0	89139
2527	1397	217	91596	174	0	93384
2528	800	249	90511	186	0	91746
2529	94268	163	1546	356	0	96333
2530	97002	127	664	351	0	98144
2531	1791	205	97744	175	0	99915
2532	1108	187	1292	93785	0	96372
2533	642	184	574	99072	0	100472
2534	459	226	97197	1611	0	99493
2535	574	195	1263	95028	0	97060
2536	464	91062	759	1397	0	93682
2537	495	1193	336	99866	0	101890
2538	535	578	261	99739	0	101113
2539	501	383	96897	1641	0	99422
2540	91103	224	1286	1005	0	93618
2541	97397	192	562	630	0	98781
2542	96953	151	366	512	0	97982
2543	96178	110	302	508	0	97098
2544	2079	93401	329	317	0	96126
2545	1198	1172	271	92301	0	94942
2546	788	546	91077	1299	0	93710
2547	608	325	89914	718	0	91565
2548	684	400	1531	88719	0	91334
2549	425	217	91146	1423	0	93211
2550	88517	168	1325	899	0	90909
2551	1367	159	635	91922	0	94083
2552	782	150	387	92379	0	93698
2553	518	165	264	93062	0	94009
2554	91079	158	271	2052	0	93560
2555	1233	90879	325	945	0	93382
2556	91799	1041	261	774	0	93875
2557	91914	434	268	647	0	93263
2558	1742	88599	343	364	0	91048
2559	867	90371	341	289	0	91868
2560	92158	1339	396	442	0	94335
2561	1507	572	367	91794	0	94240
2562	903	289	366	91269	0	92827
2563	94050	182	333	1690	0	96255
2564	1574	214	92289	658	0	94735
2565	91413	163	1332	671	0	93579
2566	94057	146	634	599	0	95436
2567	1994	94968	355	392	0	97709
2568	100561	1195	296	546	0	102598
2569	99721	549	243	691	0	101204
2570	2160	107914	217	379	0	110670
2571	802	111935	195	277	0	113209
2572	993	2317	280	109429	0	113019
2573	111009	974	166	2039	0	114188
2574	1928	113296	141	850	0	116215
2575	1131	2073	94	115406	0	118704
2576	116314	810	106	2437	0	119667
2577	2398	472	113983	889	0	117742
2578	1394	274	2008	112776	0	116452
2579	687	260	114357	2286	0	117590
2580	110799	173	2359	1178	0	114509
2581	115819	179	938	879	0	117815
2582	3042	228	114034	400	0	117704
2583	1333	112209	2335	384	0	116261
2584	1140	2093	976	114123	0	118332
2585	580	859	115092	2243	0	118774
2586	802	529	2414	113356	0	117101
2587	882	316	1021	116744	0	118963
2588	488	293	115139	3267	0	119187
2589	110762	212	2520	1752	0	115246
2590	116488	205	1029	1168	0	118890
2591	3360	279	115469	607	0	119715
2592	1462	115273	2618	590	0	119943
2593	1178	2438	1107	112545	0	117268
2594	660	113267	744	2398	0	117069
2595	559	116558	520	1114	0	118751
2596	115594	3173	479	1017	0	120263
2597	2833	1294	374	115840	0	120341
2598	1473	736	355	115458	0	118022
2599	825	558	114120	3287	0	118790
2600	752	444	112781	1531	0	115508
2601	897	344	3235	112453	0	116929
2602	874	334	1350	115389	0	117947
2603	598	453	113189	3508	0	117748
2604	574	499	113194	1580	0	115847
2605	786	440	3453	112197	0	116876
2606	112697	407	1534	3416	0	118054
2607	2712	113481	1041	1609	0	118843
2608	113433	2753	709	1341	0	118236
2609	3178	112227	574	964	0	116943
2610	1551	115591	562	797	0	118501
2611	113059	3486	602	950	0	118097
2612	3179	1574	112984	752	0	118489
2613	1671	872	2937	113014	0	118494
2614	1327	686	1346	115720	0	119079
2615	1116	536	912	123007	0	125571
2616	836	568	121172	4354	0	126930
2617	959	584	3286	121896	0	126725
2618	123467	492	1519	4324	0	129802
2619	3647	525	1117	126591	0	131880
2620	1814	442	817	132372	0	135445
2621	130082	448	707	5345	0	136582
2622	130478	474	674	2776	0	134402
2623	4639	127559	757	1693	0	134648
2624	2167	3334	129355	1231	0	136087
2625	1463	1356	127821	1057	0	131697
2626	1167	890	128782	1020	0	131859
2627	946	122354	4778	1029	0	129107
2628	1412	3398	2401	119231	0	126442
2629	973	1363	1226	123007	0	126569
2630	120410	933	919	4739	0	127001
2631	3768	710	814	119210	0	124502
2632	1611	655	117816	4395	0	124477
2633	1334	538	3558	118934	0	124364
2634	1103	563	1629	121019	0	124314
2635	795	598	117485	5131	0	124009
2636	822	115431	3749	2646	0	122648
2637	1119	3252	1742	108990	0	115103
2638	846	115154	1383	3754	0	121137
2639	821	3638	115160	1952	0	121571
2640	114102	1486	3877	1701	0	121166
2641	117003	1084	1815	1459	0	121361
2642	118528	822	1321	1369	0	122040
2643	5079	846	1029	113138	0	120092
2644	2228	115168	1009	3932	0	122337
2645	114825	3499	934	2243	0	121501
2646	117890	1459	1010	1727	0	122086
2647	117230	979	995	1599	0	120803
2648	5022	788	112711	1529	0	120050
2649	111060	583	3627	1558	0	116828
2650	4382	111821	1743	1323	0	119269
2651	110957	3383	1307	1390	0	117037
2652	4166	112134	1100	1276	0	118676
2653	113242	3808	964	1426	0	119440
2654	4417	1673	111964	1221	0	119275
2655	112054	1134	3764	1245	0	118197
2656	115745	860	1546	1218	0	119369
2657	98484	987	1309	1792	0	102572
2658	116621	834	928	1086	0	119469
2659	5428	840	110948	979	0	118195
2660	2939	808	3553	110837	0	118137
2661	110880	702	1635	3957	0	117174
2662	4331	109390	1219	2014	0	116954
2663	2302	3367	1095	108497	0	115261
2664	1733	1343	106760	3901	0	113737
2665	1786	1896	3523	106527	0	113732
2666	1575	782	106847	4128	0	113332
2667	1261	101730	3785	2254	0	109030
2668	1162	96801	1724	1611	0	101298
2669	1252	97796	1112	1340	0	101500
2670	1599	3703	1020	85309	0	91631
2671	1223	1212	598	85313	0	88346
2672	933	682	82484	2865	0	86964
2673	787	79462	2115	1206	0	83570
2674	74960	2008	898	902	0	78768
2675	2014	72263	631	628	0	75536
2676	823	73339	518	542	0	75222
2677	1565	2278	644	69929	0	74416
2678	69534	802	527	2019	0	72882
2679	70531	584	411	942	0	72468
2680	2276	444	408	69412	0	72540
2681	69051	372	375	2128	0	71926
2682	2138	377	353	68938	0	71806
2683	878	429	67611	2116	0	71034
2684	67990	392	1708	1044	0	71134
2685	2094	459	696	67938	0	71187
2686	783	388	66219	1892	0	69282
2687	600	453	65372	824	0	67249
2688	648	497	1876	65574	0	68595
2689	66543	395	797	1880	0	69615
2690	66735	373	494	861	0	68463
2691	2025	66175	429	607	0	69236
2692	68103	1561	383	692	0	70739
2693	68465	623	340	568	0	69996
2694	69146	430	328	558	0	70462
2695	2232	68348	318	510	0	71408
2696	69278	1500	296	556	0	71630
2697	70736	585	291	496	0	72108
2698	2310	442	271	69188	0	72211
2699	67599	292	280	1637	0	69808
2700	1975	65860	302	645	0	68782
2701	959	67850	313	473	0	69595
2702	874	1638	310	67583	0	70405
2703	789	700	260	68159	0	69908
2704	698	68120	264	1644	0	70726
2705	67911	1447	242	693	0	70293
2706	1745	66324	217	430	0	68716
2707	65621	1372	224	386	0	67603
2708	1792	65890	226	312	0	68220
2709	953	1445	200	64225	0	66823
2710	787	66863	160	1249	0	69059
2711	66964	1600	956	580	0	70100
2712	67087	629	484	571	0	68771
2713	66414	536	516	531	0	67997
2714	2014	366	62734	324	0	65438
2715	838	301	58214	229	0	59582
2716	485	57576	1043	235	0	59339
2717	533	985	56132	202	0	57852
2718	420	549	53508	338	0	54815
2719	479	1202	980	46996	0	49657
2720	134	123	49177	539	0	49973
2721	98	48843	546	184	0	49671
2722	48629	484	149	227	0	49489
2723	500	47687	118	88	0	48393
2724	173	48543	69	81	0	48866
2725	49052	587	82	176	0	49897
2726	49587	212	50	179	0	50028
2727	562	49858	67	138	0	50625
2728	50699	502	79	175	0	51455
2729	50776	140	68	138	0	51122
2730	50820	118	56	132	0	51126
2731	685	113	48732	68	0	49598
2732	269	118	47696	78	0	48161
2733	236	123	530	49455	0	50344
2734	193	99	181	49705	0	50178
2735	51047	91	97	664	0	51899
2736	537	49906	67	210	0	50720
2737	232	560	54	51642	0	52488
2738	178	186	54	52503	0	52921
2739	178	118	47	52963	0	53306
2740	195	74	48	52967	0	53284
2741	125	106	52984	743	0	53958
2742	134	110	52189	256	0	52689
2743	209	90	663	53837	0	54799
2744	136	81	54708	640	0	55565
2745	53758	72	725	298	0	54853
2746	772	73	210	55935	0	56990
2747	252	84	55957	711	0	57004
2748	52823	62	688	367	0	53940
2749	735	55311	223	165	0	56434
2750	55681	621	143	184	0	56629
2751	742	57306	115	112	0	58275
2752	317	682	102	57327	0	58428
2753	194	214	57659	654	0	58721
2754	234	239	679	55745	0	56897
2755	140	103	55973	738	0	56954
2756	55349	97	708	311	0	56465
2757	749	87	201	57539	0	58576
2758	58037	84	138	804	0	59063
2759	795	105	57222	214	0	58336
2760	58539	86	633	298	0	59556
2761	62864	60	220	246	0	63390
2762	1027	88	63478	88	0	64681
2763	505	188	769	62897	0	64359
2764	246	94	64792	768	0	65900
2765	166	64485	829	252	0	65732
2766	64527	873	443	413	0	66256
2767	64599	193	209	263	0	65264
2768	960	123	64404	99	0	65586
2769	382	112	63332	99	0	63925
2770	367	87	912	63525	0	64891
2771	250	65	312	65432	0	66059
2772	65870	59	185	1011	0	67125
2773	798	65688	186	305	0	66977
2774	67417	713	123	341	0	68594
2775	67836	178	127	287	0	68428
2776	990	136	66174	103	0	67403
2777	64856	87	776	249	0	65968
2778	923	89	66744	112	0	67868
2779	468	81	825	67668	0	69042
2780	274	104	70509	752	0	71639
2781	375	71	840	69547	0	70833
2782	205	88	70732	798	0	71823
2783	68730	89	879	404	0	70102
2784	70590	55	304	311	0	71260
2785	987	67	223	70069	0	71346
2786	71574	44	183	951	0	72752
2787	976	64	173	72611	0	73824
2788	344	72956	206	862	0	74368
2789	73964	641	161	480	0	75246
2790	825	73092	213	292	0	74422
2791	419	786	161	74234	0	75600
2792	364	195	132	73442	0	74133
2793	289	142	139	72681	0	73251
2794	321	89	145	71802	0	72357
2795	227	132	69721	1016	0	71096
2796	64718	97	714	590	0	66119
2797	69233	77	218	404	0	69932
2798	927	68816	186	261	0	70190
2799	403	688	134	69954	0	71179
2800	364	180	138	70523	0	71205
2801	229	178	68247	951	0	69605
2802	66487	87	747	518	0	67839
2803	892	98	267	68921	0	70178
2804	337	98	68105	838	0	69378
2805	67891	79	755	526	0	69251
2806	70165	60	300	406	0	70931
2807	70220	62	215	405	0	70902
2808	1029	65	68579	233	0	69906
2809	473	107	64903	203	0	65686
2810	66089	107	836	278	0	67310
2811	863	120	345	67578	0	68906
2812	422	91	222	68959	0	69694
2813	306	86	68410	759	0	69561
2814	66428	53	644	449	0	67574
2815	789	71	241	69794	0	70895
2816	71759	54	190	1012	0	73015
2817	72261	50	167	520	0	72998
2818	72326	46	143	436	0	72951
2819	1054	76	73302	236	0	74668
2820	480	83	763	73542	0	74868
2821	74527	45	287	1047	0	75906
2822	936	75623	219	381	0	77159
2823	481	772	145	77955	0	79353
2824	418	229	130	78461	0	79238
2825	77626	109	124	1312	0	79171
2826	77351	67	149	622	0	78189
2827	1258	66	150	76732	0	78206
2828	556	103	75803	979	0	77441
2829	74751	68	881	596	0	76296
2830	1135	104	77303	273	0	78815
2831	78165	53	980	452	0	79650
2832	80145	50	372	442	0	81009
2833	1379	94	78977	235	0	80685
2834	736	197	994	79350	0	81277
2835	401	95	83626	1150	0	85272
2836	366	86870	1237	449	0	88922
2837	520	1412	427	85158	0	87517
2838	298	87888	294	1357	0	89837
2839	451	1455	239	90001	0	92146
2840	295	426	91138	1560	0	93419
2841	246	89496	1587	581	0	91910
2842	229	93625	510	365	0	94729
2843	648	2202	342	93598	0	96790
2844	94137	599	192	1900	0	96828
2845	1904	286	148	101606	0	103944
2846	103268	146	157	2502	0	106073
2847	2323	104706	152	735	0	107916
2848	115308	2244	134	618	0	118304
2849	2949	730	118074	296	0	122049
2850	1290	341	2602	116928	0	121161
2851	975	217	741	117487	0	119420
2852	473	247	116647	3392	0	120759
2853	112182	236	2739	1421	0	116578
2854	116883	186	1115	990	0	119174
2855	3429	114791	560	509	0	119289
2856	1692	3000	376	109737	0	114805
2857	777	114007	377	2542	0	117703
2858	595	2887	113322	914	0	117718
2859	551	1015	114621	698	0	116885
2860	917	1326	3410	110949	0	116602
2861	110488	379	1150	3024	0	115041
2862	2707	108195	647	1023	0	112572
2863	109372	2657	405	800	0	113234
2864	3106	932	106608	450	0	111096
2865	107610	584	2669	607	0	111470
2866	111651	429	898	625	0	113603
2867	3646	406	109050	384	0	113486
2868	1685	360	2859	107530	0	112434
2869	110138	289	992	2965	0	114384
2870	111189	291	707	1183	0	113370
2871	111693	272	470	864	0	113299
2872	4164	280	440	108332	0	113216
2873	1678	320	106716	2859	0	111573
2874	106527	217	2811	1231	0	110786
2875	3504	337	108355	661	0	112857
2876	1748	257	2991	107025	0	112021
2877	1392	282	1096	108305	0	111075
2878	923	107965	791	3382	0	113061
2879	850	2690	107455	1292	0	112287
2880	797	102706	2995	970	0	107468
2881	766	106658	1190	820	0	109434
2882	985	3278	817	105709	0	110789
2883	742	1261	105242	3142	0	110387
2884	1011	776	2982	105243	0	110012
2885	739	629	105795	3482	0	110645
2886	965	587	3200	104607	0	109359
2887	950	585	1268	105623	0	108426
2888	750	660	100471	3986	0	105867
2889	907	567	3268	100436	0	105178
2890	704	523	101217	3811	0	106255
2891	736	522	100893	1715	0	103866
2892	730	99456	3862	1371	0	105419
2893	100729	2909	1698	1269	0	106605
2894	3388	1101	100661	984	0	106134
2895	98897	813	3437	1139	0	104286
2896	3717	660	1562	101243	0	107182
2897	1509	698	100478	3523	0	106208
2898	1027	99676	3579	1679	0	105961
2899	1069	3124	1721	100569	0	106483
2900	918	1273	100757	3594	0	106542
2901	1154	926	3592	96714	0	102386
2902	976	99847	1591	3469	0	105883
2903	101179	3169	1213	1642	0	107203
2904	3702	1346	1028	101350	0	107426
2905	99330	945	1032	3828	0	105135
2906	101530	798	1018	1936	0	105282
2907	102022	633	981	1644	0	105280
2908	102940	637	1055	1464	0	106096
2909	101507	615	972	1348	0	104442
2910	4675	96847	927	1332	0	103781
2911	2502	3008	895	98237	0	104642
2912	1996	1234	859	100047	0	104136
2913	1785	811	941	100256	0	103793
2914	1652	718	95263	4475	0	102108
2915	1474	94774	3360	2164	0	101772
2916	97159	3064	1540	1666	0	103429
2917	98442	1162	1342	1562	0	102508
2918	4487	94378	1179	1506	0	101550
2919	2063	97460	1155	1477	0	102155
2920	95749	4011	1222	1489	0	102471
2921	4073	1794	93163	1185	0	100215
2922	2134	1686	3675	90845	0	98340
2923	91330	982	1890	3752	0	97954
2924	4084	846	1312	88949	0	95191
2925	1822	89050	1136	3872	0	95880
2926	1729	3186	1029	90789	0	96733
2927	1352	1386	90126	3983	0	96847
2928	88495	1005	3646	2051	0	95197
2929	93028	719	1651	1650	0	97048
2930	4617	716	1281	88866	0	95480
2931	2663	647	1049	90698	0	95057
2932	86753	682	1029	4378	0	92842
2933	4052	85165	1001	2188	0	92406
2934	2225	2825	954	84551	0	90555
2935	2064	1114	871	85144	0	89193
2936	78056	657	718	3983	0	83414
2937	3240	77358	796	2049	0	83443
2938	76185	2455	645	1646	0	80931
2939	3527	73632	588	1198	0	78945
2940	1574	75518	607	1154	0	78853
2941	73100	2783	837	1091	0	77811
2942	2877	72870	646	1083	0	77476
2943	1692	4113	1399	69023	0	76227
2944	1290	1090	69272	2761	0	74413
2945	860	705	60417	1114	0	63096
2946	549	590	58471	901	0	60511
2947	516	57115	2299	632	0	60562
2948	46326	1420	1719	355	0	49820
2949	1201	408	409	43714	0	45732
2950	493	291	161	44435	0	45380
2951	316	171	43334	1265	0	45086
2952	43384	136	980	691	0	45191
2953	1108	136	393	44920	0	46557
2954	521	130	275	45519	0	46445
2955	420	114	154	45468	0	46156
2956	43828	121	115	1634	0	45698
2957	1121	104	42665	726	0	44616
2958	42992	98	974	515	0	44579
2959	1311	135	362	43209	0	45017
2960	548	125	42827	1115	0	44615
2961	42180	128	1001	552	0	43861
2962	1186	144	43225	415	0	44970
2963	610	439	1178	42283	0	44510
2964	444	152	43375	1100	0	45071
2965	306	129	41977	478	0	42890
2966	39949	123	1321	484	0	41877
2967	1040	99	40560	289	0	41988
2968	513	128	1199	39808	0	41648
2969	40039	100	518	1085	0	41742
2970	1113	141	391	40347	0	41992
2971	488	128	39923	1209	0	41748
2972	442	108	40272	544	0	41366
2973	291	40135	1240	441	0	42107
2974	335	993	634	39637	0	41599
2975	38376	357	439	1114	0	40286
2976	956	37942	251	531	0	39680
2977	38323	915	238	483	0	39959
2978	1164	383	225	37813	0	39585
2979	37696	285	209	1100	0	39290
2980	1182	37034	215	516	0	38947
2981	566	867	203	37544	0	39180
2982	37506	384	182	1099	0	39171
2983	1069	37534	208	545	0	39356
2984	559	956	206	37858	0	39579
2985	479	411	215	38067	0	39172
2986	38130	304	210	1323	0	39967
2987	1094	191	186	38454	0	39925
2988	523	131	251	38865	0	39770
2989	464	133	218	39510	0	40325
2990	319	144	37161	1563	0	39187
2991	36887	107	1025	855	0	38874
2992	1162	125	441	41706	0	43434
2993	559	114	42748	1490	0	44911
2994	42639	102	1384	765	0	44890
2995	1524	116	44237	560	0	46437
2996	715	147	1585	43166	0	45613
2997	500	43834	650	1491	0	46475
2998	422	1271	472	45257	0	47422
2999	345	482	44920	1840	0	47587
3000	349	377	46139	778	0	47643
3001	419	233	1807	46317	0	48776
3002	288	174	46065	1743	0	48270
3003	44572	178	1790	795	0	47335
3004	1567	209	45486	602	0	47864
3005	708	171	1762	44466	0	47107
3006	604	165	711	45734	0	47214
3007	414	184	517	45917	0	47032
3008	44400	137	379	2353	0	47269
3009	45249	111	353	1160	0	46873
3010	46389	138	310	771	0	47608
3011	2222	219	311	44824	0	47576
3012	1040	279	284	45838	0	47441
3013	667	122	43493	2156	0	46438
3014	457	136	44120	1084	0	45797
3015	404	43495	1787	790	0	46476
3016	552	1510	806	39539	0	42407
3017	388	351	418	39082	0	40239
3018	239	39021	258	1440	0	40958
3019	39060	985	231	773	0	41049
3020	1105	39218	254	503	0	41080
3021	39207	1162	296	420	0	41085
3022	1360	446	194	38813	0	40813
3023	39055	231	253	1285	0	40824
3024	1319	168	222	39216	0	40925
3025	507	164	38244	1392	0	40307
3026	421	122	1126	39093	0	40762
3027	38385	137	481	1458	0	40461
3028	1246	123	320	38889	0	40578
3029	545	89	217	39435	0	40286
3030	375	112	38258	1644	0	40389
3031	358	89	1109	39149	0	40705
3032	312	88	452	39100	0	39952
3033	274	37880	310	1613	0	40077
3034	343	946	222	39127	0	40638
3035	338	302	202	40143	0	40985
3036	362	193	154	39808	0	40517
3037	223	37417	216	1717	0	39573
3038	252	964	132	37485	0	38833
3039	35982	288	129	1453	0	37852
3040	1012	34921	153	677	0	36763
3041	335	34359	133	473	0	35300
3042	220	34431	134	391	0	35176
3043	233	1497	212	32353	0	34295
3044	178	31801	274	1028	0	33281
3045	218	33378	292	529	0	34417
3046	32609	984	382	431	0	34406
3047	988	395	31654	361	0	33398
3048	31530	322	910	431	0	33193
3049	1002	250	407	32144	0	33803
3050	347	216	31845	1133	0	33541
3051	31366	172	1129	596	0	33263
3052	906	161	31333	542	0	32942
3053	370	134	31403	473	0	32380
3054	31963	116	1338	455	0	33872
3055	1176	96	721	32636	0	34629
3056	490	90	32907	1301	0	34788
3057	32686	96	1205	776	0	34763
3058	33919	92	457	788	0	35256
3059	1395	115	33421	658	0	35589
3060	34449	89	1070	599	0	36207
3061	35686	83	395	505	0	36669
3062	1589	82	33581	553	0	35805
3063	34076	91	1072	653	0	35892
3064	34869	93	508	613	0	36083
3065	1417	146	32866	508	0	34937
3066	594	205	35789	458	0	37046
3067	493	289	1350	35923	0	38055
3068	328	247	36108	1468	0	38151
3069	36046	302	1264	778	0	38390
3070	1365	333	463	36039	0	38200
3071	715	351	291	36841	0	38198
3072	609	333	35231	1503	0	37676
3073	617	270	1064	35393	0	37344
3074	518	238	35249	1586	0	37591
3075	35756	183	1193	850	0	37982
3076	36958	140	535	739	0	38372
3077	1560	160	35823	640	0	38183
3078	36249	119	1196	673	0	38237
3079	37437	128	507	694	0	38766
3080	1605	149	36232	718	0	38704
3081	37207	109	1248	772	0	39336
3082	37606	145	579	790	0	39120
3083	1482	159	36606	743	0	38990
3084	36753	211	1172	758	0	38894
3085	1379	247	37065	742	0	39433
3086	602	206	1182	37167	0	39157
3087	490	204	479	37906	0	39079
3088	455	260	298	38690	0	39703
3089	399	255	36605	1882	0	39141
3090	35229	238	1068	1001	0	37536
3091	1350	290	35945	695	0	38280
3092	485	30973	820	353	0	32631
3093	324	30958	327	252	0	31861
3094	30046	589	432	221	0	31288
3095	731	263	163	29009	0	30166
3096	292	29211	151	572	0	30226
3097	28620	453	142	223	0	29438
3098	28653	124	134	168	0	29079
3099	638	28771	101	129	0	29639
3100	276	463	107	27234	0	28080
3101	184	27828	102	463	0	28577
3102	28278	480	108	214	0	29080
3103	28697	160	113	158	0	29128
3104	688	94	100	27795	0	28677
3105	27988	73	100	538	0	28699
3106	633	88	90	28015	0	28826
3107	260	86	27692	560	0	28598
3108	27512	66	492	199	0	28269
3109	620	89	27770	136	0	28615
3110	280	107	514	27309	0	28210
3111	27759	55	195	573	0	28582
3112	658	85	120	27807	0	28670
3113	274	54	27596	585	0	28509
3114	211	68	27299	211	0	27789
3115	253	310	620	27142	0	28325
3116	27180	68	338	577	0	28163
3117	595	27316	142	217	0	28270
3118	289	468	111	27642	0	28510
3119	217	123	27804	555	0	28699
3120	27740	63	560	244	0	28607
3121	28949	37	238	162	0	29386
3122	735	41	28233	104	0	29113
3123	28423	35	541	142	0	29141
3124	684	55	226	28965	0	29930
3125	280	32	28742	542	0	29596
3126	28428	40	556	252	0	29276
3127	626	56	230	28332	0	29244
3128	284	40	148	28151	0	28623
3129	28316	28	136	636	0	29116
3130	549	27334	151	227	0	28261
3131	243	28234	107	141	0	28725
3132	28283	507	128	181	0	29099
3133	27893	134	146	140	0	28313
3134	662	62	28010	116	0	28850
3135	282	60	27598	124	0	28064
3136	242	94	557	27787	0	28680
3137	28461	21	245	493	0	29220
3138	28324	34	117	249	0	28724
3139	28814	23	120	161	0	29118
3140	635	27808	103	125	0	28671
3141	277	28535	101	117	0	29030
3142	215	483	109	29292	0	30099
3143	237	144	87	29031	0	29499
3144	235	76	88	30103	0	30502
3145	184	63	30500	610	0	31357
3146	233	77	28567	216	0	29093
3147	30492	42	603	163	0	31300
3148	31726	49	245	144	0	32164
3149	733	48	144	31249	0	32174
3150	341	32	113	31394	0	31880
3151	240	61	94	32158	0	32553
3152	173	64	31123	711	0	32071
3153	163	61	30808	283	0	31315
3154	137	129	536	31027	0	31829
3155	106	56	31300	557	0	32019
3156	91	30050	498	254	0	30893
3157	74	31163	200	176	0	31613
3158	30992	487	158	176	0	31813
3159	476	30613	99	107	0	31295
3160	220	476	90	30922	0	31708
3161	166	167	79	31213	0	31625
3162	111	31998	83	575	0	32767
3163	132	557	80	32704	0	33473
3164	113	176	32082	632	0	33003
3165	95	32157	521	257	0	33030
3166	118	529	134	30707	0	31488
3167	64	114	30679	482	0	31339
3168	56	30173	464	158	0	30851
3169	120	483	150	29550	0	30303
3170	75	30236	119	437	0	30867
3171	122	489	59	30343	0	31013
3172	93	136	63	29826	0	30118
3173	67	29865	69	508	0	30509
3174	29449	455	59	231	0	30194
3175	29106	128	54	198	0	29486
3176	523	28808	73	128	0	29532
3177	198	29737	60	115	0	30110
3178	178	538	48	29498	0	30262
3179	100	217	29327	473	0	30117
3180	28593	138	451	200	0	29382
3181	29190	94	136	192	0	29612
3182	572	83	28793	120	0	29568
3183	28634	80	473	141	0	29328
3184	29498	74	135	136	0	29843
3185	614	83	28540	96	0	29333
3186	28219	70	455	121	0	28865
3187	612	70	29164	110	0	29956
3188	192	29414	522	98	0	30226
3189	29872	483	147	123	0	30625
3190	30128	151	122	141	0	30542
3191	603	146	29764	98	0	30611
3192	30038	91	466	131	0	30726
3193	31019	77	149	176	0	31421
3194	615	103	30234	99	0	31051
3195	31039	79	465	135	0	31718
3196	31855	77	141	144	0	32217
3197	637	81	30973	108	0	31799
3198	31527	72	481	137	0	32217
3199	624	78	179	30837	0	31718
3200	245	101	159	31178	0	31683
3201	211	92	30648	589	0	31540
3202	160	72	30316	255	0	30803
3203	141	114	547	30872	0	31674
3204	167	117	226	31472	0	31982
3205	32227	66	154	592	0	33039
3206	580	88	31638	221	0	32527
3207	32221	80	529	187	0	33017
3208	704	102	178	33097	0	34081
3209	216	88	33478	589	0	34371
3210	35224	72	550	251	0	36097
3211	714	50	195	36769	0	37728
3212	216	76	36851	621	0	37764
3213	36462	72	635	267	0	37436
3214	703	93	233	37024	0	38053
3215	37337	66	181	671	0	38255
3216	724	54	38795	218	0	39791
3217	337	114	614	37208	0	38273
3218	199	39544	233	585	0	40561
3219	40287	575	168	272	0	41302
3220	39572	193	131	252	0	40148
3221	750	40653	130	116	0	41649
3222	41387	611	111	140	0	42249
3223	41252	180	87	152	0	41671
3224	41190	110	131	144	0	41575
3225	953	40203	126	86	0	41368
3226	420	602	70	40887	0	41979
3227	270	192	41286	676	0	42424
3228	289	118	672	40641	0	41720
3229	223	70	230	41374	0	41897
3230	168	67	41220	866	0	42321
3231	189	91	40429	313	0	41022
3232	224	68	781	39315	0	40388
3233	151	41186	327	625	0	42289
3234	41608	641	195	277	0	42721
3235	41166	186	135	238	0	41725
3236	882	42121	115	133	0	43251
3237	42896	656	98	182	0	43832
3238	43067	200	82	186	0	43535
3239	907	168	42468	98	0	43641
3240	42206	116	671	175	0	43168
3241	857	43230	192	175	0	44454
3242	340	641	42761	96	0	43838
3243	338	200	41532	97	0	42167
3244	180	42095	783	139	0	43197
3245	41973	601	328	138	0	43040
3246	721	191	42160	190	0	43262
3247	337	110	599	42125	0	43171
3248	220	102	42288	580	0	43190
3249	40970	86	674	260	0	41990
3250	724	77	48184	182	0	49167
3251	334	107	47504	109	0	48054
3252	47970	65	725	184	0	48944
3253	687	49291	271	120	0	50369
3254	50729	566	233	159	0	51687
3255	51665	179	155	179	0	52178
3256	830	208	114	50809	0	51961
3257	362	54876	123	531	0	55892
3258	56125	545	139	374	0	57183
3259	691	239	55630	178	0	56738
3260	55096	158	642	213	0	56109
3261	728	56449	229	116	0	57522
3262	55923	461	194	138	0	56716
3263	55952	159	141	141	0	56393
3264	673	56305	117	97	0	57192
3265	298	484	126	57237	0	58145
3266	57877	148	176	546	0	58747
3267	576	57061	125	183	0	57945
3268	307	506	99	57923	0	58835
3269	59080	177	141	613	0	60011
3270	656	113	105	60713	0	61587
3271	331	97	99	60419	0	60946
3272	223	60562	121	721	0	61627
3273	61318	602	106	323	0	62349
3274	61994	229	113	262	0	62598
3275	63236	131	88	213	0	63668
3276	896	64058	129	128	0	65211
3277	65331	633	138	230	0	66332
3278	65715	240	107	176	0	66238
3279	978	139	77	64894	0	66088
3280	442	149	102	65219	0	65912
3281	361	128	64589	783	0	65861
3282	330	135	629	63482	0	64576
3283	407	143	241	61826	0	62617
3284	261	153	64457	803	0	65674
3285	59773	150	642	460	0	61025
3286	835	117	64321	193	0	65466
3287	419	156	64661	131	0	65367
3288	316	127	759	65007	0	66209
3289	306	111	285	65734	0	66436
3290	244	66510	269	702	0	67725
3291	67077	659	117	362	0	68215
3292	66692	230	126	277	0	67325
3293	930	66336	154	167	0	67587
3294	399	70280	146	191	0	71016
3295	350	951	110	70373	0	71784
3296	229	72912	162	744	0	74047
3297	73618	935	143	412	0	75108
3298	73994	323	115	311	0	74743
3299	1274	233	157	72961	0	74625
3300	592	140	125	73872	0	74729
3301	73775	120	108	1253	0	75256
3302	1112	168	71313	422	0	73015
3303	71589	134	916	353	0	72992
3304	1200	176	71055	168	0	72599
3305	71344	89	878	236	0	72547
3306	1133	237	307	71749	0	73426
3307	470	109	72963	873	0	74415
3308	344	139	70783	325	0	71591
3309	70660	320	1212	434	0	72626
3310	71507	117	413	309	0	72346
3311	1018	72467	195	146	0	73826
3312	492	723	107	75561	0	76883
3313	328	274	101	77973	0	78676
3314	77492	132	98	1448	0	79170
3315	1119	76669	105	487	0	78380
3316	75717	957	79	421	0	77174
3317	1102	74082	95	174	0	75453
3318	403	74494	100	155	0	75152
3319	74825	1100	84	278	0	76287
3320	1113	426	73337	99	0	74975
3321	512	245	906	73091	0	74754
3322	367	122	302	74339	0	75130
3323	210	142	73920	1227	0	75499
3324	327	100	907	73449	0	74783
3325	666	153	379	65459	0	66657
3326	173	74013	175	1259	0	75620
3327	74299	976	100	659	0	76034
3328	1118	358	74395	247	0	76118
3329	72069	200	951	321	0	73541
3330	1159	74001	353	173	0	75686
3331	552	959	176	75337	0	77024
3332	77683	333	114	1290	0	79420
3333	1200	184	90	77905	0	79379
3334	584	103	129	78456	0	79272
3335	321	142	77378	1421	0	79262
3336	74074	124	996	763	0	75957
3337	77242	109	362	509	0	78222
3338	1451	134	76568	232	0	78385
3339	696	79	1048	76264	0	78087
3340	382	131	76626	1108	0	78247
3341	75280	101	1120	634	0	77135
3342	78660	86	412	476	0	79634
3343	1490	78	233	77936	0	79737
3344	78439	75	151	1332	0	79997
3345	1287	125	81366	539	0	83317
3346	693	71	1045	81286	0	83095
3347	540	91	410	81496	0	82537
3348	404	93	227	84136	0	84860
3349	336	97	181	83815	0	84429
3350	76945	85	150	1759	0	78939
3351	1181	146	75126	659	0	77112
3352	632	72	1025	76355	0	78084
3353	361	93	75206	1253	0	76913
3354	299	117	73418	588	0	74422
3355	337	83	1329	73910	0	75659
3356	335	104	534	75143	0	76116
3357	71441	64	269	1599	0	73373
3358	1207	80	201	71741	0	73229
3359	574	90	178	72010	0	72852
3360	405	75	166	73094	0	73740
3361	71907	66	157	1909	0	74039
3362	72689	77	145	870	0	73781
3363	73555	57	170	616	0	74398
3364	72058	62	154	516	0	72790
3365	1589	74019	201	390	0	76199
3366	728	1187	143	74863	0	76921
3367	530	459	148	76465	0	77602
3368	76918	200	137	2072	0	79327
3369	1615	79400	137	974	0	82126
3370	826	1619	111	84144	0	86700
3371	415	615	88899	2008	0	91937
3372	93833	223	2093	1150	0	97299
3373	2950	98583	726	589	0	102848
3374	103217	2870	420	530	0	107037
3375	107147	865	209	447	0	108668
3376	4689	430	174	103584	0	108877
3377	1612	316	103302	3496	0	108726
3378	1207	201	3186	106238	0	110832
3379	107242	159	990	4120	0	112511
3380	4005	145	472	107450	0	112072
3381	107706	100	324	4184	0	112314
3382	3956	105635	229	1543	0	111363
3383	111170	3300	220	1030	0	115720
3384	4491	1008	221	110802	0	116522
3385	1963	518	193	118236	0	120910
3386	118042	343	214	4879	0	123478
3387	119435	249	137	1984	0	121805
3388	120513	233	148	1218	0	122112
3389	120378	222	169	937	0	121706
3390	120352	172	161	778	0	121463
3391	5910	201	216	114772	0	121099
3392	2238	294	110449	4011	0	116992
3393	1401	111480	3108	1494	0	117483
3394	110461	3321	930	1151	0	115863
3395	4117	1014	106050	761	0	111942
3396	106234	557	3349	772	0	110912
3397	4370	105515	1098	574	0	111557
3398	108891	3318	649	701	0	113559
3399	4767	1054	378	107412	0	113611
3400	2404	567	268	110499	0	113738
3401	1528	456	107742	4571	0	114297
3402	1721	297	3346	107972	0	113336
3403	1218	331	110033	4315	0	115897
3404	1226	349	109733	1840	0	113148
3405	111441	285	4226	1437	0	117389
3406	116475	283	1506	1319	0	119583
3407	5113	427	110629	969	0	117138
3408	111191	369	3560	1079	0	116199
3409	115183	342	1205	1085	0	117815
3410	5468	352	108672	915	0	115407
3411	2544	107089	3492	900	0	114025
3412	2770	3392	1352	110897	0	118411
3413	114247	1061	847	3910	0	120065
3414	118027	649	606	1762	0	121044
3415	118447	474	494	1343	0	120758
3416	118954	374	557	1168	0	121053
3417	118978	378	706	964	0	121026
3418	5768	481	112206	832	0	119287
3419	3062	555	115262	733	0	119612
3420	2701	733	4026	115889	0	123349
3421	118202	650	1694	3924	0	124470
3422	121185	541	1057	1911	0	124694
3423	121542	542	900	1574	0	124558
3424	116891	455	794	1804	0	119944
3425	5611	113133	973	1479	0	121196
3426	3014	121169	868	1751	0	126802
3427	121617	3676	913	1764	0	127970
3428	123983	1363	776	1788	0	127910
3429	5806	120769	763	1295	0	128633
3430	124446	3488	699	1493	0	130126
3431	5832	1290	120816	1192	0	129130
3432	3456	956	3408	120154	0	127974
3433	2926	685	120570	4024	0	128205
3434	2920	609	119379	1857	0	124765
3435	2918	521	4185	121066	0	128690
3436	3156	508	1641	124931	0	130236
3437	3013	539	124669	4457	0	132678
3438	3077	516	3664	121779	0	129036
3439	2751	562	1539	127460	0	132312
3440	126413	593	1234	4950	0	133190
3441	128051	750	1157	2337	0	132295
3442	6133	683	1078	125403	0	133297
3443	3409	841	124347	4018	0	132615
3444	2973	124465	3655	1865	0	132958
3445	124739	3407	1831	1739	0	131716
3446	5374	1283	126487	1422	0	134566
3447	3021	121186	4014	1550	0	129771
3448	2631	129215	1832	1538	0	135216
3449	130979	3634	1623	1643	0	137879
3450	133981	1402	1452	1659	0	138494
3451	5745	939	1484	130220	0	138388
3452	3213	786	135727	4042	0	143768
3453	2982	611	4251	135985	0	143829
3454	2856	605	2052	139090	0	144603
3455	2844	606	1528	141310	0	146288
3456	139172	560	1359	5107	0	146198
3457	5436	132867	1427	2257	0	141987
3458	3098	141224	1329	1727	0	147378
3459	2721	4097	1211	139574	0	147603
3460	2464	1612	1218	144806	0	150100
3461	142396	1086	1094	5246	0	149822
3462	142372	735	1093	2658	0	146858
3463	143237	586	1027	2029	0	146879
3464	6434	137733	1075	1580	0	146822
3465	138958	2944	1014	1332	0	144248
3466	5634	2084	1212	135257	0	144187
3467	3349	775	133123	3806	0	141053
3468	2827	773	123996	1859	0	129455
3469	125074	569	3851	1713	0	131207
3470	3850	434	122111	1206	0	127601
3471	2137	477	113307	781	0	116702
3472	104896	281	1844	740	0	107761
3473	1814	211	105087	360	0	107472
3474	814	229	102095	261	0	103399
3475	908	800	1191	98468	0	101367
3476	471	165	104488	713	0	105837
3477	495	159	781	100171	0	101606
3478	528	227	341	99176	0	100272
3479	360	122	104610	807	0	105899
3480	271	104897	770	417	0	106355
3481	105897	557	359	657	0	107470
3482	818	219	107867	185	0	109089
3483	388	184	105301	163	0	106036
3484	94677	152	837	516	0	96182
3485	675	120	101881	102	0	102778
3486	253	97964	606	125	0	98948
3487	444	88872	488	189	0	89993
3488	263	501	190	102125	0	103079
3489	246	206	109	100776	0	101337
3490	104622	113	71	1024	0	105830
3491	103773	70	79	631	0	104553
3492	104304	67	79	496	0	104946
3493	805	69	69	104519	0	105462
3494	105389	52	82	920	0	106443
3495	103928	53	100	557	0	104638
3496	793	92	104358	166	0	105409
3497	488	146	98714	154	0	99502
3498	242	104518	669	143	0	105572
3499	190	506	266	106933	0	107895
3500	107230	188	178	780	0	108376
3501	534	104682	198	281	0	105695
3502	290	513	117	107881	0	108801
3503	106455	174	106	941	0	107676
3504	104429	120	89	610	0	105248
3505	665	104957	140	279	0	106041
3506	105532	486	77	508	0	106603
3507	105737	192	86	440	0	106455
3508	830	154	77	105440	0	106501
3509	399	177	105991	516	0	107083
3510	260	102644	582	294	0	103780
3511	169	104481	274	238	0	105162
3512	101283	585	212	398	0	102478
3513	712	340	125	100625	0	101802
3514	290	190	100792	516	0	101788
3515	182	100302	523	260	0	101267
3516	101230	492	196	588	0	102506
3517	101509	193	137	504	0	102343
3518	737	183	102291	102	0	103313
3519	541	112	534	99163	0	100350
3520	336	66	203	105019	0	105624
3521	175	115	112839	793	0	113922
3522	113520	99	1029	747	0	115395
3523	138438	94	389	571	0	139492
3524	3167	119	268	156271	0	159825
3525	1036	159835	307	3399	0	164577
3526	1293	3396	136	169712	0	174537
3527	570	1404	168174	4529	0	174677
3528	166769	854	3741	2381	0	173745
3529	4735	592	1386	174084	0	180797
3530	1783	640	171876	4812	0	179111
3531	167101	470	4261	2617	0	174449
3532	5182	315	1936	172017	0	179450
3533	2817	230	1367	173514	0	177928
3534	170754	130	952	6454	0	178290
3535	4759	170033	983	3079	0	178854
3536	171105	3864	727	2382	0	178078
3537	5995	1514	488	169673	0	177670
3538	170179	1001	377	5614	0	177171
3539	5932	847	165892	2567	0	175238
3540	2922	166627	4091	1964	0	175604
3541	2669	4386	1639	171248	0	179942
3542	171843	1831	1262	5686	0	180622
3543	5386	170296	1068	2678	0	179428
3544	3456	4622	969	173100	0	182147
3545	174393	2114	869	5958	0	183334
3546	172449	1451	779	3384	0	178063
3547	7578	1162	652	167605	0	176997
3548	3790	1163	164610	5990	0	175553
3549	2734	1029	163883	3461	0	171107
3550	164675	815	5772	3004	0	174266
3551	6242	161868	2729	2170	0	173009
3552	3285	163467	2014	1960	0	170726
3553	159669	5592	1670	2150	0	169081
3554	5888	162962	1555	1689	0	172094
3555	3907	5632	1349	162515	0	173403
3556	3380	2945	954	167856	0	175135
3557	165343	2401	792	7247	0	175783
3558	164326	1916	628	3919	0	170789
3559	165566	1637	559	3126	0	170888
3560	8079	1542	156012	2528	0	168161
3561	5225	1040	4508	158814	0	169587
3562	3908	993	157536	6089	0	168526
3563	3509	955	155578	3339	0	163381
3564	3126	856	161149	2618	0	167749
3565	3016	983	7520	157358	0	168877
3566	2215	1153	161168	6232	0	170768
3567	2164	1238	163504	3363	0	170269
3568	2249	1210	7919	160120	0	171498
3569	161443	965	4421	6845	0	173674
3570	6315	1008	162119	3704	0	173146
3571	3691	921	6777	159119	0	170508
3572	3251	834	3668	164969	0	172722
3573	2810	929	163042	8016	0	174797
3574	2993	1023	6058	162076	0	172150
3575	2842	1049	163008	7527	0	174426
3576	2732	1171	6540	160407	0	170850
3577	2535	1130	3412	163767	0	170844
3578	2406	904	2871	165035	0	171216
3579	2209	962	2522	164694	0	170387
3580	155533	721	2541	9809	0	168604
3581	157725	785	2273	6068	0	166851
3582	7529	922	152153	4559	0	165163
3583	4192	148722	6020	4156	0	163090
3584	3367	4732	154541	3523	0	166163
3585	3065	2101	154134	3040	0	162340
3586	150409	1347	7946	3094	0	162796
3587	6609	152031	4880	2699	0	166219
3588	153876	5195	3946	2852	0	165869
3589	6730	155233	3708	2522	0	168193
3590	155902	5878	3535	2599	0	167914
3591	160484	2733	3016	2490	0	168723
3592	8701	2233	2499	153952	0	167385
3593	4653	154313	2177	6932	0	168075
3594	3960	5792	1755	158431	0	169938
3595	3321	2823	1805	162639	0	170588
3596	3053	1958	155129	9273	0	169413
3597	2763	155279	6091	5693	0	169826
3598	2677	5591	3361	159294	0	170923
3599	153883	2545	2733	8734	0	167895
3600	161863	1778	2644	5241	0	171526
3601	163813	1397	2574	4302	0	172086
3602	8680	157486	2575	3679	0	172420
3603	163026	5954	2214	3385	0	174579
3604	8447	167995	2267	2890	0	181599
3605	5296	6898	2082	172757	0	187033
3606	4254	3234	170688	7479	0	185655
3607	3776	2419	7010	170432	0	183637
3608	3175	169634	3718	8068	0	184595
3609	2944	6819	2833	173299	0	185895
3610	2670	3298	2220	176182	0	184370
3611	2304	171666	2210	10090	0	186270
3612	173392	7130	2040	5880	0	188442
3613	7776	3546	1667	173927	0	186916
3614	3771	2822	168227	9093	0	183913
3615	3492	2160	6518	172222	0	184392
3616	3315	1921	3100	178230	0	186566
3617	2743	1854	170995	10808	0	186400
3618	3062	2104	6928	166936	0	179030
3619	2477	167621	3524	9712	0	183334
3620	3153	6644	167789	5677	0	183263
3621	3692	2967	161698	4339	0	172696
3622	1920	151872	8017	3432	0	165241
3623	1329	134958	3386	2588	0	142261
3624	961	116565	1684	1203	0	120413
3625	105490	4086	2962	1308	0	113846
3626	101589	1270	923	1019	0	104801
3627	101006	667	495	848	0	103016
3628	3641	497	435	99042	0	103615
3629	1300	504	97209	2932	0	101945
3630	1047	471	2581	97188	0	101287
3631	775	425	1020	99622	0	101842
3632	97248	407	691	3785	0	102131
3633	98248	443	541	1705	0	100937
3634	3162	97343	498	1117	0	102120
3635	97946	2589	431	1108	0	102074
3636	99823	976	526	920	0	102245
3637	101415	640	371	928	0	103354
3638	3628	520	97019	733	0	101900
3639	1433	491	97119	630	0	99673
3640	1166	776	3045	95791	0	100778
3641	683	501	96168	2786	0	100138
3642	92900	508	2677	1256	0	97341
3643	95792	392	1000	916	0	98100
3644	3218	418	91506	573	0	95715
3645	90150	311	2284	649	0	93394
3646	2803	90547	886	524	0	94760
3647	92090	2279	565	614	0	95548
3648	2949	846	399	90485	0	94679
3649	1410	518	313	89245	0	91486
3650	902	89947	354	2757	0	93960
3651	89839	2294	335	1243	0	93711
3652	90893	883	337	877	0	92990
3653	3054	89477	417	533	0	93481
3654	1546	2322	299	87398	0	91565
3655	1089	936	337	87808	0	90170
3656	742	86770	420	2897	0	90829
3657	874	2385	384	87058	0	90701
3658	845	1024	366	89061	0	91296
3659	86526	612	350	3336	0	90824
3660	87373	477	344	1571	0	89765
3661	3189	479	84976	949	0	89593
3662	84673	447	2231	992	0	88343
3663	2908	511	84544	707	0	88670
3664	1423	725	2393	83272	0	87813
3665	910	491	83156	2621	0	87178
3666	771	81705	2392	1317	0	86185
3667	999	2356	1027	80686	0	85068
3668	841	904	554	82264	0	84563
3669	80244	549	388	3011	0	84192
3670	2531	469	356	79674	0	83030
3671	1140	488	76631	2707	0	80966
3672	77906	431	2003	1402	0	81742
3673	80162	421	831	1002	0	82416
3674	81140	425	569	890	0	83024
3675	80979	426	454	853	0	82712
3676	3348	369	407	82430	0	86554
3677	1553	361	378	86109	0	88401
3678	1097	367	396	89766	0	91626
3679	985	324	408	91134	0	92851
3680	87998	308	442	3970	0	92718
3681	89313	288	437	1779	0	91817
3682	3679	279	427	83908	0	88293
3683	1527	84550	458	2976	0	89511
3684	85657	2451	440	1446	0	89994
3685	3197	959	83984	967	0	89107
3686	1458	84467	2469	874	0	89268
3687	81927	2453	918	835	0	86133
3688	2849	82282	540	716	0	86387
3689	1344	2432	81257	625	0	85658
3690	81638	916	2371	736	0	85661
3691	83369	525	883	694	0	85471
3692	3542	449	80102	524	0	84617
3693	1851	317	2357	81232	0	85757
3694	1355	318	864	82143	0	84680
3695	996	80774	556	3194	0	85520
3696	1066	2315	455	82021	0	85857
3697	79512	829	380	3119	0	83840
3698	2827	79649	365	1400	0	84241
3699	1393	2288	330	77307	0	81318
3700	1077	863	279	78622	0	80841
3701	821	544	74710	2939	0	79014
3702	744	74744	2086	1256	0	78830
3703	69635	2274	835	1066	0	73810
3704	1902	60842	359	519	0	63622
3705	680	59514	260	386	0	60840
3706	58171	1753	637	453	0	61014
3707	1824	584	238	56737	0	59383
3708	735	354	192	57761	0	59042
3709	56855	254	138	1953	0	59200
3710	1767	200	114	57332	0	59413
3711	791	218	124	58483	0	59616
3712	58399	163	104	2142	0	60808
3713	1847	232	123	57668	0	59870
3714	692	57208	125	1841	0	59866
3715	57713	1444	95	907	0	60159
3716	1748	554	55359	522	0	58183
3717	704	53502	1376	498	0	56080
3718	553	1757	441	52876	0	55627
3719	347	459	51872	1544	0	54222
3720	338	316	51971	628	0	53253
3721	578	1368	1556	49146	0	52648
3722	49111	188	681	1545	0	51525
3723	1350	148	262	48735	0	50495
3724	621	134	170	49439	0	50364
3725	391	158	140	49881	0	50570
3726	342	157	135	50031	0	50665
3727	337	149	136	50238	0	50860
3728	243	191	47458	1731	0	49623
3729	243	169	46986	755	0	48153
3730	329	153	1328	47290	0	49100
3731	253	181	47050	1357	0	48841
3732	236	46972	1249	641	0	49098
3733	321	1171	481	47446	0	49419
3734	250	428	46293	1348	0	48319
3735	43527	259	1223	734	0	45743
3736	1173	44584	455	516	0	46728
3737	421	43618	262	427	0	44728
3738	288	44795	200	395	0	45678
3739	435	1391	226	43611	0	45663
3740	43506	485	225	1341	0	45557
3741	1177	309	142	43571	0	45199
3742	42515	248	146	1402	0	44311
3743	1165	41671	136	660	0	43632
3744	42617	1117	186	524	0	44444
3745	1277	494	141	42699	0	44611
3746	590	314	112	43092	0	44108
3747	339	42096	129	1428	0	43992
3748	379	1124	125	42983	0	44611
3749	307	443	150	43619	0	44519
3750	310	285	136	43691	0	44422
3751	42089	214	134	1698	0	44135
3752	40297	192	136	998	0	41623
3753	1326	232	41579	573	0	43710
3754	41902	206	1017	554	0	43679
3755	1320	201	42166	457	0	44144
3756	642	188	1078	42092	0	44000
3757	383	207	418	43088	0	44096
3758	344	183	249	43680	0	44456
3759	256	187	41865	1625	0	43933
3760	246	192	1117	42335	0	43890
3761	222	201	42647	1503	0	44573
3762	259	165	1184	42939	0	44547
3763	42542	199	480	1482	0	44703
3764	1125	221	42458	759	0	44563
3765	42490	192	1098	586	0	44366
3766	1216	160	412	43264	0	45052
3767	43015	155	279	1461	0	44910
3768	1196	42653	253	751	0	44853
3769	544	983	202	43716	0	45445
3770	355	373	44065	1431	0	46224
3771	401	426	1081	43704	0	45612
3772	321	969	432	42917	0	44639
3773	253	42627	266	1595	0	44741
3774	344	994	42110	745	0	44193
3775	202	41928	997	585	0	43712
3776	37291	962	501	516	0	39270
3777	725	37704	242	369	0	39040
3778	35006	607	506	249	0	36368
3779	35122	219	175	263	0	35779
3780	35247	106	90	200	0	35643
3781	863	99	101	35042	0	36105
3782	330	78	34950	706	0	36064
3783	224	93	603	34435	0	35355
3784	135	34913	224	755	0	36027
3785	145	585	128	35243	0	36101
3786	34465	196	112	823	0	35596
3787	592	34520	109	357	0	35578
3788	277	622	83	33759	0	34741
3789	180	261	84	34077	0	34602
3790	33646	126	80	859	0	34711
3791	634	120	33357	354	0	34465
3792	255	32785	598	250	0	33888
3793	211	552	186	31693	0	32642
3794	100	156	31487	561	0	32304
3795	117	217	485	30466	0	31285
3796	77	30725	160	563	0	31525
3797	158	489	123	31974	0	32744
3798	90	151	66	31668	0	31975
3799	70	90	74	31544	0	31778
3800	39	65	31045	686	0	31835
3801	30608	52	446	319	0	31425
3802	485	56	143	32801	0	33485
3803	34931	50	85	670	0	35736
3804	36059	46	67	284	0	36456
3805	36810	40	53	191	0	37094
3806	36497	49	39	211	0	36796
3807	37304	40	31	143	0	37518
3808	949	52	61	36272	0	37334
3809	342	35621	47	662	0	36672
3810	259	572	36	35342	0	36209
3811	123	35051	53	668	0	35895
3812	166	603	34	33658	0	34461
3813	33545	164	38	617	0	34364
3814	548	119	31	33363	0	34061
3815	196	61	33046	575	0	33878
3816	31985	36	435	289	0	32745
3817	489	33000	151	161	0	33801
3818	33201	437	133	165	0	33936
3819	33187	135	82	146	0	33550
3820	32410	86	45	120	0	32661
3821	624	32439	29	89	0	33181
3822	290	440	28	32441	0	33199
3823	177	146	25	32847	0	33195
3824	126	90	32289	575	0	33080
3825	167	53	427	31452	0	32099
3826	183	51	131	31179	0	31544
3827	142	30	70	32214	0	32456
3828	76	32253	46	637	0	33012
3829	32586	446	41	315	0	33388
3830	32070	160	31	229	0	32490
3831	619	103	32603	113	0	33438
3832	251	32397	439	128	0	33215
3833	240	481	134	32905	0	33760
3834	193	167	71	33427	0	33858
3835	194	94	52	33426	0	33766
3836	198	58	35	33936	0	34227
3837	174	62	40	34366	0	34642
3838	104	75	33607	769	0	34555
3839	118	98	32390	347	0	32953
3840	34280	66	586	291	0	35223
3841	36138	62	211	212	0	36623
3842	36553	61	109	202	0	36925
3843	859	71	75	36421	0	37426
3844	322	45	35819	662	0	36848
3845	35865	52	572	303	0	36792
3846	36988	49	180	247	0	37464
3847	805	86	35633	147	0	36671
3848	36026	44	573	184	0	36827
3849	785	70	37874	143	0	38872
3850	398	48	650	38156	0	39252
3851	210	75	38446	684	0	39415
3852	37891	45	694	316	0	38946
3853	39044	55	239	261	0	39599
3854	39305	51	143	208	0	39707
3855	39235	41	123	262	0	39661
3856	907	47	39877	169	0	41000
3857	385	40033	631	153	0	41202
3858	40794	600	212	198	0	41804
3859	41234	193	131	168	0	41726
3860	923	121	40898	125	0	42067
3861	465	77	661	39855	0	41058
3862	307	76	234	41197	0	41814
3863	225	64	40423	868	0	41580
3864	39153	55	669	423	0	40300
3865	40995	42	226	306	0	41569
3866	870	40871	170	191	0	42102
3867	42297	612	132	241	0	43282
3868	42205	189	140	185	0	42719
3869	42828	104	113	188	0	43233
3870	42094	73	136	140	0	42443
3871	1099	78	40547	107	0	41831
3872	40544	51	636	165	0	41396
3873	971	294	238	40113	0	41616
3874	416	40741	181	643	0	41981
3875	362	592	40120	266	0	41340
3876	274	40466	642	215	0	41597
3877	352	916	345	38547	0	40160
3878	221	182	39101	566	0	40070
3879	37508	104	582	233	0	38427
3880	632	65	38699	152	0	39548
3881	38499	70	570	127	0	39266
3882	688	45	205	38567	0	39505
3883	336	46	136	38756	0	39274
3884	245	37969	112	632	0	38958
3885	206	39349	113	248	0	39916
3886	231	570	98	40214	0	41113
3887	39947	218	92	572	0	40829
3888	40169	87	107	239	0	40602
3889	40314	66	97	157	0	40634
3890	804	74	39818	120	0	40816
3891	39827	53	527	165	0	40572
3892	702	45	40692	106	0	41545
3893	318	76	39157	97	0	39648
3894	39645	92	723	122	0	40582
3895	40795	71	256	130	0	41252
3896	725	74	40412	77	0	41288
3897	373	70	526	39853	0	40822
3898	277	78	197	41537	0	42089
3899	41631	38	158	632	0	42459
3900	41144	31	121	271	0	41567
3901	746	49	42856	131	0	43782
3902	324	41401	460	118	0	42303
3903	162	40329	163	105	0	40759
3904	39958	367	281	131	0	40737
3905	538	112	127	39703	0	40480
3906	226	70	64	40402	0	40762
3907	175	37	73	40890	0	41175
3908	40391	44	50	430	0	40915
3909	448	75	71	40799	0	41393
3910	41087	39	70	397	0	41593
3911	42032	30	76	162	0	42300
3912	556	44305	88	98	0	45047
3913	284	371	65	47779	0	48499
3914	187	150	48097	498	0	48932
3915	47721	81	535	265	0	48602
3916	49143	53	208	185	0	49589
3917	49443	41	130	173	0	49787
3918	826	43	50037	106	0	51012
3919	437	43	559	50344	0	51383
3920	51354	51	199	680	0	52284
3921	50192	42	146	256	0	50636
3922	50480	49	107	210	0	50846
3923	849	49395	105	129	0	50478
3924	402	51644	80	136	0	52262
3925	320	639	82	52960	0	54001
3926	247	226	87	52775	0	53335
3927	201	52434	74	725	0	53434
3928	52990	554	61	324	0	53929
3929	721	216	53379	165	0	54481
3930	371	113	550	53514	0	54548
3931	279	96	192	53773	0	54340
3932	220	84	53180	733	0	54217
3933	51604	63	592	358	0	52617
3934	54334	70	213	247	0	54864
3935	821	53172	150	138	0	54281
3936	53607	543	119	165	0	54434
3937	774	239	54878	121	0	56012
3938	55800	97	576	250	0	56723
3939	794	84	56540	94	0	57512
3940	55719	194	838	208	0	56959
3941	56983	54	289	178	0	57504
3942	56987	55	163	134	0	57339
3943	56454	36	123	163	0	56776
3944	811	55658	112	97	0	56678
3945	57492	474	71	167	0	58204
3946	58855	171	87	174	0	59287
3947	860	117	58469	89	0	59535
3948	58995	98	520	142	0	59755
3949	789	80	206	59127	0	60202
3950	395	61	58853	559	0	59868
3951	59295	65	589	267	0	60216
3952	775	94	203	60383	0	61455
3953	61609	57	133	709	0	62508
3954	65554	61	109	542	0	66266
3955	881	101	67004	153	0	68139
3956	66924	50	573	296	0	67843
3957	68805	53	250	194	0	69302
3958	69171	48	142	179	0	69540
3959	70040	40	112	179	0	70371
3960	1065	52	112	68184	0	69413
3961	501	68176	107	650	0	69434
3962	66799	611	149	487	0	68046
3963	70482	208	106	235	0	71031
3964	71119	107	84	231	0	71541
3965	1098	118	69640	118	0	70974
3966	545	69239	684	102	0	70570
3967	483	618	271	70135	0	71507
3968	428	199	162	71162	0	71951
3969	365	114	72742	842	0	74063
3970	436	106	854	72607	0	74003
3971	344	84	73770	1010	0	75208
3972	373	77	990	73531	0	74971
3973	421	80	334	74884	0	75719
3974	301	129	75132	1211	0	76773
3975	73464	99	973	609	0	75145
3976	76996	86	358	465	0	77905
3977	1317	128	77211	262	0	78918
3978	76882	76	982	339	0	78279
3979	78983	66	370	347	0	79766
3980	1424	91	79616	204	0	81335
3981	800	86	1038	78943	0	80867
3982	546	65	405	80382	0	81398
3983	80564	54	279	1335	0	82232
3984	1177	81416	219	538	0	83350
3985	75514	943	233	801	0	77491
3986	82098	305	172	366	0	82941
3987	1430	83251	161	204	0	85046
3988	84742	945	167	344	0	86198
3989	85177	351	157	289	0	85974
3990	1562	83397	182	161	0	85302
3991	812	980	169	84599	0	86560
3992	567	85236	179	988	0	86970
3993	563	1039	162	86305	0	88069
3994	484	422	85801	1166	0	87873
3995	461	275	84210	492	0	85438
3996	84386	185	1268	486	0	86325
3997	86762	170	503	393	0	87828
3998	1559	139	86103	214	0	88015
3999	86280	117	1136	322	0	87855
4000	88750	82	436	354	0	89622
4001	86825	94	312	343	0	87574
4002	1709	87034	299	204	0	89246
4003	939	946	206	89103	0	91194
4004	89069	345	177	1234	0	90825
4005	88849	201	190	666	0	89906
4006	1622	200	89322	337	0	91481
4007	943	143	1051	88693	0	90830
4008	738	144	449	90126	0	91457
4009	546	88780	316	1295	0	90937
4010	494	92838	242	593	0	94167
4011	571	1721	199	90152	0	92643
4012	395	90789	191	1184	0	92559
4013	88684	1067	154	515	0	90420
4014	1216	91465	156	306	0	93143
4015	93459	1240	158	413	0	95270
4016	1573	480	92973	178	0	95204
4017	96918	287	1347	336	0	98888
4018	100969	143	416	328	0	101856
4019	101233	105	260	339	0	101937
4020	99823	90	204	392	0	100509
4021	2310	97782	195	203	0	100490
4022	1131	1477	127	99996	0	102731
4023	886	514	121	99609	0	101130
4024	495	365	98712	2037	0	101609
4025	585	227	1483	97466	0	99761
4026	533	221	520	99885	0	101159
4027	100225	144	301	2365	0	103035
4028	1823	100635	249	923	0	103630
4029	959	1649	235	102063	0	104906
4030	791	545	173	104626	0	106135
4031	661	350	190	105849	0	107050
4032	104390	285	190	2818	0	107683
4033	2121	214	181	105426	0	107942
4034	105728	189	221	2594	0	108732
4035	2381	179	238	106098	0	108896
4036	1072	168	201	108056	0	109497
4037	814	164	102174	2583	0	105735
4038	97729	284	1796	1314	0	101123
4039	2240	101867	610	698	0	105415
4040	105171	1745	390	758	0	108064
4041	2513	581	218	104068	0	107380
4042	1187	391	191	106017	0	107786
4043	106378	257	136	2785	0	109556
4044	108084	252	156	1333	0	109825
4045	3084	248	128	110894	0	114354
4046	1194	249	110578	2632	0	114653
4047	832	259	109787	1148	0	112026
4048	601	115646	2518	785	0	119550
4049	117707	2475	1117	816	0	122115
4050	119365	815	564	762	0	121506
4051	3504	502	245	118073	0	122324
4052	1307	119836	228	2735	0	124106
4053	1106	2624	155	120451	0	124336
4054	941	819	166	117212	0	119138
4055	637	111797	237	3399	0	116070
4056	113210	2551	222	1562	0	117545
4057	3052	998	278	112954	0	117282
4058	1139	112678	360	2946	0	117123
4059	919	119722	282	1107	0	122030
4060	119334	3010	278	1010	0	123632
4061	3185	1135	117272	617	0	122209
4062	118963	781	2591	737	0	123072
4063	3604	658	762	119218	0	124242
4064	1550	570	480	119913	0	122513
4065	1100	118937	342	3383	0	123762
4066	1202	3046	319	119985	0	124552
4067	925	957	119535	3399	0	124816
4068	793	116200	2548	1504	0	121045
4069	643	119882	722	1115	0	122362
4070	117389	3027	588	1048	0	122052
4071	2702	118004	413	773	0	121892
4072	1219	2864	330	118592	0	123005
4073	872	118407	293	2914	0	122486
4074	867	2835	222	120046	0	123970
4075	863	1024	199	121977	0	124063
4076	639	850	116887	3795	0	122171
4077	783	643	2420	116370	0	120216
4078	846	549	768	119425	0	121588
4079	116055	557	572	3996	0	121180
4080	2973	613	114863	1773	0	120222
4081	1514	574	2490	117447	0	122025
4082	1109	566	116500	3470	0	121645
4083	115410	547	2830	1849	0	120636
4084	3096	117976	1011	1477	0	123560
4085	123604	2910	726	1515	0	128755
4086	3734	1057	562	126519	0	131872
4087	1667	948	420	128143	0	131178
4088	1306	748	124262	4434	0	130750
4089	118864	715	2883	2448	0	124910
4090	3507	126023	922	1794	0	132246
4091	126254	3295	716	1656	0	131921
4092	4049	1207	559	126188	0	132003
4093	1632	126583	553	3865	0	132633
4094	127381	3324	505	1984	0	133194
4095	3773	128797	437	1531	0	134538
4096	1702	3645	424	129354	0	135125
4097	1440	1321	394	131740	0	134895
4098	1173	1102	519	130694	0	133488
4099	1054	125932	528	4927	0	132441
4100	1162	3400	470	128717	0	133749
4101	1208	1394	434	131359	0	134395
4102	125740	1147	392	5278	0	132557
4103	127846	933	391	2562	0	131732
4104	128574	942	440	1910	0	131866
4105	4871	1005	125008	1490	0	132374
4106	126305	959	3078	1617	0	131959
4107	129780	869	1051	1574	0	133274
4108	125693	940	785	1709	0	129127
4109	4626	1049	118346	1465	0	125486
4110	122758	847	2695	1439	0	127739
4111	4388	887	918	124085	0	130278
4112	1938	803	121907	3961	0	128609
4113	1501	120955	3079	1983	0	127518
4114	1459	4448	1050	116772	0	123729
4115	1042	114634	900	3368	0	119944
4116	1032	118094	681	1726	0	121533
4117	111900	3014	1024	1407	0	117345
4118	3073	1180	507	111308	0	116068
4119	111998	753	450	3140	0	116341
4120	3226	603	370	111952	0	116151
4121	111620	602	418	3264	0	115904
4122	3283	569	401	111611	0	115864
4123	111481	637	380	3279	0	115777
4124	3215	638	107146	1361	0	112360
4125	1535	877	2323	108438	0	113173
4126	1245	708	108672	2975	0	113600
4127	1133	681	104186	1384	0	107384
4128	884	610	107995	1247	0	110736
4129	1013	1058	2893	105155	0	110119
4130	766	529	106031	2954	0	110280
4131	104372	532	2426	1452	0	108782
4132	2620	503	836	105869	0	109828
4133	1174	462	109273	2872	0	113781
4134	1117	430	2183	109361	0	113091
4135	944	403	795	111500	0	113642
4136	897	436	114685	3122	0	119140
4137	1001	375	2319	114651	0	118346
4138	1014	363	897	114516	0	116790
4139	884	115369	775	3002	0	120030
4140	116291	2008	602	1694	0	120595
4141	117544	654	569	1319	0	120086
4142	3037	515	113361	1043	0	117956
4143	111776	378	2196	1121	0	115471
4144	2808	322	110508	857	0	114495
4145	1208	300	105957	692	0	108157
4146	998	337	106586	623	0	108544
4147	1250	2081	2516	100278	0	106125
4148	632	277	103381	1788	0	106078
4149	612	457	1533	100203	0	102805
4150	555	189	599	100971	0	102314
4151	562	163	451	101639	0	102815
4152	515	196	384	101512	0	102607
4153	99820	183	301	2075	0	102379
4154	100546	183	339	1118	0	102186
4155	1675	100767	407	738	0	103587
4156	772	1216	337	102837	0	105162
4157	665	405	103138	1559	0	105767
4158	487	102743	1551	776	0	105557
4159	634	1673	588	106703	0	109598
4160	459	479	108015	1901	0	110854
4161	571	402	1701	105372	0	108046
4162	320	263	107133	2050	0	109766
4163	410	247	105241	848	0	106746
4164	501	234	1952	107987	0	110674
4165	486	216	815	108816	0	110333
4166	108742	139	597	2440	0	111918
4167	1752	117	488	108721	0	111078
4168	107569	151	426	2424	0	110570
4169	1743	105409	471	1017	0	108640
4170	702	108988	417	809	0	110916
4171	690	1705	308	111131	0	113834
4172	110994	570	343	2130	0	114037
4173	1775	110958	389	875	0	113997
4174	898	1604	338	114856	0	117696
4175	117224	486	354	2353	0	120417
4176	118661	383	354	1068	0	120466
4177	117517	286	357	1033	0	119193
4178	117123	214	384	898	0	118619
4179	120650	216	293	759	0	121918
4180	2445	280	114912	554	0	118191
4181	1151	232	113106	555	0	115044
4182	793	114514	1818	457	0	117582
4183	967	2013	957	114989	0	118926
4184	560	456	116825	1603	0	119444
4185	494	374	112799	569	0	114236
4186	630	619	1693	111503	0	114445
4187	340	182	117997	1518	0	120037
4188	349	254	116291	542	0	117436
4189	253	140460	1866	534	0	143113
4190	141702	2683	782	664	0	145831
4191	2581	151581	533	391	0	155086
4192	1045	3181	367	156109	0	160702
4193	159236	664	331	3469	0	163700
4194	3259	160954	433	791	0	165437
4195	1275	3269	344	160721	0	165609
4196	752	780	160850	3333	0	165715
4197	161190	617	3203	1127	0	166137
4198	166892	347	715	1081	0	169035
4199	169506	228	612	763	0	171109
4200	4819	309	384	166816	0	172328
4201	1391	403	166453	3722	0	171969
4202	874	165351	3545	1049	0	170819
4203	1185	3369	788	168986	0	174328
4204	169094	749	616	4099	0	174558
4205	4038	718	166014	885	0	171655
4206	1016	163332	3654	986	0	168988
4207	953	3443	166301	586	0	171283
4208	165236	886	3818	823	0	170763
4209	172805	680	963	858	0	175306
4210	173083	414	766	819	0	175082
4211	4919	441	165245	413	0	171018
4212	1649	162978	3609	577	0	168813
4213	1643	3474	1066	165229	0	171412
4214	1296	809	833	169039	0	171977
4215	1178	644	666	169766	0	172254
4216	796	514	164852	4751	0	170913
4217	160826	386	3810	2002	0	167024
4218	4247	505	165041	1151	0	170944
4219	167528	431	4102	1235	0	173296
4220	173349	447	1221	1161	0	176178
4221	174087	489	899	1082	0	176557
4222	171096	565	742	1112	0	173515
4223	5504	702	167071	646	0	173923
4224	2633	617	3836	168363	0	175449
4225	1771	801	166288	4077	0	172937
4226	1491	161126	4133	1421	0	168171
4227	1408	170532	1317	1261	0	174518
4228	169890	4497	1029	1394	0	176810
4229	167868	1641	931	1451	0	171891
4230	5004	170822	1057	1156	0	178039
4231	173632	4365	954	1371	0	180322
4232	5764	1886	150453	1339	0	159442
4233	166425	1223	3225	1417	0	172290
4234	5668	170248	1406	1058	0	178380
4235	175979	4483	1106	1316	0	182884
4236	173985	1540	997	1155	0	177677
4237	6789	1269	1022	168061	0	177141
4238	3289	1038	1048	171847	0	177222
4239	169227	1051	1181	5724	0	177183
4240	6041	1200	1014	169257	0	177512
4241	169719	1003	1193	5774	0	177689
4242	6720	967	1024	169904	0	178615
4243	168533	827	1193	5796	0	176349
4244	169749	834	1151	2378	0	174112
4245	6691	159637	1388	1672	0	169388
4246	3306	167761	1262	1390	0	173719
4247	164103	5131	1175	1612	0	172021
4248	5863	164241	1196	1443	0	172743
4249	3100	5380	1226	163055	0	172761
4250	3030	1884	1272	166340	0	172526
4251	160738	1734	1227	6319	0	170018
4252	5736	158817	1363	2884	0	168800
4253	3180	156374	1438	2268	0	163260
4254	2998	161368	1514	1838	0	167718
4255	3361	5759	155866	1678	0	166664
4256	3209	2342	155216	1570	0	162337
4257	3331	2022	156769	1539	0	163661
4258	3397	3092	5650	142159	0	154298
4259	2843	150135	2279	4395	0	159652
4260	151782	4734	1507	2399	0	160422
4261	5986	1841	148414	2040	0	158281
4262	3211	1653	147642	1840	0	154346
4263	3071	1495	151631	1475	0	157672
4264	3232	1522	5603	149145	0	159502
4265	3163	1280	2396	152387	0	159226
4266	3299	1300	1819	153912	0	160330
4267	152049	1255	1491	5583	0	160378
4268	152373	1474	1504	2399	0	157750
4269	153577	1285	1412	2054	0	158328
4270	7051	1197	1638	147720	0	157606
4271	3439	1332	143934	4662	0	153367
4272	2950	1623	147029	1934	0	153536
4273	3112	1149	4924	146826	0	156011
4274	3168	1140	2008	147320	0	153636
4275	143435	1165	1664	5571	0	151835
4276	6001	140175	1381	2671	0	150228
4277	142251	3991	1330	2227	0	149799
4278	6294	139092	1167	2065	0	148618
4279	3612	4318	972	140874	0	149776
4280	3065	1562	138866	5212	0	148705
4281	3060	1901	4135	138512	0	147608
4282	140824	1253	1489	5599	0	149165
4283	5945	1052	137677	2607	0	147281
4284	135689	1026	4239	2354	0	143308
4285	6552	949	133646	1722	0	142869
4286	3745	1221	130385	1433	0	136784
4287	124681	1182	4492	1718	0	132073
4288	5739	999	125257	1365	0	133360
4289	2088	564	99793	741	0	103186
4290	2326	97753	3429	869	0	104377
4291	87880	2464	2923	1108	0	94375
4292	84875	590	879	542	0	86886
4293	84380	319	371	448	0	85518
4294	1674	291	80518	332	0	82815
4295	79097	242	1236	453	0	81028
4296	1442	80709	456	299	0	82906
4297	80385	1182	318	393	0	82278
4298	1484	396	79824	261	0	81965
4299	797	992	1165	76906	0	79860
4300	416	196	77014	989	0	78615
4301	295	76312	1108	379	0	78094
4302	506	842	586	75393	0	77327
4303	398	276	296	76668	0	77638
4304	77518	163	232	1207	0	79120
4305	77461	121	192	573	0	78347
4306	77834	95	168	419	0	78516
4307	77750	95	159	343	0	78347
4308	77083	106	143	263	0	77595
4309	1392	122	75834	153	0	77501
4310	666	99	937	75434	0	77136
4311	386	140	78884	923	0	80333
4312	364	131	1040	78974	0	80509
4313	80253	75	398	1272	0	81998
4314	81922	93	286	551	0	82852
4315	82312	100	218	403	0	83033
4316	82611	110	188	330	0	83239
4317	1546	190	83304	187	0	85227
4318	736	137	1084	82657	0	84614
4319	438	137	82886	1142	0	84603
4320	360	82437	1223	455	0	84475
4321	362	82388	517	331	0	83598
4322	756	1370	372	81185	0	83683
4323	441	395	241	89423	0	90500
4324	584	209	252	90435	0	91480
4325	480	114	221	96184	0	96999
4326	94686	85	239	2309	0	97319
4327	1711	93852	243	826	0	96632
4328	92829	1478	142	590	0	95039
4329	1962	455	174	92053	0	94644
4330	890	241	167	90908	0	92206
4331	471	91137	203	2009	0	93820
4332	542	1527	165	91962	0	94196
4333	91396	449	138	1929	0	93912
4334	1685	86875	197	730	0	89487
4335	513	86111	150	424	0	87198
4336	86274	1624	125	413	0	88436
4337	1692	564	95	86146	0	88497
4338	569	85740	142	1524	0	87975
4339	657	1439	161	87657	0	89914
4340	87654	454	190	1880	0	90178
4341	1653	314	116	87110	0	89193
4342	674	200	100	88399	0	89373
4343	87447	169	85	2108	0	89809
4344	1706	170	83	87123	0	89082
4345	657	86584	95	1751	0	89087
4346	600	1352	81	87054	0	89087
4347	355	86199	106	1720	0	88380
4348	422	1486	71	87664	0	89643
4349	86873	478	89	1956	0	89396
4350	88060	287	92	868	0	89307
4351	2049	232	72	87790	0	90143
4352	740	232	85989	1701	0	88662
4353	84460	194	1338	920	0	86912
4354	1696	232	85583	508	0	88019
4355	85817	183	1460	623	0	88083
4356	87115	154	462	601	0	88332
4357	2028	177	84153	356	0	86714
4358	793	83287	1438	340	0	85858
4359	84213	1369	580	514	0	86676
4360	84441	469	267	610	0	85787
4361	1877	321	85912	303	0	88413
4362	85332	244	1427	550	0	87553
4363	85398	188	432	478	0	86496
4364	86072	158	223	469	0	86922
4365	2140	142	149	84609	0	87040
4366	984	166	125	85226	0	86501
4367	577	84491	171	1780	0	87019
4368	581	1310	110	86818	0	88819
4369	526	463	102	87494	0	88585
4370	417	319	84820	1955	0	87511
4371	422	270	81022	878	0	82592
4372	78695	225	1626	710	0	81256
4373	82620	172	555	603	0	83950
4374	1919	81247	357	461	0	83984
4375	941	1411	216	82588	0	85156
4376	570	536	83739	1654	0	86499
4377	612	344	1470	84921	0	87347
4378	684	285	507	86099	0	87575
4379	493	220	307	90154	0	91174
4380	376	88447	234	2405	0	91462
4381	527	1625	176	90708	0	93036
4382	517	587	147	92554	0	93805
4383	421	416	89931	2565	0	93333
4384	430	310	90143	1116	0	91999
4385	87180	233	2104	980	0	90497
4386	91213	228	757	774	0	92972
4387	2410	230	430	94051	0	97121
4388	1107	253	288	93068	0	94716
4389	772	288	254	94841	0	96155
4390	521	272	90081	3167	0	94041
4391	475	88688	2115	1383	0	92661
4392	445	2186	89314	939	0	92884
4393	88205	702	2424	857	0	92188
4394	2493	497	89806	642	0	93438
4395	89269	340	2427	717	0	92753
4396	88945	271	806	742	0	90764
4397	91605	253	528	697	0	93083
4398	3261	209	397	88834	0	92701
4399	1255	265	88435	2601	0	92556
4400	835	88756	2221	1090	0	92902
4401	863	2187	752	88609	0	92411
4402	737	720	497	91030	0	92984
4403	541	474	90779	3110	0	94904
4404	477	89376	2474	1345	0	93672
4405	91693	2449	888	1005	0	96035
4406	2722	94112	600	712	0	98146
4407	99849	2907	499	703	0	103958
4408	3845	927	440	100495	0	105707
4409	1350	608	102488	3335	0	107781
4410	1019	103402	3210	1223	0	108854
4411	104532	3288	1086	1217	0	110123
4412	3710	942	103838	717	0	109207
4413	104123	749	3551	769	0	109192
4414	106783	422	1153	690	0	109048
4415	4408	409	103796	489	0	109102
4416	103322	321	3492	621	0	107756
4417	104644	263	1148	592	0	106647
4418	102978	226	930	635	0	104769
4419	4708	98957	623	495	0	104783
4420	96953	3155	490	534	0	101132
4421	4091	97419	416	497	0	102423
4422	1511	3432	96649	471	0	102063
4423	1064	95987	3098	539	0	100688
4424	91132	3493	1603	561	0	96789
4425	92976	893	703	447	0	95019
4426	94174	674	458	391	0	95697
4427	4270	385	353	90079	0	95087
4428	1832	324	341	93252	0	95749
4429	89049	283	365	3516	0	93213
4430	93003	321	307	1239	0	94870
4431	4077	268	269	89686	0	94300
4432	1519	301	88505	3015	0	93340
4433	1076	84432	2764	952	0	89224
4434	750	89651	745	765	0	91911
4435	958	3143	726	87522	0	92349
4436	688	1092	87460	2817	0	92057
4437	906	979	2733	84427	0	89045
4438	651	85119	802	2911	0	89483
4439	891	2669	631	85993	0	90184
4440	697	869	85102	3124	0	89792
4441	880	672	2701	85540	0	89793
4442	642	436	88559	3303	0	92940
4443	889	457	3095	88218	0	92659
4444	662	449	90584	3332	0	95027
4445	680	429	90438	1050	0	92597
4446	88043	363	3401	978	0	92785
4447	91780	376	1272	734	0	94162
4448	92435	357	873	701	0	94366
4449	3895	89109	636	537	0	94177
4450	1876	2640	531	90909	0	95956
4451	88497	821	486	3103	0	92907
4452	92904	660	506	1106	0	95176
4453	92682	512	458	1003	0	94655
4454	4085	470	89480	634	0	94669
4455	1674	84182	2830	914	0	89600
4456	1306	91355	999	601	0	94261
4457	90528	3132	911	644	0	95215
4458	3480	1164	629	89673	0	94946
4459	89884	872	584	3019	0	94359
4460	3659	619	88017	941	0	93236
4461	1681	483	2770	87228	0	92162
4462	1496	477	1027	89521	0	92521
4463	1320	459	804	87880	0	90463
4464	1094	87624	628	3543	0	92889
4465	87878	2794	587	1493	0	92752
4466	89709	972	554	1058	0	92293
4467	3782	86758	559	748	0	91847
4468	1903	2912	519	86643	0	91977
4469	87484	983	528	3052	0	92047
4470	3687	926	496	87088	0	92197
4471	87044	572	447	3394	0	91457
4472	3778	85844	501	1144	0	91267
4473	86543	2843	518	1033	0	90937
4474	3851	1118	84165	716	0	89850
4475	1665	85315	2709	760	0	90449
4476	1521	2811	84087	666	0	89085
4477	1749	2173	3269	81526	0	88717
4478	81098	938	1194	2922	0	86152
4479	82581	544	804	981	0	84910
4480	82086	492	528	906	0	84012
4481	3961	406	474	78722	0	83563
4482	79525	388	450	2899	0	83262
4483	3600	391	445	78281	0	82717
4484	78539	401	397	3143	0	82480
4485	80494	420	458	1202	0	82574
4486	3618	403	78139	1052	0	83212
4487	1455	431	74365	561	0	76812
4488	1076	431	74313	622	0	76442
4489	885	676	2529	71878	0	75968
4490	72789	312	1344	2300	0	76745
4491	2415	349	728	73411	0	76903
4492	1070	305	501	75633	0	77509
4493	77542	283	401	2810	0	81036
4494	78139	220	409	1354	0	80122
4495	78351	250	384	1014	0	79999
4496	79134	225	380	779	0	80518
4497	3060	185	389	77066	0	80700
4498	76669	181	378	2334	0	79562
4499	2634	75085	413	831	0	78963
4500	75514	1749	378	904	0	78545
4501	75884	508	555	794	0	77741
4502	2676	531	71629	494	0	75330
4503	69524	343	1677	533	0	72077
4504	2331	241	68500	441	0	71513
4505	907	172	64371	350	0	65800
4506	903	287	64318	306	0	65814
4507	899	1547	1533	55553	0	59532
4508	368	102	57436	813	0	58719
4509	407	384	700	53103	0	54594
4510	203	74	54484	627	0	55388
4511	217	96	56490	250	0	57053
4512	272	209	609	55487	0	56577
4513	263	72	239	58061	0	58635
4514	161	52	59759	561	0	60533
4515	58153	43	492	314	0	59002
4516	618	45	188	59999	0	60850
4517	320	33	96	60818	0	61267
4518	60961	44	77	739	0	61821
4519	613	63	89	61906	0	62671
4520	289	40	61614	577	0	62520
4521	245	59	58280	251	0	58835
4522	190	206	513	58535	0	59444
4523	129	52	59809	423	0	60413
4524	87	60986	493	246	0	61812
4525	215	352	226	60341	0	61134
4526	61359	108	125	537	0	62129
4527	410	66	61137	190	0	61803
4528	60532	30	433	261	0	61256
4529	495	35	159	63557	0	64246
4530	261	26	121	64246	0	64654
4531	186	24	76	64620	0	64906
4532	145	20	90	64374	0	64629
4533	64574	24	78	728	0	65404
4534	464	68093	112	320	0	68989
4535	271	607	69	70017	0	70964
4536	214	213	69	70415	0	70911
4537	177	120	74	70681	0	71052
4538	206	50	62	70431	0	70749
4539	69871	40	77	1150	0	71138
4540	678	69230	120	490	0	70518
4541	69045	595	89	399	0	70128
4542	715	65105	109	230	0	66159
4543	258	66281	85	230	0	66854
4544	65358	758	79	247	0	66442
4545	759	311	66102	158	0	67330
4546	415	169	640	66554	0	67778
4547	68289	82	255	891	0	69517
4548	69295	69	152	532	0	70048
4549	62376	266	196	882	0	63720
4550	70581	65	77	367	0	71090
4551	996	72835	82	218	0	74131
4552	74395	836	59	352	0	75642
4553	76432	278	56	308	0	77074
4554	1228	79459	98	185	0	80970
4555	613	1150	69	82583	0	84415
4556	312	373	82589	1318	0	84592
4557	401	222	1230	82599	0	84452
4558	82415	137	379	1781	0	84712
4559	1416	152	85719	533	0	87820
4560	452	84395	1370	438	0	86655
4561	346	1369	86885	272	0	88872
4562	455	595	1453	82718	0	85221
4563	242	84194	540	1212	0	86188
4564	86267	1389	305	631	0	88592
4565	1366	86881	210	356	0	88813
4566	688	1512	164	86963	0	89327
4567	517	511	124	89229	0	90381
4568	87910	339	141	1898	0	90288
4569	1596	207	141	86763	0	88707
4570	568	86746	174	1589	0	89077
4571	87898	1355	148	832	0	90233
4572	88561	468	138	655	0	89822
4573	1786	88461	146	331	0	90724
4574	88883	1461	88	521	0	90953
4575	1641	87651	145	308	0	89745
4576	87526	1573	114	477	0	89690
4577	1656	87638	116	381	0	89791
4578	850	1597	144	85336	0	87927
4579	632	581	112	89579	0	90904
4580	88409	409	116	1924	0	90858
4581	89971	290	123	953	0	91337
4582	1864	88688	159	496	0	91207
4583	876	1549	87601	334	0	90360
4584	89857	604	1329	464	0	92254
4585	1807	489	446	90979	0	93721
4586	723	90143	327	1541	0	92734
4587	709	1542	160	92005	0	94416
4588	91771	556	142	1980	0	94449
4589	92581	484	110	907	0	94082
4590	93368	311	124	790	0	94593
4591	2366	303	87	91732	0	94488
4592	1019	368	90680	1676	0	93743
4593	87185	302	1350	943	0	89780
4594	88450	322	475	819	0	90066
4595	91032	295	331	613	0	92271
4596	2244	88331	224	451	0	91250
4597	1118	1547	183	89856	0	92704
4598	810	90982	168	1681	0	93641
4599	784	1799	189	91280	0	94052
4600	766	715	150	93209	0	94840
4601	577	586	95524	2206	0	98893
4602	774	409	1745	101745	0	104673
4603	719	358	568	105708	0	107353
4604	104675	340	378	3311	0	108704
4605	2602	105345	252	1253	0	109452
4606	105837	2520	208	982	0	109547
4607	111278	935	181	781	0	113175
4608	3757	753	174	109184	0	113868
4609	1615	475	109770	2826	0	114686
4610	954	106178	2440	1128	0	110700
4611	690	107301	783	858	0	109632
4612	104300	3284	635	930	0	109149
4613	2864	105484	343	642	0	109333
4614	1402	2947	209	103714	0	108272
4615	1119	1072	233	107251	0	109675
4616	731	776	104260	3398	0	109165
4617	747	608	103430	1326	0	106111
4618	670	103685	3023	849	0	108227
4619	851	2748	1036	104282	0	108917
4620	104123	1043	536	3017	0	108719
4621	3040	761	378	105450	0	109629
4622	1146	644	106282	3166	0	111238
4623	1016	571	2640	106183	0	110410
4624	103837	492	862	3500	0	108691
4625	104837	476	514	1595	0	107422
4626	3474	103337	387	1034	0	108232
4627	103829	2809	275	1024	0	107937
4628	3250	103514	333	771	0	107868
4629	103648	3006	296	791	0	107741
4630	3587	1269	273	101658	0	106787
4631	1482	802	100542	2936	0	105762
4632	1193	593	98917	1163	0	101866
4633	803	100733	3086	905	0	105527
4634	1166	2495	1220	97050	0	101931
4635	874	937	559	100470	0	102840
4636	99211	611	332	3402	0	103556
4637	100583	482	277	1550	0	102892
4638	102438	474	284	1082	0	104278
4639	3803	492	272	100420	0	104987
4640	1699	552	249	102701	0	105201
4641	1265	486	277	103847	0	105875
4642	1941	522	99630	3587	0	105680
4643	813	521	99406	1456	0	102196
4644	99317	464	2895	1224	0	103900
4645	99339	457	1077	1053	0	101926
4646	3225	443	98851	807	0	103326
4647	97593	443	2533	940	0	101509
4648	96538	385	957	1124	0	99004
4649	3392	406	94892	773	0	99463
4650	1495	94816	2563	782	0	99656
4651	1427	2700	1075	92194	0	97396
4652	975	867	93615	2627	0	98084
4653	772	94822	2432	1248	0	99274
4654	1058	2867	875	87369	0	92169
4655	682	89596	621	2145	0	93044
4656	692	2224	87969	985	0	91870
4657	697	958	88898	712	0	91265
4658	914	1159	2725	88225	0	93023
4659	88528	441	1133	2517	0	92619
4660	2624	478	544	88643	0	92289
4661	88175	427	398	2699	0	91699
4662	2778	455	409	88467	0	92109
4663	1174	482	87122	2656	0	91434
4664	86082	415	2253	1434	0	90184
4665	2471	454	87226	893	0	91044
4666	88308	409	2466	837	0	92020
4667	2723	475	1046	86411	0	90655
4668	1168	87230	746	2415	0	91559
4669	961	2170	587	88342	0	92060
4670	734	89240	583	2663	0	93220
4671	904	2313	593	86408	0	90218
4672	767	89482	544	2532	0	93325
4673	88838	2317	526	1394	0	93075
4674	90237	883	460	1151	0	92731
4675	89967	606	504	965	0	92042
4676	3338	484	87345	783	0	91950
4677	1629	484	2362	87662	0	92137
4678	1155	511	88505	2507	0	92678
4679	897	84854	2595	1197	0	89543
4680	843	88836	1161	848	0	91688
4681	86379	2674	831	892	0	90776
4682	2598	1091	86239	656	0	90584
4683	1193	85354	2405	723	0	89675
4684	1077	2376	1084	86831	0	91368
4685	85655	997	716	2736	0	90104
4686	2417	87069	612	1144	0	91242
4687	88679	2364	494	984	0	92521
4688	2816	1002	87646	748	0	92212
4689	1444	631	2366	89468	0	93909
4690	1041	450	1089	91841	0	94421
4691	848	419	765	94106	0	96138
4692	729	91799	670	3476	0	96674
4693	1137	2622	582	88895	0	93236
4694	795	978	93547	3108	0	98428
4695	982	576	2567	93008	0	97133
4696	894	427	1108	95638	0	98067
4697	992	364	695	94272	0	96323
4698	792	90967	608	3410	0	95777
4699	968	2333	569	91878	0	95748
4700	1094	1105	552	91853	0	94604
4701	570	85722	543	3098	0	89933
4702	79192	1690	370	1229	0	82481
4703	1729	78039	330	749	0	80847
4704	652	78108	321	564	0	79645
4705	875	2304	435	76383	0	79997
4706	433	696	75946	1726	0	78801
4707	70445	508	1513	826	0	73292
4708	1555	295	528	73162	0	75540
4709	512	271	71857	1597	0	74237
4710	280	71819	1408	783	0	74290
4711	371	1466	537	72786	0	75160
4712	270	486	73360	1662	0	75778
4713	413	473	1466	71771	0	74123
4714	414	322	481	72868	0	74085
4715	70736	212	325	2019	0	73292
4716	1436	70320	226	825	0	72807
4717	70506	1382	234	648	0	72770
4718	1601	537	70433	369	0	72940
4719	593	70669	1385	410	0	73057
4720	392	1430	71180	329	0	73331
4721	509	869	1541	71381	0	74300
4722	70789	351	609	1646	0	73395
4723	1450	233	311	70925	0	72919
4724	70949	205	280	1710	0	73144
4725	72522	210	201	793	0	73726
4726	1872	178	193	72943	0	75186
4727	727	215	74471	1613	0	77026
4728	515	239	75627	666	0	77047
4729	415	230	1691	77693	0	80029
4730	369	218	684	79582	0	80853
4731	78592	201	361	2119	0	81273
4732	1620	221	254	78368	0	80463
4733	637	76472	282	1807	0	79198
4734	499	1475	220	78791	0	80985
4735	404	565	196	80130	0	81295
4736	77989	328	200	2313	0	80830
4737	1570	78261	233	985	0	81049
4738	684	1596	187	79906	0	82373
4739	516	584	207	80418	0	81725
4740	293	78135	287	2295	0	81010
4741	358	1603	187	80097	0	82245
4742	369	623	198	79906	0	81096
4743	241	77402	190	2398	0	80231
4744	325	1643	170	79032	0	81170
4745	321	634	178	78715	0	79848
4746	197	76628	227	2403	0	79455
4747	316	1661	175	78201	0	80353
4748	76877	641	160	2400	0	80078
4749	77746	421	165	1243	0	79575
4750	76238	378	142	999	0	77757
4751	76662	324	130	839	0	77955
4752	2158	73278	173	718	0	76327
4753	70425	1488	102	707	0	72722
4754	1659	68509	132	562	0	70862
4755	553	69019	133	476	0	70181
4756	772	1820	334	68224	0	71150
4757	329	591	68274	1599	0	70793
4758	65897	463	1282	757	0	68399
4759	68926	270	352	639	0	70187
4760	1644	264	69227	427	0	71562
4761	69554	210	1218	583	0	71565
4762	72275	198	349	536	0	73358
4763	1719	69418	266	416	0	71819
4764	75237	1331	157	699	0	77424
4765	1711	470	106	74525	0	76812
4766	711	347	132	75432	0	76622
4767	586	271	138	75812	0	76807
4768	471	249	125	75681	0	76526
4769	74635	239	131	2064	0	77069
4770	1580	214	139	74125	0	76058
4771	730	208	131	75044	0	76113
4772	502	236	72498	1860	0	75096
4773	68021	252	1277	1031	0	70581
4774	73715	236	357	765	0	75073
4775	73968	228	258	681	0	75135
4776	1795	71100	222	541	0	73658
4777	732	73026	177	524	0	74459
4778	72704	1477	152	630	0	74963
4779	1629	537	133	72698	0	74997
4780	670	72826	156	1638	0	75290
4781	593	1350	100	72966	0	75009
4782	429	72967	135	1702	0	75233
4783	72933	1441	114	882	0	75370
4784	1486	73019	118	673	0	75296
4785	728	1443	105	72983	0	75259
4786	598	622	113	74345	0	75678
4787	470	414	73764	1806	0	76454
4788	413	76090	1299	844	0	78646
4789	619	2040	421	78158	0	81238
4790	412	680	79436	1989	0	82517
4791	359	450	80458	828	0	82095
4792	557	492	2088	81622	0	84759
4793	527	317	911	82442	0	84197
4794	284	78173	451	2645	0	81553
4795	285	82426	279	1188	0	84178
4796	437	2407	200	82771	0	85815
4797	82481	1017	140	2398	0	86036
4798	2192	611	125	85816	0	88744
4799	86117	406	101	2830	0	89454
4800	89300	353	105	1411	0	91169
4801	90917	308	122	928	0	92275
4802	3192	345	88491	602	0	92630
4803	89281	246	1977	676	0	92180
4804	2869	231	862	89482	0	93444
4805	1508	241	453	90706	0	92908
4806	843	273	88488	2985	0	92589
4807	611	304	87902	1445	0	90262
4808	684	612	2541	86002	0	89839
4809	464	83303	1177	2276	0	87220
4810	409	87158	588	1133	0	89288
4811	676	2435	374	87022	0	90507
4812	86536	1080	272	2398	0	90286
4813	2239	584	210	87405	0	90438
4814	1210	365	197	87770	0	89542
4815	721	86010	224	2896	0	89851
4816	648	1898	181	88713	0	91440
4817	486	904	88016	2599	0	92005
4818	504	561	84726	1373	0	87164
4819	83917	304	2475	1090	0	87786
4820	1978	86182	1192	682	0	90034
4821	86673	1914	582	781	0	89950
4822	87762	913	396	668	0	89739
4823	2852	586	331	83907	0	87676
4824	1331	85259	309	1945	0	88844
4825	923	1953	222	86992	0	90090
4826	85966	939	176	2503	0	89584
4827	2002	83934	207	1261	0	87404
4828	82473	1857	151	940	0	85421
4829	2125	81787	164	566	0	84642
4830	82925	2009	171	618	0	85723
4831	83313	970	166	582	0	85031
4832	2591	80732	218	424	0	83965
4833	1440	1887	240	81725	0	85292
4834	82162	829	292	1969	0	85252
4835	2091	533	78601	965	0	82190
4836	1112	415	78569	630	0	80726
4837	922	1025	2222	77784	0	81953
4838	78777	248	1043	1903	0	81971
4839	1838	214	481	79216	0	81749
4840	79187	275	296	2164	0	81922
4841	2050	316	79265	1053	0	82684
4842	81098	271	1494	843	0	83706
4843	85028	245	753	673	0	86699
4844	2638	244	385	83431	0	86698
4845	1459	241	258	84525	0	86483
4846	924	227	201	84578	0	85930
4847	604	82867	249	2566	0	86286
4848	621	1471	217	83808	0	86117
4849	522	751	267	85806	0	87346
4850	84068	406	244	2714	0	87432
4851	84735	259	252	1555	0	86801
4852	2364	281	82150	860	0	85655
4853	82435	229	1581	800	0	85045
4854	2165	271	82726	596	0	85758
4855	79857	247	1805	723	0	82632
4856	2186	254	81638	490	0	84568
4857	1228	295	80065	507	0	82095
4858	951	429	2213	79069	0	82662
4859	661	225	79700	1853	0	82439
4860	77218	241	1856	1231	0	80546
4861	1790	246	949	80686	0	83671
4862	81754	208	546	2086	0	84594
4863	82803	258	375	1321	0	84757
4864	79231	252	360	835	0	80678
4865	78843	191	279	682	0	79995
4866	2821	192	76719	503	0	80235
4867	1691	138	1513	77236	0	80578
4868	1038	181	78319	1673	0	81211
4869	900	154	1751	78114	0	80919
4870	78259	156	946	2037	0	81398
4871	1894	170	614	78948	0	81626
4872	79371	177	478	2136	0	82162
4873	2059	162	365	80002	0	82588
4874	1195	193	316	81240	0	82944
4875	80146	211	297	2584	0	83238
4876	1891	78822	338	1421	0	82472
4877	80150	1422	234	947	0	82753
4878	2034	79006	240	695	0	81975
4879	1261	1639	208	80649	0	83757
4880	79923	812	224	1958	0	82917
4881	1976	459	78677	1115	0	82227
4882	1211	280	1456	80120	0	83067
4883	80304	242	792	2006	0	83344
4884	82467	212	461	1230	0	84370
4885	2697	217	304	81002	0	84220
4886	1495	80237	323	1913	0	83968
4887	885	80698	278	1067	0	82928
4888	1013	3418	236	75678	0	80345
4889	76675	774	340	1651	0	79440
4890	1541	73350	136	842	0	75869
4891	547	70934	108	327	0	71916
4892	69190	1254	237	340	0	71021
4893	1009	68811	95	170	0	70085
4894	70564	1059	259	280	0	72162
4895	1441	464	152	69999	0	72056
4896	669	255	59	70227	0	71210
4897	260	68285	76	1333	0	69954
4898	198	68229	67	578	0	69072
4899	65186	1152	51	403	0	66792
4900	933	66134	77	203	0	67347
4901	359	70583	75	122	0	71139
4902	477	1416	156	70719	0	72768
4903	71959	602	37	1379	0	73977
4904	1332	320	74526	573	0	76751
4905	75812	167	1442	416	0	77837
4906	1940	91	719	81185	0	83935
4907	917	151	82154	1804	0	85026
4908	456	132	83594	950	0	85132
4909	462	101	2572	84577	0	87712
4910	253	136	87623	2047	0	90059
4911	87089	93	2326	1278	0	90786
4912	89682	126	1227	697	0	91732
4913	2935	158	88349	424	0	91866
4914	1611	126	2232	87674	0	91643
4915	968	131	1209	88168	0	90476
4916	89312	88	614	3162	0	93176
4917	2420	123	481	85958	0	88982
4918	1282	85986	382	2495	0	90145
4919	87603	1904	268	1501	0	91276
4920	2368	85907	341	797	0	89413
4921	1310	89442	290	679	0	91721
4922	912	2883	229	88486	0	92510
4923	797	1362	195	89899	0	92253
4924	724	730	225	90614	0	92293
4925	496	620	85973	3491	0	90580
4926	81788	412	2010	2055	0	86265
4927	2148	84430	1062	1135	0	88775
4928	86719	2199	477	1005	0	90400
4929	87982	1183	395	820	0	90380
4930	3552	667	268	86432	0	90919
4931	1731	85730	290	2469	0	90220
4932	1193	2256	279	88890	0	92618
4933	1021	1160	236	90525	0	92942
4934	89752	678	228	3723	0	94381
4935	89720	506	241	2144	0	92611
4936	3408	523	84928	1257	0	90116
4937	89763	393	1841	1129	0	93126
4938	3053	90267	942	774	0	95036
4939	91948	2453	523	825	0	95749
4940	3088	94724	359	674	0	98845
4941	2018	2817	261	93108	0	98204
4942	1304	1515	262	93787	0	96868
4943	935	91310	285	3695	0	96225
4944	988	2725	228	94860	0	98801
4945	914	1451	241	96074	0	98680
4946	891	835	239	95378	0	97343
4947	701	91548	280	4229	0	96758
4948	859	2757	232	94338	0	98186
4949	771	1540	227	95706	0	98244
4950	746	992	252	96810	0	98800
4951	628	799	91500	4689	0	97616
4952	89505	715	2431	2851	0	95502
4953	2914	613	92156	1794	0	97477
4954	92275	586	2807	1503	0	97171
4955	3298	534	92861	1277	0	97970
4956	92862	521	2969	1234	0	97586
4957	95115	528	1546	1195	0	98384
4958	4283	514	92936	1017	0	98750
4959	2442	545	2867	92425	0	98279
4960	1554	617	88388	3171	0	93730
4961	89191	506	2744	2104	0	94545
4962	3301	534	93811	1385	0	99031
4963	2068	498	92375	1252	0	96193
4964	91619	411	3906	1267	0	97203
4965	3329	91587	2074	1038	0	98028
4966	2090	2499	1249	93631	0	99469
4967	95129	1372	1071	3248	0	100820
4968	3622	841	854	95659	0	100976
4969	2167	726	821	97985	0	101699
4970	95762	554	770	4563	0	101649
4971	97216	471	779	2626	0	101092
4972	4388	524	93529	1731	0	100172
4973	2446	449	94493	1613	0	99001
4974	1769	475	3885	94913	0	101042
4975	1492	414	96514	3541	0	101961
4976	1341	477	3386	96141	0	101345
4977	1385	423	2011	96133	0	99952
4978	1369	430	1176	99598	0	102573
4979	94979	445	957	5009	0	101390
4980	3200	95195	997	2868	0	102260
4981	96433	2594	705	2276	0	102008
4982	96871	1416	743	1935	0	100965
4983	4214	94771	757	1653	0	101395
4984	94320	2608	567	1613	0	99108
4985	3603	1481	92037	1356	0	98477
4986	2342	1290	2283	91184	0	97099
4987	92891	857	1269	3247	0	98264
4988	3139	766	88255	2003	0	94163
4989	90066	548	2141	1553	0	94308
4990	3013	92468	1268	1332	0	98081
4991	101352	2109	872	1317	0	105650
4992	102476	1123	830	1210	0	105639
4993	4456	102129	690	990	0	108265
4994	106298	2700	653	1033	0	110684
4995	4270	1502	676	106024	0	112472
4996	2864	960	482	109285	0	113591
4997	107362	765	499	4323	0	112949
4998	106093	584	419	2573	0	109669
4999	4522	104259	483	1736	0	111000
5000	2630	105422	453	1415	0	109920
5001	1834	3852	369	98620	0	104675
5002	1290	99433	457	2538	0	103718
5003	1133	103136	410	1544	0	106223
5004	96657	2794	698	1131	0	101280
5005	2346	97325	359	736	0	100766
5006	92864	2014	303	721	0	95902
5007	2166	95031	211	485	0	97893
5008	1243	1981	93940	427	0	97591
5009	825	95298	1393	462	0	97978
5010	93185	2319	981	777	0	97262
5011	92511	847	422	434	0	94214
5012	2102	571	91136	224	0	94033
5013	1330	340	1431	88369	0	91470
5014	932	240	650	93186	0	95008
5015	544	276	91973	1931	0	94724
5016	614	243	1491	90328	0	92676
5017	436	240	92338	1876	0	94890
5018	359	267	89218	993	0	90837
5019	89521	170	1858	795	0	92344
5020	1516	90824	985	450	0	93775
5021	91744	1337	553	413	0	94047
5022	1977	684	381	91499	0	94541
5023	1008	515	92632	1398	0	95553
5024	911	376	1320	90342	0	92949
5025	521	92659	700	1546	0	95426
5026	94753	1284	478	993	0	97508
5027	95342	629	321	755	0	97047
5028	2137	495	249	94915	0	97796
5029	1153	340	92517	1480	0	95490
5030	89943	310	1278	861	0	92392
5031	1714	91464	622	555	0	94355
5032	92356	1366	421	507	0	94650
5033	2092	785	255	91452	0	94584
5034	91904	549	210	1515	0	94178
5035	2126	517	170	91109	0	93922
5036	1123	406	90831	1726	0	94086
5037	950	295	87038	1005	0	89288
5038	87508	277	1601	1023	0	90409
5039	1509	90574	886	590	0	93559
5040	89980	1213	780	568	0	92541
5041	90212	668	326	446	0	91652
5042	1610	90238	211	236	0	92295
5043	90288	1346	159	402	0	92195
5044	1636	805	93431	293	0	96165
5045	1038	634	1015	94548	0	97235
5046	788	517	516	95414	0	97235
5047	698	389	333	97367	0	98787
5048	541	469	95109	1777	0	97896
5049	558	431	94783	920	0	96692
5050	487	482	1541	95730	0	98240
5051	422	93544	952	1330	0	96248
5052	453	98348	538	697	0	100036
5053	99201	1627	354	692	0	101874
5054	99999	840	326	677	0	101842
5055	1683	102220	398	476	0	104777
5056	1032	1423	248	104962	0	107665
5057	713	729	276	106335	0	108053
5058	106968	544	407	2096	0	110015
5059	1622	366	346	109579	0	111913
5060	1018	359	393	109275	0	111045
5061	833	364	350	110172	0	111719
5062	694	411	103697	2111	0	106913
5063	678	504	96432	1241	0	98855
5064	103445	255	1728	1116	0	106544
5065	1647	224	921	108527	0	111319
5066	887	276	107646	1774	0	110583
5067	726	359	103757	988	0	105830
5068	105190	334	2043	1020	0	108587
5069	2001	291	116892	611	0	119795
5070	1014	118115	2131	562	0	121822
5071	889	1662	1042	127355	0	130948
5072	661	882	126452	2198	0	130193
5073	126201	613	2267	1257	0	130338
5074	2683	455	1033	133670	0	137841
5075	1374	387	132450	2688	0	136899
5076	1118	237	2514	134833	0	138702
5077	880	264	1271	137141	0	139556
5078	136529	193	813	3932	0	141467
5079	2680	136496	786	2004	0	141966
5080	1642	2353	541	137897	0	142433
5081	138924	1093	367	3099	0	143483
5082	140499	679	374	1723	0	143275
5083	141904	422	332	1227	0	143885
5084	144104	394	349	1008	0	145855
5085	4499	348	378	140678	0	145903
5086	139228	241	407	3218	0	143094
5087	141150	207	456	1867	0	143680
5088	135827	203	384	1556	0	137970
5089	137583	202	628	1286	0	139699
5090	4148	128963	516	902	0	134529
5091	1338	123354	259	398	0	125349
5092	1017	2687	285	122830	0	126819
5093	649	121111	271	1836	0	123867
5094	122151	2055	263	1141	0	125610
5095	2374	966	148	121197	0	124685
5096	121116	355	147	2196	0	123814
5097	122424	252	116	1182	0	123974
5098	2874	198	110	124394	0	127576
5099	1432	185	151	124001	0	125769
5100	775	122469	213	2507	0	125964
5101	123694	1669	142	1419	0	126924
5102	2165	122573	212	700	0	125650
5103	124339	1857	114	780	0	127090
5104	2524	785	124	125118	0	128551
5105	1235	473	122783	2009	0	126500
5106	121999	328	1678	1237	0	125242
5107	119915	264	652	892	0	121723
5108	2848	293	117273	481	0	120895
5109	1440	340	117105	460	0	119345
5110	1277	295	2197	115540	0	119309
5111	124828	244	846	2406	0	128324
5112	129786	246	402	1331	0	131765
5113	132828	213	296	1089	0	134426
5114	135218	246	227	933	0	136624
5115	3634	131084	264	552	0	135534
5116	137868	2230	165	853	0	141116
5117	3409	883	204	135713	0	140209
5118	1930	458	209	137228	0	139825
5119	1321	360	184	141126	0	142991
5120	1133	330	197	143404	0	145064
5121	140505	307	221	4081	0	145114
5122	3323	276	239	145986	0	149824
5123	1571	337	141641	3544	0	147093
5124	1384	274	2625	146110	0	150393
5125	1269	207	1020	148451	0	150947
5126	1152	236	524	148590	0	150502
5127	1201	219	377	148204	0	150001
5128	143629	235	284	4949	0	149097
5129	3417	140676	383	2155	0	146631
5130	1663	144032	344	1391	0	147430
5131	1358	3674	304	144132	0	149468
5132	142104	1367	373	3861	0	147705
5133	146967	715	303	2075	0	150060
5134	4562	474	323	146197	0	151556
5135	2090	479	141123	3797	0	147489
5136	142882	414	2817	2264	0	148377
5137	4076	329	1098	148588	0	154091
5138	2030	418	146804	3934	0	153186
5139	141612	349	3117	2413	0	147491
5140	4069	145268	1221	1465	0	152023
5141	159885	3133	587	1511	0	165116
5142	5252	162711	448	1155	0	169566
5143	3387	4627	308	164585	0	172907
5144	1816	166926	394	5005	0	174141
5145	1921	5759	266	173243	0	181189
5146	166785	2584	265	6838	0	176472
5147	5381	168630	337	3489	0	177837
5148	2955	5062	167459	2035	0	177511
5149	2289	2831	4551	169087	0	178758
5150	1508	1446	170037	5726	0	178717
5151	1822	996	5383	167738	0	175939
5152	1629	754	2598	173609	0	178590
5153	1197	753	166599	7730	0	176279
5154	155410	576	5164	4721	0	165871
5155	5531	597	163703	2591	0	172422
5156	3162	670	161867	1935	0	167634
5157	1894	161161	6796	1887	0	171738
5158	1837	4946	3235	161606	0	171624
5159	1537	2522	1758	165629	0	171446
5160	1719	1499	1155	161452	0	165825
5161	1407	1038	839	168462	0	171746
5162	1022	863	158604	8786	0	169275
5163	152074	661	4778	5252	0	162765
5164	5379	612	160385	3094	0	169470
5165	3236	459	5578	158518	0	167791
5166	156647	428	2891	6406	0	166372
5167	5400	156249	1864	3680	0	167193
5168	3431	5777	1288	153832	0	164328
5169	147898	2282	1186	5951	0	157317
5170	5320	141434	939	3454	0	151147
5171	2560	142484	610	2173	0	147827
5172	139433	5868	783	1873	0	147957
5173	4704	140799	615	1358	0	147476
5174	136518	5133	703	1563	0	143917
5175	5056	137636	612	1753	0	145057
5176	139484	5025	640	1201	0	146350
5177	141915	2475	465	1223	0	146078
5178	6279	140067	572	952	0	147870
5179	3553	4575	498	138918	0	147544
5180	2073	2442	135824	4654	0	144993
5181	135114	1533	4057	2754	0	143458
5182	5151	1126	1924	135836	0	144037
5183	2736	129087	1239	4942	0	138004
5184	1607	135955	874	2828	0	141264
5185	1403	5387	717	136672	0	144179
5186	135133	2596	672	5257	0	143658
5187	4670	1617	133503	2895	0	142685
5188	2771	1114	4012	136661	0	144558
5189	1890	1002	2048	139989	0	144929
5190	1445	823	1303	142471	0	146042
5191	1342	669	863	139930	0	142804
5192	938	132815	925	7450	0	142128
5193	1089	4224	700	138296	0	144309
5194	862	2348	132503	6388	0	142101
5195	964	1535	131664	3612	0	137775
5196	829	1258	134429	2416	0	138932
5197	1085	1104	6184	131693	0	140066
5198	129107	1000	3185	5185	0	138477
5199	4557	954	129376	3007	0	137894
5200	2653	789	130972	2122	0	136536
5201	1882	777	6112	127894	0	136665
5202	128356	711	3126	5520	0	137713
5203	4704	127500	1903	3227	0	137334
5204	128856	4463	1363	2478	0	137160
5205	5576	2467	1253	127797	0	137093
5206	3021	1774	128208	5172	0	138175
5207	2242	2143	4499	124970	0	133854
5208	1539	127720	2530	5459	0	137248
5209	131533	4629	1716	3244	0	141122
5210	4957	2553	130071	2502	0	140083
5211	2527	127551	4452	2005	0	136535
5212	124398	4740	2842	2031	0	134011
5213	5279	2888	1916	123649	0	133732
5214	3090	1595	1256	126784	0	132725
5215	125472	1020	1136	6676	0	134304
5216	127613	926	1179	3862	0	133580
5217	133001	903	1096	2492	0	137492
5218	7726	1014	909	126483	0	136132
5219	3952	123918	828	5494	0	134192
5220	126397	4183	864	3486	0	134930
5221	5340	125783	827	2436	0	134386
5222	121812	4702	774	1726	0	129014
5223	5434	118994	837	1348	0	126613
5224	3348	4796	693	117290	0	126127
5225	118093	2694	629	4754	0	126170
5226	120655	1776	504	3045	0	125980
5227	122800	1175	454	2248	0	126677
5228	123809	1055	497	1790	0	127151
5229	124108	869	474	1641	0	127092
5230	7640	959	116241	1193	0	126033
5231	4679	890	3702	116708	0	125979
5232	2982	876	117400	4140	0	125398
5233	2347	918	116660	2531	0	122456
5234	115834	1006	5586	1790	0	124216
5235	118768	815	3027	1471	0	124081
5236	119991	792	1686	1199	0	123668
5237	7427	1002	1059	112758	0	122246
5238	113727	760	1013	4394	0	119894
5239	5982	108861	742	2712	0	118297
5240	3934	110364	684	1887	0	116869
5241	2046	102251	384	1022	0	105703
5242	93604	3459	972	1027	0	99062
5243	3101	94221	482	828	0	98632
5244	90318	2342	546	615	0	93821
5245	89792	1067	291	590	0	91740
5246	3474	627	86976	462	0	91539
5247	2112	494	2100	86117	0	90823
5248	1539	387	951	91100	0	93977
5249	91126	372	561	3172	0	95231
5250	92558	311	386	1557	0	94812
5251	3811	357	375	90474	0	95017
5252	1973	392	88681	2700	0	93746
5253	1442	463	89240	1340	0	92485
5254	1371	399	2809	90192	0	94771
5255	1351	431	1154	90704	0	93640
5256	1188	414	594	93017	0	95213
5257	89025	471	438	3622	0	93556
5258	90572	437	383	1742	0	93134
5259	3686	88514	367	1081	0	93648
5260	2164	2390	353	89478	0	94385
5261	1579	1137	330	90446	0	93492
5262	1269	89538	386	3267	0	94460
5263	1343	2491	376	90953	0	95163
5264	90557	1141	396	3182	0	95276
5265	3377	645	424	90171	0	94617
5266	2060	465	439	92044	0	95008
5267	89370	451	383	3796	0	94000
5268	90329	365	458	2037	0	93189
5269	90771	409	558	1445	0	93183
5270	4486	959	634	86911	0	92990
5271	2241	398	83648	2821	0	89108
5272	1826	430	82837	1488	0	86581
5273	1462	474	82520	1125	0	85581
5274	1339	79787	2821	930	0	84877
5275	78520	2280	1667	1065	0	83532
5276	2801	1032	76345	783	0	80961
5277	74905	607	2059	849	0	78420
5278	2870	494	1066	74704	0	79134
5279	69911	560	671	2749	0	73891
5280	76866	409	516	1581	0	79372
5281	3162	75803	422	1044	0	80431
5282	78235	1928	370	1036	0	81569
5283	78682	921	439	1082	0	81124
5284	3400	76268	490	931	0	81089
5285	2177	1883	466	78271	0	82797
5286	1495	994	77632	2409	0	82530
5287	1402	555	1953	77218	0	81128
5288	1281	455	1038	79025	0	81799
5289	78367	504	631	3270	0	82772
5290	2854	404	555	78432	0	82245
5291	1706	78975	537	2704	0	83922
5292	1364	2127	464	79992	0	83947
5293	1178	1066	459	81883	0	84586
5294	1166	699	78599	3417	0	83881
5295	1144	76883	2032	2018	0	82077
5296	1185	80157	1023	1361	0	83726
5297	77547	2680	557	1347	0	82131
5298	2569	80302	502	1193	0	84566
5299	1745	2516	498	80544	0	85303
5300	1288	1334	79998	2671	0	85291
5301	1079	80685	2170	1703	0	85637
5302	81624	2317	1164	1288	0	86393
5303	2751	1262	785	81599	0	86397
5304	1761	771	626	83798	0	86956
5305	1250	634	81525	3408	0	86817
5306	1182	641	2175	80383	0	84381
5307	1245	519	1091	82737	0	85592
5308	79857	531	741	3738	0	84867
5309	76981	492	508	2105	0	80086
5310	3260	74598	517	1468	0	79843
5311	71580	1828	367	1193	0	74968
5312	2434	69831	346	982	0	73593
5313	1398	2825	358	65533	0	70114
5314	993	65690	344	2000	0	69027
5315	840	68000	384	1194	0	70418
5316	64265	2267	703	1133	0	68368
5317	62732	887	366	926	0	64911
5318	1935	60992	265	610	0	63802
5319	61729	1350	317	683	0	64079
5320	61942	641	250	697	0	63530
5321	63503	397	251	690	0	64841
5322	2138	370	236	63096	0	65840
5323	63383	417	219	1688	0	65707
5324	1826	388	60790	865	0	63869
5325	60625	342	1219	764	0	62950
5326	1812	372	61967	533	0	64684
5327	1061	376	1349	63093	0	65879
5328	802	422	552	64834	0	66610
5329	716	402	63249	1829	0	66196
5330	61992	350	1236	1049	0	64627
5331	64277	329	587	756	0	65949
5332	1988	353	65271	583	0	68195
5333	1095	281	1274	64844	0	67494
5334	855	253	614	65693	0	67415
5335	699	235	369	67225	0	68528
5336	65297	224	338	2159	0	68018
5337	65817	230	358	1084	0	67489
5338	2022	321	289	63101	0	65733
5339	925	60338	261	1418	0	62942
5340	608	60470	227	765	0	62070
5341	57995	1263	223	663	0	60144
5342	1207	57860	218	477	0	59762
5343	571	57128	167	481	0	58347
5344	603	1107	220	52883	0	54813
5345	274	371	52911	772	0	54328
5346	230	51755	632	374	0	52991
5347	380	1044	299	51032	0	52755
5348	193	50816	189	724	0	51922
5349	287	634	134	50258	0	51313
5350	50040	229	78	781	0	51128
5351	586	50457	91	310	0	51444
5352	51160	556	60	351	0	52127
5353	50396	235	68	288	0	50987
5354	720	196	49128	178	0	50222
5355	49074	121	480	234	0	49909
5356	717	187	177	50375	0	51456
5357	268	124	50435	546	0	51373
5358	184	49889	474	277	0	50824
5359	269	648	237	49531	0	50685
5360	176	211	107	50101	0	50595
5361	49840	124	57	684	0	50705
5362	533	117	56	49889	0	50595
5363	283	101	50	50310	0	50744
5364	50064	79	53	760	0	50956
5365	495	49684	74	361	0	50614
5366	49688	444	53	323	0	50508
5367	596	205	49236	143	0	50180
5368	47066	143	433	297	0	47939
5369	631	138	50494	116	0	51379
5370	276	51108	491	138	0	52013
5371	51822	491	199	247	0	52759
5372	50258	216	115	296	0	50885
5373	671	163	50425	121	0	51380
5374	356	136	50508	127	0	51127
5375	271	138	51599	139	0	52147
5376	176	53825	725	141	0	54867
5377	226	601	274	54806	0	55907
5378	203	253	58343	612	0	59411
5379	196	201	56712	256	0	57365
5380	290	106	963	57539	0	58898
5381	204	108	58888	798	0	59998
5382	58276	89	919	525	0	59809
5383	67444	73	389	383	0	68289
5384	1559	132	66581	127	0	68399
5385	739	66299	1233	194	0	68465
5386	577	1151	561	66702	0	68991
5387	273	520	67681	1205	0	69679
5388	191	66476	1295	618	0	68580
5389	486	1419	616	66071	0	68592
5390	66087	516	410	1419	0	68432
5391	65998	285	179	769	0	67231
5392	1484	66332	173	430	0	68419
5393	904	1189	126	67101	0	69320
5394	580	499	134	67938	0	69151
5395	415	329	114	67207	0	68065
5396	339	173	137	68213	0	68862
5397	176	192	66243	1898	0	68509
5398	318	161	1088	65777	0	67344
5399	145	153	64770	1523	0	66591
5400	109	63344	1238	736	0	65427
5401	63149	1022	605	632	0	65408
5402	1014	64823	370	309	0	66516
5403	682	1218	187	65481	0	67568
5404	547	555	151	65893	0	67146
5405	64748	341	94	1649	0	66832
5406	1131	177	86	65088	0	66482
5407	498	63335	123	1396	0	65352
5408	445	967	69	65560	0	67041
5409	299	539	110	65868	0	66816
5410	64560	319	98	1713	0	66690
5411	1060	208	62550	863	0	64681
5412	530	61982	786	491	0	63789
5413	341	64071	370	349	0	65131
5414	297	1195	247	63136	0	64875
5415	61899	585	140	1210	0	63834
5416	895	61695	98	630	0	63318
5417	565	1028	69	62925	0	64587
5418	321	509	61889	1093	0	63812
5419	256	325	895	62352	0	63828
5420	62591	172	401	1379	0	64543
5421	62163	134	288	775	0	63360
5422	1433	114	126	61618	0	63291
5423	62567	121	135	1267	0	64090
5424	62357	128	84	756	0	63325
5425	1471	169	61124	433	0	63197
5426	59881	118	931	391	0	61321
5427	1265	60758	456	274	0	62753
5428	61953	975	294	311	0	63533
5429	1307	518	60371	206	0	62402
5430	724	326	1014	61458	0	63522
5431	63138	160	480	1248	0	65026
5432	1254	166	59802	591	0	61813
5433	723	140	60660	384	0	61907
5434	572	133	1494	60344	0	62543
5435	313	114	62262	1234	0	63923
5436	61552	97	1437	669	0	63755
5437	1236	126	63269	434	0	65065
5438	756	88	1448	63834	0	66126
5439	523	115	646	65758	0	67042
5440	66972	105	428	1921	0	69426
5441	1572	114	67046	906	0	69638
5442	716	119	70174	532	0	71541
5443	656	90	1949	73212	0	75907
5444	317	105	74618	1794	0	76834
5445	73408	98	2100	874	0	76480
5446	1904	79	923	74637	0	77543
5447	784	100	74905	1934	0	77723
5448	712	91	1939	74851	0	77593
5449	546	88	874	76810	0	78318
5450	76142	88	576	2651	0	79457
5451	1998	123	75934	1193	0	79248
5452	74447	129	1972	823	0	77371
5453	2270	193	78466	532	0	81461
5454	77533	110	2258	603	0	80504
5455	79202	169	985	559	0	80915
5456	79212	133	642	614	0	80601
5457	2817	75892	454	472	0	79635
5458	78048	1692	356	535	0	80631
5459	78945	641	302	528	0	80416
5460	2846	419	316	77384	0	80965
5461	1283	229	76528	2154	0	80194
5462	75201	163	1903	1141	0	78408
5463	2231	131	78275	791	0	81428
5464	1212	137	2175	77174	0	80698
5465	921	109	1019	80267	0	82316
5466	79264	115	632	2726	0	82737
5467	2125	80270	500	1230	0	84125
5468	1231	1743	364	80207	0	83545
5469	1002	716	292	81505	0	83515
5470	636	515	80121	2628	0	83900
5471	740	208	1910	80060	0	82918
5472	667	173	863	82355	0	84058
5473	775	148	611	80795	0	82329
5474	471	78552	451	2809	0	82283
5475	77708	1663	360	1396	0	81127
5476	78277	625	305	1174	0	80381
5477	2412	77603	302	774	0	81091
5478	74557	1611	244	599	0	77011
5479	2296	826	279	76175	0	79576
5480	949	393	78777	1925	0	82044
5481	628	78160	1831	933	0	81552
5482	511	81018	796	770	0	83095
5483	76881	1583	748	458	0	79670
5484	80906	454	390	426	0	82176
5485	2201	286	216	80639	0	83342
5486	979	176	193	82266	0	83614
5487	707	153	199	82598	0	83657
5488	80341	139	197	2474	0	83151
5489	1954	163	78695	944	0	81756
5490	79841	129	1658	779	0	82407
5491	2146	136	603	81024	0	83909
5492	978	108	385	80332	0	81803
5493	582	79485	353	2235	0	82655
5494	624	1546	305	82273	0	84748
5495	675	480	235	83917	0	85307
5496	536	305	83165	2391	0	86397
5497	490	83710	1697	1019	0	86916
5498	86043	1672	581	895	0	89191
5499	85034	525	385	879	0	86823
5500	88072	329	358	660	0	89419
5501	87703	248	328	692	0	88971
5502	2504	279	83605	493	0	86881
5503	83581	193	1757	575	0	86106
5504	2347	221	84729	494	0	87791
5505	1197	175	1856	83680	0	86908
5506	776	85189	728	1976	0	88669
5507	762	1669	468	86869	0	89768
5508	783	566	366	88368	0	90083
5509	635	373	86810	2457	0	90275
5510	83891	314	1837	1300	0	87342
5511	87064	256	705	944	0	88969
5512	2351	84723	487	895	0	88456
5513	1112	1684	85709	722	0	89227
5514	945	641	1811	86357	0	89754
5515	708	486	86950	2152	0	90296
5516	706	401	85481	999	0	87587
5517	810	411	2151	86318	0	89690
5518	774	341	86596	2131	0	89842
5519	844	294	1939	86380	0	89457
5520	802	301	88818	2289	0	92210
5521	887	290	2010	88875	0	92062
5522	89996	259	838	2611	0	93704
5523	90769	288	578	1372	0	93007
5524	90579	272	488	1188	0	92527
5525	89963	273	454	1101	0	91791
5526	2610	88490	492	876	0	92468
5527	1355	1720	430	89796	0	93301
5528	1040	607	379	91523	0	93549
5529	827	464	88855	2661	0	92807
5530	916	485	1838	87540	0	90779
5531	714	402	87752	2423	0	91291
5532	680	393	83767	1277	0	86117
5533	82915	316	2113	1194	0	86538
5534	1953	87998	928	980	0	91859
5535	89241	1715	668	1022	0	92646
5536	90072	639	551	1010	0	92272
5537	2474	90353	521	801	0	94149
5538	91962	1601	577	1045	0	95185
5539	2427	634	91108	651	0	94820
5540	1071	91060	1650	603	0	94384
5541	91101	1551	893	894	0	94439
5542	1888	619	87537	630	0	90674
5543	84043	396	1316	718	0	86473
5544	1523	86749	630	560	0	89462
5545	87684	1247	449	753	0	90133
5546	87662	460	390	712	0	89224
5547	1727	85181	413	468	0	87789
5548	811	85862	372	362	0	87407
5549	636	87955	359	416	0	89366
5550	641	1492	445	88899	0	91477
5551	564	537	417	89443	0	90961
5552	89717	340	369	1772	0	92198
5553	87781	253	405	945	0	89384
5554	1697	250	86615	576	0	89138
5555	831	275	83163	570	0	84839
5556	589	267	86668	505	0	88029
5557	658	188	1735	87777	0	90358
5558	559	196	89596	1520	0	91871
5559	631	208	1569	88989	0	91397
5560	89910	187	632	1842	0	92571
5561	1660	248	89712	652	0	92272
5562	88859	221	1481	744	0	91305
5563	90727	253	586	658	0	92224
5564	1891	281	91169	424	0	93765
5565	824	92189	1597	464	0	95074
5566	867	1328	695	92163	0	95053
5567	528	551	93753	1579	0	96411
5568	780	278	1729	91221	0	94008
5569	596	240	752	100305	0	101893
5570	98123	238	584	2292	0	101237
5571	2092	243	439	98414	0	101188
5572	855	271	97977	1984	0	101087
5573	856	257	1766	98026	0	100905
5574	99353	237	648	2168	0	102406
5575	2014	98999	522	816	0	102351
5576	100688	1700	500	744	0	103632
5577	2322	1014	629	99554	0	103519
5578	1123	486	99292	1768	0	102669
5579	949	350	95511	658	0	97468
5580	834	335	95244	462	0	96875
5581	380	92898	1894	346	0	95518
5582	90689	1734	1344	632	0	94399
5583	1430	88524	437	271	0	90662
5584	85466	1141	255	345	0	87207
5585	1223	84912	143	149	0	86427
5586	534	1213	130	85952	0	87829
5587	343	344	124	86966	0	87777
5588	290	206	114	87043	0	87653
5589	134	85858	128	1497	0	87617
5590	314	1156	123	90054	0	91647
5591	355	340	103	100431	0	101229
5592	104567	219	107	2339	0	107232
5593	2403	160	116	109211	0	111890
5594	645	196	112755	2422	0	116018
5595	111115	131	2247	1028	0	114521
5596	115294	130	647	730	0	116801
5597	2995	115008	369	406	0	118778
5598	116381	2468	260	535	0	119644
5599	119456	733	162	563	0	120914
5600	3837	363	158	117013	0	121371
5601	1718	291	166	119866	0	122041
5602	1151	177	140	123105	0	124573
5603	121042	186	139	4059	0	125426
5604	122895	175	135	1646	0	124851
5605	3785	209	119040	783	0	123817
5606	119320	146	2623	874	0	122963
5607	122548	155	765	724	0	124192
5608	122843	140	399	755	0	124137
5609	4181	181	117221	495	0	122078
5610	1725	187	118708	436	0	121056
5611	1397	127	3419	118793	0	123736
5612	918	189	120799	3158	0	125064
5613	1124	123	3272	118605	0	123124
5614	1280	179	1162	112789	0	115410
5615	758	119830	799	3387	0	124774
5616	120837	2783	690	1580	0	125890
5617	3513	864	121104	931	0	126412
5618	122806	493	3119	858	0	127276
5619	4244	449	1055	124664	0	130412
5620	122521	311	685	3731	0	127248
5621	4009	118706	655	1482	0	124852
5622	1799	125114	499	1150	0	128562
5623	1527	3779	438	123859	0	129603
5624	1512	1214	418	127291	0	130435
5625	1137	723	123211	4569	0	129640
5626	1482	537	3265	123794	0	129078
5627	120185	370	1174	4626	0	126355
5628	3825	120902	825	1813	0	127365
5629	1811	3262	121094	1178	0	127345
5630	1779	1169	3426	120788	0	127162
5631	1239	691	122430	3807	0	128167
5632	1378	578	3857	121713	0	127526
5633	987	442	122836	4204	0	128469
5634	876	458	119899	1933	0	123166
5635	1085	574	4287	119154	0	125100
5636	119699	433	1784	4373	0	126289
5637	119613	446	1187	1984	0	123230
5638	117089	434	954	1577	0	120054
5639	4661	113852	898	1160	0	120571
5640	116310	3170	767	1213	0	121460
5641	116515	1109	723	1261	0	119608
5642	4897	750	111849	1025	0	118521
5643	2124	111312	3339	1086	0	117861
5644	1926	3556	1379	110453	0	117314
5645	110082	1272	875	4031	0	116260
5646	3877	109714	822	1806	0	116219
5647	112764	3434	694	1539	0	118431
5648	114566	1264	714	1430	0	117974
5649	113822	909	661	1287	0	116679
5650	113357	767	665	1250	0	116039
5651	5304	621	694	109009	0	115628
5652	110084	577	714	4067	0	115442
5653	4618	533	779	107885	0	113815
5654	2095	104704	833	4112	0	111744
5655	1762	2852	842	108082	0	113538
5656	107475	1006	812	4203	0	113496
5657	4198	657	105613	1995	0	112463
5658	2464	540	3252	106561	0	112817
5659	105471	439	1364	4146	0	111420
5660	4289	104089	996	1864	0	111238
5661	105474	3090	841	1524	0	110929
5662	107091	1203	789	1358	0	110441
5663	4890	104345	821	1193	0	111249
5664	104749	3193	809	1145	0	109896
5665	4574	1307	98577	1031	0	105489
5666	2445	939	98393	1026	0	102803
5667	97663	875	3670	1107	0	103315
5668	4396	777	96526	932	0	102631
5669	2479	802	2981	89833	0	96095
5670	1985	90788	1261	2764	0	96798
5671	92943	2705	913	1398	0	97959
5672	3842	90069	774	1077	0	95762
5673	2345	88956	790	992	0	93083
5674	1916	3235	789	93615	0	99555
5675	1692	1258	723	94675	0	98348
5676	1537	912	606	94189	0	97244
5677	1482	758	644	94422	0	97306
5678	1304	714	90081	4051	0	96150
5679	1273	630	2701	89382	0	93986
5680	1247	635	1118	91144	0	94144
5681	88420	633	774	3922	0	93749
5682	3280	633	746	88743	0	93402
5683	1736	634	85415	3488	0	91273
5684	85444	615	2417	1839	0	90315
5685	3514	659	1065	86418	0	91656
5686	1926	601	86860	3020	0	92407
5687	1625	1096	2704	85394	0	90819
5688	1410	86450	1227	2865	0	91952
5689	87698	2296	1004	1590	0	92588
5690	3198	964	83439	1035	0	88636
5691	1254	73304	1960	774	0	77292
5692	67767	1588	1143	775	0	71273
5693	1581	62133	546	550	0	64810
5694	657	58043	353	365	0	59418
5695	56708	1239	942	420	0	59309
5696	1204	54514	346	337	0	56401
5697	534	54190	232	251	0	55207
5698	904	1333	532	52529	0	55298
5699	376	379	51744	845	0	53344
5700	321	51891	736	399	0	53347
5701	423	995	289	50689	0	52396
5702	235	49836	150	661	0	50882
5703	49764	580	146	344	0	50834
5704	666	221	48416	271	0	49574
5705	341	259	521	48726	0	49847
5706	50130	111	206	739	0	51186
5707	662	131	118	50854	0	51765
5708	303	131	50337	646	0	51417
5709	48859	113	554	375	0	49901
5710	51149	123	200	290	0	51762
5711	741	52404	163	187	0	53495
5712	329	552	127	53099	0	54107
5713	253	217	121	54330	0	54921
5714	55005	131	118	723	0	55977
5715	54055	132	131	344	0	54662
5716	795	166	54273	156	0	55390
5717	307	53341	533	151	0	54332
5718	54113	468	185	136	0	54902
5719	598	228	119	53644	0	54589
5720	184	94	54259	492	0	55029
5721	189	133	51112	165	0	51599
5722	292	597	485	51634	0	53008
5723	52267	38	195	427	0	52927
5724	331	51213	67	102	0	51713
5725	55533	316	41	258	0	56148
5726	432	75	32	56305	0	56844
5727	145	52	24	57026	0	57247
5728	113	30	24	57645	0	57812
5729	57274	38	37	504	0	57853
5730	316	57677	35	165	0	58193
5731	132	317	28	59252	0	59729
5732	81	76	30	59124	0	59311
5733	62	59	58449	381	0	58951
5734	113	51	320	57535	0	58019
5735	50	45	59287	381	0	59763
5736	73	57501	332	129	0	58035
5737	82	309	98	58782	0	59271
5738	58178	69	49	386	0	58682
5739	317	67	57300	94	0	57778
5740	130	31	280	57876	0	58317
5741	64	49	57450	323	0	57886
5742	55220	27	300	199	0	55746
5743	317	115	58198	70	0	58700
5744	158	106	290	56800	0	57354
5745	58350	23	83	410	0	58866
5746	377	52614	147	124	0	53262
5747	56415	290	46	157	0	56908
5748	381	52438	105	87	0	53011
5749	155	324	34	58253	0	58766
5750	89	105	57471	343	0	58008
5751	130	152	55545	130	0	55957
5752	122	52	367	58586	0	59127
5753	60580	38	104	487	0	61209
5754	59518	34	74	186	0	59812
5755	469	23	49	59919	0	60460
5756	180	28	47	60761	0	61016
5757	60126	34	42	521	0	60723
5758	403	57616	76	180	0	58275
5759	128	61489	49	138	0	61804
5760	63439	429	39	207	0	64114
5761	484	164	62405	84	0	63137
5762	214	60	420	62653	0	63347
5763	102	89	62341	486	0	63018
5764	158	48	425	62909	0	63540
5765	103	75	63292	504	0	63974
5766	139	118	61562	183	0	62002
5767	155	36	524	64432	0	65147
5768	102	61676	216	445	0	62439
5769	65905	429	93	237	0	66664
5770	475	64542	119	132	0	65268
5771	189	466	69	66651	0	67375
5772	67145	126	86	600	0	67957
5773	563	88	82	68236	0	68969
5774	68977	68	73	663	0	69781
5775	68895	69	59	323	0	69346
5776	69428	55	73	221	0	69777
5777	618	66756	95	174	0	67643
5778	70589	448	75	207	0	71319
5779	596	272	61	71803	0	72732
5780	74236	83	76	778	0	75173
5781	675	94	58	76143	0	76970
5782	76458	64	83	881	0	77486
5783	77621	62	74	396	0	78153
5784	850	76433	103	235	0	77621
5785	361	639	60	83682	0	84742
5786	271	246	90	83784	0	84391
5787	186	86219	94	1153	0	87652
5788	246	1078	76	89607	0	91007
5789	89540	424	99	1488	0	91551
5790	93397	186	93	743	0	94419
5791	91911	117	101	596	0	92725
5792	1746	130	95687	263	0	97826
5793	99374	95	1180	441	0	101090
5794	104060	67	469	386	0	104982
5795	105685	86	218	357	0	106346
5796	2053	103398	170	236	0	105857
5797	999	1303	111	106122	0	108535
5798	580	556	77	107643	0	108856
5799	486	257	82	106758	0	107583
5800	302	228	103818	2148	0	106496
5801	417	134	1330	105257	0	107138
5802	106425	92	567	1939	0	109023
5803	1738	94	264	107525	0	109621
5804	976	91	160	110140	0	111367
5805	539	141	107573	2262	0	110515
5806	387	106207	1538	1061	0	109193
5807	110898	1525	601	725	0	113749
5808	1921	641	267	111187	0	114016
5809	111625	275	188	2044	0	114132
5810	1997	281	108209	869	0	111356
5811	104910	150	1604	735	0	107399
5812	1909	110815	677	516	0	113917
5813	965	1547	110371	397	0	113280
5814	563	697	110314	357	0	111931
5815	735	600	2026	107053	0	110414
5816	395	233	113965	1704	0	116297
5817	344	113111	1725	944	0	116124
5818	519	1453	704	113269	0	115945
5819	465	629	352	115995	0	117441
5820	410	315	236	117137	0	118098
5821	114895	177	205	2425	0	117702
5822	1584	114076	257	1159	0	117076
5823	936	1414	182	117782	0	120314
5824	610	646	213	119446	0	120915
5825	116136	313	185	2408	0	119042
5826	1637	115172	214	1568	0	118591
5827	118499	1521	218	973	0	121211
5828	118532	704	202	825	0	120263
5829	118245	341	180	783	0	119549
5830	2533	326	115816	506	0	119181
5831	1402	286	1468	114324	0	117480
5832	780	114740	747	1753	0	118020
5833	664	117681	437	972	0	119754
5834	716	2084	259	117777	0	120836
5835	569	115603	364	1702	0	118238
5836	123817	1812	250	1389	0	127268
5837	1923	903	121908	705	0	125439
5838	120954	472	1503	868	0	123797
5839	126498	359	658	818	0	128333
5840	2524	338	405	127305	0	130572
5841	128128	314	333	2170	0	130945
5842	2211	133610	323	1175	0	137319
5843	137446	1702	276	1302	0	140726
5844	138404	840	309	1042	0	140595
5845	146763	536	300	993	0	148592
5846	3319	466	146719	645	0	151149
5847	1874	535	146395	679	0	149483
5848	1477	439	2847	149095	0	153858
5849	1122	145602	1458	2573	0	150755
5850	968	152208	841	1430	0	155447
5851	1033	2880	545	151810	0	156268
5852	153160	1451	433	3083	0	158127
5853	2812	862	390	153664	0	157728
5854	1599	628	441	156327	0	158995
5855	154372	500	410	4019	0	159301
5856	2772	153303	452	2164	0	158691
5857	1654	2296	152925	1401	0	158276
5858	1393	1237	149487	1128	0	153245
5859	154799	810	3042	1194	0	159845
5860	2947	701	1528	153468	0	158644
5861	1588	529	157419	2672	0	162208
5862	1345	471	2478	153998	0	158292
5863	1134	449	1241	154349	0	157173
5864	927	488	841	159445	0	161701
5865	951	493	603	157317	0	159364
5866	739	152803	570	3894	0	158006
5867	850	2254	511	157473	0	161088
5868	155066	1133	543	3548	0	160290
5869	2563	153268	643	1877	0	158351
5870	158356	2422	564	1717	0	163059
5871	160639	1256	471	1437	0	163803
5872	161181	921	489	1387	0	163978
5873	3842	760	154227	963	0	159792
5874	155996	628	2297	1309	0	160230
5875	161242	550	1119	1141	0	164052
5876	158456	557	760	1247	0	161020
5877	161243	425	529	1189	0	163386
5878	3939	157857	512	933	0	163241
5879	158874	2380	384	1090	0	162728
5880	3403	1269	156308	725	0	161705
5881	2004	899	2103	154488	0	159494
5882	1652	620	948	158090	0	161310
5883	159555	446	627	3458	0	164086
5884	2977	156606	454	1789	0	161826
5885	153813	2075	318	1336	0	157542
5886	2737	153511	350	759	0	157357
5887	151768	1961	243	863	0	154835
5888	151602	810	222	751	0	153385
5889	2662	159882	282	411	0	163237
5890	161589	2199	308	650	0	164746
5891	167324	942	288	632	0	169186
5892	3692	156110	262	334	0	160398
5893	1553	160985	303	317	0	163158
5894	168758	3192	664	576	0	173190
5895	4038	1340	244	171517	0	177139
5896	173739	773	183	3689	0	178384
5897	178879	507	112	1650	0	181148
5898	181596	366	96	1268	0	183326
5899	181047	328	137	1035	0	182547
5900	5639	171841	282	620	0	178382
5901	2402	179185	269	569	0	182425
5902	181084	4207	240	837	0	186368
5903	4462	1811	178233	313	0	184819
5904	2364	1153	3487	175911	0	182915
5905	1572	609	1410	182326	0	185917
5906	179417	419	778	5209	0	185823
5907	3993	176699	452	2286	0	183430
5908	2303	3569	319	177627	0	183818
5909	1569	1497	218	184395	0	187679
5910	181839	870	184	5857	0	188750
5911	4988	610	150	183408	0	189156
5912	182825	592	166	5518	0	189101
5913	184425	657	212	2686	0	187980
5914	185988	543	173	1720	0	188424
5915	7058	450	220	181613	0	189341
5916	3631	399	285	183724	0	188039
5917	2346	441	189741	5692	0	198220
5918	1869	542	185841	2651	0	190903
5919	190406	432	6511	1882	0	199231
5920	6453	479	2747	196206	0	205885
5921	3131	562	205753	5844	0	215290
5922	2202	508	207342	2793	0	212845
5923	1963	413	8399	207358	0	218133
5924	1500	531	208911	7047	0	217989
5925	1888	580	7355	207408	0	217231
5926	2048	517	3356	209819	0	215740
5927	1292	575	208044	9540	0	219451
5928	1965	436	6728	210710	0	219839
5929	2426	491	3383	204597	0	210897
5930	2008	314	1663	218641	0	222626
5931	1423	573	208275	10982	0	221253
5932	2102	433	6535	214404	0	223474
5933	211901	464	3065	9572	0	225002
5934	7479	211522	1769	4788	0	225558
5935	216218	6425	1098	3536	0	227277
5936	8702	3155	210453	2104	0	224414
5937	213914	1466	6938	2287	0	224605
5938	219356	901	3438	2064	0	225759
5939	219627	1031	2092	1891	0	224641
5940	12071	949	1461	210288	0	224769
5941	6375	897	1385	215916	0	224573
5942	3662	791	197506	10470	0	212429
5943	191219	504	7136	5914	0	204773
5944	8623	190404	3633	3483	0	206143
5945	4262	184750	2003	2585	0	193600
5946	2682	191845	1488	2351	0	198366
5947	3119	8860	1616	182989	0	196584
5948	181150	3740	1277	8004	0	194171
5949	184584	1868	1342	4635	0	192429
5950	9773	1263	176542	3054	0	190632
5951	5411	1070	6501	178349	0	191331
5952	3456	1010	3116	183682	0	191264
5953	2737	1097	176037	9982	0	189853
5954	2483	1117	172215	5369	0	181184
5955	171679	799	8640	3820	0	184938
5956	7538	173151	4069	3159	0	187917
5957	178077	6036	2301	2986	0	189400
5958	181723	2880	1798	2656	0	189057
5959	10691	1529	1459	174932	0	188611
5960	5995	964	1323	180974	0	189256
5961	174924	994	1286	10126	0	187330
5962	8780	919	1386	175918	0	187003
5963	5283	890	1457	179182	0	186812
5964	174619	886	1517	10688	0	187710
5965	8629	897	1395	177167	0	188088
5966	177626	815	1443	9507	0	189391
5967	181002	723	1505	5865	0	189095
5968	10455	811	171907	3881	0	187054
5969	174972	738	7044	3536	0	186290
5970	178102	760	3916	3364	0	186142
5971	177673	727	2613	3384	0	184397
5972	11104	1258	139217	3714	0	155293
5973	168156	714	5820	3341	0	178031
5974	8975	164151	3283	3275	0	179684
5975	171242	5786	2324	3460	0	182812
5976	175345	2700	1903	3295	0	183243
5977	10981	1330	1761	170101	0	184173
5978	6398	795	1629	172559	0	181381
5979	4115	167698	1562	10633	0	184008
5980	3913	5990	1321	173704	0	184928
5981	3647	2943	1541	178157	0	186288
5982	172535	1549	1481	11283	0	186848
5983	9287	1089	1319	173144	0	184839
5984	6197	1039	1219	175672	0	184127
5985	4620	1019	1295	174815	0	181749
5986	3756	162906	1412	11558	0	179632
5987	162661	6069	1478	6601	0	176809
5988	8958	162638	1545	4312	0	177453
5989	153472	6285	1389	3364	0	164510
5990	8703	2923	145295	3040	0	159961
5991	141264	1614	5496	2876	0	151250
5992	7966	1099	140761	2724	0	152550
5993	4668	135964	5979	2578	0	149189
5994	130689	5055	4416	2280	0	142440
5995	128184	2740	2010	2165	0	135099
5996	7466	120213	1203	2049	0	130931
5997	4278	122901	1095	1808	0	130082
5998	120958	5367	1079	1892	0	129296
5999	123662	2472	998	1799	0	128931
6000	7306	1318	777	119758	0	129159
6001	4316	1148	706	123643	0	129813
6002	2792	1111	117399	6458	0	127760
6003	116767	896	3880	3570	0	125113
6004	5765	912	2112	116833	0	125622
6005	3682	115904	1238	5008	0	125832
6006	2965	3790	663	118774	0	126192
6007	2476	2114	613	120537	0	125740
6008	2075	1200	114303	6624	0	124202
6009	2163	1253	3535	116666	0	123617
6010	113883	906	1952	5867	0	122608
6011	4736	109831	1030	3586	0	119183
6012	2973	112007	635	2329	0	117944
6013	111466	4898	937	1874	0	119175
6014	112991	2551	719	1797	0	118058
6015	112901	1384	670	1702	0	116657
6016	6794	105337	697	1323	0	114151
6017	2594	98808	475	779	0	102656
6018	104012	3314	885	841	0	109052
6019	106368	1589	710	1037	0	109704
6020	4865	100146	472	870	0	106353
6021	1139	90664	188	486	0	92477
6022	89075	2310	480	554	0	92419
6023	2507	880	157	87936	0	91480
6024	88804	458	122	2243	0	91627
6025	2566	442	90	88316	0	91414
6026	1054	87711	167	2134	0	91066
6027	724	90335	132	891	0	92082
6028	92349	2513	300	723	0	95885
6029	92702	961	279	768	0	94710
6030	96512	540	128	573	0	97753
6031	3381	94441	153	356	0	98331
6032	1105	2393	89669	246	0	93413
6033	655	90915	1938	248	0	93756
6034	88399	2669	803	386	0	92257
6035	86213	739	289	473	0	87714
6036	2731	489	84111	173	0	87504
6037	930	83232	1924	159	0	86245
6038	934	2148	640	83502	0	87224
6039	672	719	261	82844	0	84496
6040	615	74069	325	3061	0	78070
6041	523	2158	80572	687	0	83940
6042	82990	689	1946	495	0	86120
6043	2486	531	500	84070	0	87587
6044	84646	383	301	2303	0	87633
6045	86249	357	173	860	0	87639
6046	3016	374	183	86390	0	89963
6047	1415	370	188	90911	0	92884
6048	1009	395	212	93158	0	94774
6049	913	410	138	94467	0	95928
6050	91488	400	132	3795	0	95815
6051	93632	348	186	1567	0	95733
6052	3569	429	91178	844	0	96020
6053	1674	379	2338	92401	0	96792
6054	1180	360	734	94939	0	97213
6055	957	358	433	95924	0	97672
6056	765	406	91367	3710	0	96248
6057	957	337	2439	91225	0	94958
6058	90430	302	829	3472	0	95033
6059	3149	330	487	91054	0	95020
6060	1293	360	89836	3360	0	94849
6061	1137	368	2551	90559	0	94615
6062	789	412	90113	3361	0	94675
6063	91184	357	2795	1647	0	95983
6064	3200	286	955	92623	0	97064
6065	92630	256	577	3479	0	96942
6066	92807	286	401	1640	0	95134
6067	3865	299	369	91323	0	95856
6068	92786	302	358	3551	0	96997
6069	3706	321	343	91194	0	95564
6070	1600	93409	386	3280	0	98675
6071	97556	2625	368	1621	0	102170
6072	98872	878	369	1239	0	101358
6073	100248	567	316	1051	0	102182
6074	4498	393	305	97341	0	102537
6075	2054	317	295	99171	0	101837
6076	1443	328	260	100097	0	102128
6077	1004	449	92969	4486	0	98908
6078	1010	91451	2757	2024	0	97242
6079	1199	2627	812	91791	0	96429
6080	970	879	89642	3407	0	94898
6081	89293	526	2810	1686	0	94315
6082	3397	358	969	90472	0	95196
6083	1479	317	88422	3491	0	93709
6084	90385	258	2625	1864	0	95132
6085	3407	276	924	92192	0	96799
6086	1633	267	580	94003	0	96483
6087	1345	217	453	95438	0	97453
6088	92984	215	444	4441	0	98084
6089	94437	258	447	2225	0	97367
6090	93391	259	456	1609	0	95715
6091	4015	86336	521	1247	0	92119
6092	1780	89899	477	1173	0	93329
6093	91002	2755	420	1189	0	95366
6094	3401	933	88108	1214	0	93656
6095	1664	673	2470	88290	0	93097
6096	1422	434	874	91319	0	94049
6097	88744	253	591	3954	0	93542
6098	87307	281	455	2035	0	90078
6099	3515	85234	480	1397	0	90626
6100	1908	2313	397	87320	0	91938
6101	1385	765	84825	3316	0	90291
6102	1160	541	84929	1679	0	88309
6103	1227	340	2912	86636	0	91115
6104	1121	271	1119	90001	0	92512
6105	87085	221	723	4180	0	92209
6106	3200	278	540	88618	0	92636
6107	89799	308	460	4004	0	94571
6108	90189	251	486	2063	0	92989
6109	3788	346	85399	1413	0	90946
6110	89471	251	2229	1428	0	93379
6111	91538	254	922	1370	0	94084
6112	91270	213	668	1390	0	93541
6113	3955	86382	618	1258	0	92213
6114	1830	88850	513	1259	0	92452
6115	1603	3235	447	88047	0	93332
6116	1187	887	86934	3341	0	92349
6117	1061	83688	2245	1590	0	88584
6118	1296	2275	902	77732	0	82205
6119	1024	599	640	76458	0	78721
6120	910	75154	442	2314	0	78820
6121	76265	1616	344	1394	0	79619
6122	77480	578	374	1160	0	79592
6123	2675	428	76618	908	0	80629
6124	75980	281	1594	967	0	78822
6125	2376	294	74456	857	0	77983
6126	70642	243	1699	878	0	73462
6127	2296	287	71141	721	0	74445
6128	1106	68399	1447	548	0	71500
6129	1267	1114	930	65323	0	68634
6130	828	430	518	65737	0	67513
6131	66149	279	286	1708	0	68422
6132	66796	168	270	1029	0	68263
6133	66250	144	224	816	0	67434
6134	1728	165	66173	632	0	68698
6135	1002	174	1055	66829	0	69060
6136	789	194	488	68543	0	70014
6137	68187	141	355	1714	0	70397
6138	1370	67765	301	897	0	70333
6139	71357	978	221	905	0	73461
6140	1552	491	221	72519	0	74783
6141	966	292	256	74142	0	75656
6142	746	209	219	74634	0	75808
6143	618	194	176	75138	0	76126
6144	642	331	168	74804	0	75945
6145	520	70925	228	1918	0	73591
6146	444	69109	169	873	0	70595
6147	299	66743	113	380	0	67535
6148	318	940	137	67183	0	68578
6149	284	258	65898	687	0	67127
6150	61837	189	628	421	0	63075
6151	722	66792	256	230	0	68000
6152	457	527	204	67273	0	68461
6153	300	194	144	68196	0	68834
6154	69043	137	106	939	0	70225
6155	68485	71	107	534	0	69197
6156	69703	94	89	393	0	70279
6157	1047	103	58	72521	0	73729
6158	472	92	73109	779	0	74452
6159	360	140	74263	326	0	75089
6160	305	92	829	76002	0	77228
6161	219	89	76260	890	0	77458
6162	73875	77	808	496	0	75256
6163	910	108	261	75320	0	76599
6164	382	126	75583	844	0	76935
6165	463	96	703	73840	0	75102
6166	266	89	77878	958	0	79191
6167	254	132	80693	382	0	81461
6168	454	424	970	85236	0	87084
6169	181	98	89643	1071	0	90993
6170	198	129	85049	384	0	85760
6171	137	82213	1514	272	0	84136
6172	563	1287	744	86102	0	88696
6173	90994	384	387	1358	0	93123
6174	1237	273	138	90390	0	92038
6175	581	137	93	93622	0	94433
6176	342	104	92298	1604	0	94348
6177	88034	59	1097	997	0	90187
6178	1308	42	406	94737	0	96493
6179	578	35	306	96965	0	97884
6180	95578	38	189	1765	0	97570
6181	1346	37	113	96730	0	98226
6182	96856	40	122	1884	0	98902
6183	97225	49	118	949	0	98341
6184	97184	53	81	735	0	98053
6185	1831	93806	130	361	0	96128
6186	96867	1091	87	409	0	98454
6187	1598	95340	116	231	0	97285
6188	774	1351	75	97169	0	99369
6189	97923	512	91	1456	0	99982
6190	1357	97217	150	574	0	99298
6191	98916	1264	103	636	0	100919
6192	1534	97511	131	332	0	99508
6193	98032	1486	115	388	0	100021
6194	1591	95231	158	253	0	97233
6195	697	98037	121	225	0	99080
6196	502	103168	100	280	0	104050
6197	434	1872	81	101352	0	103739
6198	240	103490	158	1273	0	105161
6199	387	1735	88	103873	0	106083
6200	354	755	97	105225	0	106431
6201	355	487	102	105278	0	106222
6202	353	264	65	106137	0	106819
6203	104502	197	63	2476	0	107238
6204	105428	170	82	1308	0	106988
6205	1990	198	103215	730	0	106133
6206	107222	160	1394	758	0	109534
6207	113228	150	509	597	0	114484
6208	117184	153	386	611	0	118334
6209	2914	229	114293	300	0	117736
6210	1297	250	114892	316	0	116755
6211	115565	170	2476	559	0	118770
6212	2624	219	119596	321	0	122760
6213	1020	124358	2514	362	0	128254
6214	1095	2368	843	126828	0	131134
6215	130963	773	541	2795	0	135072
6216	132198	530	379	1266	0	134373
6217	133592	313	308	918	0	135131
6218	3857	269	304	131949	0	136379
6219	1812	217	263	134943	0	137235
6220	1065	295	133961	3407	0	138728
6221	1081	214	2470	134941	0	138706
6222	882	193	851	139249	0	141175
6223	136574	181	604	3980	0	141339
6224	2978	136695	488	1585	0	141746
6225	139536	2614	329	1272	0	143751
6226	3520	934	286	140033	0	144773
6227	139168	641	302	3375	0	143486
6228	139567	376	313	1520	0	141776
6229	135808	301	347	1404	0	137860
6230	3879	132375	383	855	0	137492
6231	1752	137306	394	730	0	140182
6232	1378	3079	325	138279	0	143061
6233	139136	1173	354	3317	0	143980
6234	3363	725	379	137542	0	142009
6235	1685	548	308	139743	0	142284
6236	1197	506	136690	3827	0	142220
6237	1323	428	2531	136690	0	140972
6238	1157	420	878	137698	0	140153
6239	1144	318	601	138396	0	140459
6240	923	317	134421	4245	0	139906
6241	948	362	131087	2046	0	134443
6242	817	132440	3210	1530	0	137997
6243	133933	2660	1224	1359	0	139176
6244	3394	963	798	135077	0	140232
6245	1518	748	134885	3215	0	140366
6246	1535	492	2685	134534	0	139246
6247	1371	383	919	143182	0	145855
6248	140672	350	684	4412	0	146118
6249	141206	358	565	2208	0	144337
6250	3878	139122	609	1397	0	145006
6251	139859	2703	564	1350	0	144476
6252	140484	1021	619	1072	0	143196
6253	4374	864	602	138485	0	144325
6254	2038	822	136772	3189	0	142821
6255	1516	137036	2746	1526	0	142824
6256	138167	2941	988	1577	0	143673
6257	139841	1094	663	1416	0	143014
6258	4084	139376	505	1165	0	145130
6259	2280	2798	370	144529	0	149977
6260	148913	967	402	4257	0	154539
6261	151410	691	445	2179	0	154725
6262	4723	525	454	151168	0	156870
6263	149918	529	511	4767	0	155725
6264	160862	451	429	2325	0	164067
6265	162815	459	551	1863	0	165688
6266	5875	615	158305	1263	0	166058
6267	2670	152634	3393	1337	0	160034
6268	1965	157179	1134	1195	0	161473
6269	151269	3884	973	1384	0	157510
6270	4273	151390	566	1021	0	157250
6271	1967	3687	150542	857	0	157053
6272	1911	1359	3292	151009	0	157571
6273	151451	867	997	4034	0	157349
6274	4444	732	585	151110	0	156871
6275	152182	599	424	4474	0	157679
6276	153477	558	414	2034	0	156483
6277	153209	511	489	1646	0	155855
6278	5029	145194	684	1281	0	152188
6279	2089	154983	609	1236	0	158917
6280	154574	4003	515	1519	0	160611
6281	153503	1399	460	1563	0	156925
6282	156751	902	488	1370	0	159511
6283	5416	720	479	153030	0	159645
6284	152395	616	457	4373	0	157841
6285	4692	146257	530	1772	0	153251
6286	2204	153572	474	1551	0	157801
6287	1989	3995	421	152811	0	159216
6288	1627	1383	149781	4106	0	156897
6289	1602	963	147878	1719	0	152162
6290	1815	750	3826	149935	0	156326
6291	1469	823	150273	4011	0	156576
6292	1822	837	3570	150949	0	157178
6293	152466	795	1092	4417	0	158770
6294	4758	657	743	152090	0	158248
6295	150538	627	708	4615	0	156488
6296	4495	146082	734	1812	0	153123
6297	2145	3601	147726	1253	0	154725
6298	2022	1376	3347	144941	0	151686
6299	1818	1021	1106	151393	0	155338
6300	1435	967	148994	4613	0	156009
6301	1841	785	3451	145964	0	152041
6302	1472	148191	1201	4255	0	155119
6303	1773	3489	750	152945	0	158957
6304	1826	1198	595	155738	0	159357
6305	2132	799	477	158437	0	161845
6306	1714	703	154703	5416	0	162536
6307	1524	636	145690	2183	0	150033
6308	138230	488	4034	1615	0	144367
6309	3972	531	139904	937	0	145344
6310	1538	139720	3545	856	0	145659
6311	140477	2971	1349	1082	0	145879
6312	3737	140741	848	774	0	146100
6313	137201	3093	1043	998	0	142335
6314	138419	1034	721	938	0	141112
6315	136780	701	509	851	0	138841
6316	137039	591	441	861	0	138932
6317	4035	130551	469	722	0	135777
6318	1778	133987	400	615	0	136780
6319	134543	3196	477	808	0	139024
6320	3651	1222	130302	527	0	135702
6321	1796	903	2733	128823	0	134255
6322	1402	591	937	133257	0	136187
6323	1101	580	130884	3404	0	135969
6324	124252	519	2757	1518	0	129046
6325	132610	529	927	1044	0	135110
6326	131841	537	605	955	0	133938
6327	4065	128199	570	742	0	133576
6328	134063	2878	543	960	0	138444
6329	3931	1053	537	129871	0	135392
6330	1718	137207	607	2792	0	142324
6331	141414	3180	520	1420	0	146534
6332	144204	1350	521	1110	0	147185
6333	151479	945	484	1015	0	153923
6334	5596	755	420	147948	0	154719
6335	2901	709	425	149569	0	153604
6336	1713	143583	557	4742	0	150595
6337	1502	3475	145688	2083	0	152748
6338	1708	1473	3388	145997	0	152566
6339	1748	894	1441	145670	0	149753
6340	1497	730	847	153555	0	156629
6341	1181	676	148669	5470	0	155996
6342	146984	581	3590	2761	0	153916
6343	4496	606	1520	152365	0	158987
6344	2212	622	152092	4406	0	159332
6345	1774	539	3885	151345	0	157543
6346	153448	500	1673	5071	0	160692
6347	4548	152289	1107	2416	0	160360
6348	2399	3991	790	157523	0	164703
6349	1545	1690	156808	4798	0	164841
6350	151730	966	4177	2647	0	159520
6351	158739	680	1851	1904	0	163174
6352	5841	666	156164	1417	0	164088
6353	3020	1106	4251	148519	0	156896
6354	1748	153439	1942	4125	0	161254
6355	156928	4070	1363	2243	0	164604
6356	5060	1681	152543	1513	0	160797
6357	150535	1082	4358	1541	0	157516
6358	5712	818	148976	1062	0	156568
6359	3082	685	141467	987	0	146221
6360	136811	670	5026	1240	0	143747
6361	4193	140079	2279	1171	0	147722
6362	2794	3470	138764	895	0	145923
6363	1681	135992	3751	1058	0	142482
6364	1742	3519	132740	863	0	138864
6365	973	133205	3467	771	0	138416
6366	127519	3490	2153	1084	0	134246
6367	3244	1454	125639	767	0	131104
6368	1817	963	124061	709	0	127550
6369	1342	671	122387	627	0	125027
6370	120819	701	4371	733	0	126624
6371	123309	406	1973	710	0	126398
6372	3847	421	1146	120324	0	125738
6373	1960	409	124528	2666	0	129563
6374	1305	406	124292	1432	0	127435
6375	125134	466	3639	1045	0	130284
6376	3185	455	1911	127505	0	133056
6377	128145	391	1154	2926	0	132616
6378	129460	342	952	1595	0	132349
6379	4188	425	801	122906	0	128320
6380	2249	122144	883	2700	0	127976
6381	1520	2411	859	125245	0	130035
6382	1292	1277	696	127308	0	130573
6383	1072	820	124689	3780	0	130361
6384	984	120734	2914	2090	0	126722
6385	957	125252	1706	1162	0	129077
6386	984	3259	1160	123324	0	128727
6387	818	1631	123428	2820	0	128697
6388	786	122430	3066	1660	0	127942
6389	939	2702	123746	1110	0	128497
6390	121032	1434	3432	1095	0	126993
6391	125870	860	1888	981	0	129599
6392	3941	707	122903	722	0	128273
6393	122993	574	3167	924	0	127658
6394	3659	599	1841	124636	0	130735
6395	2099	128471	1360	2716	0	134646
6396	1609	2649	1107	132066	0	137431
6397	128741	1370	1084	3438	0	134633
6398	130513	818	1037	1880	0	134248
6399	130521	627	997	1280	0	133425
6400	129514	578	871	1045	0	132008
6401	4486	123673	1065	898	0	130122
6402	2253	126258	993	768	0	130272
6403	126328	3128	1054	906	0	131416
6404	3516	1615	126035	722	0	131888
6405	2249	2540	2748	124821	0	132358
6406	1275	131034	1582	2764	0	136655
6407	1192	2781	1081	131428	0	136482
6408	780	133970	950	3074	0	138774
6409	1051	3323	810	136269	0	141453
6410	872	1554	135337	3408	0	141171
6411	133112	975	3232	1942	0	139261
6412	136950	714	1695	1265	0	140624
6413	4221	876	134136	667	0	139900
6414	133911	732	3377	884	0	138904
6415	136899	608	1833	864	0	140204
6416	4617	646	133005	557	0	138825
6417	2641	520	3466	130310	0	136937
6418	134003	446	1942	3244	0	139635
6419	3939	514	132584	1524	0	138561
6420	2449	605	3362	129359	0	135775
6421	1587	445	135646	3256	0	140934
6422	1325	549	132628	1736	0	136238
6423	133636	603	4452	1373	0	140064
6424	139168	533	2211	1047	0	142959
6425	140439	434	1163	977	0	143013
6426	144476	458	956	858	0	146748
6427	5482	639	814	138457	0	145392
6428	2637	130807	933	3293	0	137670
6429	1641	135733	831	1661	0	139866
6430	1435	3934	665	131667	0	137701
6431	132401	1376	730	3246	0	137753
6432	3574	127098	646	1394	0	132712
6433	1245	127691	464	652	0	130052
6434	127487	3060	478	677	0	131702
6435	3316	1359	401	126664	0	131740
6436	127959	618	408	3038	0	132023
6437	3191	127135	423	1080	0	131829
6438	130396	2736	360	935	0	134427
6439	3596	996	132474	455	0	137521
6440	145180	751	3121	716	0	149768
6441	151406	466	1053	753	0	153678
6442	155043	397	683	764	0	156887
6443	5967	765	134136	768	0	141636
6444	149202	497	3013	728	0	153440
6445	5079	147981	1190	492	0	154742
6446	2203	3625	148164	329	0	154321
6447	2192	1815	3952	141827	0	149786
6448	1647	872	1473	140223	0	144215
6449	888	141344	892	4462	0	147586
6450	1188	3460	591	144596	0	149835
6451	1117	1253	523	147618	0	150511
6452	917	782	141200	4969	0	147868
6453	135974	482	3720	2342	0	142518
6454	4192	477	142192	1233	0	148094
6455	2025	458	4131	141561	0	148175
6456	1382	381	144251	4067	0	150081
6457	1168	309	4389	145180	0	151046
6458	147456	253	1807	4929	0	154445
6459	153026	293	1144	2110	0	156573
6460	5803	283	829	151589	0	158504
6461	2435	311	152089	4805	0	159640
6462	2011	271	4363	152869	0	159514
6463	1351	342	150547	5124	0	157364
6464	147496	331	4679	2392	0	154898
6465	153851	342	1822	1737	0	157752
6466	150198	400	1197	1449	0	153244
6467	151736	386	846	1332	0	154300
6468	6424	142629	821	1013	0	150887
6469	3323	4068	634	146738	0	154763
6470	144743	1489	583	4965	0	151780
6471	5236	140644	725	2061	0	148666
6472	2427	146946	667	1492	0	151532
6473	1940	5112	137820	1056	0	145928
6474	138892	1977	4385	991	0	146245
6475	143991	1163	1815	876	0	147845
6476	6526	808	136949	724	0	145007
6477	3536	613	4611	136397	0	145157
6478	2594	531	1887	141925	0	146937
6479	1924	512	138760	5633	0	146829
6480	1988	427	4837	137992	0	145244
6481	138634	428	2059	5591	0	146712
6482	5388	535	133610	2393	0	141926
6483	2530	447	138361	1765	0	143103
6484	136759	424	5770	1495	0	144448
6485	5573	555	138209	1133	0	145470
6486	137346	526	5440	1244	0	144556
6487	5862	134933	2351	1166	0	144312
6488	139288	4225	1541	1281	0	146335
6489	6090	1683	1192	136707	0	145672
6490	2999	1215	994	140589	0	145797
6491	138257	951	883	6216	0	146307
6492	5719	772	905	138534	0	145930
6493	137899	757	873	5866	0	145395
6494	5871	136365	913	2614	0	145763
6495	3156	4392	875	132562	0	140985
6496	2598	1679	869	137320	0	142466
6497	134287	1140	806	6277	0	142510
6498	135841	862	793	2979	0	140475
6499	135932	671	782	2293	0	139678
6500	7132	125257	845	1759	0	134993
6501	3641	130959	878	1377	0	136855
6502	130807	4909	800	1400	0	137916
6503	6092	2049	125399	1140	0	134680
6504	3014	124424	4309	1123	0	132870
6505	116869	4285	2998	1339	0	125491
6506	114150	1485	1509	967	0	118111
6507	113853	912	871	774	0	116410
6508	5741	794	773	108339	0	115647
6509	110665	567	596	3841	0	115669
6510	111438	547	575	1686	0	114246
6511	5726	480	498	106212	0	112916
6512	108192	482	628	4041	0	113343
6513	4966	555	102197	1820	0	109538
6514	2778	603	3243	104861	0	111485
6515	1997	601	1449	107436	0	111483
6516	1715	423	1133	110536	0	113807
6517	106679	341	771	5543	0	113334
6518	110443	382	584	2969	0	114378
6519	110981	482	637	1967	0	114067
6520	110332	273	528	1844	0	112977
6521	107156	263	680	1395	0	109494
6522	5913	331	717	100734	0	107695
6523	3402	333	625	103412	0	107772
6524	100404	276	755	4591	0	106026
6525	4403	96526	625	2456	0	104010
6526	98587	2803	647	1637	0	103674
6527	4586	1056	92338	1418	0	99398
6528	99408	686	2792	1022	0	103908
6529	103105	577	1117	1124	0	105923
6530	5276	496	102668	1062	0	109502
6531	109063	394	3629	847	0	113933
6532	5396	373	108328	968	0	115065
6533	3166	334	113110	692	0	117302
6534	2834	863	5264	111093	0	120054
6535	2404	631	2805	117668	0	123508
6536	1914	360	115555	5312	0	123141
6537	1739	402	115733	2986	0	120860
6538	1085	109125	5139	2265	0	117614
6539	1084	109237	2624	1582	0	114527
6540	93188	3709	2228	927	0	100052
6541	2919	97113	1010	824	0	101866
6542	94164	3141	886	850	0	99041
6543	3183	92355	586	592	0	96716
6544	93198	3064	644	503	0	97409
6545	3357	1632	87821	388	0	93198
6546	90282	1145	2487	420	0	94334
6547	3654	894	1154	87975	0	93677
6548	2003	88361	873	2288	0	93525
6549	1706	2384	641	90763	0	95494
6550	90553	1284	437	2967	0	95241
6551	92863	937	321	1535	0	95656
6552	4064	753	358	90020	0	95195
6553	2288	451	88111	2762	0	93612
6554	1682	417	86433	1505	0	90037
6555	1096	88798	3033	1110	0	94037
6556	1203	3140	1697	88340	0	94380
6557	827	1234	87987	2603	0	92651
6558	732	82185	2467	1325	0	86709
6559	1021	2458	1366	82516	0	87361
6560	633	1069	894	84295	0	86891
6561	79098	719	682	2969	0	83468
6562	2169	565	494	79633	0	82861
6563	1121	455	77544	2909	0	82029
6564	933	335	1974	78610	0	81852
6565	76914	326	1087	2885	0	81212
6566	2171	346	75839	1687	0	80043
6567	76886	249	2028	1336	0	80499
6568	2626	77687	1167	983	0	82463
6569	81009	1837	884	807	0	84537
6570	82242	989	721	642	0	84594
6571	3296	675	537	79181	0	83689
6572	2079	471	402	80380	0	83332
6573	1377	77354	458	3043	0	82232
6574	1090	1885	403	81377	0	84755
6575	79353	1091	338	2990	0	83772
6576	2400	841	77556	1665	0	82462
6577	1621	627	1879	78312	0	82439
6578	1141	77120	1066	2462	0	81789
6579	908	1962	727	80562	0	84159
6580	725	1211	507	82052	0	84495
6581	79404	896	315	3414	0	84029
6582	2295	77851	338	2021	0	82505
6583	1506	2019	381	79714	0	83620
6584	78606	1134	412	2768	0	82920
6585	2530	916	339	78986	0	82771
6586	1517	656	321	80984	0	83478
6587	80532	453	328	3813	0	85126
6588	81026	352	283	2453	0	84114
6589	3236	435	78560	1654	0	83885
6590	79540	384	1879	1359	0	83162
6591	82258	343	1066	1075	0	84742
6592	82665	345	773	985	0	84768
6593	3695	75870	651	946	0	81162
6594	2347	77212	470	784	0	80813
6595	1855	2621	407	77527	0	82410
6596	78080	1547	505	2287	0	82419
6597	79281	1055	396	1442	0	82174
6598	3446	716	322	77715	0	82199
6599	2349	534	76981	2485	0	82349
6600	79527	456	1793	1654	0	83430
6601	83745	512	1032	1339	0	86628
6602	3321	495	751	81367	0	85934
6603	2277	357	580	82675	0	85889
6604	82523	314	410	3161	0	86408
6605	2977	332	355	81513	0	85177
6606	1862	80108	416	3048	0	85434
6607	1568	1845	413	84244	0	88070
6608	84288	1057	314	3008	0	88667
6609	2707	818	81504	1872	0	86901
6610	80275	559	1751	1685	0	84270
6611	2983	450	81347	1282	0	86062
6612	1955	429	2241	82846	0	87471
6613	84162	387	1312	2692	0	88553
6614	2714	372	882	84728	0	88696
6615	1846	350	616	85767	0	88579
6616	83660	274	533	3651	0	88118
6617	2742	271	81609	2249	0	86871
6618	1830	316	84207	1658	0	88011
6619	1434	250	2612	86702	0	90998
6620	1194	237	1573	89881	0	92885
6621	1045	239	1064	91535	0	93883
6622	848	300	87972	3763	0	92883
6623	86569	204	1944	2663	0	91380
6624	91844	202	1222	1845	0	95113
6625	92369	200	949	1464	0	94982
6626	92675	183	706	1259	0	94823
6627	3768	86130	547	1150	0	91595
6628	2391	86333	411	1162	0	90297
6629	1508	86295	404	937	0	89144
6630	1171	2007	582	74884	0	78644
6631	1148	670	419	76834	0	79071
6632	774	176	73345	1158	0	75453
6633	457	67534	678	473	0	69142
6634	668	576	319	64998	0	66561
6635	63482	151	164	670	0	64467
6636	401	63144	125	329	0	63999
6637	234	401	85	63756	0	64476
6638	203	63934	115	465	0	64717
6639	65869	373	128	386	0	66756
6640	544	229	87	65095	0	65955
6641	234	90	63846	446	0	64616
6642	190	104	61783	262	0	62339
6643	252	248	581	65226	0	66307
6644	224	41	198	65121	0	65584
6645	139	29	118	68070	0	68356
6646	67235	35	102	910	0	68282
6647	633	69	66188	311	0	67201
6648	240	65268	533	215	0	66256
6649	180	529	177	66314	0	67200
6650	145	180	65725	515	0	66565
6651	109	65585	520	269	0	66483
6652	198	552	204	67740	0	68694
6653	127	179	67127	519	0	67952
6654	158	99	469	66307	0	67033
6655	115	40	169	67443	0	67767
6656	68174	27	70	782	0	69053
6657	67989	26	47	363	0	68425
6658	696	14	43	68070	0	68823
6659	68201	29	45	744	0	69019
6660	637	63	68172	215	0	69087
6661	286	28	562	69105	0	69981
6662	134	51	70858	640	0	71683
6663	176	98	592	71534	0	72400
6664	71	69475	233	801	0	70580
6665	91	70824	114	298	0	71327
6666	48	72572	109	173	0	72902
6667	345	828	82	72540	0	73795
6668	129	237	59	81334	0	81759
6669	70	152	80117	1319	0	81658
6670	147	172	79917	422	0	80658
6671	143	183	84461	170	0	84957
6672	88994	67	1649	275	0	90985
6673	1739	57	399	93163	0	95358
6674	95632	45	194	1944	0	97815
6675	1939	97948	176	467	0	100530
6676	671	2054	95	100877	0	103697
6677	103862	587	79	2422	0	106950
6678	2490	340	72	104458	0	107360
6679	104455	161	83	2847	0	107546
6680	2708	180	103971	866	0	107725
6681	841	105234	2206	575	0	108856
6682	674	2172	640	108289	0	111775
6683	108186	625	416	2660	0	111887
6684	110796	361	252	1053	0	112462
6685	3120	189	189	109687	0	113185
6686	1219	151	182	111814	0	113366
6687	108493	124	194	3370	0	112181
6688	2806	87	252	107495	0	110640
6689	950	134	106410	2919	0	110413
6690	606	105505	2442	1085	0	109638
6691	588	2225	799	108702	0	112314
6692	108368	654	508	2939	0	112469
6693	109008	448	295	1314	0	111065
6694	3403	333	108482	799	0	113017
6695	1386	104569	2502	686	0	109143
6696	873	111511	781	877	0	114042
6697	831	3135	485	111522	0	115973
6698	850	1113	330	113716	0	116009
6699	691	669	278	113506	0	115144
6700	673	443	271	113956	0	115343
6701	539	109158	332	4194	0	114223
6702	727	2754	258	111868	0	115607
6703	794	867	214	114765	0	116640
6704	111152	539	216	4381	0	116288
6705	111741	377	201	2165	0	114484
6706	3691	109883	278	1370	0	115222
6707	112591	2823	239	1321	0	116974
6708	114118	964	268	1117	0	116467
6709	114185	632	275	1119	0	116211
6710	4365	497	108596	834	0	114292
6711	2010	402	2751	109684	0	114847
6712	1360	365	921	113928	0	116574
6713	1122	422	109125	4019	0	114688
6714	935	406	2949	108837	0	113127
6715	1041	461	1100	104494	0	107096
6716	108360	431	657	4555	0	114003
6717	3241	458	106717	2129	0	112545
6718	1469	406	2831	105326	0	110032
6719	103710	402	970	4011	0	109093
6720	3174	102763	717	1962	0	108616
6721	103244	2957	406	1664	0	108271
6722	103385	1065	313	1366	0	106129
6723	3978	99800	363	1258	0	105399
6724	1956	2964	238	101596	0	106754
6725	101116	1094	275	3753	0	106238
6726	3622	100022	276	1757	0	105677
6727	1819	3137	321	101486	0	106763
6728	99972	1156	328	3834	0	105290
6729	100094	779	316	1932	0	103121
6730	4266	96789	394	1411	0	102860
6731	99126	2932	434	1307	0	103799
6732	3995	1101	368	98736	0	104200
6733	99094	740	357	3900	0	104091
6734	4022	541	95922	1818	0	102303
6735	1925	437	2822	97652	0	102836
6736	1525	388	1062	99225	0	102200
6737	95829	405	777	4622	0	101633
6738	3559	93558	615	2224	0	99956
6739	93201	2927	562	1726	0	98416
6740	3849	92089	445	1304	0	97687
6741	1875	3183	89220	1184	0	95462
6742	1646	1236	89443	1067	0	93392
6743	1567	1635	3398	87574	0	94174
6744	1131	791	87964	3427	0	93313
6745	1243	731	2948	88514	0	93436
6746	1252	640	1061	88515	0	91468
6747	1180	593	671	91840	0	94284
6748	89887	560	463	4547	0	95457
6749	90433	618	364	2317	0	93732
6750	92473	588	314	1763	0	95138
6751	4621	87501	364	1356	0	93842
6752	2299	95656	350	1231	0	99536
6753	1804	3605	100025	1204	0	106638
6754	1590	1494	3436	102870	0	109390
6755	1210	1125	102380	4330	0	109045
6756	1267	832	3931	102780	0	108810
6757	1287	696	1568	105786	0	109337
6758	1196	579	1226	106413	0	109414
6759	1052	626	100197	5995	0	107870
6760	1184	508	3809	101743	0	107244
6761	99048	485	1701	5739	0	106973
6762	4002	95833	1291	2977	0	104103
6763	1862	3377	879	99094	0	105212
6764	97744	1315	758	5146	0	104963
6765	99127	1024	773	2631	0	103555
6766	5286	736	673	95579	0	102274
6767	2910	601	591	94847	0	98949
6768	86909	502	496	4989	0	92896
6769	4333	428	430	86520	0	91711
6770	80139	287	382	4440	0	85248
6771	4091	410	286	77647	0	82434
6772	1855	238	71126	4054	0	77273
6773	1426	66029	2140	2347	0	71942
6774	1201	68085	928	1651	0	71865
6775	1603	2297	1325	62731	0	67956
6776	1465	883	882	63376	0	66606
6777	60490	596	378	2811	0	64275
6778	1936	482	370	61100	0	63888
6779	912	504	238	61772	0	63426
6780	699	435	204	58590	0	59928
6781	617	55288	154	3191	0	59250
6782	712	1498	148	57974	0	60332
6783	670	552	139	58713	0	60074
6784	578	442	136	58600	0	59756
6785	53958	345	492	3418	0	58213
6786	1680	54686	206	1930	0	58502
6787	790	1750	178	56605	0	59323
6788	648	705	159	57638	0	59150
6789	562	493	162	57956	0	59173
6790	54837	351	149	3296	0	58633
6791	2038	348	122	55517	0	58025
6792	994	330	115	55856	0	57295
6793	630	257	50956	3123	0	54966
6794	460	49573	1210	1986	0	53229
6795	553	1459	459	51831	0	54302
6796	49592	495	412	2532	0	53031
6797	1496	49629	262	1500	0	52887
6798	48681	1366	265	1258	0	51570
6799	49594	661	271	923	0	51449
6800	1885	609	191	48688	0	51373
6801	1093	449	123	50040	0	51705
6802	962	382	48856	2141	0	52341
6803	816	364	1136	50864	0	53180
6804	708	240	50270	2234	0	53452
6805	622	149	1437	52060	0	54268
6806	49107	120	649	2538	0	52414
6807	1387	49520	588	1551	0	53046
6808	644	1346	535	53016	0	55541
6809	577	585	443	53924	0	55529
6810	526	484	420	53695	0	55125
6811	545	396	280	54135	0	55356
6812	51707	341	191	2833	0	55072
6813	1549	50637	233	1800	0	54219
6814	699	1312	180	53746	0	55937
6815	52700	516	191	2774	0	56181
6816	1693	417	51110	1791	0	55011
6817	51765	309	1286	1536	0	54896
6818	53547	311	546	1193	0	55597
6819	2225	409	51493	948	0	55075
6820	1299	334	1479	52927	0	56039
6821	54128	258	707	2104	0	57197
6822	2070	54739	670	1154	0	58633
6823	56826	1378	451	1172	0	59827
6824	57768	554	369	1038	0	59729
6825	58184	439	320	1065	0	60008
6826	2621	368	222	56813	0	60024
6827	1602	363	154	58983	0	61102
6828	1307	62709	183	2348	0	66547
6829	1228	1696	151	65314	0	68389
6830	65501	700	158	2604	0	68963
6831	2304	557	63510	1492	0	67863
6832	63508	411	1535	1465	0	66919
6833	67206	435	636	1239	0	69516
6834	2658	453	475	65773	0	69359
6835	1565	323	331	67530	0	69749
6836	67030	207	336	2831	0	70404
6837	67639	158	334	1640	0	69771
6838	62293	181	282	1586	0	64342
6839	2876	206	64664	1176	0	68922
6840	1540	64607	1438	1187	0	68772
6841	66433	1542	585	1105	0	69665
6842	2517	693	400	65597	0	69207
6843	1510	65167	342	2027	0	69046
6844	1285	1773	320	66362	0	69740
6845	66462	827	330	2354	0	69973
6846	2268	844	310	66869	0	70291
6847	1527	534	65464	2581	0	70106
6848	908	64426	1261	1648	0	68243
6849	722	67333	582	1367	0	70004
6850	829	1734	63450	1049	0	67062
6851	57975	1391	1983	1226	0	62575
6852	1455	57535	695	822	0	60507
6853	779	902	354	50261	0	52296
6854	49998	229	148	662	0	51037
6855	630	49126	87	277	0	50120
6856	350	566	43	50228	0	51187
6857	50392	242	76	695	0	51405
6858	700	128	56	50453	0	51337
6859	50758	80	54	818	0	51710
6860	733	111	50563	348	0	51755
6861	337	51318	534	272	0	52461
6862	53832	579	183	342	0	54936
6863	53640	235	124	279	0	54278
6864	53604	134	93	244	0	54075
6865	967	122	51023	154	0	52266
6866	51415	98	513	241	0	52267
6867	53677	90	183	242	0	54192
6868	951	92	115	53232	0	54390
6869	53640	91	84	753	0	54568
6870	807	52316	98	310	0	53531
6871	458	546	85	53607	0	54696
6872	332	273	53314	641	0	54560
6873	325	186	568	53245	0	54324
6874	261	134	224	54692	0	55311
6875	54346	133	124	960	0	55563
6876	54204	119	103	519	0	54945
6877	887	145	52967	285	0	54284
6878	52496	100	570	320	0	53486
6879	845	108	53001	186	0	54140
6880	542	89	625	53524	0	54780
6881	362	117	53822	677	0	54978
6882	321	105	666	53633	0	54725
6883	310	53323	289	719	0	54641
6884	306	608	54176	318	0	55408
6885	302	259	55161	246	0	55968
6886	647	179	996	46655	0	48477
6887	56455	121	384	851	0	57811
6888	56785	142	213	464	0	57604
6889	57343	101	167	343	0	57954
6890	1148	101	130	56246	0	57625
6891	634	105	92	57255	0	58086
6892	448	82	97	57417	0	58044
6893	404	93	106	57302	0	57905
6894	332	130	55510	1094	0	57066
6895	322	113	692	55222	0	56349
6896	263	53725	321	939	0	55248
6897	266	680	169	55642	0	56757
6898	55536	271	155	1033	0	56995
6899	929	173	54716	482	0	56300
6900	52265	131	764	479	0	53639
6901	1023	135	55590	256	0	57004
6902	560	114	54841	250	0	55765
6903	329	54194	1198	219	0	55940
6904	585	997	608	49554	0	51744
6905	334	399	291	54659	0	55683
6906	438	45835	539	1313	0	48125
6907	57637	1090	174	599	0	59500
6908	1441	533	165	59757	0	61896
6909	923	245	132	64946	0	66246
6910	518	202	113	68526	0	69359
6911	73076	124	151	2885	0	76236
6912	78638	107	121	1439	0	80305
6913	3233	101	125	77200	0	80659
6914	1497	71	124	78932	0	80624
6915	76543	85	113	3573	0	80314
6916	2838	110	132	77148	0	80228
6917	1471	99	128	78867	0	80565
6918	1093	97	139	79982	0	81311
6919	770	120	74540	4002	0	79432
6920	72137	86	2100	2246	0	76569
6921	75575	77	852	1602	0	78106
6922	3612	111	70862	1191	0	75776
6923	1884	519	2215	67855	0	72473
6924	1073	70052	1018	2845	0	74988
6925	69908	2080	578	1877	0	74443
6926	2605	69328	562	1283	0	73778
6927	1463	67372	433	1013	0	70281
6928	1278	2656	407	63920	0	68261
6929	63034	1081	427	2664	0	67206
6930	65795	595	251	1522	0	68163
6931	3271	572	257	63701	0	67801
6932	1819	441	243	64902	0	67405
6933	1200	530	143	65218	0	67091
6934	1005	533	162	64860	0	66560
6935	914	417	150	63994	0	65475
6936	789	60188	161	3713	0	64851
6937	932	2045	118	63040	0	66135
6938	61237	863	97	3624	0	65821
6939	62929	494	121	2252	0	65796
6940	63115	333	114	1799	0	65361
6941	3407	59797	148	1605	0	64957
6942	1914	2084	130	60990	0	65118
6943	1164	997	59562	3155	0	64878
6944	58999	655	1997	2123	0	63774
6945	3011	729	794	60268	0	64802
6946	59904	436	506	3140	0	63986
6947	59064	342	305	1891	0	61602
6948	59501	457	244	1344	0	61546
6949	3882	394	260	56436	0	60972
6950	57223	364	384	2856	0	60827
6951	3469	369	279	56768	0	60885
6952	2073	292	292	58465	0	61122
6953	57105	270	273	3626	0	61274
6954	3328	312	160	57710	0	61510
6955	57082	313	161	3382	0	60938
6956	58429	309	145	2112	0	60995
6957	3945	300	110	56873	0	61228
6958	2226	265	100	58625	0	61216
6959	1662	197	97	59668	0	61624
6960	1533	203	52952	4166	0	58854
6961	1321	203	53757	2619	0	57900
6962	1391	177	2432	54121	0	58121
6963	1346	183	1030	55376	0	57935
6964	1106	186	538	56457	0	58287
6965	1111	201	377	56209	0	57898
6966	1005	194	346	56819	0	58364
6967	52413	189	449	4601	0	57652
6968	2699	51092	520	2651	0	56962
6969	1615	1918	441	53833	0	57807
6970	53175	810	419	3652	0	58056
6971	2904	439	356	54163	0	57862
6972	1648	341	281	55043	0	57313
6973	52137	311	278	4443	0	57169
6974	53372	298	253	2684	0	56607
6975	3625	398	50116	1995	0	56134
6976	2131	317	1930	52206	0	56584
6977	1687	324	50922	3449	0	56382
6978	1362	261	2156	52742	0	56521
6979	1333	159	922	53551	0	55965
6980	1373	166	536	54415	0	56490
6981	1315	157	49633	4458	0	55563
6982	1061	47257	2242	2778	0	53338
6983	1035	50755	1085	2215	0	55090
6984	943	2386	837	50891	0	55057
6985	49189	971	663	3629	0	54452
6986	2551	521	48311	2497	0	53880
6987	1445	407	50239	2000	0	54091
6988	1032	387	2924	50351	0	54694
6989	890	419	1441	50822	0	53572
6990	734	49534	927	3707	0	54902
6991	786	2169	762	51051	0	54768
6992	793	1096	629	53696	0	56214
6993	752	608	641	54862	0	56863
6994	51480	455	633	4304	0	56872
6995	53022	399	507	2677	0	56605
6996	3234	402	512	52965	0	57113
6997	1660	50918	423	3589	0	56590
6998	1226	1989	304	53205	0	56724
6999	50684	938	307	3781	0	55710
7000	2534	50811	318	2591	0	56254
7001	1551	1959	245	49193	0	52948
7002	1118	48688	247	3077	0	53130
7003	48772	1994	317	2088	0	53171
7004	47304	1095	405	1645	0	50449
7005	2778	46880	327	1546	0	51531
7006	1436	48103	323	1220	0	51082
7007	1072	2202	43866	1096	0	48236
7008	677	41579	1438	1016	0	44710
7009	919	2240	802	35517	0	39478
7010	562	655	34530	1559	0	37306
7011	170	27262	672	432	0	28536
7012	174	477	228	23854	0	24733
7013	83	169	78	24315	0	24645
7014	62	71	48	24505	0	24686
7015	23726	54	28	659	0	24467
7016	412	54	23024	292	0	23782
7017	198	65	23305	149	0	23717
7018	83	67	505	23499	0	24154
7019	64	60	24618	457	0	25199
7020	95	61	434	24907	0	25497
7021	91	55	191	24114	0	24451
7022	66	42	86	25485	0	25679
7023	55	42	65	25688	0	25850
7024	24987	47	56	665	0	25755
7025	25136	46	51	331	0	25564
7026	551	42	43	25258	0	25894
7027	233	58	25986	482	0	26759
7028	143	44	366	26315	0	26868
7029	68	25501	186	499	0	26254
7030	73	356	86	26098	0	26613
7031	25804	156	66	553	0	26579
7032	26345	78	63	323	0	26809
7033	553	69	58	26343	0	27023
7034	266	55	43	26636	0	27000
7035	132	40	49	26931	0	27152
7036	26163	53	39	708	0	26963
7037	429	55	25856	341	0	26681
7038	230	58	25582	195	0	26065
7039	93	25441	468	146	0	26148
7040	25793	330	206	168	0	26497
7041	385	174	101	26053	0	26713
7042	185	86	26449	411	0	27131
7043	100	25650	340	247	0	26337
7044	70	26646	174	165	0	27055
7045	83	438	78	26860	0	27459
7046	102	174	52	27218	0	27546
7047	76	26761	56	482	0	27375
7048	94	332	40	27559	0	28025
7049	76	152	54	27766	0	28048
7050	27164	84	55	577	0	27880
7051	331	26966	50	298	0	27645
7052	196	324	45	27041	0	27606
7053	94	174	26511	417	0	27196
7054	109	111	309	26539	0	27068
7055	26559	73	153	458	0	27243
7056	333	26543	74	256	0	27206
7057	174	322	48	27138	0	27682
7058	111	157	26753	400	0	27421
7059	89	126	27697	224	0	28136
7060	96	117	503	28589	0	29305
7061	87	71	200	29539	0	29897
7062	29513	73	84	628	0	30298
7063	451	30397	61	287	0	31196
7064	30987	479	57	224	0	31747
7065	533	209	31249	141	0	32132
7066	31335	126	492	166	0	32119
7067	608	92	32670	133	0	33503
7068	32915	74	590	167	0	33746
7069	33983	65	238	173	0	34459
7070	777	85	34582	120	0	35564
7071	336	100	34180	137	0	34753
7072	164	33811	750	161	0	34886
7073	157	564	280	35730	0	36731
7074	36139	227	155	720	0	37241
7075	635	113	113	36720	0	37581
7076	300	78	92	37525	0	37995
7077	194	57	92	37887	0	38230
7078	138	78	37048	919	0	38183
7079	35362	64	623	481	0	36530
7080	37921	38	280	295	0	38534
7081	830	38004	160	199	0	39193
7082	385	575	92	38187	0	39239
7083	183	39094	108	701	0	40086
7084	205	685	86	40243	0	41219
7085	39890	256	108	885	0	41139
7086	701	39707	101	370	0	40879
7087	332	631	77	39239	0	40279
7088	38982	237	60	789	0	40068
7089	39263	109	55	384	0	39811
7090	935	84	62	38385	0	39466
7091	370	62	38252	747	0	39431
7092	292	430	589	36927	0	38238
7093	148	38264	222	662	0	39296
7094	38080	594	138	332	0	39144
7095	637	37920	94	161	0	38812
7096	329	676	79	37666	0	38750
7097	38107	217	64	707	0	39095
7098	697	122	74	39015	0	39908
7099	322	79	46	39319	0	39766
7100	164	79	38361	808	0	39412
7101	135	38212	547	365	0	39259
7102	37946	573	206	255	0	38980
7103	34443	245	136	412	0	35236
7104	589	36839	64	128	0	37620
7105	189	37572	60	108	0	37929
7106	272	623	77	36872	0	37844
7107	36592	209	54	576	0	37431
7108	520	36210	42	216	0	36988
7109	245	511	22	36938	0	37716
7110	137	192	36526	544	0	37399
7111	136	117	474	36774	0	37501
7112	37128	73	148	645	0	37994
7113	524	37229	97	243	0	38093
7114	223	512	58	38665	0	39458
7115	113	206	38123	558	0	39000
7116	109	148	37842	222	0	38321
7117	169	98	622	38690	0	39579
7118	150	69	202	39500	0	39921
7119	96	38267	113	705	0	39181
7120	118	554	56	38705	0	39433
7121	38817	187	48	748	0	39800
7122	606	114	67	39404	0	40191
7123	39368	94	67	739	0	40268
7124	635	38766	86	289	0	39776
7125	274	40230	55	205	0	40764
7126	219	690	73	41414	0	42396
7127	166	265	75	41040	0	41546
7128	131	163	40355	796	0	41445
7129	152	128	606	40274	0	41160
7130	40598	91	224	819	0	41732
7131	669	124	40184	313	0	41290
7132	335	103	609	41241	0	42288
7133	195	100	42560	791	0	43646
7134	177	103	726	42951	0	43957
7135	197	88	280	43050	0	43615
7136	182	87	161	44121	0	44551
7137	168	125	43221	987	0	44501
7138	174	109	665	42839	0	43787
7139	100	43032	288	881	0	44301
7140	133	667	143	44401	0	45344
7141	141	243	96	44676	0	45156
7142	43786	163	81	1095	0	45125
7143	733	140	43104	504	0	44481
7144	336	118	699	43700	0	44853
7145	241	96	43441	893	0	44671
7146	184	163	42276	428	0	43051
7147	207	113	882	44581	0	45783
7148	222	108	323	44144	0	44797
7149	157	152	173	46622	0	47104
7150	45736	90	131	1237	0	47194
7151	779	156	45252	549	0	46736
7152	47106	126	723	509	0	48464
7153	888	125	257	49417	0	50687
7154	391	119	155	50907	0	51572
7155	232	52085	164	1151	0	53632
7156	236	774	122	54076	0	55208
7157	229	259	133	54351	0	54972
7158	272	162	154	54422	0	55010
7159	51113	102	133	1181	0	52529
7160	696	113	48605	564	0	49978
7161	46984	94	629	452	0	48159
7162	735	49602	256	326	0	50919
7163	49209	598	158	311	0	50276
7164	666	48170	121	243	0	49200
7165	297	48280	133	260	0	48970
7166	522	803	232	48012	0	49569
7167	48412	234	235	722	0	49603
7168	600	151	62	48750	0	49563
7169	211	46932	94	750	0	47987
7170	151	50137	90	365	0	50743
7171	161	723	65	51286	0	52235
7172	137	287	68	51330	0	51822
7173	118	50818	81	928	0	51945
7174	139	655	79	53511	0	54384
7175	165	218	81	54262	0	54726
7176	136	136	62	55435	0	55769
7177	54920	114	51	1149	0	56234
7178	694	149	53734	475	0	55052
7179	54832	102	644	471	0	56049
7180	57675	76	203	346	0	58300
7181	57295	67	112	288	0	57762
7182	924	55353	98	225	0	56600
7183	385	609	66	55587	0	56647
7184	55754	216	64	753	0	56787
7185	697	144	49	56630	0	57520
7186	56344	83	54	843	0	57324
7187	661	59034	67	351	0	60113
7188	62292	563	59	412	0	63326
7189	63303	190	65	308	0	63866
7190	64090	116	55	256	0	64517
7191	932	86	54	63636	0	64708
7192	441	116	57	65563	0	66177
7193	66123	71	33	951	0	67178
7194	665	64463	55	405	0	65588
7195	261	64884	66	283	0	65494
7196	68024	654	54	298	0	69030
7197	673	245	56	68232	0	69206
7198	331	134	46	69083	0	69594
7199	227	95	33	70629	0	70984
7200	173	68862	67	982	0	70084
7201	70598	665	48	506	0	71817
7202	784	213	38	71286	0	72321
7203	314	71507	71	842	0	72734
7204	281	791	48	75565	0	76685
7205	233	270	41	76520	0	77064
7206	219	176	40	76184	0	76619
7207	194	129	35	77181	0	77539
7208	76656	98	29	1214	0	77997
7209	76335	92	35	641	0	77103
7210	77735	87	42	525	0	78389
7211	1068	83	29	77932	0	79112
7212	497	111	76122	853	0	77583
7213	423	173	70134	426	0	71156
7214	316	189	73081	351	0	73937
7215	79372	122	869	463	0	80826
7216	823	121	320	80472	0	81736
7217	339	98	171	80156	0	80764
7218	275	86	97	81401	0	81859
7219	80557	85	63	1203	0	81908
7220	80244	89	51	619	0	81003
7221	917	83716	97	409	0	85139
7222	435	666	44	85835	0	86980
7223	342	235	84001	815	0	85393
7224	231	84599	641	392	0	85863
7225	264	764	166	86677	0	87871
7226	245	278	149	87352	0	88024
7227	226	162	106	86223	0	86717
7228	265	140	71	84402	0	84878
7229	211	115	84550	1038	0	85914
7230	244	143	79780	533	0	80700
7231	170	84976	728	404	0	86278
7232	208	595	231	86997	0	88031
7233	207	181	136	86251	0	86775
7234	85107	120	99	996	0	86322
7235	709	189	85156	378	0	86432
7236	357	82	578	85577	0	86594
7237	316	87	220	89059	0	89682
7238	220	122	90259	826	0	91427
7239	151	89575	632	444	0	90802
7240	91029	596	202	526	0	92353
7241	709	228	89299	279	0	90515
7242	87661	157	612	414	0	88844
7243	756	205	93157	224	0	94342
7244	397	111	618	94826	0	95952
7245	274	112	95262	655	0	96303
7246	275	193	94848	360	0	95676
7247	290	104	712	98223	0	99329
7248	1001	271	596	81392	0	83260
7249	208	62	179	102394	0	102843
7250	258	71	138	99894	0	100361
7251	277	97	101	99130	0	99605
7252	169	121	100496	928	0	101714
7253	250	179	93334	529	0	94292
7254	124	99638	725	348	0	100835
7255	100875	609	307	457	0	102248
7256	794	303	188	101747	0	103032
7257	102438	98	153	1014	0	103703
7258	874	127	105	102406	0	103512
7259	105639	62	95	1315	0	107111
7260	934	48	104	106963	0	108049
7261	370	67	90	107810	0	108337
7262	220	108358	155	1134	0	109867
7263	225	727	89	112852	0	113893
7264	206	234	94	112872	0	113406
7265	210	129	95	112737	0	113171
7266	186	87	83	112375	0	112731
7267	106	109019	137	1166	0	110428
7268	110061	607	67	707	0	111442
7269	668	108597	141	364	0	109770
7270	240	675	54	108234	0	109203
7271	106705	188	46	967	0	107906
7272	731	220	103115	300	0	104366
7273	296	212	101899	254	0	102661
7274	438	322	781	101612	0	103153
7275	167	89	349	106062	0	106667
7276	92	60	139	106283	0	106574
7277	327	76	128	98565	0	99096
7278	167	50	56	103399	0	103672
7279	77	101181	106	884	0	102248
7280	99	513	73	103834	0	104519
7281	102925	148	47	1066	0	104186
7282	607	115	61	104050	0	104833
7283	198	119	104907	745	0	105969
7284	231	66	586	103779	0	104662
7285	103676	43	218	1091	0	105028
7286	625	106483	194	401	0	107703
7287	334	626	91	110097	0	111148
7288	264	229	63	113082	0	113638
7289	166	178	111078	1567	0	112989
7290	199	248	132137	537	0	133121
7291	159460	115	2804	710	0	163089
7292	4506	138	970	161997	0	167611
7293	2209	101	877	168232	0	171419
7294	1679	174	172664	5960	0	180477
7295	1119	214	173791	3395	0	178519
7296	463	175616	6314	2826	0	185219
7297	925	4729	3256	176524	0	185434
7298	265	1857	177218	5212	0	184552
7299	154	176646	6171	2201	0	185172
7300	176936	5724	2665	2314	0	187639
7301	183890	2291	2249	1741	0	190171
7302	7305	1977	1418	177656	0	188356
7303	3531	179027	983	5471	0	189012
7304	180846	5565	806	2799	0	190016
7305	7250	2495	693	173971	0	184409
7306	3114	2246	175943	5789	0	187092
7307	2602	178402	5229	2758	0	188991
7308	178668	5656	2158	2768	0	189250
7309	184509	2446	1905	2125	0	190985
7310	7873	2219	1334	180079	0	191505
7311	4641	1474	804	185014	0	191933
7312	3268	1005	177724	7587	0	189584
7313	2788	858	5308	181497	0	190451
7314	2408	815	2273	174160	0	179656
7315	1848	506	1856	184423	0	188633
7316	1564	489	1293	185215	0	188561
7317	1471	506	866	180172	0	183015
7318	820	175440	854	10647	0	187761
7319	176281	5113	677	6689	0	188760
7320	5796	2151	174224	4776	0	186947
7321	2564	171992	5412	3708	0	183676
7322	2925	5942	2251	177214	0	188332
7323	175820	2454	2105	7711	0	188090
7324	6581	2223	1575	177337	0	187716
7325	3267	1620	1080	181152	0	187119
7326	2932	1065	1019	182984	0	188000
7327	2270	981	1038	184404	0	188693
7328	1507	977	171648	11507	0	185639
7329	1374	172773	5522	6960	0	186629
7330	174401	5693	2217	6014	0	188325
7331	6389	2507	172889	4191	0	185976
7332	3224	2242	6752	175503	0	187721
7333	174771	1868	3047	8164	0	187850
7334	7137	173181	2739	4201	0	187258
7335	176613	6216	2103	4190	0	189122
7336	8856	3125	1652	165856	0	179489
7337	4624	2600	1247	180236	0	188707
7338	3982	1867	1040	179621	0	186510
7339	3130	1288	897	181549	0	186864
7340	171330	1330	908	12354	0	185922
7341	7309	1229	803	176598	0	185939
7342	3837	891	842	181169	0	186739
7343	167360	868	836	11857	0	180921
7344	7688	982	162553	7183	0	178406
7345	4079	898	5616	169167	0	179760
7346	162407	805	2386	9922	0	175520
7347	165875	719	2044	5770	0	174408
7348	9174	748	1563	161625	0	173110
7349	5541	764	1338	163132	0	170775
7350	4331	148451	1340	10200	0	164322
7351	3274	5480	982	156943	0	166679
7352	2586	2267	829	158594	0	164276
7353	2102	1888	144868	11787	0	160645
7354	1874	1408	143933	7740	0	154955
7355	1409	143393	7161	6656	0	158619
7356	1674	5716	3936	146871	0	158197
7357	1669	2556	3341	152608	0	160174
7358	145550	2459	2481	10178	0	160668
7359	6346	1974	1963	147112	0	157395
7360	3401	1477	140548	10438	0	155864
7361	3466	1336	6162	145727	0	156691
7362	2480	1341	136937	10534	0	151292
7363	2178	1184	139848	6494	0	149704
7364	1982	1185	8446	139231	0	150844
7365	1765	1193	4716	145297	0	152971
7366	138797	1202	3527	10451	0	153977
7367	143501	961	2512	6976	0	153950
7368	8461	890	2316	143215	0	154882
7369	143698	1006	1725	9718	0	156147
7370	148794	734	1410	5954	0	156892
7371	10209	861	1237	145528	0	157835
7372	6156	878	1170	149388	0	157592
7373	144438	759	1054	10694	0	156945
7374	143672	539	1207	7104	0	152522
7375	9537	482	1084	141960	0	153063
7376	5783	134866	1060	10096	0	151805
7377	5224	5213	826	142748	0	154011
7378	3955	2065	691	147802	0	154513
7379	2751	1849	135011	12083	0	151694
7380	2599	1419	5207	145002	0	154227
7381	133906	954	2485	11767	0	149112
7382	6330	136034	2518	7121	0	152003
7383	138151	5644	1658	6135	0	151588
7384	140425	2440	1216	5022	0	149103
7385	143350	2188	989	4384	0	150911
7386	10837	2793	1067	133196	0	147893
7387	7529	1321	121484	8129	0	138463
7388	6349	1242	119741	4692	0	132024
7389	3731	118411	6367	4931	0	133440
7390	2038	94099	2440	2967	0	101544
7391	1360	66981	1065	1153	0	70559
7392	1239	65028	1213	1144	0	68624
7393	1680	1946	61559	1174	0	66359
7394	51926	1386	2062	800	0	56174
7395	989	404	321	51845	0	53559
7396	396	148	137	51298	0	51979
7397	345	162	110	51293	0	51910
7398	245	50459	134	1009	0	51847
7399	50092	666	144	542	0	51444
7400	862	217	49760	346	0	51185
7401	225	47638	613	234	0	48710
7402	287	660	266	48463	0	49676
7403	48469	146	180	776	0	49571
7404	702	105	84	48275	0	49166
7405	230	80	47143	748	0	48201
7406	200	112	46192	285	0	46789
7407	208	98	635	48015	0	48956
7408	215	56	217	48207	0	48695
7409	47977	41	119	876	0	49013
7410	631	56	47540	325	0	48552
7411	46806	46	553	311	0	47716
7412	47745	33	156	270	0	48204
7413	824	48	108	47825	0	48805
7414	277	70	48356	673	0	49376
7415	248	83	567	48652	0	49550
7416	49023	46	187	827	0	50083
7417	636	48621	131	307	0	49695
7418	49738	588	101	294	0	50721
7419	783	174	80	50405	0	51442
7420	256	51237	93	809	0	52395
7421	235	743	72	52049	0	53099
7422	218	197	78	53191	0	53684
7423	134	52587	96	1052	0	53869
7424	201	817	80	53966	0	55064
7425	235	209	73	55311	0	55828
7426	231	153	89	56312	0	56785
7427	149	132	55644	1273	0	57198
7428	119	55394	956	497	0	56966
7429	56737	948	238	422	0	58345
7430	1154	284	184	57837	0	59459
7431	309	61128	155	1158	0	62750
7432	65485	1157	130	568	0	67340
7433	1470	332	81	66149	0	68032
7434	564	228	76	67055	0	67923
7435	439	154	72	66110	0	66775
7436	402	119	68	65267	0	65856
7437	64192	126	84	2093	0	66495
7438	1554	122	70	65251	0	66997
7439	590	101	75	66520	0	67286
7440	65237	104	79	2115	0	67535
7441	1620	107	71	65895	0	67693
7442	548	141	64620	1900	0	67209
7443	512	119	1277	65433	0	67341
7444	63808	107	352	1950	0	66217
7445	1590	140	225	64542	0	66497
7446	567	136	64008	1878	0	66589
7447	445	163	62818	850	0	64276
7448	64300	117	1714	810	0	66941
7449	67134	116	591	675	0	68516
7450	67666	93	342	651	0	68752
7451	67855	117	254	570	0	68796
7452	2140	128	66088	407	0	68763
7453	1030	76	1438	66077	0	68621
7454	783	112	443	67968	0	69306
7455	66937	93	298	2146	0	69474
7456	1797	113	279	67647	0	69836
7457	623	119	66326	1965	0	69033
7458	603	153	1444	67287	0	69487
7459	404	107	67319	1983	0	69813
7460	372	67045	1545	879	0	69841
7461	68286	1376	615	785	0	71062
7462	1757	400	391	68260	0	70808
7463	634	260	66665	1843	0	69402
7464	647	155	1533	67530	0	69865
7465	528	132	490	70480	0	71630
7466	395	151	69520	2290	0	72356
7467	491	136	1684	70299	0	72610
7468	69733	83	602	2460	0	72878
7469	1845	190	64985	1091	0	68111
7470	65857	126	1510	977	0	68470
7471	1927	65602	569	738	0	68836
7472	832	1421	65964	599	0	68816
7473	609	494	66265	651	0	68019
7474	988	934	2099	57238	0	61259
7475	570	192	752	62596	0	64110
7476	365	202	62244	2096	0	64907
7477	397	153	1650	62652	0	64852
7478	62836	118	684	2238	0	65876
7479	63831	81	478	1212	0	65602
7480	1964	109	416	62869	0	65358
7481	933	152	338	63224	0	64647
7482	662	62117	334	2229	0	65342
7483	64070	1363	373	1276	0	67082
7484	1881	434	307	64445	0	67067
7485	804	64437	320	2104	0	67665
7486	65634	1526	337	1216	0	68713
7487	66564	492	357	1048	0	68461
7488	2157	66493	324	912	0	69886
7489	1046	1604	320	67675	0	70645
7490	896	505	300	68383	0	70084
7491	677	384	65102	2584	0	68747
7492	713	294	1711	65434	0	68152
7493	64902	234	646	2577	0	68359
7494	2094	222	480	65078	0	67874
7495	908	192	63124	2612	0	66836
7496	63356	146	1817	1402	0	66721
7497	2205	188	697	64289	0	67379
7498	1051	183	62989	2424	0	66647
7499	911	160	1856	63725	0	66652
7500	766	169	63084	2465	0	66484
7501	758	138	1985	63663	0	66544
7502	711	132	834	65253	0	66930
7503	62905	136	652	2843	0	66536
7504	1948	62632	587	1494	0	66661
7505	63749	1552	559	1267	0	67127
7506	64173	473	484	1112	0	66242
7507	64229	314	467	1036	0	66046
7508	2625	62337	510	851	0	66323
7509	1307	1678	62403	787	0	66175
7510	1103	546	1873	62855	0	66377
7511	63554	394	772	2316	0	67036
7512	64729	272	684	1197	0	66882
7513	2554	261	586	62933	0	66334
7514	62634	252	528	2470	0	65884
7515	2359	251	61042	1308	0	64960
7516	61434	212	1885	1163	0	64694
7517	2505	233	60564	949	0	64251
7518	1212	59378	1918	901	0	63409
7519	59840	1430	949	864	0	63083
7520	58603	524	699	909	0	60735
7521	2209	57605	643	739	0	61196
7522	57352	1560	710	931	0	60553
7523	57241	520	449	844	0	59054
7524	2250	377	54658	727	0	58012
7525	53602	280	1497	773	0	56152
7526	1975	231	52611	618	0	55435
7527	988	840	1444	49215	0	52487
7528	772	50149	648	1460	0	53029
7529	804	1165	49596	754	0	52319
7530	45217	1231	1812	1317	0	49577
7531	43540	536	643	775	0	45494
7532	1309	222	272	40571	0	42374
7533	635	175	39880	988	0	41678
7534	527	263	876	39999	0	41665
7535	39934	148	371	1071	0	41524
7536	1086	40189	294	474	0	42043
7537	40020	752	254	453	0	41479
7538	40400	252	203	335	0	41190
7539	1154	39237	226	304	0	40921
7540	593	763	169	39740	0	41265
7541	40368	280	190	942	0	41780
7542	1132	197	172	40590	0	42091
7543	578	191	193	42252	0	43214
7544	478	166	42166	1087	0	43897
7545	450	146	881	42280	0	43757
7546	493	130	292	42984	0	43899
7547	42081	147	216	1311	0	43755
7548	42706	138	183	553	0	43580
7549	1385	161	187	42332	0	44065
7550	642	140	41258	1146	0	43186
7551	537	148	40679	454	0	41818
7552	500	230	1095	40919	0	42744
7553	416	112	41903	1143	0	43574
7554	425	259	1052	41297	0	43033
7555	378	134	428	41462	0	42402
7556	41517	107	316	1257	0	43197
7557	1106	113	40651	549	0	42419
7558	40239	94	928	488	0	41749
7559	40665	85	348	441	0	41539
7560	1226	90	39305	369	0	40990
7561	592	92	39446	294	0	40424
7562	545	1155	1000	37292	0	39992
7563	402	36568	431	820	0	38221
7564	382	37785	304	369	0	38840
7565	605	863	239	35223	0	36930
7566	354	243	137	34482	0	35216
7567	278	132	121	35710	0	36241
7568	285	85	117	36021	0	36508
7569	34771	80	106	958	0	35915
7570	773	70	145	34932	0	35920
7571	294	81	34225	869	0	35469
7572	297	52	653	33832	0	34834
7573	254	33283	197	810	0	34544
7574	290	551	172	34049	0	35062
7575	34031	118	129	851	0	35129
7576	781	103	158	34301	0	35343
7577	300	64	34092	778	0	35234
7578	199	33233	684	307	0	34423
7579	213	566	261	33971	0	35011
7580	33873	145	197	817	0	35032
7581	34316	112	145	367	0	34940
7582	918	88	130	34186	0	35322
7583	344	93	32460	723	0	33620
7584	291	83	30805	268	0	31447
7585	31617	48	701	248	0	32614
7586	756	54	32194	158	0	33162
7587	249	57	31859	127	0	32292
7588	271	245	595	30237	0	31348
7589	31803	24	245	585	0	32657
7590	31606	20	110	235	0	31971
7591	31777	23	77	169	0	32046
7592	622	34	32321	139	0	33116
7593	229	42	32780	112	0	33163
7594	130	34331	533	122	0	35116
7595	143	415	194	34155	0	34907
7596	113	101	129	35008	0	35351
7597	152	57	91	33706	0	34006
7598	125	23	92	35083	0	35323
7599	111	33	34704	633	0	35481
7600	97	34668	449	271	0	35485
7601	36414	405	178	234	0	37231
7602	39281	125	140	213	0	39759
7603	40170	59	111	196	0	40536
7604	985	40164	109	127	0	41385
7605	346	807	80	40710	0	41943
7606	42435	176	78	1016	0	43705
7607	983	44100	96	337	0	45516
7608	43858	912	81	319	0	45170
7609	1057	43730	117	169	0	45073
7610	44398	1035	117	199	0	45749
7611	45166	272	109	195	0	45742
7612	1352	182	100	44914	0	46548
7613	578	95	90	46892	0	47655
7614	305	128	45865	1349	0	47647
7615	229	132	44860	503	0	45724
7616	46054	66	1307	394	0	47821
7617	48119	64	429	280	0	48892
7618	1533	84	234	46646	0	48497
7619	643	72	168	47676	0	48559
7620	397	81	46249	1452	0	48179
7621	364	104	1093	46043	0	47604
7622	243	112	46079	1451	0	47885
7623	270	129	1219	46601	0	48219
7624	272	126	388	48190	0	48976
7625	47152	86	278	1686	0	49202
7626	47441	96	163	761	0	48461
7627	1652	101	141	47073	0	48967
7628	757	103	106	47770	0	48736
7629	428	122	46321	1670	0	48541
7630	401	79	1173	47096	0	48749
7631	317	108	46959	1570	0	48954
7632	46690	97	1308	758	0	48853
7633	1471	89	468	47820	0	49848
7634	47372	97	338	1529	0	49336
7635	1463	46819	238	697	0	49217
7636	47826	1120	228	574	0	49748
7637	1586	407	218	47476	0	49687
7638	733	241	184	48051	0	49209
7639	525	47037	236	1630	0	49428
7640	498	1162	181	48371	0	50212
7641	399	371	47186	1621	0	49577
7642	483	264	1233	47421	0	49401
7643	338	163	45802	1615	0	47918
7644	307	44397	1295	732	0	46731
7645	382	991	544	45225	0	47142
7646	299	308	44666	1355	0	46628
7647	321	235	44043	680	0	45279
7648	379	313	1399	43769	0	45860
7649	43286	133	685	1469	0	45573
7650	1143	107	42749	658	0	44657
7651	541	76	1133	42831	0	44581
7652	43267	91	493	1438	0	45289
7653	1176	42140	337	678	0	44331
7654	44541	1013	252	675	0	46481
7655	1337	336	214	44761	0	46648
7656	626	235	173	45619	0	46653
7657	488	150	166	46243	0	47047
7658	45163	136	215	1845	0	47359
7659	1284	114	212	45883	0	47493
7660	587	103	249	46941	0	47880
7661	44623	109	222	1797	0	46751
7662	1316	138	44123	871	0	46448
7663	628	147	1161	44923	0	46859
7664	499	127	44473	1493	0	46592
7665	44205	173	1273	785	0	46436
7666	1441	148	463	45201	0	47253
7667	632	179	45283	1467	0	47561
7668	44519	175	1131	863	0	46688
7669	46308	173	474	654	0	47609
7670	1601	208	46540	591	0	48940
7671	813	159	1183	46666	0	48821
7672	598	179	506	48220	0	49503
7673	449	168	47839	1702	0	50158
7674	407	47079	1237	947	0	49670
7675	391	1035	48242	728	0	50396
7676	46613	354	1370	757	0	49094
7677	1322	256	49027	588	0	51193
7678	47713	157	1435	648	0	49953
7679	1461	117	48911	557	0	51046
7680	47777	66	1419	650	0	49912
7681	1409	48771	728	554	0	51462
7682	716	981	455	48939	0	51091
7683	578	330	401	50653	0	51962
7684	446	252	49769	1652	0	52119
7685	499	205	1178	48604	0	50486
7686	454	48428	558	1535	0	50975
7687	48121	952	420	914	0	50407
7688	1215	48039	366	782	0	50402
7689	617	1044	308	49004	0	50973
7690	48970	344	346	1561	0	51221
7691	1323	49164	298	873	0	51658
7692	48788	1097	389	635	0	50909
7693	1513	429	48626	579	0	51147
7694	746	243	1323	49110	0	51422
7695	696	187	611	49806	0	51300
7696	471	183	480	51066	0	52200
7697	49936	156	366	1950	0	52408
7698	50510	174	338	993	0	52015
7699	50828	132	321	762	0	52043
7700	50359	187	302	637	0	51485
7701	1772	156	46978	498	0	49404
7702	43212	100	787	331	0	44430
7703	1053	42752	408	299	0	44512
7704	464	43250	257	233	0	44204
7705	43146	844	905	344	0	45239
7706	43007	264	377	334	0	43982
7707	807	126	120	41135	0	42188
7708	41904	88	104	696	0	42792
7709	42155	48	93	349	0	42645
7710	44882	48	86	256	0	45272
7711	989	85	85	44215	0	45374
7712	396	43214	105	690	0	44405
7713	201	44237	96	258	0	44792
7714	264	800	74	44335	0	45473
7715	43754	228	105	701	0	44788
7716	611	44032	78	257	0	44978
7717	277	546	63	44132	0	45018
7718	185	175	44238	615	0	45213
7719	42387	114	516	311	0	43328
7720	641	44128	192	165	0	45126
7721	254	45433	117	134	0	45938
7722	44845	668	69	178	0	45760
7723	668	220	45002	116	0	46006
7724	314	141	550	44274	0	45279
7725	179	45080	192	564	0	46015
7726	212	569	111	45989	0	46881
7727	178	184	63	45790	0	46215
7728	202	41096	162	731	0	42191
7729	188	586	63	46755	0	47592
7730	204	181	43	47186	0	47614
7731	46434	138	58	816	0	47446
7732	640	45827	54	291	0	46812
7733	46565	569	44	270	0	47448
7734	733	231	54	46075	0	47093
7735	268	46498	56	686	0	47508
7736	189	609	46594	213	0	47605
7737	287	311	585	46965	0	48148
7738	194	193	192	48532	0	49111
7739	132	125	48659	775	0	49691
7740	47256	98	672	394	0	48420
7741	807	102	171	53026	0	54106
7742	53243	90	111	1050	0	54494
7743	1026	102	51756	315	0	53199
7744	453	111	843	52738	0	54145
7745	266	103	54984	1034	0	56387
7746	270	161	1045	55772	0	57248
7747	234	147	329	57531	0	58241
7748	56654	81	199	1388	0	58322
7749	958	56921	111	557	0	58547
7750	57661	981	71	437	0	59150
7751	1201	322	57325	187	0	59035
7752	500	263	951	57520	0	59234
7753	328	150	58921	1055	0	60454
7754	53729	129	1166	562	0	55586
7755	58019	96	337	456	0	58908
7756	1303	93	57532	209	0	59137
7757	57198	97	1026	303	0	58624
7758	59058	85	330	277	0	59750
7759	1396	76	277	58293	0	60042
7760	613	89	57175	1095	0	58972
7761	406	132	58389	407	0	59334
7762	341	85	1224	59156	0	60806
7763	316	98	523	58871	0	59808
7764	277	57380	354	1252	0	59263
7765	209	59567	226	596	0	60598
7766	59348	1167	159	527	0	61201
7767	1197	452	208	59065	0	60922
7768	469	57551	206	1177	0	59403
7769	374	60111	195	542	0	61222
7770	58174	1213	185	511	0	60083
7771	1197	501	158	58501	0	60357
7772	522	58501	186	1148	0	60357
7773	490	1060	169	59025	0	60744
7774	366	392	164	59375	0	60297
7775	361	281	200	59166	0	60008
7776	57825	167	173	1687	0	59852
7777	1180	57347	188	736	0	59451
7778	594	1072	189	58191	0	60046
7779	518	398	175	58733	0	59824
7780	439	299	196	58944	0	59878
7781	296	175	56386	1658	0	58515
7782	54938	142	1105	852	0	57037
7783	1262	167	408	57027	0	58864
7784	56034	137	358	1405	0	57934
7785	56624	134	246	702	0	57706
7786	56616	177	216	640	0	57649
7787	1597	214	55445	429	0	57685
7788	743	55014	1080	378	0	57215
7789	534	1144	365	54855	0	56898
7790	316	414	54761	1191	0	56682
7791	344	403	53282	524	0	54553
7792	419	488	1142	51785	0	53834
7793	248	51762	496	1118	0	53624
7794	52711	984	364	643	0	54702
7795	53623	362	202	662	0	54849
7796	54447	298	179	552	0	55476
7797	54471	172	170	525	0	55338
7798	1452	233	52880	355	0	54920
7799	52823	211	887	450	0	54371
7800	1259	53808	365	409	0	55841
7801	577	906	316	55096	0	56895
7802	477	335	216	56108	0	57136
7803	55503	258	208	1403	0	57372
7804	1183	148	195	55565	0	57091
7805	518	139	53602	1305	0	55564
7806	52026	132	964	639	0	53761
7807	53778	137	353	595	0	54863
7808	53572	123	308	533	0	54536
7809	1457	155	51785	322	0	53719
7810	49187	121	892	374	0	50574
7811	1111	49403	389	333	0	51236
7812	50095	732	446	425	0	51698
7813	1170	348	262	49226	0	51006
7814	489	306	212	49647	0	50654
7815	394	48726	213	1021	0	50354
7816	367	799	169	49385	0	50720
7817	285	49036	161	988	0	50470
7818	365	929	157	48806	0	50257
7819	349	48174	146	928	0	49597
7820	388	821	142	48550	0	49901
7821	327	48243	146	964	0	49680
7822	352	899	121	49695	0	51067
7823	279	49600	130	1062	0	51071
7824	53003	939	125	578	0	54645
7825	1285	335	101	53943	0	55664
7826	565	280	108	55002	0	55955
7827	493	203	105	57446	0	58247
7828	388	153	96	58517	0	59154
7829	292	181	58138	1942	0	60553
7830	404	156	1261	58654	0	60475
7831	391	160	401	60221	0	61173
7832	58857	124	260	1933	0	61174
7833	58827	127	144	929	0	60027
7834	1792	58973	161	540	0	61466
7835	877	1295	137	59316	0	61625
7836	644	478	133	62351	0	63606
7837	63194	315	96	2095	0	65700
7838	1775	248	59492	929	0	62444
7839	60056	177	1280	665	0	62178
7840	1766	61548	489	417	0	64220
7841	57936	1245	206	331	0	59718
7842	58047	405	111	321	0	58884
7843	1667	56312	121	225	0	58325
7844	643	58431	88	173	0	59335
7845	708	1814	226	54766	0	57514
7846	244	515	54282	1201	0	56242
7847	53222	216	1159	566	0	55163
7848	1304	153	53903	238	0	55598
7849	52809	153	1211	250	0	54423
7850	1349	104	53493	147	0	55093
7851	502	52851	1245	130	0	54728
7852	384	1151	424	53169	0	55128
7853	52077	380	194	1285	0	53936
7854	53246	197	121	513	0	54077
7855	1694	129	97	52832	0	54752
7856	54131	124	91	1376	0	55722
7857	54691	125	84	569	0	55469
7858	1740	53325	109	270	0	55444
7859	54124	1234	82	319	0	55759
7860	1541	54217	118	190	0	56066
7861	761	1353	91	54354	0	56559
7862	53765	437	110	1517	0	55829
7863	55697	238	86	587	0	56608
7864	55914	171	80	382	0	56547
7865	1983	178	54171	178	0	56510
7866	764	152	55265	171	0	56352
7867	575	132	1648	55831	0	58186
7868	498	123	527	58675	0	59823
7869	296	60186	256	1841	0	62579
7870	60961	1578	158	723	0	63420
7871	1912	585	122	61147	0	63766
7872	885	292	120	62672	0	63969
7873	467	214	61257	2230	0	64168
7874	352	59430	1621	903	0	62306
7875	328	62450	572	481	0	63831
7876	489	2013	268	62342	0	65112
7877	61449	745	225	1970	0	64389
7878	1949	366	167	61697	0	64179
7879	893	227	163	63653	0	64936
7880	62297	249	157	2507	0	65210
7881	63679	213	136	1078	0	65106
7882	2510	203	138	62679	0	65530
7883	1059	228	61750	2035	0	65072
7884	736	207	1622	63047	0	65612
7885	567	169	594	64676	0	66006
7886	63233	167	297	2711	0	66408
7887	2080	150	222	63805	0	66257
7888	63558	173	198	2463	0	66392
7889	2232	213	63349	1134	0	66928
7890	1082	194	1768	64998	0	68042
7891	808	185	652	66849	0	68494
7892	628	193	345	67814	0	68980
7893	654	208	210	67164	0	68236
7894	657	205	216	66100	0	67178
7895	492	250	62714	3082	0	66538
7896	62455	198	1857	1534	0	66044
7897	2245	192	742	63475	0	66654
7898	1023	220	61729	2518	0	65490
7899	713	238	62442	1315	0	64708
7900	721	238	2358	61968	0	65285
7901	61586	230	894	2516	0	65226
7902	62566	251	494	1361	0	64672
7903	63624	247	422	966	0	65259
7904	3074	259	381	60203	0	63917
7905	1338	60760	379	2393	0	64870
7906	62355	1822	371	1313	0	65861
7907	63611	727	388	956	0	65682
7908	63825	429	326	864	0	65444
7909	63671	290	325	861	0	65147
7910	3252	314	323	61086	0	64975
7911	1555	298	60210	2472	0	64535
7912	1126	258	1943	60907	0	64234
7913	868	276	60383	2686	0	64213
7914	60128	209	2114	1460	0	63911
7915	61869	165	878	1097	0	64009
7916	2997	198	59158	916	0	63269
7917	59574	155	2027	964	0	62720
7918	62284	145	906	962	0	64297
7919	3161	204	582	59992	0	63939
7920	1581	59535	458	2387	0	63961
7921	60653	1753	400	1351	0	64157
7922	2720	1281	387	57833	0	62221
7923	1405	56893	337	2277	0	60912
7924	1025	1672	295	55670	0	58662
7925	770	572	54624	2111	0	58077
7926	778	54893	1475	1156	0	58302
7927	52547	1665	837	1056	0	56105
7928	52558	659	693	917	0	54827
7929	51487	296	359	676	0	52818
7930	51815	170	348	693	0	53026
7931	2259	548	338	49211	0	52356
7932	1186	49020	308	1607	0	52121
7933	46863	1163	396	1051	0	49473
7934	1776	500	47827	708	0	50811
7935	1023	46811	1296	600	0	49730
7936	855	1059	44669	560	0	47143
7937	761	505	1187	41061	0	43514
7938	646	38103	523	1084	0	40356
7939	597	887	321	42455	0	44260
7940	553	394	43432	1218	0	45597
7941	598	254	1000	42905	0	44757
7942	568	177	444	44643	0	45832
7943	540	182	323	45211	0	46256
7944	43506	182	240	1528	0	45456
7945	1260	43073	263	860	0	45456
7946	742	909	254	43924	0	45829
7947	42839	366	267	1339	0	44811
7948	1245	43100	255	764	0	45364
7949	43600	926	257	624	0	45407
7950	1408	421	43215	493	0	45537
7951	873	362	955	42556	0	44746
7952	663	43102	436	1145	0	45346
7953	43744	965	312	617	0	45638
7954	1352	428	42543	457	0	44780
7955	814	40529	984	432	0	42759
7956	611	881	434	41189	0	43115
7957	526	415	257	41769	0	42967
7958	41027	280	238	1179	0	42724
7959	1151	248	241	40557	0	42197
7960	652	238	39386	1062	0	41338
7961	560	277	745	38650	0	40232
7962	449	225	39416	1002	0	41092
7963	515	508	788	37788	0	39599
7964	433	38873	385	889	0	40580
7965	38849	745	332	586	0	40512
7966	37963	344	240	467	0	39014
7967	1000	35941	220	343	0	37504
7968	316	34376	150	200	0	35042
7969	616	494	306	32448	0	33864
7970	32316	127	167	475	0	33085
7971	510	114	82	32090	0	32796
7972	31846	69	83	464	0	32462
7973	434	30990	66	155	0	31645
7974	223	331	57	31886	0	32497
7975	164	128	32298	362	0	32952
7976	177	167	336	32058	0	32738
7977	163	125	103	32646	0	33037
7978	32876	78	68	497	0	33519
7979	364	33083	57	193	0	33697
7980	159	398	46	33543	0	34146
7981	33647	111	61	440	0	34259
7982	359	90	33584	164	0	34197
7983	33496	72	306	183	0	34057
7984	433	248	96	34172	0	34949
7985	169	34995	70	354	0	35588
7986	35547	332	56	205	0	36140
7987	416	110	35953	100	0	36579
7988	182	92	35253	88	0	35615
7989	120	35504	369	106	0	36099
7990	34780	271	303	103	0	35457
7991	266	62	39	35107	0	35474
7992	111	46	19	35303	0	35479
7993	35905	23	21	455	0	36404
7994	370	31	36048	136	0	36585
7995	160	23	344	37107	0	37634
7996	98	46	38963	389	0	39496
7997	108	27	405	38789	0	39329
7998	44	39178	150	411	0	39783
7999	56	391	79	40350	0	40876
8000	38	127	40050	459	0	40674
8001	39775	83	423	213	0	40494
8002	485	37	132	41234	0	41888
8003	159	32	41356	478	0	42025
8004	142	25	460	40765	0	41392
8005	88	38	160	41426	0	41712
8006	48	36	40811	617	0	41512
8007	59	51	40919	265	0	41294
8008	79	31	599	42169	0	42878
8009	57	39	42573	516	0	43185
8010	42152	28	572	250	0	43002
8011	511	28	199	43191	0	43929
8012	43099	34	121	606	0	43860
8013	561	39	42559	221	0	43380
8014	254	28	525	43353	0	44160
8015	152	46	46084	549	0	46831
8016	69	45462	612	268	0	46411
8017	90	483	46541	147	0	47261
8018	86	178	44910	131	0	45305
8019	44771	90	693	165	0	45719
8020	46286	34	287	157	0	46764
8021	695	38	47129	91	0	47953
8022	368	42	573	45851	0	46834
8023	251	40	236	47143	0	47670
8024	123	53	48439	687	0	49302
8025	49	46945	625	330	0	47949
8026	46711	506	254	246	0	47717
8027	576	198	48149	103	0	49026
8028	318	111	600	48422	0	49451
8029	235	43	246	49672	0	50196
8030	50394	36	159	863	0	51452
8031	51156	19	122	429	0	51726
8032	51477	29	120	281	0	51907
8033	51862	29	85	212	0	52188
8034	914	32	113	51218	0	52277
8035	361	58	52886	616	0	53921
8036	259	37	641	52981	0	53918
8037	207	35	249	53803	0	54294
8038	212	31	191	55476	0	55910
8039	130	64	54395	961	0	55550
8040	52681	25	681	456	0	53843
8041	867	111	274	54892	0	56144
8042	329	33	56006	851	0	57219
8043	218	56652	796	389	0	58055
8044	210	695	299	58086	0	59290
8045	196	226	212	58973	0	59607
8046	58040	131	155	1127	0	59453
8047	810	58590	148	464	0	60012
8048	341	718	58679	295	0	60033
8049	329	219	791	58271	0	59610
8050	224	136	308	59268	0	59936
8051	58718	62	188	1140	0	60108
8052	58812	53	145	546	0	59556
8053	1089	44	142	59345	0	60620
8054	59313	65	118	1012	0	60508
8055	936	58536	141	438	0	60051
8056	384	729	61497	297	0	62907
8057	351	254	782	61589	0	62976
8058	250	145	312	63768	0	64475
8059	246	82	211	64036	0	64575
8060	238	56	140	63002	0	63436
8061	177	61861	141	1239	0	63418
8062	61797	797	127	622	0	63343
8063	962	270	117	62187	0	63536
8064	342	64117	128	971	0	65558
8065	65194	778	132	550	0	66654
8066	65178	293	99	440	0	66010
8067	1046	65798	145	326	0	67315
8068	508	844	125	67320	0	68797
8069	366	309	98	68085	0	68858
8070	296	185	122	66973	0	67576
8071	282	101	95	68004	0	68482
8072	68081	91	101	1457	0	69730
8073	68641	87	105	717	0	69550
8074	1244	68410	128	441	0	70223
8075	498	1014	68416	289	0	70217
8076	379	353	983	69016	0	70731
8077	69966	184	339	1319	0	71808
8078	1119	67681	223	563	0	69586
8079	423	69175	151	396	0	70145
8080	70617	1223	99	417	0	72356
8081	71799	421	89	349	0	72658
8082	1574	277	101	70792	0	72744
8083	594	168	72587	1286	0	74635
8084	458	232	72867	543	0	74100
8085	76648	190	1446	581	0	78865
8086	79828	181	543	492	0	81044
8087	79421	109	255	399	0	80184
8088	78939	119	171	374	0	79603
8089	78867	116	150	371	0	79504
8090	1631	78274	170	299	0	80374
8091	727	1185	162	77986	0	80060
8092	438	81162	122	1049	0	82771
8093	82790	1163	213	610	0	84776
8094	81840	465	163	551	0	83019
8095	81744	250	107	391	0	82492
8096	81405	155	94	342	0	81996
8097	1391	79371	120	230	0	81112
8098	80217	891	92	365	0	81565
8099	1170	79380	130	229	0	80909
8100	676	1130	96	80381	0	82283
8101	80010	299	91	1142	0	81542
8102	1151	219	80602	379	0	82351
8103	605	179	821	79264	0	80869
8104	453	193	244	81640	0	82530
8105	326	167	81184	1145	0	82822
8106	264	81014	899	507	0	82684
8107	81663	949	279	482	0	83373
8108	81375	301	153	379	0	82208
8109	1192	79861	135	262	0	81450
8110	556	977	123	80759	0	82415
8111	397	354	82577	975	0	84303
8112	350	84641	862	402	0	86255
8113	84861	975	261	540	0	86637
8114	1098	351	84010	242	0	85701
8115	78438	213	839	356	0	79846
8116	82584	168	285	301	0	83338
8117	1227	196	84367	219	0	86009
8118	516	83942	871	235	0	85564
8119	695	957	305	82562	0	84519
8120	386	330	86024	876	0	87616
8121	81739	268	913	534	0	83454
8122	84943	169	269	391	0	85772
8123	1101	84217	198	199	0	85715
8124	536	815	129	85102	0	86582
8125	406	316	119	86598	0	87439
8126	355	221	86153	947	0	87676
8127	293	86414	758	377	0	87842
8128	90386	868	251	682	0	92187
8129	91164	284	149	472	0	92069
8130	92341	206	112	494	0	93153
8131	1146	227	90275	169	0	91817
8132	89588	145	750	369	0	90852
8133	93017	130	239	307	0	93693
8134	1169	154	141	92759	0	94223
8135	498	163	90490	725	0	91876
8136	519	214	666	89593	0	90992
8137	379	193	91674	746	0	92992
8138	376	448	680	89202	0	90706
8139	282	89800	281	732	0	91095
8140	222	94845	148	281	0	95496
8141	337	747	157	96899	0	98140
8142	380	271	125	93730	0	94506
8143	95074	140	93	1049	0	96356
8144	802	196	93833	232	0	95063
8145	91302	108	614	417	0	92441
8146	759	95268	209	176	0	96412
8147	96628	608	145	391	0	97772
8148	96675	195	120	346	0	97336
8149	915	134	95	96608	0	97752
8150	415	138	99702	625	0	100880
8151	427	162	613	99657	0	100859
8152	246	103358	250	690	0	104544
8153	319	739	132	105810	0	107000
8154	303	277	106	106635	0	107321
8155	105248	167	98	1222	0	106735
8156	952	133	84	103483	0	104652
8157	368	101086	146	903	0	102503
8158	390	714	77	104034	0	105215
8159	104379	269	77	1159	0	105884
8160	877	104578	113	436	0	106004
8161	445	913	143	108302	0	109803
8162	369	304	110	108895	0	109678
8163	386	221	76	111440	0	112123
8164	314	141	76	110149	0	110680
8165	111190	116	71	1838	0	113215
8166	1356	111	89	113183	0	114739
8167	612	134	77	114767	0	115590
8168	545	209	77	116605	0	117436
8169	210	117141	115	2122	0	119588
8170	117331	1510	119	1139	0	120099
8171	1735	544	117311	499	0	120089
8172	543	116679	1450	408	0	119080
8173	115397	1466	475	573	0	117911
8174	1669	520	117803	219	0	120211
8175	546	117964	1442	270	0	120222
8176	710	1919	559	117360	0	120548
8177	260	119163	370	1353	0	121146
8178	262	1559	118004	450	0	120275
8179	282	605	117491	382	0	118760
8180	126	118921	1690	280	0	121017
8181	119380	1409	724	576	0	122089
8182	119072	487	429	588	0	120576
8183	1618	386	114116	159	0	116279
8184	757	318	105747	165	0	106987
8185	443	232	110924	135	0	111734
8186	464	140	1810	110710	0	113124
8187	486	134	727	110196	0	111543
8188	354	121	425	114658	0	115558
8189	173	154	116744	1962	0	119033
8190	481	139	1429	111716	0	113765
8191	332	111	514	116185	0	117142
8192	187	148	113648	1955	0	115938
8193	110080	119	1561	1195	0	112955
8194	1731	117	554	118328	0	120730
8195	827	132	385	118073	0	119417
8196	403	119202	338	2086	0	122029
8197	120219	1537	261	1313	0	123330
8198	1753	632	119032	594	0	122011
8199	118090	370	1628	692	0	120780
8200	2153	250	663	120083	0	123149
8201	799	289	121306	1813	0	124207
8202	770	226	1755	120158	0	122909
8203	121170	190	752	2496	0	124608
8204	1865	219	120686	856	0	123626
8205	118966	154	1911	973	0	122004
8206	122035	154	761	857	0	123807
8207	123150	142	562	798	0	124652
8208	2573	120156	468	697	0	123894
8209	1333	1606	314	124163	0	127416
8210	125754	580	352	2298	0	128984
8211	125346	380	357	1198	0	127281
8212	126809	253	279	976	0	128317
8213	2982	272	121854	504	0	125612
8214	127048	195	1972	648	0	129863
8215	3058	157	812	133858	0	137885
8216	1308	215	132811	2729	0	137063
8217	1183	173	2608	136846	0	140810
8218	989	158	937	139052	0	141136
8219	590	240	139285	4077	0	144192
8220	863	138	3255	139945	0	144201
8221	934	167	1196	144070	0	146367
8222	491	243	158445	4717	0	163896
8223	164201	137	4252	2598	0	171188
8224	180578	133	1899	1777	0	184387
8225	7107	139	1344	184253	0	192843
8226	3301	253	182979	5644	0	192177
8227	3038	189	5492	179784	0	188503
8228	2054	177605	2347	6496	0	188502
8229	2432	4820	1582	180683	0	189517
8230	1954	1784	1290	185454	0	190482
8231	180472	1171	1250	9192	0	192085
8232	181555	928	1192	5468	0	189143
8233	186423	863	1101	4149	0	192536
8234	9038	899	890	182209	0	193036
8235	5109	807	666	186699	0	193281
8236	3741	748	178046	9220	0	191755
8237	3878	683	5378	175629	0	185568
8238	3057	176445	2350	8261	0	190113
8239	178826	5120	1661	5042	0	190649
8240	6953	174635	1486	4063	0	187137
8241	176952	6121	1424	3877	0	188374
8242	7817	2840	1356	168971	0	180984
8243	3844	172179	1302	7153	0	184478
8244	173277	6508	1173	4295	0	185253
8245	177121	3375	966	3433	0	184895
8246	9525	2545	843	170675	0	183588
8247	5092	170647	982	7275	0	183996
8248	4490	6558	854	173052	0	184954
8249	3512	3165	168342	8256	0	183275
8250	164911	2377	5598	4929	0	177815
8251	7828	166473	2506	3774	0	180581
8252	165422	6304	1725	3460	0	176911
8253	8498	3152	1471	164520	0	177641
8254	167155	2432	1475	7856	0	178918
8255	8634	1985	165252	4257	0	180128
8256	171092	1682	6142	3721	0	182637
8257	173936	1582	2846	3295	0	181659
8258	10832	1505	168856	2925	0	184118
8259	7189	1230	6684	168364	0	183467
8260	5942	1000	3235	171945	0	182122
8261	167286	1064	2644	9866	0	180860
8262	9051	163051	2410	5572	0	180084
8263	5599	8647	2260	160459	0	176965
8264	4478	2721	158864	8678	0	174741
8265	3767	2080	157540	5500	0	168887
8266	3491	154997	7314	4755	0	170557
8267	3891	6151	154846	4062	0	168950
8268	149681	3483	7358	3888	0	164410
8269	7609	2576	4039	145876	0	160100
8270	150680	1883	3207	7694	0	163464
8271	7521	1922	148854	4317	0	162614
8272	4858	1801	7063	148794	0	162516
8273	4084	1824	3693	153249	0	162850
8274	3775	1698	146225	8657	0	160355
8275	3869	1458	6681	147864	0	159872
8276	144363	1573	3487	8968	0	158391
8277	149094	1218	2895	5759	0	158966
8278	9147	1224	2549	146420	0	159340
8279	145291	1191	2333	8958	0	157773
8280	147191	1110	2047	5813	0	156161
8281	10085	139293	1985	4752	0	156115
8282	6948	5271	1754	142972	0	156945
8283	144954	2431	1544	8358	0	157287
8284	9835	1910	1651	144111	0	157507
8285	143137	1575	1603	9004	0	155319
8286	9763	1746	1578	141777	0	154864
8287	6316	1793	138176	9143	0	155428
8288	5025	137917	5747	6183	0	154872
8289	5226	6148	2901	125986	0	140261
8290	4702	135886	2311	8006	0	150905
8291	135085	6400	2367	5464	0	149316
8292	8239	130331	2326	4540	0	145436
8293	5150	132629	2260	3997	0	144036
8294	4398	7954	2194	129351	0	143897
8295	128586	4673	2016	8097	0	143372
8296	7687	3611	1636	129147	0	142081
8297	128041	3334	1520	8637	0	141532
8298	128859	3260	1364	5505	0	138988
8299	9125	126339	1525	4574	0	141563
8300	129953	6552	1656	4235	0	142396
8301	132017	3557	1594	3934	0	141102
8302	132677	2764	1588	3675	0	140704
8303	11289	2352	121527	3212	0	138380
8304	7909	2178	5342	122506	0	137935
8305	7009	1955	2630	126940	0	138534
8306	5902	1954	117736	8562	0	134154
8307	124030	1703	5727	5330	0	136790
8308	128311	1409	3313	4802	0	137835
8309	127666	1345	2753	4386	0	136150
8310	124171	1275	2475	4380	0	132301
8311	10743	115610	2112	4191	0	132656
8312	119336	4884	1679	3610	0	129509
8313	10919	2585	1599	114236	0	129339
8314	7592	1975	102196	6454	0	118217
8315	106641	1612	4108	3748	0	116109
8316	9081	103955	2174	2995	0	118205
8317	99672	4516	1787	2682	0	108657
8318	7688	95016	1462	2720	0	106886
8319	5232	91648	1388	2840	0	101108
8320	4379	90966	1520	2868	0	99733
8321	4169	90165	1733	2892	0	98959
8322	3580	4598	70459	2121	0	80758
8323	3122	5645	3307	57113	0	69187
8324	1429	1117	51933	2211	0	56690
8325	43583	566	1346	859	0	46354
8326	1493	43067	586	618	0	45764
8327	749	43968	366	591	0	45674
8328	686	1473	344	42594	0	45097
8329	786	765	232	43221	0	45004
8330	585	628	41874	1497	0	44584
8331	554	568	41853	727	0	43702
8332	607	537	1214	41557	0	43915
8333	575	336	41548	1356	0	43815
8334	612	41033	1185	675	0	43505
8335	787	1056	501	40128	0	42472
8336	777	474	303	42928	0	44482
8337	738	347	41831	1425	0	44341
8338	770	300	992	41718	0	43780
8339	42206	246	477	1360	0	44289
8340	1466	235	375	41733	0	43809
8341	769	204	332	42207	0	43512
8342	538	213	40877	1699	0	43327
8343	39996	200	1108	919	0	42223
8344	1427	41143	496	645	0	43711
8345	971	989	294	41350	0	43604
8346	876	426	40940	1179	0	43421
8347	849	424	976	40812	0	43061
8348	41332	347	380	1274	0	43333
8349	1562	365	40897	632	0	43456
8350	918	488	1093	40743	0	43242
8351	723	274	41746	1289	0	44032
8352	616	41386	1103	765	0	43870
8353	801	1156	41065	461	0	43483
8354	527	40146	1088	524	0	42285
8355	427	917	36401	337	0	38082
8356	407	831	837	32829	0	34904
8357	185	33918	396	593	0	35092
8358	33212	591	174	326	0	34303
8359	631	292	121	33396	0	34440
8360	33947	187	121	611	0	34866
8361	752	151	84	34789	0	35776
8362	402	179	90	35566	0	36237
8363	35437	145	98	844	0	36524
8364	36240	102	89	456	0	36887
8365	965	97	116	37275	0	38453
8366	450	96	38020	782	0	39348
8367	345	37578	658	342	0	38923
8368	336	662	38227	190	0	39415
8369	239	38660	659	185	0	39743
8370	38214	663	337	243	0	39457
8371	745	268	37494	146	0	38653
8372	365	164	37229	144	0	37902
8373	233	142	800	36285	0	37460
8374	37140	85	321	726	0	38272
8375	701	94	37967	316	0	39078
8376	348	38951	707	159	0	40165
8377	39963	601	280	238	0	41082
8378	40495	267	161	230	0	41153
8379	41068	144	119	188	0	41519
8380	41237	139	134	173	0	41683
8381	41011	173	102	172	0	41458
8382	980	103	39981	122	0	41186
8383	420	391	620	38616	0	40047
8384	265	38980	300	537	0	40082
8385	39925	570	153	284	0	40932
8386	619	40066	136	147	0	40968
8387	38305	513	171	154	0	39143
8388	38196	188	80	148	0	38612
8389	638	37666	100	78	0	38482
8390	38607	508	80	120	0	39315
8391	613	169	66	38588	0	39436
8392	290	96	93	39071	0	39550
8393	177	81	38232	616	0	39106
8394	143	38946	482	255	0	39826
8395	183	499	182	39420	0	40284
8396	165	174	113	40025	0	40477
8397	154	101	98	39940	0	40293
8398	122	95	38565	663	0	39445
8399	37247	85	493	290	0	38115
8400	569	91	176	39281	0	40117
8401	39960	57	124	615	0	40756
8402	626	78	99	40035	0	40838
8403	273	72	40639	600	0	41584
8404	185	83	40384	252	0	40904
8405	39854	101	685	252	0	40892
8406	41286	71	264	207	0	41828
8407	675	40198	143	124	0	41140
8408	277	499	40327	102	0	41205
8409	263	200	542	39649	0	40654
8410	501	229	300	33678	0	34708
8411	41812	58	116	733	0	42719
8412	42068	62	99	336	0	42565
8413	42248	61	86	222	0	42617
8414	710	63	41430	122	0	42325
8415	42621	68	495	243	0	43427
8416	657	42	187	43170	0	44056
8417	318	65	99	43465	0	43947
8418	213	56	107	43654	0	44030
8419	152	42705	111	668	0	43636
8420	42723	471	78	327	0	43599
8421	600	173	76	42569	0	43418
8422	272	130	42261	555	0	43218
8423	237	83	495	41856	0	42671
8424	153	42258	232	555	0	43198
8425	43021	487	132	322	0	43962
8426	611	174	92	42852	0	43729
8427	318	125	96	42634	0	43173
8428	198	111	42678	689	0	43676
8429	195	78	500	42409	0	43182
8430	181	42700	214	593	0	43688
8431	197	503	110	43856	0	44666
8432	173	195	43737	596	0	44701
8433	40878	91	505	394	0	41868
8434	43285	78	208	263	0	43834
8435	691	43666	122	155	0	44634
8436	43331	424	100	208	0	44063
8437	44373	131	80	190	0	44774
8438	631	43843	99	150	0	44723
8439	311	567	69	44568	0	45515
8440	45447	174	107	657	0	46385
8441	569	46165	82	250	0	47066
8442	238	511	46636	138	0	47523
8443	46668	166	632	218	0	47684
8444	48755	85	174	187	0	49201
8445	48903	73	97	185	0	49258
8446	48803	67	73	216	0	49159
8447	814	49201	83	139	0	50237
8448	50242	563	71	206	0	51082
8449	51374	182	49	215	0	51820
8450	51986	102	60	192	0	52340
8451	978	88	51	51697	0	52814
8452	51578	65	60	866	0	52569
8453	782	53519	79	268	0	54648
8454	305	778	55984	142	0	57209
8455	349	296	863	57957	0	59465
8456	59424	119	213	1091	0	60847
8457	1117	113	59090	264	0	60584
8458	532	75	994	59293	0	60894
8459	232	103	59354	1049	0	60738
8460	181	59035	1051	337	0	60604
8461	312	1052	259	58386	0	60009
8462	180	253	58523	996	0	59952
8463	130	57970	1017	298	0	59415
8464	414	1111	276	57513	0	59314
8465	57490	265	256	1217	0	59228
8466	57655	113	95	378	0	58241
8467	58003	77	64	287	0	58431
8468	57841	57	86	222	0	58206
8469	57698	59	76	224	0	58057
8470	1220	84	57082	113	0	58499
8471	57279	48	852	236	0	58415
8472	59393	55	233	214	0	59895
8473	1234	93	155	58606	0	60088
8474	58963	80	99	991	0	60133
8475	57679	70	87	355	0	58191
8476	1106	56281	99	206	0	57692
8477	523	850	96	56962	0	58431
8478	411	199	83	58038	0	58731
8479	57333	124	62	1216	0	58735
8480	1078	56370	103	362	0	57913
8481	388	57946	102	224	0	58660
8482	433	1053	101	59105	0	60692
8483	381	305	103	60003	0	60792
8484	365	177	85	59544	0	60171
8485	376	100	88	60479	0	61043
8486	58940	84	76	1430	0	60530
8487	59020	82	45	572	0	59719
8488	1352	107	58683	265	0	60407
8489	665	85	927	58035	0	59712
8490	462	102	218	59494	0	60276
8491	257	116	58244	1255	0	59872
8492	56730	75	944	597	0	58346
8493	1133	57756	252	322	0	59463
8494	58047	965	147	283	0	59442
8495	1324	270	101	57679	0	59374
8496	437	205	58127	1130	0	59899
8497	428	184	973	58970	0	60555
8498	266	81	60752	1239	0	62338
8499	229	61033	1025	441	0	62728
8500	60203	1013	423	482	0	62121
8501	60518	266	183	346	0	61313
8502	1180	59595	177	209	0	61161
8503	518	935	112	59158	0	60723
8504	58394	259	122	1185	0	59960
8505	1045	57894	141	403	0	59483
8506	457	979	94	58745	0	60275
8507	59075	278	116	1180	0	60649
8508	1153	226	57750	367	0	59496
8509	57340	134	936	435	0	58845
8510	1120	58228	288	297	0	59933
8511	58642	932	222	349	0	60145
8512	58819	276	191	309	0	59595
8513	1318	225	57426	220	0	59189
8514	656	165	942	56192	0	57955
8515	504	138	265	58136	0	59043
8516	339	162	57516	1219	0	59236
8517	371	152	955	56560	0	58038
8518	527	158	308	54837	0	55830
8519	58398	140	211	1345	0	60094
8520	59024	116	160	554	0	59854
8521	1375	122	142	58155	0	59794
8522	565	148	58030	1123	0	59866
8523	493	123	970	58493	0	60079
8524	407	118	292	59414	0	60231
8525	362	136	59338	1278	0	61114
8526	385	140	981	60086	0	61592
8527	59953	99	302	1360	0	61714
8528	60126	99	222	571	0	61018
8529	1222	59050	202	410	0	60884
8530	60494	943	133	467	0	62037
8531	60636	252	131	433	0	61452
8532	1343	60157	153	309	0	61962
8533	61358	1000	118	409	0	62885
8534	61904	269	119	365	0	62657
8535	62614	174	115	401	0	63304
8536	1531	164	60041	282	0	62018
8537	60466	113	995	377	0	61951
8538	1398	206	269	61933	0	63806
8539	61855	101	230	1282	0	63468
8540	1337	120	60507	493	0	62457
8541	561	58985	1041	345	0	60932
8542	59621	986	391	368	0	61366
8543	1219	60464	210	254	0	62147
8544	593	1017	158	60536	0	62304
8545	426	321	134	62227	0	63108
8546	61921	199	124	1436	0	63680
8547	61617	128	137	607	0	62489
8548	1499	141	59980	303	0	61923
8549	614	157	56165	263	0	57199
8550	416	134	57635	202	0	58387
8551	484	678	1211	56495	0	58868
8552	267	119	57066	1040	0	58492
8553	319	182	54080	359	0	54940
8554	731	1116	1095	50791	0	53733
8555	52981	134	447	1034	0	54596
8556	53708	37	135	369	0	54249
8557	54005	28	106	242	0	54381
8558	54391	20	79	190	0	54680
8559	900	23	94	53871	0	54888
8560	380	25	76	54531	0	55012
8561	203	47	55387	792	0	56429
8562	240	39	682	54895	0	55856
8563	348	35	268	53013	0	53664
8564	57126	33	123	999	0	58281
8565	57217	20	103	402	0	57742
8566	1027	39	81	56874	0	58021
8567	57529	23	79	942	0	58573
8568	58451	26	71	401	0	58949
8569	1136	32	60	58533	0	59761
8570	481	26	70	58401	0	58978
8571	271	58	56770	1103	0	58202
8572	232	95	55367	430	0	56124
8573	274	161	960	56960	0	58355
8574	261	65	345	58507	0	59178
8575	170	38	58001	1064	0	59273
8576	56040	17	841	534	0	57432
8577	57277	23	291	350	0	57941
8578	1121	52	56056	201	0	57430
8579	433	55865	816	207	0	57321
8580	57147	665	353	282	0	58447
8581	906	226	58683	164	0	59979
8582	475	178	824	58021	0	59498
8583	368	89	340	59687	0	60484
8584	61053	44	206	1091	0	62394
8585	63617	24	159	576	0	64376
8586	1097	27	136	63889	0	65149
8587	531	25	110	67260	0	67926
8588	67269	23	121	1294	0	68707
8589	68013	26	121	575	0	68735
8590	67810	28	137	406	0	68381
8591	1361	47	67507	246	0	69161
8592	644	31	951	68091	0	69717
8593	426	26	306	70127	0	70885
8594	69693	14	211	1416	0	71334
8595	1137	69209	172	569	0	71087
8596	74330	882	137	485	0	75834
8597	1499	74054	162	294	0	76009
8598	711	1311	137	76660	0	78819
8599	532	346	151	78467	0	79496
8600	314	173	77143	2048	0	79678
8601	464	89	1520	77531	0	79604
8602	304	122	77258	1945	0	79629
8603	449	81	1682	78398	0	80610
8604	389	86	537	78915	0	79927
8605	267	74725	371	2236	0	77599
8606	267	78691	247	929	0	80134
8607	507	1809	221	77395	0	79932
8608	418	566	190	80682	0	81856
8609	411	259	179	81402	0	82251
8610	404	170	182	82085	0	82841
8611	385	129	164	83577	0	84255
8612	279	164	80859	2676	0	83978
8613	423	125	1745	80814	0	83107
8614	366	107	524	83376	0	84373
8615	309	149	79148	2558	0	82164
8616	253	78269	1833	1144	0	81499
8617	412	1616	576	80544	0	83148
8618	275	503	79347	2169	0	82294
8619	238	79836	1871	949	0	82894
8620	392	1673	580	81592	0	84237
8621	83082	481	405	2362	0	86330
8622	1992	294	281	82867	0	85434
8623	795	207	224	84106	0	85332
8624	524	173	242	85127	0	86066
8625	471	181	231	83406	0	84289
8626	331	79514	244	2818	0	82907
8627	415	1646	226	82655	0	84942
8628	84414	536	242	2810	0	88002
8629	1972	339	198	85943	0	88452
8630	786	234	201	86187	0	87408
8631	559	194	231	87392	0	88376
8632	83369	193	205	3106	0	86873
8633	84224	162	229	1587	0	86202
8634	2459	135	199	84524	0	87317
8635	81218	175	196	2547	0	84136
8636	83015	172	180	1364	0	84731
8637	2189	82109	215	964	0	85477
8638	82035	1580	205	1025	0	84845
8639	1889	81016	234	794	0	83933
8640	673	82079	196	775	0	83723
8641	680	1953	336	83230	0	86199
8642	494	672	83479	2063	0	86708
8643	509	520	1512	81684	0	84225
8644	428	305	495	83101	0	84329
8645	294	81246	372	2212	0	84124
8646	81520	1554	204	1198	0	84476
8647	1721	501	170	81871	0	84263
8648	595	366	85468	2061	0	88490
8649	544	380	1396	85329	0	87649
8650	315	86203	461	2100	0	89079
8651	87504	1484	316	1188	0	90492
8652	1700	519	199	88289	0	90707
8653	582	415	87825	2044	0	90866
8654	585	325	1386	88406	0	90702
8655	369	85452	490	2104	0	88415
8656	373	1521	304	88250	0	90448
8657	89018	531	270	2450	0	92269
8658	90880	383	232	1365	0	92860
8659	91332	275	232	1192	0	93031
8660	2105	90623	278	1048	0	94054
8661	91558	1599	240	918	0	94315
8662	2054	549	182	92287	0	95072
8663	91262	402	220	2447	0	94331
8664	1958	91419	190	1119	0	94686
8665	813	1891	166	93540	0	96410
8666	524	634	93542	2183	0	96883
8667	88345	497	1549	1402	0	91793
8668	1697	93592	510	1015	0	96814
8669	728	1752	317	94760	0	97557
8670	542	555	211	96903	0	98211
8671	469	392	174	95075	0	96110
8672	464	289	201	93281	0	94235
8673	301	92300	218	2541	0	95360
8674	94287	1572	165	1363	0	97387
8675	94521	561	174	1011	0	96267
8676	2057	475	94024	701	0	97257
8677	935	347	1497	94910	0	97689
8678	563	317	94652	2049	0	97581
8679	93579	262	1658	1140	0	96639
8680	95943	274	519	1014	0	97750
8681	93605	205	336	839	0	94985
8682	2319	235	216	91263	0	94033
8683	874	89289	199	2034	0	92396
8684	91334	1529	130	1109	0	94102
8685	1946	636	127	90157	0	92866
8686	89796	371	163	2140	0	92470
8687	1896	302	84458	846	0	87502
8688	786	271	81623	652	0	83332
8689	86112	191	1440	662	0	88405
8690	1864	289	533	86418	0	89104
8691	85309	162	327	1843	0	87641
8692	1709	84261	236	764	0	86970
8693	85767	1309	219	774	0	88069
8694	86198	465	232	681	0	87576
8695	2009	398	83832	381	0	86620
8696	698	255	75994	232	0	77179
8697	442	77585	1140	273	0	79440
8698	814	1001	740	77020	0	79575
8699	77503	252	537	1052	0	79344
8700	879	147	84	77158	0	78268
8701	425	119	71	78857	0	79472
8702	298	130	76409	935	0	77772
8703	75145	94	661	568	0	76468
8704	871	238	213	79315	0	80637
8705	430	149	77084	797	0	78460
8706	410	188	73733	322	0	74653
8707	401	445	805	76972	0	78623
8708	259	171	77079	754	0	78263
8709	325	169	75421	318	0	76233
8710	483	230	787	71061	0	72561
8711	256	123	78042	674	0	79095
8712	303	124	645	76407	0	77479
8713	182	73306	311	745	0	74544
8714	79035	575	166	512	0	80288
8715	706	78775	178	273	0	79932
8716	362	742	94	80243	0	81441
8717	223	80879	130	802	0	82034
8718	232	850	83876	347	0	85305
8719	530	270	962	95031	0	96793
8720	222	237	111422	1854	0	113735
8721	110400	122	2397	995	0	113914
8722	2590	117962	994	388	0	121934
8723	120940	2620	610	446	0	124616
8724	3584	1031	281	119059	0	123955
8725	121071	665	227	3011	0	124974
8726	3575	362	118957	1142	0	124036
8727	1470	119402	2780	789	0	124441
8728	119488	2728	1041	668	0	123925
8729	3531	1113	700	114728	0	120072
8730	1441	118167	449	2565	0	122622
8731	1312	3027	298	120879	0	125516
8732	121766	1215	314	3876	0	127171
8733	3203	130280	345	1508	0	135336
8734	131792	3737	285	1256	0	137070
8735	4427	1609	127374	567	0	133977
8736	129497	947	3429	691	0	134564
8737	4914	522	1262	129744	0	136442
8738	129445	423	885	4081	0	134834
8739	4425	127520	567	1508	0	134020
8740	2251	3496	424	129319	0	135490
8741	1698	1393	309	132352	0	135752
8742	936	992	124989	4947	0	131864
8743	1119	542	3469	125614	0	130744
8744	962	466	1312	129864	0	132604
8745	959	432	817	130490	0	132698
8746	938	374	490	131399	0	133201
8747	626	415	126704	5872	0	133617
8748	603	120546	3711	2742	0	127602
8749	840	3577	1444	123837	0	129698
8750	121751	1335	968	4708	0	128762
8751	123253	863	642	2399	0	127157
8752	4870	122433	553	1618	0	129474
8753	122549	3859	475	1453	0	128336
8754	124252	1450	503	1274	0	127479
8755	123896	1034	492	1284	0	126706
8756	5795	119327	517	1055	0	126694
8757	119309	3797	414	1115	0	124635
8758	5355	1807	398	114788	0	122348
8759	2210	1103	113551	4118	0	120982
8760	1532	113084	3391	1941	0	119948
8761	1525	3883	1476	113649	0	120533
8762	997	1537	111665	4138	0	118337
8763	110749	1089	3561	2060	0	117459
8764	4261	776	1422	111868	0	118327
8765	2155	662	938	113845	0	117600
8766	1747	577	532	113388	0	116244
8767	1511	572	425	113881	0	116389
8768	1076	665	106874	5732	0	114347
8769	102365	547	3428	3030	0	109370
8770	4015	105813	1419	1918	0	113165
8771	106987	3534	1005	1480	0	113006
8772	4477	107222	657	1160	0	113516
8773	108870	4189	542	1179	0	114780
8774	4898	1709	471	107795	0	114873
8775	2181	1157	106093	4313	0	113744
8776	1644	800	107049	2133	0	111626
8777	1292	751	4533	106440	0	113016
8778	1108	643	1927	108525	0	112203
8779	1080	541	1196	110400	0	113217
8780	105720	485	862	6185	0	113252
8781	4083	605	105089	3094	0	112871
8782	2159	607	3632	102798	0	109196
8783	1646	105401	1474	4306	0	112827
8784	105666	3760	1067	2340	0	112833
8785	4487	1630	104065	1686	0	111868
8786	2218	103591	3773	1393	0	110975
8787	1794	3858	104713	1229	0	111594
8788	1499	1716	4248	104928	0	112391
8789	1322	1277	104702	4375	0	111676
8790	1132	985	105734	2296	0	110147
8791	1188	853	4867	105491	0	112399
8792	1074	717	104722	4681	0	111194
8793	1104	682	106313	2420	0	110519
8794	1077	640	5080	104159	0	110956
8795	103001	575	2403	4963	0	110942
8796	4145	640	103119	2534	0	110438
8797	2097	631	4286	102608	0	109622
8798	1533	627	2073	106002	0	110235
8799	102496	663	1525	5656	0	110340
8800	4294	708	1077	104360	0	110439
8801	101910	499	1083	5451	0	108943
8802	4670	99872	961	2756	0	108259
8803	2290	3552	957	103532	0	110331
8804	102910	1413	936	5029	0	110288
8805	105728	992	957	2698	0	110375
8806	5416	720	877	103850	0	110863
8807	2669	656	101687	4897	0	109909
8808	100148	561	3852	2735	0	107296
8809	4292	101550	1821	2192	0	109855
8810	97717	3613	1454	2071	0	104855
8811	103447	1461	981	1736	0	107625
8812	104285	1027	909	1637	0	107858
8813	6033	715	98617	1429	0	106794
8814	3054	97866	3668	1458	0	106046
8815	2441	4313	1674	97306	0	105734
8816	2035	2437	1337	99706	0	105515
8817	1629	1123	95475	5114	0	103341
8818	1313	89810	3416	2772	0	97311
8819	910	77064	1264	1712	0	80950
8820	644	63962	642	751	0	65999
8821	58445	1906	2357	653	0	63361
8822	1919	615	503	56193	0	59230
8823	675	347	323	56981	0	58326
8824	501	303	55572	1698	0	58074
8825	54445	276	1236	772	0	56729
8826	1550	214	439	55789	0	57992
8827	834	704	350	56204	0	58092
8828	705	210	54819	1665	0	57399
8829	416	54255	1271	718	0	56660
8830	594	1811	538	54138	0	57081
8831	367	405	53964	1473	0	56209
8832	211	49637	962	590	0	51400
8833	43102	500	272	268	0	44142
8834	544	159	43719	167	0	44589
8835	226	194	444	42278	0	43142
8836	148	43135	148	424	0	43855
8837	43432	412	157	235	0	44236
8838	508	118	90	43439	0	44155
8839	43649	91	70	514	0	44324
8840	43750	73	53	239	0	44115
8841	513	43535	65	149	0	44262
8842	44053	412	66	195	0	44726
8843	45448	108	70	235	0	45861
8844	525	99	45209	86	0	45919
8845	44993	93	388	176	0	45650
8846	476	81	45094	95	0	45746
8847	44688	58	388	140	0	45274
8848	45352	47	131	156	0	45686
8849	439	58	45425	72	0	45994
8850	241	140	326	45322	0	46029
8851	133	70	46139	326	0	46668
8852	141	81	42880	131	0	43233
8853	123	112	45796	111	0	46142
8854	176	227	397	45721	0	46521
8855	103	34	124	49139	0	49400
8856	106	28	54	49650	0	49838
8857	105	32	49	50775	0	50961
8858	88	49	51257	576	0	51970
8859	152	50	478	50747	0	51427
8860	94	49473	155	584	0	50306
8861	73	504	53630	167	0	54374
8862	165	143	577	53069	0	53954
8863	60	92	54989	614	0	55755
8864	70	54064	664	225	0	55023
8865	51	55634	237	134	0	56056
8866	136	731	113	55766	0	56746
8867	72	247	55613	641	0	56573
8868	78	135	55501	214	0	55928
8869	143	130	790	56195	0	57258
8870	143	59	260	56786	0	57248
8871	126	50	140	57842	0	58158
8872	63	84	57189	880	0	58216
8873	63	56206	677	321	0	57267
8874	54	58859	244	174	0	59331
8875	99	826	146	59212	0	60283
8876	54	267	58249	722	0	59292
8877	79	167	57944	241	0	58431
8878	50	60465	849	183	0	61547
8879	61245	742	329	226	0	62542
8880	707	62051	194	128	0	63080
8881	215	843	64143	101	0	65302
8882	64486	221	896	176	0	65779
8883	968	117	280	66648	0	68013
8884	68275	85	170	1122	0	69652
8885	1072	83	110	68973	0	70238
8886	396	84	98	70726	0	71304
8887	70449	85	89	1443	0	72066
8888	1055	72375	118	488	0	74036
8889	361	1109	72120	236	0	73826
8890	162	73412	1039	189	0	74802
8891	73049	1172	330	262	0	74813
8892	1089	73177	220	145	0	74631
8893	73677	1205	135	256	0	75273
8894	73950	395	103	252	0	74700
8895	1395	73764	139	155	0	75453
8896	533	1151	92	73402	0	75178
8897	73064	351	119	1286	0	74820
8898	73931	214	96	508	0	74749
8899	1530	138	108	72735	0	74511
8900	522	132	71073	1184	0	72911
8901	312	150	71503	403	0	72368
8902	293	245	1381	72699	0	74618
8903	167	127	71314	1244	0	72852
8904	69135	172	1271	558	0	71136
8905	1145	70118	404	360	0	72027
8906	534	1105	226	71697	0	73562
8907	343	353	132	72453	0	73281
8908	287	198	127	71933	0	72545
8909	271	130	119	71108	0	71628
8910	260	100	129	72267	0	72756
8911	179	131	70664	1586	0	72560
8912	145	70605	1102	602	0	72454
8913	71719	1112	418	423	0	73672
8914	1272	367	217	71153	0	73009
8915	505	219	148	72144	0	73016
8916	332	160	141	72060	0	72693
8917	191	71253	179	1637	0	73260
8918	290	1176	120	73266	0	74852
8919	248	421	126	74405	0	75200
8920	72156	238	106	1829	0	74329
8921	1217	69791	169	719	0	71896
8922	409	71319	143	459	0	72330
8923	340	1457	115	71862	0	73774
8924	71176	484	147	1535	0	73342
8925	1275	313	71405	531	0	73524
8926	68957	213	1233	595	0	70998
8927	1384	192	73001	331	0	74908
8928	608	198	1279	72996	0	75081
8929	380	189	415	74688	0	75672
8930	292	166	229	74121	0	74808
8931	254	142	193	74129	0	74718
8932	310	167	157	72707	0	73341
8933	72838	172	168	1927	0	75105
8934	1323	154	71395	756	0	73628
8935	515	152	1238	72930	0	74835
8936	311	196	74860	1447	0	76814
8937	209	74739	1330	671	0	76949
8938	75139	1199	483	620	0	77441
8939	1328	446	77146	433	0	79353
8940	613	264	1293	77958	0	80128
8941	450	201	470	80246	0	81367
8942	236	193	79656	1934	0	82019
8943	259	205	79276	824	0	80564
8944	463	200	1718	75284	0	77665
8945	80198	157	587	1849	0	82791
8946	80791	156	325	852	0	82124
8947	1771	79494	250	542	0	82057
8948	81481	1361	191	557	0	83590
8949	1704	503	198	78856	0	81261
8950	646	81286	219	1552	0	83703
8951	477	1405	190	82814	0	84886
8952	347	519	83178	1730	0	85774
8953	462	290	1366	80872	0	82990
8954	484	221	478	83424	0	84607
8955	80243	171	265	1940	0	82619
8956	1347	79764	216	891	0	82218
8957	79134	1223	169	644	0	81170
8958	1395	78477	216	409	0	80497
8959	76509	1238	175	478	0	78400
8960	1313	75281	189	371	0	77154
8961	516	75769	133	358	0	76776
8962	75835	1337	279	452	0	77903
8963	1398	630	257	73354	0	75639
8964	438	74191	163	1163	0	75955
8965	75503	1031	274	725	0	77533
8966	75836	377	174	505	0	76892
8967	76886	214	156	484	0	77740
8968	75769	173	122	443	0	76507
8969	1427	75168	167	352	0	77114
8970	645	1043	117	76789	0	78594
8971	440	395	116	78069	0	79020
8972	77765	223	123	1583	0	79694
8973	1233	173	116	77261	0	78783
8974	76343	172	112	1402	0	78029
8975	1185	196	73897	571	0	75849
8976	73489	128	914	592	0	75123
8977	1160	200	74285	362	0	76007
8978	717	646	985	73096	0	75444
8979	73484	152	424	1220	0	75280
8980	1085	72126	209	505	0	73925
8981	69763	808	161	467	0	71199
8982	975	67464	146	281	0	68866
8983	520	1152	169	72283	0	74124
8984	295	301	70205	832	0	71633
8985	65420	443	942	560	0	67365
8986	714	68807	265	257	0	70043
8987	470	862	147	68380	0	69859
8988	258	235	97	67491	0	68081
8989	249	150	49	66878	0	67326
8990	147	132	66896	777	0	67952
8991	137	66410	546	356	0	67449
8992	66547	602	216	341	0	67706
8993	66468	201	121	328	0	67118
8994	713	66078	104	158	0	67053
8995	68054	565	77	380	0	69076
8996	728	300	54	68087	0	69169
8997	282	67429	98	591	0	68400
8998	68421	555	59	403	0	69438
8999	688	287	66413	171	0	67559
9000	280	67363	528	194	0	68365
9001	291	667	183	68210	0	69351
9002	197	198	97	69266	0	69758
9003	149	158	67983	686	0	68976
9004	256	120	507	66152	0	67035
9005	149	130	67713	637	0	68629
9006	254	91	544	67269	0	68158
9007	196	112	206	68574	0	69088
9008	199	114	105	68742	0	69160
9009	218	97	83	69289	0	69687
9010	164	147	68525	813	0	69649
9011	211	164	69552	373	0	70300
9012	135	76421	882	284	0	77722
9013	270	1062	361	81017	0	82710
9014	187	431	83739	1147	0	85504
9015	152	82973	1206	511	0	84842
9016	392	1386	489	86778	0	89045
9017	193	539	88889	1367	0	90988
9018	85189	256	1470	775	0	87690
9019	93160	156	492	477	0	94285
9020	2057	108	244	92699	0	95108
9021	788	135	92234	1584	0	94741
9022	604	160	1481	91807	0	94052
9023	92476	105	590	2026	0	95197
9024	1555	93752	379	760	0	96446
9025	96543	1485	183	754	0	98965
9026	98273	590	148	596	0	99607
9027	2305	285	147	94866	0	97603
9028	1116	166	156	96261	0	97699
9029	621	143	123	97251	0	98138
9030	535	144	129	96846	0	97654
9031	530	149	133	96044	0	96856
9032	95515	121	115	2678	0	98429
9033	96539	102	140	1285	0	98066
9034	96364	109	126	898	0	97497
9035	2382	176	90861	506	0	93925
9036	91649	110	1335	623	0	93717
9037	2084	251	523	91871	0	94729
9038	893	187	91127	1834	0	94041
9039	535	89166	1589	928	0	92218
9040	714	1711	721	88989	0	92135
9041	561	598	357	90006	0	91522
9042	339	89244	332	2075	0	91990
9043	552	1481	250	92444	0	94727
9044	363	630	91243	2050	0	94286
9045	345	362	92290	981	0	93978
9046	449	299	2151	93876	0	96775
9047	93325	172	934	2290	0	96721
9048	93165	168	473	1218	0	95024
9049	2394	265	92286	693	0	95638
9050	1108	86802	1788	633	0	90331
9051	642	91121	765	582	0	93110
9052	87328	2068	500	784	0	90680
9053	1928	889	88449	580	0	91846
9054	1155	537	1664	87630	0	90986
9055	88086	254	721	2207	0	91268
9056	1971	85604	487	1097	0	89159
9057	966	88593	318	785	0	90662
9058	87619	2114	264	774	0	90771
9059	2210	885	238	88463	0	91796
9060	91837	424	262	2259	0	94782
9061	2544	260	253	99840	0	102897
9062	1466	209	244	102438	0	104357
9063	877	297	101213	3442	0	105829
9064	858	305	2303	104509	0	107975
9065	756	281	978	106969	0	108984
9066	105396	236	649	4230	0	110511
9067	3002	274	406	107406	0	111088
9068	1328	303	105739	3671	0	111041
9069	105080	237	2681	2040	0	110038
9070	3074	257	1239	107796	0	112366
9071	107225	231	774	3692	0	111922
9072	3327	101601	570	1935	0	107433
9073	1596	107586	467	1348	0	110997
9074	106729	3404	503	1165	0	111801
9075	108380	1586	467	1025	0	111458
9076	4187	919	424	106237	0	111767
9077	2168	546	104667	3192	0	110573
9078	1540	396	2809	106835	0	111580
9079	104796	469	1323	3818	0	110406
9080	3184	104402	864	1794	0	110244
9081	1893	2838	510	106268	0	111509
9082	105338	1377	461	3508	0	110684
9083	3465	903	100490	1816	0	106674
9084	102957	518	2717	1619	0	107811
9085	98768	501	1296	1624	0	102189
9086	4126	490	102341	1026	0	107983
9087	2250	519	103605	1026	0	107400
9088	1749	393	3758	101222	0	107122
9089	1395	322	1747	104719	0	108183
9090	1010	104003	1042	4208	0	110263
9091	1138	2792	668	106943	0	111541
9092	931	1289	106253	4108	0	112581
9093	1157	783	3091	108207	0	113238
9094	1056	458	1496	113967	0	116977
9095	978	363	108524	4932	0	114797
9096	863	107149	3219	2809	0	114040
9097	986	2888	1514	109868	0	115256
9098	973	1325	983	112936	0	116217
9099	110147	846	712	4915	0	116620
9100	3664	546	598	110802	0	115610
9101	1855	473	107723	4470	0	114521
9102	106975	476	3141	2515	0	113107
9103	110757	540	1476	1860	0	114633
9104	111872	495	975	1507	0	114849
9105	5074	515	105920	1243	0	112752
9106	2710	453	3239	106008	0	112410
9107	1794	378	1599	109079	0	112850
9108	1423	377	1208	110198	0	113206
9109	104849	398	822	5359	0	111428
9110	3646	103941	766	2857	0	111210
9111	1925	2721	98835	1811	0	105292
9112	1225	95695	2686	1397	0	101003
9113	884	93331	1242	1180	0	96637
9114	785	92247	942	1086	0	95060
9115	1575	4018	1246	88229	0	95068
9116	937	1486	86718	2958	0	92099
9117	79451	1113	2429	1793	0	84786
9118	2384	83668	1235	1310	0	88597
9119	81002	2060	768	1110	0	84940
9120	2489	82785	503	976	0	86753
9121	83757	2401	491	1041	0	87690
9122	2707	84296	440	824	0	88267
9123	1452	2627	84568	764	0	89411
9124	1255	1184	2198	83332	0	87969
9125	951	782	1036	86931	0	89700
9126	85402	506	738	3427	0	90073
9127	2746	483	552	90233	0	94014
9128	1361	486	89172	3464	0	94483
9129	1259	417	2505	90891	0	95072
9130	852	506	90262	3443	0	95063
9131	667	89323	2962	1805	0	94757
9132	934	2566	1257	87059	0	91816
9133	736	90698	930	2800	0	95164
9134	90825	2938	691	1600	0	96054
9135	3031	1298	599	90798	0	95726
9136	1475	890	90038	3076	0	95479
9137	1105	687	88728	1613	0	92133
9138	87912	582	3339	1419	0	93252
9139	2956	732	1533	88553	0	93774
9140	1421	611	87458	2988	0	92478
9141	1081	650	84882	1579	0	88192
9142	735	85110	3336	1244	0	90425
9143	869	2807	1887	79867	0	85430
9144	574	83822	1157	2641	0	88194
9145	720	2621	758	82633	0	86732
9146	83571	1113	674	3157	0	88515
9147	2484	814	603	84730	0	88631
9148	1192	554	533	86762	0	89041
9149	85398	475	580	3730	0	90183
9150	2729	504	550	89723	0	93506
9151	1418	501	504	90012	0	92435
9152	1003	90399	474	3695	0	95571
9153	91316	2561	517	2081	0	96475
9154	93852	1105	515	1502	0	96974
9155	3631	764	550	92297	0	97242
9156	1805	542	532	93707	0	96586
9157	1283	520	480	93325	0	95608
9158	811	87019	527	4328	0	92685
9159	739	91142	565	2210	0	94656
9160	1142	3268	498	87245	0	92153
9161	76400	856	386	2518	0	80160
9162	77057	512	337	1301	0	79207
9163	2266	74137	312	851	0	77566
9164	70605	1735	277	758	0	73375
9165	1821	69147	281	651	0	71900
9166	703	69846	280	625	0	71454
9167	1356	2083	532	67730	0	71701
9168	66839	631	422	1964	0	69856
9169	1626	64218	262	808	0	66914
9170	600	65998	254	647	0	67499
9171	591	1664	204	66164	0	68623
9172	480	654	180	67793	0	69107
9173	373	485	65457	1959	0	68274
9174	64628	370	1344	1012	0	67354
9175	64784	374	416	864	0	66438
9176	1793	357	66177	627	0	68954
9177	716	413	66026	622	0	67777
9178	570	376	1668	67297	0	69911
9179	537	334	559	69420	0	70850
9180	367	67900	373	2175	0	70815
9181	494	1686	240	69688	0	72108
9182	422	695	68650	2091	0	71858
9183	537	510	1528	68520	0	71095
9184	527	415	466	69923	0	71331
9185	68059	337	388	2426	0	71210
9186	1798	385	66733	1089	0	70005
9187	65212	323	1689	948	0	68172
9188	1940	386	65390	752	0	68468
9189	746	437	1669	63889	0	66741
9190	463	357	63649	1923	0	66392
9191	407	424	63627	889	0	65347
9192	594	767	1862	61622	0	64845
9193	58636	578	1094	2289	0	62597
9194	58412	302	503	954	0	60171
9195	1719	58340	392	744	0	61195
9196	58175	1412	519	737	0	60843
9197	58400	538	387	673	0	59998
9198	1770	57476	422	623	0	60291
9199	833	1500	402	58602	0	61337
9200	570	522	380	60011	0	61483
9201	484	412	363	59888	0	61147
9202	493	378	346	60149	0	61366
9203	383	352	58126	2207	0	61068
9204	56984	288	1449	1102	0	59823
9205	1678	260	603	58874	0	61415
9206	779	283	369	58913	0	60344
9207	561	58222	323	2105	0	61211
9208	569	1507	268	60150	0	62494
9209	429	620	57704	2092	0	60845
9210	57481	415	1373	1170	0	60439
9211	1770	324	59635	909	0	62638
9212	834	389	1471	58729	0	61423
9213	58797	277	474	2038	0	61586
9214	1686	59311	348	1015	0	62360
9215	862	1466	232	62120	0	64680
9216	550	622	61421	1998	0	64591
9217	568	472	1509	62203	0	64752
9218	61398	334	499	2175	0	64406
9219	1798	382	61085	933	0	64198
9220	735	358	59850	777	0	61720
9221	570	59209	1756	698	0	62233
9222	57728	1560	745	710	0	60743
9223	1619	56906	454	576	0	59555
9224	760	1582	55603	513	0	58458
9225	539	543	54483	439	0	56004
9226	384	53437	1605	433	0	55859
9227	48230	1154	803	389	0	50576
9228	1057	48119	381	296	0	49853
9229	417	1061	232	47729	0	49439
9230	332	280	242	48778	0	49632
9231	212	225	47919	1315	0	49671
9232	299	155	1087	47815	0	49356
9233	191	178	48460	1255	0	50084
9234	47429	170	1139	507	0	49245
9235	48987	171	391	374	0	49923
9236	49112	147	316	328	0	49903
9237	1380	134	47239	280	0	49033
9238	47770	153	1122	310	0	49355
9239	1220	157	373	46719	0	48469
9240	410	47332	289	1095	0	49126
9241	47392	978	257	554	0	49181
9242	1099	310	45607	401	0	47417
9243	46449	185	1031	344	0	48009
9244	46908	104	400	346	0	47758
9245	1292	143	45084	255	0	46774
9246	510	44961	1067	265	0	46803
9247	512	1387	486	44569	0	46954
9248	304	307	45011	1044	0	46666
9249	349	247	43573	405	0	44574
9250	370	805	1038	38941	0	41154
9251	195	88	38966	767	0	40016
9252	178	89	768	37550	0	38585
9253	231	105	263	36215	0	36814
9254	185	82	170	38329	0	38766
9255	150	82	37653	899	0	38784
9256	172	68	744	37743	0	38727
9257	157	94	38028	833	0	39112
9258	168	82	802	38363	0	39415
9259	39242	90	295	877	0	40504
9260	802	87	218	39265	0	40372
9261	245	39888	193	839	0	41165
9262	251	708	140	41572	0	42671
9263	41790	212	153	944	0	43099
9264	804	41950	191	349	0	43294
9265	346	800	152	42595	0	43893
9266	42533	251	132	981	0	43897
9267	880	190	42466	387	0	43923
9268	342	131	839	42819	0	44131
9269	208	97	43269	994	0	44568
9270	193	87	43065	417	0	43762
9271	221	162	1036	42791	0	44210
9272	42906	66	418	983	0	44373
9273	877	90	41895	331	0	43193
9274	41734	84	888	286	0	42992
9275	1025	169	349	42667	0	44210
9276	353	109	42500	818	0	43780
9277	249	98	41662	319	0	42328
9278	185	123	41866	229	0	42403
9279	276	550	1008	39726	0	41560
9280	40538	105	670	838	0	42151
9281	688	40169	224	305	0	41386
9282	303	627	177	40162	0	41269
9283	201	196	143	41012	0	41552
9284	40737	112	151	905	0	41905
9285	41063	58	147	381	0	41649
9286	825	40432	179	212	0	41648
9287	41221	630	136	223	0	42210
9288	41417	199	134	168	0	41918
9289	903	137	137	40960	0	42137
9290	365	100	40561	730	0	41756
9291	40671	128	725	312	0	41836
9292	801	76	235	41811	0	42923
9293	340	80	181	41963	0	42564
9294	41493	66	140	928	0	42627
9295	799	62	124	40266	0	41251
9296	364	85	99	40819	0	41367
9297	40046	52	106	980	0	41184
9298	754	40470	112	386	0	41722
9299	40675	601	112	322	0	41710
9300	797	191	40205	177	0	41370
9301	40564	103	702	205	0	41574
9302	865	55	237	40940	0	42097
9303	304	41047	200	729	0	42280
9304	275	619	127	42124	0	43145
9305	235	156	103	42359	0	42853
9306	220	115	108	42438	0	42881
9307	41464	51	114	1000	0	42629
9308	679	40088	115	388	0	41270
9309	222	40489	112	245	0	41068
9310	40028	643	77	249	0	40997
9311	656	227	40447	142	0	41472
9312	268	138	39526	151	0	40083
9313	38939	285	958	241	0	40423
9314	623	132	39417	163	0	40335
9315	226	43	480	38186	0	38935
9316	270	55	215	36009	0	36549
9317	121	34	106	39375	0	39636
9318	127	39	61	39294	0	39521
9319	103	36951	97	698	0	37849
9320	111	488	71	39570	0	40240
9321	106	126	38884	637	0	39753
9322	115	87	508	38627	0	39337
9323	87	73	38109	641	0	38910
9324	119	71	37504	242	0	37936
9325	102	54	634	38614	0	39404
9326	109	49	38973	619	0	39750
9327	128	55	604	38749	0	39536
9328	38975	45	212	716	0	39948
9329	569	42	38820	253	0	39684
9330	38224	54	533	225	0	39036
9331	633	45	191	39010	0	39879
9332	217	54	38677	610	0	39558
9333	153	38293	543	260	0	39249
9334	177	468	194	39418	0	40257
9335	125	132	40673	624	0	41554
9336	166	90	577	40749	0	41582
9337	41889	71	205	759	0	42924
9338	42341	53	142	339	0	42875
9339	43149	56	118	254	0	43577
9340	818	42	113	43207	0	44180
9341	340	43	97	43962	0	44442
9342	218	40	92	44821	0	45171
9343	44915	42	98	972	0	46027
9344	730	45656	98	379	0	46863
9345	302	664	93	46763	0	47822
9346	230	190	95	48097	0	48612
9347	47285	121	82	1141	0	48629
9348	849	47642	85	444	0	49020
9349	361	781	80	50071	0	51293
9350	50596	242	87	1111	0	52036
9351	50991	127	73	487	0	51678
9352	1309	88	89	50292	0	51778
9353	50488	72	83	1160	0	51803
9354	1231	67	67	50343	0	51708
9355	464	90	50111	1201	0	51866
9356	408	61	897	50559	0	51925
9357	314	56	296	51704	0	52370
9358	291	51	177	52128	0	52647
9359	49722	57	107	1447	0	51333
9360	935	49431	87	631	0	51084
9361	48554	859	85	478	0	49976
9362	1010	47419	98	298	0	48825
9363	341	48898	73	235	0	49547
9364	48378	1046	139	279	0	49842
9365	922	48791	101	209	0	50023
9366	409	983	73	49118	0	50583
9367	48488	297	117	1025	0	49927
9368	49068	192	54	448	0	49762
9369	1165	118	61	48520	0	49864
9370	512	76	65	48489	0	49142
9371	270	48178	61	1127	0	49636
9372	49284	791	47	588	0	50710
9373	48492	265	61	469	0	49287
9374	1038	49734	66	297	0	51135
9375	425	50759	67	249	0	51500
9376	343	1152	56	51034	0	52585
9377	51102	399	49	1206	0	52756
9378	1155	254	51	50991	0	52451
9379	435	209	44	52167	0	52855
9380	306	152	50165	1382	0	52005
9381	258	139	50180	569	0	51146
9382	276	131	1103	50344	0	51854
9383	193	124	50277	1208	0	51802
9384	192	49906	1060	479	0	51637
9385	234	1013	321	50513	0	52081
9386	216	320	199	51763	0	52498
9387	260	217	111	51949	0	52537
9388	180	173	50734	1477	0	52564
9389	225	163	48985	637	0	50010
9390	48943	131	1136	544	0	50754
9391	1047	50214	421	342	0	52024
9392	50330	994	220	331	0	51875
9393	1223	327	123	50310	0	51983
9394	51082	233	99	1211	0	52625
9395	1260	174	81	50723	0	52238
9396	449	51088	88	1201	0	52826
9397	51675	1000	90	586	0	53351
9398	1154	323	50012	390	0	51879
9399	424	49885	935	317	0	51561
9400	50036	1052	359	342	0	51789
9401	1127	371	191	49173	0	50862
9402	399	48010	139	1066	0	49614
9403	399	970	93	50249	0	51711
9404	49919	337	85	1345	0	51686
9405	1197	246	73	50256	0	51772
9406	50248	195	70	1403	0	51916
9407	1277	195	49000	548	0	51020
9408	557	157	933	49683	0	51330
9409	49471	152	293	1319	0	51235
9410	1196	205	48263	533	0	50197
9411	451	47011	1039	467	0	48968
9412	444	1068	344	46404	0	48260
9413	308	351	46437	1159	0	48255
9414	266	302	45728	528	0	46824
9415	304	425	1189	45970	0	47888
9416	231	187	45579	1183	0	47180
9417	239	197	45073	532	0	46041
9418	270	194	1177	44742	0	46383
9419	44990	140	475	1192	0	46797
9420	1048	139	265	45088	0	46540
9421	471	136	178	46050	0	46835
9422	350	153	45457	1324	0	47284
9423	335	132	949	46824	0	48240
9424	47309	142	343	1388	0	49182
9425	1061	190	46834	539	0	48624
9426	420	46691	969	459	0	48539
9427	361	940	362	48169	0	49832
9428	48327	356	249	1217	0	50149
9429	1113	237	196	48083	0	49629
9430	422	47643	212	1198	0	49475
9431	327	995	48768	521	0	50611
9432	322	375	987	50190	0	51874
9433	52284	260	365	1319	0	54228
9434	1284	191	51266	567	0	53308
9435	562	156	1189	53048	0	54955
9436	54394	116	445	1578	0	56533
9437	57135	124	287	718	0	58264
9438	1821	56930	240	504	0	59495
9439	57355	1394	198	418	0	59365
9440	1860	549	165	56757	0	59331
9441	664	316	56924	1593	0	59497
9442	411	54667	1435	666	0	57179
9443	291	56906	533	463	0	58193
9444	428	1883	485	54855	0	57651
9445	378	670	301	56207	0	57556
9446	173	300	53746	1680	0	55899
9447	215	52510	1289	673	0	54687
9448	163	53504	485	439	0	54591
9449	351	1585	351	51165	0	53452
9450	50311	413	243	1294	0	52261
9451	1094	49960	149	482	0	51685
9452	455	1099	137	51302	0	52993
9453	52526	349	121	1378	0	54374
9454	1235	229	133	52986	0	54583
9455	467	200	116	52956	0	53739
9456	352	182	95	53445	0	54074
9457	268	160	132	53544	0	54104
9458	51939	152	131	1697	0	53919
9459	1212	208	110	52232	0	53762
9460	395	177	50313	1378	0	52263
9461	49586	180	1012	643	0	51421
9462	1169	173	49533	432	0	51307
9463	452	161	50297	366	0	51276
9464	366	205	1293	50485	0	52349
9465	336	183	470	51275	0	52264
9466	304	129	236	52003	0	52672
9467	50901	120	171	1607	0	52799
9468	1155	132	49903	707	0	51897
9469	49872	112	1041	557	0	51582
9470	51359	103	375	468	0	52305
9471	1436	155	49943	373	0	51907
9472	49974	99	1028	477	0	51578
9473	1270	138	50502	369	0	52279
9474	482	50685	1061	325	0	52553
9475	586	1176	641	50539	0	52942
9476	279	332	270	51949	0	52830
9477	287	172	217	51295	0	51971
9478	306	119	174	51007	0	51606
9479	181	145	50357	1428	0	52111
9480	218	144	50092	603	0	51057
9481	242	134	1195	50328	0	51899
9482	176	138	50717	1215	0	52246
9483	49219	92	1048	657	0	51016
9484	51634	105	419	456	0	52614
9485	1290	121	259	50947	0	52617
9486	50782	108	210	1184	0	52284
9487	1119	51545	214	572	0	53450
9488	51969	900	187	504	0	53560
9489	1184	323	51525	379	0	53411
9490	532	220	984	51452	0	53188
9491	292	51890	430	1104	0	53716
9492	53473	896	245	674	0	55288
9493	1061	328	223	54081	0	55693
9494	491	183	53301	1190	0	55165
9495	377	152	991	53224	0	54744
9496	53209	90	454	1329	0	55082
9497	1152	144	53199	589	0	55084
9498	561	150	1041	53766	0	55518
9499	406	150	461	54848	0	55865
9500	377	131	53948	1432	0	55888
9501	308	52019	1093	708	0	54128
9502	650	42811	665	698	0	44824
9503	411	1192	263	54519	0	56385
9504	385	430	232	56155	0	57202
9505	331	239	224	56817	0	57611
9506	55256	172	234	1633	0	57295
9507	55598	202	228	797	0	56825
9508	1425	215	252	55605	0	57497
9509	55460	198	165	1470	0	57293
9510	1176	54672	234	751	0	56833
9511	498	1054	212	56967	0	58731
9512	342	420	198	57963	0	58923
9513	292	246	224	58375	0	59137
9514	55372	202	178	1843	0	57595
9515	1166	54163	228	862	0	56419
9516	517	998	203	56094	0	57812
9517	55401	388	173	1508	0	57470
9518	1237	256	164	56196	0	57853
9519	631	184	139	56348	0	57302
9520	464	52639	188	1658	0	54949
9521	307	55555	176	887	0	56925
9522	353	1172	146	55462	0	57133
9523	363	438	147	55608	0	56556
9524	53142	191	156	1800	0	55289
9525	1280	136	151	53541	0	55108
9526	531	154	51865	1525	0	54075
9527	413	150	1032	51945	0	53540
9528	330	50729	457	1400	0	52916
9529	52147	974	315	819	0	54255
9530	1287	334	243	52365	0	54229
9531	588	246	183	51714	0	52731
9532	334	50167	207	1520	0	52228
9533	48622	797	145	754	0	50318
9534	970	49728	144	485	0	51327
9535	486	1035	108	49214	0	50843
9536	308	260	47865	962	0	49395
9537	439	842	783	44282	0	46346
9538	44392	64	307	862	0	45625
9539	671	44104	100	305	0	45180
9540	269	693	55	44729	0	45746
9541	152	43192	58	734	0	44136
9542	141	742	50	44919	0	45852
9543	96	239	43939	832	0	45106
9544	133	294	643	43495	0	44565
9545	97	108	165	44292	0	44662
9546	185	70	83	44805	0	45143
9547	42886	61	68	1045	0	44060
9548	43643	58	42	484	0	44227
9549	833	43252	42	259	0	44386
9550	43782	691	51	278	0	44802
9551	757	42678	52	210	0	43697
9552	225	43940	52	170	0	44387
9553	42507	813	57	277	0	43654
9554	779	299	41074	186	0	42338
9555	279	171	638	41493	0	42581
9556	186	110	166	42751	0	43213
9557	152	92	91	43605	0	43940
9558	42161	79	61	1128	0	43429
9559	757	41189	59	421	0	42426
9560	276	760	39	42688	0	43763
9561	225	41971	57	820	0	43073
9562	44131	858	28	415	0	45432
9563	921	292	33	44245	0	45491
9564	373	166	32	50888	0	51459
9565	166	54007	74	1503	0	55750
9566	223	1249	42	57570	0	59084
9567	191	451	34	58818	0	59494
9568	56221	242	53	2220	0	58736
9569	1422	54792	92	961	0	57267
9570	508	57492	64	576	0	58640
9571	379	1766	33	56838	0	59016
9572	238	683	54512	1755	0	57188
9573	249	463	54232	760	0	55704
9574	270	400	1735	54468	0	56873
9575	171	296	54004	1793	0	56264
9576	258	237	1584	54553	0	56632
9577	311	240	642	53487	0	54680
9578	205	192	328	56682	0	57407
9579	54217	165	245	2532	0	57159
9580	1582	143	194	55157	0	57076
9581	659	172	164	55330	0	56325
9582	318	53096	162	2396	0	55972
9583	346	1494	143	55962	0	57945
9584	217	584	53755	2210	0	56766
9585	283	345	1505	55328	0	57461
9586	281	283	550	56843	0	57957
9587	53113	267	332	2596	0	56308
9588	1599	240	244	54286	0	56369
9589	621	213	200	54183	0	55217
9590	407	175	199	54926	0	55707
9591	50460	185	170	2795	0	53610
9592	1557	50941	141	1410	0	54049
9593	678	1518	165	52094	0	54455
9594	431	580	143	53301	0	54455
9595	277	430	50024	2590	0	53321
9596	304	317	1443	51320	0	53384
9597	48203	209	577	2498	0	51487
9598	1505	48751	317	1333	0	51906
9599	686	1510	245	49177	0	51618
9600	461	617	191	50409	0	51678
9601	319	373	47432	2608	0	50732
9602	45690	288	1429	1464	0	48871
9603	1510	46591	577	1087	0	49765
9604	46577	1466	316	942	0	49301
9605	1667	657	272	47132	0	49728
9606	760	402	213	48147	0	49522
9607	472	335	188	48767	0	49762
9608	477	260	217	49053	0	50007
9609	46719	313	185	2671	0	49888
9610	1655	294	152	46092	0	48193
9611	650	44327	204	2408	0	47589
9612	445	1389	234	46302	0	48370
9613	422	526	274	47702	0	48924
9614	45379	342	238	2681	0	48640
9615	1619	44857	215	1404	0	48095
9616	746	1522	175	46818	0	49261
9617	45632	607	132	2418	0	48789
9618	47122	391	129	1495	0	49137
9619	2059	326	171	46963	0	49519
9620	896	322	45128	2354	0	48700
9621	45908	314	1284	1400	0	48906
9622	1837	329	493	46958	0	49617
9623	848	283	46154	2340	0	49625
9624	579	273	1476	48065	0	50393
9625	571	231	597	48805	0	50204
9626	497	242	310	48922	0	49971
9627	475	47794	276	2687	0	51232
9628	457	1433	219	50179	0	52288
9629	406	573	189	51335	0	52503
9630	437	367	184	51470	0	52458
9631	473	335	197	51186	0	52191
9632	476	331	160	50759	0	51726
9633	454	405	184	50622	0	51665
9634	45790	295	179	2930	0	49194
9635	1498	247	44005	1686	0	47436
9636	689	43280	1216	1328	0	46513
9637	43608	1180	541	1215	0	46544
9638	1422	43489	333	990	0	46234
9639	43307	1348	340	945	0	45940
9640	1777	620	271	43118	0	45786
9641	43288	342	303	1945	0	45878
9642	1588	315	248	43527	0	45678
9643	864	263	169	42964	0	44260
9644	560	41973	172	2218	0	44923
9645	42869	1189	125	1457	0	45640
9646	1396	529	42892	1257	0	46074
9647	788	322	1036	44593	0	46739
9648	518	302	43974	1934	0	46728
9649	519	328	42543	1257	0	44647
9650	43600	254	1418	1038	0	46310
9651	1378	311	605	44712	0	47006
9652	728	216	43705	1824	0	46473
9653	527	199	44998	1209	0	46933
9654	528	179	1379	45514	0	47600
9655	476	218	627	47226	0	48547
9656	46425	238	376	2057	0	49096
9657	1449	234	318	47125	0	49126
9658	802	192	47507	1835	0	50336
9659	583	185	1129	48754	0	50651
9660	563	489	558	48261	0	49871
9661	410	48226	383	1894	0	50913
9662	47183	966	326	1331	0	49806
9663	1105	46639	295	1033	0	49072
9664	40458	573	190	635	0	41856
9665	491	35024	99	260	0	35874
9666	161	33686	106	187	0	34140
9667	273	416	247	33408	0	34344
9668	156	126	205	33308	0	33795
9669	117	134	51	32955	0	33257
9670	32012	48	39	383	0	32482
9671	242	46	31854	163	0	32305
9672	104	74	186	31585	0	31949
9673	31373	28	64	320	0	31785
9674	235	30955	51	156	0	31397
9675	92	31167	52	133	0	31444
9676	146	309	78	31414	0	31947
9677	93	92	38	31795	0	32018
9678	58	67	31	31851	0	32007
9679	46	32117	37	280	0	32480
9680	70	183	22	32591	0	32866
9681	56	69	32387	268	0	32780
9682	52	73	30164	103	0	30392
9683	30931	32	156	172	0	31291
9684	208	42	65	32243	0	32558
9685	32292	21	90	268	0	32671
9686	32129	28	28	175	0	32360
9687	169	32273	41	82	0	32565
9688	32835	141	30	164	0	33170
9689	33771	43	31	144	0	33989
9690	196	37	21	33812	0	34066
9691	114	33	22	34291	0	34460
9692	71	36	34835	198	0	35140
9693	49	35211	162	127	0	35549
9694	222	164	83	32242	0	32711
9695	56	46	27	36371	0	36500
9696	36249	27	26	296	0	36598
9697	167	28	21	36479	0	36695
9698	37006	25	24	275	0	37330
9699	202	25	29	37772	0	38028
9700	73	37936	31	259	0	38299
9701	39471	249	15	218	0	39953
9702	340	82	18	43503	0	43943
9703	184	44	22	46834	0	47084
9704	140	41	28	49590	0	49799
9705	62	44	49212	979	0	50297
9706	120	32	747	50079	0	50978
9707	51190	18	199	1135	0	52542
9708	909	23	99	53529	0	54560
9709	382	17	75	58922	0	59396
9710	264	49	57	59480	0	59850
9711	111	57659	96	1698	0	59564
9712	82	61013	68	668	0	61831
9713	60477	1525	39	544	0	62585
9714	1248	61442	66	280	0	63036
9715	61539	1451	53	357	0	63400
9716	62142	490	46	335	0	63013
9717	62444	237	33	345	0	63059
9718	1898	182	60622	168	0	62870
9719	666	61759	1215	218	0	63858
9720	62754	1332	371	286	0	64743
9721	1568	493	153	62781	0	64995
9722	710	276	85	63603	0	64674
9723	465	226	45	63573	0	64309
9724	283	60984	92	1831	0	63190
9725	351	1318	41	62330	0	64040
9726	61962	429	32	1708	0	64131
9727	1549	219	48	61123	0	62939
9728	674	160	57	62283	0	63174
9729	342	160	60190	1924	0	62616
9730	269	217	60900	822	0	62208
9731	364	152	1550	61855	0	63921
9732	310	112	544	62862	0	63828
9733	167	62122	282	1969	0	64540
9734	334	1313	154	63067	0	64868
9735	333	478	121	64455	0	65387
9736	298	243	110	64957	0	65608
9737	62905	180	103	2356	0	65544
9738	1426	223	62692	1033	0	65374
9739	669	181	1293	64427	0	66570
9740	64419	167	441	1883	0	66910
9741	65055	158	254	1005	0	66472
9742	1925	174	159	64144	0	66402
9743	904	193	124	65360	0	66581
9744	63437	222	129	2176	0	65964
9745	1561	62113	158	1015	0	64847
9746	725	63556	139	658	0	65078
9747	614	1664	132	63891	0	66301
9748	64070	601	129	1860	0	66660
9749	65093	295	127	1059	0	66574
9750	64605	202	121	810	0	65738
9751	2021	279	64026	565	0	66891
9752	62926	257	1320	694	0	65197
9753	1861	247	62416	634	0	65158
9754	61658	178	1440	753	0	64029
9755	1719	61713	554	681	0	64667
9756	793	1437	62096	634	0	64960
9757	600	603	1473	62528	0	65204
9758	553	367	62120	1887	0	64927
9759	582	264	1545	62281	0	64672
9760	61955	241	603	2205	0	65004
9761	1711	282	61917	1090	0	65000
9762	821	265	1565	62387	0	65038
9763	623	63882	707	1891	0	67103
9764	595	1424	453	67219	0	69691
9765	604	629	346	67581	0	69160
9766	634	423	277	65453	0	66787
9767	65986	290	303	2550	0	69129
9768	67046	272	244	1444	0	69006
9769	2198	279	246	66605	0	69328
9770	1058	340	64797	2109	0	68304
9771	788	335	64272	1181	0	66576
9772	666	332	1802	66529	0	69329
9773	665	405	68075	2069	0	71214
9774	672	373	1607	68732	0	71384
9775	716	314	643	67283	0	68956
9776	699	261	401	69925	0	71286
9777	686	65126	423	2542	0	68777
9778	694	64781	413	1361	0	67249
9779	578	1761	391	69518	0	72248
9780	590	726	392	70217	0	71925
9781	571	437	350	70345	0	71703
9782	68253	337	335	2765	0	71690
9783	1778	322	68768	1467	0	72335
9784	862	315	1578	70024	0	72779
9785	69440	208	729	2405	0	72782
9786	1717	69018	512	1384	0	72631
9787	880	1556	407	71472	0	74315
9788	603	590	421	72866	0	74480
9789	489	419	386	72334	0	73628
9790	419	250	377	72379	0	73425
9791	509	262	68980	2835	0	72586
9792	66485	246	1516	1715	0	69962
9793	69275	200	608	1390	0	71473
9794	2080	246	68447	1053	0	71826
9795	68520	253	1497	1052	0	71322
9796	70314	274	615	966	0	72169
9797	2190	269	69499	892	0	72850
9798	1058	70821	1553	982	0	74414
9799	1012	1773	778	71350	0	74913
9800	714	463	73514	1847	0	76538
9801	657	71196	1479	1130	0	74462
9802	716	1122	68248	778	0	70864
9803	394	64709	1145	1501	0	67749
9804	541	1080	839	63575	0	66035
9805	356	290	63616	928	0	65190
9806	521	496	879	62067	0	63963
9807	354	173	64558	925	0	66010
9808	254	63009	766	561	0	64590
9809	58681	315	382	301	0	59679
9810	243	57214	133	117	0	57707
9811	109	60424	114	220	0	60867
9812	529	324	262	60489	0	61604
9813	103	95	71	61340	0	61609
9814	90	32	14	60965	0	61101
9815	101	28	24	59948	0	60101
9816	54	24	9	61632	0	61719
9817	43	46	66304	212	0	66605
9818	139	21	173	65109	0	65442
9819	86	14	35	67821	0	67956
9820	68871	9	38	498	0	69416
9821	69705	18	25	254	0	70002
9822	70576	8	23	187	0	70794
9823	396	20	15	71186	0	71617
9824	77675	11	11	584	0	78281
9825	83060	22	19	356	0	83457
9826	85363	18	16	256	0	85653
9827	1043	58	84071	49	0	85221
9828	84018	18	782	206	0	85024
9829	88002	23	189	233	0	88447
9830	88238	15	104	164	0	88521
9831	1329	17	74	87819	0	89239
9832	432	80	88590	890	0	89992
9833	363	18	875	88233	0	89489
9834	91249	13	195	1234	0	92691
9835	1100	27	116	92052	0	93295
9836	278	94628	127	963	0	95996
9837	306	838	40	98370	0	99554
9838	98033	180	56	1314	0	99583
9839	99117	94	33	558	0	99802
9840	98828	64	35	397	0	99324
9841	1354	91	100212	151	0	101808
9842	674	42	1012	99334	0	101062
9843	469	37	241	103966	0	104713
9844	274	63	103333	1320	0	104990
9845	185	100505	1150	468	0	102308
9846	210	1076	101476	248	0	103010
9847	321	283	1129	103319	0	105052
9848	104172	112	326	1376	0	105986
9849	1257	150	106376	370	0	108153
9850	558	76	1152	107367	0	109153
9851	298	91	107824	1233	0	109446
9852	106444	34	1272	612	0	108362
9853	1383	59	354	110031	0	111827
9854	458	83	114157	1318	0	116016
9855	501	52	1209	113455	0	115217
9856	287	113	115930	1407	0	117737
9857	247	116371	1292	547	0	118457
9858	406	1097	391	118309	0	120203
9859	119471	293	264	1648	0	121676
9860	1525	148	227	119839	0	121739
9861	683	104	206	118949	0	119942
9862	118621	65	200	1862	0	120748
9863	1488	112339	213	678	0	114718
9864	551	116079	194	521	0	117345
9865	506	1405	159	117220	0	119290
9866	307	116516	250	1487	0	118560
9867	396	1252	168	118762	0	120578
9868	408	385	143	119721	0	120657
9869	119614	238	141	2012	0	122005
9870	1398	118001	199	768	0	120366
9871	578	1322	117867	537	0	120304
9872	425	121267	1212	498	0	123402
9873	121633	1324	371	602	0	123930
9874	124545	407	293	559	0	125804
9875	1909	253	242	123128	0	125532
9876	125607	204	210	1867	0	127888
9877	1848	165	221	125625	0	127859
9878	125590	193	183	2058	0	128024
9879	127687	153	213	1022	0	129075
9880	2156	156	195	131469	0	133976
9881	132332	120	219	2197	0	134868
9882	2063	183	131268	758	0	134272
9883	129859	118	1463	857	0	132297
9884	2084	139	516	132844	0	135583
9885	134448	144	376	2002	0	136970
9886	1994	134249	381	806	0	137430
9887	1185	1408	264	135892	0	138749
9888	1014	414	332	137037	0	138797
9889	136291	267	356	2442	0	139356
9890	2074	330	134846	976	0	138226
9891	1059	133321	1579	811	0	136770
9892	950	1431	554	136920	0	139855
9893	734	135271	471	1911	0	138387
9894	828	1591	328	139061	0	141808
9895	914	551	320	136830	0	138615
9896	807	416	298	139931	0	141452
9897	138234	380	236	2747	0	141597
9898	1971	356	204	136661	0	139192
9899	137236	368	215	2651	0	140470
9900	136767	293	269	1554	0	138883
9901	2470	261	283	137396	0	140410
9902	137057	243	307	2484	0	140091
9903	136300	253	340	1494	0	138387
9904	2412	332	135376	904	0	139024
9905	1257	368	1609	133231	0	136465
9906	136844	361	648	2373	0	140226
9907	1921	134919	589	1072	0	138501
9908	138021	1589	463	1221	0	141294
9909	138438	499	366	1257	0	140560
9910	2498	379	134178	801	0	137856
9911	1400	304	1674	129577	0	132955
9912	140162	250	742	2632	0	143786
9913	2385	233	511	142925	0	146054
9914	1368	244	417	145570	0	147599
9915	1080	256	422	147088	0	148846
9916	1022	217	393	152621	0	154253
9917	149218	178	347	3820	0	153563
9918	2973	378	150165	1531	0	155047
9919	1625	594	2516	154727	0	159462
9920	1045	381	165098	3237	0	169761
9921	958	466	166725	1626	0	169775
9922	169002	260	5221	1620	0	176103
9923	4710	296	178593	999	0	184598
9924	2208	172098	4656	768	0	179730
9925	173672	3972	2878	1172	0	181694
9926	176914	1844	1055	996	0	180809
9927	6458	731	491	171839	0	179519
9928	2917	431	174266	4024	0	181638
9929	1513	517	171093	2110	0	175233
9930	175890	249	5623	1473	0	183235
9931	5086	359	2575	179737	0	187757
9932	181576	198	1220	4789	0	187783
9933	4970	184063	901	2315	0	192249
9934	186435	3976	700	1614	0	192725
9935	186816	1995	557	1225	0	190593
9936	6524	181608	635	793	0	189560
9937	3808	4308	465	182974	0	191555
9938	183426	2170	429	4973	0	190998
9939	5382	988	181880	2348	0	190598
9940	2935	182575	4497	1390	0	191397
9941	2206	4505	2273	183468	0	192452
9942	184324	2123	1163	5151	0	192761
9943	5055	185342	816	2579	0	193792
9944	189597	4692	665	1739	0	196693
9945	5909	2725	185219	862	0	194715
9946	185919	1186	4655	1181	0	192941
9947	6255	884	188256	659	0	196054
9948	186805	714	5384	1031	0	193934
9949	185696	566	2764	1171	0	190197
9950	7600	662	180925	705	0	189892
9951	3989	181683	4888	763	0	191323
9952	3185	4598	2703	175317	0	185803
9953	1896	2403	183249	4753	0	192301
9954	1637	179495	5091	2717	0	188940
9955	2187	4824	2876	175131	0	185018
9956	1961	2614	1630	183458	0	189663
9957	1539	1336	178321	6915	0	188111
9958	2039	910	5219	174267	0	182435
9959	1872	875	3049	180784	0	186580
9960	1496	804	177599	7410	0	187309
9961	1839	767	5551	173199	0	181356
9962	1403	176039	3342	5819	0	186603
9963	178810	4881	1986	3713	0	189390
9964	5845	2707	1672	176312	0	186536
9965	3464	178697	1883	5569	0	189613
9966	2730	5162	1728	172898	0	182518
9967	2112	182741	1843	5527	0	192223
9968	2244	5804	179994	3161	0	191203
9969	2114	182744	5709	2227	0	192794
9970	180582	6188	3489	2236	0	192495
9971	182348	3330	2223	2164	0	190065
9972	185346	2080	1869	2239	0	191534
9973	9106	1636	183177	1715	0	195634
9974	5001	1640	181371	1770	0	189782
9975	3453	187241	8147	1693	0	200534
9976	3314	6168	4401	181454	0	195337
9977	2943	193465	2638	5815	0	204861
9978	3262	7279	2128	178038	0	190707
9979	2847	193785	1916	6201	0	204749
9980	192469	7600	1740	4012	0	205821
9981	207141	4190	1615	2850	0	215796
9982	10715	2714	1613	210945	0	225987
9983	5963	2271	208112	7780	0	224126
9984	206621	1993	7388	4928	0	220930
9985	9114	211744	4255	3163	0	228276
9986	5887	7474	2950	209635	0	225946
9987	4679	4317	2191	209243	0	220430
9988	3447	213969	2156	9619	0	229191
9989	215699	8210	1940	5631	0	231480
9990	9226	4922	212508	3075	0	229731
9991	6225	3319	7806	212813	0	230163
9992	214562	2529	4400	8637	0	230128
9993	215878	2353	3134	5168	0	226533
9994	11712	211931	2556	3355	0	229554
9995	7269	7846	2454	207497	0	225066
9996	4577	215163	2314	8237	0	230291
9997	219268	8892	2120	5445	0	235725
9998	9348	5106	216928	3519	0	234901
9999	5630	3843	218473	2942	0	230888
10000	4492	2842	10219	215071	0	232624
10001	3677	2564	5461	216257	0	227959
10002	3029	215906	3691	10621	0	233247
10003	3368	8219	2763	219288	0	233638
10004	2929	4543	214600	10315	0	232387
10005	212462	3253	8302	6499	0	230516
10006	8760	2782	4534	219046	0	235122
10007	4918	2754	215552	9793	0	233017
10008	4159	2441	8371	217449	0	232420
10009	3157	2489	4815	215990	0	226451
10010	2593	215720	3299	11444	0	233056
10011	2976	8280	2485	218703	0	232444
10012	2977	4872	2361	216328	0	226538
10013	2944	3487	2291	216896	0	225618
10014	201233	2547	2100	13014	0	218894
10015	7843	196476	2217	7280	0	213816
10016	4601	200106	1819	4716	0	211242
10017	193411	8498	1813	3913	0	207635
10018	190100	4424	1733	3490	0	199747
10019	9187	181009	1810	2727	0	194733
10020	3910	175090	1397	2005	0	182402
10021	160060	5639	1123	1909	0	168731
10022	4774	158623	797	1673	0	165867
10023	2067	159526	689	1439	0	163721
10024	154780	5457	1463	1809	0	163509
10025	4435	156110	640	1381	0	162566
10026	154674	5051	760	1623	0	162108
10027	153291	2385	744	1564	0	157984
10028	154120	1880	617	1503	0	158120
10029	5997	148923	685	1865	0	157470
10030	3072	151816	606	1231	0	156725
10031	2463	5335	431	147002	0	155231
10032	1716	147654	494	4186	0	154050
10033	1915	5278	454	150796	0	158443
10034	152179	2550	546	5285	0	160560
10035	5006	2128	575	150304	0	158013
10036	2409	148853	718	5182	0	157162
10037	147837	4424	646	2784	0	155691
10038	4991	145363	614	2056	0	153024
10039	2546	151095	517	1754	0	155912
10040	2588	6569	561	143780	0	153498
10041	1606	147462	581	4333	0	153982
10042	146241	5147	760	2393	0	154541
10043	4646	2535	142763	1808	0	151752
10044	2203	142208	3931	1717	0	150059
10045	2054	4455	1693	143397	0	151599
10046	1647	2249	142305	4708	0	150909
10047	1669	1954	3899	140963	0	148485
10048	1539	1638	1704	144461	0	149342
10049	1521	1379	1368	146462	0	150730
10050	1452	1408	1056	146043	0	149959
10051	1410	1299	140575	6674	0	149958
10052	1211	139825	4184	3828	0	149048
10053	139172	4374	1889	3191	0	148626
10054	4300	2363	137159	2436	0	146258
10055	136984	1991	4115	2320	0	145410
10056	5016	1731	138602	1949	0	147298
10057	2714	1423	4674	139049	0	147860
10058	2181	1370	138912	4913	0	147376
10059	1800	1387	141687	2744	0	147618
10060	1612	1276	5395	140463	0	148746
10061	1842	1438	2829	135107	0	141216
10062	1580	1414	1740	145226	0	149960
10063	1542	1407	1244	143799	0	147992
10064	140106	1450	1132	7067	0	149755
10065	4560	1361	138479	3953	0	148353
10066	139957	1277	3906	3432	0	148572
10067	142544	1363	1828	2594	0	148329
10068	142878	1409	1355	2372	0	148014
10069	142305	1487	1010	2063	0	146865
10070	143463	1479	771	1917	0	147630
10071	7384	1440	630	137976	0	147430
10072	3903	1412	130927	4612	0	140854
10073	2780	1322	127712	2503	0	134317
10074	2095	129587	3963	2159	0	137804
10075	123295	3980	2443	1879	0	131597
10076	3909	2690	1461	120440	0	128500
10077	2306	2971	840	118149	0	124266
10078	1851	116877	613	4190	0	123531
10079	1706	116813	553	2411	0	121483
10080	1697	116382	452	1688	0	120219
10081	101678	3772	758	1493	0	107701
10082	2391	2194	500	91932	0	97017
10083	903	90889	304	1876	0	93972
10084	747	1797	214	90915	0	93673
10085	522	805	90289	1928	0	93544
10086	533	587	92145	866	0	94131
10087	772	574	1969	97965	0	101280
10088	101299	471	882	2463	0	105115
10089	107471	418	372	1204	0	109465
10090	108112	434	266	887	0	109699
10091	3397	486	106312	592	0	110787
10092	1655	556	2216	105992	0	110419
10093	1103	621	951	110720	0	113395
10094	808	531	106694	3193	0	111226
10095	102741	550	2388	1663	0	107342
10096	2857	467	107640	963	0	111927
10097	1170	420	105432	624	0	107646
10098	758	388	106206	519	0	107871
10099	894	340	3247	102454	0	106935
10100	628	314	1423	105919	0	108284
10101	452	312	106613	3193	0	110570
10102	645	275	2566	107088	0	110574
10103	108353	206	1216	3214	0	112989
10104	2728	213	768	110804	0	114513
10105	1097	268	111159	3144	0	115668
10106	673	266	114894	1568	0	117401
10107	807	334	3394	113700	0	118235
10108	117391	248	1501	3272	0	122412
10109	3006	122604	927	1467	0	128004
10110	126021	2857	804	1257	0	130939
10111	128506	1214	775	1105	0	131600
10112	4622	583	128823	827	0	134855
10113	2365	316	3518	128815	0	135014
10114	130649	214	1872	4099	0	136834
10115	130056	201	1217	2326	0	133800
10116	4540	128635	909	1346	0	135430
10117	2552	2947	824	129477	0	135800
10118	1552	1296	798	134203	0	137849
10119	980	646	129696	4871	0	136193
10120	1240	329	3478	128744	0	133791
10121	945	277	129773	4292	0	135287
10122	1025	326	128137	2236	0	131724
10123	1302	294	4479	126565	0	132640
10124	125718	188	2204	4022	0	132132
10125	3529	122953	1333	2204	0	130019
10126	123658	2917	1043	1573	0	129191
10127	124611	1359	837	1383	0	128190
10128	4801	122469	816	1054	0	129140
10129	2689	3065	740	119130	0	125624
10130	118684	1482	605	3367	0	124138
10131	3782	118366	596	1747	0	124491
10132	116819	2970	583	1382	0	121754
10133	3547	113403	667	892	0	118509
10134	2045	2799	544	110216	0	115604
10135	1400	1332	505	113467	0	116704
10136	110270	726	526	4004	0	115526
10137	109446	563	487	2253	0	112749
10138	3862	109410	582	1424	0	115278
10139	1991	2435	107336	1026	0	112788
10140	1250	1219	105835	940	0	109244
10141	1141	881	3554	103379	0	108955
10142	792	106213	1923	2797	0	111725
10143	993	2427	1158	108947	0	113525
10144	1015	1244	909	108817	0	111985
10145	1121	703	769	108937	0	111530
10146	863	576	106650	4116	0	112205
10147	909	556	105363	2155	0	108983
10148	841	107603	3511	1446	0	113401
10149	1045	2539	1717	108298	0	113599
10150	1058	1368	1022	112699	0	116147
10151	1018	873	108825	3907	0	114623
10152	102615	1397	2759	2483	0	109254
10153	3209	599	1629	110661	0	116098
10154	1762	619	110103	3340	0	115824
10155	106565	479	2996	2386	0	112426
10156	3123	109323	1704	1546	0	115696
10157	1961	2680	113112	1240	0	118993
10158	1648	1537	3011	112741	0	118937
10159	112521	936	1758	3575	0	118790
10160	3148	667	113555	2016	0	119386
10161	1921	529	3184	114397	0	120031
10162	1459	531	1846	115327	0	119163
10163	1078	563	1292	123648	0	126581
10164	122585	509	1076	5122	0	129292
10165	3407	119014	1020	2780	0	126221
10166	1931	3062	934	122643	0	128570
10167	1252	1507	123475	4116	0	130350
10168	1201	990	3511	121635	0	127337
10169	953	118772	1930	4272	0	125927
10170	908	127124	1194	2616	0	131842
10171	124988	3974	1048	2082	0	132092
10172	127465	1936	968	1681	0	132050
10173	4854	1174	123687	1344	0	131059
10174	122716	911	3483	1430	0	128540
10175	4117	123940	1875	1262	0	131194
10176	126765	3407	1083	1528	0	132783
10177	4427	1788	820	125732	0	132767
10178	2562	1197	127059	3806	0	134624
10179	1993	1025	3392	127501	0	133911
10180	1660	835	127519	4242	0	134256
10181	125648	744	3935	2617	0	132944
10182	3775	823	2020	128657	0	135275
10183	2074	131199	1213	4188	0	138674
10184	1842	3929	1045	134189	0	141005
10185	1414	1858	132681	4581	0	140534
10186	1002	130259	3565	2737	0	137563
10187	123354	3419	1816	2141	0	130730
10188	3023	119008	1231	1352	0	124614
10189	1389	117676	871	988	0	120924
10190	1328	3847	748	113277	0	119200
10191	713	115228	596	2911	0	119448
10192	1097	3269	675	116544	0	121585
10193	848	1559	113849	3238	0	119494
10194	108511	1032	2520	1847	0	113910
10195	114662	770	1186	1189	0	117807
10196	3710	704	112366	789	0	117569
10197	110097	622	2501	962	0	114182
10198	3041	111101	1248	789	0	116179
10199	113170	2505	813	869	0	117357
10200	3334	1358	557	111238	0	116487
10201	1555	852	111543	2557	0	116507
10202	945	112849	2381	1512	0	117687
10203	1131	2604	1428	112812	0	117975
10204	793	1219	735	114391	0	117138
10205	109438	678	510	3482	0	114108
10206	105632	543	462	1885	0	108522
10207	2982	102599	490	1138	0	107209
10208	1131	97719	388	662	0	99900
10209	568	95724	252	389	0	96933
10210	999	2028	552	92671	0	96250
10211	92126	551	543	1619	0	94839
10212	90914	324	140	645	0	92023
10213	1668	262	120	89946	0	91996
10214	672	188	124	90639	0	91623
10215	89634	192	111	1769	0	91706
10216	1526	203	107	91003	0	92839
10217	549	226	90433	1491	0	92699
10218	90338	186	1097	858	0	92479
10219	92824	208	333	592	0	93957
10220	1694	288	92498	300	0	94780
10221	94842	232	1181	532	0	96787
10222	1687	202	347	97629	0	99865
10223	750	250	242	97907	0	99149
10224	489	197	181	99379	0	100246
10225	97032	203	200	2066	0	99501
10226	1427	98530	223	786	0	100966
10227	673	1319	161	100015	0	102168
10228	441	97528	226	1463	0	99658
10229	98915	1416	183	745	0	101259
10230	1602	518	187	99869	0	102176
10231	763	336	206	101146	0	102451
10232	543	99687	210	1870	0	102310
10233	496	1532	98706	707	0	101441
10234	498	516	1388	101021	0	103423
10235	101440	324	464	1942	0	104170
10236	109685	312	297	975	0	111269
10237	2689	342	114315	492	0	117838
10238	1247	269	2323	117174	0	121013
10239	617	119570	905	2559	0	123651
10240	681	2559	427	123774	0	127441
10241	122753	961	333	3294	0	127341
10242	123979	570	274	1568	0	126391
10243	3720	447	276	121794	0	126237
10244	1454	119770	265	2920	0	124409
10245	128550	2669	188	1588	0	132995
10246	3320	1075	165	131960	0	136520
10247	132292	662	174	3524	0	136652
10248	139555	467	193	1818	0	142033
10249	4240	422	193	138687	0	143542
10250	1942	371	198	140250	0	142761
10251	1289	316	215	143348	0	145168
10252	847	139990	261	4741	0	145839
10253	1117	2980	163	144563	0	148823
10254	959	1133	201	145448	0	147741
10255	774	693	139036	4401	0	144904
10256	766	632	134645	2011	0	138054
10257	870	480	3592	136891	0	141833
10258	135640	351	1425	4026	0	141442
10259	3155	135574	757	1805	0	141291
10260	134527	2961	517	1524	0	139529
10261	3745	1165	134370	1073	0	140353
10262	1791	728	129643	971	0	133133
10263	932	130921	3495	930	0	136278
10264	1389	3009	1743	131134	0	137275
10265	599	1131	131152	2868	0	135750
10266	557	707	131661	1440	0	134365
10267	817	699	3209	131086	0	135811
10268	131767	261	1433	3254	0	136715
10269	132814	243	784	1695	0	135536
10270	3583	577	478	130624	0	135262
10271	1619	363	137799	2910	0	142691
10272	1279	299	2465	140426	0	144469
10273	975	319	1102	139329	0	141725
10274	513	139877	753	3346	0	144489
10275	140941	2382	624	1889	0	145836
10276	141160	961	541	1372	0	144034
10277	3288	140608	507	970	0	145373
10278	1755	2629	437	136529	0	141350
10279	940	139477	485	2627	0	143529
10280	140052	2733	406	1615	0	144806
10281	3008	1187	136160	967	0	141322
10282	1483	877	130302	820	0	133482
10283	949	623	131224	666	0	133462
10284	880	575	3358	131536	0	136349
10285	687	328	1573	133106	0	135694
10286	132325	317	837	3493	0	136972
10287	2578	340	518	132790	0	136226
10288	1542	381	428	136409	0	138760
10289	1014	374	140418	3417	0	145223
10290	825	459	134496	1828	0	137608
10291	135885	351	2957	1614	0	140807
10292	2432	138899	1422	990	0	143743
10293	142654	2174	800	1189	0	146817
10294	2965	992	671	142319	0	146947
10295	1655	586	611	142188	0	145040
10296	1011	139297	598	3268	0	144174
10297	871	2268	509	142796	0	146444
10298	140333	1025	424	3485	0	145267
10299	2701	711	372	141748	0	145532
10300	1385	601	140792	3217	0	145995
10301	1088	137944	2377	1905	0	143314
10302	138137	2270	1276	1627	0	143310
10303	141105	1034	875	1520	0	144534
10304	141586	720	621	1397	0	144324
10305	143003	545	469	1319	0	145336
10306	3981	470	461	140398	0	145310
10307	2135	500	442	142993	0	146070
10308	1380	498	140113	3732	0	145723
10309	1232	441	2299	141461	0	145433
10310	1017	517	140986	3433	0	145953
10311	1072	398	2592	141594	0	145656
10312	140645	442	1313	3804	0	146204
10313	2656	143137	986	2080	0	148859
10314	1646	2193	713	147350	0	151902
10315	1204	1127	602	150481	0	153414
10316	147199	662	600	4189	0	152650
10317	143839	480	575	2595	0	147489
10318	3660	488	142581	1593	0	148322
10319	1778	142521	2584	1392	0	148275
10320	1246	2318	1300	143918	0	148782
10321	1048	1114	1009	145337	0	148508
10322	142372	753	828	4104	0	148057
10323	141209	502	1293	2463	0	145467
10324	3718	604	142374	1366	0	148062
10325	2054	607	139332	1110	0	143103
10326	1480	505	3315	139197	0	144497
10327	1182	447	1583	143166	0	146378
10328	1052	475	140360	3680	0	145567
10329	136579	379	2825	2413	0	142196
10330	3089	416	1464	142010	0	146979
10331	140000	311	1121	3548	0	144980
10332	2896	137578	838	2015	0	143327
10333	141758	2263	718	2029	0	146768
10334	3358	1136	147988	1313	0	153795
10335	1866	145127	2544	1306	0	150843
10336	1081	142437	1146	845	0	145509
10337	133711	1975	1939	1150	0	138775
10338	131019	675	522	851	0	133067
10339	2138	406	300	129661	0	132505
10340	877	127564	344	1559	0	130344
10341	556	131370	341	887	0	133154
10342	662	1785	228	133150	0	135825
10343	133087	719	266	2066	0	136138
10344	133311	433	213	1354	0	135311
10345	2095	315	124858	527	0	127795
10346	121259	220	1137	774	0	123390
10347	1537	128942	534	329	0	131342
10348	131379	1574	266	770	0	133989
10349	2322	152800	273	343	0	155738
10350	892	167012	254	321	0	168479
10351	1652	5195	400	181988	0	189235
10352	194818	2161	435	5543	0	202957
10353	201119	1359	126	2606	0	205210
10354	7604	860	194069	1642	0	204175
10355	4640	437	5188	195785	0	206050
10356	199789	231	1972	6658	0	208650
10357	7893	236	1576	200363	0	210068
10358	202065	200	1023	7789	0	211077
10359	205111	221	769	3828	0	209929
10360	8901	394	197616	2598	0	209509
10361	5610	318	5422	195538	0	206888
10362	4122	312	2095	201757	0	208286
10363	3156	276	1632	203742	0	208806
10364	1891	398	193528	9287	0	205104
10365	1981	250	6006	195845	0	204082
10366	1666	385	2479	192264	0	196794
10367	768	189679	2006	9249	0	201702
10368	840	5629	187743	5073	0	199285
10369	715	191898	5966	3887	0	202466
10370	191584	6964	2461	2930	0	203939
10371	6823	3070	1882	182598	0	194373
10372	3526	2453	1299	180631	0	187909
10373	2422	182552	1151	7715	0	193840
10374	182459	6319	797	4581	0	194156
10375	186547	2601	565	3817	0	193530
10376	8369	179373	647	2681	0	191070
10377	4477	187439	524	2138	0	194578
10378	185320	7965	537	1946	0	195768
10379	7891	4154	179965	1232	0	193242
10380	4109	3226	179074	1088	0	187497
10381	175762	2354	7517	1808	0	187441
10382	6890	181532	3921	1298	0	193641
10383	183388	6449	2699	1766	0	194302
10384	8168	2974	178797	1376	0	191315
10385	182411	2380	6247	1863	0	192901
10386	8763	185737	2927	1237	0	198664
10387	5217	6547	2292	188183	0	202239
10388	4585	2970	1599	190758	0	199912
10389	4075	2436	1290	177226	0	185027
10390	3194	1596	1101	186089	0	191980
10391	2670	1384	925	183095	0	188074
10392	2067	177491	891	11466	0	191915
10393	179957	5998	758	7272	0	193985
10394	7113	2845	177368	5128	0	192454
10395	4077	2317	6012	182393	0	194799
10396	3240	1881	181308	8325	0	194754
10397	2751	1530	7677	182669	0	194627
10398	2334	1239	3867	187759	0	195199
10399	180774	1143	3116	10788	0	195821
10400	7002	1282	177355	6218	0	191857
10401	3485	176703	7047	4882	0	192117
10402	3389	6372	3264	181353	0	194378
10403	2961	3209	2488	186824	0	195482
10404	2335	2915	180892	9524	0	195666
10405	2457	2199	6747	182896	0	194299
10406	2185	1948	3074	189711	0	196918
10407	177293	1506	2486	11519	0	192804
10408	6626	179355	1757	6899	0	194637
10409	180896	6723	1441	5583	0	194643
10410	185960	3402	1213	4191	0	194766
10411	10423	2890	1138	180666	0	195117
10412	6049	2324	177225	7657	0	193255
10413	4771	2156	178545	3972	0	189444
10414	3923	1725	8432	176922	0	191002
10415	3320	1463	4704	176172	0	185659
10416	2475	175006	3866	9641	0	190988
10417	175743	6265	2850	6088	0	190946
10418	7352	171754	2411	4717	0	186234
10419	4137	179674	1741	3955	0	189507
10420	178120	9034	1437	3834	0	192425
10421	8576	4875	1317	175703	0	190471
10422	4688	182585	1349	8254	0	196876
10423	3912	7880	1270	185872	0	198934
10424	2852	3997	179027	10082	0	195958
10425	2556	3241	180022	6273	0	192092
10426	2559	2402	8178	183528	0	196667
10427	2034	2046	183644	9610	0	197334
10428	2185	1671	8907	183927	0	196690
10429	2063	1434	4855	186462	0	194814
10430	1762	1239	4142	191406	0	198549
10431	178908	1164	2940	12998	0	196010
10432	6493	172661	2593	8188	0	189935
10433	3118	182058	1960	6408	0	193544
10434	171523	7750	1622	5031	0	185926
10435	176597	4363	1309	4115	0	186384
10436	9087	3649	1269	172165	0	186170
10437	5096	3061	170851	7693	0	186701
10438	4374	2426	6070	173964	0	186834
10439	3227	2007	172057	9300	0	186591
10440	2735	171076	7352	5462	0	186625
10441	2564	6238	3545	176201	0	188548
10442	174028	3076	3068	8927	0	189099
10443	7483	2944	2348	176266	0	189041
10444	3910	2231	169688	8700	0	184529
10445	167262	1900	6895	5297	0	181354
10446	8267	1726	170945	4327	0	185265
10447	5284	1391	167886	3402	0	177963
10448	3314	159302	7751	3802	0	174169
10449	1865	136231	3441	1864	0	143401
10450	1691	129000	2752	1630	0	135073
10451	102668	3263	3397	2339	0	111667
10452	96749	397	545	772	0	98463
10453	881	188	137	98543	0	99749
10454	427	128	103	98922	0	99580
10455	266	104	89	101288	0	101747
10456	152	100382	142	892	0	101568
10457	101680	620	97	651	0	103048
10458	697	100839	156	270	0	101962
10459	292	716	108	102836	0	103952
10460	102156	252	116	1108	0	103632
10461	787	184	104	102508	0	103583
10462	360	156	101	104189	0	104806
10463	104447	125	86	1253	0	105911
10464	102960	126	115	730	0	103931
10465	954	164	103231	273	0	104622
10466	450	166	100544	247	0	101407
10467	307	183	104010	203	0	104703
10468	330	164	972	104539	0	106005
10469	279	139	371	106307	0	107096
10470	156	105933	273	1002	0	107364
10471	108825	807	147	701	0	110480
10472	972	279	139	110111	0	111501
10473	415	162	134	111843	0	112554
10474	256	111088	158	1265	0	112767
10475	198	117402	158	579	0	118337
10476	277	1148	104	120196	0	121725
10477	392	362	108	131409	0	132271
10478	131490	236	99	2402	0	134227
10479	132034	172	114	1085	0	133405
10480	2298	163	98	131766	0	134325
10481	915	226	130426	1902	0	133469
10482	646	270	125279	776	0	126971
10483	601	121	1995	130283	0	133000
10484	601	121	754	127903	0	129379
10485	296	126970	525	2252	0	130043
10486	124977	1634	266	1242	0	128119
10487	1928	527	256	125536	0	128247
10488	654	437	124945	1931	0	127967
10489	697	249	1640	126937	0	129523
10490	334	224	126188	2209	0	128955
10491	401	311	126212	879	0	127803
10492	617	672	2196	128782	0	132267
10493	129116	211	976	2461	0	132764
10494	1755	158	128191	838	0	130942
10495	839	139	1757	126836	0	129571
10496	505	202	134625	1910	0	137242
10497	591	140	1897	134332	0	136960
10498	559	124	695	134804	0	136182
10499	367	180	134028	2366	0	136941
10500	412	241	128839	1143	0	130635
10501	939	189	2310	122395	0	125833
10502	409	123	999	133833	0	135364
10503	420	93	731	135232	0	136476
10504	405	103	478	133163	0	134149
10505	131831	112	455	3079	0	135477
10506	132247	121	402	1675	0	134445
10507	2139	131041	425	1024	0	134629
10508	132792	1588	347	1161	0	135888
10509	2212	501	376	133771	0	136860
10510	134013	335	423	2618	0	137389
10511	2239	222	131693	1017	0	135171
10512	133545	125	1971	1251	0	136892
10513	2374	186	821	135332	0	138713
10514	1146	134	616	139596	0	141492
10515	138195	110	439	3329	0	142073
10516	2606	179	420	147384	0	150589
10517	903	221	152078	3370	0	156572
10518	151332	143	2781	2086	0	156342
10519	2987	156448	1167	1340	0	161942
10520	1457	2631	689	163438	0	168215
10521	968	937	173951	3667	0	179523
10522	1023	587	3556	172987	0	178153
10523	604	419	173892	4635	0	179550
10524	938	319	4079	174669	0	180005
10525	507	173741	1590	4778	0	180616
10526	975	3462	968	177047	0	182452
10527	573	180783	822	4827	0	187005
10528	1587	4592	629	173682	0	180490
10529	1090	1490	547	191888	0	195015
10530	1200	936	544	193253	0	195933
10531	1175	557	636	193636	0	196004
10532	1249	412	604	194591	0	196856
10533	753	558	186174	7203	0	194688
10534	1139	384	4366	188359	0	194248
10535	952	367	1785	192552	0	195656
10536	187333	327	1408	7571	0	196639
10537	4319	185607	1024	4635	0	195585
10538	188259	4419	778	3210	0	196666
10539	5694	1701	773	188593	0	196761
10540	2034	1355	186747	6022	0	196158
10541	1296	187362	4689	3321	0	196668
10542	185610	4611	1970	3145	0	195336
10543	4638	183565	1466	2372	0	192041
10544	1702	190852	994	2253	0	195801
10545	187884	5805	884	2557	0	197130
10546	5396	2395	717	197223	0	205731
10547	196880	1468	729	7042	0	206119
10548	6570	859	743	194102	0	202274
10549	2447	759	192423	7505	0	203134
10550	1700	805	190251	3827	0	196583
10551	185898	656	6495	3394	0	196443
10552	193842	683	3035	2666	0	200226
10553	7489	666	1782	187286	0	197223
10554	3662	730	1193	191570	0	197155
10555	182734	805	1014	8280	0	192833
10556	5991	178706	934	3990	0	189621
10557	2751	186163	806	3052	0	192772
10558	183292	6357	801	2640	0	193090
10559	186156	2720	780	2453	0	192109
10560	7315	182528	926	1942	0	192711
10561	4179	5825	732	183070	0	193806
10562	2657	2524	180107	6231	0	191519
10563	2019	1858	180279	3143	0	187299
10564	177911	1214	6644	2924	0	188693
10565	6453	1032	180770	2159	0	190414
10566	3529	935	6150	176330	0	186944
10567	2759	861	2533	175838	0	181991
10568	1825	175835	1974	7385	0	187019
10569	176748	5306	1400	4077	0	187531
10570	6797	2278	1145	176552	0	186772
10571	3098	1898	172415	6720	0	184131
10572	2375	172362	5157	3711	0	183605
10573	2301	6181	2150	172483	0	183115
10574	1865	2468	169669	6507	0	180509
10575	1804	1961	165174	3485	0	172424
10576	1343	163067	6482	2971	0	173863
10577	149732	4832	2903	2280	0	159747
10578	4695	152826	1924	1843	0	161288
10579	152904	5062	1447	2017	0	161430
10580	5370	2256	149677	1822	0	159125
10581	146862	1610	4726	2113	0	155311
10582	5316	150007	2223	1867	0	159413
10583	2770	4704	1646	151302	0	160422
10584	2062	2149	1359	156629	0	162199
10585	152676	1664	1493	6799	0	162632
10586	5065	1494	151541	3507	0	161607
10587	152161	1472	4643	2893	0	161169
10588	155514	1262	2100	2527	0	161403
10589	6298	1275	148087	2207	0	157867
10590	3103	1267	151285	2053	0	157708
10591	2491	1503	5869	147285	0	157148
10592	149033	1229	2852	5829	0	158943
10593	150749	1258	2051	3189	0	157247
10594	6266	148398	1740	2506	0	158910
10595	3573	4791	1410	151978	0	161752
10596	2894	2148	1132	149053	0	155227
10597	2491	1710	1065	150315	0	155581
10598	2325	1255	1084	152682	0	157346
10599	147940	1211	1275	7613	0	158039
10600	6054	1250	1165	150945	0	159414
10601	3128	1346	147586	6464	0	158524
10602	2722	1262	146348	3295	0	153627
10603	144136	1119	5938	2780	0	153973
10604	6084	142879	2945	2081	0	153989
10605	3119	151108	2237	1819	0	158283
10606	3108	5720	1770	149980	0	160578
10607	2580	2534	1504	154010	0	160628
10608	2528	1698	1517	152865	0	158608
10609	2282	1392	1377	155902	0	160953
10610	1951	1284	149080	7818	0	160133
10611	2285	1092	4733	150360	0	158470
10612	2299	1082	2090	152238	0	157709
10613	1839	1118	143777	7268	0	154002
10614	136347	861	5170	4364	0	146742
10615	5083	141118	2483	3311	0	151995
10616	132711	3751	1848	2631	0	140941
10617	4858	1445	128063	1912	0	136278
10618	2471	1067	123806	1593	0	128937
10619	1688	121847	4454	1510	0	129499
10620	111213	4960	6137	2186	0	124496
10621	104485	1361	1507	1349	0	108702
10622	104956	807	746	1046	0	107555
10623	3446	101687	621	985	0	106739
10624	100531	2345	664	947	0	104487
10625	3045	953	100565	766	0	105329
10626	1245	100429	2296	799	0	104769
10627	96183	2228	1183	1021	0	100615
10628	2343	97396	790	825	0	101354
10629	94193	2115	580	751	0	97639
10630	91721	793	531	801	0	93846
10631	2610	602	93374	440	0	97026
10632	1220	94016	2029	435	0	97700
10633	93996	1908	899	639	0	97442
10634	2253	789	93324	346	0	96712
10635	1087	93114	2006	440	0	96647
10636	1101	2176	863	91492	0	95632
10637	707	766	91771	1767	0	95011
10638	623	660	88728	746	0	90757
10639	740	709	1995	89627	0	93071
10640	88736	284	951	2060	0	92031
10641	1804	88118	559	908	0	91389
10642	812	1584	87719	615	0	90730
10643	839	649	86135	434	0	88057
10644	83004	545	1975	540	0	86064
10645	1686	87531	939	349	0	90505
10646	79047	851	548	322	0	80768
10647	953	79054	189	100	0	80296
10648	80152	924	312	330	0	81718
10649	78807	308	176	244	0	79535
10650	1147	77450	165	124	0	78886
10651	535	870	128	78903	0	80436
10652	81856	336	121	1099	0	83412
10653	1148	197	130	83450	0	84925
10654	514	145	160	87609	0	88428
10655	87650	114	133	1695	0	89592
10656	1332	87318	156	520	0	89326
10657	89402	1289	132	496	0	91319
10658	1559	423	88391	182	0	90555
10659	642	248	1289	89824	0	92003
10660	521	161	376	90274	0	91332
10661	89650	147	243	1855	0	91895
10662	90303	185	164	731	0	91383
10663	1795	160	122	89773	0	91850
10664	703	224	90435	1436	0	92798
10665	578	159	1296	90364	0	92397
10666	444	148	388	91971	0	92951
10667	415	169	284	92724	0	93592
10668	424	137	188	92840	0	93589
10669	91395	122	161	2121	0	93799
10670	1540	181	90381	764	0	92866
10671	584	91026	1360	538	0	93508
10672	569	1302	421	91329	0	93621
10673	443	418	278	94497	0	95636
10674	347	305	93507	1938	0	96097
10675	347	271	92072	814	0	93504
10676	450	155	1672	94587	0	96864
10677	465	159	565	96096	0	97285
10678	378	207	93955	2085	0	96625
10679	461	175	1610	93769	0	96015
10680	95551	190	583	2199	0	98523
10681	1796	98011	413	870	0	101090
10682	718	1664	97312	611	0	100305
10683	471	97567	1717	540	0	100295
10684	568	1845	614	99444	0	102471
10685	425	662	99148	1870	0	102105
10686	411	98286	1815	867	0	101379
10687	532	1649	708	99705	0	102594
10688	387	630	100470	1929	0	103416
10689	511	387	1809	99766	0	102473
10690	520	284	666	100840	0	102310
10691	100342	238	432	2647	0	103659
10692	2001	246	331	101076	0	103654
10693	101145	254	349	2534	0	104282
10694	98678	250	374	1238	0	100540
10695	99027	245	339	963	0	100574
10696	2658	263	308	97740	0	100969
10697	935	260	95975	2082	0	99252
10698	689	294	93640	972	0	95595
10699	95364	174	2107	957	0	98602
10700	1893	243	96291	574	0	99001
10701	92847	204	1928	814	0	95793
10702	1852	94929	757	605	0	98143
10703	96118	1453	520	781	0	98872
10704	1944	531	96861	561	0	99897
10705	856	340	98537	509	0	100242
10706	831	316	2098	98905	0	102150
10707	465	217	102729	2157	0	105568
10708	432	251	104139	925	0	105747
10709	814	232	2587	107228	0	110861
10710	677	205	903	112117	0	113902
10711	544	219	584	116081	0	117428
10712	356	114473	561	3461	0	118851
10713	603	2459	459	114435	0	117956
10714	352	118145	479	3018	0	121994
10715	118302	2728	457	1606	0	123093
10716	120832	995	420	1156	0	123403
10717	3548	549	412	116333	0	120842
10718	1403	115425	456	3077	0	120361
10719	856	2661	117400	1346	0	122263
10720	119149	860	2984	1173	0	124166
10721	3457	535	1178	119689	0	124859
10722	1557	362	709	122080	0	124708
10723	1108	437	564	123876	0	125985
10724	119315	290	534	4753	0	124892
10725	3285	114082	564	2068	0	119999
10726	1265	118617	550	1336	0	121768
10727	114665	3441	508	1203	0	119817
10728	3212	116366	506	869	0	120953
10729	117346	3377	465	1041	0	122229
10730	118807	1209	473	1064	0	121553
10731	4031	115835	483	809	0	121158
10732	1957	3190	480	114401	0	120028
10733	1014	115632	538	3366	0	120550
10734	1067	3320	415	116186	0	120988
10735	975	1254	377	122886	0	125492
10736	121621	840	367	5006	0	127834
10737	127302	715	399	2284	0	130700
10738	5015	589	469	126009	0	132082
10739	2095	700	122443	4313	0	129551
10740	120904	550	3430	2245	0	127129
10741	4090	122096	1348	1542	0	129076
10742	2000	3573	873	123182	0	129628
10743	1649	1408	605	126265	0	129927
10744	1350	1020	542	127409	0	130321
10745	120269	838	423	5831	0	127361
10746	121716	665	392	3065	0	125838
10747	4753	114511	498	2065	0	121827
10748	2217	118637	488	1522	0	122864
10749	1994	4264	416	118013	0	124687
10750	1629	1867	423	120932	0	124851
10751	1172	1294	117654	5038	0	125158
10752	1331	1200	3388	116532	0	122451
10753	926	742	114458	4889	0	121015
10754	885	561	109656	2227	0	113329
10755	835	108591	4056	1814	0	115296
10756	1366	3395	1808	108924	0	115493
10757	109086	1244	1056	4283	0	115669
10758	3844	974	680	108542	0	114040
10759	1690	863	106851	4226	0	113630
10760	105572	782	3130	2202	0	111686
10761	108666	715	1212	1657	0	112250
10762	4610	767	105276	1338	0	111991
10763	2425	628	3218	108088	0	114359
10764	106686	564	1321	4122	0	112693
10765	4112	106983	922	2087	0	114104
10766	109374	3413	765	1874	0	115426
10767	113084	1433	689	1657	0	116863
10768	5036	1118	603	110475	0	117232
10769	2556	834	571	115308	0	119269
10770	113333	716	610	5332	0	119991
10771	4671	654	561	114332	0	120218
10772	2162	707	111983	5129	0	119981
10773	110635	609	3548	2701	0	117493
10774	113781	639	1350	2129	0	117899
10775	5086	108442	974	1649	0	116151
10776	2398	112201	668	1501	0	116768
10777	1955	4694	583	108393	0	115625
10778	1438	110702	585	4074	0	116799
10779	1617	4408	558	111387	0	117970
10780	108948	1657	534	4817	0	115956
10781	107745	1091	554	2432	0	111822
10782	4626	104934	583	1874	0	112017
10783	105000	3490	597	1674	0	110761
10784	4559	104195	582	1323	0	110659
10785	104881	3888	532	1386	0	110687
10786	106988	1621	566	1393	0	110568
10787	5092	1234	101992	1286	0	109604
10788	101960	892	3262	1352	0	107466
10789	4718	99076	1356	1215	0	106365
10790	2367	103847	928	1227	0	108369
10791	103930	4064	745	1215	0	109954
10792	4702	1968	583	102896	0	110149
10793	2357	1368	101838	3892	0	109455
10794	2188	1154	3153	102929	0	109424
10795	1767	1023	1195	106111	0	110096
10796	1541	923	101133	4936	0	108533
10797	98445	795	3332	2697	0	105269
10798	4147	99444	1347	2132	0	107070
10799	99797	3306	1067	1649	0	105819
10800	4919	1422	747	97430	0	104518
10801	97607	1185	614	3972	0	103378
10802	4564	95841	581	2011	0	102997
10803	2616	3824	524	96565	0	103529
10804	95736	1455	535	4198	0	101924
10805	4427	1133	90530	2075	0	98165
10806	2132	845	85833	1682	0	90492
10807	82780	984	3746	1499	0	89009
10808	3675	80999	1560	1107	0	87341
10809	1551	75889	800	847	0	79087
10810	2325	3348	1105	69901	0	76679
10811	1120	70781	577	2343	0	74821
10812	1252	2731	540	71104	0	75627
10813	1083	1120	485	73371	0	76059
10814	935	795	548	72376	0	74654
10815	962	69375	519	3048	0	73904
10816	988	2098	510	69872	0	73468
10817	958	959	67908	2567	0	72392
10818	914	66722	1749	1517	0	70902
10819	879	2031	650	63182	0	66742
10820	788	63933	551	1746	0	67018
10821	63794	1817	498	1052	0	67161
10822	64063	778	397	940	0	66178
10823	64405	601	449	812	0	66267
10824	2483	64166	406	693	0	67748
10825	1408	1706	341	64505	0	67960
10826	1102	851	63351	1645	0	66949
10827	968	783	61937	846	0	64534
10828	60739	806	1795	1017	0	64357
10829	62081	685	812	820	0	64398
10830	2123	508	465	62852	0	65948
10831	1328	511	322	65064	0	67225
10832	941	456	64453	2389	0	68239
10833	797	61151	1621	3165	0	66734
10834	864	62973	787	1102	0	65726
10835	703	1571	59498	603	0	62375
10836	767	1334	1514	55436	0	59051
10837	632	440	561	49886	0	51519
10838	432	305	230	56034	0	57001
10839	423	291	174	56031	0	56919
10840	55274	272	166	1512	0	57224
10841	1221	310	53216	615	0	55362
10842	53441	267	932	477	0	55117
10843	1286	260	416	53818	0	55780
10844	54150	273	240	1182	0	55845
10845	1289	284	208	54155	0	55936
10846	626	255	54218	1207	0	56306
10847	522	341	966	54585	0	56414
10848	375	284	55598	1245	0	57502
10849	423	332	982	54550	0	56287
10850	336	221	56114	1174	0	57845
10851	258	55397	954	554	0	57163
10852	352	923	444	55885	0	57604
10853	312	381	235	55899	0	56827
10854	213	55820	221	1146	0	57400
10855	57013	934	180	650	0	58777
10856	1061	368	178	57152	0	58759
10857	510	263	187	57182	0	58142
10858	57433	199	152	1465	0	59249
10859	58326	183	171	746	0	59426
10860	59829	165	160	546	0	60700
10861	60197	157	155	448	0	60957
10862	1493	188	57403	324	0	59408
10863	56924	170	943	437	0	58474
10864	59034	177	379	402	0	59992
10865	1459	147	238	56454	0	58298
10866	678	254	186	56443	0	57561
10867	54631	135	158	1302	0	56226
10868	1002	53796	139	588	0	55525
10869	488	887	122	52516	0	54013
10870	259	298	53521	879	0	54957
10871	174	52294	640	396	0	53504
10872	51716	767	471	328	0	53282
10873	51986	275	250	305	0	52816
10874	51998	118	107	234	0	52457
10875	52589	82	71	257	0	52999
10876	919	72	84	51187	0	52262
10877	410	102	50675	666	0	51853
10878	259	133	52209	313	0	52914
10879	247	87	948	56020	0	57302
10880	58795	44	344	1053	0	60236
10881	1115	63	157	59422	0	60757
10882	443	85	59800	1132	0	61460
10883	60335	45	1020	610	0	62010
10884	61246	50	351	357	0	62004
10885	1496	68	206	61359	0	63129
10886	551	54	62806	1117	0	64528
10887	358	71	63473	444	0	64346
10888	61823	44	1307	431	0	63605
10889	1126	62723	484	293	0	64626
10890	506	983	63509	210	0	65208
10891	444	329	1105	63037	0	64915
10892	63492	113	432	1312	0	65349
10893	1179	61103	279	493	0	63054
10894	505	62595	213	276	0	63589
10895	63045	1224	175	327	0	64771
10896	1286	408	174	62911	0	64779
10897	66778	163	176	1332	0	68449
10898	1466	134	162	68031	0	69793
10899	656	128	162	69127	0	70073
10900	309	164	67888	1605	0	69966
10901	360	172	64679	618	0	65829
10902	364	165	68508	361	0	69398
10903	400	117	1651	69044	0	71212
10904	69982	122	562	1550	0	72216
10905	1534	150	69709	590	0	71983
10906	768	113	1385	70052	0	72318
10907	397	161	71269	1554	0	73381
10908	391	71968	1495	680	0	74534
10909	481	1346	548	73703	0	76078
10910	495	369	338	74458	0	75660
10911	411	167	354	75073	0	76005
10912	73704	123	357	2128	0	76312
10913	1663	107	350	73733	0	75853
10914	733	131	328	74966	0	76158
10915	73992	122	328	2164	0	76606
10916	1634	158	72568	868	0	75228
10917	72723	122	1477	673	0	74995
10918	73666	145	618	519	0	74948
10919	1972	198	72250	424	0	74844
10920	71602	170	1478	534	0	73784
10921	1879	184	555	74186	0	76804
10922	800	135	75103	1620	0	77658
10923	74959	129	1476	965	0	77529
10924	76492	84	551	740	0	77867
10925	2098	78	360	75819	0	78355
10926	993	86	346	76499	0	77924
10927	716	68	331	77108	0	78223
10928	74980	64	330	2245	0	77619
10929	1732	74957	372	955	0	78016
10930	73966	1147	345	699	0	76157
10931	1526	70007	369	511	0	72413
10932	656	70375	365	485	0	71881
10933	594	1457	375	71200	0	73626
10934	548	420	316	72300	0	73584
10935	544	204	265	71554	0	72567
10936	521	156	272	71672	0	72621
10937	422	177	69608	1915	0	72122
10938	68704	171	1260	1002	0	71137
10939	1502	171	477	71154	0	73304
10940	669	230	71220	1648	0	73767
10941	648	195	1281	71608	0	73732
10942	578	226	486	73223	0	74513
10943	505	265	74733	1851	0	77354
10944	559	189	1296	74908	0	76952
10945	524	181	524	75210	0	76439
10946	75353	120	368	2167	0	78008
10947	1504	153	75211	987	0	77855
10948	72942	86	1384	874	0	75286
10949	1556	75543	598	650	0	78347
10950	75697	1171	426	757	0	78051
10951	75313	327	429	722	0	76791
10952	1878	227	386	74684	0	77175
10953	789	171	73959	1742	0	76661
10954	528	76378	1439	893	0	79238
10955	583	1476	571	75193	0	77823
10956	406	79300	410	1631	0	81747
10957	79997	1521	346	939	0	82803
10958	1728	482	78183	659	0	81052
10959	702	373	77270	610	0	78955
10960	618	299	1738	77125	0	79780
10961	521	261	79507	1849	0	82138
10962	611	237	1609	80244	0	82701
10963	588	216	579	80362	0	81745
10964	82031	202	400	2361	0	84994
10965	1715	82089	430	1017	0	85251
10966	751	1529	395	84228	0	86903
10967	604	437	393	86225	0	87659
10968	556	280	380	85840	0	87056
10969	467	82400	515	2372	0	85754
10970	433	85114	465	1067	0	87079
10971	83794	1694	428	977	0	86893
10972	84653	518	410	879	0	86460
10973	84599	311	328	846	0	86084
10974	2221	301	82122	699	0	85343
10975	978	621	1596	82129	0	85324
10976	616	308	81947	2026	0	84897
10977	544	81773	1618	951	0	84886
10978	78973	1648	751	967	0	82339
10979	1656	465	77407	547	0	80075
10980	800	447	1278	75222	0	77747
10981	493	234	77241	1406	0	79374
10982	74810	199	1349	814	0	77172
10983	77680	156	466	740	0	79042
10984	77952	142	336	550	0	78980
10985	77007	168	286	509	0	77970
10986	1652	191	77104	354	0	79301
10987	75533	157	1165	512	0	77367
10988	77462	152	429	493	0	78536
10989	1479	76102	327	343	0	78251
10990	76494	1025	261	445	0	78225
10991	77997	308	266	460	0	79031
10992	1668	202	292	75447	0	77609
10993	675	77755	257	1133	0	79820
10994	80996	1063	243	649	0	82951
10995	85767	333	235	551	0	86886
10996	1966	317	92664	380	0	95327
10997	792	239	93338	229	0	94598
10998	528	211	96752	233	0	97724
10999	643	576	2773	95364	0	99356
11000	95962	155	1145	2294	0	99556
11001	2150	95870	630	860	0	99510
11002	95391	1996	397	686	0	98470
11003	2456	95499	280	378	0	98613
11004	95186	2223	310	415	0	98134
11005	2373	93224	323	314	0	96234
11006	980	96154	259	240	0	97633
11007	93332	2435	259	442	0	96468
11008	2106	94421	229	210	0	96966
11009	1036	2272	200	94286	0	97794
11010	698	881	94794	1847	0	98220
11011	481	620	94783	681	0	96565
11012	555	378	2391	93952	0	97276
11013	574	268	979	96985	0	98806
11014	340	302	95970	2518	0	99130
11015	533	235	1988	94929	0	97685
11016	519	244	748	97666	0	99177
11017	96744	203	539	2893	0	100379
11018	2073	96525	420	1240	0	100258
11019	992	2024	325	94221	0	97562
11020	595	97795	353	2043	0	100786
11021	97466	2327	323	1105	0	101221
11022	2132	97522	309	667	0	100630
11023	98003	2348	260	638	0	101249
11024	98865	943	196	544	0	100548
11025	3071	638	213	96387	0	100309
11026	1511	478	239	97597	0	99825
11027	1056	398	281	98790	0	100525
11028	786	388	312	98947	0	100433
11029	529	420	93924	3198	0	98071
11030	89923	347	2002	1645	0	93917
11031	2285	93927	784	958	0	97954
11032	1260	2149	491	97029	0	100929
11033	1026	898	361	97987	0	100272
11034	616	96813	334	2862	0	100625
11035	97817	2274	373	1579	0	102043
11036	2370	98430	396	973	0	102169
11037	1221	2588	332	99812	0	103953
11038	978	1081	279	102265	0	104603
11039	833	791	237	102814	0	104675
11040	721	550	252	102220	0	103743
11041	99389	473	275	3756	0	103893
11042	2620	458	98467	1611	0	103156
11043	1241	443	2309	97334	0	101327
11044	986	423	1060	98945	0	101414
11045	775	404	860	99981	0	102020
11046	741	391	613	99602	0	101347
11047	95492	394	435	4017	0	100338
11048	2793	428	94898	1891	0	100010
11049	1421	731	2101	92457	0	96710
11050	1030	90100	849	2716	0	94695
11051	741	95553	603	1369	0	98266
11052	94295	2835	347	1277	0	98754
11053	2625	1447	93003	810	0	97885
11054	88809	1016	1947	813	0	92585
11055	2848	713	90097	655	0	94313
11056	1287	487	2041	87565	0	91380
11057	89288	362	911	2592	0	93153
11058	1964	89788	782	1400	0	93934
11059	948	1864	608	88385	0	91805
11060	813	84315	646	2275	0	88049
11061	89073	2203	498	1476	0	93250
11062	90045	903	435	1253	0	92636
11063	2719	699	345	89465	0	93228
11064	1348	506	86684	2512	0	91050
11065	1054	522	85259	1363	0	88198
11066	777	713	2218	86485	0	90193
11067	588	85327	1062	2250	0	89227
11068	664	2331	597	90610	0	94202
11069	822	1089	265	87609	0	89785
11070	895	873	213	86541	0	88522
11071	651	608	87118	3199	0	91576
11072	775	400	1789	87417	0	90381
11073	592	359	811	89107	0	90869
11074	385	85583	716	3599	0	90283
11075	376	2189	423	85614	0	88602
11076	393	740	357	91601	0	93091
11077	446	480	457	92866	0	94249
11078	568	308	379	92824	0	94079
11079	515	360	331	91614	0	92820
11080	483	404	307	91770	0	92964
11081	474	439	243	89794	0	90950
11082	404	571	230	88865	0	90070
11083	535	563	82297	4539	0	87934
11084	629	551	1698	85393	0	88271
11085	84161	397	697	3214	0	88469
11086	2205	278	541	84071	0	87095
11087	1080	293	83705	3045	0	88123
11088	81951	268	1885	1960	0	86064
11089	86186	298	852	1534	0	88870
11090	86324	342	628	1211	0	88505
11091	86456	317	377	1222	0	88372
11092	3258	315	289	86018	0	89880
11093	1515	229	83564	2781	0	88089
11094	936	80528	1799	1683	0	84946
11095	650	75506	875	1257	0	78288
11096	1196	1919	1799	65002	0	69916
11097	434	330	607	66281	0	67652
11098	260	147	94	65293	0	65794
11099	167	93	73	67782	0	68115
11100	174	71	61	74143	0	74449
11101	78332	61	69	2069	0	80531
11102	1562	78266	113	816	0	80757
11103	566	82105	102	498	0	83271
11104	548	2272	90	83615	0	86525
11105	324	820	78	86103	0	87325
11106	326	419	75	86152	0	86972
11107	309	188	64	86277	0	86838
11108	151	193	81494	3182	0	85020
11109	180	80327	1878	1453	0	83838
11110	280	1860	564	81710	0	84414
11111	79855	656	343	2425	0	83279
11112	1958	463	154	81016	0	83591
11113	685	276	80043	2554	0	83558
11114	506	301	77129	1177	0	79113
11115	258	278	80713	923	0	82172
11116	405	413	2601	79036	0	82455
11117	81266	190	1239	2468	0	85163
11118	1942	160	560	82346	0	85008
11119	817	154	300	84887	0	86158
11120	82722	127	239	3146	0	86234
11121	2150	135	239	84431	0	86955
11122	909	114	287	85739	0	87049
11123	567	150	86196	2865	0	89778
11124	285	86266	2018	1481	0	90050
11125	402	1859	782	90558	0	93601
11126	89622	582	560	2703	0	93467
11127	2183	348	350	91084	0	93965
11128	860	224	90231	2808	0	94123
11129	739	375	2024	90438	0	93576
11130	375	90405	732	2938	0	94450
11131	476	2013	460	92961	0	95910
11132	333	802	90669	2948	0	94752
11133	245	94439	2124	1508	0	98316
11134	458	2603	764	97337	0	101162
11135	459	916	541	105588	0	107504
11136	409	577	343	107569	0	108898
11137	417	330	292	108788	0	109827
11138	248	336	103969	4534	0	109087
11139	185	104238	2694	2244	0	109361
11140	104918	2650	1054	1682	0	110304
11141	107490	1007	709	1221	0	110427
11142	3594	689	459	106005	0	110747
11143	1375	428	104357	3488	0	109648
11144	103074	298	2866	1796	0	108034
11145	3120	284	1092	106823	0	111319
11146	1149	272	108336	3655	0	113412
11147	953	210	2971	109595	0	113729
11148	702	234	1094	111006	0	113036
11149	621	189	730	112658	0	114198
11150	522	261	110610	4750	0	116143
11151	823	284	2893	107372	0	111372
11152	561	110621	1214	3763	0	116159
11153	111647	2754	781	2111	0	117293
11154	113607	1041	595	1584	0	116827
11155	113788	667	494	1435	0	116384
11156	4221	110751	511	1212	0	116695
11157	111782	2866	436	1371	0	116455
11158	3738	1044	484	109925	0	115191
11159	109625	658	511	3947	0	114741
11160	110820	517	479	2114	0	113930
11161	4051	487	106122	1601	0	112261
11162	1783	105713	2959	1322	0	111777
11163	106969	2839	1126	1269	0	112203
11164	3476	1236	821	106663	0	112196
11165	1575	835	105364	3471	0	111245
11166	1177	105410	2892	1755	0	111234
11167	104557	3015	1255	1522	0	110349
11168	3531	1199	697	105262	0	110689
11169	1804	762	494	107382	0	110442
11170	1308	642	428	107576	0	109954
11171	1069	103361	471	4658	0	109559
11172	1008	2846	434	105753	0	110041
11173	762	102790	573	4216	0	108341
11174	819	3158	573	105193	0	109743
11175	818	1375	103023	4079	0	109295
11176	814	921	2914	104861	0	109510
11177	783	638	1308	106961	0	109690
11178	802	492	914	108599	0	110807
11179	676	547	103499	5129	0	109851
11180	740	496	2994	104827	0	109057
11181	825	481	1276	108133	0	110715
11182	686	494	888	109428	0	111496
11183	715	518	713	108958	0	110904
11184	771	491	615	109823	0	111700
11185	695	541	104303	5450	0	110989
11186	814	504	2822	106036	0	110176
11187	847	465	1261	106539	0	109112
11188	100687	392	900	5275	0	107254
11189	3137	98222	800	2892	0	105051
11190	1541	102240	624	2271	0	106676
11191	1336	3360	606	102682	0	107984
11192	1036	1409	573	102784	0	105802
11193	767	97008	651	4647	0	103073
11194	908	2804	510	99381	0	103603
11195	692	97380	532	4535	0	103139
11196	1022	3039	518	98440	0	103019
11197	938	1401	530	98385	0	101254
11198	664	939	92739	4393	0	98735
11199	608	90059	2484	2644	0	95795
11200	637	87580	899	1815	0	90931
11201	76636	2273	1005	1296	0	81210
11202	1639	77258	476	863	0	80236
11203	957	1832	351	76051	0	79191
11204	686	811	73692	2044	0	77233
11205	689	817	1372	73273	0	76151
11206	72601	472	611	2393	0	76077
11207	1659	463	73031	1206	0	76359
11208	671	74437	1453	1104	0	77665
11209	1092	1590	722	67554	0	70958
11210	526	611	491	77771	0	79399
11211	77312	465	428	2641	0	80846
11212	1555	420	335	78385	0	80695
11213	708	365	353	79141	0	80567
11214	551	433	219	79277	0	80480
11215	457	365	249	78785	0	79856
11216	76056	337	277	2891	0	79561
11217	75978	321	244	1754	0	78297
11218	1853	304	246	76437	0	78840
11219	74558	280	292	2314	0	77444
11220	1797	336	262	73597	0	75992
11221	726	324	70949	2295	0	74294
11222	653	338	68514	1350	0	70855
11223	637	929	1520	65828	0	68914
11224	375	65663	638	2006	0	68682
11225	497	1310	404	65707	0	67918
11226	64455	493	288	2076	0	67312
11227	1198	429	230	65586	0	67443
11228	64421	302	228	2147	0	67098
11229	1398	382	192	65355	0	67327
11230	717	346	64786	1873	0	67722
11231	448	63150	1064	1195	0	65857
11232	361	65206	475	1015	0	67057
11233	528	1959	371	58908	0	61766
11234	254	371	59078	1364	0	61067
11235	77	51688	457	368	0	52590
11236	348	598	244	50260	0	51450
11237	49305	127	171	552	0	50155
11238	266	118	49616	187	0	50187
11239	121	65	255	50077	0	50518
11240	99	95	77	51615	0	51886
11241	65	63	51096	438	0	51662
11242	118	90	47873	228	0	48309
11243	56	183	50910	183	0	51332
11244	108	205	365	51519	0	52197
11245	50	59	52306	400	0	52815
11246	48736	38	364	264	0	49402
11247	446	54	125	53280	0	53905
11248	170	52	60540	499	0	61261
11249	90	61540	514	266	0	62410
11250	76	476	61181	140	0	61873
11251	176	269	638	61056	0	62139
11252	62709	125	313	856	0	64003
11253	669	44	107	64371	0	65191
11254	261	45	49	65374	0	65729
11255	69039	32	64	1010	0	70145
11256	982	50	35	70564	0	71631
11257	292	70	71584	1097	0	73043
11258	70930	27	1004	498	0	72459
11259	1079	72916	313	243	0	74551
11260	74611	1004	153	252	0	76020
11261	1269	284	79	74651	0	76283
11262	359	163	73853	1100	0	75475
11263	272	152	73758	384	0	74566
11264	271	258	1392	74655	0	76576
11265	206	84	458	74897	0	75645
11266	136	81	74616	1359	0	76192
11267	181	111	71342	470	0	72104
11268	73745	45	1377	389	0	75556
11269	1262	54	484	75133	0	76933
11270	75805	30	277	1331	0	77443
11271	1374	53	182	75183	0	76792
11272	463	89	77766	1314	0	79632
11273	304	131	79904	470	0	80809
11274	311	92	1533	81992	0	83928
11275	280	40	536	83804	0	84660
11276	145	77	84576	1706	0	86504
11277	83658	21	1583	779	0	86041
11278	1736	34	466	87847	0	90083
11279	90962	20	336	1919	0	93237
11280	1959	100711	306	640	0	103616
11281	727	2299	207	104286	0	107519
11282	105231	577	166	2870	0	108844
11283	2754	299	104977	872	0	108902
11284	1073	146	2572	106275	0	110066
11285	700	109	807	107379	0	108995
11286	591	100	434	110380	0	111505
11287	284	143	106716	3664	0	110807
11288	472	85	2699	105925	0	109181
11289	256	106446	930	3179	0	110811
11290	483	2426	496	109054	0	112459
11291	296	651	107563	3195	0	111705
11292	298	375	108641	1227	0	110541
11293	474	256	3411	108818	0	112959
11294	483	199	1109	111221	0	113012
11295	446	141	618	112946	0	114151
11296	503	112	489	113462	0	114566
11297	110035	89	427	4269	0	114820
11298	110948	89	367	1785	0	113189
11299	3541	121	108121	1050	0	112833
11300	1125	109171	2841	894	0	114031
11301	827	2561	908	113123	0	117419
11302	115228	723	554	3628	0	120133
11303	104935	508	684	2119	0	108246
11304	117921	235	451	1130	0	119737
11305	118823	174	461	997	0	120455
11306	3957	211	114631	779	0	119578
11307	111956	163	2908	1049	0	116076
11308	3375	110784	1064	870	0	116093
11309	1505	2614	618	113739	0	118476
11310	907	789	113722	3334	0	118752
11311	952	448	3038	112715	0	117153
11312	643	365	112922	3690	0	117620
11313	816	264	3280	113598	0	117958
11314	698	261	1235	117243	0	119437
11315	114573	177	737	4542	0	120029
11316	3435	218	615	115906	0	120174
11317	1251	281	115113	4031	0	120676
11318	1022	209	3135	118366	0	122732
11319	117916	205	1268	4260	0	123649
11320	3512	227	866	119605	0	124210
11321	1352	251	118020	4022	0	123645
11322	828	116111	3310	2007	0	122256
11323	120649	2824	1303	1772	0	126548
11324	3464	808	891	117365	0	122528
11325	1364	121587	791	3525	0	127267
11326	122139	3001	716	1918	0	127774
11327	3575	1018	120491	1368	0	126452
11328	1458	119447	3230	1249	0	125384
11329	1127	3000	1330	122723	0	128180
11330	897	980	121101	3760	0	126738
11331	920	585	3388	119226	0	124119
11332	119803	392	1317	4424	0	125936
11333	3494	406	117735	2011	0	123646
11334	1597	349	3280	118788	0	124014
11335	1164	396	118961	3993	0	124514
11336	1198	395	3478	119186	0	124257
11337	1039	378	1411	122743	0	125571
11338	118657	343	969	4880	0	124849
11339	3425	118149	889	2223	0	124686
11340	1524	2805	784	121159	0	126272
11341	119558	890	801	4410	0	125659
11342	121299	572	833	2208	0	124912
11343	4196	637	735	118471	0	124039
11344	1635	114044	819	4022	0	120520
11345	1087	119017	756	2036	0	122896
11346	1195	3406	843	117496	0	122940
11347	1003	1161	791	118106	0	121061
11348	108394	631	683	4416	0	114124
11349	3142	453	615	108229	0	112439
11350	1195	471	103854	3851	0	109371
11351	99467	315	2648	2217	0	104647
11352	2952	101064	1053	1501	0	106570
11353	101604	2426	752	1337	0	106119
11354	3219	789	102226	1233	0	107467
11355	1266	102736	2464	992	0	107458
11356	101714	2579	1352	1167	0	106812
11357	103203	856	839	1028	0	105926
11358	3199	537	101375	683	0	105794
11359	100324	582	2459	841	0	104206
11360	102919	330	954	882	0	105085
11361	3239	101257	623	693	0	105812
11362	1507	2309	471	104394	0	108681
11363	1105	828	102101	2721	0	106755
11364	1001	550	2531	104792	0	108874
11365	676	467	105848	3196	0	110187
11366	773	421	2817	105624	0	109635
11367	106835	377	1062	3463	0	111737
11368	3060	278	658	109904	0	113900
11369	1199	331	116513	3424	0	121467
11370	119174	266	3283	1729	0	124452
11371	4187	212	1251	123399	0	129049
11372	1484	276	119924	4038	0	125722
11373	116349	217	3651	1819	0	122036
11374	4310	514	1295	118304	0	124423
11375	1605	360	115588	4014	0	121567
11376	1091	362	113455	1595	0	116503
11377	1285	1568	3976	111247	0	118076
11378	776	299	113988	3549	0	118612
11379	630	108690	3584	1606	0	114510
11380	873	2499	1171	98411	0	102954
11381	98175	590	797	2559	0	102121
11382	2252	425	98199	886	0	101762
11383	872	224	97611	748	0	99455
11384	94672	110	2835	692	0	98309
11385	2420	116	98672	393	0	101601
11386	95011	72	2781	592	0	98456
11387	2615	111	97362	391	0	100479
11388	1239	111	2723	96054	0	100127
11389	722	140	98660	2255	0	101777
11390	757	204	2691	97520	0	101172
11391	442	196	100532	2604	0	103774
11392	426	187	97601	1109	0	99323
11393	94053	110	3003	1037	0	98203
11394	2077	98271	1522	580	0	102450
11395	100324	1868	1127	662	0	103981
11396	2520	100367	822	392	0	104101
11397	1269	2192	761	101497	0	105719
11398	1125	725	734	104394	0	106978
11399	103520	482	761	2844	0	107607
11400	2529	263	752	102307	0	105851
11401	1143	214	101198	2672	0	105227
11402	97600	141	2485	1383	0	101609
11403	100633	138	1267	1028	0	103066
11404	3024	161	1106	99569	0	103860
11405	1388	237	100157	2451	0	104233
11406	1136	287	2503	99216	0	103142
11407	675	99764	1223	2659	0	104321
11408	721	2059	920	102026	0	105726
11409	779	755	684	104502	0	106720
11410	715	572	100470	3181	0	104938
11411	93250	409	2388	1815	0	97862
11412	2453	99184	1092	1219	0	103948
11413	99931	2077	893	1094	0	103995
11414	2753	100618	724	858	0	104953
11415	1452	2373	591	100033	0	104449
11416	974	100914	694	2607	0	105189
11417	813	2404	99389	1331	0	103937
11418	888	1772	2510	95365	0	100535
11419	834	691	1116	98483	0	101124
11420	734	396	989	101686	0	103805
11421	98395	307	807	3772	0	103281
11422	2626	358	823	99355	0	103162
11423	96764	427	751	3388	0	101330
11424	98407	516	596	1788	0	101307
11425	96972	477	740	1587	0	99776
11426	3618	507	94593	1186	0	99904
11427	1929	439	2558	96158	0	101084
11428	1471	439	1346	100577	0	103833
11429	1153	437	1264	102545	0	105399
11430	103812	416	951	4390	0	109569
11431	3347	409	945	104829	0	109530
11432	1648	421	970	108606	0	111645
11433	110137	398	991	4715	0	116241
11434	3923	335	1043	113319	0	118620
11435	1872	404	113409	4594	0	120279
11436	1560	467	114816	2289	0	119132
11437	1509	321	4454	116332	0	122616
11438	115231	314	2118	4795	0	122458
11439	114705	253	1645	2395	0	118998
11440	5226	249	1178	113531	0	120184
11441	2515	309	112045	4435	0	119304
11442	1890	109855	4070	2145	0	117960
11443	1546	3161	1823	114000	0	120530
11444	1355	1008	1452	116861	0	120676
11445	1435	743	1184	117265	0	120627
11446	113671	455	1151	6105	0	121382
11447	4214	410	112988	3010	0	120622
11448	113665	446	4005	2512	0	120628
11449	4968	3754	1617	109359	0	119698
11450	2271	112651	1369	4444	0	120735
11451	114985	3410	1076	2524	0	121995
11452	115375	1198	976	2313	0	119862
11453	5284	997	116087	1649	0	124017
11454	2630	107884	3828	1835	0	116177
11455	1869	111388	1498	1638	0	116393
11456	110374	3872	1321	1817	0	117384
11457	4525	1390	894	110483	0	117292
11458	2253	1064	784	111443	0	115544
11459	1954	701	805	111188	0	114648
11460	1353	102775	685	5715	0	110528
11461	1180	108793	631	2839	0	113443
11462	106046	4073	569	2358	0	113046
11463	4426	1535	544	105915	0	112420
11464	1674	1056	109072	4255	0	116057
11465	1708	840	3774	113348	0	119670
11466	1148	819	120607	5316	0	127890
11467	1300	768	121440	2335	0	125843
11468	1307	786	122259	1884	0	126236
11469	600	107691	5420	933	0	114644
11470	1401	3917	3535	101820	0	110673
11471	539	104362	1821	3412	0	110134
11472	1197	4060	1180	97885	0	104322
11473	663	1655	759	106663	0	109740
11474	103976	1255	529	5294	0	111054
11475	3668	763	427	106056	0	110914
11476	103492	520	378	5288	0	109678
11477	105985	389	344	2702	0	109420
11478	5197	359	362	101409	0	107327
11479	2601	99301	414	4313	0	106629
11480	2045	3250	390	99908	0	105593
11481	1201	99917	450	4545	0	106113
11482	1162	3992	375	100456	0	105985
11483	746	1825	98244	4951	0	105766
11484	814	1379	3318	100336	0	105847
11485	767	834	1392	103955	0	106948
11486	97286	614	1114	6002	0	105016
11487	3504	97780	823	3212	0	105319
11488	1843	3467	613	99905	0	105828
11489	1629	1466	441	99801	0	103337
11490	1062	95809	642	5466	0	102979
11491	1072	3765	435	98048	0	103320
11492	90194	1777	383	5795	0	98149
11493	96176	1385	389	3117	0	101067
11494	4760	92618	386	2448	0	100212
11495	2671	3726	358	94031	0	100786
11496	90938	1602	439	4836	0	97815
11497	4263	92274	493	2514	0	99544
11498	2306	3960	506	89275	0	96047
11499	1638	90919	592	4435	0	97584
11500	91056	4402	543	2548	0	98549
11501	4239	2117	88318	2053	0	96727
11502	2059	1691	89207	1673	0	94630
11503	1851	1271	4607	89155	0	96884
11504	1187	1029	90248	4514	0	96978
11505	1166	803	4908	89063	0	95940
11506	87914	732	2460	5294	0	96400
11507	3996	774	89251	2960	0	96981
11508	2173	833	4041	90291	0	97338
11509	1811	783	1926	93366	0	97886
11510	89737	815	1466	6059	0	98077
11511	4097	90339	1018	3571	0	99025
11512	91577	3609	693	3121	0	99000
11513	93177	1761	575	2377	0	97890
11514	5629	87937	664	1823	0	96053
11515	3417	3807	628	89850	0	97702
11516	2495	2055	87239	4268	0	96057
11517	1810	1757	3482	88065	0	95114
11518	1280	87590	1592	4966	0	95428
11519	89433	4085	1274	2942	0	97734
11520	4058	2012	1025	91009	0	98104
11521	1881	1712	90381	5100	0	99074
11522	1632	1276	3632	93322	0	99862
11523	1342	1141	1690	96332	0	100505
11524	1302	1073	1324	97555	0	101254
11525	1228	927	927	98357	0	101439
11526	1165	884	772	96234	0	99055
11527	1069	820	89204	7574	0	98667
11528	1380	856	86972	4497	0	93705
11529	822	81737	4204	3396	0	90159
11530	765	85136	2196	2338	0	90435
11531	83029	3704	1822	1898	0	90453
11532	3552	1988	82533	1535	0	89608
11533	77101	1624	3513	1364	0	83602
11534	3553	1161	74922	1152	0	80788
11535	1845	856	72053	993	0	75747
11536	1402	684	3479	70277	0	75842
11537	73048	532	2230	2945	0	78755
11538	2688	472	1466	74538	0	79164
11539	1551	493	1020	75857	0	78921
11540	1197	373	79378	4172	0	85120
11541	978	392	2444	81958	0	85772
11542	874	306	1323	82603	0	85106
11543	764	327	1005	84066	0	86162
11544	795	415	743	83832	0	85785
11545	786	315	567	84210	0	85878
11546	79904	330	464	5083	0	85781
11547	2502	325	366	81960	0	85153
11548	1345	414	77170	4300	0	83229
11549	1310	547	1982	79533	0	83372
11550	979	486	77384	3722	0	82571
11551	985	661	2652	78608	0	82906
11552	625	392	79770	3783	0	84570
11553	495	614	2959	76901	0	80969
11554	385	347	1651	81136	0	83519
11555	361	334	77543	3955	0	82193
11556	73372	334	2388	2780	0	78874
11557	2114	409	78600	2064	0	83187
11558	1428	468	2582	79915	0	84393
11559	80947	220	1612	3106	0	85885
11560	2501	272	1223	82138	0	86134
11561	1689	481	795	83171	0	86136
11562	1271	315	80992	3804	0	86382
11563	892	77993	1933	2908	0	83726
11564	529	72660	942	1845	0	75976
11565	341	71262	741	1297	0	73641
11566	1281	640	924	60673	0	63518
11567	61670	148	289	578	0	62685
11568	379	101	38	61563	0	62081
11569	174	52	43	62129	0	62398
11570	124	34	52	62947	0	63157
11571	93	24	54	62794	0	62965
11572	46	61869	67	568	0	62550
11573	71	344	44	64321	0	64780
11574	75	117	37	64352	0	64581
11575	38	63399	61	558	0	64056
11576	65175	354	48	376	0	65953
11577	367	126	36	65576	0	66105
11578	65642	72	49	615	0	66378
11579	65229	59	46	378	0	65712
11580	476	65861	74	164	0	66575
11581	236	381	39	70508	0	71164
11582	149	151	69346	456	0	70102
11583	154	135	67024	234	0	67547
11584	152	298	415	69124	0	69989
11585	70804	43	253	605	0	71705
11586	72111	26	101	389	0	72627
11587	463	39	81	73228	0	73811
11588	73703	26	55	686	0	74470
11589	454	72406	86	244	0	73190
11590	73599	353	62	317	0	74331
11591	448	76878	104	173	0	77603
11592	251	435	79	79901	0	80666
11593	239	186	51	80139	0	80615
11594	124	79418	77	512	0	80131
11595	80033	407	179	428	0	81047
11596	441	223	78087	212	0	78963
11597	304	134	385	79294	0	80117
11598	168	130	80159	494	0	80951
11599	268	82	436	79936	0	80722
11600	81898	55	192	693	0	82838
11601	504	52	117	81982	0	82655
11602	81488	62	92	748	0	82390
11603	80925	54	77	508	0	81564
11604	619	47	71	81285	0	82022
11605	283	101	79714	557	0	80655
11606	221	83626	420	360	0	84627
11607	215	373	152	85258	0	85998
11608	84297	134	104	844	0	85379
11609	523	195	82900	290	0	83908
11610	359	102	413	84130	0	85004
11611	294	90	141	84327	0	84852
11612	208	68	139	86168	0	86583
11613	85848	87	99	932	0	86966
11614	529	75	123	84351	0	85078
11615	241	84	103	86397	0	86825
11616	208	112	85718	689	0	86727
11617	285	56	476	86119	0	86936
11618	227	70	208	88121	0	88626
11619	222	59	144	89735	0	90160
11620	153	87588	179	858	0	88778
11621	219	407	106	87722	0	88454
11622	233	192	82	87803	0	88310
11623	85507	92	80	1026	0	86705
11624	620	145	82975	404	0	84144
11625	355	178	78002	334	0	78869
11626	181	83281	577	338	0	84377
11627	283	439	245	86984	0	87951
11628	86489	175	230	850	0	87744
11629	621	110	126	85006	0	85863
11630	292	82	94	86523	0	86991
11631	193	59	95	87526	0	87873
11632	219	46	84	86014	0	86363
11633	192	52	79	85972	0	86295
11634	133	89	84674	881	0	85777
11635	207	58	438	84915	0	85618
11636	85301	45	165	1032	0	86543
11637	480	82742	153	478	0	83853
11638	252	416	103	85205	0	85976
11639	193	158	81	85350	0	85782
11640	168	153	80680	802	0	81803
11641	266	98	505	79610	0	80479
11642	160	88	193	84488	0	84929
11643	85530	57	134	1225	0	86946
11644	647	86962	136	554	0	88299
11645	366	706	86	89210	0	90368
11646	273	255	98	90531	0	91157
11647	260	231	96	90736	0	91323
11648	166	155	90435	1308	0	92064
11649	214	179	85006	746	0	86145
11650	139	88128	1137	553	0	89957
11651	111	91335	452	453	0	92351
11652	204	1030	269	91376	0	92879
11653	212	84587	354	1174	0	86327
11654	257	1455	123	97019	0	98854
11655	230	529	112	105455	0	106326
11656	238	256	125	110379	0	110998
11657	283	182	100	121815	0	122380
11658	121	208	120591	3644	0	124564
11659	336	153	2104	122237	0	124830
11660	273	140	1070	124780	0	126263
11661	267	116	620	128249	0	129252
11662	122806	88	452	5079	0	128425
11663	2264	124540	564	2899	0	130267
11664	1420	2360	346	122059	0	126185
11665	684	126175	524	3667	0	131050
11666	123084	3030	280	3021	0	129415
11667	112396	1775	233	2932	0	117336
11668	3214	124382	212	1885	0	129693
11669	1932	129588	223	1491	0	133234
11670	1216	4542	124914	1167	0	131839
11671	944	129952	2547	1279	0	134722
11672	1161	4146	1328	127343	0	133978
11673	128673	2388	820	3694	0	135575
11674	3143	130870	555	2129	0	136697
11675	1831	3995	631	133055	0	139512
11676	1296	2670	454	135311	0	139731
11677	1063	1675	578	138135	0	141451
11678	134191	1374	373	5689	0	141627
11679	3452	1396	132265	3375	0	140488
11680	129219	1056	2785	2764	0	135824
11681	3878	131291	1459	1990	0	138618
11682	2203	3724	851	133515	0	140293
11683	1608	2053	130701	4314	0	138676
11684	126454	1457	3350	2912	0	134173
11685	4094	130945	1686	1764	0	138489
11686	2459	3833	1225	129726	0	137243
11687	1629	131592	902	3978	0	138101
11688	1352	4233	821	133813	0	140219
11689	1300	2295	652	136812	0	141059
11690	993	1705	131401	5465	0	139564
11691	1158	1349	126438	3371	0	132316
11692	1108	1465	4175	129277	0	136025
11693	702	1107	130297	5079	0	137185
11694	842	1036	4015	131250	0	137143
11695	1022	814	2439	128697	0	132972
11696	818	649	1801	135737	0	139005
11697	130384	623	1531	6675	0	139213
11698	3445	698	1488	133599	0	139230
11699	1802	731	130681	6008	0	139222
11700	131131	627	3643	4284	0	139685
11701	3749	647	2077	135657	0	142130
11702	2333	649	1442	138103	0	142527
11703	133645	606	1179	6792	0	142222
11704	3944	135002	1318	4117	0	144381
11705	2527	3240	1062	139769	0	146598
11706	1652	1726	1080	138444	0	142902
11707	133590	1173	997	6802	0	142562
11708	4048	991	132124	4575	0	141738
11709	2407	1012	3350	134271	0	141040
11710	1942	821	1991	136514	0	141268
11711	1584	981	1347	135143	0	139055
11712	1325	130602	1151	7101	0	140179
11713	1258	3207	1176	136027	0	141668
11714	131331	1763	881	6628	0	140603
11715	3676	130705	1025	4638	0	140044
11716	129103	3562	870	4088	0	137623
11717	4188	131136	742	3359	0	139425
11718	131854	4161	702	3457	0	140174
11719	4734	2628	128162	2717	0	138241
11720	2912	2037	126749	2728	0	134426
11721	128986	1427	4288	2597	0	137298
11722	4495	1671	131000	2290	0	139456
11723	3226	1308	4028	130609	0	139171
11724	2776	1366	2705	120245	0	127092
11725	1999	1004	1994	135272	0	140269
11726	131163	936	1711	6554	0	140364
11727	4211	917	128199	4102	0	137429
11728	129027	913	3839	3408	0	137187
11729	4724	1000	2348	135072	0	143144
11730	134641	902	1602	6050	0	143195
11731	5423	913	1257	136992	0	144585
11732	139935	925	1392	6079	0	148331
11733	6073	881	1227	148732	0	156913
11734	3499	901	150387	6332	0	161119
11735	153269	842	4445	4224	0	162780
11736	160123	699	2454	3611	0	166887
11737	7691	720	1741	157964	0	168116
11738	4556	815	1452	157451	0	164274
11739	3132	155902	1591	7286	0	167911
11740	154290	4066	1453	4878	0	164687
11741	5867	155670	1430	3465	0	166432
11742	153069	4712	1181	3261	0	162223
11743	6452	2311	151078	2877	0	162718
11744	3761	1657	150763	2735	0	158916
11745	2970	1180	147663	2572	0	154385
11746	147898	1315	6346	2320	0	157879
11747	5970	149287	3288	2003	0	160548
11748	3869	4211	2260	148754	0	159094
11749	147784	2126	1793	5402	0	157105
11750	5435	148693	1800	3346	0	159274
11751	3681	6349	1558	143668	0	155256
11752	2569	143167	1456	5168	0	152360
11753	2339	140422	1194	3345	0	147300
11754	2144	142466	969	2298	0	147877
11755	129004	5363	1461	2448	0	138276
11756	4094	127854	757	1673	0	134378
11757	1611	114265	649	1011	0	117536
11758	1201	115084	555	879	0	117719
11759	112683	3261	995	965	0	117904
11760	113834	1247	613	890	0	116584
11761	3493	912	108809	659	0	113873
11762	107519	492	2375	773	0	111159
11763	111343	426	928	721	0	113418
11764	3525	480	595	108574	0	113174
11765	110414	428	448	2734	0	114024
11766	3097	523	107081	1103	0	111804
11767	1371	112619	2270	775	0	117035
11768	114090	2570	1035	805	0	118500
11769	3186	1227	558	116182	0	121153
11770	116673	694	352	2874	0	120593
11771	3198	611	110548	1173	0	115530
11772	113471	483	2222	835	0	117011
11773	3352	598	880	114641	0	119471
11774	1448	517	113205	2602	0	117772
11775	868	107719	2434	1127	0	112148
11776	670	113737	953	700	0	116060
11777	1008	3299	761	110067	0	115135
11778	874	1250	424	109137	0	111685
11779	496	110438	244	2671	0	113849
11780	110976	2411	218	1234	0	114839
11781	111000	967	220	747	0	112934
11782	110867	560	234	611	0	112272
11783	3403	109849	219	426	0	113897
11784	1694	2375	212	105832	0	110113
11785	879	110432	241	2109	0	113661
11786	110497	2534	224	1051	0	114306
11787	110052	1043	191	746	0	112032
11788	3247	107380	206	433	0	111266
11789	109853	2408	171	574	0	113006
11790	3101	1042	206	108763	0	113112
11791	1526	596	267	110614	0	113003
11792	110483	455	336	3341	0	114615
11793	108439	401	348	1448	0	110636
11794	110213	359	302	877	0	111751
11795	3807	405	274	107640	0	112126
11796	1791	421	243	110534	0	112989
11797	1032	577	106999	3312	0	111920
11798	1078	530	2232	107241	0	111081
11799	973	687	829	107527	0	110016
11800	895	587	103618	3269	0	108369
11801	841	604	100290	1405	0	103140
11802	740	583	104854	798	0	106975
11803	824	500	3339	103345	0	108008
11804	789	578	102177	2601	0	106145
11805	918	672	2654	101471	0	105715
11806	1002	637	1032	104157	0	106828
11807	898	634	101990	3468	0	106990
11808	821	744	102111	1509	0	105185
11809	952	670	3024	100927	0	105573
11810	748	707	106054	2934	0	110443
11811	877	752	104784	1339	0	107752
11812	872	104636	3174	966	0	109648
11813	107870	2729	1312	839	0	112750
11814	109140	1317	734	805	0	111996
11815	109730	937	532	856	0	112055
11816	3667	105021	495	811	0	109994
11817	1854	108047	490	719	0	111110
11818	1426	3104	493	108326	0	113349
11819	1312	1302	508	108982	0	112104
11820	1109	795	105890	3432	0	111226
11821	1254	554	2612	106539	0	110959
11822	106982	505	1139	3482	0	112108
11823	3215	440	785	103001	0	107441
11824	1527	105236	756	3027	0	110546
11825	108880	2591	625	1645	0	113741
11826	110957	1185	579	1184	0	113905
11827	112365	693	584	1151	0	114793
11828	4189	587	107570	969	0	113315
11829	2042	1265	2376	108990	0	114673
11830	114696	420	1307	3642	0	120065
11831	3672	484	117663	1548	0	123367
11832	1610	111476	3193	1198	0	117477
11833	1009	108713	1190	803	0	111715
11834	100411	2859	1220	711	0	105201
11835	2579	100022	560	595	0	103756
11836	1193	2497	455	97723	0	101868
11837	632	855	98114	2492	0	102093
11838	793	709	2309	97696	0	101507
11839	97195	367	867	2783	0	101212
11840	2385	95853	510	1029	0	99777
11841	96500	2196	456	698	0	99850
11842	2571	743	94771	596	0	98681
11843	1113	773	2257	92083	0	96226
11844	593	95984	820	2222	0	99619
11845	789	2286	552	98309	0	101936
11846	98194	690	420	2802	0	102106
11847	99897	398	413	1112	0	101820
11848	99998	312	354	771	0	101435
11849	100935	298	386	652	0	102271
11850	3144	277	377	96892	0	100690
11851	1184	380	98075	2380	0	102019
11852	986	428	2163	95822	0	99399
11853	669	97603	765	2293	0	101330
11854	99760	2056	460	1089	0	103365
11855	2454	746	98098	638	0	101936
11856	96334	391	2205	715	0	99645
11857	2476	350	780	98087	0	101693
11858	963	321	100281	2425	0	103990
11859	828	228	2186	100420	0	103662
11860	101931	223	807	2777	0	105738
11861	102923	251	530	1206	0	104910
11862	103172	244	479	826	0	104721
11863	2937	349	100161	574	0	104021
11864	1408	640	2078	100268	0	104394
11865	803	340	102303	2258	0	105704
11866	755	101314	2183	932	0	105184
11867	97218	2039	1029	748	0	101034
11868	2070	94612	573	513	0	97768
11869	92489	1665	455	486	0	95095
11870	2035	545	256	90266	0	93102
11871	615	91001	322	1557	0	93495
11872	92857	1571	263	760	0	95451
11873	1870	514	92261	384	0	95029
11874	776	384	1529	92280	0	94969
11875	93771	214	475	1845	0	96305
11876	1896	245	92549	552	0	95242
11877	887	273	1521	90608	0	93289
11878	654	87940	630	1607	0	90831
11879	587	1651	375	94280	0	96893
11880	580	599	262	95261	0	96702
11881	93383	418	196	2137	0	96134
11882	1868	92269	238	734	0	95109
11883	827	1689	215	91519	0	94250
11884	507	92469	306	1735	0	95017
11885	599	1731	317	93286	0	95933
11886	490	94357	365	1739	0	96951
11887	94816	1791	269	802	0	97678
11888	2022	644	95295	446	0	98407
11889	931	452	1669	95114	0	98166
11890	673	281	568	96383	0	97905
11891	578	302	360	97294	0	98534
11892	647	305	290	95752	0	96994
11893	628	295	93922	2322	0	97167
11894	646	95523	1661	882	0	98712
11895	96467	1654	507	824	0	99452
11896	98096	522	348	730	0	99696
11897	2058	96239	344	541	0	99182
11898	98173	1739	301	688	0	100901
11899	98399	592	308	678	0	99977
11900	2142	98871	275	539	0	101827
11901	1065	1751	229	98406	0	101451
11902	689	100172	335	1578	0	102774
11903	100501	1804	292	857	0	103454
11904	2007	635	98299	578	0	101519
11905	94029	386	1677	820	0	96912
11906	2041	325	99384	594	0	102344
11907	987	315	1734	99674	0	102710
11908	100656	282	538	2086	0	103562
11909	2193	285	98864	682	0	102024
11910	95268	236	1750	761	0	98015
11911	98762	263	576	766	0	100367
11912	2301	280	415	98119	0	101115
11913	868	97487	398	1785	0	100538
11914	100275	1783	252	862	0	103172
11915	2157	720	194	99572	0	102643
11916	960	96694	249	1820	0	99723
11917	99060	1682	224	909	0	101875
11918	2063	647	272	99636	0	102618
11919	785	102146	354	1850	0	105135
11920	685	1681	336	106636	0	109338
11921	107256	549	344	2316	0	110465
11922	107219	363	286	1098	0	108966
11923	108127	322	302	774	0	109525
11924	2434	241	317	105328	0	108320
11925	965	316	302	105991	0	107574
11926	684	404	104694	2171	0	107953
11927	926	716	1648	104328	0	107618
11928	627	338	107777	2061	0	110803
11929	577	297	99625	736	0	101235
11930	257	175	95417	238	0	96087
11931	134	99085	1159	224	0	100602
11932	534	1162	923	96199	0	98818
11933	163	105326	270	786	0	106545
11934	108660	1309	196	634	0	110799
11935	109844	374	116	431	0	110765
11936	1802	164	79	112829	0	114874
11937	551	166	116282	1559	0	118558
11938	504	102	1751	116315	0	118672
11939	250	185	119960	1986	0	122381
11940	472	141	1865	117556	0	120034
11941	166	118210	622	1968	0	120966
11942	156	123622	287	632	0	124697
11943	121908	2176	202	590	0	124876
11944	2013	713	121449	269	0	124444
11945	897	343	1886	120768	0	123894
11946	595	217	501	123752	0	125065
11947	123608	159	273	2764	0	126804
11948	2030	123416	281	888	0	126615
11949	124358	1963	195	803	0	127319
11950	2094	125621	267	422	0	128404
11951	124410	2087	219	597	0	127313
11952	126997	643	231	657	0	128528
11953	2769	385	208	126334	0	129696
11954	862	332	125838	2138	0	129170
11955	122475	244	2068	1010	0	125797
11956	2194	126789	642	484	0	130109
11957	128462	2060	331	694	0	131547
11958	2574	657	257	124460	0	127948
11959	1033	411	187	124647	0	126278
11960	553	123194	232	2572	0	126551
11961	685	2126	162	122850	0	125823
11962	447	124559	218	2283	0	127507
11963	679	2187	170	124287	0	127323
11964	630	743	153	123846	0	125372
11965	120289	396	200	2915	0	123800
11966	2319	370	119845	916	0	123450
11967	814	118634	1914	684	0	122046
11968	831	2048	590	121161	0	124630
11969	121686	630	363	2613	0	125292
11970	124069	415	271	1235	0	125990
11971	123062	364	256	996	0	124678
11972	2910	377	120514	570	0	124371
11973	121854	333	2125	691	0	125003
11974	2792	383	676	123667	0	127518
11975	122629	327	374	2795	0	126125
11976	2600	120473	382	1021	0	124476
11977	1211	2288	289	122891	0	126679
11978	121549	754	294	2901	0	125498
11979	2641	123371	307	1045	0	127364
11980	1197	2504	249	125396	0	129346
11981	876	926	121509	2743	0	126054
11982	126238	604	2128	1294	0	130264
11983	132879	448	774	1044	0	135145
11984	3792	456	130439	621	0	135308
11985	1478	125749	2743	694	0	130664
11986	1049	130920	905	826	0	133700
11987	1123	3209	660	131050	0	136042
11988	1229	1144	513	125117	0	128003
11989	956	736	366	131635	0	133693
11990	691	634	131007	3921	0	136253
11991	130293	572	2839	1963	0	135667
11992	138055	531	949	1410	0	140945
11993	140566	488	591	1262	0	142907
11994	140653	551	489	1089	0	142782
11995	141509	506	472	1118	0	143605
11996	143678	516	471	1047	0	145712
11997	5068	512	474	146449	0	152503
11998	2064	584	143482	4083	0	150213
11999	1458	656	147005	1566	0	150685
12000	1387	670	4151	147122	0	153330
12001	1522	582	1345	147368	0	150817
12002	1388	556	764	148981	0	151689
12003	1160	148244	592	5073	0	155069
12004	150343	3923	552	2286	0	157104
12005	4622	153783	578	1421	0	160404
12006	2210	4264	500	152991	0	159965
12007	151082	1391	476	4948	0	157897
12008	4661	151397	472	1945	0	158475
12009	2255	4264	456	152745	0	159720
12010	1817	1517	410	156450	0	160194
12011	1462	1069	393	156880	0	159804
12012	1097	150752	526	5955	0	158330
12013	1377	4157	465	154618	0	160617
12014	1064	1557	152329	5553	0	160503
12015	1399	1021	4074	155337	0	161831
12016	1332	857	1249	159214	0	162652
12017	1438	857	685	165790	0	168770
12018	1504	837	505	168318	0	171164
12019	1209	871	159925	7437	0	169442
12020	1050	159653	4939	3567	0	169209
12021	1455	5119	1557	162892	0	171023
12022	1436	1785	1039	169540	0	173800
12023	1421	1284	757	167521	0	170983
12024	1036	157397	838	8188	0	167459
12025	1052	168651	723	3878	0	174304
12026	164217	6390	527	3107	0	174241
12027	6124	2542	469	162276	0	171411
12028	2086	1563	158822	6572	0	169043
12029	1396	159594	4845	3234	0	169069
12030	156045	5395	1870	2758	0	166068
12031	5571	1999	153092	2035	0	162697
12032	2199	1463	152905	1915	0	158482
12033	1479	1050	151394	1679	0	155602
12034	1645	2531	6528	144283	0	154987
12035	927	965	146543	5556	0	153991
12036	754	139989	5491	2717	0	148951
12037	1090	4299	2117	136073	0	143579
12038	602	1624	137204	5086	0	144516
12039	854	1377	4753	134767	0	141751
12040	132685	913	1979	5769	0	141346
12041	4252	834	132452	2758	0	140296
12042	129648	719	4617	2461	0	137445
12043	4708	134406	1932	1696	0	142742
12044	134898	4336	1388	1703	0	142325
12045	5367	1723	1197	134508	0	142795
12046	135081	1196	1178	5167	0	142622
12047	136703	874	1113	2628	0	141318
12048	133821	869	1093	2145	0	137928
12049	5898	134092	1105	1525	0	142620
12050	134995	4241	1118	1606	0	141960
12051	137271	1565	1150	1570	0	141556
12052	6161	1174	132496	1294	0	141125
12053	2891	132417	4463	1363	0	141134
12054	2428	4560	2018	132372	0	141378
12055	1947	1809	1426	136239	0	141421
12056	1762	1375	1145	137396	0	141678
12057	1443	1037	131800	6301	0	140581
12058	1620	875	4476	133231	0	140202
12059	1383	874	132945	5942	0	141144
12060	132267	805	4889	3245	0	141206
12061	137427	791	2127	2467	0	142812
12062	5931	934	134340	1903	0	143108
12063	134762	868	4612	2086	0	142328
12064	139101	768	2110	1944	0	143923
12065	140911	743	1511	1877	0	145042
12066	7033	765	1278	135500	0	144576
12067	3561	941	135674	4968	0	145144
12068	2616	136121	4544	2592	0	145873
12069	2411	4418	1957	137114	0	145900
12070	2030	1829	137643	5194	0	146696
12071	1874	1389	132101	2670	0	138034
12072	130120	1200	5295	2394	0	139009
12073	4480	135828	2573	2112	0	144993
12074	137873	4070	1891	2255	0	146089
12075	139821	1726	1609	2116	0	145272
12076	5546	137557	1621	1816	0	146540
12077	138628	4136	1609	1756	0	146129
12078	5565	1843	139920	1483	0	148811
12079	3133	1302	137983	1387	0	143805
12080	2713	1060	138559	1293	0	143625
12081	2134	134275	5543	1213	0	143165
12082	131817	3675	3354	1210	0	140056
12083	132771	1523	2024	1242	0	137560
12084	5210	126408	1587	1154	0	134359
12085	2712	132407	1424	1226	0	137769
12086	2184	4264	1420	130866	0	138734
12087	1831	2124	1225	133448	0	138628
12088	131566	1524	1227	4740	0	139057
12089	4191	132286	1231	2213	0	139921
12090	131826	3682	1147	1781	0	138436
12091	130035	1754	1124	1502	0	134415
12092	5119	1440	126491	1121	0	134171
12093	2876	124757	3376	984	0	131993
12094	2844	3858	1848	124083	0	132633
12095	123016	1671	1264	3301	0	129252
12096	4450	1256	1155	121090	0	127951
12097	116893	862	1105	3112	0	121972
12098	3686	805	113583	1395	0	119469
12099	2146	109619	2988	1084	0	115837
12100	1731	113644	1394	985	0	117754
12101	1919	3762	1491	108117	0	115289
12102	1458	112725	1145	2196	0	117524
12103	112643	2933	978	1530	0	118084
12104	2779	1640	109423	1076	0	114918
12105	105901	1172	2250	1288	0	110611
12106	2946	978	111179	1004	0	116107
12107	1934	800	2404	110753	0	115891
12108	1773	784	1209	111790	0	115556
12109	1723	722	959	113221	0	116625
12110	112283	648	881	3054	0	116866
12111	2949	597	112182	1523	0	117251
12112	1780	679	2090	112474	0	117023
12113	1541	950	1063	112766	0	116320
12114	1378	109088	854	2752	0	114072
12115	1166	109142	669	1612	0	112589
12116	1164	111580	686	1241	0	114671
12117	1107	2209	621	106608	0	110545
12118	845	1152	505	102953	0	105455
12119	307	98513	258	1029	0	100107
12120	317	99472	249	527	0	100565
12121	99266	706	515	693	0	101180
12122	802	524	185	98914	0	100425
12123	238	97308	147	474	0	98167
12124	99527	392	256	464	0	100639
12125	635	173	125	101131	0	102064
12126	110006	80	151	841	0	111078
12127	1120	115	92	113039	0	114366
12128	351	138	114760	1047	0	116296
12129	232	115482	905	365	0	116984
12130	114137	927	303	653	0	116020
12131	1049	336	115887	122	0	117394
12132	287	115595	913	172	0	116967
12133	432	910	288	117169	0	118799
12134	227	225	127	118835	0	119414
12135	295	125	55	115422	0	115897
12136	385	65	51	112690	0	113191
12137	93	106	116403	1088	0	117690
12138	55	114707	825	405	0	115992
12139	199	770	178	116623	0	117770
12140	114436	187	125	1215	0	115963
12141	775	115492	81	324	0	116672
12142	417	836	61	121438	0	122752
12143	196	309	119297	1111	0	120913
12144	85	120082	1124	416	0	121707
12145	549	1239	338	112482	0	114608
12146	106	124300	258	786	0	125450
12147	126124	1463	76	639	0	128302
12148	127047	417	64	610	0	128138
12149	1804	309	122356	173	0	124642
12150	122274	161	1282	545	0	124262
12151	126520	90	362	492	0	127464
12152	1909	172	121444	120	0	123645
12153	659	121601	1407	177	0	123844
12154	758	1269	365	122360	0	124752
12155	445	367	238	127998	0	129048
12156	126400	248	119	2234	0	129001
12157	1740	122	92	126894	0	128848
12158	487	149	126493	1724	0	128853
12159	120743	158	1476	951	0	123328
12160	1725	182	123319	353	0	125579
12161	509	124192	1679	272	0	126652
12162	122242	1520	473	535	0	124770
12163	1738	483	122923	169	0	125313
12164	611	414	117689	178	0	118892
12165	409	121338	1697	206	0	123650
12166	425	1554	609	123688	0	126276
12167	235	559	121411	1541	0	123746
12168	798	370	1729	108931	0	111828
12169	381	141	492	120024	0	121038
12170	206	162	118022	2013	0	120403
12171	174	116681	1684	803	0	119342
12172	317	1520	495	118967	0	121299
12173	116582	441	394	1967	0	119384
12174	116224	302	219	829	0	117574
12175	2076	180	177	116340	0	118773
12176	740	215	114554	1738	0	117247
12177	488	213	117020	578	0	118299
12178	407	160	2039	116976	0	119582
12179	234	198	115998	1801	0	118231
12180	113457	156	1934	809	0	116356
12181	2003	134	590	117966	0	120693
12182	795	137	439	119717	0	121088
12183	436	118014	351	2316	0	121117
12184	433	1763	253	121079	0	123528
12185	261	585	117150	2225	0	120221
12186	112329	391	1902	1050	0	115672
12187	117497	196	576	948	0	119217
12188	2398	203	117358	406	0	120365
12189	1108	148	1956	122137	0	125349
12190	760	167	618	126411	0	127956
12191	401	212	125379	3130	0	129122
12192	588	173	2570	126111	0	129442
12193	817	186	915	124922	0	126840
12194	354	129547	687	3461	0	134049
12195	603	2809	352	134725	0	138489
12196	548	758	304	137880	0	139490
12197	137281	521	351	4574	0	142727
12198	142021	288	333	2045	0	144687
12199	145459	177	337	1393	0	147366
12200	144979	203	327	956	0	146465
12201	144360	217	284	955	0	145816
12202	4999	275	137089	645	0	143008
12203	2239	192	3373	137369	0	143173
12204	1472	195	1063	141546	0	144276
12205	783	278	137907	4497	0	143465
12206	132424	250	3570	2093	0	138337
12207	137879	238	1165	1487	0	140769
12208	4605	370	127373	831	0	133179
12209	135458	243	3156	1081	0	139938
12210	140014	192	1087	996	0	142289
12211	4929	248	135503	616	0	141296
12212	2578	349	3655	131374	0	137956
12213	1560	134735	1423	3500	0	141218
12214	1287	3508	917	143247	0	148959
12215	1266	1035	555	145579	0	148435
12216	1286	630	503	143915	0	146334
12217	795	368	139997	5446	0	146606
12218	136971	248	3882	2518	0	143619
12219	142505	227	1341	1663	0	145736
12220	5345	199	961	139256	0	145761
12221	2206	241	136574	4324	0	143345
12222	1689	426	4009	135812	0	141936
12223	919	209	138477	4799	0	144404
12224	934	263	139886	1808	0	142891
12225	730	137939	4966	1420	0	145055
12226	1496	3181	1881	129785	0	136343
12227	128414	884	1277	3925	0	134500
12228	125788	546	660	1700	0	128694
12229	128300	251	577	1355	0	130483
12230	5097	224	512	124307	0	130140
12231	1926	128493	553	3789	0	134761
12232	1536	3413	439	132332	0	137720
12233	916	1077	135762	4618	0	142373
12234	144594	661	4037	2017	0	151309
12235	157025	335	1309	1647	0	160316
12236	6313	259	929	155361	0	162862
12237	2867	264	651	159048	0	162830
12238	2178	257	586	160975	0	163996
12239	1273	290	153570	6975	0	162108
12240	143779	220	4826	3310	0	152135
12241	5328	148710	1805	2066	0	157909
12242	1799	150479	1206	1400	0	154884
12243	1497	4830	148464	1108	0	155899
12244	1589	2221	4702	144722	0	153234
12245	953	1075	147680	4998	0	154706
12246	141704	712	5052	2092	0	149560
12247	5346	597	1624	143281	0	150848
12248	2044	461	142121	4829	0	149455
12249	1645	145499	4452	2085	0	153681
12250	146368	4025	1589	2014	0	153996
12251	5116	1254	148856	1240	0	156466
12252	1965	143748	4755	1293	0	151761
12253	1575	151825	1787	1114	0	156301
12254	150774	5151	1467	1212	0	158604
12255	5396	1922	947	150560	0	158825
12256	2016	1263	154072	5052	0	162403
12257	1558	154219	4944	2135	0	162856
12258	155668	4646	1776	1968	0	164058
12259	158703	1518	1422	1515	0	163158
12260	6061	155147	1106	1125	0	163439
12261	2568	4928	157604	1159	0	166259
12262	2096	1758	5063	158332	0	167249
12263	159093	1327	1871	5425	0	167716
12264	162146	852	1509	2266	0	166773
12265	6549	823	157710	1576	0	166658
12266	3336	784	4992	155805	0	164917
12267	2417	746	1902	162366	0	167431
12268	1707	743	159892	6234	0	168576
12269	1558	869	158182	2759	0	163368
12270	159781	731	6284	2136	0	168932
12271	165770	804	2636	1611	0	170821
12272	167418	811	1805	1516	0	171550
12273	168541	701	1392	1446	0	172080
12274	7476	834	159094	1285	0	168689
12275	162554	609	5104	1448	0	169715
12276	7362	564	2058	160313	0	170297
12277	3279	632	162320	5579	0	171810
12278	2577	694	163158	2673	0	169102
12279	1849	160858	6230	2418	0	171355
12280	1863	4657	2879	160423	0	169822
12281	1752	1704	162145	5291	0	170892
12282	157672	1363	5660	2404	0	167099
12283	6039	1191	2477	148482	0	158189
12284	2629	160414	2107	4462	0	169612
12285	163239	4536	1703	2530	0	172008
12286	165946	1490	1661	2271	0	171368
12287	6837	1170	161258	1604	0	170869
12288	3352	158926	5470	1493	0	169241
12289	2752	4088	2144	156145	0	165129
12290	155898	1680	1783	4738	0	164099
12291	5680	1640	1474	154199	0	162993
12292	2644	1059	150203	4712	0	158618
12293	139977	979	4218	2242	0	147416
12294	4535	144253	2030	1823	0	152641
12295	2184	138728	1523	1354	0	143789
12296	1969	147905	1391	1326	0	152591
12297	144246	4410	2309	1605	0	152570
12298	143702	1803	1410	1104	0	148019
12299	144864	1370	1060	863	0	148157
12300	5314	968	905	140871	0	148058
12301	2523	944	141524	3560	0	148551
12302	2104	877	3600	143068	0	149649
12303	144601	666	1529	4322	0	151118
12304	4478	605	1309	145558	0	151950
12305	148366	583	1049	4417	0	154415
12306	149685	646	1181	1921	0	153433
12307	147023	697	1155	1695	0	150570
12308	4678	145228	1118	1393	0	152417
12309	147380	3343	1074	1289	0	153086
12310	4878	1304	143653	831	0	150666
12311	2791	1017	143809	730	0	148347
12312	2403	141649	3959	1017	0	149028
12313	2599	3169	2000	137897	0	145665
12314	138121	1047	1272	3351	0	143791
12315	4105	846	135435	1261	0	141647
12316	133720	564	3361	1271	0	138916
12317	4246	545	1458	134033	0	140282
12318	1913	134841	1436	3198	0	141388
12319	1787	2802	1226	139406	0	145221
12320	1488	1234	138085	3446	0	144253
12321	133408	949	3262	1854	0	139473
12322	3860	792	139725	1265	0	145642
12323	2104	674	134583	912	0	138273
12324	131832	518	3541	1055	0	136946
12325	3619	132465	1626	863	0	138573
12326	136659	2890	1257	967	0	141773
12327	138693	1072	1020	959	0	141744
12328	4631	817	133467	684	0	139599
12329	131665	696	3439	947	0	136747
12330	4018	684	131150	977	0	136829
12331	1971	511	125167	888	0	128537
12332	1854	463	126137	910	0	129364
12333	1249	120050	3221	786	0	125306
12334	107914	2392	3328	1055	0	114689
12335	105769	623	898	698	0	107988
12336	105427	245	339	456	0	106467
12337	105349	191	309	465	0	106314
12338	1990	217	103967	185	0	106359
12339	1095	159	1338	103675	0	106267
12340	828	140	514	104841	0	106323
12341	105862	151	372	1805	0	108190
12342	1559	104534	385	598	0	107076
12343	767	1198	290	104956	0	107211
12344	104457	367	308	1569	0	106701
12345	1557	327	104641	448	0	106973
12346	893	323	1287	102955	0	105458
12347	569	248	105422	1388	0	107627
12348	511	103828	1447	541	0	106327
12349	771	1460	640	100142	0	103013
12350	99395	407	379	1536	0	101717
12351	1404	244	309	99930	0	101887
12352	604	235	100051	1384	0	102274
12353	393	99392	1259	587	0	101631
12354	98525	1168	466	640	0	100799
12355	1435	405	97982	246	0	100068
12356	93602	274	1357	468	0	95701
12357	1464	96485	503	255	0	98707
12358	97432	1254	603	430	0	99719
12359	98595	407	228	411	0	99641
12360	1934	244	177	98275	0	100630
12361	765	224	97218	1340	0	99547
12362	468	97555	1411	559	0	99993
12363	578	1401	492	101480	0	103951
12364	576	470	314	103053	0	104413
12365	569	228	258	108050	0	109105
12366	634	202	241	111754	0	112831
12367	339	121861	265	2818	0	125283
12368	127190	2403	236	1334	0	131163
12369	2919	127459	269	579	0	131226
12370	1457	2964	194	132867	0	137482
12371	135514	953	212	3457	0	140136
12372	3926	521	196	136085	0	140728
12373	1372	443	134776	3696	0	140287
12374	821	134390	3121	1506	0	139838
12375	1174	3220	1028	135683	0	141105
12376	1040	1137	542	139771	0	142490
12377	132241	704	346	4645	0	137936
12378	3522	561	129925	1855	0	135863
12379	129499	395	3198	1540	0	134632
12380	132043	391	1103	1217	0	134754
12381	132304	426	674	1115	0	134519
12382	4952	566	128251	718	0	134487
12383	2619	625	3328	126082	0	132654
12384	1914	551	1181	129365	0	133011
12385	1135	568	128491	4661	0	134855
12386	1015	511	129558	2168	0	133252
12387	130226	411	4422	1635	0	136694
12388	4579	417	1781	132165	0	138942
12389	134304	420	1187	4470	0	140381
12390	138312	450	812	2271	0	141845
12391	5776	402	690	136107	0	142975
12392	2529	429	140829	4710	0	148497
12393	139212	359	4232	2534	0	146337
12394	5534	395	1696	144404	0	152029
12395	2603	475	143296	4916	0	151290
12396	1917	141491	4301	2357	0	150066
12397	141222	4062	1908	1958	0	149150
12398	5021	142888	1368	1385	0	150662
12399	3305	4808	987	132109	0	141209
12400	1963	144020	1026	4369	0	151378
12401	139411	4773	1110	2795	0	148089
12402	142900	1847	1064	2411	0	148222
12403	6088	140729	1104	1954	0	149875
12404	141963	4427	1031	2091	0	149512
12405	141576	1920	1030	2142	0	146668
12406	6608	137169	1039	1878	0	146694
12407	139642	4450	983	2027	0	147102
12408	6660	1793	1118	136696	0	146267
12409	4026	1257	1068	140280	0	146631
12410	138650	898	1058	6206	0	146812
12411	6639	909	1101	130650	0	139299
12412	3588	132869	1133	5083	0	142673
12413	134025	4353	1129	2987	0	142494
12414	135058	2054	1089	2564	0	140765
12415	6334	133964	1219	2064	0	143581
12416	136067	4692	1153	2047	0	143959
12417	138889	2078	1218	1840	0	144025
12418	7617	1466	1034	132992	0	143109
12419	4422	1272	130933	5253	0	141880
12420	3449	130768	4295	2965	0	141477
12421	134149	4599	1828	2376	0	142952
12422	136158	2127	1208	2181	0	141674
12423	7746	1655	128867	2058	0	140326
12424	132465	1223	4586	2241	0	140515
12425	6946	1392	126216	1946	0	136500
12426	129963	1435	4649	2048	0	138095
12427	7065	1640	2133	128235	0	139073
12428	3963	1739	126863	5205	0	137770
12429	3312	1834	128130	2674	0	135950
12430	3377	2116	5365	125663	0	136521
12431	3189	1785	2277	127285	0	134536
12432	3190	1628	121774	5990	0	132582
12433	3537	1510	4527	122418	0	131992
12434	3251	1584	122853	5623	0	133311
12435	3504	1611	4893	122747	0	132755
12436	3544	1614	2272	122870	0	130300
12437	3520	116593	1796	6083	0	127992
12438	3317	117468	1547	3473	0	125805
12439	3050	123545	1512	2942	0	131049
12440	3296	5612	1392	122043	0	132343
12441	3100	2569	1382	126103	0	133154
12442	2839	1836	119749	7019	0	131443
12443	118388	1539	4906	3966	0	128799
12444	124189	1485	2313	3156	0	131143
12445	7392	118816	1882	2523	0	130613
12446	122280	4696	1546	2311	0	130833
12447	7206	2311	1499	119458	0	130474
12448	121882	1650	1686	5731	0	130949
12449	124688	1347	1621	3391	0	131047
12450	7649	1449	1659	120175	0	130932
12451	117039	1445	1655	5814	0	125953
12452	6372	111629	1639	3293	0	122933
12453	3929	116554	1546	2465	0	124494
12454	3579	5581	1642	111304	0	122106
12455	3135	116243	1661	4878	0	125917
12456	3218	4975	1491	114099	0	123783
12457	3412	2299	1368	117424	0	124503
12458	113765	1617	1522	6134	0	123038
12459	5840	111001	1539	3619	0	121999
12460	110610	4212	1557	2814	0	119193
12461	109259	2140	1519	2785	0	115703
12462	6054	107643	1463	2699	0	117859
12463	107492	4064	1330	2593	0	115479
12464	5864	2007	102536	2417	0	112824
12465	2811	99234	3567	2241	0	107853
12466	95034	3286	1806	2302	0	102428
12467	3810	1399	84167	1387	0	90763
12468	1654	75928	2309	1117	0	81008
12469	1599	78490	1516	1171	0	82776
12470	72040	2272	1567	747	0	76626
12471	71446	1006	509	631	0	73592
12472	71234	681	317	654	0	72886
12473	2544	68587	357	1120	0	72608
12474	1534	1674	314	70563	0	74085
12475	70685	795	418	1932	0	73830
12476	71709	612	378	1045	0	73744
12477	2582	513	403	70210	0	73708
12478	1350	574	70145	1818	0	73887
12479	1070	541	69967	883	0	72461
12480	1074	431	1865	70853	0	74223
12481	901	431	932	72247	0	74511
12482	859	443	71359	2194	0	74855
12483	869	307	1736	70051	0	72963
12484	811	70266	832	1951	0	73860
12485	69887	1527	583	1041	0	73038
12486	2050	934	530	68435	0	71949
12487	66274	399	429	1714	0	68816
12488	1640	65287	429	996	0	68352
12489	836	67171	350	775	0	69132
12490	66016	1313	470	703	0	68502
12491	1422	538	63965	590	0	66515
12492	55982	660	1106	354	0	58102
12493	971	56398	490	360	0	58219
12494	465	549	250	53581	0	54845
12495	53209	231	113	677	0	54230
12496	664	135	98	52757	0	53654
12497	53882	115	88	767	0	54852
12498	53355	90	114	382	0	53941
12499	706	54525	98	220	0	55549
12500	54117	435	63	238	0	54853
12501	521	53034	74	115	0	53744
12502	53792	471	99	170	0	54532
12503	625	200	69	53764	0	54658
12504	54544	112	84	557	0	55297
12505	553	100	30	55323	0	56006
12506	56901	78	33	678	0	57690
12507	58154	85	33	332	0	58604
12508	58808	81	39	208	0	59136
12509	59130	90	25	180	0	59425
12510	59412	69	27	176	0	59684
12511	718	91	34	59853	0	60696
12512	58871	68	42	611	0	59592
12513	609	57354	55	195	0	58213
12514	255	490	57661	114	0	58520
12515	274	196	448	57674	0	58592
12516	166	106	59615	529	0	60416
12517	227	98	460	61303	0	62088
12518	182	96	62027	610	0	62915
12519	61261	60	560	335	0	62216
12520	715	58	162	63020	0	63955
12521	247	88	62212	569	0	63116
12522	200	102	63022	204	0	63528
12523	243	283	633	64548	0	65707
12524	69935	67	301	825	0	71128
12525	692	72722	165	271	0	73850
12526	74112	721	110	311	0	75254
12527	74564	272	62	253	0	75151
12528	1066	73753	72	106	0	74997
12529	77127	780	49	353	0	78309
12530	1073	314	70	77555	0	79012
12531	551	166	44	78038	0	78799
12532	347	122	38	78846	0	79353
12533	78438	77	51	1260	0	79826
12534	845	78662	81	531	0	80119
12535	467	869	38	80697	0	82071
12536	350	335	44	82118	0	82847
12537	81470	204	28	1440	0	83142
12538	1169	133	45	81680	0	83027
12539	484	125	82952	1168	0	84729
12540	276	86231	1076	516	0	88099
12541	88850	1225	379	412	0	90866
12542	1515	538	232	87163	0	89448
12543	558	89845	151	1272	0	91826
12544	90822	1335	101	697	0	92955
12545	1589	589	89130	385	0	91693
12546	619	89620	1231	305	0	91775
12547	91524	1410	457	364	0	93755
12548	1626	553	320	90627	0	93126
12549	811	350	176	91326	0	92663
12550	469	269	90385	1771	0	92894
12551	495	223	1297	89609	0	91624
12552	257	180	96036	1789	0	98262
12553	299	209	91275	807	0	92590
12554	261	200	96301	529	0	97291
12555	96890	165	2014	564	0	99633
12556	99161	120	938	451	0	100670
12557	101114	106	592	363	0	102175
12558	2164	129	319	98721	0	101333
12559	1036	98098	240	1294	0	100668
12560	677	101033	170	608	0	102488
12561	103016	1631	174	722	0	105543
12562	103100	790	152	632	0	104674
12563	1707	103265	182	281	0	105435
12564	103489	1358	183	394	0	105424
12565	1773	590	101273	198	0	103834
12566	870	486	99564	160	0	101080
12567	866	276	1622	96838	0	99602
12568	545	194	816	103788	0	105343
12569	362	191	103027	1665	0	105245
12570	444	127	1424	100928	0	102923
12571	102764	124	630	1929	0	105447
12572	1353	169	101817	764	0	104103
12573	100713	130	1395	636	0	102874
12574	1851	123	606	104132	0	106712
12575	906	182	106667	1396	0	109151
12576	639	107512	1470	673	0	110294
12577	109369	1267	651	756	0	112043
12578	1559	584	106748	371	0	109262
12579	106116	413	1491	431	0	108451
12580	1850	277	647	107450	0	110224
12581	108114	189	482	1610	0	110395
12582	1882	190	112764	654	0	115490
12583	1075	153	1416	114515	0	117159
12584	118946	120	651	1894	0	121611
12585	121703	123	504	1044	0	123374
12586	125400	146	358	875	0	126779
12587	126776	146	280	629	0	127831
12588	2631	160	275	122643	0	125709
12589	1450	167	219	123166	0	125002
12590	936	204	122615	2131	0	125886
12591	866	147	1558	122685	0	125256
12592	887	181	666	120328	0	122062
12593	461	125421	535	2373	0	128790
12594	127797	1698	395	1332	0	131222
12595	130906	620	321	986	0	132833
12596	2581	133552	297	634	0	137064
12597	1425	2145	236	134545	0	138351
12598	1089	734	232	137265	0	139320
12599	133228	428	213	3178	0	137047
12600	2584	336	137283	1364	0	141567
12601	1234	222	2223	139792	0	143471
12602	798	257	141745	2715	0	145515
12603	138734	165	2554	1449	0	142902
12604	143762	187	1009	1036	0	145994
12605	145441	194	611	824	0	147070
12606	3683	186	427	141713	0	146009
12607	1881	180	290	142446	0	144797
12608	142154	195	264	3303	0	145916
12609	2836	290	139134	1424	0	143684
12610	1412	205	2165	140768	0	144550
12611	141905	182	795	2932	0	145814
12612	2859	214	618	142350	0	146041
12613	1320	219	148548	2791	0	152878
12614	1074	321	142220	1312	0	144927
12615	144144	414	2745	1318	0	148621
12616	2525	147841	1251	764	0	152381
12617	151980	1991	781	1097	0	155849
12618	154869	670	521	894	0	156954
12619	3255	472	402	154182	0	158311
12620	1676	457	357	153585	0	156075
12621	1018	152318	424	2934	0	156694
12622	152658	2022	317	1625	0	156622
12623	2604	152599	348	1032	0	156583
12624	1100	152881	305	730	0	155016
12625	1068	2293	337	150272	0	153970
12626	150200	831	307	2404	0	153742
12627	152809	511	257	1213	0	154790
12628	2872	308	278	150956	0	154414
12629	1479	248	212	149108	0	151047
12630	1175	198	184	149578	0	151135
12631	147099	161	248	3151	0	150659
12632	2347	252	146514	1355	0	150468
12633	1096	146551	1909	1058	0	150614
12634	147209	1662	675	1036	0	150582
12635	2496	998	592	146393	0	150479
12636	1264	469	146225	2095	0	150053
12637	1167	378	143327	1067	0	145939
12638	722	145009	2208	1027	0	148966
12639	683	148673	881	767	0	151004
12640	1102	1979	923	143999	0	148003
12641	800	127786	670	1651	0	130907
12642	804	1488	251	141060	0	143603
12643	637	493	218	144528	0	145876
12644	144443	332	392	2317	0	147484
12645	1803	265	218	144720	0	147006
12646	902	225	194	146068	0	147389
12647	698	333	143732	1989	0	146752
12648	701	261	1360	145417	0	147739
12649	146722	260	573	2319	0	149874
12650	148186	266	368	1212	0	150032
12651	2160	151158	353	740	0	154411
12652	148620	1718	216	1005	0	151559
12653	2421	691	146420	650	0	150182
12654	1025	148010	1823	777	0	151635
12655	945	2034	576	151280	0	154835
12656	833	735	394	154706	0	156668
12657	824	505	329	155456	0	157114
12658	153790	357	344	3376	0	157867
12659	147437	332	461	1730	0	149960
12660	2736	376	149722	907	0	153741
12661	1299	355	146702	892	0	149248
12662	1052	470	148760	736	0	151018
12663	916	148288	2594	786	0	152584
12664	823	152841	928	785	0	155377
12665	152853	2504	500	1154	0	157011
12666	153869	865	399	1116	0	156249
12667	3023	493	379	155068	0	158963
12668	1376	377	425	153962	0	156140
12669	849	154324	489	3018	0	158680
12670	871	2138	406	158671	0	162086
12671	756	849	156927	2847	0	161379
12672	642	156782	2371	1284	0	161079
12673	779	2313	842	159915	0	163849
12674	749	902	161681	2627	0	165959
12675	1020	684	2277	153427	0	157408
12676	709	157713	785	2697	0	161904
12677	162145	2435	488	1607	0	166675
12678	162801	878	338	1419	0	165436
12679	166880	595	351	1412	0	169238
12680	3686	540	303	166020	0	170549
12681	1649	558	305	170308	0	172820
12682	166011	517	307	4027	0	170862
12683	3282	165107	415	1438	0	170242
12684	166750	2907	371	1507	0	171535
12685	3539	1020	169690	814	0	175063
12686	171008	554	3200	1123	0	175885
12687	177163	430	1093	1129	0	179815
12688	5107	410	544	174558	0	180619
12689	177660	366	437	4203	0	182666
12690	181457	394	404	1994	0	184249
12691	5237	415	439	179614	0	185705
12692	1898	458	176682	3929	0	182967
12693	169966	422	3389	2059	0	175836
12694	3970	456	177460	956	0	182842
12695	1563	180537	3521	797	0	186418
12696	1526	3221	1582	181782	0	188111
12697	1045	1054	577	188491	0	191167
12698	197653	433	401	5077	0	203564
12699	4286	508	197473	1573	0	203840
12700	1781	610	3880	190471	0	196742
12701	867	192462	1327	4188	0	198844
12702	581	195411	779	1572	0	198343
12703	1006	4855	469	197485	0	203815
12704	702	1527	193881	4512	0	200622
12705	1145	796	4049	195479	0	201469
12706	1042	554	1300	196921	0	199817
12707	645	691	190350	5455	0	197141
12708	541	194315	3984	2013	0	200853
12709	190358	4222	1337	1673	0	197590
12710	4231	195141	766	1009	0	201147
12711	1967	4418	485	195337	0	202207
12712	189200	1468	499	5198	0	196365
12713	4264	186033	648	1738	0	192683
12714	1606	4384	184618	1032	0	191640
12715	182017	1495	4137	1347	0	188996
12716	4370	188797	1446	876	0	195489
12717	189206	4319	765	1242	0	195532
12718	5205	1598	181207	734	0	188744
12719	182513	815	4145	1109	0	188582
12720	5319	581	1432	184018	0	191350
12721	2016	683	182374	4667	0	189740
12722	1548	680	4228	179180	0	185636
12723	1028	176886	1564	4804	0	184282
12724	1271	4194	846	182571	0	188882
12725	1317	1463	599	185043	0	188422
12726	1015	940	176896	5939	0	184790
12727	1363	656	4228	179119	0	185366
12728	1140	1179	154918	5716	0	162953
12729	1067	178642	3441	2305	0	185455
12730	1365	4637	1306	180190	0	187498
12731	1175	1674	180369	5086	0	188304
12732	1093	177566	4725	2183	0	185567
12733	1082	186749	1676	1541	0	191048
12734	1161	5673	183103	1189	0	191126
12735	1236	1950	182245	1161	0	186592
12736	1572	1164	5731	179891	0	188358
12737	178948	870	1954	5616	0	187388
12738	5205	178302	1107	2302	0	186916
12739	2465	4860	828	176677	0	184830
12740	176342	1659	834	5610	0	184445
12741	5523	177890	817	2304	0	186534
12742	176744	4972	772	1962	0	184450
12743	5657	180897	836	1420	0	188810
12744	182056	5294	815	1695	0	189860
12745	182364	1925	880	1737	0	186906
12746	185752	1195	871	1636	0	189454
12747	7148	188759	934	1523	0	198364
12748	3457	5694	901	191612	0	201664
12749	2139	2056	187239	6040	0	197474
12750	1772	187188	5560	2796	0	197316
12751	2294	5914	2046	182540	0	192794
12752	2235	2375	1385	186320	0	192315
12753	1549	1470	178239	6873	0	188131
12754	1547	174739	5270	2960	0	184516
12755	172791	5255	2224	2273	0	182543
12756	5742	172489	1279	1879	0	181389
12757	2847	5442	1090	172640	0	182019
12758	1680	2163	171812	5810	0	181465
12759	166737	1445	5399	2696	0	176277
12760	5843	1307	1932	174147	0	183229
12761	2038	1269	170925	6022	0	180254
12762	162812	1125	5445	2927	0	172309
12763	5351	167162	2182	2081	0	176776
12764	168739	5365	1622	2038	0	177764
12765	171462	2319	1082	2047	0	176910
12766	6658	1497	1054	168493	0	177702
12767	2606	1459	166561	5872	0	176498
12768	1899	165477	5229	2648	0	175253
12769	1245	5575	165313	1983	0	174116
12770	1451	2643	5402	161465	0	170961
12771	1281	2057	2232	168477	0	174047
12772	162730	1480	1478	7048	0	172736
12773	5241	1198	160883	3198	0	170520
12774	2117	157551	5287	2069	0	167024
12775	1801	5278	1938	158320	0	167337
12776	1791	2160	1328	162718	0	167997
12777	156066	1578	1234	6441	0	165319
12778	5289	157124	934	2687	0	166034
12779	2764	5159	809	153461	0	162193
12780	147573	2285	808	5715	0	156381
12781	4677	148974	890	2526	0	157067
12782	145849	4706	752	1611	0	152918
12783	146288	1924	942	1496	0	150650
12784	5638	141485	974	1268	0	149365
12785	129733	3783	695	1072	0	135283
12786	4200	130439	687	904	0	136230
12787	129702	3780	759	1010	0	135251
12788	129992	1337	723	1125	0	133177
12789	4502	126984	511	974	0	132971
12790	123002	3392	493	1048	0	127935
12791	126295	1108	575	942	0	128920
12792	126100	915	564	1001	0	128580
12793	4539	857	120638	781	0	126815
12794	1830	637	115093	753	0	118313
12795	1283	634	115316	597	0	117830
12796	113153	1035	4327	753	0	119268
12797	3311	613	110746	600	0	115270
12798	1254	495	99022	380	0	101151
12799	1343	954	2887	91399	0	96583
12800	92776	358	1118	2280	0	96532
12801	2390	365	92866	759	0	96380
12802	1018	389	95307	618	0	97332
12803	964	394	2717	93809	0	97884
12804	870	324	1052	95834	0	98080
12805	766	304	707	96949	0	98726
12806	626	368	94297	2987	0	98278
12807	768	331	2247	94416	0	97762
12808	93336	334	898	2943	0	97511
12809	2391	93589	673	1136	0	97789
12810	1152	2221	506	94245	0	98124
12811	998	820	409	96405	0	98632
12812	768	648	95236	2889	0	99541
12813	625	93922	2365	1218	0	98130
12814	93452	2412	890	1061	0	97815
12815	2523	94142	678	748	0	98091
12816	1252	2555	545	94308	0	98660
12817	902	942	94044	2498	0	98386
12818	909	684	2511	96961	0	101065
12819	778	487	998	99744	0	102007
12820	99587	425	812	3509	0	104333
12821	3006	381	642	96678	0	100707
12822	1139	96402	659	3291	0	101491
12823	876	103037	562	1344	0	105819
12824	772	3144	102046	956	0	106918
12825	102398	1157	2844	891	0	107290
12826	3265	785	1013	103814	0	108877
12827	1413	509	834	105867	0	108623
12828	1157	436	683	106740	0	109016
12829	105175	376	560	4146	0	110257
12830	3024	106205	548	1856	0	111633
12831	106021	2700	506	1455	0	110682
12832	3339	938	101331	913	0	106521
12833	1353	754	100571	780	0	103458
12834	102653	503	3308	895	0	107359
12835	3438	484	1654	103116	0	108692
12836	1423	450	955	105633	0	108461
12837	1133	386	766	106557	0	108842
12838	797	445	103837	3979	0	109058
12839	103718	385	2791	1979	0	108873
12840	106324	352	1162	1489	0	109327
12841	104102	398	936	1227	0	106663
12842	4109	720	851	100785	0	106465
12843	1821	416	98136	3213	0	103586
12844	1380	466	96385	1567	0	99798
12845	1093	517	99544	1297	0	102451
12846	823	95433	3423	1152	0	100831
12847	1516	2286	1898	86540	0	92240
12848	85553	686	871	2438	0	89548
12849	2100	468	85442	1163	0	89173
12850	86654	286	2072	1107	0	90119
12851	2481	331	879	87492	0	91183
12852	1155	417	652	87845	0	90069
12853	847	83751	592	2748	0	87938
12854	705	85758	632	1338	0	88433
12855	699	89273	600	1018	0	91590
12856	819	2418	646	89422	0	93305
12857	88312	836	591	2518	0	92257
12858	89475	500	526	1365	0	91866
12859	2581	399	86661	1062	0	90703
12860	86809	322	2051	1011	0	90193
12861	2445	347	86758	902	0	90452
12862	1284	361	2209	86995	0	90849
12863	969	293	86875	2352	0	90489
12864	86981	323	2270	1245	0	90819
12865	2389	442	1004	88364	0	92199
12866	1052	372	90388	2344	0	94156
12867	856	375	86665	1207	0	89103
12868	87162	359	2565	1077	0	91163
12869	89666	360	1188	992	0	92206
12870	2515	89345	794	868	0	93522
12871	1296	1777	644	91448	0	95165
12872	898	707	90887	2215	0	94707
12873	829	614	89501	1096	0	92040
12874	995	728	2326	90506	0	94555
12875	90644	525	1362	2394	0	94925
12876	2076	89462	711	1205	0	93454
12877	1083	1758	574	91899	0	95314
12878	91815	743	500	2488	0	95546
12879	2207	510	538	92079	0	95334
12880	1178	91093	607	2334	0	95212
12881	977	1698	611	93674	0	96960
12882	93185	672	603	2408	0	96868
12883	2402	541	583	93595	0	97121
12884	94143	355	609	2524	0	97631
12885	2281	94925	701	1363	0	99270
12886	96401	1684	719	1226	0	100030
12887	2483	638	93563	880	0	97564
12888	92507	545	2135	975	0	96162
12889	96027	469	1113	920	0	98529
12890	2660	94988	865	820	0	99333
12891	1459	1978	715	93922	0	98074
12892	1027	702	93503	1941	0	97173
12893	944	596	90596	1087	0	93223
12894	87649	794	2333	1213	0	91989
12895	86874	432	1020	1014	0	89340
12896	1836	86122	613	866	0	89437
12897	1035	88167	477	727	0	90406
12898	87856	1533	525	694	0	90608
12899	1778	86073	573	564	0	88988
12900	961	88866	571	591	0	90989
12901	984	1351	580	88785	0	91700
12902	732	561	426	87754	0	89473
12903	601	410	87464	1982	0	90457
12904	739	316	1269	87370	0	89694
12905	87469	287	617	1990	0	90363
12906	1702	337	86607	816	0	89462
12907	1022	348	85691	676	0	87737
12908	1151	252	1574	85763	0	88740
12909	926	294	728	89151	0	91099
12910	879	306	596	89341	0	91122
12911	676	326	87487	1732	0	90221
12912	659	315	1416	84899	0	87289
12913	658	325	743	88331	0	90057
12914	86800	290	532	1603	0	89225
12915	1307	85443	458	750	0	87958
12916	85893	1008	478	611	0	87990
12917	1493	381	85520	461	0	87855
12918	78184	216	880	451	0	79731
12919	1005	83240	489	331	0	85065
12920	79880	503	332	263	0	80978
12921	607	79115	147	186	0	80055
12922	76080	588	345	290	0	77303
12923	477	73681	96	107	0	74361
12924	258	73448	188	117	0	74011
12925	525	615	391	73648	0	75179
12926	74249	161	179	448	0	75037
12927	74172	78	26	245	0	74521
12928	74789	48	22	206	0	75065
12929	553	82	73334	56	0	74025
12930	266	105	71835	56	0	72262
12931	208	110	486	74867	0	75671
12932	96	74690	234	464	0	75484
12933	75	77464	106	181	0	77826
12934	191	605	51	75924	0	76771
12935	75690	197	34	595	0	76516
12936	76020	94	39	286	0	76439
12937	76714	50	41	194	0	76999
12938	770	101	75507	36	0	76414
12939	362	58	479	77081	0	77980
12940	172	89	78100	544	0	78905
12941	78161	60	582	367	0	79170
12942	80038	60	211	276	0	80585
12943	822	85	79667	85	0	80659
12944	414	57	569	79865	0	80905
12945	81217	59	218	810	0	82304
12946	755	60	105	82963	0	83883
12947	413	55	70	83693	0	84231
12948	428	69	114	85062	0	85673
12949	91932	42	56	1507	0	93537
12950	1465	45	81	97015	0	98606
12951	100281	59	75	2088	0	102503
12952	2090	106163	124	781	0	109158
12953	980	1889	82	112005	0	114956
12954	675	733	63	113784	0	115255
12955	513	456	67	113590	0	114626
12956	111458	209	78	3522	0	115267
12957	2477	162	72	111907	0	114618
12958	1155	138	68	113308	0	114669
12959	112836	105	67	3513	0	116521
12960	114499	108	72	1821	0	116500
12961	114665	80	78	1161	0	115984
12962	3677	118	109111	634	0	113540
12963	1827	176	105107	550	0	107660
12964	111984	89	2690	570	0	115333
12965	2897	97	1171	111039	0	115204
12966	1479	88	633	109673	0	111873
12967	111493	71	352	3373	0	115289
12968	109992	76	276	1763	0	112107
12969	110638	73	197	1232	0	112140
12970	3532	106921	228	664	0	111345
12971	109129	2009	153	685	0	111976
12972	108137	743	136	636	0	109652
12973	3480	104755	173	466	0	108874
12974	1741	107415	162	810	0	110128
12975	1532	2533	212	108545	0	112822
12976	110921	1106	154	2468	0	114649
12977	112142	605	123	1207	0	114077
12978	112185	361	110	968	0	113624
12979	3955	276	87	109403	0	113721
12980	110363	213	100	2753	0	113429
12981	3398	228	106247	1237	0	111110
12982	107636	212	2012	1115	0	110975
12983	3347	214	107331	643	0	111535
12984	1700	250	104500	575	0	107025
12985	1428	296	2718	103833	0	108275
12986	105452	144	1326	2722	0	109644
12987	2862	172	701	105603	0	109338
12988	1402	164	104908	3084	0	109558
12989	1196	195	104251	1538	0	107180
12990	1093	145	2746	104778	0	108762
12991	104186	146	1271	3082	0	108685
12992	2734	104339	825	1518	0	109416
12993	1653	2020	516	107167	0	111356
12994	1465	814	452	109427	0	112158
12995	1010	550	107953	3469	0	112982
12996	1002	399	105575	1890	0	108866
12997	980	283	2927	108684	0	112874
12998	108847	216	1406	3369	0	113838
12999	2982	254	107429	1790	0	112455
13000	1830	263	2428	107597	0	112118
13001	1600	204	1089	108508	0	111401
13002	1314	246	773	110863	0	113196
13003	106430	246	540	4371	0	111587
13004	3246	390	97398	2365	0	103399
13005	1887	104959	1856	1769	0	110471
13006	1690	2321	878	107709	0	112598
13007	1318	979	106705	3285	0	112287
13008	1285	103628	2570	1956	0	109439
13009	1353	108478	1205	1589	0	112625
13010	107772	2957	885	1427	0	113041
13011	3252	108474	680	1229	0	113635
13012	110201	2978	594	1333	0	115106
13013	3838	1352	107435	1138	0	113763
13014	2288	934	2593	109682	0	115497
13015	110156	640	1178	3570	0	115544
13016	3677	110482	917	1980	0	117056
13017	2255	2678	109898	1649	0	116480
13018	2183	1236	2719	103123	0	109261
13019	1705	110639	1304	2908	0	116556
13020	1718	2826	992	113768	0	119304
13021	112027	1332	810	3869	0	118038
13022	3469	114819	787	2136	0	121211
13023	116690	2919	662	1954	0	122225
13024	118676	1316	605	1649	0	122246
13025	4874	980	115810	1297	0	122961
13026	2866	119535	3162	1207	0	126770
13027	2418	3507	1537	125647	0	133109
13028	1988	1269	129716	3951	0	136924
13029	1782	984	139016	1809	0	143591
13030	1953	1162	5378	142119	0	150612
13031	146769	505	2516	5042	0	154832
13032	149442	482	1684	2342	0	153950
13033	6706	495	1154	146733	0	155088
13034	3086	560	146035	5523	0	155204
13035	2216	146283	4549	2641	0	155689
13036	150339	4402	1808	2277	0	158826
13037	153715	1650	1348	1714	0	158427
13038	6455	150598	1094	1640	0	159787
13039	153647	4866	949	1395	0	160857
13040	6363	1956	148443	913	0	157675
13041	149753	1381	4701	1097	0	156932
13042	146795	1033	1891	1428	0	151147
13043	6475	882	148536	973	0	156866
13044	3526	843	4965	146583	0	155917
13045	2501	536	146815	4921	0	154773
13046	1805	139202	5357	2206	0	148570
13047	1520	144239	2383	1865	0	150007
13048	1897	5773	1532	136721	0	145923
13049	1003	1602	136928	4200	0	143733
13050	677	127778	3599	1513	0	133567
13051	534	129618	1344	1062	0	132558
13052	116470	3738	1171	1049	0	122428
13053	118608	1066	461	592	0	120727
13054	3446	640	346	117563	0	121995
13055	1353	482	264	116906	0	119005
13056	757	117982	306	3054	0	122099
13057	117634	2694	231	1354	0	121913
13058	119579	799	231	1045	0	121654
13059	3310	117747	254	637	0	121948
13060	1447	2776	187	119026	0	123436
13061	878	894	117970	2809	0	122551
13062	978	637	2501	118531	0	122647
13063	119690	483	753	3328	0	124254
13064	3230	391	513	120417	0	124551
13065	1297	326	436	123922	0	125981
13066	122578	262	349	4045	0	127234
13067	3281	293	319	120482	0	124375
13068	1131	118704	342	3405	0	123582
13069	1070	2504	254	123503	0	127331
13070	911	787	300	125981	0	127979
13071	773	574	288	124056	0	125691
13072	552	121229	341	3878	0	126000
13073	652	2742	291	122175	0	125860
13074	493	950	119559	3648	0	124650
13075	731	600	2694	119724	0	123749
13076	490	582	118529	3624	0	123225
13077	497	117064	2966	1492	0	122019
13078	721	2910	1054	120251	0	124936
13079	653	946	731	122644	0	124974
13080	728	618	592	123164	0	125102
13081	674	549	531	122655	0	124409
13082	532	572	118499	4358	0	123961
13083	564	117458	2868	1957	0	122847
13084	702	2895	941	121781	0	126319
13085	617	1011	121676	3736	0	127040
13086	809	766	3151	122718	0	127444
13087	123075	650	1149	4173	0	129047
13088	3392	677	118115	1640	0	123824
13089	120201	532	2939	1404	0	125076
13090	3964	516	1043	122970	0	128493
13091	1679	521	122502	3657	0	128359
13092	1247	120527	3289	1605	0	126668
13093	1240	3143	1136	121653	0	127172
13094	984	1153	123677	3709	0	129523
13095	801	122116	3447	1641	0	128005
13096	948	3326	1267	123946	0	129487
13097	123165	1189	1025	4147	0	129526
13098	126528	964	901	1853	0	130246
13099	127815	768	633	1619	0	130835
13100	4650	691	123815	1215	0	130371
13101	2045	125404	3298	1099	0	131846
13102	1679	3466	1145	126744	0	133034
13103	1283	1297	910	133521	0	137011
13104	132428	988	758	4771	0	138945
13105	3861	134139	678	2005	0	140683
13106	135312	3905	543	1860	0	141620
13107	135726	1423	546	1641	0	139336
13108	139005	1099	474	1571	0	142149
13109	5258	889	133674	1213	0	141034
13110	136552	733	3655	1261	0	142201
13111	5075	732	1180	136945	0	143932
13112	2302	612	876	138944	0	142734
13113	135687	535	783	5240	0	142245
13114	4586	619	567	133793	0	139565
13115	1737	131827	624	4947	0	139135
13116	1437	3709	447	132581	0	138174
13117	129268	1220	395	5251	0	136134
13118	4133	942	126633	2391	0	134099
13119	1578	125968	3378	1892	0	132816
13120	1435	3577	1039	126897	0	132948
13121	126043	1210	792	4501	0	132546
13122	3988	857	123027	2057	0	129929
13123	2086	2921	3834	120470	0	129311
13124	1990	715	120185	4302	0	127192
13125	1779	635	116490	2105	0	121009
13126	1571	556	113021	1508	0	116656
13127	1210	480	110669	1264	0	113623
13128	1027	578	105727	1004	0	108336
13129	90054	1458	4052	979	0	96543
13130	1705	90705	1204	551	0	94165
13131	87445	1225	715	535	0	89920
13132	87286	407	440	512	0	88645
13133	1688	85810	376	320	0	88194
13134	644	87895	357	351	0	89247
13135	87511	1413	417	515	0	89856
13136	87361	504	255	490	0	88610
13137	1784	421	249	84435	0	86889
13138	726	85151	249	1275	0	87401
13139	86540	1186	212	738	0	88676
13140	1416	85304	261	390	0	87371
13141	746	1301	225	86435	0	88707
13142	87046	494	201	1523	0	89264
13143	87309	308	225	686	0	88528
13144	1751	293	221	86580	0	88845
13145	876	241	206	87334	0	88657
13146	594	240	85800	1600	0	88234
13147	619	245	1228	85115	0	87207
13148	468	248	85948	1520	0	88184
13149	542	194	1319	83784	0	85839
13150	517	182	555	86004	0	87258
13151	85233	179	389	1933	0	87734
13152	85339	235	348	950	0	86872
13153	1689	233	83988	551	0	86461
13154	82887	192	1293	600	0	84972
13155	1678	197	550	84295	0	86720
13156	811	246	85199	1445	0	87701
13157	759	210	1350	85109	0	87428
13158	675	193	547	90545	0	91960
13159	520	254	89937	1930	0	92641
13160	623	212	1539	91634	0	94008
13161	512	242	94290	1945	0	96989
13162	611	308	1799	97995	0	100713
13163	103068	194	701	2536	0	106499
13164	2217	104784	539	1082	0	108622
13165	107233	2091	441	891	0	110656
13166	2607	108784	395	676	0	112462
13167	108168	2482	358	776	0	111784
13168	2764	107956	365	506	0	111591
13169	107273	2530	411	734	0	110948
13170	2790	107771	344	541	0	111446
13171	1538	2665	298	108255	0	112756
13172	1054	1138	107703	2453	0	112348
13173	884	903	106450	1059	0	109296
13174	1042	670	2801	106907	0	111420
13175	107004	543	1262	2777	0	111586
13176	2709	107981	769	1245	0	112704
13177	1495	2545	506	109292	0	113838
13178	992	1126	108975	2769	0	113862
13179	804	807	110137	1290	0	113038
13180	966	1077	3082	104901	0	110026
13181	560	109833	1515	2635	0	114543
13182	109910	2428	1004	1490	0	114832
13183	2672	1109	111817	960	0	116558
13184	1258	787	109700	773	0	112518
13185	846	111002	3121	727	0	115696
13186	110357	2616	1837	899	0	115709
13187	111796	1110	1025	734	0	114665
13188	3318	740	745	110007	0	114810
13189	111525	552	658	2694	0	115429
13190	110686	494	655	1369	0	113204
13191	3326	109620	648	859	0	114453
13192	110766	2330	650	759	0	114505
13193	3152	1073	111406	513	0	116144
13194	1768	756	2393	109650	0	114567
13195	1443	596	1162	110621	0	113822
13196	109165	511	783	3184	0	113643
13197	2696	108304	631	1557	0	113188
13198	108279	2283	586	1126	0	112274
13199	2893	109403	456	790	0	113542
13200	1496	110718	471	626	0	113311
13201	1460	2831	107594	526	0	112411
13202	1137	1687	104185	576	0	107585
13203	100680	1317	2708	705	0	105410
13204	102904	744	1379	651	0	105678
13205	2686	565	99845	405	0	103501
13206	1403	95027	1868	394	0	98692
13207	1014	98811	927	324	0	101076
13208	98347	2269	788	447	0	101851
13209	98565	1217	506	434	0	100722
13210	2546	877	443	98115	0	101981
13211	100174	578	463	1869	0	103084
13212	2386	431	478	99255	0	102550
13213	1282	444	98979	1949	0	102654
13214	1082	478	94113	952	0	96625
13215	98317	448	2187	884	0	101836
13216	2159	535	1085	97343	0	101122
13217	1232	103185	771	1521	0	106709
13218	105718	1737	557	1118	0	109130
13219	106324	858	548	919	0	108649
13220	2653	697	104875	548	0	108773
13221	106507	480	1760	766	0	109513
13222	110196	421	1001	627	0	112245
13223	2963	469	801	108106	0	112339
13224	1671	106093	669	1893	0	110326
13225	1269	107849	608	1061	0	110787
13226	1136	2522	423	113512	0	117593
13227	1214	1333	413	111346	0	114306
13228	1155	883	407	114297	0	116742
13229	1041	723	111714	3045	0	116523
13230	1105	708	107564	1512	0	110889
13231	1081	618	2724	109153	0	113576
13232	938	626	110414	2312	0	114290
13233	929	686	108694	1244	0	111553
13234	922	612	2886	107985	0	112405
13235	845	636	114180	2508	0	118169
13236	751	112736	2820	1450	0	117757
13237	117741	2294	1428	1402	0	122865
13238	2677	1202	1084	116521	0	121484
13239	1393	116512	888	2525	0	121318
13240	1053	2434	120001	1304	0	124792
13241	972	1167	2792	119670	0	124601
13242	779	851	124238	2777	0	128645
13243	985	558	3166	124211	0	128920
13244	952	531	1524	128967	0	131974
13245	847	639	130339	3700	0	135525
13246	1043	571	3044	128336	0	132994
13247	822	126998	1586	3262	0	132668
13248	932	2828	1049	134434	0	139243
13249	883	1333	133409	3461	0	139086
13250	1023	942	2930	132652	0	137547
13251	131854	579	1530	3866	0	137829
13252	3026	131996	1140	1982	0	138144
13253	1761	2893	878	133766	0	139298
13254	1191	1277	135646	3294	0	141408
13255	882	131304	2993	1882	0	137061
13256	850	135637	1425	1332	0	139244
13257	939	3549	132331	1111	0	137930
13258	1012	1872	2837	127514	0	133235
13259	1211	1601	1449	127037	0	131298
13260	917	652	126968	3496	0	132033
13261	637	119264	2630	1879	0	124410
13262	532	121856	1258	1147	0	124793
13263	113570	2189	857	773	0	117389
13264	1693	114607	468	548	0	117316
13265	113645	1846	446	601	0	116538
13266	1972	757	233	110978	0	113940
13267	116113	451	279	2170	0	119013
13268	1862	375	115280	817	0	118334
13269	115193	281	1678	787	0	117939
13270	2082	362	777	117909	0	121130
13271	799	118691	539	1818	0	121847
13272	120839	1674	371	954	0	123838
13273	2003	1309	348	120560	0	124220
13274	792	120726	367	1843	0	123728
13275	503	128171	327	904	0	129905
13276	127588	2059	457	910	0	131014
13277	129068	845	245	652	0	130810
13278	130406	456	208	624	0	131694
13279	2407	340	217	125917	0	128881
13280	891	121839	319	1849	0	124898
13281	481	126664	270	784	0	128199
13282	460	2049	267	127677	0	130453
13283	126082	839	252	2214	0	129387
13284	120902	566	213	1394	0	123075
13285	125738	337	235	906	0	127216
13286	2437	408	120416	491	0	123752
13287	1184	503	120362	404	0	122453
13288	129750	329	1981	663	0	132723
13289	2119	281	773	129456	0	132629
13290	1007	314	480	131484	0	133285
13291	753	342	311	129554	0	130960
13292	603	362	303	131052	0	132320
13293	416	415	126973	2725	0	130529
13294	507	352	1781	126423	0	129063
13295	398	397	126188	2361	0	129344
13296	119517	344	2012	1413	0	123286
13297	1897	126013	886	848	0	129644
13298	971	1803	601	130290	0	133665
13299	718	782	430	129105	0	131035
13300	127171	545	451	2927	0	131094
13301	127047	435	375	1593	0	129450
13302	127824	517	322	1141	0	129804
13303	127671	478	323	999	0	129471
13304	2826	455	125634	722	0	129637
13305	1427	499	123004	598	0	125528
13306	1038	421	2282	125413	0	129154
13307	127060	415	1051	2395	0	130921
13308	125344	348	793	1477	0	127962
13309	2475	410	123706	1018	0	127609
13310	1297	318	1863	122388	0	125866
13311	123249	340	844	2750	0	127183
13312	2219	445	630	123815	0	127109
13313	1122	485	124619	2461	0	128687
13314	1013	492	1897	124268	0	127670
13315	125624	502	932	2685	0	129743
13316	2077	132705	692	1259	0	136733
13317	132639	1889	472	1407	0	136407
13318	133669	782	426	1295	0	136172
13319	135080	562	414	1136	0	137192
13320	2978	460	384	133304	0	137126
13321	131430	496	347	2390	0	134663
13322	2298	133051	399	1107	0	136855
13323	1282	137561	391	861	0	140095
13324	1136	2956	427	135556	0	140075
13325	136650	1104	387	2550	0	140691
13326	2433	141081	346	1162	0	145022
13327	162221	2424	351	1166	0	166162
13328	172165	1022	274	1115	0	174576
13329	5114	176369	321	787	0	182591
13330	2637	4026	254	179564	0	186481
13331	1907	1607	227	184457	0	188198
13332	1367	1060	181695	5388	0	189510
13333	1938	790	3902	179136	0	185766
13334	1374	767	181399	5228	0	188768
13335	1149	173900	4285	4370	0	183704
13336	1469	4262	1804	179713	0	187248
13337	172520	1618	1077	5684	0	180899
13338	177377	886	944	3050	0	182257
13339	5709	894	896	176245	0	183744
13340	2355	730	172195	5022	0	180302
13341	163450	763	4033	2987	0	171233
13342	4515	165412	1780	1871	0	173578
13343	2221	164450	1000	1670	0	169341
13344	1837	168944	869	1270	0	172920
13345	2259	4982	838	161983	0	170062
13346	1214	2021	165383	4095	0	172713
13347	1471	1388	3699	163790	0	170348
13348	1104	1191	165177	4170	0	171642
13349	888	1247	162802	1929	0	166866
13350	763	1232	166936	1279	0	170210
13351	1290	973	4979	159631	0	166873
13352	953	766	2359	168652	0	172730
13353	814	643	1719	170710	0	173886
13354	906	521	1498	166034	0	168959
13355	165516	438	1403	6230	0	173587
13356	3479	163942	1541	2931	0	171893
13357	164913	3379	1161	2593	0	172046
13358	3849	167526	1005	2116	0	174496
13359	2072	3855	658	169743	0	176328
13360	1474	1618	581	175864	0	179537
13361	172496	1016	470	6210	0	180192
13362	175304	1022	437	3147	0	179910
13363	177513	1007	418	2283	0	181221
13364	176196	980	405	1966	0	179547
13365	175485	885	289	1902	0	178561
13366	5842	170681	352	1583	0	178458
13367	166182	3605	282	1897	0	171966
13368	5244	165653	347	1076	0	172320
13369	165773	3856	336	1237	0	171202
13370	5420	1691	163090	805	0	171006
13371	3399	1265	3169	160751	0	168584
13372	2267	165217	1330	3289	0	172103
13373	2113	4024	776	165724	0	172637
13374	1763	1996	163205	3911	0	170875
13375	1992	1509	3457	156529	0	163487
13376	155599	1129	1626	4930	0	163284
13377	3900	155391	1227	2755	0	163273
13378	1912	159977	1083	2081	0	165053
13379	1406	4857	160895	1877	0	169035
13380	1375	2531	3713	158902	0	166521
13381	1111	162353	1934	4512	0	169910
13382	1265	4060	1302	167858	0	174485
13383	1182	2134	166471	4836	0	174623
13384	1028	162549	3919	2762	0	170258
13385	1184	4413	164532	1803	0	171932
13386	1218	2418	162394	1708	0	167738
13387	1519	1718	4681	161512	0	169430
13388	163732	1581	2149	4759	0	172221
13389	4182	1351	1715	165901	0	173149
13390	1939	1391	166904	4737	0	174971
13391	1628	1416	4586	169238	0	176868
13392	1237	1475	176303	4966	0	183981
13393	1209	1332	173518	2958	0	179017
13394	174760	1082	6042	2897	0	184781
13395	186549	955	2920	2914	0	193338
13396	187940	751	2473	2822	0	193986
13397	5724	704	183674	2329	0	192431
13398	2720	686	185364	2127	0	190897
13399	2236	546	6472	181088	0	190342
13400	2183	618	3459	186434	0	192694
13401	185698	723	2191	6460	0	195072
13402	5570	858	1700	186521	0	194649
13403	2802	793	186803	6036	0	196434
13404	2103	901	181226	3435	0	187665
13405	1727	184496	5922	2794	0	194939
13406	1924	4091	2658	191063	0	199736
13407	1919	1921	192865	5588	0	202293
13408	2165	1317	5204	189956	0	198642
13409	191424	1056	2757	6614	0	201851
13410	4978	1030	194154	3350	0	203512
13411	2989	880	5399	193893	0	203161
13412	2460	993	2557	198465	0	204475
13413	2152	905	192888	6758	0	202703
13414	2299	747	5333	190037	0	198416
13415	1983	797	190360	6299	0	199439
13416	178119	852	5483	3722	0	188176
13417	5347	843	2862	180866	0	189918
13418	2538	179322	2074	5765	0	189699
13419	180436	4215	1675	3804	0	190130
13420	181354	1687	1783	3085	0	187909
13421	6147	178464	1776	2515	0	188902
13422	4872	11939	1901	161064	0	179776
13423	2203	169159	1299	4446	0	177107
13424	1969	171918	1068	2583	0	177538
13425	3525	5540	161951	1970	0	172986
13426	2090	160430	3804	1961	0	168285
13427	1681	3414	137099	1292	0	143486
13428	117855	1299	2109	1006	0	122269
13429	119921	378	670	797	0	121766
13430	1668	120833	431	411	0	123343
13431	584	121474	374	333	0	122765
13432	365	123806	283	327	0	124781
13433	124059	1738	333	598	0	126728
13434	1934	594	250	126311	0	129089
13435	605	436	131554	1623	0	134218
13436	364	131882	1894	648	0	134788
13437	520	1934	599	135284	0	138337
13438	494	654	371	133672	0	135191
13439	254	146587	302	2329	0	149472
13440	155450	2664	298	1297	0	159709
13441	3336	817	158171	445	0	162769
13442	1751	516	3351	186642	0	192260
13443	449	206827	978	4477	0	212731
13444	207597	5308	473	1804	0	215182
13445	5587	1558	205151	872	0	213168
13446	1485	201175	5309	709	0	208678
13447	1830	5625	1378	202942	0	211775
13448	776	1672	202505	5323	0	210276
13449	196661	1004	5772	1961	0	205398
13450	6323	700	1564	199848	0	208435
13451	1691	664	199779	5781	0	207915
13452	1038	199261	5775	1850	0	207924
13453	195634	5516	1691	1825	0	204666
13454	5395	200292	1207	958	0	207852
13455	200332	6117	825	1233	0	208507
13456	204438	1877	666	1199	0	208180
13457	7545	1390	538	196381	0	205854
13458	2564	191225	713	5576	0	200078
13459	1744	5324	193299	1635	0	202002
13460	1905	1748	5498	192641	0	201792
13461	2999	1613	2344	170569	0	177525
13462	1546	834	1291	196599	0	200270
13463	1622	670	943	196944	0	200179
13464	1517	655	686	197912	0	200770
13465	191608	605	774	8666	0	201653
13466	187083	734	755	3893	0	192465
13467	187991	635	670	2839	0	192135
13468	7029	185960	730	1709	0	195428
13469	2898	5499	189322	1224	0	198943
13470	1959	1725	189626	1168	0	194478
13471	1395	1411	192600	1094	0	196500
13472	1864	1280	7463	184246	0	194853
13473	1684	879	2987	191649	0	197199
13474	1594	805	1854	192952	0	197205
13475	954	884	186184	8337	0	196359
13476	881	182128	6225	3767	0	193001
13477	942	5783	185148	2495	0	194368
13478	1138	1997	187899	1952	0	192986
13479	1866	1403	7401	181387	0	192057
13480	1182	1306	185482	6520	0	194490
13481	1826	1131	7120	181035	0	191112
13482	179738	1115	2765	7723	0	191341
13483	182210	1094	2028	3216	0	188548
13484	7789	1148	176900	2230	0	188067
13485	3624	1071	6575	175985	0	187255
13486	2349	1307	178092	7047	0	188795
13487	1724	178324	7123	3002	0	190173
13488	179083	6579	2846	2548	0	191056
13489	7044	2459	178161	1969	0	189633
13490	2615	170582	6952	1907	0	182056
13491	1999	172918	2844	1872	0	179633
13492	1667	171780	2210	1928	0	177585
13493	1855	8000	160291	1824	0	171970
13494	2267	4158	6610	151694	0	164729
13495	1681	156861	2640	6334	0	167516
13496	2278	6767	2067	156323	0	167435
13497	2197	2771	1948	161061	0	167977
13498	152741	2127	1912	8383	0	165163
13499	6247	153532	1835	4255	0	165869
13500	151088	6132	1969	3472	0	162661
13501	6880	148207	1836	2937	0	159860
13502	3203	155229	1728	2626	0	162786
13503	2649	7534	149199	2299	0	161681
13504	2573	3961	6584	147259	0	160377
13505	2163	2909	147283	6783	0	159138
13506	1997	144479	6956	3452	0	156884
13507	2189	6384	144747	2930	0	156250
13508	2397	2750	146494	2744	0	154385
13509	2018	144847	7561	2889	0	157315
13510	139484	6651	3625	2963	0	152723
13511	6063	143130	3000	2987	0	155180
13512	143393	6871	2689	3026	0	155979
13513	6749	3139	142608	3121	0	155617
13514	3149	2032	144439	3420	0	153040
13515	2208	141258	7781	3415	0	154662
13516	139891	6238	3540	3231	0	152900
13517	6781	140382	3004	2911	0	153078
13518	3614	6462	2874	141458	0	154408
13519	143058	3069	2590	6781	0	155498
13520	7223	2586	141675	3009	0	154493
13521	3103	2309	7453	142804	0	155669
13522	140443	1990	3619	7405	0	153457
13523	6736	140334	3205	3587	0	153862
13524	3141	6140	2740	142635	0	154656
13525	2298	2559	140385	7987	0	153229
13526	139670	2088	7019	4261	0	153038
13527	6272	2092	3610	141977	0	153951
13528	2254	1964	140013	7713	0	151944
13529	2080	1799	7370	137469	0	148718
13530	1887	137765	3586	7743	0	150981
13531	1741	6118	138239	4147	0	150245
13532	2394	2503	6794	136170	0	147861
13533	132366	1915	3248	7095	0	144624
13534	7060	1757	2698	130199	0	141714
13535	122495	1593	2362	6437	0	132887
13536	6125	121890	2401	3019	0	133435
13537	120160	5507	2680	2584	0	130931
13538	6057	2606	117743	2227	0	128633
13539	2832	2018	106074	1813	0	112737
13540	2181	1726	95958	1367	0	101232
13541	1738	89978	6385	1522	0	99623
13542	2587	1459	4801	41589	0	50436
13543	340	294	638	41092	0	42364
13544	198	183	215	40289	0	40885
13545	158	162	159	40969	0	41448
13546	131	143	40369	913	0	41556
13547	38811	120	674	424	0	40029
13548	663	40618	275	255	0	41811
13549	40493	642	156	217	0	41508
13550	714	277	146	40272	0	41409
13551	281	40578	139	625	0	41623
13552	230	715	133	41313	0	42391
13553	40779	276	184	739	0	41978
13554	589	42000	140	276	0	43005
13555	42062	677	137	231	0	43107
13556	41967	247	133	178	0	42525
13557	788	166	116	42121	0	43191
13558	284	162	41727	607	0	42780
13559	41381	186	647	289	0	42503
13560	674	147	206	43042	0	44069
13561	43482	119	143	718	0	44462
13562	44753	102	126	310	0	45291
13563	44753	101	104	230	0	45188
13564	855	132	44327	159	0	45473
13565	398	209	614	43702	0	44923
13566	44282	122	234	725	0	45363
13567	765	111	45153	259	0	46288
13568	292	45322	651	193	0	46458
13569	467	809	294	42130	0	43700
13570	152	212	44987	575	0	45926
13571	157	142	44064	223	0	44586
13572	254	322	683	43479	0	44738
13573	220	87	287	45234	0	45828
13574	142	64	159	45393	0	45758
13575	121	62	119	44738	0	45040
13576	117	63	44558	720	0	45458
13577	111	44695	539	286	0	45631
13578	142	513	198	45918	0	46771
13579	46508	161	118	646	0	47433
13580	45990	95	96	336	0	46517
13581	46540	72	84	232	0	46928
13582	722	109	79	46225	0	47135
13583	312	265	78	45616	0	46271
13584	181	43248	78	625	0	44132
13585	126	44959	86	261	0	45432
13586	369	727	143	43925	0	45164
13587	43152	320	177	717	0	44366
13588	43022	74	58	251	0	43405
13589	43028	35	48	163	0	43274
13590	43043	44	53	161	0	43301
13591	43378	37	39	150	0	43604
13592	460	43173	49	104	0	43786
13593	182	325	38	44384	0	44929
13594	45406	84	45	471	0	46006
13595	45995	44	47	236	0	46322
13596	479	46	33	45695	0	46253
13597	201	34	33	46194	0	46462
13598	133	52	46643	448	0	47276
13599	180	42	331	45370	0	45923
13600	127	65	104	46457	0	46753
13601	107	52	48079	468	0	48706
13602	171	100	304	47665	0	48240
13603	90	49157	115	393	0	49755
13604	109	324	49133	171	0	49737
13605	105	49577	324	130	0	50136
13606	189	364	132	48981	0	49666
13607	134	148	53	50058	0	50393
13608	66	48974	65	411	0	49516
13609	63	50086	64	160	0	50373
13610	51325	319	56	221	0	51921
13611	51100	97	39	194	0	51430
13612	403	86	50220	102	0	50811
13613	51559	37	282	244	0	52122
13614	54620	26	88	254	0	54988
13615	55081	29	48	209	0	55367
13616	54870	35	96	190	0	55191
13617	435	52	52673	96	0	53256
13618	294	118	49248	90	0	49750
13619	54593	48	343	191	0	55175
13620	328	55841	164	90	0	56423
13621	119	225	56311	61	0	56716
13622	56453	89	305	187	0	57034
13623	57255	38	87	176	0	57556
13624	340	71	56184	47	0	56642
13625	56743	55	284	127	0	57209
13626	400	37	105	62159	0	62701
13627	167	49	63967	325	0	64508
13628	60677	38	345	343	0	61403
13629	344	64140	169	138	0	64791
13630	66832	292	89	288	0	67501
13631	72935	102	70	527	0	73634
13632	492	53	53	73558	0	74156
13633	247	56	60	73299	0	73662
13634	150	36	52	75323	0	75561
13635	75279	34	40	677	0	76030
13636	77621	46	34	378	0	78079
13637	619	39	29	78169	0	78856
13638	353	30	28	77652	0	78063
13639	191	64	76375	617	0	77247
13640	74074	42	407	477	0	75000
13641	523	47	160	79396	0	80126
13642	309	41	64	79298	0	79712
13643	153	77741	80	758	0	78732
13644	201	471	26	79636	0	80334
13645	215	216	33	79353	0	79817
13646	78577	91	41	908	0	79617
13647	609	79162	63	388	0	80222
13648	378	515	21	81118	0	82032
13649	284	228	17	80737	0	81266
13650	245	117	25	81456	0	81843
13651	159	105	80616	869	0	81749
13652	256	71	509	79431	0	80267
13653	79911	45	224	946	0	81126
13654	674	91	79192	372	0	80329
13655	396	43	570	80954	0	81963
13656	263	38	236	82812	0	83349
13657	83007	39	143	1135	0	84324
13658	81549	36	100	683	0	82368
13659	881	83	81675	318	0	82957
13660	77688	67	607	466	0	78828
13661	794	146	81059	159	0	82158
13662	82322	61	640	449	0	83472
13663	850	87751	317	233	0	89151
13664	90812	739	157	421	0	92129
13665	979	91476	128	226	0	92809
13666	94642	959	149	463	0	96213
13667	1103	95655	98	237	0	97093
13668	552	1093	123	98726	0	100494
13669	467	356	64	99245	0	100132
13670	358	232	66	99107	0	99763
13671	188	96274	110	1555	0	98127
13672	257	975	94	98003	0	99329
13673	152	97897	115	1350	0	99514
13674	261	1120	62	100407	0	101850
13675	100690	378	92	1536	0	102696
13676	100003	243	71	764	0	101081
13677	1390	98541	110	446	0	100487
13678	746	1063	67	100638	0	102514
13679	99855	397	71	1444	0	101767
13680	1296	99901	111	538	0	101846
13681	524	101504	127	396	0	102551
13682	102353	1457	73	533	0	104416
13683	103126	634	58	460	0	104278
13684	1576	101933	103	251	0	103863
13685	102881	1314	48	403	0	104646
13686	1683	524	32	103141	0	105380
13687	659	460	105473	1283	0	107875
13688	105416	270	1191	886	0	107763
13689	107404	210	417	744	0	108775
13690	1859	232	106827	336	0	109254
13691	107782	222	1294	650	0	109948
13692	110296	190	461	686	0	111633
13693	113761	179	297	726	0	114963
13694	2044	111673	225	315	0	114257
13695	114403	1436	106	543	0	116488
13696	115671	569	112	569	0	116921
13697	2253	435	85	114941	0	117714
13698	1323	298	82	115953	0	117656
13699	860	261	80	117969	0	119170
13700	117457	224	86	2449	0	120216
13701	1883	263	83	116198	0	118427
13702	117004	247	60	2294	0	119605
13703	117787	239	104	1148	0	119278
13704	2410	224	98	117050	0	119782
13705	1356	259	96	119296	0	121007
13706	1049	220	106	120920	0	122295
13707	119994	268	83	2742	0	123087
13708	1947	118512	170	1196	0	121825
13709	1217	1664	104	122125	0	125110
13710	988	686	96	124326	0	126096
13711	122658	472	118	2846	0	126094
13712	123253	339	135	1599	0	125326
13713	2754	356	118690	859	0	122659
13714	1485	441	116964	682	0	119572
13715	126559	296	2316	850	0	130021
13716	2835	315	853	129626	0	133629
13717	1666	288	441	146852	0	149247
13718	1035	404	145751	4235	0	151425
13719	1050	553	3043	143827	0	148473
13720	747	143349	962	3957	0	149015
13721	698	150734	557	1576	0	153565
13722	147371	3900	312	1475	0	153058
13723	3731	1428	145638	901	0	151698
13724	1451	149738	2910	769	0	154868
13725	1576	3469	942	152127	0	158114
13726	946	1217	150415	3697	0	156275
13727	1227	783	3315	146221	0	151546
13728	1194	561	962	149743	0	152460
13729	862	483	148357	4598	0	154300
13730	786	147772	3436	1925	0	153919
13731	1076	3372	1045	144364	0	149857
13732	144849	1044	793	4187	0	150873
13733	146576	735	534	1806	0	149651
13734	146924	489	458	1452	0	149323
13735	4854	143019	514	997	0	149384
13736	143224	3301	433	1051	0	148009
13737	4514	1195	379	142652	0	148740
13738	1711	771	139908	3767	0	146157
13739	138832	591	3158	1802	0	144383
13740	3867	141399	1051	1207	0	147524
13741	1657	3189	687	142022	0	147555
13742	1382	1030	512	143082	0	146006
13743	955	139125	549	4312	0	144941
13744	1205	3487	398	144077	0	149167
13745	1201	1150	451	146239	0	149041
13746	1186	859	447	148948	0	151440
13747	143870	684	511	5307	0	150372
13748	144141	601	529	2739	0	148010
13749	4403	772	142821	1779	0	149775
13750	2165	784	3338	143034	0	149321
13751	1762	623	1092	148071	0	151548
13752	1418	667	923	149213	0	152221
13753	145216	727	691	5391	0	152025
13754	3983	722	140586	2470	0	147761
13755	139176	609	3364	2203	0	145352
13756	145319	553	1187	1940	0	148999
13757	4926	509	900	143814	0	150149
13758	144355	472	791	4625	0	150243
13759	4682	686	138109	2097	0	145574
13760	139053	565	3133	2189	0	144940
13761	4595	150526	1219	1645	0	157985
13762	2171	3437	148407	1318	0	155333
13763	1652	1318	148612	1482	0	153064
13764	2020	1847	4349	145540	0	153756
13765	1445	743	148470	4135	0	154793
13766	143099	791	4008	2240	0	150138
13767	3849	143405	1460	1658	0	150372
13768	144588	3342	1039	1721	0	150690
13769	4283	1259	757	145865	0	152164
13770	1735	926	144728	4295	0	151684
13771	1391	762	143975	2212	0	148340
13772	1433	1042	3904	146266	0	152645
13773	147271	577	1590	4781	0	154219
13774	3696	142893	1089	2427	0	150105
13775	1562	149057	889	2127	0	153635
13776	148399	3703	856	2061	0	155019
13777	3934	148864	842	1654	0	155294
13778	150196	3673	792	1594	0	156255
13779	4677	1542	721	149140	0	156080
13780	149054	913	697	4203	0	154867
13781	4559	667	830	149026	0	155082
13782	149952	614	825	4535	0	155926
13783	4421	528	873	148864	0	154686
13784	2052	146232	967	4226	0	153477
13785	147982	3046	746	2290	0	154064
13786	3968	146787	779	1816	0	153350
13787	1941	3485	141458	1288	0	148172
13788	1804	1573	3309	137732	0	144418
13789	1279	143835	1349	3369	0	149832
13790	140224	3319	950	1774	0	146267
13791	140867	1335	942	1529	0	144673
13792	4369	139136	904	1150	0	145559
13793	1871	3404	138086	1092	0	144453
13794	1742	1242	3312	135272	0	141568
13795	1289	132823	1476	3578	0	139166
13796	1361	3235	1134	139599	0	145329
13797	1540	1180	897	141007	0	144624
13798	137822	1088	722	4500	0	144132
13799	3685	136166	759	2052	0	142662
13800	1824	3170	648	139455	0	145097
13801	139130	1378	553	4159	0	145220
13802	139750	1044	587	2100	0	143481
13803	139134	899	630	1722	0	142385
13804	4862	915	574	136026	0	142377
13805	134882	743	608	3677	0	139910
13806	4172	133372	654	1604	0	139802
13807	133521	3012	608	1626	0	138767
13808	3779	133698	556	1382	0	139415
13809	134395	3131	606	1545	0	139677
13810	134599	1160	546	1463	0	137768
13811	4472	1851	693	130778	0	137794
13812	2139	781	131870	3215	0	138005
13813	2015	839	127199	1358	0	131411
13814	1439	130394	2730	1102	0	135665
13815	125922	2766	1506	1374	0	131568
13816	3127	1128	123699	709	0	128663
13817	100293	562	1183	535	0	102573
13818	1398	101710	426	259	0	103793
13819	651	105112	307	302	0	106372
13820	726	1578	258	107742	0	110304
13821	431	109175	234	1118	0	110958
13822	458	1526	111506	523	0	114013
13823	746	770	1363	108804	0	111683
13824	374	113655	476	1519	0	116024
13825	504	1730	290	115886	0	118410
13826	115286	669	187	2264	0	118406
13827	2104	574	190	115581	0	118449
13828	770	445	116651	2233	0	120099
13829	625	117051	1834	895	0	120405
13830	677	2139	624	118137	0	121577
13831	679	788	470	119683	0	121620
13832	551	618	369	121495	0	123033
13833	118205	517	325	3162	0	122209
13834	117277	361	235	1712	0	119585
13835	2708	454	116304	888	0	120354
13836	1324	417	114101	664	0	116506
13837	807	116494	2373	653	0	120327
13838	119364	2076	929	833	0	123202
13839	2518	779	626	119584	0	123507
13840	1097	612	485	120380	0	122574
13841	1008	458	332	121290	0	123088
13842	928	393	206	121599	0	123126
13843	730	408	116322	3290	0	120750
13844	113926	372	2012	1802	0	118112
13845	2762	357	640	128185	0	131944
13846	1168	393	126845	3162	0	131568
13847	128351	392	2829	1698	0	133270
13848	141693	303	1095	1272	0	144363
13849	4584	413	155207	769	0	160973
13850	2440	381	161849	553	0	165223
13851	1988	352	5201	160136	0	167677
13852	162984	295	2029	4959	0	170267
13853	166879	252	1287	2120	0	170538
13854	6273	398	930	160603	0	168204
13855	3060	312	935	165853	0	170160
13856	1634	420	162432	5917	0	170403
13857	1850	779	4663	160483	0	167775
13858	1384	387	160666	5824	0	168261
13859	154172	388	5021	2895	0	162476
13860	4890	159567	2092	1962	0	168511
13861	152694	3970	1211	1698	0	159573
13862	4955	152128	1026	1119	0	159228
13863	152022	4622	1181	1199	0	159024
13864	5960	1664	711	147561	0	155896
13865	3102	1026	639	150980	0	155747
13866	149563	809	473	5992	0	156837
13867	151845	638	405	2716	0	155604
13868	152622	554	446	1915	0	155537
13869	153827	469	383	1457	0	156136
13870	7256	440	145658	1188	0	154542
13871	146611	297	4215	1465	0	152588
13872	152191	328	1518	1269	0	155306
13873	152662	259	1082	1008	0	155011
13874	8040	241	766	145871	0	154918
13875	143183	239	736	5197	0	149355
13876	6501	139939	944	2102	0	149486
13877	3983	3937	840	142347	0	151107
13878	3423	1343	760	146306	0	151832
13879	2443	985	140127	6426	0	149981
13880	2596	656	4602	138761	0	146615
13881	1952	139823	1966	6207	0	149948
13882	139482	4483	1339	3485	0	148789
13883	5590	140468	1210	2637	0	149905
13884	142189	5038	959	2707	0	150893
13885	6654	2030	1000	141577	0	151261
13886	139906	1379	944	6190	0	148419
13887	6310	137230	994	2995	0	147529
13888	140074	4931	879	2513	0	148397
13889	143210	2242	881	1977	0	148310
13890	8020	1611	750	138216	0	148597
13891	4601	1312	637	142550	0	149100
13892	3563	1159	136195	6786	0	147703
13893	3323	1074	4291	138317	0	147005
13894	3150	868	1650	140885	0	146553
13895	2866	717	135615	7537	0	146735
13896	2855	606	4852	138572	0	146885
13897	2487	587	135604	7064	0	145742
13898	135046	515	5500	3774	0	144835
13899	6701	524	2478	135766	0	145469
13900	3691	622	131810	6413	0	142536
13901	133131	578	5219	3352	0	142280
13902	7060	610	2319	134454	0	144443
13903	3827	662	133601	6473	0	144563
13904	135082	539	5153	3766	0	144540
13905	6823	618	2284	136475	0	146200
13906	3800	632	1737	139529	0	145698
13907	137002	663	1404	7854	0	146923
13908	6898	666	1194	136406	0	145164
13909	3834	695	1281	139406	0	145216
13910	3273	797	1168	135763	0	141001
13911	2834	131479	959	8049	0	143321
13912	129147	4680	931	4703	0	139461
13913	132847	1979	833	3587	0	139246
13914	7830	1484	745	129141	0	139200
13915	130158	1083	750	6937	0	138928
13916	131690	979	736	4188	0	137593
13917	133006	964	857	3248	0	138075
13918	108255	1081	1462	3832	0	114630
13919	129294	649	1210	2902	0	134055
13920	8598	636	116163	2763	0	128160
13921	4812	697	112939	2609	0	121057
13922	113210	662	5245	2394	0	121511
13923	6536	109629	2669	2450	0	121284
13924	3708	3679	1902	108212	0	117501
13925	2896	1368	106841	5323	0	116428
13926	2578	946	107773	2960	0	114257
13927	2679	1683	5412	105415	0	115189
13928	105341	1066	3350	5595	0	115352
13929	5354	753	1648	106091	0	113846
13930	2962	814	104406	5452	0	113634
13931	108276	506	4206	3478	0	116466
13932	5407	498	2201	109543	0	117649
13933	3266	370	1548	112548	0	117732
13934	2786	320	1123	114107	0	118336
13935	2627	327	1004	112886	0	116844
13936	2439	379	106042	6931	0	115791
13937	2568	343	3740	108792	0	115443
13938	107506	385	1691	6191	0	115773
13939	5011	414	101736	4010	0	111171
13940	104917	470	3665	3230	0	112282
13941	109777	431	1664	2717	0	114589
13942	109487	465	1349	2524	0	113825
13943	107961	387	1122	2422	0	111892
13944	6829	100692	990	2260	0	110771
13945	3225	90858	780	1554	0	96417
13946	2749	93986	912	1454	0	99101
13947	86995	4298	2703	2270	0	96266
13948	4102	1217	79469	1395	0	86183
13949	58823	1056	2087	724	0	62690
13950	2017	279	671	55968	0	58935
13951	55995	155	335	1299	0	57784
13952	1347	106	219	55830	0	57502
13953	55969	101	225	1460	0	57755
13954	1411	85	195	55750	0	57441
13955	898	106	183	57292	0	58479
13956	53730	72	240	1617	0	55659
13957	1350	59245	215	822	0	61632
13958	823	813	59019	520	0	61175
13959	689	57900	892	520	0	60001
13960	492	747	55600	345	0	57184
13961	574	764	858	52568	0	54764
13962	53783	171	585	791	0	55330
13963	721	145	180	52803	0	53849
13964	52407	76	149	789	0	53421
13965	792	54611	151	360	0	55914
13966	469	516	55431	276	0	56692
13967	345	54633	556	245	0	55779
13968	300	55379	255	220	0	56154
13969	53544	491	349	224	0	54608
13970	52386	156	183	215	0	52940
13971	549	52403	106	155	0	53213
13972	283	393	77	53358	0	54111
13973	204	132	85	53764	0	54185
13974	53841	81	73	673	0	54668
13975	550	78	54025	261	0	54914
13976	254	101	52352	199	0	52906
13977	229	64	535	53934	0	54762
13978	174	96	54589	539	0	55398
13979	52713	66	528	341	0	53648
13980	55103	60	169	267	0	55599
13981	643	54654	136	162	0	55595
13982	309	473	56375	127	0	57284
13983	323	177	498	56167	0	57165
13984	231	124	59718	545	0	60618
13985	291	89	515	59322	0	60217
13986	60240	88	204	755	0	61287
13987	613	61261	160	289	0	62323
13988	309	584	63471	166	0	64530
13989	218	63816	595	199	0	64828
13990	208	66961	258	180	0	67607
13991	68259	710	156	320	0	69445
13992	67086	234	135	294	0	67749
13993	855	172	67423	187	0	68637
13994	378	69180	642	225	0	70425
13995	300	652	240	70572	0	71764
13996	296	212	173	70631	0	71312
13997	279	159	113	69888	0	70439
13998	228	112	71155	894	0	72389
13999	314	114	634	70369	0	71431
14000	248	116	253	73788	0	74405
14001	74444	97	179	1084	0	75804
14002	74636	109	124	611	0	75480
14003	74530	94	139	476	0	75239
14004	73641	116	128	372	0	74257
14005	73613	132	127	361	0	74233
14006	958	72348	149	207	0	73662
14007	72038	612	79	264	0	72993
14008	846	258	71260	112	0	72476
14009	484	401	553	70675	0	72113
14010	72103	131	214	710	0	73158
14011	671	71605	164	255	0	72695
14012	73330	571	105	358	0	74364
14013	74720	208	95	358	0	75381
14014	814	146	105	75380	0	76445
14015	431	141	69	75398	0	76039
14016	278	77946	148	796	0	79168
14017	315	593	86	80711	0	81705
14018	228	283	82398	771	0	83680
14019	380	176	656	83351	0	84563
14020	198	149	83836	864	0	85047
14021	80460	123	859	576	0	82018
14022	1006	166	331	85353	0	86856
14023	423	132	86560	910	0	88025
14024	279	83401	924	457	0	85061
14025	224	85941	384	273	0	86822
14026	86164	989	321	368	0	87842
14027	988	485	204	86150	0	87827
14028	396	230	90512	758	0	91896
14029	212	88723	761	404	0	90100
14030	282	769	90377	177	0	91605
14031	87565	326	791	440	0	89122
14032	89588	163	334	328	0	90413
14033	90400	113	179	291	0	90983
14034	1118	118	145	90481	0	91862
14035	472	146	89878	756	0	91252
14036	284	89737	813	378	0	91212
14037	333	670	305	92621	0	93929
14038	220	325	90472	799	0	91816
14039	250	297	86990	329	0	87866
14040	292	124	946	91351	0	92713
14041	93214	87	391	1044	0	94736
14042	853	86	255	93191	0	94385
14043	440	105	198	94745	0	95488
14044	245	126	95343	1055	0	96769
14045	424	99	795	94972	0	96290
14046	345	75	330	95414	0	96164
14047	231	130	96670	1124	0	98155
14048	216	177	94033	492	0	94918
14049	291	94	1026	96259	0	97670
14050	190	161	98239	944	0	99534
14051	279	95	930	97954	0	99258
14052	98691	87	432	1284	0	100494
14053	783	100741	342	553	0	102419
14054	450	732	261	103847	0	105290
14055	268	309	101613	972	0	103162
14056	92756	166	889	876	0	94687
14057	832	96514	420	369	0	98135
14058	99035	737	256	576	0	100604
14059	994	306	228	99092	0	100620
14060	510	190	223	98830	0	99753
14061	100698	135	187	1533	0	102553
14062	971	173	100806	513	0	102463
14063	99166	100	887	633	0	100786
14064	1029	92	393	102734	0	104248
14065	100372	67	278	1250	0	101967
14066	100308	97	255	770	0	101430
14067	1408	121	192	101027	0	102748
14068	584	102551	268	1148	0	104551
14069	106160	1010	221	877	0	108268
14070	107254	362	184	720	0	108520
14071	1732	252	107309	300	0	109593
14072	106296	190	1180	512	0	108178
14073	1731	199	515	108259	0	110704
14074	737	107993	381	1326	0	110437
14075	680	1209	278	108393	0	110560
14076	424	107923	276	1325	0	109948
14077	109005	1358	211	971	0	111545
14078	110732	539	228	708	0	112207
14079	1988	345	143	115674	0	118150
14080	887	273	113786	1684	0	116630
14081	701	312	111563	833	0	113409
14082	648	182	2055	117894	0	120779
14083	118751	168	989	2264	0	122172
14084	125061	124	519	1316	0	127020
14085	2747	125365	450	650	0	129212
14086	1478	2103	292	126988	0	130861
14087	813	880	129208	2420	0	133321
14088	587	606	131099	1156	0	133448
14089	837	688	3557	140594	0	145676
14090	151495	257	1693	4145	0	157590
14091	4226	145	732	154460	0	159563
14092	1523	206	151204	4534	0	157467
14093	151795	114	3911	2152	0	157972
14094	4514	162	1516	152392	0	158584
14095	2091	151	1059	155412	0	158713
14096	1588	151	594	154823	0	157156
14097	825	150410	576	5882	0	157693
14098	748	3572	150854	2653	0	157827
14099	656	1359	152999	1758	0	156772
14100	966	804	5104	153383	0	160257
14101	573	490	154324	4534	0	159921
14102	150682	307	4994	2424	0	158407
14103	4616	286	1944	153427	0	160273
14104	2084	343	1350	155275	0	159052
14105	1543	295	967	155529	0	158334
14106	807	152005	967	6226	0	160005
14107	155867	3810	780	3367	0	163824
14108	4629	1353	628	156791	0	163401
14109	154969	899	622	5642	0	162132
14110	4866	154705	573	2557	0	162701
14111	155452	4200	617	2236	0	162505
14112	152133	1540	652	2079	0	156404
14113	156259	1019	551	1863	0	159692
14114	6429	147429	641	1379	0	155878
14115	3103	151233	583	1240	0	156159
14116	147315	4999	508	1539	0	154361
14117	4976	148214	578	1182	0	154950
14118	2296	4933	143671	1105	0	152005
14119	1686	138665	3838	1219	0	145408
14120	1268	146008	1593	954	0	149823
14121	143820	5106	1187	1199	0	151312
14122	4589	2453	140629	776	0	148447
14123	2188	1650	139002	682	0	143522
14124	2113	1203	4993	137971	0	146280
14125	141195	875	2361	4548	0	148979
14126	4770	819	140202	1834	0	147625
14127	2519	813	4244	140479	0	148055
14128	1586	899	134460	4597	0	141542
14129	1342	918	131513	2168	0	135941
14130	129495	781	5243	1876	0	137395
14131	4656	793	133696	1017	0	140162
14132	2481	697	4993	131089	0	139260
14133	2077	725	2146	132096	0	137044
14134	1365	128359	1700	5225	0	136649
14135	1354	134049	1266	2568	0	139237
14136	1453	4816	1169	130374	0	137812
14137	1147	2234	130724	4708	0	138813
14138	1341	1567	4244	131395	0	138547
14139	1174	1136	2017	135479	0	139806
14140	953	941	133346	5935	0	141175
14141	1092	786	4565	135011	0	141454
14142	134907	752	2377	6008	0	144044
14143	4448	853	133161	2796	0	141258
14144	132902	729	4711	2473	0	140815
14145	5396	652	2391	133934	0	142373
14146	2650	533	1801	138507	0	143491
14147	1815	136104	1519	6402	0	145840
14148	1672	4311	1426	139525	0	146934
14149	1583	1694	1278	145411	0	149966
14150	140943	1258	1465	7318	0	150984
14151	5086	822	1374	143328	0	150610
14152	2554	800	1187	146542	0	151083
14153	138582	836	1312	7659	0	148389
14154	5394	784	1366	141208	0	148752
14155	2772	821	1358	137728	0	142679
14156	1863	136677	1413	7268	0	147221
14157	138699	4374	1337	4469	0	148879
14158	5512	1885	1008	140142	0	148547
14159	2620	1504	1002	143872	0	148998
14160	2222	1104	136917	7515	0	147758
14161	1789	975	4589	138316	0	145669
14162	1574	830	2235	142628	0	147267
14163	135279	752	1534	8062	0	145627
14164	137937	893	1161	4715	0	144706
14165	6505	953	1078	137561	0	146097
14166	3296	994	131988	6351	0	142629
14167	2454	125591	4542	3453	0	136040
14168	1797	131175	2269	2946	0	138187
14169	2284	5180	1891	130237	0	139592
14170	129333	2237	1186	6071	0	138827
14171	5096	1655	858	131284	0	138893
14172	131482	1186	564	6454	0	139686
14173	5501	1085	697	133283	0	140566
14174	2911	984	751	135364	0	140010
14175	130116	1104	625	7005	0	138850
14176	130200	1155	680	3806	0	135841
14177	6330	126856	707	2754	0	136647
14178	3260	133902	660	2308	0	140130
14179	2202	4863	722	125138	0	132925
14180	1890	2351	667	128150	0	133058
14181	1829	1518	121171	5408	0	129926
14182	113090	1161	3623	3361	0	121235
14183	4187	116640	1519	2441	0	124787
14184	1523	113121	1044	1654	0	117342
14185	109430	3358	1527	1741	0	116056
14186	3770	1380	108108	1294	0	114552
14187	1756	1090	103824	1187	0	107857
14188	1700	1097	96131	1095	0	100023
14189	797	88612	2295	727	0	92431
14190	876	970	1249	78862	0	81957
14191	288	292	244	78815	0	79639
14192	309	207	157	79536	0	80209
14193	77480	130	133	1580	0	79323
14194	77104	147	121	838	0	78210
14195	1152	77000	139	461	0	78752
14196	520	957	118	79097	0	80692
14197	361	372	79141	1123	0	80997
14198	272	79186	942	489	0	80889
14199	78173	977	304	696	0	80150
14200	1050	354	78234	348	0	79986
14201	71723	253	876	598	0	73450
14202	1035	203	77102	318	0	78658
14203	487	536	867	75156	0	77046
14204	297	77118	323	1000	0	78738
14205	78124	801	229	703	0	79857
14206	897	78394	189	400	0	79880
14207	77240	929	154	512	0	78835
14208	1039	344	125	77151	0	78659
14209	438	270	78735	1091	0	80534
14210	489	200	833	80381	0	81903
14211	407	181	273	87497	0	88358
14212	294	250	86452	1671	0	88667
14213	83081	168	1305	1033	0	85587
14214	1443	88730	433	539	0	91145
14215	88817	1390	214	661	0	91082
14216	1564	89894	224	434	0	92116
14217	672	1565	164	93153	0	95554
14218	432	526	91461	1767	0	94186
14219	103788	311	1598	989	0	106686
14220	2332	108469	495	569	0	111865
14221	1029	2319	255	108422	0	112025
14222	805	744	189	113219	0	114957
14223	116441	542	168	3360	0	120511
14224	122798	303	165	1560	0	124826
14225	3463	124138	222	847	0	128670
14226	132435	2963	216	818	0	136432
14227	134751	1001	186	743	0	136681
14228	136903	698	169	770	0	138540
14229	5086	455	134634	413	0	140588
14230	2180	130810	3273	559	0	136822
14231	1236	138895	1208	508	0	141847
14232	1279	4294	699	131305	0	137577
14233	1149	1788	361	137019	0	140317
14234	135698	1020	269	4730	0	141717
14235	3752	134864	318	1979	0	140913
14236	136689	3707	225	1361	0	141982
14237	4601	1552	219	134363	0	140735
14238	2128	989	208	138212	0	141537
14239	134086	615	220	5087	0	140008
14240	133916	506	263	2413	0	137098
14241	5053	577	128998	1269	0	135897
14242	2713	827	3309	128641	0	135490
14243	1499	479	127194	3723	0	132895
14244	1115	544	125655	1662	0	128976
14245	1099	545	127339	1010	0	129993
14246	122089	755	5027	1009	0	128880
14247	3909	471	2017	121003	0	127400
14248	1935	330	1047	121989	0	125301
14249	1481	352	665	125130	0	127628
14250	881	369	121670	4852	0	127772
14251	1165	330	3252	121905	0	126652
14252	1140	309	1348	125521	0	128318
14253	121608	288	828	5125	0	127849
14254	123378	337	558	2566	0	126839
14255	125412	259	494	1626	0	127791
14256	125917	347	525	1161	0	127950
14257	6032	368	431	121005	0	127836
14258	122948	417	476	4117	0	127958
14259	5081	493	428	122294	0	128296
14260	2470	590	114208	4458	0	121726
14261	118650	457	2976	2476	0	124559
14262	4508	118638	1250	1681	0	126077
14263	2666	3328	767	118677	0	125438
14264	2171	1744	538	119737	0	124190
14265	1587	119882	531	4668	0	126668
14266	119002	3625	479	2666	0	125772
14267	4417	118187	449	1796	0	124849
14268	2428	3934	116763	1333	0	124458
14269	1976	1802	117844	1196	0	122818
14270	115840	1250	4474	1356	0	122920
14271	119358	866	2060	1437	0	123721
14272	5257	741	115296	1162	0	122456
14273	115322	663	3730	1385	0	121100
14274	5069	651	115057	1147	0	121924
14275	115285	598	4133	1397	0	121413
14276	5109	630	114923	1278	0	121940
14277	2800	639	116302	1336	0	121077
14278	2367	621	4810	108838	0	116636
14279	2074	588	2551	111583	0	116796
14280	112457	558	1680	5387	0	120082
14281	111291	522	1289	3171	0	116273
14282	113463	547	1135	2273	0	117418
14283	116042	533	1142	1858	0	119575
14284	6255	109797	1106	1551	0	118709
14285	3731	3292	976	109285	0	117284
14286	2774	110384	1018	4273	0	118449
14287	2457	3717	998	112000	0	119172
14288	2229	1590	1040	112454	0	117313
14289	2124	1136	946	112854	0	117060
14290	1966	897	106927	6113	0	115903
14291	104953	711	3719	3631	0	113014
14292	4772	102378	1863	2658	0	111671
14293	2943	108098	1331	2147	0	114519
14294	2464	4404	107342	1859	0	116069
14295	2255	2157	3821	107151	0	115384
14296	2149	1299	1966	108876	0	114290
14297	106685	904	1444	5731	0	114764
14298	4963	835	1177	106716	0	113691
14299	2976	803	1099	109011	0	113889
14300	2415	727	1150	109926	0	114218
14301	2067	707	1189	111058	0	115021
14302	105540	595	1214	6479	0	113828
14303	108084	607	1315	3502	0	113508
14304	109170	593	1247	2499	0	113509
14305	6320	557	1337	106780	0	114994
14306	107783	495	1216	5048	0	114542
14307	5546	554	1216	108858	0	116174
14308	3474	648	1334	112362	0	117818
14309	2699	438	105451	5999	0	114587
14310	2223	419	103875	3280	0	109797
14311	1972	374	99931	2290	0	104567
14312	97434	588	5205	1923	0	105150
14313	4695	828	2755	91598	0	99876
14314	2742	94340	1679	3871	0	102632
14315	97068	2832	1331	2403	0	103634
14316	4487	1271	93434	2047	0	101239
14317	90836	865	3410	1797	0	96908
14318	4595	87885	1821	1563	0	95864
14319	74472	1906	956	940	0	78274
14320	3385	1244	610	72806	0	78045
14321	72404	550	606	2522	0	76082
14322	2886	69048	555	1501	0	73990
14323	1678	68236	504	1085	0	71503
14324	60151	1892	748	786	0	63577
14325	1869	60042	497	663	0	63071
14326	602	49416	282	372	0	50672
14327	712	49828	505	362	0	51407
14328	46819	1295	1129	350	0	49593
14329	45312	428	246	231	0	46217
14330	45457	258	85	164	0	45964
14331	1120	192	63	44375	0	45750
14332	496	184	67	45005	0	45752
14333	337	170	44104	912	0	45523
14334	365	124	689	44372	0	45550
14335	292	119	44758	868	0	46037
14336	346	104	734	44691	0	45875
14337	293	102	255	45652	0	46302
14338	44914	100	183	1087	0	46284
14339	44950	107	155	543	0	45755
14340	945	44561	155	310	0	45971
14341	457	732	147	44759	0	46095
14342	300	315	45989	829	0	47433
14343	353	201	715	46096	0	47365
14344	362	160	249	46772	0	47543
14345	328	141	144	47357	0	47970
14346	264	149	46150	1071	0	47634
14347	240	148	44316	502	0	45206
14348	45315	84	888	433	0	46720
14349	808	129	357	46503	0	47797
14350	318	84	46241	926	0	47569
14351	44600	63	766	564	0	45993
14352	770	46403	346	372	0	47891
14353	47173	670	285	370	0	48498
14354	914	266	48184	248	0	49612
14355	47577	161	696	311	0	48745
14356	871	203	283	48099	0	49456
14357	412	151	48801	720	0	50084
14358	295	47043	673	1669	0	49680
14359	48658	679	410	364	0	50111
14360	787	346	255	48309	0	49697
14361	408	154	223	48607	0	49392
14362	262	48762	171	860	0	50055
14363	256	598	149	49452	0	50455
14364	199	291	48934	800	0	50224
14365	192	48526	647	413	0	49778
14366	48879	623	260	367	0	50129
14367	724	284	193	48538	0	49739
14368	372	196	141	48493	0	49202
14369	271	165	47769	822	0	49027
14370	292	258	619	47985	0	49154
14371	260	180	49858	769	0	51067
14372	234	49979	682	361	0	51256
14373	49579	650	394	408	0	51031
14374	49505	244	232	349	0	50330
14375	49378	174	179	313	0	50044
14376	776	51062	177	242	0	52257
14377	420	615	170	51632	0	52837
14378	328	251	123	51952	0	52654
14379	438	259	186	46083	0	46966
14380	51334	137	101	928	0	52500
14381	51302	122	104	496	0	52024
14382	836	106	90	51192	0	52224
14383	372	149	54402	783	0	55706
14384	314	116	577	54369	0	55376
14385	273	84	233	55225	0	55815
14386	248	75	175	55259	0	55757
14387	276	100	139	55419	0	55934
14388	55406	99	131	1076	0	56712
14389	723	82	134	56467	0	57406
14390	337	103	126	56728	0	57294
14391	227	56374	102	1032	0	57735
14392	243	641	80	58213	0	59177
14393	209	59193	83	1008	0	60493
14394	257	818	69	60111	0	61255
14395	59629	272	70	1149	0	61120
14396	779	60182	123	544	0	61628
14397	60365	818	78	514	0	61775
14398	975	302	60632	316	0	62225
14399	465	197	768	60601	0	62031
14400	275	149	62026	1005	0	63455
14401	303	151	881	62029	0	63364
14402	261	277	305	61978	0	62821
14403	204	60429	265	1161	0	62059
14404	188	61754	190	553	0	62685
14405	137	63312	131	380	0	63960
14406	62329	807	161	477	0	63774
14407	646	60030	114	263	0	61053
14408	179	59916	76	229	0	60400
14409	656	671	183	60211	0	61721
14410	60488	171	74	717	0	61450
14411	518	63064	63	237	0	63882
14412	64243	540	43	327	0	65153
14413	64524	143	40	273	0	64980
14414	672	153	65719	123	0	66667
14415	340	120	523	64898	0	65881
14416	209	80	138	67595	0	68022
14417	140	95	86	68055	0	68376
14418	192	99	56	66933	0	67280
14419	108	109	65245	740	0	66202
14420	171	209	58985	302	0	59667
14421	61589	84	555	298	0	62526
14422	510	63650	167	128	0	64455
14423	136	64452	103	121	0	64812
14424	65002	582	80	224	0	65888
14425	511	64138	67	117	0	64833
14426	219	569	52	65667	0	66507
14427	65889	169	50	685	0	66793
14428	593	153	65041	190	0	65977
14429	256	88	509	66169	0	67022
14430	139	105	66681	613	0	67538
14431	65703	75	570	365	0	66713
14432	627	122	71755	167	0	72671
14433	72852	73	613	337	0	73875
14434	76348	88	181	356	0	76973
14435	76772	79	115	273	0	77239
14436	77100	95	82	285	0	77562
14437	77583	83	55	233	0	77954
14438	857	90	74	77285	0	78306
14439	80178	85	69	937	0	81269
14440	783	76	71	80735	0	81665
14441	320	91	77	80822	0	81310
14442	230	95	66	81316	0	81707
14443	193	142	80461	826	0	81622
14444	258	109	588	79304	0	80259
14445	218	102	174	82150	0	82644
14446	197	125	80050	787	0	81159
14447	75096	87	620	507	0	76310
14448	775	88	183	81998	0	83044
14449	295	98	81724	718	0	82835
14450	255	129	78957	267	0	79608
14451	250	172	718	79490	0	80630
14452	189	80	82009	732	0	83010
14453	258	201	665	82187	0	83311
14454	277	74	210	82007	0	82568
14455	148	81098	187	817	0	82250
14456	138	82784	143	366	0	83431
14457	83719	660	102	431	0	84912
14458	692	211	104	84597	0	85604
14459	320	120	120	83618	0	84178
14460	227	90	94	86097	0	86508
14461	169	121	86405	900	0	87595
14462	235	86	640	84673	0	85634
14463	86077	95	215	1014	0	87401
14464	744	140	86899	361	0	88144
14465	374	84	683	89640	0	90781
14466	319	93	224	90611	0	91247
14467	247	59	144	92209	0	92659
14468	126	94869	203	1004	0	96202
14469	96476	894	102	650	0	98122
14470	99483	263	154	479	0	100379
14471	1444	100775	165	291	0	102675
14472	645	1125	99	106510	0	108379
14473	348	377	106107	1446	0	108278
14474	343	305	102285	592	0	103525
14475	107642	136	1896	556	0	110230
14476	1900	119	703	110327	0	113049
14477	114502	97	431	2022	0	117052
14478	2298	115080	322	800	0	118500
14479	896	118631	252	591	0	120370
14480	118431	2603	172	689	0	121895
14481	2266	121793	247	401	0	124707
14482	1181	2519	167	123840	0	127707
14483	932	947	171	121038	0	123088
14484	489	125648	227	2654	0	129018
14485	127323	2456	171	1489	0	131439
14486	2553	1147	127103	744	0	131547
14487	124195	740	2225	879	0	128039
14488	3078	526	129093	452	0	133149
14489	121627	424	2648	765	0	125464
14490	3128	463	129994	467	0	134052
14491	1306	127448	2877	455	0	132086
14492	1451	2826	1247	128981	0	134505
14493	128239	952	828	2681	0	132700
14494	2758	610	126099	928	0	130395
14495	1267	429	126524	599	0	128819
14496	1209	441	3083	123259	0	127992
14497	639	305	128161	2506	0	131611
14498	874	318	2861	125266	0	129319
14499	939	315	1287	123222	0	125763
14500	563	287	127247	3268	0	131365
14501	871	174	2740	125626	0	129411
14502	129278	186	1351	3318	0	134133
14503	2421	127958	1024	1479	0	132882
14504	131221	2229	719	1338	0	135507
14505	3011	891	626	129228	0	133756
14506	129843	562	519	3124	0	134048
14507	132655	382	519	1722	0	135278
14508	3672	365	564	131962	0	136563
14509	1719	132123	584	2676	0	137102
14510	134938	2301	465	1690	0	139394
14511	3045	998	129481	944	0	134468
14512	1490	697	128175	881	0	131243
14513	127762	459	3083	1051	0	132355
14514	3136	402	1467	128949	0	133954
14515	1529	378	129785	2745	0	134437
14516	1300	380	2660	129420	0	133760
14517	131284	407	1233	3293	0	136217
14518	134448	365	962	1809	0	137584
14519	134628	290	761	1459	0	137138
14520	3855	135783	723	873	0	141234
14521	2215	2351	482	139142	0	144190
14522	1535	1009	470	140528	0	143542
14523	138667	723	494	3747	0	143631
14524	3112	137086	498	1806	0	142502
14525	138636	2517	474	1447	0	143074
14526	3558	1131	499	137864	0	143052
14527	137709	821	457	3184	0	142171
14528	3470	789	131294	1465	0	137018
14529	1791	132365	2500	1274	0	137930
14530	1730	2668	1148	131619	0	137165
14531	1227	135879	870	2445	0	140421
14532	1344	2788	590	133785	0	138507
14533	132542	1236	556	3368	0	137702
14534	3150	1041	126707	1490	0	132388
14535	125190	677	2535	1534	0	129936
14536	3209	130325	1296	1064	0	135894
14537	1800	2572	888	134556	0	139816
14538	1492	1246	670	136805	0	140213
14539	132422	913	618	3889	0	137842
14540	3215	790	130040	1851	0	135896
14541	1884	617	2511	132845	0	137857
14542	1540	553	1264	133910	0	137267
14543	1255	605	954	134362	0	137176
14544	1155	616	725	135165	0	137661
14545	131688	547	695	4611	0	137541
14546	131622	497	626	2722	0	135467
14547	3811	534	130288	1657	0	136290
14548	2186	654	124614	1461	0	128915
14549	131869	447	3166	1788	0	137270
14550	137099	451	1561	1626	0	140737
14551	3882	446	1075	135603	0	141006
14552	2284	395	861	135972	0	139512
14553	133605	392	787	4047	0	138831
14554	3315	131077	915	2181	0	137488
14555	1941	2126	864	134357	0	139288
14556	1604	869	755	136657	0	139885
14557	1418	656	131689	3986	0	137749
14558	1454	465	2548	132185	0	136652
14559	1226	501	132940	3889	0	138556
14560	1322	418	2920	133218	0	137878
14561	131630	375	1425	4084	0	137514
14562	3336	434	1062	132905	0	137737
14563	1894	416	130574	3836	0	136720
14564	1459	124410	2801	2289	0	130959
14565	1424	2504	1353	130749	0	136030
14566	1238	979	129551	3489	0	135257
14567	1206	128999	2678	2071	0	134954
14568	1383	2773	1194	128206	0	133556
14569	1051	1105	126024	3159	0	131339
14570	108125	804	2411	2358	0	113698
14571	2330	120509	1287	1518	0	125644
14572	1121	116798	866	1111	0	119896
14573	928	120264	712	999	0	122903
14574	1364	3247	768	116070	0	121449
14575	734	956	118475	2309	0	122474
14576	617	116696	2013	1270	0	120596
14577	1081	2684	908	114912	0	119585
14578	120068	636	510	2360	0	123574
14579	2382	369	257	151828	0	154836
14580	1091	450	174315	3990	0	179846
14581	577	176273	4523	1512	0	182885
14582	172055	4728	1335	1614	0	179732
14583	4706	175847	896	1062	0	182511
14584	1563	5376	168714	810	0	176463
14585	835	171004	4987	986	0	177812
14586	1653	6169	2155	166852	0	176829
14587	860	2795	166834	4559	0	175048
14588	1097	165867	5308	1438	0	173710
14589	1927	6230	1841	162823	0	172821
14590	1264	2962	1692	164587	0	170505
14591	301	164743	1715	5931	0	172690
14592	963	6025	1332	166248	0	174568
14593	374	2691	164503	6501	0	174069
14594	404	2254	167269	2901	0	172828
14595	995	2179	6014	165882	0	175070
14596	163831	1695	2199	7495	0	175220
14597	165525	1643	1611	3900	0	172679
14598	5956	1660	1557	161213	0	170386
14599	1861	161572	2053	6455	0	171941
14600	1960	4950	2359	163593	0	172862
14601	161419	1796	1893	7076	0	172184
14602	6599	1234	1039	161488	0	170360
14603	3788	1165	660	164879	0	170492
14604	159901	1293	652	8224	0	170070
14605	5665	157975	802	4225	0	168667
14606	2755	5737	743	160178	0	169413
14607	158153	2103	642	7770	0	168668
14608	6473	1314	152191	4113	0	164091
14609	153866	1113	4686	3935	0	163600
14610	7279	1172	1430	156810	0	166691
14611	157122	1482	1012	7223	0	166839
14612	159253	1604	941	3951	0	165749
14613	150104	1147	1008	3840	0	156099
14614	7856	152398	1346	2525	0	164125
14615	4405	5019	151857	2029	0	163310
14616	3570	154119	5117	2363	0	165169
14617	153904	5552	1649	2551	0	163656
14618	7669	152061	1240	1675	0	162645
14619	4907	6067	999	152383	0	164356
14620	148658	2951	1091	5990	0	158690
14621	6468	148828	1461	2351	0	159108
14622	3044	6926	148120	1772	0	159862
14623	3190	3507	5136	147966	0	159799
14624	2753	2883	148713	6223	0	160572
14625	2375	149192	5583	4446	0	161596
14626	2569	6621	2168	148170	0	159528
14627	2445	3189	1864	152750	0	160248
14628	1872	2672	2071	153553	0	160168
14629	1585	2192	2214	149421	0	155412
14630	1212	147032	2019	8426	0	158689
14631	144516	6586	1697	4853	0	157652
14632	5709	3291	143956	4079	0	157035
14633	2535	2270	5281	147580	0	157666
14634	144365	1786	2042	9191	0	157384
14635	6221	1967	143946	4934	0	157068
14636	2844	141667	5907	3753	0	154171
14637	2876	6708	2686	140959	0	153229
14638	2716	2983	141513	6798	0	154010
14639	2101	141815	6798	4099	0	154813
14640	136644	6323	3065	3870	0	149902
14641	6471	141121	2525	2989	0	153106
14642	2894	7432	2287	140298	0	152911
14643	2127	3988	1937	146227	0	154279
14644	139212	3068	2053	8849	0	153182
14645	6312	140159	2311	4317	0	153099
14646	3352	7502	1907	142145	0	154906
14647	138162	3986	1756	8090	0	151994
14648	138811	3490	1644	4888	0	148833
14649	7648	136206	1370	4610	0	149834
14650	137077	7159	1238	4254	0	149728
14651	140795	3996	1275	3492	0	149558
14652	8776	3583	1255	135817	0	149431
14653	4931	2854	132385	8059	0	148229
14654	4878	2532	5655	133254	0	146319
14655	4381	2697	2124	137452	0	146654
14656	3901	2469	130336	8863	0	145569
14657	3972	127543	5785	5796	0	143096
14658	3584	6253	2520	131197	0	143554
14659	2595	2768	2454	136491	0	144308
14660	2308	2026	2647	137525	0	144506
14661	2429	1766	2349	134212	0	140756
14662	2247	128604	2223	10089	0	143163
14663	130496	6254	1933	5827	0	144510
14664	132775	2975	1226	5396	0	142372
14665	131658	2195	900	5762	0	140515
14666	7917	124178	983	5671	0	138749
14667	4152	6378	888	127207	0	138625
14668	3550	3322	122588	8555	0	138015
14669	4171	3450	5060	121945	0	134626
14670	4457	124202	1813	7582	0	138054
14671	122716	6009	1189	4278	0	134192
14672	124339	3237	1172	3833	0	132581
14673	122516	2852	1387	3958	0	130713
14674	7718	116612	1808	3704	0	129842
14675	4095	113403	2060	3227	0	122785
14676	3865	118124	1698	3415	0	127102
14677	4691	6929	112728	2469	0	126817
14678	5042	4562	104285	2745	0	116634
14679	4653	12139	3821	58515	0	79128
14680	47179	472	1497	1353	0	50501
14681	46545	143	188	458	0	47334
14682	1043	195	114	47235	0	48587
14683	433	184	135	46678	0	47430
14684	311	163	129	48397	0	49000
14685	258	197	112	48698	0	49265
14686	48172	211	100	1225	0	49708
14687	49309	204	106	509	0	50128
14688	1155	50298	120	364	0	51937
14689	50992	1024	69	457	0	52542
14690	51927	319	104	382	0	52732
14691	52562	237	117	313	0	53229
14692	1360	284	45514	372	0	47530
14693	50451	190	700	349	0	51690
14694	1201	51005	241	223	0	52670
14695	510	1044	143	52541	0	54238
14696	399	354	110	53388	0	54251
14697	335	51195	163	1352	0	53045
14698	297	1093	142	54116	0	55648
14699	53512	331	141	1436	0	55420
14700	1286	224	117	54151	0	55778
14701	498	180	53078	1349	0	55105
14702	51993	172	1021	648	0	53834
14703	1249	53931	280	428	0	55888
14704	541	1142	138	54629	0	56450
14705	403	347	132	55386	0	56268
14706	415	240	83	55560	0	56298
14707	338	239	53850	1564	0	55991
14708	331	53087	1022	635	0	55075
14709	434	1117	247	53791	0	55589
14710	406	375	52688	1209	0	54678
14711	422	300	957	51887	0	53566
14712	344	214	51755	1256	0	53569
14713	398	421	1033	50614	0	52466
14714	273	50216	362	1190	0	52041
14715	298	1016	193	50372	0	51879
14716	49941	302	145	1313	0	51701
14717	50214	221	139	622	0	51196
14718	1298	222	49339	378	0	51237
14719	424	173	47238	331	0	48166
14720	270	174	50969	290	0	51703
14721	295	187	1154	51154	0	52790
14722	278	110	420	53578	0	54386
14723	238	127	208	54296	0	54869
14724	146	53868	181	1483	0	55678
14725	245	1113	152	53820	0	55330
14726	260	338	124	56167	0	56889
14727	252	214	129	57818	0	58413
14728	57036	152	121	1724	0	59033
14729	57873	148	143	779	0	58943
14730	1460	138	57196	456	0	59250
14731	537	174	56381	359	0	57451
14732	57884	118	1426	406	0	59834
14733	60077	119	524	395	0	61115
14734	1602	126	60411	316	0	62455
14735	598	163	59138	316	0	60215
14736	59722	126	1535	379	0	61762
14737	61368	104	536	348	0	62356
14738	1578	141	60863	280	0	62862
14739	653	104	1282	60231	0	62270
14740	412	100	480	61652	0	62644
14741	286	62506	304	1598	0	64694
14742	343	1248	230	64374	0	66195
14743	246	368	67078	1631	0	69323
14744	355	205	1471	67538	0	69569
14745	332	149	495	68807	0	69783
14746	251	133	66800	1988	0	69172
14747	65352	85	1528	888	0	67853
14748	68549	68	549	621	0	69787
14749	1955	103	369	67116	0	69543
14750	837	78	261	68710	0	69886
14751	67956	90	281	2031	0	70358
14752	67896	74	278	929	0	69177
14753	63447	157	265	831	0	64700
14754	68545	118	230	506	0	69399
14755	1924	66256	282	417	0	68879
14756	65923	1321	231	511	0	67986
14757	1705	65694	240	427	0	68066
14758	739	1480	214	66115	0	68548
14759	576	440	240	66256	0	67512
14760	368	64537	251	1879	0	67035
14761	411	1373	208	65673	0	67665
14762	408	390	224	65599	0	66621
14763	304	63927	253	1987	0	66471
14764	427	1393	220	64849	0	66889
14765	454	416	210	65934	0	67014
14766	453	291	200	65998	0	66942
14767	391	193	63466	2161	0	66211
14768	374	61892	1432	911	0	64609
14769	537	1772	484	60295	0	63088
14770	374	62069	347	1552	0	64342
14771	61668	1434	286	780	0	64168
14772	1556	479	60673	575	0	63283
14773	674	368	59191	450	0	60683
14774	58042	297	1558	467	0	60364
14775	1581	479	650	58262	0	60972
14776	522	169	56646	1307	0	58644
14777	446	175	55709	592	0	56922
14778	498	570	1386	54661	0	57115
14779	53984	169	609	1432	0	56194
14780	54625	144	303	653	0	55725
14781	1454	148	197	53821	0	55620
14782	574	162	52564	1309	0	54609
14783	389	53920	1071	645	0	56025
14784	381	1101	389	54286	0	56157
14785	294	372	53846	1270	0	55782
14786	275	53181	1081	629	0	55166
14787	439	1156	415	52521	0	54531
14788	51792	338	351	1265	0	53746
14789	1059	301	200	50658	0	52218
14790	446	50895	220	1186	0	52747
14791	51055	913	213	652	0	52833
14792	1046	386	52359	505	0	54296
14793	506	51702	946	425	0	53579
14794	422	948	51566	358	0	53294
14795	50172	392	1138	439	0	52141
14796	1068	296	460	49265	0	51089
14797	537	127	290	51259	0	52213
14798	51132	116	272	1210	0	52730
14799	1050	139	238	51390	0	52817
14800	464	111	50185	1149	0	51909
14801	48812	142	891	602	0	50447
14802	1047	50313	381	446	0	52187
14803	534	788	280	50131	0	51733
14804	49921	295	240	1071	0	51527
14805	946	49271	234	537	0	50988
14806	514	939	206	50673	0	52332
14807	50602	350	185	1139	0	52276
14808	974	257	203	50647	0	52081
14809	425	49993	154	1155	0	51727
14810	322	872	50463	595	0	52252
14811	320	384	820	51941	0	53465
14812	422	264	347	49938	0	50971
14813	52090	179	242	1295	0	53806
14814	995	161	168	52444	0	53768
14815	52292	179	167	1224	0	53862
14816	52638	168	186	633	0	53625
14817	1309	145	150	51785	0	53389
14818	579	51755	135	1045	0	53514
14819	419	866	112	51972	0	53369
14820	48815	359	94	1206	0	50474
14821	943	49180	131	550	0	50804
14822	328	49895	114	305	0	50642
14823	50134	887	146	374	0	51541
14824	50699	330	116	319	0	51464
14825	969	50470	99	285	0	51823
14826	50817	893	333	354	0	52397
14827	50741	295	155	247	0	51438
14828	1074	213	102	50329	0	51718
14829	445	151	51428	880	0	52904
14830	395	433	821	51382	0	53031
14831	240	167	52110	999	0	53516
14832	339	336	850	51999	0	53524
14833	183	110	52026	1026	0	53345
14834	50023	130	873	489	0	51515
14835	951	121	358	50748	0	52178
14836	52409	74	193	941	0	53617
14837	1028	397	153	51380	0	52958
14838	449	52353	105	923	0	53830
14839	53503	780	115	576	0	54974
14840	992	376	50704	284	0	52356
14841	49992	283	698	297	0	51270
14842	869	50295	310	174	0	51648
14843	47631	597	123	192	0	48543
14844	48166	237	92	168	0	48663
14845	897	47849	85	112	0	48943
14846	435	687	70	49661	0	50853
14847	50009	265	79	839	0	51192
14848	884	49788	79	334	0	51085
14849	462	770	46	50708	0	51986
14850	51256	299	53	939	0	52547
14851	970	147	50	51081	0	52248
14852	515	124	41	51457	0	52137
14853	327	120	45	51901	0	52393
14854	240	132	50498	1149	0	52019
14855	311	108	742	50580	0	51741
14856	51144	103	264	1080	0	52591
14857	946	118	50779	530	0	52373
14858	490	67	819	51349	0	52725
14859	357	106	291	52251	0	53005
14860	216	102	51008	1214	0	52540
14861	50424	90	821	601	0	51936
14862	52610	87	330	435	0	53462
14863	1209	112	51943	294	0	53558
14864	575	84	860	51861	0	53380
14865	387	78	351	53696	0	54512
14866	284	105	55140	1269	0	56798
14867	328	88	961	56116	0	57493
14868	369	79	379	56259	0	57086
14869	244	97	57839	1491	0	59671
14870	57020	72	1090	713	0	58895
14871	1208	91	413	59874	0	61586
14872	59594	70	228	1489	0	61381
14873	60351	69	181	728	0	61329
14874	1541	91	59743	456	0	61831
14875	710	100	1133	59720	0	61663
14876	60375	59	422	1522	0	62378
14877	1329	61100	295	639	0	63363
14878	625	1092	215	63529	0	65461
14879	490	323	217	64546	0	65576
14880	392	149	179	65934	0	66654
14881	296	120	64202	1908	0	66526
14882	60866	93	1341	955	0	63255
14883	1458	76	473	62748	0	64755
14884	675	72	274	63432	0	64453
14885	441	73	62012	1892	0	64418
14886	415	70	1342	62039	0	63866
14887	397	60	502	63872	0	64831
14888	61852	65	342	2062	0	64321
14889	1431	61383	283	919	0	64016
14890	592	1174	61459	648	0	63873
14891	61502	358	1369	608	0	63837
14892	1533	192	499	61146	0	63370
14893	633	128	61285	1665	0	63711
14894	447	144	61993	799	0	63383
14895	480	159	1627	62812	0	65078
14896	349	107	63686	1688	0	65830
14897	372	125	62838	817	0	64152
14898	323	61365	1694	661	0	64043
14899	407	1207	703	65452	0	67769
14900	325	363	65513	1664	0	67865
14901	382	230	1453	64869	0	66934
14902	67488	142	602	1913	0	70145
14903	1494	135	410	68024	0	70063
14904	619	119	337	69848	0	70923
14905	68194	98	317	2083	0	70692
14906	69379	111	313	1055	0	70858
14907	1836	118	337	71337	0	73628
14908	678	127	71564	1812	0	74181
14909	464	70614	1505	888	0	73471
14910	432	1336	600	72583	0	74951
14911	72219	380	443	1921	0	74963
14912	73077	214	362	964	0	74617
14913	1895	70236	385	706	0	73222
14914	719	72975	354	629	0	74677
14915	73409	1539	354	650	0	75952
14916	74141	510	331	658	0	75640
14917	1939	301	74700	571	0	77511
14918	899	319	1505	73637	0	76360
14919	527	75677	610	1670	0	78484
14920	77946	1391	434	832	0	80603
14921	1771	665	356	76829	0	79621
14922	697	75468	365	1771	0	78301
14923	536	1426	76206	788	0	78956
14924	562	960	1529	73353	0	76404
14925	394	76911	538	1618	0	79461
14926	77820	1379	396	845	0	80440
14927	78254	499	320	646	0	79719
14928	1701	77135	269	551	0	79656
14929	75942	1268	239	521	0	77970
14930	75781	402	253	505	0	76941
14931	1606	73764	248	446	0	76064
14932	612	75441	207	481	0	76741
14933	737	1645	308	74543	0	77233
14934	74650	446	251	1545	0	76892
14935	1372	316	75615	559	0	77862
14936	72699	242	1169	527	0	74637
14937	1332	75556	348	405	0	77641
14938	76405	1132	335	443	0	78315
14939	76977	349	260	383	0	77969
14940	77483	244	211	462	0	78400
14941	1646	269	194	75658	0	77767
14942	607	75361	246	1256	0	77470
14943	76750	1149	175	616	0	78690
14944	1389	438	76175	384	0	78386
14945	527	75670	1194	365	0	77756
14946	439	1197	375	78488	0	80499
14947	336	382	76125	1109	0	77952
14948	367	308	75587	414	0	76676
14949	374	312	1213	75662	0	77561
14950	384	204	470	79861	0	80919
14951	385	143	257	80685	0	81470
14952	369	221	179	78986	0	79755
14953	279	76158	235	1422	0	78094
14954	283	79946	207	527	0	80963
14955	81217	1237	178	489	0	83121
14956	1251	419	170	81389	0	83229
14957	566	258	164	82000	0	82988
14958	416	225	156	83325	0	84122
14959	82295	238	175	1573	0	84281
14960	83137	179	144	713	0	84173
14961	1509	163	113	82862	0	84647
14962	83976	173	145	1395	0	85689
14963	84007	167	159	648	0	84981
14964	85239	207	114	535	0	86095
14965	1607	242	183	83444	0	85476
14966	625	183	78837	1097	0	80742
14967	468	255	73500	452	0	74675
14968	419	186	76807	300	0	77712
14969	298	165	79409	214	0	80086
14970	456	504	1153	78973	0	81086
14971	79749	107	429	967	0	81252
14972	79276	124	176	446	0	80022
14973	1063	145	78510	223	0	79941
14974	505	148	77566	203	0	78422
14975	293	83688	887	205	0	85073
14976	461	910	358	84887	0	86616
14977	85428	240	295	967	0	86930
14978	802	169	84029	289	0	85289
14979	81729	135	710	383	0	82957
14980	741	86501	277	186	0	87705
14981	314	667	124	90002	0	91107
14982	290	213	83	93469	0	94055
14983	315	121	99	91698	0	92233
14984	94648	81	76	1338	0	96143
14985	1022	100	85	95031	0	96238
14986	484	96	73	95844	0	96497
14987	95561	90	68	1387	0	97106
14988	1114	72	75	95158	0	96419
14989	451	118	96123	1128	0	97820
14990	95017	71	855	681	0	96624
14991	1090	91	318	98220	0	99719
14992	554	99	212	97241	0	98106
14993	296	96465	175	1199	0	98135
14994	97815	858	110	705	0	99488
14995	99118	326	74	521	0	100039
14996	1367	206	90	97894	0	99557
14997	615	140	97433	1020	0	99208
14998	92131	103	947	667	0	93848
14999	1149	89	97822	336	0	99396
15000	622	84	1102	96945	0	98753
15001	410	91	421	100856	0	101778
15002	99586	50	262	1643	0	101541
15003	1379	69	146	102578	0	104172
15004	522	105	102043	1434	0	104104
15005	99993	66	1151	789	0	101999
15006	1414	114	106552	419	0	108499
15007	635	156	104806	317	0	105914
15008	108425	85	1782	490	0	110782
15009	1813	238	657	111433	0	114141
15010	612	114117	424	1240	0	116393
15011	115923	1246	287	712	0	118168
15012	115837	405	225	557	0	117024
15013	1910	263	114476	302	0	116951
15014	113586	144	1390	425	0	115545
15015	1885	184	544	116205	0	118818
15016	783	137	118245	1432	0	120597
15017	524	115165	1460	669	0	117818
15018	115365	1340	680	717	0	118102
15019	1496	116510	392	388	0	118786
15020	821	1478	354	116854	0	119507
15021	627	504	218	118155	0	119504
15022	534	272	185	117671	0	118662
15023	480	220	165	114546	0	115411
15024	301	113442	253	2063	0	116059
15025	352	1265	111096	912	0	113625
15026	246	112511	1309	690	0	114756
15027	113398	1419	509	605	0	115931
15028	1557	544	319	113596	0	116016
15029	114052	311	261	1687	0	116311
15030	1744	236	220	114782	0	116982
15031	118011	175	190	2018	0	120394
15032	1688	118651	261	768	0	121368
15033	121958	1354	196	842	0	124350
15034	122894	491	199	703	0	124287
15035	120590	341	170	620	0	121721
15036	121170	230	198	660	0	122258
15037	2142	119145	211	393	0	121891
15038	1059	1295	119602	295	0	122251
15039	923	550	1342	120095	0	122910
15040	121091	376	518	1761	0	123746
15041	123490	238	341	870	0	124939
15042	2168	209	239	124277	0	126893
15043	1003	216	127509	1745	0	130473
15044	916	193	1529	125353	0	127991
15045	553	127846	614	1863	0	130876
15046	129823	1680	423	1108	0	133034
15047	2102	698	303	130489	0	133592
15048	881	126466	337	1993	0	129677
15049	686	133464	279	869	0	135298
15050	510	136395	267	690	0	137862
15051	718	2428	244	138592	0	141982
15052	139418	896	251	2412	0	142977
15053	2198	139903	235	907	0	143243
15054	1090	2132	181	142744	0	146147
15055	141894	729	189	2584	0	145396
15056	2517	530	193	142494	0	145734
15057	142125	397	186	2736	0	145444
15058	142898	324	182	1283	0	144687
15059	2874	146109	245	779	0	150007
15060	1574	2086	206	142638	0	146504
15061	915	148009	244	1949	0	151117
15062	147822	2344	198	1059	0	151423
15063	148582	837	210	922	0	150551
15064	150833	632	239	792	0	152496
15065	3324	454	317	149631	0	153726
15066	1526	440	147062	2326	0	151354
15067	144892	408	2082	1289	0	148671
15068	150213	378	683	1027	0	152301
15069	3263	420	399	146610	0	150692
15070	1518	148400	354	2321	0	152593
15071	1378	2227	263	151130	0	154998
15072	1070	952	269	154092	0	156383
15073	152764	713	314	3268	0	157059
15074	151153	558	257	1711	0	153679
15075	3214	632	144187	934	0	148967
15076	1647	526	2112	144693	0	148978
15077	146903	474	679	2794	0	150850
15078	3136	635	431	147389	0	151591
15079	1393	554	146968	3016	0	151931
15080	1059	138609	2263	1470	0	143401
15081	916	145837	703	1149	0	148605
15082	155412	2542	557	1100	0	159611
15083	3387	1031	362	163654	0	168434
15084	1619	680	267	180182	0	182748
15085	179242	551	234	5142	0	185169
15086	4621	695	176743	2020	0	184079
15087	2386	514	3626	179414	0	185940
15088	1602	531	179885	4727	0	186745
15089	1281	180316	4171	2182	0	187950
15090	185010	3959	1703	2000	0	192672
15091	189626	1562	1076	1616	0	193880
15092	191833	1056	941	1397	0	195227
15093	6277	910	184442	1172	0	192801
15094	187607	818	4066	1214	0	193705
15095	194015	761	1615	1094	0	197485
15096	6937	681	896	190366	0	198880
15097	160659	950	1672	5880	0	169161
15098	5144	709	185534	2004	0	193391
15099	184521	530	4012	1718	0	190781
15100	6078	634	184925	1191	0	192828
15101	3159	187289	4250	1288	0	195986
15102	2668	5414	2114	177279	0	187475
15103	2081	187800	1278	3796	0	194955
15104	2081	4207	184773	1563	0	192624
15105	1696	186931	4167	1373	0	194167
15106	179011	4296	1764	1374	0	186445
15107	4086	174609	1194	1003	0	180892
15108	1990	175672	827	949	0	179438
15109	1654	4806	170749	736	0	177945
15110	1614	2492	3739	169486	0	177331
15111	172530	1686	1514	4009	0	179739
15112	4238	1513	169659	1560	0	176970
15113	2052	171404	3895	1204	0	178555
15114	1907	3973	1605	171989	0	179474
15115	1556	1765	172407	4086	0	179814
15116	1390	1293	169336	2015	0	174034
15117	1642	1180	4821	171136	0	178779
15118	1379	986	172931	4203	0	179499
15119	1444	1011	4655	160877	0	167987
15120	1219	163895	2382	4081	0	171577
15121	1359	3689	1825	168701	0	175574
15122	1204	168730	1464	4277	0	175675
15123	1623	3922	1197	171794	0	178536
15124	169677	1805	1220	4892	0	177594
15125	4478	1306	1102	169621	0	176507
15126	2029	167509	1012	4893	0	175443
15127	1801	3942	908	173714	0	180365
15128	1560	1800	170093	4983	0	178436
15129	1603	1333	3897	172153	0	178986
15130	171684	1100	1827	5286	0	179897
15131	4267	1263	164894	2511	0	172935
15132	2278	1212	4173	166098	0	173761
15133	163780	978	1935	5161	0	171854
15134	4386	161202	1616	2690	0	169894
15135	2525	3913	1388	163998	0	171824
15136	165283	1791	1215	4842	0	173131
15137	4999	1253	1358	165171	0	172781
15138	2519	1318	162117	4947	0	170901
15139	158487	1259	3919	2859	0	166524
15140	4711	159781	2178	2017	0	168687
15141	2465	164149	1471	2053	0	170138
15142	165050	4293	1680	1966	0	172989
15143	162114	2041	1470	1701	0	167326
15144	5489	1579	1318	159433	0	167819
15145	160402	1397	1259	4049	0	167107
15146	4916	1441	153720	2253	0	162330
15147	155790	1223	3657	2084	0	162754
15148	4715	154393	1914	1821	0	162843
15149	155884	3437	1651	1797	0	162769
15150	4708	1769	153770	1518	0	161765
15151	3226	1727	3743	154105	0	162801
15152	2430	1303	2090	156125	0	161948
15153	2094	1435	1607	147836	0	152972
15154	1847	151649	1525	4353	0	159374
15155	154292	3248	1310	2646	0	161496
15156	4447	1669	1389	144419	0	151924
15157	2591	145598	1342	3971	0	153502
15158	159389	3274	1163	2855	0	166681
15159	155075	1859	1306	2274	0	160514
15160	158249	1498	1147	2240	0	163134
15161	158152	1220	1107	2047	0	162526
15162	156077	1160	1155	1902	0	160294
15163	5494	1263	1229	153456	0	161442
15164	3773	1220	1139	153416	0	159548
15165	151955	1137	1029	4822	0	158943
15166	4635	1446	1009	152247	0	159337
15167	3044	1472	974	153132	0	158622
15168	2280	1438	142150	5180	0	151048
15169	146989	1382	3225	3377	0	154973
15170	151082	1312	1831	2873	0	157098
15171	152609	1653	1280	2366	0	157908
15172	5201	1506	1288	141181	0	149176
15173	2893	144793	1341	4085	0	153112
15174	155743	3217	1401	2651	0	163012
15175	151769	1703	1246	2660	0	157378
15176	5919	1441	1186	162412	0	170958
15177	163051	1291	1432	5038	0	170812
15178	6525	2447	127689	3899	0	140560
15179	3456	161993	3172	2646	0	171267
15180	3575	167551	1952	2947	0	176025
15181	4107	5053	163582	2256	0	174998
15182	1805	148642	3945	2120	0	156512
15183	1821	143237	2107	2088	0	149253
15184	128677	2428	1787	1252	0	134144
15185	2086	127044	753	1076	0	130959
15186	1559	2314	604	129070	0	133547
15187	131211	1200	465	2605	0	135481
15188	2446	951	126089	1418	0	130904
15189	125388	816	1596	1493	0	129293
15190	2593	849	123417	1088	0	127947
15191	1625	603	120861	1036	0	124125
15192	119999	503	2339	1137	0	123978
15193	2346	413	123422	925	0	127106
15194	1355	120515	1986	761	0	124617
15195	1469	1783	1358	119469	0	124079
15196	120546	905	727	1983	0	124161
15197	2083	116463	529	1068	0	120143
15198	1383	1683	418	118968	0	122452
15199	1008	1014	117887	1939	0	121848
15200	1257	630	1493	118217	0	121597
15201	116387	416	867	2312	0	119982
15202	2175	422	114399	1242	0	118238
15203	1645	436	1620	114230	0	117931
15204	115588	503	889	2128	0	119108
15205	118364	385	606	1437	0	120792
15206	3068	370	416	117551	0	121405
15207	2063	385	315	117582	0	120345
15208	1338	360	119402	2481	0	123581
15209	1254	368	114623	1442	0	117687
15210	118453	330	2154	1173	0	122110
15211	122394	355	1091	884	0	124724
15212	2645	119802	741	595	0	123783
15213	121320	1494	561	554	0	123929
15214	123786	754	437	798	0	125775
15215	2834	608	127840	519	0	131801
15216	1521	130356	1748	779	0	134404
15217	133709	1749	1090	747	0	137295
15218	134566	836	562	514	0	136478
15219	137299	486	335	475	0	138595
15220	3128	382	239	134077	0	137826
15221	1769	291	205	135276	0	137541
15222	1075	133167	235	2440	0	136917
15223	885	1744	176	137356	0	140161
15224	136200	796	199	2516	0	139711
15225	2268	533	149	136998	0	139948
15226	1190	432	134392	2461	0	138475
15227	1009	365	129955	1232	0	132561
15228	872	234	2384	132968	0	136458
15229	558	228	135433	2305	0	138524
15230	636	359	131497	1249	0	133741
15231	718	182	2794	132053	0	135747
15232	713	282	1398	136301	0	138694
15233	503	181	136482	2835	0	140001
15234	572	217	134448	1442	0	136679
15235	473	136411	2790	951	0	140625
15236	138015	1860	1456	925	0	142256
15237	2095	140307	937	537	0	143876
15238	140812	2247	641	704	0	144404
15239	142982	1062	462	624	0	145130
15240	2881	142767	478	376	0	146502
15241	144386	2372	331	508	0	147597
15242	3030	1076	342	142751	0	147199
15243	1422	756	144158	2235	0	148571
15244	1248	505	2176	142061	0	145990
15245	861	388	1019	147268	0	149536
15246	140382	286	651	3508	0	144827
15247	141985	269	484	1840	0	144578
15248	143286	262	404	1201	0	145153
15249	142873	232	383	940	0	144428
15250	137742	204	307	867	0	139120
15251	3826	131224	428	498	0	135976
15252	2019	2048	385	136147	0	140599
15253	1266	957	136259	2468	0	140950
15254	1257	577	2293	136472	0	140599
15255	1061	394	1031	137186	0	139672
15256	852	289	785	144794	0	146720
15257	149672	254	560	4098	0	154584
15258	3520	274	485	149865	0	154144
15259	152331	285	401	4268	0	157285
15260	4233	289	153164	1802	0	159488
15261	2270	235	3383	178642	0	184530
15262	1365	311	184680	5183	0	191539
15263	185209	232	5119	2390	0	192950
15264	5619	250	1867	187973	0	195709
15265	2210	382	189252	5456	0	197300
15266	1871	265	5071	190476	0	197683
15267	191681	223	2076	6353	0	200333
15268	5536	334	187617	2733	0	196220
15269	191114	239	5104	2171	0	198628
15270	198279	196	2180	1749	0	202404
15271	196688	187	1350	1681	0	199906
15272	194386	190	1104	1598	0	197278
15273	7635	185230	1007	1215	0	195087
15274	3279	181275	849	1159	0	186562
15275	2557	177491	916	1093	0	182057
15276	2444	7309	1224	163605	0	174582
15277	1366	169069	820	4035	0	175290
15278	166203	4439	852	1875	0	173369
15279	4453	160536	771	1268	0	167028
15280	1868	165470	830	1057	0	169225
15281	1937	4860	747	165194	0	172738
15282	1665	1838	690	169648	0	173841
15283	165769	1117	801	5754	0	173441
15284	5109	805	724	166523	0	173161
15285	2374	762	161638	5172	0	169946
15286	1912	803	154350	2301	0	159366
15287	1811	726	159806	1578	0	163921
15288	2275	580	5176	158163	0	166194
15289	2255	570	1990	168260	0	173075
15290	1862	773	162319	5580	0	170534
15291	1768	962	158959	2305	0	163994
15292	1493	1104	164158	1557	0	168312
15293	164911	1119	5739	1522	0	173291
15294	5309	1071	2320	167174	0	175874
15295	2452	1114	1384	171039	0	175989
15296	168619	1075	1104	6337	0	177135
15297	5428	1054	899	167734	0	175115
15298	2241	163050	969	5855	0	172115
15299	1680	171660	890	2916	0	177146
15300	1847	5326	730	171587	0	179490
15301	170614	1962	770	6142	0	179488
15302	172524	1190	934	3305	0	177953
15303	174691	801	1242	2542	0	179276
15304	6785	642	1289	170633	0	179349
15305	3029	607	166364	5710	0	175710
15306	2224	532	5160	167701	0	175617
15307	1638	585	165951	6203	0	174377
15308	161080	440	5753	3315	0	170588
15309	5649	535	2813	162993	0	171990
15310	158665	407	2146	6454	0	167672
15311	5810	492	159743	3198	0	169243
15312	155277	395	5377	2797	0	163846
15313	6497	506	162170	2239	0	171412
15314	3545	152181	5156	2155	0	163037
15315	2666	155656	2213	2096	0	162631
15316	151950	5325	1628	2180	0	161083
15317	6162	2431	1158	150434	0	160185
15318	3134	1581	150104	5240	0	160059
15319	2567	146531	4373	2446	0	155917
15320	2313	154103	1835	1820	0	160071
15321	2499	5627	1269	152413	0	161808
15322	152876	2238	1147	5752	0	162013
15323	154454	1575	1167	2930	0	160126
15324	6167	152081	1206	2317	0	161771
15325	154387	4756	1243	2369	0	162755
15326	6112	1952	1272	153570	0	162906
15327	3109	1411	151232	5605	0	161357
15328	2481	151811	4947	2933	0	162172
15329	2534	4630	2515	153388	0	163067
15330	2181	1866	1826	156632	0	162505
15331	153127	1236	1702	6743	0	162808
15332	5638	1219	150208	2934	0	159999
15333	150360	1142	4991	2434	0	158927
15334	154481	1042	2405	2144	0	160072
15335	6578	1128	1976	150336	0	160018
15336	3308	1179	1696	154242	0	160425
15337	148262	1258	1352	6480	0	157352
15338	5986	1329	1211	149453	0	157979
15339	2889	1276	145377	6114	0	155656
15340	2163	1284	142979	2824	0	149250
15341	1995	139534	5224	2199	0	148952
15342	1927	149898	2085	2075	0	155985
15343	2317	5404	1309	142219	0	151249
15344	1872	142103	1088	5094	0	150157
15345	144758	4996	1118	2999	0	153871
15346	4889	145947	1028	2373	0	154237
15347	2521	4859	986	147509	0	155875
15348	1878	2286	997	151346	0	156507
15349	1696	1648	145953	6333	0	155630
15350	2015	1044	4538	146995	0	154592
15351	2135	738	2081	151115	0	156069
15352	2035	148697	1632	6431	0	158795
15353	2117	4134	1426	151175	0	158852
15354	1997	1591	1265	155241	0	160094
15355	2192	1034	148640	7074	0	158940
15356	1458	145524	4916	3766	0	155664
15357	1603	10192	1963	129347	0	143105
15358	1213	136343	1246	4442	0	143244
15359	1123	3784	131037	2356	0	138300
15360	949	127385	3679	1727	0	133740
15361	99165	3412	2233	1558	0	106368
15362	95995	870	583	609	0	98057
15363	95671	557	336	557	0	97121
15364	2168	94353	277	353	0	97151
15365	94008	1679	185	473	0	96345
15366	2094	718	165	92727	0	95704
15367	91120	458	174	1976	0	93728
15368	1845	89108	192	789	0	91934
15369	89642	1671	202	806	0	92321
15370	91409	702	173	775	0	93059
15371	2202	92129	200	482	0	95013
15372	976	1945	92443	371	0	95735
15373	861	840	1730	98418	0	101849
15374	542	574	103891	2255	0	107262
15375	627	408	2496	106542	0	110073
15376	532	368	882	113104	0	114886
15377	348	346	113165	3593	0	117452
15378	546	341	2782	114204	0	117873
15379	114866	280	950	3685	0	119781
15380	2923	332	114832	1369	0	119456
15381	1050	114780	2958	898	0	119686
15382	1066	2800	955	112911	0	117732
15383	790	958	550	118351	0	120649
15384	540	630	115302	3709	0	120181
15385	739	565	2760	111731	0	115795
15386	416	114055	1001	3232	0	118704
15387	111561	2794	631	1682	0	116668
15388	2560	112715	482	988	0	116745
15389	106878	2831	326	922	0	110957
15390	2659	107092	356	618	0	110725
15391	894	110554	372	500	0	112320
15392	693	3150	105467	452	0	109762
15393	766	1526	2739	104822	0	109853
15394	700	704	862	104190	0	106456
15395	539	511	495	108261	0	109806
15396	313	109626	432	3648	0	114019
15397	544	2944	347	111562	0	115397
15398	111116	1024	334	3921	0	116395
15399	3257	662	383	112050	0	116352
15400	111479	481	377	4184	0	116521
15401	3618	488	110370	1686	0	116162
15402	111533	408	3082	1415	0	116438
15403	3859	475	1078	112087	0	117499
15404	1530	481	748	117640	0	120399
15405	116818	469	520	4677	0	122484
15406	3630	521	116141	1969	0	122261
15407	1304	115648	3303	1468	0	121723
15408	1189	3282	1154	118625	0	124250
15409	117847	1215	815	4070	0	123947
15410	120693	970	500	1790	0	123953
15411	4470	752	412	119201	0	124835
15412	1791	683	117171	3921	0	123566
15413	113702	605	3320	1943	0	119570
15414	3833	704	114883	1340	0	120760
15415	1807	775	3620	114544	0	120746
15416	1150	599	115096	4005	0	120850
15417	1096	705	3655	113967	0	119423
15418	781	552	111753	4418	0	117504
15419	719	110920	3669	2106	0	117414
15420	1152	3262	1458	104494	0	110366
15421	767	112044	1041	3328	0	117180
15422	112898	3430	674	1853	0	118855
15423	115219	1280	642	1509	0	118650
15424	4374	938	110706	1036	0	117054
15425	2134	683	3267	110703	0	116787
15426	112592	609	1341	3898	0	118440
15427	3981	557	896	112041	0	117475
15428	1944	494	733	113158	0	116329
15429	1422	513	108232	4683	0	114850
15430	105240	450	3383	2508	0	111581
15431	3820	519	109052	1694	0	115085
15432	1878	446	3671	109129	0	115124
15433	1453	430	109580	4056	0	115519
15434	108693	387	3907	2229	0	115216
15435	110793	362	1720	1923	0	114798
15436	110863	417	1462	1495	0	114237
15437	4915	487	1101	108425	0	114928
15438	2184	477	106252	3925	0	112838
15439	1521	581	107796	2069	0	111967
15440	1363	923	4157	102120	0	108563
15441	1159	105820	2061	3698	0	112738
15442	104165	3041	1398	2023	0	110627
15443	3732	1347	1088	104790	0	110957
15444	1865	963	103866	3966	0	110660
15445	1718	770	3323	105353	0	111164
15446	1393	652	106958	4337	0	113340
15447	1477	752	3881	108444	0	114554
15448	1283	576	109188	4428	0	115475
15449	1306	544	108703	2287	0	112840
15450	1120	106405	4330	2085	0	113940
15451	1124	2906	107065	1654	0	112749
15452	1216	1206	107320	1648	0	111390
15453	1804	1114	4431	89612	0	96961
15454	1343	572	2055	99277	0	103247
15455	1162	101286	1507	3816	0	107771
15456	102128	2672	1292	2130	0	108222
15457	3403	100854	1237	1626	0	107120
15458	1938	2952	1153	102021	0	108064
15459	102476	1114	1177	3630	0	108397
15460	3681	776	1070	102526	0	108053
15461	102713	558	1200	3993	0	108464
15462	3814	479	1115	104283	0	109691
15463	1789	551	104151	4145	0	110636
15464	1522	541	3289	105628	0	110980
15465	1331	494	1599	108686	0	112110
15466	105966	495	1424	4613	0	112498
15467	106611	393	1280	2585	0	110869
15468	105828	427	1331	1967	0	109553
15469	4146	99769	1392	1669	0	106976
15470	1842	102060	1265	1443	0	106610
15471	101469	2856	1472	1461	0	107258
15472	3305	1168	101605	1418	0	107496
15473	1550	811	97091	1161	0	100613
15474	1577	3104	3433	88223	0	96337
15475	799	440	89695	2421	0	93355
15476	763	318	84326	1280	0	86687
15477	81250	487	2729	1142	0	85608
15478	83562	271	1352	912	0	86097
15479	2417	81724	854	739	0	85734
15480	1203	84610	716	754	0	87283
15481	1102	2004	672	76632	0	80410
15482	695	83373	643	1774	0	86485
15483	85384	1825	628	1125	0	88962
15484	2109	765	556	82961	0	86391
15485	1052	84880	593	1905	0	88430
15486	87154	1659	576	1122	0	90511
15487	2043	772	86468	849	0	90132
15488	1087	609	84826	704	0	87226
15489	85702	385	2319	809	0	89215
15490	2107	382	83812	719	0	87020
15491	83767	237	1947	663	0	86614
15492	2130	480	990	85464	0	89064
15493	984	285	85638	1801	0	88708
15494	763	83078	1851	978	0	86670
15495	637	85444	1022	706	0	87809
15496	79787	1408	662	535	0	82392
15497	1260	80744	454	427	0	82885
15498	78523	1139	435	391	0	80488
15499	78649	345	383	382	0	79759
15500	1342	77680	363	257	0	79642
15501	596	1163	310	77924	0	79993
15502	380	333	78859	1084	0	80656
15503	277	81826	1206	399	0	83708
15504	561	2171	466	81575	0	84773
15505	372	515	397	87905	0	89189
15506	86179	217	150	1684	0	88230
15507	1420	131	115	86233	0	87899
15508	399	158	85226	1578	0	87361
15509	290	84704	1274	569	0	86837
15510	332	1323	406	86575	0	88636
15511	86711	367	310	1684	0	89072
15512	88994	242	178	649	0	90063
15513	1880	192	151	88968	0	91191
15514	91201	172	181	1742	0	93296
15515	2014	209	90973	548	0	93744
15516	878	154	1667	91265	0	93964
15517	522	184	92890	1873	0	95469
15518	598	158	1857	98801	0	101414
15519	511	126	653	99254	0	100544
15520	530	151	377	100229	0	101287
15521	448	129	274	100588	0	101439
15522	443	124	233	100216	0	101016
15523	98457	128	207	3533	0	102325
15524	100225	114	160	1590	0	102089
15525	2789	98872	211	999	0	102871
15526	100975	2133	231	912	0	104251
15527	2770	695	188	101103	0	104756
15528	1201	417	192	103400	0	105210
15529	1020	285	155	102911	0	104371
15530	731	232	102328	3356	0	106647
15531	839	199	2306	98421	0	101765
15532	519	101200	735	2906	0	105360
15533	101839	2252	492	1448	0	106031
15534	102471	646	412	1212	0	104741
15535	3040	429	99775	878	0	104122
15536	1097	100062	2403	880	0	104442
15537	904	2349	761	101120	0	105134
15538	623	804	101587	2985	0	105999
15539	800	495	2421	96113	0	99829
15540	578	99241	800	3003	0	103622
15541	97304	2463	584	1523	0	101874
15542	2752	98540	418	1051	0	102761
15543	1140	2718	98036	874	0	102768
15544	960	1072	97845	756	0	100633
15545	660	95065	2877	886	0	99488
15546	537	96969	1038	916	0	99460
15547	93790	2811	744	1088	0	98433
15548	94898	1012	477	1007	0	97394
15549	3134	660	467	93602	0	97863
15550	1200	575	92790	2862	0	97427
15551	1065	539	2383	92760	0	96747
15552	992	510	799	94422	0	96723
15553	92468	409	571	3536	0	96984
15554	91982	470	509	1601	0	94562
15555	3305	436	459	95382	0	99582
15556	1246	469	95295	3244	0	100254
15557	802	95550	2578	1581	0	100511
15558	96001	2685	968	1316	0	100970
15559	2913	98069	671	1076	0	102729
15560	1458	3166	501	100749	0	105874
15561	1158	1164	498	104962	0	107782
15562	930	811	645	104703	0	107089
15563	839	705	588	102886	0	105018
15564	99193	707	533	4484	0	104917
15565	3394	630	415	99633	0	104072
15566	1447	96955	421	4091	0	102914
15567	1254	2764	411	99650	0	104079
15568	96120	1012	472	4298	0	101902
15569	3126	96111	524	2178	0	101939
15570	1441	2952	544	97713	0	102650
15571	1097	1147	94636	3888	0	100768
15572	94160	845	2790	1972	0	99767
15573	3721	752	940	95220	0	100633
15574	1634	644	93181	3698	0	99157
15575	1219	699	92471	1814	0	96203
15576	1357	1045	3536	92220	0	98158
15577	91723	671	1679	3855	0	97928
15578	93102	564	948	2118	0	96732
15579	3590	93514	655	1858	0	99617
15580	93301	2672	535	1894	0	98402
15581	95299	980	496	1892	0	98667
15582	95107	642	525	1802	0	98076
15583	94694	551	503	1703	0	97451
15584	4409	601	477	91876	0	97363
15585	2149	702	484	93536	0	96871
15586	1684	663	87579	4142	0	94068
15587	1255	83360	2616	2182	0	89413
15588	1091	87146	1011	1854	0	91102
15589	970	3109	85837	1701	0	91617
15590	85205	1225	2835	1648	0	90913
15591	3242	754	1096	86727	0	91819
15592	86944	598	879	3602	0	92023
15593	87664	627	719	1819	0	90829
15594	3841	731	83891	1385	0	89848
15595	2082	648	2679	84266	0	89675
15596	85697	521	1004	3360	0	90582
15597	3611	615	729	84954	0	89909
15598	1858	706	83679	3455	0	89698
15599	1544	2728	2708	79868	0	86848
15600	1272	83441	1242	3111	0	89066
15601	1251	86440	780	1651	0	90122
15602	1264	2990	82204	1275	0	87733
15603	1005	79524	2524	995	0	84048
15604	73998	2796	1402	1336	0	79532
15605	72871	834	724	910	0	75339
15606	2706	479	498	71327	0	75010
15607	1241	406	409	72558	0	74614
15608	960	421	365	73633	0	75379
15609	70946	355	282	2829	0	74412
15610	2365	70672	306	1186	0	74529
15611	70431	1799	231	916	0	73377
15612	69996	629	258	736	0	71619
15613	2541	68600	282	720	0	72143
15614	65590	1513	273	591	0	67967
15615	1902	65757	199	586	0	68444
15616	66402	1650	258	697	0	69007
15617	1954	547	64474	637	0	67612
15618	57369	646	1587	452	0	60054
15619	1375	58080	427	356	0	60238
15620	875	1187	534	58416	0	61012
15621	558	354	161	60920	0	61993
15622	471	254	124	61468	0	62317
15623	61980	178	146	1979	0	64283
15624	1529	223	143	62976	0	64871
15625	684	204	61042	1731	0	63661
15626	60273	224	1236	822	0	62555
15627	1526	266	60558	566	0	62916
15628	759	393	1306	60523	0	62981
15629	611	283	61145	1517	0	63556
15630	463	417	1311	59171	0	61362
15631	350	59840	563	1522	0	62275
15632	438	1152	378	59459	0	61427
15633	343	59484	296	1456	0	61579
15634	506	1220	236	60547	0	62509
15635	60356	496	259	1611	0	62722
15636	1459	373	190	62109	0	64131
15637	62032	199	245	1674	0	64150
15638	1590	259	58995	666	0	61510
15639	60327	241	1093	615	0	62276
15640	61554	190	408	527	0	62679
15641	61955	209	337	377	0	62878
15642	1943	219	182	61123	0	63467
15643	60438	192	219	1416	0	62265
15644	1683	212	57900	625	0	60420
15645	58856	209	1142	599	0	60806
15646	1670	202	58067	458	0	60397
15647	59114	211	1201	407	0	60933
15648	1671	210	479	59691	0	62051
15649	845	261	60277	1253	0	62636
15650	786	173	1185	60160	0	62304
15651	707	185	512	61356	0	62760
15652	555	168	60270	1673	0	62666
15653	57450	114	1202	977	0	59743
15654	1330	60594	565	756	0	63245
15655	59390	887	337	521	0	61135
15656	1200	58396	294	401	0	60291
15657	57700	923	306	446	0	59375
15658	1144	290	56348	346	0	58128
15659	52293	597	1191	491	0	54572
15660	896	52471	384	276	0	54027
15661	563	524	351	51683	0	53121
15662	284	207	128	53187	0	53806
15663	287	126	75	53532	0	54020
15664	194	131	53581	857	0	54763
15665	289	77	585	53385	0	54336
15666	186	95	56207	789	0	57277
15667	58024	68	740	402	0	59234
15668	61789	68	283	375	0	62515
15669	1267	72	180	62690	0	64209
15670	475	80	63257	1034	0	64846
15671	62376	46	976	572	0	63970
15672	1175	79	74294	297	0	75845
15673	621	75	1398	74171	0	76265
15674	471	52	447	77303	0	78273
15675	406	64	293	79227	0	79990
15676	364	58	219	80468	0	81109
15677	77221	50	157	2307	0	79735
15678	1492	77735	230	837	0	80294
15679	561	1404	75246	502	0	77713
15680	391	75783	1466	342	0	77982
15681	76694	1575	438	411	0	79118
15682	1792	453	317	76613	0	79175
15683	77443	279	227	1825	0	79774
15684	1899	159	189	77819	0	80066
15685	830	107	186	78370	0	79493
15686	558	143	170	79207	0	80078
15687	346	132	76457	2299	0	79234
15688	290	75331	1523	1017	0	78161
15689	357	1422	77566	670	0	80015
15690	446	421	1687	78065	0	80619
15691	79541	303	558	1969	0	82371
15692	79327	207	440	1025	0	80999
15693	80640	158	274	890	0	81962
15694	2112	79288	291	573	0	82264
15695	82411	1479	222	708	0	84820
15696	2042	483	240	82351	0	85116
15697	874	337	236	83645	0	85092
15698	704	222	235	83682	0	84843
15699	487	82579	262	2317	0	85645
15700	600	1524	225	79737	0	82086
15701	438	81564	283	1912	0	84197
15702	81870	1721	244	977	0	84812
15703	82989	502	243	842	0	84576
15704	2258	383	188	83087	0	85916
15705	997	291	81069	1906	0	84263
15706	81297	248	1493	1052	0	84090
15707	1977	285	481	83906	0	86649
15708	748	248	82721	2064	0	85781
15709	81081	238	1554	1066	0	83939
15710	1974	247	491	84134	0	86846
15711	83539	218	416	2142	0	86315
15712	1956	82318	284	940	0	85498
15713	952	1669	247	82118	0	84986
15714	718	84357	267	1906	0	87248
15715	779	2047	228	85762	0	88816
15716	502	85811	288	2013	0	88614
15717	675	1770	284	87792	0	90521
15718	490	618	86001	2000	0	89109
15719	75457	451	1481	1270	0	78659
15720	1623	85214	508	780	0	88125
15721	768	1334	83781	497	0	86380
15722	82431	436	1384	741	0	84992
15723	1748	452	408	85075	0	87683
15724	704	289	84432	1603	0	87028
15725	590	84610	1293	786	0	87279
15726	525	1294	441	86977	0	89237
15727	455	512	87582	1581	0	90130
15728	537	448	1265	87655	0	89905
15729	470	319	445	90012	0	91246
15730	447	310	90678	1945	0	93380
15731	567	346	1371	91516	0	93800
15732	423	361	93326	1962	0	96072
15733	553	321	1537	93720	0	96131
15734	461	386	97460	2059	0	100366
15735	632	298	1535	98192	0	100657
15736	638	327	604	99414	0	100983
15737	607	343	489	98777	0	100216
15738	465	97387	491	2076	0	100419
15739	98406	1413	410	1397	0	101626
15740	99632	479	491	1147	0	101749
15741	1973	374	363	100626	0	103336
15742	100904	322	433	2286	0	103945
15743	1774	366	100446	1113	0	103699
15744	704	101789	1463	1077	0	105033
15745	103195	1337	577	1276	0	106385
15746	1576	103730	579	839	0	106724
15747	767	1557	416	106012	0	108752
15748	646	664	410	107110	0	108830
15749	104250	497	405	2310	0	107462
15750	1791	415	307	104899	0	107412
15751	907	351	103691	2025	0	106974
15752	752	102793	1379	1082	0	106006
15753	104601	1429	495	1104	0	107629
15754	1757	561	417	103917	0	106652
15755	759	104973	347	1949	0	108028
15756	735	1518	356	105191	0	107800
15757	549	106676	394	1850	0	109469
15758	107441	1720	322	1270	0	110753
15759	107455	585	348	1203	0	109591
15760	1997	586	105103	794	0	108480
15761	1143	461	103098	701	0	105403
15762	925	390	1534	104800	0	107649
15763	637	106232	671	1705	0	109245
15764	713	1358	502	108826	0	111399
15765	107885	479	393	2247	0	111004
15766	1483	458	104324	954	0	107219
15767	814	556	1159	100521	0	103050
15768	489	280	100935	1363	0	103067
15769	453	342	95794	694	0	97283
15770	394	101555	1243	569	0	103761
15771	1425	2388	846	97071	0	101730
15772	91198	341	405	1017	0	92961
15773	548	147	90981	213	0	91889
15774	208	89003	469	223	0	89903
15775	89007	339	163	346	0	89855
15776	433	131	103	89656	0	90323
15777	91914	84	79	771	0	92848
15778	91897	72	58	593	0	92620
15779	92625	39	63	558	0	93285
15780	536	97	96561	93	0	97287
15781	92849	56	417	416	0	93738
15782	97817	49	147	359	0	98372
15783	563	98718	166	123	0	99570
15784	305	477	83	101300	0	102165
15785	254	133	67	100349	0	100803
15786	175	99	63	102185	0	102522
15787	101761	70	48	901	0	102780
15788	98501	61	80	526	0	99168
15789	649	118	99787	173	0	100727
15790	424	58	434	99454	0	100370
15791	176	98858	223	521	0	99778
15792	100760	442	120	551	0	101873
15793	574	255	100411	162	0	101402
15794	417	114	490	98467	0	99488
15795	262	87	188	99834	0	100371
15796	169	99171	170	686	0	100196
15797	213	495	108	101227	0	102043
15798	395	212	108	95798	0	96513
15799	203	123	68	101210	0	101604
15800	100498	78	81	1181	0	101838
15801	667	81	78	100005	0	100831
15802	349	74	79	100307	0	100809
15803	100836	74	78	1249	0	102237
15804	750	81	61	101708	0	102600
15805	528	109710	107	783	0	111128
15806	114497	1090	70	811	0	116468
15807	118142	514	61	694	0	119411
15808	121144	243	83	648	0	122118
15809	131268	134	77	681	0	132160
15810	2859	138048	155	264	0	141326
15811	154681	2338	75	680	0	157774
15812	158223	788	86	844	0	159941
15813	4694	573	66	155821	0	161154
15814	1716	357	153049	3413	0	158535
15815	1608	206	3110	152943	0	157867
15816	1159	170	838	155249	0	157416
15817	891	135	586	154070	0	155682
15818	907	140	499	153975	0	155521
15819	827	133	253	155410	0	156623
15820	149717	110	179	5661	0	155667
15821	3964	105	114	151443	0	155626
15822	1251	209	150555	4617	0	156632
15823	1369	173	3233	148262	0	153037
15824	629	148384	987	4279	0	154279
15825	908	3513	621	149976	0	155018
15826	488	936	149495	4283	0	155202
15827	136660	629	3494	2184	0	142967
15828	145600	373	1054	1662	0	148689
15829	4513	307	148033	852	0	153705
15830	1768	146616	3449	748	0	152581
15831	149960	3288	1128	1019	0	155395
15832	151383	970	721	912	0	153986
15833	152324	723	445	839	0	154331
15834	149302	412	277	765	0	150756
15835	6069	315	252	143850	0	150486
15836	2596	407	143372	3791	0	150166
15837	2294	296	3426	144461	0	150477
15838	1819	264	1086	149560	0	152729
15839	1160	358	146118	5180	0	152816
15840	1084	386	144658	2271	0	148399
15841	142461	285	4434	2121	0	149301
15842	4256	144722	1865	1477	0	152320
15843	2275	3555	1191	145841	0	152862
15844	1551	1115	143047	4693	0	150406
15845	137644	762	4032	2692	0	145130
15846	4457	522	142263	2049	0	149291
15847	139269	369	4440	2240	0	146318
15848	4786	141565	1692	1840	0	149883
15849	2498	3657	1148	143400	0	150703
15850	1752	1308	141149	4951	0	149160
15851	135950	894	4083	2692	0	143619
15852	4779	138512	1772	1899	0	146962
15853	2138	146270	1385	1511	0	151304
15854	2155	4798	1127	144195	0	152275
15855	1753	2100	924	150078	0	154855
15856	151631	1465	831	6064	0	159991
15857	5480	150143	891	2872	0	159386
15858	3086	4621	877	153983	0	162567
15859	152296	1650	858	6144	0	160948
15860	158387	1200	830	3066	0	163483
15861	161054	870	850	2886	0	165660
15862	7728	803	158466	2229	0	169226
15863	4025	764	160401	2260	0	167450
15864	168824	575	6012	2649	0	178060
15865	6935	167564	2691	2517	0	179707
15866	3085	173679	1984	2495	0	181243
15867	3095	6526	1515	164024	0	175160
15868	2042	170080	1444	6681	0	180247
15869	170710	6436	1552	3603	0	182301
15870	7177	2484	1456	169728	0	180845
15871	3321	2003	166807	6973	0	179104
15872	168297	1590	6042	3435	0	179364
15873	173983	1345	2588	2839	0	180755
15874	8976	1412	2086	168996	0	181470
15875	4829	1290	1695	173131	0	180945
15876	4074	1201	1664	174028	0	180967
15877	3524	1235	1524	172921	0	179204
15878	3037	1451	161369	9120	0	174977
15879	3004	160564	5914	4612	0	174094
15880	3146	6128	2421	150617	0	162312
15881	2637	159830	2041	7247	0	171755
15882	2920	6757	1634	150102	0	161413
15883	2400	156802	1544	7557	0	168303
15884	156438	6777	1562	4315	0	169092
15885	158369	2827	1462	3849	0	166507
15886	8033	155541	1682	3282	0	168538
15887	157793	6362	1660	3036	0	168851
15888	8631	2825	1646	156243	0	169345
15889	154955	2491	1494	7427	0	166367
15890	8278	153851	1605	3456	0	167190
15891	155751	6657	1589	2926	0	166923
15892	160373	3049	1610	2396	0	167428
15893	9714	2606	1602	152683	0	166605
15894	4999	2297	151102	6850	0	165248
15895	4028	150278	6210	3399	0	163915
15896	3800	6557	2566	152706	0	165629
15897	153270	3398	2066	7504	0	166238
15898	7690	2916	150005	3748	0	164359
15899	4391	2380	5764	150194	0	162729
15900	3796	2158	2369	155760	0	164083
15901	152947	1894	1914	8865	0	165620
15902	155419	1804	1677	5089	0	163989
15903	153630	1708	1594	4256	0	161188
15904	9298	146849	1549	3527	0	161223
15905	140275	5581	1210	3410	0	150476
15906	7563	2217	131270	3178	0	144228
15907	3924	1964	128200	2885	0	136973
15908	3420	1714	127631	2558	0	135323
15909	3959	6974	6484	108165	0	125582
15910	2194	1280	106359	4340	0	114173
15911	91294	1023	2940	1790	0	97047
15912	3450	851	1148	92242	0	97691
15913	1955	839	92846	3115	0	98755
15914	95059	847	2730	1842	0	100478
15915	3756	766	1168	95737	0	101427
15916	2119	793	1014	98509	0	102435
15917	98323	712	866	3781	0	103682
15918	3640	753	900	100508	0	105801
15919	1942	802	100198	3579	0	106521
15920	1842	722	2835	101707	0	107106
15921	1701	726	102284	3542	0	108253
15922	1587	684	3128	101699	0	107098
15923	100253	547	1399	3910	0	106109
15924	3451	96659	1101	2173	0	103384
15925	1871	101206	990	1814	0	105881
15926	1876	3026	856	99986	0	105744
15927	1664	1312	801	100966	0	104743
15928	1422	96639	880	3943	0	102884
15929	1544	97461	921	2053	0	101979
15930	1418	2980	944	96270	0	101612
15931	1287	1305	991	97439	0	101022
15932	93663	879	927	4114	0	99583
15933	3132	91608	900	2263	0	97903
15934	1611	91418	874	1813	0	95716
15935	1361	95729	811	1557	0	99458
15936	92042	3232	928	1648	0	97850
15937	3030	1397	91177	1468	0	97072
15938	90139	1008	2780	1581	0	95508
15939	3141	869	1177	90749	0	95936
15940	1557	85623	932	3289	0	91401
15941	1320	92140	762	1705	0	95927
15942	91304	2836	696	1587	0	96423
15943	3106	1282	788	88885	0	94061
15944	1438	95756	802	3122	0	101118
15945	97603	2788	839	1857	0	103087
15946	99641	1239	685	1674	0	103239
15947	3614	1119	96772	1295	0	102800
15948	97880	942	2539	1350	0	102711
15949	100561	911	1064	1366	0	103902
15950	3757	899	769	97106	0	102531
15951	1763	93699	758	3330	0	99550
15952	1447	97251	585	1722	0	101005
15953	1502	3632	569	95082	0	100785
15954	92187	1320	657	3336	0	97500
15955	3078	1068	85250	1614	0	91010
15956	1620	821	83660	1074	0	87175
15957	1903	771	81921	934	0	85529
15958	1927	695	83199	804	0	86625
15959	816	82920	2483	843	0	87062
15960	955	82911	1283	809	0	85958
15961	1423	2432	77344	680	0	81879
15962	951	1248	75579	826	0	78604
15963	478	68354	1833	542	0	71207
15964	520	969	738	64111	0	66338
15965	109	333	67293	795	0	68530
15966	219	190	889	65158	0	66456
15967	139	123	310	69269	0	69841
15968	137	88	164	70912	0	71301
15969	193	89	121	73868	0	74271
15970	105	93	72598	1473	0	74269
15971	192	62	1110	70980	0	72344
15972	72316	63	401	1434	0	74214
15973	1140	113	70974	496	0	72723
15974	72338	91	1173	435	0	74037
15975	1369	88	383	74362	0	76202
15976	480	96	74779	1253	0	76608
15977	74781	94	1244	574	0	76693
15978	1416	96	443	76391	0	78346
15979	76990	68	277	1526	0	78861
15980	1495	101	237	75633	0	77466
15981	484	75315	204	1480	0	77483
15982	335	1148	78058	602	0	80143
15983	378	404	1262	79082	0	81126
15984	79535	243	461	1643	0	81882
15985	80428	227	271	713	0	81639
15986	80729	182	230	537	0	81678
15987	80214	167	194	504	0	81079
15988	79324	168	185	470	0	80147
15989	1614	78576	201	374	0	80765
15990	79824	1284	202	439	0	81749
15991	1538	506	78026	326	0	80396
15992	78651	325	1249	424	0	80649
15993	1610	293	438	76132	0	78473
15994	638	278	78290	1251	0	80457
15995	430	306	77596	558	0	78890
15996	450	255	1626	78068	0	80399
15997	79502	216	597	1576	0	81891
15998	1473	78253	434	615	0	80775
15999	78883	1299	319	536	0	81037
16000	1626	78997	255	406	0	81284
16001	864	1440	246	81594	0	84144
16002	627	564	234	83166	0	84591
16003	82504	366	235	1919	0	85024
16004	1643	298	248	82961	0	85150
16005	799	253	82040	1928	0	85020
16006	82294	194	1383	867	0	84738
16007	1763	181	501	84325	0	86770
16008	841	194	386	84576	0	85997
16009	572	221	83062	1858	0	85713
16010	77814	207	1477	1031	0	80529
16011	83188	210	585	732	0	84715
16012	1891	82712	377	493	0	85473
16013	848	1314	81531	319	0	84012
16014	589	488	80248	352	0	81677
16015	692	769	1679	78981	0	82121
16016	574	551	704	78472	0	80301
16017	389	78943	454	1679	0	81465
16018	403	1179	76490	1518	0	79590
16019	449	386	1281	75337	0	77453
16020	385	279	77456	1374	0	79494
16021	416	241	1386	74752	0	76795
16022	277	76024	626	1417	0	78344
16023	405	1140	406	78750	0	80701
16024	401	370	315	79184	0	80270
16025	432	232	292	78586	0	79542
16026	77773	215	274	1888	0	80150
16027	1383	230	76582	795	0	78990
16028	573	78993	1311	616	0	81493
16029	474	1354	539	83226	0	85593
16030	84815	474	378	1848	0	87515
16031	1790	306	301	86424	0	88821
16032	87085	202	338	2111	0	89736
16033	1981	202	86887	880	0	89950
16034	87703	157	1676	736	0	90272
16035	2194	143	658	90611	0	93606
16036	926	170	90359	1972	0	93427
16037	649	89262	1777	928	0	92616
16038	697	1642	652	89304	0	92295
16039	625	640	435	91445	0	93145
16040	89328	346	384	2403	0	92461
16041	1863	87162	393	1052	0	90470
16042	789	85635	391	747	0	87562
16043	571	88822	338	571	0	90302
16044	83038	1929	453	611	0	86031
16045	1741	82924	292	543	0	85500
16046	1033	1702	327	82227	0	85289
16047	791	577	260	83084	0	84712
16048	81914	401	232	2091	0	84638
16049	1624	80695	235	1023	0	83577
16050	763	1487	257	82715	0	85222
16051	83977	534	229	2059	0	86799
16052	84509	333	203	1009	0	86054
16053	84258	232	263	755	0	85508
16054	2127	82599	294	496	0	85516
16055	82496	1363	232	525	0	84616
16056	1836	691	218	81055	0	83800
16057	725	78725	240	1554	0	81244
16058	509	81251	192	712	0	82664
16059	766	1733	267	80566	0	83332
16060	79692	584	204	1771	0	82251
16061	81206	366	172	911	0	82655
16062	1848	354	152	78881	0	81235
16063	701	77739	224	1563	0	80227
16064	78912	1336	219	752	0	81219
16065	1573	547	76093	488	0	78701
16066	681	435	74127	456	0	75699
16067	73672	341	1360	557	0	75930
16068	1408	329	73407	409	0	75553
16069	601	237	1070	69526	0	71434
16070	70561	172	410	1189	0	72332
16071	1202	176	202	71837	0	73417
16072	472	215	71448	1166	0	73301
16073	378	71227	967	530	0	73102
16074	424	1055	349	73239	0	75067
16075	289	403	72464	1090	0	74246
16076	69461	355	994	604	0	71414
16077	1139	237	303	72044	0	73723
16078	454	208	71942	1101	0	73705
16079	348	224	936	70961	0	72469
16080	249	69873	359	1192	0	71673
16081	331	987	207	73779	0	75304
16082	331	356	131	73159	0	73977
16083	366	226	97	71461	0	72150
16084	231	71002	141	1413	0	72787
16085	72759	975	145	738	0	74617
16086	1111	367	144	73688	0	75310
16087	555	233	170	74144	0	75102
16088	419	179	162	75075	0	75835
16089	280	181	73879	1543	0	75883
16090	375	154	1007	74293	0	75829
16091	75035	160	356	1552	0	77103
16092	1153	75223	280	664	0	77320
16093	506	1140	183	77722	0	79551
16094	410	454	137	78531	0	79532
16095	77375	279	162	1774	0	79590
16096	1229	77500	179	768	0	79676
16097	78978	1210	107	687	0	80982
16098	80639	436	142	526	0	81743
16099	1776	279	146	79712	0	81913
16100	79789	239	110	1634	0	81772
16101	1542	76858	133	688	0	79221
16102	78107	1333	136	587	0	80163
16103	1685	519	103	79229	0	81536
16104	84444	307	85	1819	0	86655
16105	86975	276	116	791	0	88158
16106	2460	362	81073	561	0	84456
16107	86176	253	1411	625	0	88465
16108	89454	201	335	578	0	90568
16109	91403	207	247	799	0	92656
16110	2928	257	93956	483	0	97624
16111	1081	95214	2434	434	0	99163
16112	1001	2640	701	96259	0	100601
16113	96223	761	506	2936	0	100426
16114	2782	94543	242	957	0	98524
16115	95359	2697	146	799	0	99001
16116	3435	792	172	96001	0	100400
16117	1210	649	94707	2827	0	99393
16118	97701	306	2509	1052	0	101568
16119	3416	290	739	99807	0	104252
16120	1355	221	98897	2975	0	103448
16121	99822	213	2766	1211	0	104012
16122	3443	225	101489	772	0	105929
16123	1687	309	3196	103790	0	108982
16124	1261	275	1036	110488	0	113060
16125	108753	206	675	4408	0	114042
16126	110216	223	437	2008	0	112884
16127	4498	107294	397	1199	0	113388
16128	108359	3076	394	1025	0	112854
16129	4191	991	102565	571	0	108318
16130	1774	714	102574	504	0	105566
16131	101030	633	3629	695	0	105987
16132	3620	101349	1519	493	0	106981
16133	99727	2790	1073	556	0	104146
16134	3581	99309	663	403	0	103956
16135	99365	3119	519	544	0	103547
16136	3952	1062	420	97473	0	102907
16137	1701	737	97238	2964	0	102640
16138	1609	467	2789	97879	0	102744
16139	1244	375	1011	101848	0	104478
16140	99818	293	786	4047	0	104944
16141	3479	391	97680	1719	0	103269
16142	97454	273	2957	1441	0	102125
16143	3798	96987	1113	860	0	102758
16144	99246	2844	838	786	0	103714
16145	4157	1044	594	97251	0	103046
16146	1866	906	96267	3084	0	102123
16147	1672	593	2972	97232	0	102469
16148	98134	455	1174	3761	0	103524
16149	3883	461	907	98356	0	103607
16150	1909	465	646	98346	0	101366
16151	1427	92935	633	4104	0	99099
16152	1367	2784	568	96807	0	101526
16153	1103	998	94697	4003	0	100801
16154	1210	675	3031	95803	0	100719
16155	1171	525	1152	98584	0	101432
16156	95245	404	906	4616	0	101171
16157	3736	405	695	96048	0	100884
16158	1798	499	93232	4184	0	99713
16159	1533	93300	3044	2189	0	100066
16160	1535	2900	1278	95196	0	100909
16161	1348	1177	995	97218	0	100738
16162	94878	847	767	4440	0	100932
16163	3754	92105	736	2126	0	98721
16164	1842	3032	687	95224	0	100785
16165	92342	1159	654	4085	0	98240
16166	96034	997	578	2088	0	99697
16167	4570	649	553	95037	0	100809
16168	2295	636	93563	4123	0	100617
16169	95135	542	3075	2234	0	100986
16170	4140	662	1290	98526	0	104618
16171	97926	478	1021	4498	0	103923
16172	99800	455	841	2400	0	103496
16173	4831	94260	748	1872	0	101711
16174	95209	3085	643	1693	0	100630
16175	4501	94300	739	1339	0	100879
16176	2478	3448	677	95129	0	101732
16177	2020	1492	677	95594	0	99783
16178	1629	93846	721	4378	0	100574
16179	95756	3264	598	2586	0	102204
16180	96112	1404	661	2103	0	100280
16181	4686	1091	90721	1687	0	98185
16182	2508	891	90869	1564	0	95832
16183	2095	764	3644	92486	0	98989
16184	93186	559	1677	4274	0	99696
16185	4105	596	1240	93291	0	99232
16186	2262	532	891	95864	0	99549
16187	1896	561	92241	4985	0	99683
16188	1624	597	92497	2683	0	97401
16189	1528	596	93947	2157	0	98228
16190	90664	778	4338	1880	0	97660
16191	93169	678	2057	1597	0	97501
16192	4405	87864	1402	1502	0	95173
16193	2308	91067	986	1452	0	95813
16194	2064	3638	860	90332	0	96894
16195	1560	1633	89313	3817	0	96323
16196	88608	1161	3042	2240	0	95051
16197	3886	854	91257	1747	0	97744
16198	2047	728	3324	90751	0	96850
16199	1682	504	1539	94013	0	97738
16200	1458	523	1225	94792	0	97998
16201	1501	449	897	96119	0	98966
16202	92732	492	820	5190	0	99234
16203	4064	628	683	92814	0	98189
16204	1693	467	86670	4060	0	92890
16205	82420	379	2486	2396	0	87681
16206	3136	391	84348	1728	0	89603
16207	1715	462	83246	1290	0	86713
16208	1402	82062	3136	1306	0	87906
16209	1881	1922	1725	74630	0	80158
16210	73658	713	1029	2077	0	77477
16211	1911	458	500	73934	0	76803
16212	980	382	73227	2020	0	76609
16213	819	269	1515	74293	0	76896
16214	73487	203	796	2270	0	76756
16215	1685	73379	529	1342	0	76935
16216	72542	1286	487	1154	0	75469
16217	1807	71639	368	861	0	74675
16218	71307	1378	438	979	0	74102
16219	1631	69826	369	602	0	72428
16220	889	70459	315	532	0	72195
16221	759	1534	68089	407	0	70789
16222	661	67108	1313	379	0	69461
16223	61401	935	654	359	0	63349
16224	860	364	182	60475	0	61881
16225	60622	160	97	860	0	61739
16226	802	61472	87	339	0	62700
16227	61359	752	92	356	0	62559
16228	921	286	61388	173	0	62768
16229	408	191	774	61161	0	62534
16230	260	62156	304	820	0	63540
16231	282	787	188	64357	0	65614
16232	279	278	131	65057	0	65745
16233	70564	189	130	1330	0	72213
16234	1329	71510	119	513	0	73471
16235	73056	1340	107	425	0	74928
16236	1674	551	73438	214	0	75877
16237	698	360	71357	166	0	72581
16238	427	72528	1787	211	0	74953
16239	490	1392	747	73128	0	75757
16240	285	564	73747	1429	0	76025
16241	511	326	1562	70351	0	72750
16242	337	271	611	75801	0	77020
16243	235	231	72680	2087	0	75233
16244	261	215	72859	907	0	74242
16245	229	196	75587	587	0	76599
16246	243	170	76050	404	0	76867
16247	182	77235	2182	433	0	80032
16248	385	1478	992	77330	0	80185
16249	281	624	595	80057	0	81557
16250	205	378	78495	2117	0	81195
16251	330	283	1716	77942	0	80271
16252	209	259	81716	2024	0	84208
16253	317	181	1855	81365	0	83718
16254	307	167	843	81884	0	83201
16255	151	81282	600	2262	0	84295
16256	309	1586	401	82993	0	85289
16257	419	614	379	82892	0	84304
16258	311	410	307	83725	0	84753
16259	209	357	80779	2566	0	83911
16260	184	80578	1619	1302	0	83683
16261	80849	1582	723	962	0	84116
16262	81864	667	470	790	0	83791
16263	2160	456	388	80841	0	83845
16264	1096	441	339	80234	0	82110
16265	619	81028	288	2243	0	84178
16266	80982	1636	294	1322	0	84234
16267	1705	82336	291	798	0	85130
16268	81112	1743	247	740	0	83842
16269	1845	788	79091	459	0	82183
16270	76711	529	1618	589	0	79447
16271	1782	78677	694	449	0	81602
16272	930	1535	458	79840	0	82763
16273	635	658	390	80291	0	81974
16274	399	79200	319	2054	0	81972
16275	80418	1611	245	1209	0	83483
16276	1745	736	277	82050	0	84808
16277	815	500	281	84178	0	85774
16278	83537	406	251	2521	0	86715
16279	85777	368	257	1290	0	87692
16280	2356	306	84476	760	0	87898
16281	86241	280	1734	762	0	89017
16282	2331	313	751	87132	0	90527
16283	1101	286	86910	2053	0	90350
16284	850	281	1899	86384	0	89414
16285	498	321	85583	2306	0	88708
16286	452	292	86374	1144	0	88262
16287	517	332	2419	86411	0	89679
16288	306	312	87531	2246	0	90395
16289	313	87668	2200	1257	0	91438
16290	448	1715	1017	88463	0	91643
16291	408	713	723	92177	0	94021
16292	382	505	90613	2629	0	94129
16293	338	90336	2025	1384	0	94083
16294	91310	1872	937	1152	0	95271
16295	2078	797	623	93066	0	96564
16296	92945	530	516	2586	0	96577
16297	2204	91381	543	1214	0	95342
16298	1080	2098	92553	921	0	96652
16299	876	1004	2167	92197	0	96244
16300	92357	570	1094	2602	0	96623
16301	2150	487	91794	1277	0	95708
16302	89230	359	2245	1196	0	93030
16303	2355	89223	1185	740	0	93503
16304	978	90931	708	704	0	93321
16305	90339	2220	739	789	0	94087
16306	2265	1020	594	89609	0	93488
16307	1113	708	510	89474	0	91805
16308	659	89319	426	2888	0	93292
16309	617	1931	444	91737	0	94729
16310	571	831	380	92873	0	94655
16311	90362	552	330	3098	0	94342
16312	2035	439	396	90702	0	93572
16313	945	367	89495	2617	0	93424
16314	781	341	1886	90084	0	93092
16315	588	306	876	92875	0	94645
16316	496	337	91157	2926	0	94916
16317	479	368	1935	91936	0	94718
16318	89778	266	895	3079	0	94018
16319	89314	295	631	1704	0	91944
16320	90101	247	458	1384	0	92190
16321	2771	268	422	89150	0	92611
16322	1339	383	88177	2403	0	92302
16323	921	88264	1752	1405	0	92342
16324	865	1780	762	90003	0	93410
16325	683	764	89784	2304	0	93535
16326	760	585	1810	88592	0	91747
16327	586	450	834	90428	0	92298
16328	87129	316	607	2921	0	90973
16329	1835	88975	498	1473	0	92781
16330	1007	1674	86898	968	0	90547
16331	82200	745	1768	1128	0	85841
16332	1930	84979	882	839	0	88630
16333	638	80403	401	482	0	81924
16334	81614	1380	867	598	0	84459
16335	1579	592	317	82105	0	84593
16336	654	393	87552	1413	0	90012
16337	608	375	1347	86459	0	88789
16338	343	88107	536	1593	0	90579
16339	89796	1378	349	930	0	92453
16340	1573	564	261	90426	0	92824
16341	91701	334	219	1926	0	94180
16342	1717	233	200	90784	0	92934
16343	653	92585	232	1629	0	95099
16344	94786	1456	216	1000	0	97458
16345	95492	514	197	821	0	97024
16346	2078	94783	223	513	0	97597
16347	93941	1572	166	614	0	96293
16348	1979	687	140	91839	0	94645
16349	752	91722	202	1594	0	94270
16350	92542	1583	173	855	0	95153
16351	1757	93065	191	481	0	95494
16352	92182	1645	176	624	0	94627
16353	1900	620	132	92114	0	94766
16354	93071	397	177	1902	0	95547
16355	93716	304	147	991	0	95158
16356	94284	339	136	711	0	95470
16357	2317	311	104	93239	0	95971
16358	1110	258	115	94929	0	96412
16359	93422	212	105	2285	0	96024
16360	1911	286	93378	871	0	96446
16361	988	268	1438	93791	0	96485
16362	663	94656	481	1851	0	97651
16363	680	1610	236	97145	0	99671
16364	678	636	165	98262	0	99741
16365	574	431	95436	2238	0	98679
16366	653	382	1549	100051	0	102635
16367	435	102917	592	2376	0	106320
16368	632	2243	289	107188	0	110352
16369	524	1018	113169	2712	0	117423
16370	814	536	2561	114091	0	118002
16371	785	354	1040	118293	0	120472
16372	115335	293	488	4482	0	120598
16373	116708	278	321	2234	0	119541
16374	4266	409	251	114676	0	119602
16375	1863	110247	321	3445	0	115876
16376	1017	114237	253	1806	0	117313
16377	895	3523	111467	1052	0	116937
16378	1048	2188	2678	110696	0	116610
16379	110289	873	1283	3506	0	115951
16380	3057	748	563	111077	0	115445
16381	1352	512	110188	3389	0	115441
16382	1045	403	2625	110924	0	114997
16383	899	333	1191	113182	0	115605
16384	867	299	618	115090	0	116874
16385	625	349	110619	4447	0	116040
16386	595	110333	2576	2243	0	115747
16387	110018	2578	1134	1675	0	115405
16388	110388	1162	611	1316	0	113477
16389	3949	731	407	107712	0	112799
16390	1841	583	106721	3053	0	112198
16391	1060	106384	2568	1727	0	111739
16392	1080	3241	1180	104066	0	109567
16393	706	105651	651	2826	0	109834
16394	529	109082	424	1549	0	111584
16395	106030	3409	598	1173	0	111210
16396	2810	1559	105580	781	0	110730
16397	1436	859	104644	695	0	107634
16398	1191	775	3203	104229	0	109398
16399	913	470	1390	108220	0	110993
16400	683	475	107158	3536	0	111852
16401	926	390	2493	105088	0	108897
16402	645	425	106510	3297	0	110877
16403	101251	336	2752	2033	0	106372
16404	2748	432	1303	106257	0	110740
16405	1426	490	108928	2982	0	113826
16406	1114	473	2545	105414	0	109546
16407	704	112019	1261	3035	0	117019
16408	112527	2436	742	2037	0	117742
16409	2576	112712	618	1290	0	117196
16410	114116	2708	551	1308	0	118683
16411	2969	1405	111259	944	0	116577
16412	112459	807	2460	1186	0	116912
16413	3161	629	1225	114446	0	119461
16414	1676	543	114389	2952	0	119560
16415	1188	439	2671	113891	0	118189
16416	844	451	112020	3341	0	116656
16417	106414	406	2823	2254	0	111897
16418	2697	112008	1480	1471	0	117656
16419	1597	2395	933	110293	0	115218
16420	894	114476	790	2834	0	118994
16421	114410	2856	625	2022	0	119913
16422	115065	1418	590	1544	0	118617
16423	3576	114245	580	1236	0	119637
16424	1919	2753	547	115899	0	121118
16425	1281	1423	515	116973	0	120192
16426	1080	878	470	117221	0	119649
16427	113952	697	562	4620	0	119831
16428	2682	112738	675	2536	0	118631
16429	1483	2609	633	113279	0	118004
16430	1033	1388	696	114831	0	117948
16431	111349	790	655	4526	0	117320
16432	2906	693	108868	2453	0	114920
16433	1662	575	106666	1979	0	110882
16434	104655	452	3307	1696	0	110110
16435	2847	475	106113	1319	0	110754
16436	1512	543	98335	942	0	101332
16437	1256	834	3322	96289	0	101701
16438	98758	434	1846	2794	0	103832
16439	2549	442	1022	98802	0	102815
16440	1446	386	97506	2846	0	102184
16441	93029	423	2395	1936	0	97783
16442	2621	497	95630	1106	0	99854
16443	1363	95834	2482	959	0	100638
16444	1283	2312	1685	98015	0	103295
16445	98501	1062	961	2639	0	103163
16446	2156	629	731	98782	0	102298
16447	1217	424	707	100155	0	102503
16448	101095	302	560	3357	0	105314
16449	2211	281	516	102682	0	105690
16450	1341	261	514	104731	0	106847
16451	788	300	102756	3155	0	106999
16452	712	280	1873	102911	0	105776
16453	103626	248	1162	2988	0	108024
16454	103823	301	613	1998	0	106735
16455	104623	319	617	1250	0	106809
16456	3099	508	459	101622	0	105688
16457	1656	100349	440	2183	0	104628
16458	102244	1783	411	1481	0	105919
16459	2161	102599	439	994	0	106193
16460	102151	1935	398	890	0	105374
16461	2391	1051	385	101872	0	105699
16462	101403	570	401	2162	0	104536
16463	100838	390	389	1560	0	103177
16464	101115	316	465	1185	0	103081
16465	2837	98045	511	746	0	102139
16466	1165	95020	363	631	0	97179
16467	91180	1178	419	620	0	93397
16468	1226	91374	226	393	0	93219
16469	282	83332	132	184	0	83930
16470	291	83147	256	128	0	83822
16471	83568	583	487	369	0	85007
16472	578	215	68	82937	0	83798
16473	279	104	10	83610	0	84003
16474	83999	61	110	905	0	85075
16475	514	79	85260	248	0	86101
16476	414	49	442	92722	0	93627
16477	328	51	163	94108	0	94650
16478	275	38	106	102118	0	102537
16479	331	56	43	104975	0	105405
16480	85	102965	160	2548	0	105758
16481	63	123068	117	1126	0	124374
16482	125384	2967	40	909	0	129300
16483	3109	1253	28	126010	0	130400
16484	1493	737	26	129132	0	131388
16485	797	468	125367	3990	0	130622
16486	864	254	2756	127068	0	130942
16487	327	300	128140	4097	0	132864
16488	653	162	3489	129437	0	133741
16489	246	211	133988	4185	0	138630
16490	120	132383	4035	1992	0	138530
16491	530	3221	1549	135560	0	140860
16492	135039	1185	986	4401	0	141611
16493	136609	762	614	2045	0	140030
16494	5014	493	376	134999	0	140882
16495	2119	415	134041	4199	0	140774
16496	1394	376	133358	1866	0	136994
16497	128310	248	4595	1809	0	134962
16498	3750	131452	2105	1071	0	138378
16499	134810	3505	1304	1165	0	140784
16500	135726	1336	825	1145	0	139032
16501	5232	1019	131674	774	0	138699
16502	2872	626	3860	130348	0	137706
16503	2143	441	1662	133135	0	137381
16504	1523	447	1127	139294	0	142391
16505	1337	305	763	134250	0	136655
16506	1381	305	689	131348	0	133723
16507	668	347	124801	6911	0	132727
16508	648	327	125656	3543	0	130174
16509	1091	278	4995	126516	0	132880
16510	1180	307	2339	130011	0	133837
16511	1158	343	1510	132345	0	135356
16512	126981	341	1132	6909	0	135363
16513	4763	395	827	128609	0	134594
16514	128459	335	682	6151	0	135627
16515	5600	337	611	132004	0	138552
16516	132970	262	568	6543	0	140343
16517	136726	218	687	3621	0	141252
16518	134898	214	692	2874	0	138678
16519	135626	253	744	2379	0	139002
16520	135969	248	654	2060	0	138931
16521	7520	333	649	130715	0	139217
16522	131231	374	630	5624	0	137859
16523	5987	127732	648	2980	0	137347
16524	131519	3846	713	2451	0	138529
16525	6144	1544	633	131982	0	140303
16526	2994	1026	129706	5780	0	139506
16527	2424	688	4256	133006	0	140374
16528	1897	577	131746	6392	0	140612
16529	1961	409	5067	133162	0	140599
16530	1896	421	2312	137741	0	142370
16531	1596	403	132598	7259	0	141856
16532	1547	418	132583	4120	0	138668
16533	1737	365	5892	134111	0	142105
16534	132842	312	2813	6646	0	142613
16535	5449	358	131848	3584	0	141239
16536	2810	131320	5063	2978	0	142171
16537	2226	3978	136350	2357	0	144911
16538	135430	1568	5518	2403	0	144919
16539	5805	1129	2631	136717	0	146282
16540	138338	759	1915	5924	0	146936
16541	141055	478	1388	3538	0	146459
16542	7277	439	1350	138365	0	147431
16543	3797	446	133561	6351	0	144155
16544	2970	360	4890	134283	0	142503
16545	2312	354	2434	137134	0	142234
16546	130054	364	1789	8154	0	140361
16547	5519	130769	1526	4541	0	142355
16548	3183	4065	1369	134497	0	143114
16549	2423	1630	130012	6528	0	140593
16550	127138	1115	4976	4002	0	137231
16551	5732	128035	2504	3182	0	139453
16552	3358	4332	1827	131425	0	140942
16553	2674	1823	1455	133965	0	139917
16554	2330	1172	1343	136298	0	141143
16555	130164	772	1263	8506	0	140705
16556	134244	554	1123	5018	0	140939
16557	7487	508	1079	133196	0	142270
16558	4027	581	129255	7036	0	140899
16559	2903	128984	4826	4172	0	140885
16560	130853	4287	2388	3475	0	141003
16561	135855	1724	1671	2939	0	142189
16562	7577	1095	1258	132394	0	142324
16563	4329	834	1204	137051	0	143418
16564	3029	726	132486	7743	0	143984
16565	2310	132648	5017	4534	0	144509
16566	136608	4548	2383	3606	0	147145
16567	136552	1897	1675	3016	0	143140
16568	7160	133588	1304	2532	0	144584
16569	135231	4845	1063	2403	0	143542
16570	7264	1987	966	133297	0	143514
16571	3743	1399	130423	6466	0	142031
16572	3282	949	4867	133530	0	142628
16573	2487	755	130728	6993	0	140963
16574	128581	655	5518	4310	0	139064
16575	5836	127652	2724	3180	0	139392
16576	3012	4843	1477	121305	0	130637
16577	2193	1543	119895	5507	0	129138
16578	1843	984	115398	2762	0	120987
16579	108558	1278	4639	2505	0	116980
16580	4022	108425	2293	1913	0	116653
16581	92558	2265	1942	1067	0	97832
16582	91258	833	915	977	0	93983
16583	91455	460	589	877	0	93381
16584	3231	692	672	88404	0	92999
16585	1549	360	88077	2424	0	92410
16586	1039	87859	1980	1142	0	92020
16587	1226	2475	1146	87678	0	92525
16588	864	751	87862	2369	0	91846
16589	662	479	82114	890	0	84145
16590	684	497	1816	81554	0	84551
16591	551	240	80952	1785	0	83528
16592	78090	240	1682	992	0	81004
16593	1712	218	738	81051	0	83719
16594	899	219	535	83361	0	85014
16595	82399	241	433	2120	0	85193
16596	1628	81096	414	938	0	84076
16597	84806	1328	367	926	0	87427
16598	1865	572	394	84041	0	86872
16599	1043	346	348	85231	0	86968
16600	799	294	370	85697	0	87160
16601	742	247	357	84148	0	85494
16602	82453	261	354	2302	0	85370
16603	1765	280	81459	1066	0	84570
16604	840	80799	1370	749	0	83758
16605	673	1245	639	82186	0	84743
16606	78426	556	486	1933	0	81401
16607	82027	337	396	1073	0	83833
16608	1754	81326	389	741	0	84210
16609	80364	1165	335	789	0	82653
16610	1527	79990	398	587	0	82502
16611	742	83067	309	589	0	84707
16612	747	1607	395	83393	0	86142
16613	562	588	83258	1577	0	85985
16614	645	757	1233	81459	0	84094
16615	80146	356	572	1822	0	82896
16616	1418	78122	368	1098	0	81006
16617	764	1198	260	79476	0	81698
16618	584	500	82942	1490	0	85516
16619	83111	335	1257	1100	0	85803
16620	86428	275	499	872	0	88074
16621	87233	256	347	765	0	88601
16622	1809	280	83895	435	0	86419
16623	82310	292	1141	566	0	84309
16624	1454	83545	518	409	0	85926
16625	724	1261	322	81488	0	83795
16626	508	83312	317	1098	0	85235
16627	83939	1161	273	748	0	86121
16628	81066	449	262	675	0	82452
16629	1415	342	83637	394	0	85788
16630	622	83338	1060	365	0	85385
16631	591	1106	536	83817	0	86050
16632	471	419	321	84578	0	85789
16633	439	298	290	83961	0	84988
16634	568	231	285	83841	0	84925
16635	507	240	230	86018	0	86995
16636	454	236	82540	1671	0	84901
16637	369	81728	1214	751	0	84062
16638	81545	1241	437	650	0	83873
16639	1528	452	82944	409	0	85333
16640	668	84302	1325	395	0	86690
16641	85353	1297	495	516	0	87661
16642	1610	487	87508	361	0	89966
16643	85483	324	1474	553	0	87834
16644	85212	302	511	620	0	86645
16645	87324	265	293	487	0	88369
16646	1832	86919	295	392	0	89438
16647	724	1487	85260	346	0	87817
16648	464	86398	1428	341	0	88631
16649	989	1708	524	74781	0	78002
16650	353	86224	322	1315	0	88214
16651	85785	1417	311	686	0	88199
16652	88490	470	199	556	0	89715
16653	87054	292	192	683	0	88221
16654	2016	292	87604	362	0	90274
16655	812	90448	1548	397	0	93205
16656	751	1647	512	97794	0	100704
16657	103644	558	282	2161	0	106645
16658	2389	102832	309	727	0	106257
16659	1207	2311	205	103091	0	106814
16660	696	798	104563	2355	0	108412
16661	104319	476	2362	1032	0	108189
16662	2784	406	109487	548	0	113225
16663	1130	300	112253	368	0	114051
16664	106303	242	3255	550	0	110350
16665	2983	278	108423	224	0	111908
16666	103569	245	2896	397	0	107107
16667	2841	103933	1147	222	0	108143
16668	107528	2340	734	508	0	111110
16669	3201	855	493	107240	0	111789
16670	1736	490	412	107365	0	110003
16671	1165	320	398	110384	0	112267
16672	108572	220	396	3717	0	112905
16673	108673	198	373	1708	0	110952
16674	109538	241	324	1067	0	111170
16675	3749	105565	338	545	0	110197
16676	1903	2378	292	107261	0	111834
16677	1172	907	105919	2696	0	110694
16678	1063	562	2443	103330	0	107398
16679	675	102277	995	3042	0	106989
16680	935	2397	575	104116	0	108023
16681	912	924	401	106152	0	108389
16682	104288	605	276	3806	0	108975
16683	3082	450	286	105183	0	109001
16684	1293	406	103377	3379	0	108455
16685	963	410	102347	1565	0	105285
16686	1007	331	3248	103298	0	107884
16687	102730	297	1382	3380	0	107789
16688	3136	392	844	102524	0	106896
16689	1630	291	566	105608	0	108095
16690	996	300	103099	3837	0	108232
16691	776	101981	2804	1824	0	107385
16692	886	2422	1209	104125	0	108642
16693	101663	940	979	3397	0	106979
16694	2823	101473	677	1582	0	106555
16695	1633	2599	476	102896	0	107604
16696	1081	1081	101765	3261	0	107188
16697	1028	717	2696	100251	0	104692
16698	98577	491	1238	3749	0	104055
16699	2780	97702	913	1783	0	103178
16700	1392	2657	99285	1214	0	104548
16701	1274	1139	2646	98555	0	103614
16702	902	799	100324	3251	0	105276
16703	98242	599	3055	1801	0	103697
16704	100749	482	1334	1537	0	104102
16705	3702	503	99728	1022	0	104955
16706	2001	446	2906	98829	0	104182
16707	1336	552	101004	3054	0	105946
16708	972	99688	3259	1643	0	105562
16709	992	2698	1675	101427	0	106792
16710	823	1142	101252	3387	0	106604
16711	1035	917	3103	96986	0	102041
16712	814	98247	1527	3283	0	103871
16713	1037	2626	1079	99955	0	104697
16714	758	1092	98547	3545	0	103942
16715	95267	794	2988	2050	0	101099
16716	2894	97912	1538	1464	0	103808
16717	99977	2729	1113	1383	0	105202
16718	3461	1221	95764	1097	0	101543
16719	94695	853	2970	1214	0	99732
16720	3502	649	94891	1097	0	100139
16721	94335	692	3408	1112	0	99547
16722	98413	558	1556	1220	0	101747
16723	4088	527	1169	96109	0	101893
16724	2220	556	905	99152	0	102833
16725	97744	609	796	4095	0	103244
16726	3428	97286	842	2275	0	103831
16727	99775	2773	929	1664	0	105141
16728	3960	1162	850	98295	0	104267
16729	1971	97527	925	3414	0	103837
16730	1752	2814	796	101516	0	106878
16731	1487	1114	789	104187	0	107577
16732	1323	781	782	103261	0	106147
16733	1113	100119	762	4602	0	106596
16734	100730	2725	628	2411	0	106494
16735	3453	1347	621	101213	0	106634
16736	1686	886	98995	3674	0	105241
16737	1307	704	97258	2190	0	101459
16738	1067	674	98444	1778	0	101963
16739	97125	654	3792	1669	0	103240
16740	98582	527	1890	1478	0	102477
16741	3665	555	95990	1238	0	101448
16742	1977	634	2694	90707	0	96012
16743	1382	534	1369	93647	0	96932
16744	871	469	96118	3736	0	101194
16745	819	495	95675	2094	0	99083
16746	935	458	3294	96904	0	101591
16747	97159	389	1757	3203	0	102508
16748	96089	353	1212	1878	0	99532
16749	96379	352	970	1584	0	99285
16750	3540	92919	939	1275	0	98673
16751	1812	95773	907	1143	0	99635
16752	1443	2737	799	94841	0	99820
16753	94486	1116	793	2809	0	99204
16754	2660	819	91507	1452	0	96438
16755	85420	551	2058	1492	0	89521
16756	2265	81206	968	890	0	85329
16757	879	76744	470	460	0	78553
16758	75666	1577	663	599	0	78505
16759	1420	74951	422	433	0	77226
16760	650	73313	379	361	0	74703
16761	71154	1857	1305	985	0	75301
16762	971	71644	271	280	0	73166
16763	372	715	151	70260	0	71498
16764	281	275	93	71006	0	71655
16765	70527	177	95	990	0	71789
16766	70249	122	146	426	0	70943
16767	836	70324	150	248	0	71558
16768	348	70750	143	186	0	71427
16769	274	752	69997	138	0	71161
16770	70878	374	772	241	0	72265
16771	73569	203	276	273	0	74321
16772	75460	126	141	259	0	75986
16773	1118	110	104	76121	0	77453
16774	472	90	81	79102	0	79745
16775	79921	90	98	1205	0	81314
16776	1142	98	84	80524	0	81848
16777	368	126	81079	1137	0	82710
16778	402	127	893	81076	0	82498
16779	218	83621	302	1120	0	85261
16780	310	1034	161	85485	0	86990
16781	312	342	97	87679	0	88430
16782	305	204	71	88318	0	88898
16783	87019	124	81	1737	0	88961
16784	1117	86321	145	666	0	88249
16785	502	1073	96	88605	0	90276
16786	271	391	88399	1321	0	90382
16787	288	315	84374	530	0	85507
16788	389	191	1373	86889	0	88842
16789	326	140	482	88261	0	89209
16790	86834	135	248	1698	0	88915
16791	1366	164	158	85455	0	87143
16792	469	85165	177	1451	0	87262
16793	318	1153	87286	627	0	89384
16794	405	463	1144	88579	0	90591
16795	258	258	89915	1458	0	91889
16796	333	218	1249	89985	0	91785
16797	90206	148	475	1606	0	92435
16798	90967	166	254	768	0	92155
16799	1532	89750	280	456	0	92018
16800	758	1151	192	90626	0	92727
16801	92913	407	191	1509	0	95020
16802	94285	217	206	793	0	95501
16803	95321	187	190	647	0	96345
16804	95279	128	194	555	0	96156
16805	94589	133	186	506	0	95414
16806	1791	91922	233	354	0	94300
16807	93046	1094	175	427	0	94742
16808	1543	401	91288	300	0	93532
16809	799	211	1081	92028	0	94119
16810	93399	166	365	1459	0	95389
16811	93522	145	222	716	0	94605
16812	93405	147	181	551	0	94284
16813	1798	209	91712	408	0	94127
16814	953	151	1129	93009	0	95242
16815	95384	136	402	1537	0	97459
16816	1449	94731	289	630	0	97099
16817	98258	1237	177	701	0	100373
16818	97201	418	157	549	0	98325
16819	97877	267	152	484	0	98780
16820	1908	337	157	98171	0	100573
16821	99299	217	144	1719	0	101379
16822	1775	265	97157	672	0	99869
16823	854	271	96184	535	0	97844
16824	98066	176	1535	645	0	100422
16825	1634	175	99007	410	0	101226
16826	94774	132	1313	549	0	96768
16827	1536	171	97339	329	0	99375
16828	796	319	1214	95750	0	98079
16829	95457	108	495	1498	0	97558
16830	1411	93686	339	615	0	96051
16831	96433	1053	229	675	0	98390
16832	1445	93108	237	427	0	95217
16833	702	97891	231	349	0	99173
16834	626	1243	232	100258	0	102359
16835	558	426	246	100649	0	101879
16836	510	260	241	100333	0	101344
16837	407	220	98184	1621	0	100432
16838	96687	164	1188	926	0	98965
16839	102964	155	481	647	0	104247
16840	103726	129	287	634	0	104776
16841	104190	141	179	574	0	105084
16842	104198	155	209	495	0	105057
16843	2116	225	96560	418	0	99319
16844	1083	228	98111	340	0	99762
16845	806	147	1529	100726	0	103208
16846	646	191	100184	1501	0	102522
16847	100991	167	1418	791	0	103367
16848	1920	104679	566	468	0	107633
16849	988	1543	319	110456	0	113306
16850	111565	497	255	2054	0	114371
16851	2409	290	231	113536	0	116466
16852	1146	242	113720	2134	0	117242
16853	923	229	113324	884	0	115360
16854	859	167	2367	117681	0	121074
16855	654	194	117841	2120	0	120809
16856	114937	155	2221	1040	0	118353
16857	2412	147	916	117820	0	121295
16858	1173	173	117531	2124	0	121001
16859	782	116593	2101	1026	0	120502
16860	920	1758	829	120100	0	123607
16861	706	728	120959	2193	0	124586
16862	871	417	2135	117368	0	120791
16863	812	215	901	120207	0	122135
16864	642	210	120766	2933	0	124551
16865	788	198	2259	120576	0	123821
16866	824	187	1042	117852	0	119905
16867	772	147	661	122453	0	124033
16868	118527	148	532	3296	0	122503
16869	2398	115354	492	1484	0	119728
16870	1161	118952	422	924	0	121459
16871	864	2459	115568	653	0	119544
16872	112026	875	2007	733	0	115641
16873	2145	474	113191	496	0	116306
16874	954	348	111046	441	0	112789
16875	693	512	2280	109219	0	112704
16876	110121	150	1037	2086	0	113394
16877	1798	109693	623	1015	0	113129
16878	109602	1587	520	931	0	112640
16879	108401	622	379	779	0	110181
16880	2201	108647	334	451	0	111633
16881	108686	1558	455	559	0	111258
16882	108028	633	403	555	0	109619
16883	2087	108290	334	375	0	111086
16884	1076	1681	322	109359	0	112438
16885	845	691	346	111653	0	113535
16886	112614	342	342	2253	0	115551
16887	1800	113636	352	1073	0	116861
16888	117273	1815	273	792	0	120153
16889	118418	754	258	684	0	120114
16890	123780	381	241	647	0	125049
16891	3236	282	232	121594	0	125344
16892	1533	277	236	124899	0	126945
16893	122836	229	237	3037	0	126339
16894	125211	201	231	1408	0	127051
16895	126150	235	212	901	0	127498
16896	3639	213	217	127610	0	131679
16897	1502	271	127134	2818	0	131725
16898	1090	246	2433	130191	0	133960
16899	978	226	898	139527	0	141629
16900	666	298	136089	3920	0	140973
16901	702	319	146079	1698	0	148798
16902	984	259	4345	148985	0	154573
16903	644	289	149369	4121	0	154423
16904	150395	168	4165	2246	0	156974
16905	4293	171	1835	152446	0	158745
16906	2201	209	1032	156840	0	160282
16907	156582	179	658	5788	0	163207
16908	4599	204	729	156714	0	162246
16909	2519	210	542	159067	0	162338
16910	1502	187	579	161011	0	163279
16911	1413	195	485	161616	0	163709
16912	951	261	154185	6512	0	161909
16913	1053	206	3664	157039	0	161962
16914	849	304	152606	5472	0	159231
16915	755	153187	4171	3100	0	161213
16916	1005	3689	1816	154871	0	161381
16917	728	1511	151110	5095	0	158444
16918	143891	700	4191	3259	0	152041
16919	4198	149558	2142	1894	0	157792
16920	152036	3790	1159	1806	0	158791
16921	4992	1589	891	147518	0	154990
16922	2173	147455	858	4536	0	155022
16923	148537	3836	692	2823	0	155888
16924	4336	149323	737	1829	0	156225
16925	151165	4239	648	1594	0	157646
16926	5135	2014	598	149913	0	157660
16927	151174	1094	581	4960	0	157809
16928	4856	151341	644	2613	0	159454
16929	153162	4347	580	1914	0	160003
16930	5330	1945	148307	1381	0	156963
16931	3008	1162	4048	150475	0	158693
16932	149645	720	1849	5188	0	157402
16933	152195	640	1042	3012	0	156889
16934	6559	627	822	148455	0	156463
16935	3080	741	146954	5159	0	155934
16936	2070	139250	4154	2905	0	148379
16937	1673	149168	1988	1953	0	154782
16938	150272	5112	1306	2101	0	158791
16939	5259	2144	812	148676	0	156891
16940	2974	1062	839	152114	0	156989
16941	148748	782	793	6657	0	156980
16942	149742	733	1047	3521	0	155043
16943	6166	775	146003	2197	0	155141
16944	3397	827	4083	147205	0	155512
16945	2250	641	145260	5324	0	153475
16946	1871	144032	4302	3283	0	153488
16947	139150	3683	2122	2887	0	147842
16948	4363	139148	1337	2113	0	146961
16949	2425	140887	1068	1810	0	146190
16950	2239	4721	1183	139482	0	147625
16951	135473	2012	977	4993	0	143455
16952	4015	135066	1011	2943	0	143035
16953	134174	3947	887	2410	0	141418
16954	4443	132408	1002	1777	0	139630
16955	2588	4119	796	134501	0	142004
16956	133743	2084	948	4840	0	141615
16957	4452	1487	132833	2896	0	141668
16958	3027	1478	3695	133224	0	141424
16959	2103	1180	131686	4805	0	139774
16960	1901	124359	3881	3048	0	133189
16961	1592	131606	1882	2348	0	137428
16962	127244	4709	1356	2448	0	135757
16963	4071	129499	1089	2049	0	136708
16964	129618	4195	1158	2155	0	137126
16965	132024	2146	1028	2071	0	137269
16966	5283	1734	126215	1666	0	134898
16967	128051	1365	3521	1957	0	134894
16968	4913	1537	129356	1608	0	137414
16969	3133	128874	3917	1635	0	137559
16970	130787	4020	1989	1714	0	138510
16971	4948	129106	1465	1572	0	137091
16972	3192	3996	1104	131140	0	139432
16973	131790	2113	1158	4559	0	139620
16974	5300	1508	846	131397	0	139051
16975	3067	1437	131391	4856	0	140751
16976	2376	1512	3634	131325	0	138847
16977	2068	1458	1795	134510	0	139831
16978	131930	1515	1146	5741	0	140332
16979	4755	1518	129452	3107	0	138832
16980	130576	1230	3810	2312	0	137928
16981	136003	1144	1903	2174	0	141224
16982	6142	1190	1369	133546	0	142247
16983	3834	1099	1006	135420	0	141359
16984	132512	1121	1041	5843	0	140517
16985	5420	131066	1091	2928	0	140505
16986	3454	3847	1003	130477	0	138781
16987	2372	1982	126179	4209	0	134742
16988	2183	1501	120394	2513	0	126591
16989	1929	125666	4031	1944	0	133570
16990	2046	3829	1820	121338	0	129033
16991	1817	2044	1128	123718	0	128707
16992	120257	1483	844	4874	0	127458
16993	4392	1327	823	119305	0	125847
16994	115547	1085	855	4203	0	121690
16995	4119	111717	901	2416	0	119153
16996	2176	110258	670	1672	0	114776
16997	1765	113841	622	1526	0	117754
16998	109892	3531	1228	1877	0	116528
16999	102421	1619	1064	1493	0	106597
17000	3510	99311	578	1124	0	104523
17001	87057	1199	455	464	0	89175
17002	1395	85064	165	343	0	86967
17003	706	1370	154	83888	0	86118
17004	392	83600	186	1164	0	85342
17005	83945	1479	305	756	0	86485
17006	84079	536	153	510	0	85278
17007	1578	393	103	81245	0	83319
17008	81465	281	102	1403	0	83251
17009	1464	297	132	80962	0	82855
17010	585	81455	158	1296	0	83494
17011	603	1579	137	81805	0	84124
17012	423	81621	142	1247	0	83433
17013	81279	1158	158	671	0	83266
17014	1263	494	78587	376	0	80720
17015	76545	288	837	421	0	78091
17016	1188	237	254	78553	0	80232
17017	470	279	77145	982	0	78876
17018	75757	198	820	675	0	77450
17019	1104	258	79368	304	0	81034
17020	592	257	907	77482	0	79238
17021	472	209	332	79312	0	80325
17022	406	185	175	78571	0	79337
17023	399	204	142	78761	0	79506
17024	328	76364	174	1406	0	78272
17025	433	1081	154	81332	0	83000
17026	80639	364	158	1557	0	82718
17027	1266	304	79023	490	0	81083
17028	478	82527	1052	450	0	84507
17029	84632	1354	370	560	0	86916
17030	90244	492	231	494	0	91461
17031	2268	380	138	98912	0	101698
17032	829	309	98602	2319	0	102059
17033	758	315	2082	98221	0	101376
17034	647	288	840	105228	0	107003
17035	404	251	102861	3359	0	106875
17036	370	106350	2557	1434	0	110711
17037	108947	2740	1068	956	0	113711
17038	109707	1166	408	857	0	112138
17039	112672	534	368	724	0	114298
17040	4633	359	312	109324	0	114628
17041	2335	271	247	114622	0	117475
17042	115087	233	236	4511	0	120067
17043	3945	267	231	110818	0	115261
17044	1844	111869	296	3595	0	117604
17045	116673	2989	206	2029	0	121897
17046	117640	1343	285	1696	0	120964
17047	126941	614	273	1207	0	129035
17048	129231	451	230	1060	0	130972
17049	6134	399	119527	750	0	126810
17050	2999	431	120848	697	0	124975
17051	2146	464	4586	120102	0	127298
17052	1798	397	1915	123961	0	128071
17053	1334	352	120193	5153	0	127032
17054	1287	363	121360	2366	0	125376
17055	1403	336	4805	120445	0	126989
17056	120864	264	2157	4475	0	127760
17057	4664	235	1253	119160	0	125312
17058	2327	271	119073	4554	0	126225
17059	1468	119516	3895	2421	0	127300
17060	120715	3463	1889	1805	0	127872
17061	123804	1426	1253	1482	0	127965
17062	125217	714	1055	1296	0	128282
17063	125642	459	994	1230	0	128325
17064	6268	458	117006	1074	0	124806
17065	3371	367	3917	118785	0	126440
17066	120199	392	1993	4513	0	127097
17067	5151	382	1260	119969	0	126762
17068	3132	364	1022	116827	0	121345
17069	2021	114325	841	5449	0	122636
17070	2036	3460	718	118557	0	124771
17071	115738	1527	750	5254	0	123269
17072	4563	115829	834	2726	0	123952
17073	116038	3904	771	1980	0	122693
17074	5171	115677	683	1578	0	123109
17075	3283	4304	490	109223	0	117300
17076	2230	109674	752	4186	0	116842
17077	1829	116206	722	2451	0	121208
17078	113750	4992	786	2033	0	121561
17079	4881	2330	110952	1735	0	119898
17080	2850	1452	109944	1580	0	115826
17081	2006	1256	109402	1603	0	114267
17082	104165	1076	5203	1867	0	112311
17083	4355	105648	2508	1606	0	114117
17084	2682	110227	1448	1542	0	115899
17085	104650	5069	1054	1573	0	112346
17086	4892	103926	1026	1270	0	111114
17087	3073	108422	1028	1229	0	113752
17088	2312	5328	937	107576	0	116153
17089	2168	2707	106006	4442	0	115323
17090	2020	1915	107799	2671	0	114405
17091	2088	1621	4956	107698	0	116363
17092	106162	1397	2606	4778	0	114943
17093	4825	106956	1813	2636	0	116230
17094	3373	4136	1466	108718	0	117693
17095	2633	2404	106838	4583	0	116458
17096	2537	1739	105689	2716	0	112681
17097	2478	1430	5248	105357	0	114513
17098	105019	1329	2774	5101	0	114223
17099	108210	1215	1944	3078	0	114447
17100	6313	1231	103581	2275	0	113400
17101	105144	1166	4494	2263	0	113067
17102	5707	1148	104720	1998	0	113573
17103	3659	948	5046	101055	0	110708
17104	2816	102443	3077	4604	0	112940
17105	106536	3832	2174	2855	0	115397
17106	5655	2173	1773	106736	0	116337
17107	3889	1448	1771	106988	0	114096
17108	3137	1071	1816	110873	0	116897
17109	2626	925	1885	111183	0	116619
17110	2479	885	103923	6736	0	114023
17111	2457	102478	4753	3929	0	113617
17112	2550	3775	2835	106051	0	115211
17113	105091	2060	1947	5598	0	114696
17114	5449	1371	1818	106539	0	115177
17115	3536	1076	1709	108693	0	115014
17116	2584	1226	103070	6714	0	113594
17117	2496	1266	100932	4253	0	108947
17118	2259	99362	5392	3224	0	110237
17119	2085	104005	2917	2864	0	111871
17120	2217	5072	1917	103742	0	112948
17121	102680	2648	1595	5627	0	112550
17122	4909	1901	100824	3780	0	111414
17123	3277	101796	4145	2771	0	111989
17124	2590	4293	2472	99326	0	108681
17125	1912	100582	1635	4778	0	108907
17126	2020	4666	1385	97715	0	105786
17127	1704	98438	1245	4892	0	106279
17128	2026	4144	1097	95024	0	102291
17129	91251	2455	1031	4527	0	99264
17130	3460	85941	999	2697	0	93097
17131	1760	3609	755	75055	0	81179
17132	73829	1610	754	2823	0	79016
17133	2441	72267	636	1846	0	77190
17134	1128	66145	461	1313	0	69047
17135	1164	66950	511	1099	0	69724
17136	1246	2222	1008	61775	0	66251
17137	567	1191	519	61218	0	63495
17138	426	59869	263	1842	0	62400
17139	556	1813	332	60235	0	62936
17140	773	893	59618	1605	0	62889
17141	400	59506	1076	771	0	61753
17142	503	3672	464	54430	0	59069
17143	376	57604	297	1023	0	59300
17144	487	1130	55529	559	0	57705
17145	301	55856	828	461	0	57446
17146	48983	1063	530	534	0	51110
17147	535	234	91	48165	0	49025
17148	48127	71	76	497	0	48771
17149	427	75	47414	123	0	48039
17150	199	62	370	48612	0	49243
17151	88	69	49319	430	0	49906
17152	121	60	409	49449	0	50039
17153	51002	52	119	592	0	51765
17154	453	43	75	51259	0	51830
17155	51450	43	61	602	0	52156
17156	402	52071	56	187	0	52716
17157	52481	400	52	254	0	53187
17158	451	129	52696	114	0	53390
17159	153	53527	422	85	0	54187
17160	158	376	146	54610	0	55290
17161	221	133	84	54799	0	55237
17162	55	121	53735	480	0	54391
17163	72	53469	376	194	0	54111
17164	91	405	121	54514	0	55131
17165	49	54399	72	395	0	54915
17166	98	414	46	54469	0	55027
17167	31	54205	43	413	0	54692
17168	54052	410	46	241	0	54749
17169	428	186	47	54663	0	55324
17170	132	121	54467	388	0	55108
17171	67	54021	344	196	0	54628
17172	41	56121	105	127	0	56394
17173	99	472	55273	55	0	55899
17174	40	55674	369	91	0	56174
17175	133	356	99	55615	0	56203
17176	45	132	56474	313	0	56964
17177	152	68	302	55951	0	56473
17178	100	46	104	57262	0	57512
17179	44	75	57009	390	0	57518
17180	54805	59	320	265	0	55449
17181	358	33	102	58612	0	59105
17182	140	59	62357	331	0	62887
17183	56	62853	339	163	0	63411
17184	64107	302	120	262	0	64791
17185	304	63028	106	83	0	63521
17186	134	326	30	64820	0	65310
17187	63937	94	46	469	0	64546
17188	367	64	32	63787	0	64250
17189	123	72	65271	367	0	65833
17190	141	43	356	65337	0	65877
17191	70	78	65459	378	0	65985
17192	63805	53	393	298	0	64549
17193	397	69	66019	77	0	66562
17194	66709	45	391	280	0	67425
17195	67934	60	148	250	0	68392
17196	496	86	68240	66	0	68888
17197	249	92	64853	77	0	65271
17198	91	68480	510	91	0	69172
17199	71541	370	186	213	0	72310
17200	461	140	82	73123	0	73806
17201	250	72	60	72480	0	72862
17202	79019	46	70	956	0	80091
17203	80497	53	68	489	0	81107
17204	80947	45	63	317	0	81372
17205	80965	47	54	249	0	81315
17206	596	65	57	80325	0	81043
17207	81280	51	54	598	0	81983
17208	512	55	50	81982	0	82599
17209	268	57	64	81624	0	82013
17210	183	78	61	82769	0	83091
17211	145	100	80781	573	0	81599
17212	112	78387	439	281	0	79219
17213	114	79999	202	183	0	80498
17214	116	462	91	82359	0	83028
17215	82199	163	73	628	0	83063
17216	477	80	60	81926	0	82543
17217	81730	44	71	691	0	82536
17218	508	96	84038	212	0	84854
17219	82290	72	416	327	0	83105
17220	525	63	140	86390	0	87118
17221	88482	59	87	733	0	89361
17222	87764	61	59	457	0	88341
17223	88806	72	59	347	0	89284
17224	677	62	67	88820	0	89626
17225	270	113	88036	508	0	88927
17226	243	62	507	88133	0	88945
17227	90274	54	173	825	0	91326
17228	672	123	97417	229	0	98441
17229	436	74	590	102791	0	103891
17230	107037	51	213	1139	0	108440
17231	912	139	107312	295	0	108658
17232	111799	62	822	525	0	113208
17233	117458	50	261	395	0	118164
17234	1334	74	183	118121	0	119712
17235	637	66	103	119804	0	120610
17236	119893	46	87	1615	0	121641
17237	1270	60	87	122485	0	123902
17238	121811	44	90	1800	0	123745
17239	1400	120705	158	616	0	122879
17240	498	122830	99	393	0	123820
17241	507	1569	79	123399	0	125554
17242	299	551	124461	1353	0	126664
17243	205	123904	1285	547	0	125941
17244	122965	1431	451	727	0	125574
17245	1247	120918	301	290	0	122756
17246	466	1419	120796	163	0	122844
17247	636	530	1193	118783	0	121142
17248	213	376	123448	1319	0	125356
17249	163	125096	1366	486	0	127111
17250	310	1256	452	125952	0	127970
17251	133	124328	371	1207	0	126039
17252	189	1360	124430	363	0	126342
17253	350	480	1243	123015	0	125088
17254	157	366	125734	1286	0	127543
17255	297	208	1384	124455	0	126344
17256	125505	139	482	1759	0	127885
17257	1291	221	122741	519	0	124772
17258	117794	132	1327	732	0	119985
17259	1469	198	121783	242	0	123692
17260	700	131	1411	121478	0	123720
17261	393	164	126784	1356	0	128697
17262	525	109	1421	126296	0	128351
17263	391	93	537	128770	0	129791
17264	450	107	368	125970	0	126895
17265	380	78	257	128713	0	129428
17266	246	121	134435	1905	0	136707
17267	131094	96	1340	1362	0	133892
17268	1457	110	462	144527	0	146556
17269	145020	65	354	1972	0	147411
17270	147329	104	271	1020	0	148724
17271	149548	96	291	914	0	150849
17272	2298	91	180	151780	0	154349
17273	1013	120	191	154222	0	155546
17274	521	165167	268	2137	0	168093
17275	180715	2198	194	1320	0	184427
17276	190661	801	174	1052	0	192688
17277	192807	569	169	935	0	194480
17278	5007	494	191430	411	0	197342
17279	2893	266	3078	191697	0	197934
17280	1775	279	191542	3286	0	196882
17281	189682	181	3738	1779	0	195380
17282	193588	162	1646	1464	0	196860
17283	4870	198	1075	190096	0	196239
17284	2596	236	720	187570	0	191122
17285	1663	191364	616	4186	0	197829
17286	195701	3108	352	2428	0	201589
17287	196940	1158	351	1853	0	200302
17288	4748	193228	451	1059	0	199486
17289	196111	3489	414	1256	0	201270
17290	4932	1415	368	194974	0	201689
17291	2724	928	382	197851	0	201885
17292	198131	627	316	4899	0	203973
17293	4292	600	193939	2216	0	201047
17294	193630	343	3116	2280	0	199369
17295	199046	323	1197	1803	0	202369
17296	4977	193102	976	1023	0	200078
17297	198378	3175	624	1155	0	203332
17298	5077	1416	192875	529	0	199897
17299	2973	1019	3138	194549	0	201679
17300	195870	658	1301	3964	0	201793
17301	4834	501	939	195468	0	201742
17302	2369	445	187878	4394	0	195086
17303	2166	243	3565	183268	0	189242
17304	1438	197636	1640	4540	0	205254
17305	1645	3364	1145	204183	0	210337
17306	1609	1342	785	208465	0	212201
17307	1663	994	628	203911	0	207196
17308	1396	710	478	208237	0	210821
17309	960	729	202477	6175	0	210341
17310	1401	505	3331	204466	0	209703
17311	203364	375	1381	6127	0	211247
17312	3997	200291	1151	2999	0	208438
17313	2254	3464	761	208825	0	215304
17314	1774	1435	208036	4787	0	216032
17315	1734	1068	3568	210587	0	216957
17316	212205	740	1514	5742	0	220201
17317	213559	594	1178	3402	0	218733
17318	210783	430	959	2639	0	214811
17319	6727	372	861	208978	0	216938
17320	3843	428	207496	4611	0	216378
17321	3050	204712	3814	2433	0	214009
17322	209644	3494	1788	2534	0	217460
17323	5183	1555	1446	208537	0	216721
17324	3096	1390	1207	210882	0	216575
17325	2637	966	206607	5636	0	215846
17326	2383	200223	3875	3379	0	209860
17327	2123	209376	1774	2674	0	215947
17328	2361	5317	1567	200438	0	209683
17329	1824	2233	194425	4970	0	203452
17330	183618	1650	3747	3365	0	192380
17331	4795	1404	183246	2149	0	191594
17332	180066	1107	3444	2581	0	187198
17333	5033	189803	1831	1990	0	198657
17334	2987	3192	187551	1784	0	195514
17335	183657	1534	3702	2084	0	190977
17336	4802	185148	1948	1350	0	193248
17337	192611	3409	1344	1791	0	199155
17338	4906	1842	189946	1087	0	197781
17339	3071	191035	3245	1228	0	198579
17340	194392	3346	1666	1821	0	201225
17341	4886	1715	189591	1249	0	197441
17342	189914	1139	3574	1616	0	196243
17343	4918	960	1907	190664	0	198449
17344	193215	835	1534	4070	0	199654
17345	4936	737	1266	192739	0	199678
17346	192699	805	1042	4868	0	199414
17347	4668	833	191379	2954	0	199834
17348	2743	716	3254	194623	0	201336
17349	2135	700	1652	195219	0	199706
17350	1772	807	192150	5490	0	200219
17351	1750	729	3574	193529	0	199582
17352	2189	156392	3222	5658	0	167461
17353	1351	3107	1520	206042	0	212020
17354	1510	1456	1229	214141	0	218336
17355	1858	1106	967	228571	0	232502
17356	1495	983	223868	8050	0	234396
17357	218703	738	5103	5003	0	229547
17358	6514	631	2389	240054	0	249588
17359	3207	648	241400	7464	0	252719
17360	236478	562	6403	4416	0	247859
17361	247118	624	2826	3187	0	253755
17362	253756	694	1788	2703	0	258941
17363	10345	759	1482	248844	0	261430
17364	5590	759	1227	274834	0	282410
17365	3965	769	1157	271364	0	277255
17366	2527	265415	1259	11199	0	280400
17367	264593	7193	1077	6346	0	279209
17368	265540	2841	1066	4696	0	274143
17369	11201	2066	1243	262244	0	276754
17370	5717	1469	256004	9164	0	272354
17371	4534	1295	256596	4555	0	266980
17372	2848	246022	9880	3492	0	262242
17373	2440	258198	4478	3094	0	268210
17374	234997	9828	3868	3719	0	252412
17375	7002	229100	1488	1866	0	239456
17376	226980	6368	1101	1738	0	236187
17377	227981	2357	819	1747	0	232904
17378	227852	1264	730	1543	0	231389
17379	9669	986	644	222690	0	233989
17380	4889	800	572	237736	0	243997
17381	240893	783	542	9263	0	251481
17382	8834	729	568	244962	0	255093
17383	3709	850	241437	8564	0	254560
17384	244818	779	6811	3948	0	256356
17385	9091	825	2401	244421	0	256738
17386	4564	903	1293	250509	0	257269
17387	3601	892	845	254951	0	260289
17388	2371	921	242939	10883	0	257114
17389	230193	731	7286	5363	0	243573
17390	8678	734	242768	2967	0	255147
17391	4688	781	8113	241216	0	254798
17392	2838	950	244558	8494	0	256840
17393	3005	800	8219	240393	0	252417
17394	2798	825	3255	249382	0	256260
17395	2297	827	246860	11136	0	261120
17396	3049	922	8148	232715	0	244834
17397	2328	245786	3345	9160	0	260619
17398	248574	7232	2013	5167	0	262986
17399	255114	2508	1554	4095	0	263271
17400	11567	1311	1430	249901	0	264209
17401	5031	980	248984	9751	0	264746
17402	3294	236405	8343	5099	0	253141
17403	2551	252583	3666	3712	0	262512
17404	238455	9181	2516	3584	0	253736
17405	9309	3607	233271	3051	0	249238
17406	234402	1930	8314	3370	0	248016
17407	10488	1123	3637	234660	0	249908
17408	5199	1041	2429	242578	0	251247
17409	230471	996	2146	12395	0	246008
17410	9209	230309	1911	6338	0	247767
17411	4546	7572	233401	4287	0	249806
17412	4155	2971	8285	230404	0	245815
17413	2863	1913	233891	10120	0	248787
17414	2659	229005	9356	5406	0	246426
17415	3232	7717	4251	233718	0	248918
17416	229581	3273	2897	10865	0	246616
17417	236099	2140	2410	6004	0	246653
17418	11592	1870	227796	4181	0	245439
17419	5728	227475	8714	3723	0	245640
17420	227909	8123	4155	3732	0	243919
17421	10014	229228	2862	3508	0	245612
17422	5731	9077	2455	228390	0	245653
17423	228200	3996	2097	10429	0	244722
17424	10610	2575	2127	230917	0	246229
17425	5544	2166	223931	10937	0	242578
17426	4492	1834	8650	228874	0	243850
17427	3698	2183	225697	11182	0	242760
17428	3943	2034	9230	226748	0	241955
17429	224187	1844	4353	11941	0	242325
17430	10089	224307	3280	6281	0	243957
17431	226968	8483	2820	5096	0	243367
17432	11125	3931	2663	225363	0	243082
17433	5724	2952	2414	229724	0	240814
17434	4291	2711	198713	13519	0	219234
17435	3887	2424	221474	6836	0	234621
17436	3803	220148	10870	5102	0	239923
17437	3984	8817	219545	4261	0	236607
17438	209113	3882	10569	4632	0	228196
17439	10223	214045	5226	4371	0	233865
17440	5362	222251	3598	4155	0	235366
17441	4160	226606	3111	4097	0	237974
17442	3981	12151	2584	221230	0	239946
17443	3468	5473	221158	11037	0	241136
17444	3438	222333	9767	6201	0	241739
17445	3777	9707	4621	211666	0	229771
17446	3350	223711	3569	10422	0	241052
17447	219883	9938	2972	6351	0	239144
17448	226430	4482	2948	5122	0	238982
17449	12374	3743	2896	220359	0	239372
17450	6537	2912	2724	224326	0	236499
17451	211709	2518	2806	13316	0	230349
17452	9976	205393	2774	7212	0	225355
17453	5118	211570	2735	5074	0	224497
17454	4678	10929	2300	195702	0	213609
17455	2628	3933	182578	8642	0	197781
17456	2246	180344	6939	4954	0	194483
17457	169808	6844	4058	3562	0	184272
17458	6278	163163	2576	3008	0	175025
17459	3193	165532	2014	2416	0	173155
17460	156764	7393	2508	2312	0	168977
17461	5900	161133	1508	2210	0	170751
17462	3292	6512	155229	1958	0	166991
17463	2201	155707	5311	2322	0	165541
17464	131688	4494	2463	1373	0	140018
17465	3572	131321	1152	979	0	137024
17466	130578	4012	1288	1097	0	136975
17467	4212	1938	747	128912	0	135809
17468	2030	1451	645	132793	0	136919
17469	1393	1242	129748	4324	0	136707
17470	1111	130415	3124	2088	0	136738
17471	1257	3574	1302	133207	0	139340
17472	131764	1652	975	4019	0	138410
17473	132886	1208	749	2089	0	136932
17474	4133	132726	818	1497	0	139174
17475	2065	3756	675	134247	0	140743
17476	135184	1666	729	3935	0	141514
17477	136866	1336	950	1989	0	141141
17478	4794	1137	129541	1293	0	136765
17479	2305	1099	123124	912	0	127440
17480	1492	988	120797	764	0	124041
17481	722	115822	3117	552	0	120213
17482	109514	2457	2429	579	0	114979
17483	2208	108603	751	455	0	112017
17484	107414	2390	677	600	0	111081
17485	2283	111598	363	360	0	114604
17486	1162	2322	345	114288	0	118117
17487	115923	982	289	2244	0	119438
17488	2269	665	115005	760	0	118699
17489	114735	520	1951	667	0	117873
17490	118342	464	794	525	0	120125
17491	2716	115679	477	380	0	119252
17492	1071	119387	321	301	0	121080
17493	122648	2446	559	563	0	126216
17494	2353	1025	124961	308	0	128647
17495	120933	941	2126	631	0	124631
17496	123594	480	780	502	0	125356
17497	2742	383	354	121204	0	124683
17498	124091	342	237	2034	0	126704
17499	2484	404	147	126045	0	129080
17500	1204	352	183	129638	0	131377
17501	902	340	211	127314	0	128767
17502	624	116473	260	11621	0	128978
17503	128303	1799	280	1203	0	131585
17504	129860	751	256	784	0	131651
17505	2755	474	247	129185	0	132661
17506	1318	446	297	127551	0	129612
17507	819	126989	356	2262	0	130426
17508	128654	1993	267	1128	0	132042
17509	2271	929	125543	608	0	129351
17510	1192	686	1772	127758	0	131408
17511	913	545	125435	1999	0	128892
17512	878	476	1953	126032	0	129339
17513	681	464	126313	2277	0	129735
17514	875	453	1969	124450	0	127747
17515	126038	444	750	2472	0	129704
17516	2387	469	126187	952	0	129995
17517	124794	358	1993	994	0	128139
17518	2497	129952	898	623	0	133970
17519	1306	1931	584	134065	0	137886
17520	1011	839	512	136436	0	138798
17521	138558	640	459	2800	0	142457
17522	2534	520	378	142897	0	146329
17523	1302	587	141211	2393	0	145493
17524	141704	441	1693	1573	0	145411
17525	149078	397	676	1185	0	151336
17526	149082	437	429	1084	0	151032
17527	148839	350	354	1007	0	150550
17528	3084	144238	406	762	0	148490
17529	1618	1729	355	147711	0	151413
17530	147198	668	333	2301	0	150500
17531	2567	576	318	145785	0	149246
17532	144034	448	349	2354	0	147185
17533	2437	475	139413	948	0	143273
17534	1307	461	138506	740	0	141014
17535	1333	2330	1949	132505	0	138117
17536	874	135777	979	1773	0	139403
17537	769	141459	551	1009	0	143788
17538	139404	1805	622	1477	0	143308
17539	1932	713	138290	748	0	141683
17540	128461	393	1474	1096	0	131424
17541	1806	136091	743	608	0	139248
17542	138506	1253	452	801	0	141012
17543	2032	565	318	137392	0	140307
17544	1062	509	139942	1602	0	143115
17545	1048	350	1306	139607	0	142311
17546	912	285	569	140006	0	141772
17547	667	137092	447	2010	0	140216
17548	629	142741	435	1042	0	144847
17549	824	1657	364	143583	0	146428
17550	817	143868	407	1685	0	146777
17551	764	1531	141506	854	0	144655
17552	848	779	135562	774	0	137963
17553	133689	444	1725	999	0	136857
17554	142614	341	736	933	0	144624
17555	2023	139056	536	645	0	142260
17556	1247	1370	355	140896	0	143868
17557	917	612	358	142564	0	144451
17558	764	487	140879	1975	0	144105
17559	924	378	1447	135258	0	138007
17560	597	139090	692	1894	0	142273
17561	637	1439	135978	979	0	139033
17562	691	683	133885	717	0	135976
17563	748	129407	1891	714	0	132760
17564	681	1549	137004	556	0	139790
17565	843	643	1595	135990	0	139071
17566	1365	533	770	124002	0	126670
17567	717	510	139420	1952	0	142599
17568	929	690	1485	136579	0	139683
17569	569	133242	766	1844	0	136421
17570	481	140542	574	1077	0	142674
17571	671	2047	418	139900	0	143036
17572	552	643	141217	1836	0	144248
17573	448	142507	1635	819	0	145409
17574	979	2045	812	142307	0	146143
17575	451	501	138440	1617	0	141009
17576	130582	298	1272	972	0	133124
17577	138829	204	374	758	0	140165
17578	139191	201	301	634	0	140327
17579	1605	172	237	137080	0	139094
17580	704	140	217	138636	0	139697
17581	437	222	141786	1451	0	143896
17582	593	191	1217	140287	0	142288
17583	552	224	377	143093	0	144246
17584	292	229	142465	1533	0	144519
17585	124586	150	1250	1192	0	127178
17586	1233	133992	455	427	0	136107
17587	135141	1088	282	711	0	137222
17588	1220	133233	236	313	0	135002
17589	554	1264	189	135155	0	137162
17590	361	399	134610	1204	0	136574
17591	641	565	1177	129482	0	131865
17592	236	254	131369	1320	0	133179
17593	114061	186	1146	1003	0	116396
17594	971	175	124114	270	0	125530
17595	505	107	1088	119918	0	121618
17596	223	146	123666	1092	0	125127
17597	171	124002	1238	415	0	125826
17598	499	1151	389	126836	0	128875
17599	572	299	271	125938	0	127080
17600	422	181	170	130938	0	131711
17601	209	190	129398	1880	0	131677
17602	217	250	130048	705	0	131220
17603	365	120	1913	132244	0	134642
17604	579	93	618	154462	0	155752
17605	554	99	375	165919	0	166947
17606	169012	85	305	4753	0	174155
17607	3652	77	221	175887	0	179837
17608	1548	224	182175	4066	0	188013
17609	190108	114	3766	2268	0	196256
17610	5020	155	1584	199090	0	205849
17611	208164	111	919	5400	0	214594
17612	213957	101	414	2894	0	217366
17613	7447	108	381	212249	0	220185
17614	214441	68	455	5952	0	220916
17615	217013	90	328	3180	0	220611
17616	7532	195	209355	1637	0	218719
17617	3622	211221	4786	1162	0	220791
17618	2825	4561	2124	206504	0	216014
17619	1947	1981	1142	216118	0	221188
17620	213227	967	651	7622	0	222467
17621	212516	468	597	4078	0	217659
17622	212989	320	545	2591	0	216445
17623	8437	459	198772	1419	0	209087
17624	4115	201596	5034	1345	0	212090
17625	203787	4755	2345	1569	0	212456
17626	6200	205199	1410	1019	0	213828
17627	207845	5744	780	1426	0	215795
17628	7251	2559	558	205751	0	216119
17629	207112	1342	612	6055	0	215121
17630	209978	828	589	3341	0	214736
17631	212399	592	466	2387	0	215844
17632	9058	625	204954	1487	0	216124
17633	211064	436	4795	1887	0	218182
17634	7524	209720	2298	1349	0	220891
17635	216810	5071	1269	1604	0	224754
17636	219817	2367	797	1607	0	224588
17637	222710	1347	755	1573	0	226385
17638	10151	882	688	211129	0	222850
17639	5281	212352	667	5549	0	223849
17640	215809	5449	583	3350	0	225191
17641	7753	2618	211397	1918	0	223686
17642	4650	213509	5186	1540	0	224885
17643	4212	5804	2274	201920	0	214210
17644	2905	211701	1491	5098	0	221195
17645	212551	6511	952	2984	0	222998
17646	219998	3072	841	2041	0	225952
17647	9767	1847	751	214962	0	227327
17648	5352	1439	209509	6294	0	222594
17649	3680	210276	5457	3541	0	222954
17650	3863	5911	2737	199087	0	211598
17651	3323	2937	1498	219578	0	227336
17652	3135	1742	1058	227439	0	233374
17653	222352	1377	874	10008	0	234611
17654	227082	1101	898	5123	0	234204
17655	228961	1218	821	3175	0	234175
17656	232083	1182	694	2511	0	236470
17657	11777	1083	667	223822	0	237349
17658	6470	1186	224266	7363	0	239285
17659	4940	942	6014	228699	0	240595
17660	4166	913	2793	232174	0	240046
17661	3801	853	1642	233659	0	239955
17662	3896	937	1154	235285	0	241272
17663	228103	933	981	11368	0	241385
17664	8944	997	1118	230480	0	241539
17665	229224	833	1136	9764	0	240957
17666	233060	913	1000	5923	0	240896
17667	11592	972	221214	4028	0	237806
17668	7252	910	218414	3256	0	229832
17669	5459	951	226863	3023	0	236296
17670	4831	1450	8984	221603	0	236868
17671	4218	954	225995	7988	0	239155
17672	4412	1043	7536	221460	0	234451
17673	4002	1098	3895	224475	0	233470
17674	224120	1066	2444	10798	0	238428
17675	9058	1199	1791	222049	0	234097
17676	5948	224389	1626	9212	0	241175
17677	231681	5970	1610	5914	0	245175
17678	9486	231742	1550	4003	0	246781
17679	6064	7169	232229	3390	0	248852
17680	4448	236185	6841	3186	0	250660
17681	232876	7640	3758	3292	0	247566
17682	9353	4043	2217	231779	0	247392
17683	6305	2697	227713	7798	0	244513
17684	229491	1795	6650	5034	0	242970
17685	9780	1717	3670	231825	0	246992
17686	6383	1570	231232	8114	0	247299
17687	5406	1544	6792	233939	0	247681
17688	4702	1266	3801	238081	0	247850
17689	4368	1312	2563	238264	0	246507
17690	3911	231314	1990	10799	0	248014
17691	236658	6572	1573	6444	0	251247
17692	9498	3593	1547	233953	0	248591
17693	6111	233678	1489	8379	0	249657
17694	5081	6921	1202	239475	0	252679
17695	4095	3944	233790	9089	0	250918
17696	3831	235606	6431	5550	0	251418
17697	235242	6997	3651	4279	0	250169
17698	238249	3863	2405	3432	0	247949
17699	10713	2461	1809	232520	0	247503
17700	6188	1965	1628	237561	0	247342
17701	234387	1609	1553	10543	0	248092
17702	229906	1586	1550	6495	0	239537
17703	10173	228527	1458	4394	0	244552
17704	209435	5108	1523	3174	0	219240
17705	7633	2244	197124	2333	0	209334
17706	4469	1566	193545	2114	0	201694
17707	2507	188746	5217	2053	0	198523
17708	1923	188088	2633	1596	0	194240
17709	172756	4327	3483	1628	0	182194
17710	3473	172794	996	1168	0	178431
17711	169278	2976	856	1163	0	174273
17712	167567	1249	619	1041	0	170476
17713	166269	744	582	1039	0	168634
17714	3974	644	526	163286	0	168430
17715	165001	514	474	3359	0	169348
17716	3495	613	160053	1481	0	165642
17717	1878	584	160096	1040	0	163598
17718	1317	161640	3164	996	0	167117
17719	1170	2415	164248	868	0	168701
17720	1457	1178	2869	157454	0	162958
17721	939	696	163847	2969	0	168451
17722	1050	631	159885	1478	0	163044
17723	1080	596	3281	161817	0	166774
17724	163288	536	1503	3282	0	168609
17725	164289	546	933	1883	0	167651
17726	3591	571	167068	963	0	172193
17727	163404	512	2741	1483	0	168140
17728	3233	525	169527	873	0	174158
17729	167959	452	2914	1272	0	172597
17730	175853	398	1385	1263	0	178899
17731	3972	413	857	173712	0	178954
17732	2225	413	640	168991	0	172269
17733	1370	161635	769	3506	0	167280
17734	1115	168983	721	1689	0	172508
17735	1312	3025	684	166295	0	171316
17736	1272	1307	662	168771	0	172012
17737	163966	724	548	3654	0	168892
17738	2798	162080	569	1682	0	167129
17739	162256	2466	585	1609	0	166916
17740	2832	162256	659	898	0	166645
17741	1478	2920	160653	681	0	165732
17742	1419	1382	2470	159303	0	164574
17743	161358	718	1085	3238	0	166399
17744	166978	581	606	1851	0	170016
17745	4001	166909	616	1028	0	172554
17746	1691	171485	551	771	0	174498
17747	1165	176286	554	686	0	178691
17748	1538	4488	640	186061	0	192727
17749	1038	1591	188053	3927	0	194609
17750	834	187666	3976	1520	0	193996
17751	1384	3971	1303	189292	0	195950
17752	1091	1230	602	193991	0	196914
17753	578	748	189410	4566	0	195302
17754	701	669	186383	1542	0	189295
17755	183479	406	4605	1435	0	189925
17756	4155	482	192203	630	0	197470
17757	189331	413	4106	1159	0	195009
17758	187896	409	1323	986	0	190614
17759	188866	413	759	1004	0	191042
17760	188240	403	637	983	0	190263
17761	5363	559	179626	502	0	186050
17762	1906	180731	3674	653	0	186964
17763	1858	3807	1235	180001	0	186901
17764	1057	1299	182340	3829	0	188525
17765	1480	818	3862	177360	0	183520
17766	1235	162751	1928	4064	0	169978
17767	1346	3812	840	185721	0	191719
17768	1358	1271	630	187521	0	190780
17769	1542	791	625	183904	0	186862
17770	183454	651	552	5644	0	190301
17771	4747	658	642	183249	0	189296
17772	2145	606	624	185189	0	188564
17773	1488	670	721	183631	0	186510
17774	844	174912	884	5258	0	181898
17775	174625	3819	750	2575	0	181769
17776	4118	165725	876	1496	0	172215
17777	1338	169383	745	1118	0	172584
17778	1723	4148	799	169817	0	176487
17779	1509	1342	695	171726	0	175272
17780	169305	722	609	5425	0	176061
17781	4862	530	629	170856	0	176877
17782	171988	488	628	5146	0	178250
17783	202828	511	639	2314	0	206292
17784	7710	562	693	200157	0	209122
17785	3643	641	643	200822	0	205749
17786	1605	201989	772	7760	0	212126
17787	208012	6098	637	3840	0	218587
17788	6806	215238	650	1977	0	224671
17789	217052	7257	632	1948	0	226889
17790	7936	2997	209632	1437	0	222002
17791	211992	1587	6335	1906	0	221820
17792	223475	1062	2342	1961	0	228840
17793	10226	981	1167	214452	0	226826
17794	4122	1050	213922	7750	0	226844
17795	2349	212558	7056	3680	0	225643
17796	2623	7735	2732	219688	0	232778
17797	1886	3196	217874	8365	0	231321
17798	2366	2025	7362	218203	0	229956
17799	215011	1181	2956	9486	0	228634
17800	8472	971	213498	4032	0	226973
17801	3615	207298	7582	2727	0	221222
17802	2394	217678	3316	1982	0	225370
17803	3089	9600	1901	192164	0	206754
17804	1816	212879	1412	6586	0	222693
17805	210868	8279	1281	3616	0	224044
17806	213598	3404	934	2789	0	220725
17807	215219	1940	938	2320	0	220417
17808	10699	1681	201099	1679	0	215158
17809	208111	1432	7106	2037	0	218686
17810	9578	1448	2906	204255	0	218187
17811	4767	1262	1509	208933	0	216471
17812	3322	1262	1212	210887	0	216683
17813	2851	1130	1126	211363	0	216470
17814	2131	1266	200734	11447	0	215578
17815	2108	1300	202016	5234	0	210658
17816	1850	1149	200899	3473	0	207371
17817	190634	1124	9687	3063	0	204508
17818	8229	193378	3995	2746	0	208348
17819	4345	7274	2136	194612	0	208367
17820	192714	3106	1490	9259	0	206569
17821	8382	192066	1402	4554	0	206404
17822	4081	201524	1422	2863	0	209890
17823	195927	9681	1350	2641	0	209599
17824	200562	4189	1311	2481	0	208543
17825	10560	196678	1271	2189	0	210698
17826	5474	8067	1110	183845	0	198496
17827	3325	191850	1027	7999	0	204201
17828	190499	8327	1012	4152	0	203990
17829	191205	3856	1126	3005	0	199192
17830	192283	2477	984	2633	0	198377
17831	11244	182978	1085	2315	0	197622
17832	5616	7745	923	186218	0	200502
17833	3441	3793	183237	8705	0	199176
17834	3310	2381	7118	185011	0	197820
17835	3198	2014	2978	191387	0	199577
17836	2655	2024	181746	10540	0	196965
17837	181885	1644	7449	5125	0	196103
17838	9278	1586	3247	185254	0	199365
17839	4975	1676	1921	185875	0	194447
17840	3353	181963	1432	10297	0	197045
17841	182783	7677	1399	5303	0	197162
17842	9159	3944	1326	178995	0	193424
17843	4463	179612	1386	8828	0	194289
17844	173290	7266	1408	4768	0	186732
17845	8006	173154	1260	3102	0	185522
17846	165463	7329	1489	2771	0	177052
17847	8346	3355	161405	2360	0	175466
17848	3897	2168	146551	1870	0	154486
17849	2480	1487	145211	1566	0	150744
17850	1972	143536	7899	1657	0	155064
17851	2686	6321	4510	129670	0	143187
17852	2043	137945	1829	5061	0	146878
17853	139935	6242	1285	3000	0	150462
17854	6257	3132	138630	1862	0	149881
17855	138199	1961	5592	1663	0	147415
17856	142231	1649	2856	1356	0	148092
17857	8279	1402	1858	136684	0	148223
17858	140082	1460	1269	5826	0	148637
17859	7408	1195	1253	139654	0	149510
17860	3653	1409	137234	6345	0	148641
17861	136546	1330	5259	3426	0	146561
17862	6366	135998	2934	2098	0	147396
17863	3694	5404	1697	138183	0	148978
17864	139034	2757	1269	5796	0	148856
17865	6701	1826	1084	139152	0	148763
17866	3735	1350	134263	6661	0	146009
17867	2666	1149	5305	134884	0	144004
17868	2028	134200	2741	6494	0	145463
17869	136567	5337	1547	3380	0	146831
17870	6300	2785	1231	135885	0	146201
17871	137541	1783	1001	6361	0	146686
17872	6934	1333	871	137473	0	146611
17873	3747	1031	884	136428	0	142090
17874	2509	134428	1000	7436	0	145373
17875	133852	5228	874	4055	0	144009
17876	6129	138764	919	2566	0	148378
17877	3728	5756	852	130679	0	141015
17878	2004	133353	831	5683	0	141871
17879	133269	5553	609	3286	0	142717
17880	132110	2836	718	2690	0	138354
17881	132918	1751	786	2399	0	137854
17882	7583	123997	904	1826	0	134310
17883	1788	97631	366	790	0	100575
17884	95928	3142	564	771	0	100405
17885	3096	97154	373	734	0	101357
17886	1991	4054	713	90459	0	97217
17887	1261	1025	87813	2343	0	92442
17888	80900	665	1634	969	0	84168
17889	82207	418	506	729	0	83860
17890	82158	385	286	547	0	83376
17891	2126	81131	222	364	0	83843
17892	80233	1447	175	446	0	82301
17893	1908	610	80623	279	0	83420
17894	734	79750	1159	265	0	81908
17895	743	1988	550	74640	0	77921
17896	268	75084	241	740	0	76333
17897	72618	770	225	386	0	73999
17898	713	72991	102	191	0	73997
17899	307	668	76	73186	0	74237
17900	192	73081	97	661	0	74031
17901	272	690	101	75299	0	76362
17902	225	262	90	74140	0	74717
17903	185	213	74082	799	0	75279
17904	267	134	637	72375	0	73413
17905	72875	148	225	882	0	74130
17906	72898	122	153	403	0	73576
17907	872	161	101	73059	0	74193
17908	408	183	72453	731	0	73775
17909	345	160	658	72121	0	73284
17910	72815	136	216	934	0	74101
17911	75765	120	172	600	0	76657
17912	76803	136	111	445	0	77495
17913	995	78748	134	217	0	80094
17914	80606	688	75	435	0	81804
17915	951	302	78427	182	0	79862
17916	84685	189	759	514	0	86147
17917	993	172	273	88030	0	89468
17918	490	144	167	88830	0	89631
17919	410	121	111	89696	0	90338
17920	87861	159	72	1319	0	89411
17921	86862	110	89	688	0	87749
17922	1152	147	110	87032	0	88441
17923	578	147	88825	987	0	90537
17924	533	120	789	88708	0	90150
17925	400	141	229	88719	0	89489
17926	350	153	87811	1146	0	89460
17927	250	87704	834	596	0	89384
17928	387	789	275	90245	0	91696
17929	91818	298	165	1268	0	93549
17930	1044	228	125	92452	0	93849
17931	522	202	72	93331	0	94127
17932	93631	174	95	1479	0	95379
17933	1053	91761	115	645	0	93574
17934	483	94338	101	399	0	95321
17935	94060	1110	83	548	0	95801
17936	1106	469	93227	241	0	95043
17937	90269	276	857	499	0	91901
17938	1142	264	98479	235	0	100120
17939	481	100093	931	241	0	101746
17940	101632	924	422	491	0	103469
17941	102950	340	180	450	0	103920
17942	103310	247	121	428	0	104106
17943	104033	177	103	493	0	104806
17944	1414	251	102298	188	0	104151
17945	826	257	838	101570	0	103491
17946	104004	170	275	1183	0	105632
17947	1172	198	106797	358	0	108525
17948	557	202	104485	261	0	105505
17949	388	104588	1018	217	0	106211
17950	106465	753	461	384	0	108063
17951	1061	291	283	105463	0	107098
17952	106067	133	168	1032	0	107400
17953	879	107386	130	309	0	108704
17954	514	816	68	114628	0	116026
17955	407	211	83	115042	0	115743
17956	351	136	82	117753	0	118322
17957	240	152	118782	1476	0	120650
17958	177	120254	1114	592	0	122137
17959	128894	1198	354	562	0	131008
17960	1753	427	203	129484	0	131867
17961	129413	199	121	1923	0	131656
17962	128811	115	125	817	0	129868
17963	2361	114	87	128780	0	131342
17964	933	186	131140	1737	0	133996
17965	784	144	1498	130601	0	133027
17966	381	131050	585	1823	0	133839
17967	473	1486	283	135172	0	137414
17968	279	544	133501	1920	0	136244
17969	131916	290	1574	1041	0	134821
17970	1855	180	523	136163	0	138721
17971	134803	131	349	2166	0	137449
17972	1955	200	132909	748	0	135812
17973	128493	128	1589	855	0	131065
17974	2046	193	132793	351	0	135383
17975	128467	113	1636	711	0	130927
17976	1936	128742	679	344	0	131701
17977	764	133233	418	323	0	134738
17978	683	1959	309	134226	0	137177
17979	1007	796	314	122774	0	124891
17980	522	371	161	134984	0	136038
17981	134950	245	150	2605	0	137950
17982	1874	173	141	136716	0	138904
17983	741	199	135749	2022	0	138711
17984	130911	145	1511	1387	0	133954
17985	1696	136522	599	673	0	139490
17986	138896	1520	356	885	0	141657
17987	136850	535	268	788	0	138441
17988	2335	398	137101	343	0	140177
17989	1467	257	1658	135075	0	138457
17990	930	234	590	143340	0	145094
17991	595	272	144357	2349	0	147573
17992	437	142764	1914	1084	0	146199
17993	142537	1781	658	1150	0	146126
17994	144367	618	415	952	0	146352
17995	2676	388	320	145955	0	149339
17996	1371	296	272	145960	0	147899
17997	896	252	232	152205	0	153585
17998	148118	222	263	3530	0	152133
17999	2328	150599	335	1372	0	154634
18000	152820	2151	237	1296	0	156504
18001	152808	713	255	1024	0	154800
18002	3319	499	156310	506	0	160634
18003	1716	354	2488	152605	0	157163
18004	957	158701	1012	2713	0	163383
18005	1020	2536	554	163704	0	167814
18006	1030	1006	371	168452	0	170859
18007	720	630	170077	3861	0	175288
18008	173502	384	2955	2174	0	179015
18009	189704	311	1115	1702	0	192832
18010	196793	281	653	1452	0	199179
18011	5953	335	454	191867	0	198609
18012	2871	517	419	190506	0	194313
18013	1495	186192	511	5359	0	193557
18014	1128	195591	555	2342	0	199616
18015	192810	5050	467	1929	0	200256
18016	4761	188477	469	1148	0	194855
18017	2104	4719	187318	919	0	195060
18018	1975	1851	4190	189980	0	197996
18019	192671	1038	1726	5099	0	200534
18020	5022	823	189840	2132	0	197817
18021	2427	832	188012	1413	0	192684
18022	192363	602	5548	1495	0	200008
18023	194958	590	2217	1384	0	199149
18024	6738	561	1244	190596	0	199139
18025	2955	705	190183	5035	0	198878
18026	2356	692	4571	191032	0	198651
18027	1612	822	183755	5784	0	191973
18028	1546	764	191204	2498	0	196012
18029	1339	192708	5698	1707	0	201452
18030	194767	4397	2526	1737	0	203427
18031	196267	1721	1587	1668	0	201243
18032	6211	192109	1252	1223	0	200795
18033	3438	4741	1059	192431	0	201669
18034	2613	1912	996	194787	0	200308
18035	2071	1211	946	198158	0	202386
18036	193110	856	980	7299	0	202245
18037	5102	191068	946	3422	0	200538
18038	188687	4509	870	2467	0	196533
18039	189013	1961	880	1955	0	193809
18040	6747	1380	181133	1342	0	190602
18041	3329	181713	4622	1341	0	191005
18042	2725	4738	2079	185429	0	194971
18043	1919	2059	184456	4952	0	193386
18044	181043	1460	4852	2858	0	190213
18045	187603	1090	2076	2202	0	192971
18046	188439	868	1374	1977	0	192658
18047	186138	783	1146	1770	0	189837
18048	7595	759	1008	179697	0	189059
18049	3737	816	177078	5134	0	186765
18050	3013	733	4524	178284	0	186554
18051	178574	707	2138	5964	0	187383
18052	179587	697	1431	3202	0	184917
18053	6631	173194	1208	2028	0	183061
18054	172014	4024	1004	1875	0	178917
18055	6062	1778	167864	1295	0	176999
18056	3230	1293	166470	1216	0	172209
18057	163184	1222	5468	1593	0	171467
18058	5399	162236	2504	1279	0	171418
18059	3087	3468	1359	153072	0	160986
18060	2164	154593	979	3665	0	161401
18061	2070	3895	784	157794	0	164543
18062	1946	1714	741	158977	0	163378
18063	1799	1174	731	163521	0	167225
18064	156795	911	783	5833	0	164322
18065	161263	850	731	2932	0	165776
18066	160325	903	727	1998	0	163953
18067	5981	925	154455	1302	0	162663
18068	155310	752	3866	1480	0	161408
18069	5569	751	2056	159496	0	167872
18070	3290	609	1360	167029	0	172288
18071	2329	748	165068	5651	0	173796
18072	2548	704	4424	181676	0	189352
18073	189289	683	1923	6728	0	198623
18074	6251	733	187759	3082	0	197825
18075	3362	610	5535	189740	0	199247
18076	190896	513	2320	6669	0	200398
18077	192071	540	1646	3256	0	197513
18078	7963	649	188659	2257	0	199528
18079	4134	797	192224	1710	0	198865
18080	3339	623	6786	193507	0	204255
18081	196458	620	3118	6528	0	206724
18082	200210	703	2029	3236	0	206178
18083	8206	782	1474	188558	0	199020
18084	3998	193688	1336	5947	0	204969
18085	196042	4985	1283	3288	0	205598
18086	6736	196573	1423	2526	0	207258
18087	3901	5758	1251	198887	0	209797
18088	3019	2152	195603	6411	0	207185
18089	2685	1434	191791	2984	0	198894
18090	2302	1137	195200	2127	0	200766
18091	2628	918	7463	189501	0	200510
18092	2515	764	3310	195639	0	202228
18093	191102	616	2255	7841	0	201814
18094	6240	188576	1764	3781	0	200361
18095	192129	4966	1447	2896	0	201438
18096	7500	2035	1360	182621	0	193516
18097	3529	182899	1309	5531	0	193268
18098	2643	192256	1202	2807	0	198908
18099	2643	6321	1014	189234	0	199212
18100	187874	2595	1022	6368	0	197859
18101	6033	188555	1097	3006	0	198691
18102	180177	4896	1056	2509	0	188638
18103	5833	184363	1057	1734	0	192987
18104	182560	5362	1344	1742	0	191008
18105	6506	2333	175326	1362	0	185527
18106	3408	1716	173184	1227	0	179535
18107	2357	171281	5212	1126	0	179976
18108	158675	5027	3819	1452	0	168973
18109	3974	150127	1385	775	0	156261
18110	1850	141796	850	665	0	145161
18111	2550	4357	875	144687	0	152469
18112	144509	1626	806	3320	0	150261
18113	3315	145346	568	1259	0	150488
18114	142493	3122	488	1191	0	147294
18115	3446	141791	430	606	0	146273
18116	140224	3342	436	776	0	144778
18117	3339	138236	401	596	0	142572
18118	1393	140987	403	530	0	143313
18119	1411	3634	472	135579	0	141096
18120	822	138191	429	2471	0	141913
18121	137556	3249	318	1142	0	142265
18122	2959	1342	135385	709	0	140395
18123	1386	1087	2394	136157	0	141024
18124	996	943	137589	2736	0	142264
18125	886	605	2838	136876	0	141205
18126	861	637	1037	139388	0	141923
18127	766	643	131692	3531	0	136632
18128	123037	527	2747	2053	0	128364
18129	2993	128149	1174	1328	0	133644
18130	130641	2657	981	1169	0	135448
18131	3420	130617	688	994	0	135719
18132	1799	3071	585	132029	0	137484
18133	130870	1200	1940	3180	0	137190
18134	133233	1001	757	1442	0	136433
18135	134435	811	645	1318	0	137209
18136	4498	676	567	131670	0	137411
18137	2433	741	539	132947	0	136660
18138	1761	134732	586	3547	0	140626
18139	137156	2919	580	2143	0	142798
18140	140080	1176	547	1682	0	143485
18141	139712	1124	719	1147	0	142702
18142	138589	890	581	1332	0	141392
18143	4595	132548	718	1031	0	138892
18144	2443	3010	769	135332	0	141554
18145	1820	1483	132620	3085	0	139008
18146	131686	1146	2867	1738	0	137437
18147	140181	897	1068	1682	0	143828
18148	4615	889	136083	963	0	142550
18149	2470	1130	136211	895	0	140706
18150	2048	965	3584	138282	0	144879
18151	1502	1070	1638	143230	0	147440
18152	1441	1015	1120	145763	0	149339
18153	141941	1085	819	4800	0	148645
18154	3808	953	786	143305	0	148852
18155	1912	836	139298	4316	0	146362
18156	1634	905	3385	141424	0	147348
18157	1236	876	142925	4368	0	149405
18158	1345	898	3585	142513	0	148341
18159	1414	806	1443	150701	0	154364
18160	1318	885	148121	4797	0	155121
18161	140552	976	3747	2659	0	147934
18162	4048	148817	1529	1779	0	156173
18163	151640	3986	1129	1339	0	158094
18164	4956	1948	657	154188	0	161749
18165	154172	1593	576	4591	0	160932
18166	4799	156840	611	2151	0	164401
18167	2484	165957	465	1595	0	170501
18168	2458	7427	616	170480	0	180981
18169	1797	2732	175984	4791	0	185304
18170	1447	2084	170986	1996	0	176513
18171	1364	172682	5776	1630	0	181452
18172	149748	4336	2488	1244	0	157816
18173	3992	1676	1341	148441	0	155450
18174	146810	929	964	4022	0	152725
18175	4095	144082	989	1743	0	150909
18176	1821	149621	828	1212	0	153482
18177	1896	5191	693	148094	0	155874
18178	147310	2235	539	4266	0	154350
18179	149283	1480	287	2031	0	153081
18180	5252	1197	144141	1244	0	151834
18181	2589	1126	139659	964	0	144338
18182	140248	942	4184	1148	0	146522
18183	4267	140972	1936	882	0	148057
18184	141313	3619	1296	886	0	147114
18185	5149	1669	994	138283	0	146095
18186	2430	1112	136129	3454	0	143125
18187	131752	792	3859	1825	0	138228
18188	4159	131999	1912	1126	0	139196
18189	2019	137018	1273	834	0	141144
18190	2250	4516	1079	134629	0	142474
18191	136102	1971	914	4040	0	143027
18192	4246	1310	793	136740	0	143089
18193	140008	1057	819	4368	0	146252
18194	4491	1296	131976	1957	0	139720
18195	137088	1129	2943	1715	0	142875
18196	141766	934	1112	1574	0	145386
18197	5629	824	133722	1196	0	141371
18198	132677	643	3385	1337	0	138042
18199	5198	129653	1752	966	0	137569
18200	3125	3358	1292	130590	0	138365
18201	2473	131227	1073	3203	0	137976
18202	135214	3832	934	1537	0	141517
18203	4916	1723	970	130864	0	138473
18204	2511	129012	977	3630	0	136130
18205	2206	3860	800	131002	0	137868
18206	1614	131387	565	4245	0	137811
18207	1606	4383	490	133545	0	140024
18208	133319	2210	488	4734	0	140751
18209	4254	1603	479	133957	0	140293
18210	2241	1419	130324	4751	0	138735
18211	129708	1227	3259	2798	0	136992
18212	4451	1177	1329	132701	0	139658
18213	2353	1047	128792	4619	0	136811
18214	2140	879	124636	2688	0	130343
18215	1907	724	131046	2065	0	135742
18216	1987	592	5226	128290	0	136095
18217	1840	579	2702	134693	0	139814
18218	1643	673	2031	135254	0	139601
18219	1505	602	1757	136361	0	140225
18220	133401	714	1605	6103	0	141823
18221	137367	689	1436	3526	0	143018
18222	138609	774	1160	2878	0	143421
18223	140608	852	896	2629	0	144985
18224	6073	765	713	136784	0	144335
18225	3485	925	137092	5030	0	146532
18226	138550	702	3413	3150	0	145815
18227	145582	798	1519	2317	0	150216
18228	6455	773	1142	142015	0	150385
18229	3838	747	995	146036	0	151616
18230	146003	702	1003	5888	0	153596
18231	5626	649	1068	140100	0	147443
18232	3243	138091	1145	5350	0	147829
18233	143317	3554	1100	3287	0	151258
18234	141371	1538	1109	2851	0	146869
18235	6201	1248	140353	2327	0	150129
18236	3622	1078	3949	142261	0	150910
18237	2805	962	1928	147269	0	152964
18238	144067	899	1522	6154	0	152642
18239	146374	842	1266	3357	0	151839
18240	6741	848	1006	144338	0	152933
18241	3892	793	141227	5430	0	151342
18242	3120	678	141849	3237	0	148884
18243	2819	553	4709	145075	0	153156
18244	2929	826	2273	147731	0	153759
18245	144074	535	1605	6227	0	152441
18246	5546	137854	1477	3487	0	148364
18247	3156	137137	1462	2641	0	144396
18248	2502	142417	1381	2224	0	148524
18249	2659	4733	1458	139960	0	148810
18250	138943	1962	1361	5161	0	147427
18251	139209	1509	746	2856	0	144320
18252	5535	137217	593	2245	0	145590
18253	139933	4191	493	2003	0	146620
18254	5401	2030	519	138517	0	146467
18255	2901	1638	137605	4600	0	146744
18256	2924	1221	3320	135376	0	142841
18257	2774	991	1284	138155	0	143204
18258	2562	929	1028	137417	0	141936
18259	131066	691	887	5684	0	138328
18260	4290	1189	905	126992	0	133376
18261	2351	125157	897	5100	0	133505
18262	123387	2739	1634	3343	0	131103
18263	3823	121065	836	2688	0	128412
18264	1889	117573	769	2187	0	122418
18265	1682	120746	727	1934	0	125089
18266	1752	2868	110916	1437	0	116973
18267	1068	107794	2288	1346	0	112496
18268	1081	1814	96139	938	0	99972
18269	88889	610	1248	653	0	91400
18270	91935	193	296	662	0	93086
18271	1222	177	93324	376	0	95099
18272	93448	166	914	656	0	95184
18273	98100	151	207	639	0	99097
18274	1196	172	96565	342	0	98275
18275	459	99251	846	343	0	100899
18276	599	1014	279	100747	0	102639
18277	102120	265	186	1223	0	103794
18278	1118	225	129	101203	0	102675
18279	105188	205	106	1342	0	106841
18280	104879	194	142	610	0	105825
18281	1246	219	104058	287	0	105810
18282	103437	162	820	521	0	104940
18283	1095	106888	269	312	0	108564
18284	109142	925	147	459	0	110673
18285	1195	274	131	109794	0	111394
18286	538	224	109275	1060	0	111097
18287	534	179	903	108322	0	109938
18288	108878	150	296	1340	0	110664
18289	1071	108627	196	520	0	110414
18290	497	949	108816	440	0	110702
18291	632	300	908	105110	0	106950
18292	448	251	109340	1105	0	111144
18293	399	109249	976	523	0	111147
18294	109804	991	325	612	0	111732
18295	1175	340	248	110094	0	111857
18296	518	289	109954	1070	0	111831
18297	502	404	102993	446	0	104345
18298	111173	278	1056	585	0	113092
18299	1296	264	352	113023	0	114935
18300	633	287	244	113674	0	114838
18301	477	285	114131	1291	0	116184
18302	471	313	112232	471	0	113487
18303	475	117112	1240	427	0	119254
18304	518	1090	435	119171	0	121214
18305	543	356	342	119286	0	120527
18306	390	118497	304	1342	0	120533
18307	419	1167	117401	555	0	119542
18308	115150	405	1116	683	0	117354
18309	1374	273	385	121207	0	123239
18310	568	292	122635	1369	0	124864
18311	586	294	1202	118357	0	120439
18312	507	121538	447	1354	0	123846
18313	521	1275	121401	537	0	123734
18314	118450	478	1349	758	0	121035
18315	1512	422	123003	363	0	125300
18316	626	399	119416	348	0	120789
18317	495	334	117666	324	0	118819
18318	468	307	126179	334	0	127288
18319	630	313	1849	127279	0	130071
18320	419	261	134306	1714	0	136700
18321	566	306	1792	130114	0	132778
18322	254	133015	614	1807	0	135690
18323	141230	1682	373	778	0	144063
18324	2318	501	298	143250	0	146367
18325	803	366	142354	2224	0	145747
18326	443	142083	2176	906	0	145608
18327	654	2078	731	144246	0	147709
18328	143405	622	555	2519	0	147101
18329	2044	143702	382	779	0	146907
18330	943	2169	292	147141	0	150545
18331	148405	671	289	2546	0	151911
18332	2244	427	145939	767	0	149377
18333	145775	240	2156	806	0	148977
18334	2392	282	148825	329	0	151828
18335	142994	230	2283	527	0	146034
18336	144563	132	842	537	0	146074
18337	3067	218	141185	239	0	144709
18338	928	139685	1883	256	0	142752
18339	1050	2038	895	134770	0	138753
18340	365	612	143087	1902	0	145966
18341	616	544	1933	137241	0	140334
18342	638	289	726	139104	0	140757
18343	277	202	141617	2482	0	144578
18344	314	213	138908	956	0	140391
18345	451	171	2425	141545	0	144592
18346	144602	118	971	2347	0	148038
18347	1991	140871	596	880	0	144338
18348	795	144068	417	531	0	145811
18349	145477	2355	324	645	0	148801
18350	148466	839	269	719	0	150293
18351	2811	458	276	147805	0	151350
18352	1223	267	283	149020	0	150793
18353	753	206	254	151123	0	152336
18354	147309	189	278	3203	0	150979
18355	2104	141395	346	1173	0	145018
18356	854	145505	336	731	0	147426
18357	730	2415	347	147384	0	150876
18358	596	868	269	149974	0	151707
18359	561	463	293	150231	0	151548
18360	148171	266	292	3314	0	152043
18361	2104	149274	297	1298	0	152973
18362	151869	2121	284	1107	0	155381
18363	2671	891	150553	510	0	154625
18364	997	152590	2405	582	0	156574
18365	789	2426	917	153738	0	157870
18366	153412	880	598	3078	0	157968
18367	2840	644	152336	1159	0	156979
18368	1248	521	151281	836	0	153886
18369	1017	389	3301	153402	0	158109
18370	715	380	1290	156588	0	158973
18371	646	377	739	155192	0	156954
18372	759	350	529	149360	0	150998
18373	755	358	419	150687	0	152219
18374	515	145452	475	4113	0	150555
18375	682	2447	447	148783	0	152359
18376	145162	944	523	3822	0	150451
18377	2634	146897	472	1796	0	151799
18378	146852	2746	417	1522	0	151537
18379	3166	1226	142466	998	0	147856
18380	1426	765	143152	940	0	146283
18381	1177	598	3390	148859	0	154024
18382	763	550	175749	3438	0	180500
18383	993	468	4675	174688	0	180824
18384	1129	481	2162	173119	0	176891
18385	178894	429	1129	6764	0	187216
18386	179425	443	753	3453	0	184074
18387	6478	181334	743	1744	0	190299
18388	2858	192929	724	1240	0	197751
18389	1885	6574	607	191457	0	200523
18390	192927	2875	615	6167	0	202584
18391	5637	1474	193167	2848	0	203126
18392	2987	868	5343	194156	0	203354
18393	1905	651	2419	197667	0	202642
18394	1094	709	192077	7918	0	201798
18395	873	191450	5585	3991	0	201899
18396	1415	5417	2477	189695	0	199004
18397	899	2501	194777	6627	0	204804
18398	1234	1364	5680	194230	0	202508
18399	186520	834	2694	7374	0	197422
18400	5343	185481	1642	3702	0	196168
18401	2592	191560	1207	2348	0	197707
18402	1868	6997	1028	189593	0	199486
18403	185447	3041	938	6786	0	196212
18404	5515	186899	1079	3559	0	197052
18405	189707	5774	1002	2849	0	199332
18406	6674	2778	186253	2223	0	197928
18407	3483	1725	191789	2036	0	199033
18408	2667	1365	7611	185885	0	197528
18409	2026	1255	3359	198895	0	205535
18410	192308	1277	1897	8978	0	204460
18411	7447	1268	1191	193644	0	203550
18412	3747	1607	189696	7770	0	202820
18413	2801	1658	5906	190232	0	200597
18414	2252	1351	2913	197175	0	203691
18415	1740	1249	185671	9473	0	198133
18416	178903	1177	6418	5494	0	191992
18417	6563	1259	3299	188485	0	199606
18418	181750	994	2096	8090	0	192930
18419	6080	173714	2031	4668	0	186493
18420	173321	5486	1671	3640	0	184118
18421	6173	169235	1459	3181	0	180048
18422	3122	173564	1756	2745	0	181187
18423	3085	7194	1977	163941	0	176197
18424	162387	3160	1728	6432	0	173707
18425	164387	2269	1124	3621	0	171401
18426	7044	2058	940	161266	0	171308
18427	161988	1574	1007	6467	0	171036
18428	163862	1494	1021	3827	0	170204
18429	7931	1647	983	161436	0	171997
18430	157166	1391	1073	6516	0	166146
18431	6647	157011	1415	3805	0	168878
18432	159466	5153	1519	3063	0	169201
18433	6641	2622	151154	2962	0	163379
18434	161513	1429	4978	3321	0	171241
18435	7025	992	2559	162384	0	172960
18436	4063	827	1872	167007	0	173769
18437	2936	892	1827	167916	0	173571
18438	2689	1487	1529	166624	0	172329
18439	2089	1180	1447	166641	0	171357
18440	2063	149443	1736	9111	0	162353
18441	2307	161467	1414	5531	0	170719
18442	161057	6036	1228	4138	0	172459
18443	6469	3311	157641	2992	0	170413
18444	157749	2573	4825	3095	0	168242
18445	7083	2205	157197	2839	0	169324
18446	4597	2093	5431	156341	0	168462
18447	3379	2258	2396	162963	0	170996
18448	158154	1721	1467	8471	0	169813
18449	7439	1794	155641	4370	0	169244
18450	5087	1574	4881	158069	0	169611
18451	3839	1411	161810	7213	0	174273
18452	3577	164230	5554	4429	0	177790
18453	3775	5301	2637	170057	0	181770
18454	170196	2578	1747	7926	0	182447
18455	167377	1722	1452	4724	0	175275
18456	172427	1749	1361	3830	0	179367
18457	9028	164962	1567	3409	0	178966
18458	4939	173716	1766	3197	0	183618
18459	157974	6971	1730	4145	0	170820
18460	6685	169805	1339	3875	0	181704
18461	3700	173055	1333	4083	0	182171
18462	3325	7101	166528	3707	0	180661
18463	2306	163994	5046	3787	0	175133
18464	2089	167747	2785	3145	0	175766
18465	2396	7082	1663	167537	0	178678
18466	2215	3901	166089	6536	0	178741
18467	2555	2562	161995	3729	0	170841
18468	160644	1871	6680	3201	0	172396
18469	6794	1556	165160	2525	0	176035
18470	168085	1314	6364	2515	0	178278
18471	7015	1469	3372	166323	0	178179
18472	4415	166705	2082	6556	0	179758
18473	174232	5228	1835	4226	0	185521
18474	181433	2804	1761	3542	0	189540
18475	8375	1646	1643	179557	0	191221
18476	5098	1355	1770	182095	0	190318
18477	3767	1324	1539	184488	0	191118
18478	178974	1270	1185	9245	0	190674
18479	167248	1471	1178	5433	0	175330
18480	180503	1569	903	3687	0	186662
18481	8692	167985	786	2782	0	180245
18482	144041	2922	649	1335	0	148947
18483	3923	139633	498	1128	0	145182
18484	1996	141582	453	1026	0	145057
18485	2173	5091	1110	133626	0	142000
18486	1284	135087	626	2680	0	139677
18487	129448	2397	534	1133	0	133512
18488	2724	1050	294	127525	0	131593
18489	125063	551	272	2324	0	128210
18490	2180	120438	261	956	0	123835
18491	951	125663	253	585	0	127452
18492	127389	2056	295	780	0	130520
18493	2243	129378	284	506	0	132411
18494	1231	2131	400	131033	0	134795
18495	1042	732	367	133077	0	135218
18496	132282	428	234	2707	0	135651
18497	2498	339	194	132713	0	135744
18498	926	376	134486	2475	0	138263
18499	823	398	2116	135393	0	138730
18500	137809	316	624	2858	0	141607
18501	2569	140435	425	941	0	144370
18502	147439	2564	258	1044	0	151305
18503	144072	897	290	1027	0	146286
18504	149707	653	190	776	0	151326
18505	3881	567	145624	414	0	150486
18506	1556	546	140587	420	0	143109
18507	140372	403	2934	670	0	144379
18508	2928	142260	1012	433	0	146633
18509	1291	2721	548	144799	0	149359
18510	996	1008	385	145034	0	147423
18511	636	138876	421	3201	0	143134
18512	550	144459	388	1165	0	146562
18513	720	3217	342	145203	0	149482
18514	774	1127	248	147368	0	149517
18515	558	761	142678	3427	0	147424
18516	736	741	135828	1346	0	138651
18517	140555	401	3185	1200	0	145341
18518	148154	416	1158	901	0	150629
18519	3800	410	737	146121	0	151068
18520	1487	464	145988	3053	0	150992
18521	1281	484	2826	144980	0	149571
18522	144899	470	893	3622	0	149884
18523	3322	514	143721	1350	0	148907
18524	1597	519	2823	146503	0	151442
18525	1062	567	146550	3114	0	151293
18526	856	143994	3089	1374	0	149313
18527	748	2864	145975	870	0	150457
18528	1138	1504	3191	142467	0	148300
18529	145549	696	1237	3308	0	150790
18530	3235	603	764	147746	0	152348
18531	147151	459	525	3735	0	151870
18532	150405	434	470	1740	0	153049
18533	147589	507	457	1320	0	149873
18534	4041	483	141960	800	0	147284
18535	145039	364	2715	1026	0	149144
18536	3790	389	1053	146053	0	151285
18537	1813	362	714	147848	0	150737
18538	1184	480	145102	3519	0	150285
18539	1269	719	2612	145654	0	150254
18540	147106	413	1005	3843	0	152367
18541	2999	146532	750	1632	0	151913
18542	150945	2581	519	1574	0	155619
18543	153025	889	433	1348	0	155695
18544	154514	631	412	1189	0	156746
18545	4368	539	447	151211	0	156565
18546	1898	474	152267	3336	0	157975
18547	1607	386	2795	155187	0	159975
18548	1330	391	1071	158202	0	160994
18549	156559	333	738	4553	0	162183
18550	153758	379	611	2290	0	157038
18551	4138	461	148122	1329	0	154050
18552	2122	651	2968	147804	0	153545
18553	1410	439	148667	3626	0	154142
18554	150029	354	3586	1811	0	155780
18555	3935	161510	1364	1352	0	168161
18556	163426	3508	1085	1187	0	169206
18557	4517	165766	702	939	0	171924
18558	165930	4076	700	1089	0	171795
18559	4669	165775	619	858	0	171921
18560	2478	4319	613	165931	0	173341
18561	1972	1424	468	171171	0	175035
18562	168900	1021	449	5393	0	175763
18563	168761	600	475	2595	0	172431
18564	170221	544	483	1886	0	173134
18565	164335	481	513	1602	0	166931
18566	168601	475	485	1230	0	170791
18567	6582	468	471	161914	0	169435
18568	3028	160604	481	4189	0	168302
18569	2603	3876	386	159721	0	166586
18570	1671	158492	430	4596	0	165189
18571	1705	4435	388	156285	0	162813
18572	1338	157153	452	4676	0	163619
18573	1593	4404	391	156130	0	162518
18574	1358	1478	149723	4871	0	157430
18575	144563	1071	3591	2377	0	151602
18576	4545	148935	1245	1636	0	156361
18577	150367	3829	880	1484	0	156560
18578	5080	1474	146697	1105	0	154356
18579	145585	1120	3767	1298	0	151770
18580	5144	890	151943	1041	0	159018
18581	2474	894	4405	151674	0	159447
18582	1747	160158	1581	4495	0	167981
18583	1384	4449	162266	1729	0	169828
18584	1641	1683	4744	163444	0	171512
18585	156381	1295	1956	5620	0	165252
18586	5447	830	1363	166204	0	173844
18587	2749	735	879	169640	0	174003
18588	2369	630	700	171919	0	175618
18589	1599	678	164729	7114	0	174120
18590	1877	593	4609	163745	0	170824
18591	1251	159542	1858	6285	0	168936
18592	1514	4323	1276	162856	0	169969
18593	1567	1644	813	164525	0	168549
18594	159357	1165	668	6932	0	168122
18595	5501	1030	615	163221	0	170367
18596	2533	695	162194	6291	0	171713
18597	1993	614	162050	3101	0	167758
18598	1413	523	162387	2364	0	166687
18599	1046	159833	6337	1806	0	169022
18600	156922	4690	3696	1899	0	167207
18601	4598	155828	1904	1356	0	163686
18602	153118	4955	1286	1320	0	160679
18603	5624	2135	750	151159	0	159668
18604	2461	1498	152606	4707	0	161272
18605	2034	1059	148721	2226	0	154040
18606	1340	154110	5487	1789	0	162726
18607	1550	4678	2698	154893	0	163819
18608	1327	2000	1700	158909	0	163936
18609	1244	1539	1174	160923	0	164880
18610	950	1132	155892	7132	0	165106
18611	147372	938	4771	4030	0	157111
18612	5232	905	155974	2502	0	164613
18613	2968	801	5418	154247	0	163434
18614	2447	786	2378	160975	0	166586
18615	1571	789	155497	6972	0	164829
18616	149185	733	5205	4147	0	159270
18617	5221	155352	2458	2843	0	165874
18618	157129	4804	1761	2456	0	166150
18619	6200	2133	1193	152941	0	162467
18620	2693	155263	1167	5646	0	164769
18621	2493	5005	1101	159232	0	167831
18622	157956	2336	1033	6894	0	168219
18623	5887	1615	1031	158118	0	166651
18624	2818	1176	152956	6979	0	163929
18625	151617	1020	4955	3846	0	161438
18626	157012	914	2408	3073	0	163407
18627	7101	1025	152017	2155	0	162298
18628	3913	974	5148	152654	0	162689
18629	156133	958	2513	6321	0	165925
18630	6271	897	1850	153837	0	162855
18631	3327	979	1365	154085	0	159756
18632	2798	859	1228	154247	0	159132
18633	2155	820	1124	155536	0	159635
18634	1733	860	146866	8676	0	158135
18635	1809	729	5183	149762	0	157483
18636	1605	787	146805	7683	0	156880
18637	144469	690	6058	4366	0	155583
18638	149976	710	2990	3564	0	157240
18639	149779	754	2274	2915	0	155722
18640	150660	731	1651	2732	0	155774
18641	8345	747	1519	143709	0	154320
18642	142489	632	1360	6622	0	151103
18643	6804	689	138832	3746	0	150071
18644	3552	659	138176	3199	0	145586
18645	133977	594	6188	2782	0	143541
18646	5656	131095	3363	2534	0	142648
18647	2860	134016	2251	2211	0	141338
18648	2860	5479	2012	130885	0	141236
18649	2048	2497	130234	5496	0	140275
18650	125056	1723	5144	3480	0	135403
18651	5499	1161	129666	2762	0	139088
18652	2886	122638	4872	2289	0	132685
18653	2577	3700	122850	2080	0	131207
18654	1788	116085	4639	1835	0	124347
18655	103928	4135	3221	1894	0	113178
18656	3685	102905	1637	1558	0	109785
18657	1945	100741	1174	1349	0	105209
18658	1829	3708	1043	99808	0	106388
18659	1227	1866	98293	3518	0	104904
18660	1259	1218	3150	95768	0	101395
18661	1234	885	1698	98832	0	102649
18662	1024	795	95542	4603	0	101964
18663	1156	648	3340	94021	0	99165
18664	1160	91614	1905	4004	0	98683
18665	1223	2692	1451	97111	0	102477
18666	96123	1381	1226	4038	0	102768
18667	3535	984	1059	97506	0	103084
18668	2042	817	95670	4055	0	102584
18669	1753	722	3131	97867	0	103473
18670	1271	709	96068	4175	0	102223
18671	95316	683	3412	2553	0	101964
18672	3507	625	1822	97641	0	103595
18673	97529	673	1444	4107	0	103753
18674	3763	613	96014	2418	0	102808
18675	92866	576	3301	2086	0	98829
18676	3713	96579	1890	1568	0	103750
18677	2186	2788	97638	1494	0	104106
18678	1823	2361	3432	95561	0	103177
18679	1455	1054	98454	3437	0	104400
18680	1183	91025	3427	2094	0	97729
18681	1184	95799	1886	1728	0	100597
18682	84435	2750	1179	1261	0	89625
18683	2485	88744	823	1164	0	93216
18684	89752	2570	927	1152	0	94401
18685	3329	1176	827	90162	0	95494
18686	1491	783	88596	2890	0	93760
18687	1102	89261	2598	1457	0	94418
18688	1241	2733	1364	89678	0	95016
18689	1068	1163	854	93564	0	96649
18690	1021	840	717	95119	0	97697
18691	953	721	665	93296	0	95635
18692	792	87282	681	4026	0	92781
18693	689	92927	691	2015	0	96322
18694	89039	2842	701	1448	0	94030
18695	2542	88573	551	1034	0	92700
18696	1174	2633	503	84611	0	88921
18697	770	979	83784	2466	0	87999
18698	601	83314	2173	1170	0	87258
18699	782	2283	840	82365	0	86270
18700	745	1292	654	82272	0	84963
18701	403	82394	425	2695	0	85917
18702	80183	2140	408	1379	0	84110
18703	2081	945	79324	872	0	83222
18704	74983	685	1769	768	0	78205
18705	2067	77864	738	546	0	81215
18706	72311	1739	443	465	0	74958
18707	1701	74100	233	312	0	76346
18708	917	1909	318	76420	0	79564
18709	596	788	284	78134	0	79802
18710	76502	538	173	2386	0	79599
18711	1882	472	177	77312	0	79843
18712	734	385	76085	2084	0	79288
18713	399	73838	1571	926	0	76734
18714	388	75947	573	559	0	77467
18715	521	2095	406	74701	0	77723
18716	362	847	75081	1696	0	77986
18717	441	650	1500	74001	0	76592
18718	421	439	547	75573	0	76980
18719	248	406	73369	2249	0	76272
18720	307	394	71637	1021	0	73359
18721	246	73040	1779	784	0	75849
18722	73199	1652	704	770	0	76325
18723	1726	755	397	72274	0	75152
18724	627	70485	368	1694	0	73174
18725	72813	1794	276	958	0	75841
18726	1720	789	277	73011	0	75797
18727	721	531	262	73273	0	74787
18728	337	71430	260	2335	0	74362
18729	378	1691	256	71799	0	74124
18730	71493	722	270	2291	0	74776
18731	1745	565	283	72721	0	75314
18732	815	469	263	73874	0	75421
18733	511	508	71351	2321	0	74691
18734	465	543	68072	1120	0	70200
18735	70752	422	1911	957	0	74042
18736	1781	451	702	71555	0	74489
18737	861	430	406	72475	0	74172
18738	591	434	294	73584	0	74903
18739	457	468	70578	2588	0	74091
18740	70468	423	1575	1449	0	73915
18741	1842	446	653	71662	0	74603
18742	918	417	447	73183	0	74965
18743	70720	436	394	2660	0	74210
18744	1765	70161	390	1409	0	73725
18745	817	1714	70118	1080	0	73729
18746	600	804	1670	68996	0	72070
18747	517	69815	772	2184	0	73288
18748	547	1676	572	72181	0	74976
18749	70787	729	488	2490	0	74494
18750	1885	604	364	71514	0	74367
18751	70166	526	379	2496	0	73567
18752	70737	479	389	1445	0	73050
18753	2371	455	343	68986	0	72155
18754	1043	66627	359	2358	0	70387
18755	708	70194	337	1427	0	72666
18756	550	2087	69081	1108	0	72826
18757	686	1013	1771	66754	0	70224
18758	578	692	735	70418	0	72423
18759	536	570	481	71637	0	73224
18760	69329	511	411	2937	0	73188
18761	1965	483	333	70408	0	73189
18762	1007	461	69142	2547	0	73157
18763	69487	351	1601	1688	0	73127
18764	2059	378	692	71981	0	75110
18765	1020	409	510	73819	0	75758
18766	667	448	71406	2746	0	75267
18767	70462	443	1739	1615	0	74259
18768	1919	438	737	72828	0	75922
18769	921	428	73157	2603	0	77109
18770	796	352	1813	73684	0	76645
18771	777	317	871	70041	0	72006
18772	665	73314	604	2648	0	77231
18773	73138	1686	503	1734	0	77061
18774	73115	696	460	1417	0	75688
18775	2258	71935	464	1185	0	75842
18776	71402	1740	446	1191	0	74779
18777	71143	681	397	1207	0	73428
18778	2532	492	381	70371	0	73776
18779	1133	343	67455	2337	0	71268
18780	884	281	64931	1294	0	67390
18781	606	249	64317	957	0	66129
18782	533	370	65301	896	0	67100
18783	684	1122	1954	59847	0	63607
18784	438	241	946	61942	0	63567
18785	482	222	375	61672	0	62751
18786	533	208	277	62703	0	63721
18787	61425	191	278	2117	0	64011
18788	1434	62539	289	1065	0	65327
18789	63422	1029	236	784	0	65471
18790	1477	437	62753	563	0	65230
18791	695	238	65289	517	0	66739
18792	578	680	1551	66117	0	68926
18793	67001	177	1052	1687	0	69917
18794	65609	130	424	887	0	67050
18795	1610	65058	330	592	0	67590
18796	606	66767	255	547	0	68175
18797	569	1409	254	66849	0	69081
18798	66341	470	310	1503	0	68624
18799	1254	66664	192	673	0	68783
18800	67197	1148	193	655	0	69193
18801	67504	481	167	568	0	68720
18802	68050	292	163	470	0	68975
18803	1672	228	66836	366	0	69102
18804	812	67413	1038	316	0	69579
18805	66859	1010	503	505	0	68877
18806	66937	453	294	449	0	68133
18807	1532	64324	173	331	0	66360
18808	502	62511	119	129	0	63261
18809	62776	1016	196	213	0	64201
18810	1100	429	98	62427	0	64054
18811	455	247	62116	823	0	63641
18812	61089	159	814	400	0	62462
18813	1032	147	266	63520	0	64965
18814	400	64825	198	829	0	66252
18815	379	860	92	66682	0	68013
18816	277	345	66612	961	0	68195
18817	318	239	854	66389	0	67800
18818	69850	162	313	1162	0	71487
18819	1093	150	160	70527	0	71930
18820	541	113	107	71279	0	72040
18821	306	166	72929	1256	0	74657
18822	402	121	887	71038	0	72448
18823	217	72744	324	1079	0	74364
18824	73562	884	198	586	0	75230
18825	72420	318	151	422	0	73311
18826	1261	218	73264	234	0	74977
18827	613	203	892	71568	0	73276
18828	306	71233	335	1025	0	72899
18829	252	74131	214	407	0	75004
18830	73788	1132	186	427	0	75533
18831	1150	419	113	75217	0	76899
18832	434	266	74864	1061	0	76625
18833	361	208	73557	437	0	74563
18834	307	161	1197	75823	0	77488
18835	75668	141	468	1249	0	77526
18836	75821	129	273	571	0	76794
18837	1430	131	186	77977	0	79724
18838	592	172	78790	1105	0	80659
18839	348	78503	1024	503	0	80378
18840	79072	980	370	508	0	80930
18841	1051	79683	266	314	0	81314
18842	80623	1108	187	373	0	82291
18843	1280	438	172	80541	0	82431
18844	531	295	80268	1148	0	82242
18845	510	229	1029	79331	0	81099
18846	80432	162	390	1446	0	82430
18847	1208	213	80082	512	0	82015
18848	517	80249	1113	412	0	82291
18849	488	1015	430	81339	0	83272
18850	82008	411	291	1378	0	84088
18851	1244	297	81671	516	0	83728
18852	663	220	1098	82798	0	84779
18853	523	182	451	84799	0	85955
18854	338	233	84351	1466	0	86388
18855	473	196	1176	82898	0	84743
18856	338	227	83979	1399	0	85943
18857	82057	176	1223	783	0	84239
18858	1352	184	506	87422	0	89464
18859	609	265	90871	1325	0	93070
18860	457	91874	1329	619	0	94279
18861	94610	1295	504	657	0	97066
18862	100967	466	328	648	0	102409
18863	2187	369	232	108111	0	110899
18864	892	110130	267	1958	0	113247
18865	112337	2048	265	925	0	115575
18866	2526	703	223	112546	0	115998
18867	920	490	112029	2300	0	115739
18868	109249	349	2032	1075	0	112705
18869	2297	109911	774	666	0	113648
18870	1097	2060	473	112304	0	115934
18871	112358	651	339	2498	0	115846
18872	2452	528	109846	827	0	113653
18873	983	382	111497	625	0	113487
18874	936	323	2556	109554	0	113369
18875	578	293	113914	2323	0	117108
18876	718	206	2511	111340	0	114775
18877	403	110031	1052	2500	0	113986
18878	492	2146	678	117092	0	120408
18879	115418	640	473	3031	0	119562
18880	2275	513	115091	1117	0	118996
18881	809	115371	2348	963	0	119491
18882	876	2196	777	115912	0	119761
18883	535	750	118507	2466	0	122258
18884	720	1138	2194	113213	0	117265
18885	387	114157	918	2462	0	117924
18886	301	118730	633	925	0	120589
18887	114984	2335	556	1051	0	118926
18888	1853	116926	422	572	0	119773
18889	654	2145	113391	382	0	116572
18890	106971	925	2133	712	0	110741
18891	1920	596	112934	256	0	115706
18892	1008	424	1856	105734	0	109022
18893	497	293	113060	1707	0	115557
18894	354	111884	1963	607	0	114808
18895	558	1611	711	112642	0	115522
18896	459	528	460	113195	0	114642
18897	499	405	322	111336	0	112562
18898	236	321	111889	2346	0	114792
18899	442	266	1697	109881	0	112286
18900	321	233	558	114112	0	115224
18901	111103	215	445	2620	0	114383
18902	111361	174	342	1414	0	113291
18903	2072	237	111336	728	0	114373
18904	805	109430	1773	600	0	112608
18905	664	1639	111929	397	0	114629
18906	567	543	1943	112130	0	115183
18907	397	453	114913	1818	0	117581
18908	484	327	2010	113575	0	116396
18909	386	265	793	117334	0	118778
18910	251	220	115669	2375	0	118515
18911	107285	211	1973	1414	0	110883
18912	1702	116825	784	838	0	120149
18913	684	1755	556	118750	0	121745
18914	502	654	121120	2012	0	124288
18915	499	582	114969	839	0	116889
18916	115285	387	2193	931	0	118796
18917	1738	118931	974	560	0	122203
18918	729	1721	677	120245	0	123372
18919	121963	525	465	2239	0	125192
18920	2024	388	403	122594	0	125409
18921	891	288	382	125666	0	127227
18922	593	345	124476	2493	0	127907
18923	119008	259	1865	1565	0	122697
18924	127072	236	743	1086	0	129137
18925	2473	224	608	126998	0	130303
18926	126563	239	425	2415	0	129642
18927	2446	282	418	126586	0	129732
18928	973	121241	489	2749	0	125452
18929	737	127739	435	1101	0	130012
18930	770	2444	422	129465	0	133101
18931	127010	882	402	2619	0	130913
18932	2062	575	301	128050	0	130988
18933	128786	328	313	2786	0	132213
18934	129919	352	316	1379	0	131966
18935	2682	306	331	129691	0	133010
18936	1392	262	281	131846	0	133781
18937	891	321	128080	2767	0	132059
18938	734	312	128336	1301	0	130683
18939	806	318	2551	129820	0	133495
18940	459	262	137390	2645	0	140756
18941	135325	239	2664	1528	0	139756
18942	2543	225	1108	145771	0	149647
18943	905	287	152270	2961	0	156423
18944	150710	198	3126	1747	0	155781
18945	164580	208	1346	1348	0	167482
18946	4560	170161	880	846	0	176447
18947	2632	3387	522	175114	0	181655
18948	1397	1396	177719	3695	0	184207
18949	177472	898	3605	2169	0	184144
18950	185046	445	1569	1729	0	188789
18951	5087	457	182601	792	0	188937
18952	184826	281	3784	1134	0	190025
18953	5031	301	1713	183382	0	190427
18954	2574	225	1148	187437	0	191384
18955	185293	220	731	5382	0	191626
18956	186430	226	663	2750	0	190069
18957	5668	953	792	183016	0	190429
18958	3020	320	182048	4232	0	189620
18959	1770	177815	3474	2287	0	185346
18960	1524	3212	179947	1482	0	186165
18961	1452	1494	177716	1010	0	181672
18962	1032	173672	4951	1065	0	180720
18963	1564	3114	2502	162084	0	169264
18964	1017	1267	1321	166099	0	169704
18965	691	799	163919	3672	0	169081
18966	1161	437	3043	161301	0	165942
18967	164483	284	1488	4053	0	170308
18968	3195	408	165774	1892	0	171269
18969	166408	258	3094	1903	0	171663
18970	171880	170	1682	1370	0	175102
18971	172866	201	1117	1276	0	175460
18972	5225	360	166814	741	0	173140
18973	2786	443	167610	703	0	171542
18974	2203	430	3971	167242	0	173846
18975	1768	458	2187	162639	0	167052
18976	1185	169168	1429	3702	0	175484
18977	169681	2774	1011	2456	0	175922
18978	169799	1200	1035	1774	0	173808
18979	4304	168733	931	1148	0	175116
18980	170251	2883	743	1573	0	175450
18981	4038	167981	729	1141	0	173889
18982	170966	3264	731	1385	0	176346
18983	4491	1439	739	166901	0	173570
18984	2402	1048	167175	3371	0	173996
18985	1851	788	163587	1754	0	167980
18986	1543	757	4190	164826	0	171316
18987	1422	454	2339	167026	0	171241
18988	993	552	164588	4261	0	170394
18989	1280	524	3569	161730	0	167103
18990	1372	510	2039	161052	0	164973
18991	163711	422	1457	5145	0	170735
18992	166117	394	1026	3005	0	170542
18993	163822	428	891	2274	0	167415
18994	5084	498	159524	1238	0	166344
18995	2882	159806	3295	1163	0	167146
18996	2376	2773	1664	163514	0	170327
18997	1812	1367	166046	3245	0	172470
18998	1597	165544	3562	1723	0	172426
18999	168972	2997	1997	1708	0	175674
19000	3917	1409	1468	169399	0	176193
19001	2284	970	1142	172289	0	176685
19002	170050	651	1029	4986	0	176716
19003	4020	656	930	170456	0	176062
19004	2639	609	800	171618	0	175666
19005	170995	608	705	5408	0	177716
19006	4211	666	166924	2711	0	174512
19007	2458	165888	3288	1910	0	173544
19008	167818	3108	1698	1860	0	174484
19009	4076	1639	168914	1325	0	175954
19010	166385	1071	3544	1767	0	172767
19011	4201	171554	2140	1320	0	179215
19012	171049	3134	1625	1736	0	177544
19013	171374	1512	1277	1737	0	175900
19014	168164	1036	1085	1719	0	172004
19015	5548	767	1021	164133	0	171469
19016	3153	1269	1007	164664	0	170093
19017	2329	160891	945	4755	0	168920
19018	1907	163151	1065	2722	0	168845
19019	1950	164876	933	1886	0	169645
19020	164331	3898	815	1824	0	170868
19021	3863	1900	160599	1252	0	167614
19022	2449	1294	2981	160287	0	167011
19023	1884	924	1647	161582	0	166037
19024	1437	160029	1315	4173	0	166954
19025	1595	3141	928	162584	0	168248
19026	1685	1668	889	160394	0	164636
19027	1331	161720	842	4518	0	168411
19028	160645	3101	956	3016	0	167718
19029	3370	162055	691	1978	0	168094
19030	2028	3419	158373	1514	0	165334
19031	157429	1651	2933	1846	0	163859
19032	3540	161418	1459	1473	0	167890
19033	160820	3023	1100	1582	0	166525
19034	4044	1591	859	159822	0	166316
19035	2575	1170	961	159751	0	164457
19036	1868	932	157823	3847	0	164470
19037	1786	943	155222	2047	0	159998
19038	1816	1486	3339	156345	0	162986
19039	155823	678	1811	3617	0	161929
19040	150485	581	1241	2118	0	154425
19041	4043	150027	839	1479	0	156388
19042	1857	146147	640	993	0	149637
19043	1104	143506	507	749	0	145866
19044	2719	4457	1563	134104	0	142843
19045	132261	857	1765	2884	0	137767
19046	131696	292	136	1020	0	133144
19047	130435	182	150	745	0	131512
19048	2782	277	125044	240	0	128343
19049	849	146652	2194	342	0	150037
19050	889	2400	571	163087	0	166947
19051	165000	580	332	3654	0	169566
19052	4056	393	169	166875	0	171493
19053	1384	227	126	174881	0	176618
19054	173642	200	162	5100	0	179104
19055	186332	193	141	1743	0	188409
19056	5658	267	184376	703	0	191004
19057	2480	250	4437	185664	0	192831
19058	1003	237	183564	4833	0	189637
19059	1259	239	4874	184326	0	190698
19060	650	289	183402	5290	0	189631
19061	1055	567	5001	182658	0	189281
19062	178941	170	1575	5946	0	186632
19063	4659	176657	968	2066	0	184350
19064	1504	186540	580	1212	0	189836
19065	1734	5906	471	170237	0	178348
19066	619	186859	429	4269	0	192176
19067	185631	5339	417	1793	0	193180
19068	183319	1721	324	1364	0	186728
19069	6254	1074	177333	633	0	185294
19070	2076	176434	4753	807	0	184070
19071	1797	4694	1489	179938	0	187918
19072	885	1512	179140	5007	0	186544
19073	177092	813	4934	2087	0	184926
19074	5781	637	1553	179501	0	187472
19075	1917	566	180425	5062	0	187970
19076	1571	445	4973	180479	0	187468
19077	180503	411	1691	6004	0	188609
19078	5260	476	177664	1980	0	185380
19079	177701	334	5035	1590	0	184660
19080	184211	299	1734	1203	0	187447
19081	7051	403	960	178861	0	187275
19082	2507	499	177264	5230	0	185500
19083	1547	633	175112	2005	0	179297
19084	174571	429	6038	1600	0	182638
19085	181478	307	2130	1419	0	185334
19086	6850	451	176659	987	0	184947
19087	3283	367	5289	176481	0	185420
19088	2283	293	1945	176535	0	181056
19089	1291	176983	1406	6333	0	186013
19090	1631	4905	937	180964	0	188437
19091	180763	1506	841	6539	0	189649
19092	6249	791	780	181569	0	189389
19093	2330	568	177849	6446	0	187193
19094	175345	453	5389	2987	0	184174
19095	6301	460	2055	177058	0	185874
19096	2542	663	175227	5934	0	184366
19097	1698	170925	5581	2646	0	180850
19098	167891	5118	2180	2394	0	177583
19099	5764	172613	1427	1713	0	181517
19100	173361	5664	1034	2010	0	182069
19101	6731	2082	168883	1654	0	179350
19102	2898	163918	5420	1758	0	173994
19103	2107	173322	2231	1613	0	179273
19104	2157	6587	1635	167363	0	177742
19105	2195	2304	1299	172972	0	178770
19106	1719	1366	166320	7491	0	176896
19107	1818	917	5781	169447	0	177963
19108	166546	828	2603	7367	0	177344
19109	6213	995	162937	3359	0	173504
19110	3105	942	6062	163652	0	173761
19111	2086	1080	160842	6750	0	170758
19112	156360	1057	6384	3515	0	167316
19113	6230	160435	2831	2659	0	172155
19114	161737	5734	2018	2489	0	171978
19115	167750	2283	1580	2407	0	174020
19116	169127	1522	1538	2235	0	174422
19117	8867	1391	157675	1830	0	169763
19118	4150	157831	6042	1792	0	169815
19119	3119	5702	2756	159826	0	171403
19120	2529	2390	2035	168994	0	175948
19121	170429	1440	1761	8548	0	182178
19122	7933	1107	1795	172801	0	183636
19123	174030	1062	1939	8510	0	185541
19124	176250	1031	2853	4356	0	184490
19125	178670	1070	1661	3265	0	184666
19126	179591	1023	1840	2559	0	185013
19127	10595	954	1550	170913	0	184012
19128	172583	944	1600	7865	0	182992
19129	9128	1068	164141	3687	0	178024
19130	167008	1083	6817	2882	0	177790
19131	174260	965	3001	2367	0	180593
19132	10220	1192	158834	6125	0	176371
19133	167688	1093	6789	2123	0	177693
19134	174624	965	3154	2018	0	180761
19135	10458	862	2161	166439	0	179920
19136	5377	922	1976	171469	0	179744
19137	162850	4837	1817	8995	0	178499
19138	8800	887	1636	166435	0	177758
19139	4918	840	1671	165894	0	173323
19140	3481	155719	1604	9284	0	170088
19141	3369	4961	1526	159689	0	169545
19142	155612	1732	1514	8032	0	166890
19143	7787	1129	1279	155579	0	165774
19144	4269	736	1420	154394	0	160819
19145	3039	140874	1528	8367	0	153808
19146	3366	4755	1270	139963	0	149354
19147	3795	2007	1254	138730	0	145786
19148	132943	1173	1193	7223	0	142532
19149	6188	2558	805	105579	0	115130
19150	2409	512	92160	4486	0	99567
19151	1452	85330	2912	2501	0	92195
19152	1148	86251	1333	1510	0	90242
19153	80796	3208	1229	1301	0	86534
19154	3088	81873	636	1114	0	86711
19155	70837	2015	1141	778	0	74771
19156	2378	69824	365	572	0	73139
19157	71284	2002	397	691	0	74374
19158	2519	835	151	71688	0	75193
19159	1275	597	111	72834	0	74817
19160	870	71366	132	2728	0	75096
19161	941	2021	122	73506	0	76590
19162	651	815	72528	2500	0	76494
19163	70762	484	1753	1412	0	74411
19164	2212	75155	680	874	0	78921
19165	74946	1927	349	744	0	77966
19166	76059	842	219	696	0	77816
19167	77390	489	213	548	0	78640
19168	3382	359	162	74302	0	78205
19169	1729	355	147	74895	0	77126
19170	1011	73556	163	2922	0	77652
19171	73659	2022	111	1538	0	77330
19172	2396	74378	124	850	0	77748
19173	75235	2298	112	707	0	78352
19174	2756	1057	74322	588	0	78723
19175	77741	548	2003	702	0	80994
19176	3135	387	804	78057	0	82383
19177	1580	401	77184	2639	0	81804
19178	1174	348	78110	1311	0	80943
19179	982	335	3090	78199	0	82606
19180	794	279	78831	2773	0	82677
19181	895	272	2761	78176	0	82104
19182	75341	266	1255	3113	0	79975
19183	2926	252	672	76637	0	80487
19184	1503	312	74287	3077	0	79179
19185	1085	71569	2392	1603	0	76649
19186	785	75073	1121	1093	0	78072
19187	1066	3020	776	72662	0	77524
19188	72762	1320	535	2932	0	77549
19189	2748	688	280	73405	0	77121
19190	1589	427	262	75050	0	77328
19191	1153	350	316	76086	0	77905
19192	883	362	303	76608	0	78156
19193	763	403	73425	3899	0	78490
19194	786	308	72618	2027	0	75739
19195	73020	278	2963	1387	0	77648
19196	75666	226	1380	1186	0	78458
19197	3429	287	753	74266	0	78735
19198	1896	323	493	76112	0	78824
19199	1095	312	72881	3615	0	77903
19200	873	73174	2369	1895	0	78311
19201	73247	2265	1099	1397	0	78008
19202	75408	1105	659	1050	0	78222
19203	3530	718	346	74065	0	78659
19204	1822	566	73198	2937	0	78523
19205	1257	461	2210	72962	0	76890
19206	812	72945	1127	3033	0	77917
19207	825	2357	73337	1571	0	78090
19208	73178	1145	2369	1299	0	77991
19209	2817	724	1120	74663	0	79324
19210	75770	458	730	3136	0	80094
19211	3001	442	72713	1742	0	77898
19212	74243	417	2433	1355	0	78448
19213	3170	455	1184	73987	0	78796
19214	73955	478	790	2971	0	78194
19215	3314	476	575	72273	0	76638
19216	1698	68602	602	3090	0	73992
19217	1288	72221	502	1613	0	75624
19218	1214	3324	494	70357	0	75389
19219	827	1276	68516	2568	0	73187
19220	646	67118	1967	1525	0	71256
19221	1124	1915	970	61284	0	65293
19222	59011	741	729	1952	0	62433
19223	59676	417	314	1091	0	61498
19224	2173	293	312	59259	0	62037
19225	1225	292	295	59306	0	61118
19226	747	56194	336	2272	0	59549
19227	555	59447	311	1223	0	61536
19228	58711	1855	257	977	0	61800
19229	1649	949	264	58785	0	61647
19230	932	523	242	59810	0	61507
19231	615	370	58042	2404	0	61431
19232	501	312	1531	58427	0	60771
19233	556	278	808	58604	0	60246
19234	479	249	560	59614	0	60902
19235	539	259	57771	2598	0	61167
19236	490	228	1564	58839	0	61121
19237	58025	188	833	2451	0	61497
19238	1609	268	56687	1380	0	59944
19239	59048	281	1602	1257	0	62188
19240	1931	245	898	60279	0	63353
19241	1093	203	582	62431	0	64309
19242	815	191	424	64020	0	65450
19243	539	193	61243	2785	0	64760
19244	59832	159	1714	1695	0	63400
19245	1767	63587	896	1096	0	67346
19246	64583	1551	541	940	0	67615
19247	1971	64925	426	822	0	68144
19248	1099	1812	386	65799	0	69096
19249	65912	831	322	2189	0	69254
19250	1947	540	63913	1292	0	67692
19251	63432	276	1648	1010	0	66366
19252	2172	295	64801	714	0	67982
19253	1214	556	1845	63695	0	67310
19254	744	238	63450	1936	0	66368
19255	535	61976	1871	1216	0	65598
19256	946	1612	1045	59821	0	63424
19257	57952	825	713	2066	0	61556
19258	1544	406	284	57214	0	59448
19259	846	55988	299	1673	0	58806
19260	685	1291	262	57177	0	59415
19261	55881	646	243	1757	0	58527
19262	54864	373	243	1092	0	56572
19263	1901	53383	262	774	0	56320
19264	786	51157	159	414	0	52516
19265	647	1324	305	50388	0	52664
19266	511	613	263	50832	0	52219
19267	50009	349	169	1496	0	52023
19268	49707	228	162	853	0	50950
19269	1340	49686	160	519	0	51705
19270	747	1113	124	49093	0	51077
19271	517	546	129	49966	0	51158
19272	379	305	48849	1379	0	50912
19273	294	48046	875	845	0	50060
19274	226	47216	366	514	0	48322
19275	305	1002	203	44753	0	46263
19276	141	322	44355	685	0	45503
19277	138	197	43744	337	0	44416
19278	189	172	784	44058	0	45203
19279	183	129	346	44883	0	45541
19280	112	87	44471	874	0	45544
19281	177	66	640	44829	0	45712
19282	107	93	45574	798	0	46572
19283	46161	90	691	502	0	47444
19284	833	83	302	47155	0	48373
19285	347	99	47784	896	0	49126
19286	211	122	47796	468	0	48597
19287	240	181	1117	49944	0	51482
19288	159	98	53021	1110	0	54388
19289	163	106	52875	528	0	53672
19290	122	52198	1370	344	0	54034
19291	53958	1004	549	309	0	55820
19292	1058	397	55189	204	0	56848
19293	493	213	1129	54826	0	56661
19294	362	133	482	56035	0	57012
19295	245	119	256	57597	0	58217
19296	162	114	55818	1644	0	57738
19297	205	104	1144	55189	0	56642
19298	55288	67	480	1533	0	57368
19299	1191	64	274	55408	0	56937
19300	454	105	55116	1413	0	57088
19301	326	88	1148	55200	0	56762
19302	55512	96	500	1565	0	57673
19303	56586	72	303	800	0	57761
19304	56365	71	243	490	0	57169
19305	1696	67	232	55692	0	57687
19306	56105	70	190	1402	0	57767
19307	56366	66	184	719	0	57335
19308	56332	51	198	538	0	57119
19309	1692	53880	233	339	0	56144
19310	55162	1042	193	363	0	56760
19311	1504	406	163	54641	0	56714
19312	649	251	53966	1262	0	56128
19313	416	53884	1153	598	0	56051
19314	54561	1116	472	508	0	56657
19315	1312	444	306	54737	0	56799
19316	661	238	223	54512	0	55634
19317	360	52780	243	1552	0	54935
19318	269	55136	223	733	0	56361
19319	52665	1384	212	544	0	54805
19320	1207	53074	205	398	0	54884
19321	51892	1215	176	371	0	53654
19322	1268	51865	175	333	0	53641
19323	51585	1206	155	369	0	53315
19324	1301	51256	174	322	0	53053
19325	564	53250	167	294	0	54275
19326	52538	1404	138	398	0	54478
19327	1270	570	51668	279	0	53787
19328	547	52025	1077	271	0	53920
19329	478	1177	446	52211	0	54312
19330	374	458	258	54237	0	55327
19331	388	291	195	53536	0	54410
19332	367	182	173	54233	0	54955
19333	284	205	53467	1764	0	55720
19334	53185	155	1152	895	0	55387
19335	1399	156	442	55475	0	57472
19336	56250	155	302	1602	0	58309
19337	58791	172	219	749	0	59931
19338	59717	171	180	583	0	60651
19339	58561	173	201	463	0	59398
19340	2105	199	56434	357	0	59095
19341	935	302	1427	56143	0	58807
19342	538	180	56307	1653	0	58678
19343	392	55654	1678	736	0	58460
19344	732	1625	766	52419	0	55542
19345	515	579	410	54867	0	56371
19346	342	248	246	55198	0	56034
19347	351	182	215	54560	0	55308
19348	261	166	52970	2139	0	55536
19349	360	171	1427	53594	0	55552
19350	373	141	546	54998	0	56058
19351	54249	141	322	2118	0	56830
19352	56592	139	251	1010	0	57992
19353	2198	135	225	56743	0	59301
19354	956	130	218	58145	0	59449
19355	629	140	217	58910	0	59896
19356	57337	150	212	2616	0	60315
19357	59219	141	200	1207	0	60767
19358	57101	166	213	881	0	58361
19359	59039	141	190	659	0	60029
19360	2428	57376	188	524	0	60516
19361	58613	1539	161	588	0	60901
19362	59552	524	163	594	0	60833
19363	2491	300	139	57542	0	60472
19364	1181	259	143	58131	0	59714
19365	56189	200	136	2388	0	58913
19366	2077	54216	149	1045	0	57487
19367	940	56512	135	713	0	58300
19368	57654	1883	171	674	0	60382
19369	2108	700	143	57799	0	60750
19370	1107	380	121	58988	0	60596
19371	792	273	95	59838	0	60998
19372	702	260	100	59531	0	60593
19373	681	248	105	58704	0	59738
19374	530	56160	113	2525	0	59328
19375	558	1581	85	56806	0	59030
19376	56139	574	74	2197	0	58984
19377	1821	340	108	56000	0	58269
19378	848	278	106	56869	0	58101
19379	54957	264	108	2390	0	57719
19380	1798	54683	134	1124	0	57739
19381	909	1830	100	54301	0	57140
19382	576	54519	115	1858	0	57068
19383	550	2151	148	53435	0	56284
19384	543	568	52310	1768	0	55189
19385	49556	454	1274	986	0	52270
19386	1393	50488	418	651	0	52950
19387	48536	1139	199	523	0	50397
19388	1372	433	46758	410	0	48973
19389	705	693	982	44109	0	46489
19390	383	44225	388	1220	0	46216
19391	320	46018	230	648	0	47216
19392	44591	1190	274	498	0	46553
19393	1247	434	139	44923	0	46743
19394	532	215	46321	1242	0	48310
19395	420	178	955	47224	0	48777
19396	296	165	47135	1354	0	48950
19397	45910	153	1034	761	0	47858
19398	1179	155	47656	502	0	49492
19399	623	125	1027	47427	0	49202
19400	385	48476	393	1302	0	50556
19401	399	1000	199	48996	0	50594
19402	317	49005	172	1354	0	50848
19403	50364	1123	132	763	0	52382
19404	1339	444	94	52210	0	54087
19405	655	253	52225	1390	0	54523
19406	504	235	50622	762	0	52123
19407	52107	167	1262	626	0	54162
19408	54919	173	435	571	0	56098
19409	54979	170	194	517	0	55860
19410	54519	147	160	505	0	55331
19411	1645	53147	153	462	0	55407
19412	54548	1075	118	495	0	56236
19413	55054	439	115	470	0	56078
19414	1688	279	52963	424	0	55354
19415	871	241	982	53010	0	55104
19416	54143	204	351	1431	0	56129
19417	1432	224	52488	747	0	54891
19418	748	221	1033	52976	0	54978
19419	504	225	54486	1447	0	56662
19420	544	210	1075	54264	0	56093
19421	461	55189	433	1344	0	57427
19422	56556	1061	220	761	0	58598
19423	1366	494	54633	507	0	57000
19424	55121	300	1017	498	0	56936
19425	1450	247	405	55599	0	57701
19426	56160	196	195	1433	0	57984
19427	1406	204	173	56287	0	58070
19428	59252	240	170	1633	0	61295
19429	1416	281	57073	757	0	59527
19430	60643	246	1022	674	0	62585
19431	1390	212	432	61710	0	63744
19432	722	193	246	62459	0	63620
19433	61156	178	198	1608	0	63140
19434	1302	211	162	61294	0	62969
19435	575	196	59876	1280	0	61927
19436	464	438	841	59211	0	60954
19437	57136	121	384	1159	0	58800
19438	890	55326	227	622	0	57065
19439	431	55757	175	399	0	56762
19440	55421	754	197	335	0	56707
19441	809	57611	140	302	0	58862
19442	588	649	227	56941	0	58405
19443	56981	218	323	813	0	58335
19444	57116	143	82	382	0	57723
19445	56900	134	81	315	0	57430
19446	825	147	56516	188	0	57676
19447	365	377	471	56150	0	57363
19448	218	56744	251	573	0	57786
19449	265	582	161	57526	0	58534
19450	227	237	58758	584	0	59806
19451	229	55981	527	294	0	57031
19452	317	692	175	57141	0	58325
19453	55835	99	180	460	0	56574
19454	342	55821	66	155	0	56384
19455	192	309	57655	83	0	58239
19456	214	116	390	57601	0	58321
19457	134	97	58265	429	0	58925
19458	207	66	454	56886	0	57613
19459	59538	40	191	618	0	60387
19460	521	40	100	59688	0	60349
19461	60222	41	82	612	0	60957
19462	60860	44	88	356	0	61348
19463	601	61628	95	165	0	62489
19464	63458	415	60	229	0	64162
19465	567	62373	84	132	0	63156
19466	259	542	63998	86	0	64885
19467	424	163	514	63355	0	64456
19468	226	96	183	68082	0	68587
19469	165	89	66192	755	0	67201
19470	114	65736	662	333	0	66845
19471	67689	571	198	321	0	68779
19472	69621	178	125	324	0	70248
19473	946	112	84	70750	0	71892
19474	426	71	66	70800	0	71363
19475	270	58	68	72584	0	72980
19476	71701	62	81	1006	0	72850
19477	737	112	69681	352	0	70882
19478	319	116	69772	225	0	70432
19479	301	53	784	72040	0	73178
19480	168	69	71914	759	0	72910
19481	172	116	71525	301	0	72114
19482	268	77	815	69810	0	70970
19483	168	96	73778	757	0	74799
19484	138	73240	768	347	0	74493
19485	257	641	245	75071	0	76214
19486	166	235	76887	804	0	78092
19487	270	143	724	75641	0	76778
19488	150	73332	289	867	0	74638
19489	228	642	190	76494	0	77554
19490	168	218	77477	859	0	78722
19491	284	201	711	74949	0	76145
19492	76909	72	267	1068	0	78316
19493	745	105	76229	316	0	77395
19494	72279	71	713	389	0	73452
19495	799	75684	290	206	0	76979
19496	77509	683	178	319	0	78689
19497	859	399	145	77626	0	79029
19498	286	77017	138	811	0	78252
19499	79997	760	114	473	0	81344
19500	969	319	119	80973	0	82380
19501	331	193	81330	1012	0	82866
19502	170	81518	958	420	0	83066
19503	317	922	378	82923	0	84540
19504	81872	260	201	1212	0	83545
19505	80705	156	140	529	0	81530
19506	1312	103	121	80356	0	81892
19507	466	118	79685	1078	0	81347
19508	75475	102	969	639	0	77185
19509	1077	158	79503	271	0	81009
19510	543	141	1063	79055	0	80802
19511	80874	120	373	1280	0	82647
19512	1076	80122	263	465	0	81926
19513	81694	921	190	526	0	83331
19514	1195	350	79487	278	0	81310
19515	80892	179	1057	384	0	82512
19516	1267	135	420	82507	0	84329
19517	589	110	272	84397	0	85368
19518	388	155	83562	1342	0	85447
19519	409	143	1036	81324	0	82912
19520	83045	112	390	1443	0	84990
19521	1197	104	287	83309	0	84897
19522	486	83412	268	1229	0	85395
19523	412	974	203	84721	0	86310
19524	291	84482	256	1276	0	86305
19525	274	1111	83564	565	0	85514
19526	81194	355	1059	606	0	83214
19527	1235	243	401	85641	0	87520
19528	494	203	82334	1223	0	84254
19529	327	81381	1142	588	0	83438
19530	371	1055	396	81492	0	83314
19531	341	410	277	82541	0	83569
19532	81778	271	239	1644	0	83932
19533	1248	230	234	82919	0	84631
19534	83578	170	229	1669	0	85646
19535	84031	151	247	881	0	85310
19536	1579	83648	280	475	0	85982
19537	85863	1302	181	613	0	87959
19538	1753	412	186	92065	0	94416
19539	718	285	91809	1767	0	94579
19540	92000	185	1531	872	0	94588
19541	1928	166	471	91141	0	93706
19542	774	194	90184	1819	0	92971
19543	87440	196	1922	867	0	90425
19544	1952	211	489	90821	0	93473
19545	724	91826	380	1861	0	94791
19546	680	1603	295	90594	0	93172
19547	471	91651	310	1901	0	94333
19548	91360	1733	280	950	0	94323
19549	1924	558	92214	574	0	95270
19550	679	91409	1697	540	0	94325
19551	670	1775	518	92648	0	95611
19552	452	549	92312	1858	0	95171
19553	442	478	88662	739	0	90321
19554	400	90429	1986	656	0	93471
19555	783	1909	703	90373	0	93768
19556	472	516	443	92466	0	93897
19557	617	408	331	106362	0	107718
19558	109756	291	285	3519	0	113851
19559	3080	337	116166	1104	0	120687
19560	896	117377	3458	769	0	122500
19561	885	3527	924	117639	0	122975
19562	702	903	622	123807	0	126034
19563	411	672	119410	4515	0	125008
19564	791	565	3645	119698	0	124699
19565	384	292	119286	4484	0	124446
19566	434	308	116176	1386	0	118304
19567	471	330	117359	948	0	119108
19568	771	310	4506	111884	0	117471
19569	652	255	1511	116165	0	118583
19570	616	232	836	119602	0	121286
19571	115400	218	557	5030	0	121205
19572	3514	114200	527	1734	0	119975
19573	116525	3535	474	1329	0	121863
19574	115178	941	453	1171	0	117743
19575	119934	607	418	957	0	121916
19576	4657	117936	414	707	0	123714
19577	119741	3592	487	836	0	124656
19578	122385	976	334	794	0	124489
19579	4988	708	349	118233	0	124278
19580	1995	449	356	121596	0	124396
19581	1419	355	364	123754	0	125892
19582	801	411	118429	5246	0	124887
19583	115916	316	3709	2165	0	122106
19584	4290	369	1113	118925	0	124697
19585	116919	315	826	4683	0	122743
19586	4353	115498	654	1712	0	122217
19587	1806	3574	581	117261	0	123222
19588	1279	968	571	121075	0	123893
19589	117300	685	574	5216	0	123775
19590	4394	506	475	117955	0	123330
19591	109406	468	492	5484	0	115850
19592	118141	458	374	2168	0	121141
19593	5022	111669	455	1594	0	118740
19594	1683	116671	494	1120	0	119968
19595	1587	4816	403	112517	0	119323
19596	857	114450	498	4171	0	119976
19597	1152	4362	417	114788	0	120719
19598	847	1209	112991	4655	0	119702
19599	807	969	109802	1656	0	113234
19600	106550	679	4057	1516	0	112802
19601	110514	471	1436	1259	0	113680
19602	4395	107294	900	1090	0	113679
19603	108051	3527	603	1223	0	113404
19604	4221	109693	603	1125	0	115642
19605	1605	3926	629	111201	0	117361
19606	1230	1123	582	114012	0	116947
19607	951	865	590	114428	0	116834
19608	755	568	653	115305	0	117281
19609	110412	421	686	5640	0	117159
19610	3590	110065	732	2799	0	117186
19611	111217	3482	668	1940	0	117307
19612	114281	940	677	1528	0	117426
19613	4928	855	109107	1146	0	116036
19614	108701	653	3451	1292	0	114097
19615	4692	107716	987	1110	0	114505
19616	1986	3805	694	109240	0	115725
19617	1724	1334	502	109330	0	112890
19618	1254	106543	534	4514	0	112845
19619	108958	3882	530	2181	0	115551
19620	4375	1299	106285	1622	0	113581
19621	106590	1004	3671	1706	0	112971
19622	4930	662	106967	1498	0	114057
19623	2177	593	4297	107215	0	114282
19624	1899	775	1593	111067	0	115334
19625	1450	627	1410	112747	0	116234
19626	110026	848	1117	6194	0	118185
19627	4318	820	110075	3134	0	118347
19628	110683	841	3978	3013	0	118515
19629	114842	613	1780	2553	0	119788
19630	114625	604	1441	2545	0	119215
19631	114741	572	1508	2026	0	118847
19632	5898	640	1272	111121	0	118931
19633	2655	633	109039	4776	0	117103
19634	2317	941	3854	108974	0	116086
19635	1911	600	108271	5277	0	116059
19636	1788	827	106177	2646	0	111438
19637	1881	105554	3845	2220	0	113500
19638	2177	3548	1366	97891	0	104982
19639	2106	1300	787	102328	0	106521
19640	2297	1333	596	91917	0	96143
19641	2328	816	499	100790	0	104433
19642	100188	867	477	4668	0	106200
19643	102207	584	459	2210	0	105460
19644	5166	716	398	98993	0	105273
19645	2519	549	96120	4584	0	103772
19646	1892	489	2991	98711	0	104083
19647	1525	418	1023	102304	0	105270
19648	1231	434	97679	5315	0	104659
19649	1613	433	3088	97909	0	103043
19650	97631	577	1104	4870	0	104182
19651	99686	557	672	2463	0	103378
19652	100236	756	441	2177	0	103610
19653	5084	687	299	97281	0	103351
19654	96683	700	324	4381	0	102088
19655	96644	536	426	2263	0	99869
19656	4765	500	92164	1974	0	99403
19657	1588	256	73835	971	0	76650
19658	1231	242	73253	863	0	75589
19659	64622	222	1075	379	0	66298
19660	881	64541	516	309	0	66247
19661	64384	518	503	300	0	65705
19662	768	67956	171	222	0	69117
19663	441	655	176	68429	0	69701
19664	329	193	91	69180	0	69793
19665	306	129	95	69309	0	69839
19666	229	108	68333	891	0	69561
19667	65322	64	645	492	0	66523
19668	815	103	288	68444	0	69650
19669	315	74	68257	662	0	69308
19670	271	90	64448	314	0	65123
19671	65591	77	699	285	0	66652
19672	676	67807	320	242	0	69045
19673	67826	520	267	296	0	68909
19674	67319	177	158	281	0	67935
19675	740	66449	112	168	0	67469
19676	66103	510	103	244	0	66960
19677	710	200	67470	132	0	68512
19678	375	122	64587	116	0	65200
19679	261	112	67587	115	0	68075
19680	305	374	790	67198	0	68667
19681	145	49	68416	490	0	69100
19682	65708	71	546	310	0	66635
19683	67707	26	218	218	0	68169
19684	694	50	68087	90	0	68921
19685	322	63	476	67294	0	68155
19686	68354	17	224	610	0	69205
19687	564	70546	149	233	0	71492
19688	243	72045	103	133	0	72524
19689	72612	572	127	271	0	73582
19690	548	195	72882	69	0	73694
19691	330	430	436	70800	0	71996
19692	180	61	229	71689	0	72159
19693	118	23	76	72873	0	73090
19694	55	71382	91	537	0	72065
19695	415	454	86	67056	0	68011
19696	76538	133	45	701	0	77417
19697	672	70	50	78559	0	79351
19698	243	79126	84	755	0	80208
19699	81728	700	50	440	0	82918
19700	859	270	48	82253	0	83430
19701	405	136	47	85113	0	85701
19702	86275	82	48	1226	0	87631
19703	87036	53	55	551	0	87695
19704	1344	51	41	87344	0	88780
19705	90060	38	43	1251	0	91392
19706	91078	33	47	589	0	91747
19707	1488	91212	57	297	0	93054
19708	92646	1089	25	322	0	94082
19709	1399	91245	86	186	0	92916
19710	737	1192	46	92330	0	94305
19711	402	487	93380	1188	0	95457
19712	492	258	1053	92956	0	94759
19713	419	145	383	94047	0	94994
19714	364	137	172	97413	0	98086
19715	96177	93	114	2015	0	98399
19716	1376	95597	108	865	0	97946
19717	99185	1206	61	687	0	101139
19718	1611	101823	108	363	0	103905
19719	104834	1553	66	586	0	107039
19720	105582	668	84	484	0	106818
19721	106452	344	71	468	0	107335
19722	105682	238	101	478	0	106499
19723	2337	235	103775	330	0	106677
19724	1277	185	1459	104779	0	107700
19725	935	195	499	108572	0	110201
19726	591	257	106640	2301	0	109789
19727	103985	237	1718	1055	0	106995
19728	2266	214	573	106810	0	109863
19729	946	256	105419	2093	0	108714
19730	724	245	104254	842	0	106065
19731	792	179	2245	107482	0	110698
19732	628	197	110236	2129	0	113190
19733	791	183	2131	108659	0	111764
19734	769	149	818	109813	0	111549
19735	537	183	107197	2629	0	110546
19736	103594	172	2005	1329	0	107100
19737	2374	207	771	107943	0	111295
19738	1040	222	108574	2316	0	112152
19739	945	150	2051	109275	0	112421
19740	109840	117	851	2729	0	113537
19741	2273	133	108751	1133	0	112290
19742	106409	123	2107	1092	0	109731
19743	112468	110	877	959	0	114414
19744	2947	125	628	111500	0	115200
19745	1482	156	465	111280	0	113383
19746	919	252	109706	2811	0	113688
19747	901	176	2112	110281	0	113470
19748	1207	246	944	101719	0	104116
19749	790	147	638	112654	0	114229
19750	576	173	108694	3181	0	112624
19751	106107	115	2124	1854	0	110200
19752	110600	131	960	1406	0	113097
19753	112695	127	689	1203	0	114714
19754	115017	168	519	1122	0	116826
19755	3414	213	418	114083	0	118128
19756	113506	224	479	2823	0	117032
19757	114494	230	468	1551	0	116743
19758	94175	545	732	2124	0	97576
19759	113810	161	500	1236	0	115707
19760	3208	111341	514	1041	0	116104
19761	113935	1783	509	1122	0	117349
19762	112448	562	505	1079	0	114594
19763	3359	110513	522	940	0	115334
19764	112672	2157	425	1028	0	116282
19765	3473	712	485	112279	0	116949
19766	1850	458	409	114075	0	116792
19767	111997	302	428	3490	0	116217
19768	3124	108600	531	1545	0	113800
19769	1603	110506	521	1121	0	113751
19770	1454	2559	470	111971	0	116454
19771	1194	894	111711	2768	0	116567
19772	1244	564	2298	109987	0	114093
19773	1192	347	916	113869	0	116324
19774	111578	338	653	3518	0	116087
19775	112763	289	540	1720	0	115312
19776	3516	245	459	111660	0	115880
19777	1638	330	109276	3073	0	114317
19778	1409	300	2445	111165	0	115319
19779	112547	255	981	3370	0	117153
19780	3225	325	115360	1582	0	120492
19781	1569	115903	2923	1263	0	121658
19782	120146	2498	1111	1330	0	125085
19783	3616	751	739	120420	0	125526
19784	1744	486	590	121600	0	124420
19785	1469	354	544	124158	0	126525
19786	1175	305	118654	4337	0	124471
19787	109825	277	2811	2384	0	115297
19788	3520	265	114206	1546	0	119537
19789	1681	112415	3194	1304	0	118594
19790	1576	2447	1228	115154	0	120405
19791	1444	845	818	118062	0	121169
19792	1446	642	736	122171	0	124995
19793	1173	410	118405	4803	0	124791
19794	1103	326	116722	2359	0	120510
19795	1005	319	119074	1681	0	122079
19796	876	117626	3912	1408	0	123822
19797	1504	3069	1870	117885	0	124328
19798	119529	818	1087	3883	0	125317
19799	125655	540	837	1724	0	128756
19800	4713	464	127994	1227	0	134398
19801	1958	128852	3762	1221	0	135793
19802	1464	3535	128016	1031	0	134046
19803	1085	132716	3892	1061	0	138754
19804	127805	4620	2225	1387	0	136037
19805	128474	1406	1100	1073	0	132053
19806	4681	126143	803	847	0	132474
19807	127205	3789	596	909	0	132499
19808	4837	1275	664	125383	0	132159
19809	2256	881	557	129045	0	132739
19810	127313	634	577	4760	0	133284
19811	125403	638	462	2003	0	128506
19812	125641	512	385	1582	0	128120
19813	5339	119343	517	1235	0	126434
19814	2261	126382	440	1091	0	130174
19815	125785	4131	429	1202	0	131547
19816	4664	1540	123435	865	0	130504
19817	2309	1965	3462	119880	0	127616
19818	117787	889	1315	3870	0	123861
19819	4376	113054	810	1447	0	119687
19820	1901	119812	622	1010	0	123345
19821	119419	4194	636	1034	0	125283
19822	4402	1653	115624	748	0	122427
19823	113332	1403	3465	818	0	119018
19824	4369	886	112045	594	0	117894
19825	1901	754	112066	537	0	115258
19826	1723	857	3999	110695	0	117274
19827	1268	676	114154	3142	0	119240
19828	111598	638	3663	1364	0	117263
19829	115468	486	1621	1072	0	118647
19830	117259	501	1088	917	0	119765
19831	117106	463	856	786	0	119211
19832	5089	468	765	111480	0	117802
19833	112802	451	716	3432	0	117401
19834	4371	110077	631	1378	0	116457
19835	2445	3010	603	108780	0	114838
19836	1742	112494	587	3122	0	117945
19837	117419	3344	508	1511	0	122782
19838	118293	1309	510	1202	0	121314
19839	4816	939	475	115721	0	121951
19840	117582	733	542	3674	0	122531
19841	119703	682	590	1595	0	122570
19842	5001	743	521	116460	0	122725
19843	2661	612	525	117702	0	121500
19844	2097	683	499	119832	0	123111
19845	1766	605	114219	4558	0	121148
19846	1635	562	110004	2125	0	114326
19847	1459	579	114060	1521	0	117619
19848	1560	558	4237	114854	0	121209
19849	1339	599	117244	3774	0	122956
19850	1452	584	3955	116496	0	122487
19851	1392	545	123066	4195	0	129198
19852	1392	528	119597	2058	0	123575
19853	116989	518	4485	1779	0	123771
19854	3794	118371	2144	1298	0	125607
19855	121947	3191	1585	1260	0	127983
19856	4257	1282	1285	120656	0	127480
19857	2294	864	1113	123038	0	127309
19858	1731	750	121058	4383	0	127922
19859	1468	120302	3494	2159	0	127423
19860	1570	3318	1482	124061	0	130431
19861	1413	1325	123976	3789	0	130503
19862	1256	121596	3341	1740	0	127933
19863	1488	3133	1616	122324	0	128561
19864	121462	1270	1285	3744	0	127761
19865	122605	930	1014	1871	0	126420
19866	4168	812	944	121634	0	127558
19867	122001	756	836	3718	0	127311
19868	3993	121001	926	1746	0	127666
19869	2217	2961	839	123978	0	129995
19870	1806	1334	124737	3472	0	131349
19871	1781	1018	3116	125924	0	131839
19872	1590	844	125741	3905	0	132080
19873	124186	757	3478	2047	0	130468
19874	4116	734	1471	127288	0	133609
19875	2079	126894	1144	3755	0	133872
19876	1934	3591	925	132306	0	138756
19877	1566	1207	130244	4128	0	137145
19878	1473	917	127421	2091	0	131902
19879	1355	842	126309	1554	0	130060
19880	119870	1053	4276	1338	0	126537
19881	3100	121623	1933	1048	0	127704
19882	1565	2508	1215	121816	0	127104
19883	121860	1070	1060	3066	0	127056
19884	2923	121391	950	1571	0	126835
19885	126954	2586	867	1553	0	131960
19886	128894	1168	854	1197	0	132113
19887	130337	808	793	1186	0	133124
19888	132732	593	817	930	0	135072
19889	4192	674	126683	791	0	132340
19890	125318	443	2649	1019	0	129429
19891	3708	439	124256	843	0	129246
19892	118693	387	2579	861	0	122520
19893	3347	559	1353	123268	0	128527
19894	1896	300	121382	2079	0	125657
19895	1371	118683	2182	1101	0	123337
19896	1797	4987	1396	113659	0	121839
19897	1086	116732	868	1830	0	120516
19898	916	118524	666	1204	0	121310
19899	109679	1626	983	961	0	113249
19900	1554	527	106635	427	0	109143
19901	517	103217	971	320	0	105025
19902	101731	874	830	442	0	103877
19903	806	102260	289	196	0	103551
19904	103555	670	185	322	0	104732
19905	940	328	143	102863	0	104274
19906	103911	177	131	798	0	105017
19907	882	125	139	102741	0	103887
19908	103402	126	117	876	0	104521
19909	850	136	133	103027	0	104146
19910	381	104960	158	786	0	106285
19911	352	656	137	108248	0	109393
19912	108101	255	113	971	0	109440
19913	715	106459	145	357	0	107676
19914	407	692	113	107392	0	108604
19915	108459	272	99	947	0	109777
19916	829	198	104	108934	0	110065
19917	477	156	111	108602	0	109346
19918	312	197	109366	898	0	110773
19919	301	194	105637	423	0	106555
19920	370	187	805	106227	0	107589
19921	243	186	111837	762	0	113028
19922	315	139	749	111007	0	112210
19923	648	211	364	99627	0	100850
19924	311	130	176	112510	0	113127
19925	228	184	112049	982	0	113443
19926	419	149	657	106792	0	108017
19927	278	139	264	110169	0	110850
19928	215	110974	219	936	0	112344
19929	250	643	143	113373	0	114409
19930	112645	256	159	1136	0	114196
19931	847	177	176	114280	0	115480
19932	364	175	127250	1034	0	128823
19933	121484	143	1554	865	0	124046
19934	1699	134029	848	480	0	137056
19935	1189	1783	550	137724	0	141246
19936	755	905	135815	2003	0	139478
19937	128296	617	1934	1390	0	132237
19938	2010	134482	998	881	0	138371
19939	136747	1969	698	748	0	140162
19940	2755	996	379	135731	0	139861
19941	135844	688	290	2320	0	139142
19942	2763	418	134375	1084	0	138640
19943	1387	131754	1937	936	0	136014
19944	948	144025	971	565	0	146509
19945	145311	2554	769	915	0	149549
19946	145979	1312	405	680	0	148376
19947	2931	909	143955	276	0	148071
19948	141944	452	1965	528	0	144889
19949	146114	301	952	567	0	147934
19950	146722	245	715	579	0	148261
19951	3499	138188	446	307	0	142440
19952	1946	141283	308	295	0	143832
19953	142042	2580	255	593	0	145470
19954	143539	1400	217	550	0	145706
19955	2926	143693	228	251	0	147098
19956	1900	2226	143	145254	0	149523
19957	1148	1182	144674	1910	0	148914
19958	142407	767	1930	1401	0	146505
19959	136361	686	1185	1870	0	140102
19960	151496	340	758	904	0	153498
19961	3225	147636	445	852	0	152158
19962	1873	2031	149604	345	0	153853
19963	153612	1028	1982	639	0	157261
19964	2790	787	938	155592	0	160107
19965	1712	491	694	155874	0	158771
19966	1409	345	391	160509	0	162654
19967	819	368	157397	3356	0	161940
19968	1028	280	1950	154237	0	157495
19969	591	331	156934	2949	0	160805
19970	392	152636	2278	1497	0	156803
19971	150957	1877	1142	1260	0	155236
19972	1926	150271	803	569	0	153569
19973	1072	152986	491	424	0	154973
19974	152662	2640	500	724	0	156526
19975	2095	154448	335	319	0	157197
19976	1331	2477	215	152736	0	156759
19977	968	151590	219	1684	0	154461
19978	152205	2383	185	1144	0	155917
19979	2096	152194	196	655	0	155141
19980	1366	2502	138	154504	0	158510
19981	981	1364	152375	1964	0	156684
19982	800	967	1841	153891	0	157499
19983	485	152519	1027	3180	0	157211
19984	603	2203	726	157711	0	161243
19985	590	1302	395	155504	0	157791
19986	856	915	354	149847	0	151972
19987	675	452	302	158034	0	159463
19988	653	436	294	158891	0	160274
19989	654	404	274	160814	0	162146
19990	560	452	157035	4443	0	162490
19991	153222	381	2632	2783	0	159018
19992	3051	348	1279	168135	0	172813
19993	1602	410	166971	3805	0	172788
19994	1264	586	165963	2136	0	169949
19995	1082	439	4315	170908	0	176744
19996	172504	465	2559	4274	0	179802
19997	3639	618	168618	2121	0	174996
19998	166718	506	3857	2235	0	173316
19999	4589	562	174683	1145	0	180979
20000	2919	537	4336	174865	0	182657
20001	2388	581	2119	181254	0	186342
20002	1549	715	178038	4690	0	184992
20003	169834	581	3943	3185	0	177543
20004	4257	633	2064	177377	0	184331
20005	2392	569	176876	4243	0	184080
20006	2061	653	175880	2429	0	181023
20007	1909	574	4887	171046	0	178416
20008	1392	177276	3003	3608	0	185279
20009	181307	3263	2073	2525	0	189168
20010	180224	1669	1435	2176	0	185504
20011	5336	1477	179487	1247	0	187547
20012	3704	1025	3856	174445	0	183030
20013	181187	836	1992	4571	0	188586
20014	4803	769	179043	2434	0	187049
20015	175629	518	4166	2456	0	182769
20016	5248	173465	2448	1649	0	182810
20017	3131	3315	1928	182579	0	190953
20018	2603	1607	1425	185140	0	190775
20019	187145	1230	1209	5876	0	195460
20020	4874	888	1138	188439	0	195339
20021	2871	771	1011	187680	0	192333
20022	2468	652	843	190545	0	194508
20023	184820	462	918	7615	0	193815
20024	4636	609	181871	4315	0	191431
20025	181526	509	4051	3612	0	189698
20026	185176	468	2224	2898	0	190766
20027	189116	454	1893	2333	0	193796
20028	7329	737	1311	183890	0	193267
20029	4225	725	184474	4871	0	194295
20030	2866	178665	4520	2963	0	189014
20031	2116	183213	2287	2698	0	190314
20032	1434	175975	1373	1615	0	180397
20033	1570	4114	175205	1437	0	182326
20034	1877	2882	3732	191748	0	200239
20035	197618	1119	1801	5888	0	206426
20036	214674	706	1177	3368	0	219925
20037	8039	607	796	222434	0	231876
20038	4282	558	219769	6859	0	231468
20039	3123	505	219874	3382	0	226884
20040	2393	370	7578	222672	0	233013
20041	1535	453	225665	7182	0	234835
20042	1873	388	7737	225303	0	235301
20043	1919	383	3756	220904	0	226962
20044	1097	218348	2934	9063	0	231442
20045	1791	5646	1987	226345	0	235769
20046	1738	2438	1483	234091	0	239750
20047	226479	1898	1457	10929	0	240763
20048	7406	1061	1391	230221	0	240079
20049	3977	740	1273	233954	0	239944
20050	224285	607	1432	11314	0	237638
20051	7399	222036	1669	6366	0	237470
20052	226755	5929	1430	5072	0	239186
20053	8814	2825	220594	3427	0	235660
20054	221696	2051	6843	3445	0	234035
20055	224763	1287	3636	3385	0	233071
20056	10440	1068	215768	2543	0	229819
20057	5961	1028	215261	2476	0	224726
20058	5152	1119	9335	207204	0	222810
20059	210897	639	5396	8384	0	225316
20060	8388	738	207248	4509	0	220883
20061	5227	584	8337	206400	0	220548
20062	3766	704	205588	8765	0	218823
20063	3450	654	9109	203728	0	216941
20064	3157	635	4810	209765	0	218367
20065	203166	613	3822	11570	0	219171
20066	201786	666	2892	7470	0	212814
20067	210000	763	2311	5837	0	218911
20068	11784	737	203828	4112	0	220461
20069	6620	800	205140	3745	0	216305
20070	5502	794	9338	204024	0	219658
20071	4352	921	5507	208487	0	219267
20072	3921	854	4058	213665	0	222498
20073	201937	745	3105	12426	0	218213
20074	8218	200413	2892	7488	0	219011
20075	199145	6077	2488	6210	0	213920
20076	197972	2799	2213	4951	0	207935
20077	10847	192052	2286	3868	0	209053
20078	6753	200472	2192	3552	0	212969
20079	198139	8216	2251	3973	0	212579
20080	9306	4222	2178	193119	0	208825
20081	5764	191222	2159	9731	0	208876
20082	6443	6824	1819	196992	0	212078
20083	5284	3585	190164	10722	0	209755
20084	4560	2771	7341	194401	0	209073
20085	191406	1790	5253	11870	0	210319
20086	8729	1550	188774	7163	0	206216
20087	5573	1436	187995	6417	0	201421
20088	5343	4460	10607	175945	0	196355
20089	4062	171803	6711	9723	0	192299
20090	3402	176142	4464	7275	0	191283
20091	3064	183911	3246	6912	0	197133
20092	175576	8412	2776	6033	0	192797
20093	176812	4093	2139	6090	0	189134
20094	171282	2726	2029	5916	0	181953
20095	10414	168616	2158	5458	0	186646
20096	174519	5459	2130	5547	0	187655
20097	173576	3234	2133	4990	0	183933
20098	10726	3281	166230	3682	0	183919
20099	7534	161192	6914	3300	0	178940
20100	6373	6255	4823	163522	0	180973
20101	163633	3527	4232	7525	0	178917
20102	9493	2660	160103	5200	0	177456
20103	6194	1756	7629	157886	0	173465
20104	5095	157434	5372	8677	0	176578
20105	4635	5520	4090	161466	0	175711
20106	4689	2970	3366	164157	0	175182
20107	160697	2312	3609	10975	0	177593
20108	162706	1850	3422	8030	0	176008
20109	9890	1680	3528	161584	0	176682
20110	6418	1958	156229	9817	0	174422
20111	5589	2017	154239	7063	0	168908
20112	157717	1719	7942	6141	0	173519
20113	10627	1708	158619	4102	0	175056
20114	8008	1967	8023	146239	0	164237
20115	6396	149969	5627	6981	0	168973
20116	152341	5290	5412	5059	0	168102
20117	8117	151043	4239	5355	0	168754
20118	154738	6376	3222	5986	0	170322
20119	9285	3335	2963	153126	0	168709
20120	6550	2839	2637	156498	0	168524
20121	153523	2886	2351	9977	0	168737
20122	157681	2451	2443	6085	0	168660
20123	11386	2550	2309	153045	0	169290
20124	8047	3029	2030	154942	0	168048
20125	6289	3040	147201	8774	0	165304
20126	5179	2721	146070	6073	0	160043
20127	145670	2402	7413	5760	0	161245
20128	7756	2747	139540	4904	0	154947
20129	142969	2090	7238	5214	0	157511
20130	146567	1534	5152	5255	0	158508
20131	9748	1675	138733	4783	0	154939
20132	6852	130221	6670	4147	0	147890
20133	6030	135349	4832	3162	0	149373
20134	2996	3396	112396	1592	0	120380
20135	4698	7968	5593	95003	0	113262
20136	88860	1827	3105	4025	0	97817
20137	86321	457	524	1188	0	88490
20138	94836	332	425	1029	0	96622
20139	110859	315	352	956	0	112482
20140	113323	313	367	895	0	114898
20141	4385	112950	533	617	0	118485
20142	111550	3051	393	757	0	115751
20143	3753	110367	441	376	0	114937
20144	108995	3163	407	457	0	113022
20145	3771	897	104566	202	0	109436
20146	1796	425	2732	101789	0	106742
20147	1308	339	701	100585	0	102933
20148	698	101571	400	3122	0	105791
20149	102520	2952	250	1140	0	106862
20150	104962	1028	180	633	0	106803
20151	4196	601	188	101369	0	106354
20152	1753	355	320	103892	0	106320
20153	102074	234	276	3975	0	106559
20154	3502	244	214	102369	0	106329
20155	1425	351	158	104613	0	106547
20156	102442	325	160	4028	0	106955
20157	3862	240	116	102373	0	106591
20158	102291	208	160	3914	0	106573
20159	103676	137	124	1825	0	105762
20160	4141	183	99965	969	0	105258
20161	101327	159	2656	1515	0	105657
20162	103027	131	692	1039	0	104889
20163	103470	146	396	898	0	104910
20164	4396	208	96971	747	0	102322
20165	2161	192	2723	96609	0	101685
20166	1633	174	797	100257	0	102861
20167	1083	208	96121	3659	0	101071
20168	94975	150	2952	1393	0	99470
20169	4065	136	909	94198	0	99308
20170	1762	180	92438	3214	0	97594
20171	1277	200	95050	1129	0	97656
20172	1146	138	3547	94859	0	99690
20173	812	213	95989	3631	0	100645
20174	1034	171	3405	95669	0	100279
20175	1196	145	1138	98454	0	100933
20176	922	215	94963	4221	0	100321
20177	1016	200	3319	92786	0	97321
20178	778	90264	1336	3612	0	95990
20179	636	97581	946	1573	0	100736
20180	94871	3446	829	1230	0	100376
20181	96141	998	618	1295	0	99052
20182	3888	94483	563	1168	0	100102
20183	95227	3042	606	1131	0	100006
20184	97586	931	484	1066	0	100067
20185	4522	737	430	94633	0	100322
20186	1993	710	394	97602	0	100699
20187	94274	580	290	4355	0	99499
20188	4101	91418	389	1656	0	97564
20189	1847	94986	416	1121	0	98370
20190	1871	3654	364	93951	0	99840
20191	1613	1243	93059	3669	0	99584
20192	91600	696	3093	1880	0	97269
20193	95345	465	952	1596	0	98358
20194	92928	524	566	1415	0	95433
20195	4870	91390	529	962	0	97751
20196	2402	3442	442	90984	0	97270
20197	1893	1184	455	95060	0	98592
20198	91784	762	622	4662	0	97830
20199	4499	90835	548	1965	0	97847
20200	2699	3286	485	91008	0	97478
20201	2415	1225	476	93957	0	98073
20202	2257	1000	367	94100	0	97724
20203	91011	825	396	5188	0	97420
20204	4657	90010	504	2477	0	97648
20205	2718	4104	440	87431	0	94693
20206	2138	90318	549	4026	0	97031
20207	90052	3801	584	2365	0	96802
20208	4665	1301	87693	2045	0	95704
20209	87876	951	3445	2238	0	94510
20210	4639	812	85393	2117	0	92961
20211	2618	1745	3335	82404	0	90102
20212	82906	820	1191	4283	0	89200
20213	4489	789	80816	2128	0	88222
20214	82199	587	3169	1921	0	87876
20215	84820	404	1333	2043	0	88600
20216	85843	367	944	1824	0	88978
20217	5198	343	941	81227	0	87709
20218	2613	332	818	82999	0	86762
20219	2384	291	709	84172	0	87556
20220	80161	253	832	5038	0	86284
20221	4459	79816	836	2426	0	87537
20222	81913	2574	815	1658	0	86960
20223	84381	778	897	1414	0	87470
20224	5024	569	79539	1416	0	86548
20225	81281	455	3005	1618	0	86359
20226	84711	386	1273	1670	0	88040
20227	4821	403	1081	81881	0	88186
20228	2417	522	1007	83340	0	87286
20229	2105	512	845	84064	0	87526
20230	80489	467	953	4485	0	86394
20231	80965	365	1032	2160	0	84522
20232	78387	328	936	1741	0	81392
20233	4180	71773	980	1611	0	78544
20234	1634	68643	956	1404	0	72637
20235	1130	70767	754	1668	0	74319
20236	68852	2793	1360	1877	0	74882
20237	3207	930	66988	1668	0	72793
20238	1476	657	57058	1383	0	60574
20239	40197	336	1342	498	0	42373
20240	1040	112	41860	295	0	43307
20241	189	64	359	35262	0	35874
20242	134	34461	125	371	0	35091
20243	37140	383	120	195	0	37838
20244	37275	77	42	123	0	37517
20245	37367	63	34	97	0	37561
20246	535	50	33	39730	0	40348
20247	174	66	40520	345	0	41105
20248	183	83	38590	99	0	38955
20249	40297	54	381	162	0	40894
20250	41380	44	115	112	0	41651
20251	41040	24	89	110	0	41263
20252	484	32	60	41146	0	41722
20253	232	33	37	41332	0	41634
20254	150	70	40869	377	0	41466
20255	40731	42	309	228	0	41310
20256	405	46	69	42747	0	43267
20257	183	35	62	42665	0	42945
20258	154	41	40	42738	0	42973
20259	110	42326	61	429	0	42926
20260	100	326	49	42896	0	43371
20261	128	62	54	42891	0	43135
20262	42667	55	50	481	0	43253
20263	430	65	41577	128	0	42200
20264	40790	37	317	163	0	41307
20265	42889	37	70	161	0	43157
20266	463	27	64	42471	0	43025
20267	192	48	55	42587	0	42882
20268	42433	22	59	456	0	42970
20269	441	48	41287	146	0	41922
20270	138	41305	329	151	0	41923
20271	150	283	83	41403	0	41919
20272	41210	55	98	373	0	41736
20273	347	52	52	40396	0	40847
20274	126	41	39987	349	0	40503
20275	150	62	39191	134	0	39537
20276	40391	36	301	209	0	40937
20277	366	79	95	42323	0	42863
20278	130	35	41735	266	0	42166
20279	41292	23	206	235	0	41756
20280	44414	20	70	252	0	44756
20281	285	22	44	44561	0	44912
20282	148	13	37	44445	0	44643
20283	104	44149	59	239	0	44551
20284	46337	171	30	251	0	46789
20285	266	40	18	46657	0	46981
20286	131	37	25	47228	0	47421
20287	103	42	47611	218	0	47974
20288	44566	17	180	263	0	45026
20289	46853	15	55	184	0	47107
20290	226	45817	67	105	0	46215
20291	104	158	44888	57	0	45207
20292	83	53	44372	48	0	44556
20293	155	259	146	43758	0	44318
20294	45991	75	186	292	0	46544
20295	149	26	30	46027	0	46232
20296	47798	16	21	313	0	48148
20297	47863	18	15	196	0	48092
20298	48360	19	30	187	0	48596
20299	195	12	23	48676	0	48906
20300	141	19	30	48835	0	49025
20301	50151	8	19	260	0	50438
20302	160	31	50850	53	0	51094
20303	47649	9	65	197	0	47920
20304	48746	13	31	153	0	48943
20305	119	15	50034	17	0	50185
20306	66	40	48628	20	0	48754
20307	41	49645	106	33	0	49825
20308	100	106	71	50770	0	51047
20309	48694	30	83	207	0	49014
20310	108	16	11	50882	0	51017
20311	39	34	51389	77	0	51539
20312	31	49890	83	45	0	50049
20313	23	50416	46	46	0	50531
20314	35	78	19	52155	0	52287
20315	60	28	6	51257	0	51351
20316	21	50593	30	122	0	50766
20317	42	105	50457	37	0	50641
20318	48510	28	103	175	0	48816
20319	52353	14	27	157	0	52551
20320	115	52351	40	50	0	52556
20321	51634	111	5	127	0	51877
20322	149	85	10	51144	0	51388
20323	51148	18	13	255	0	51434
20324	177	9	9	50908	0	51103
20325	48	52535	31	174	0	52788
20326	80	233	52472	57	0	52842
20327	110	52	231	55838	0	56231
20328	212	36	58	53985	0	54291
20329	80	13	22	59373	0	59488
20330	60601	17	11	793	0	61422
20331	733	10	22	61143	0	61908
20332	242	46	64423	739	0	65450
20333	170	85	65536	245	0	66036
20334	68192	20	1179	306	0	69697
20335	1141	60	69840	66	0	71107
20336	70490	11	1209	197	0	71907
20337	1433	28	299	76274	0	78034
20338	563	19	180	78763	0	79525
20339	398	23	111	83592	0	84124
20340	323	16	101	83629	0	84069
20341	82788	11	79	2485	0	85363
20342	1823	59	83333	789	0	86004
20343	748	29	1743	81998	0	84518
20344	308	84764	525	1837	0	87434
20345	85990	1759	256	749	0	88754
20346	2118	409	159	83728	0	86414
20347	83430	208	112	2259	0	86009
20348	2207	169	82428	676	0	85480
20349	879	85	1873	79945	0	82782
20350	370	81924	564	1946	0	84804
20351	83237	1820	298	856	0	86211
20352	2145	510	82482	514	0	85651
20353	937	256	1986	81269	0	84448
20354	636	147	547	84419	0	85749
20355	82441	142	365	2688	0	85636
20356	2178	140	81555	959	0	84832
20357	735	150	82628	656	0	84169
20358	743	121	2402	82075	0	85341
20359	462	118	82146	2179	0	84905
20360	347	124	83047	857	0	84375
20361	544	128	2594	81602	0	84868
20362	605	120	928	83687	0	85340
20363	547	86	633	87015	0	88281
20364	84504	69	477	3125	0	88175
20365	2148	85033	441	1332	0	88954
20366	86479	1987	392	1023	0	89881
20367	2651	544	378	85590	0	89163
20368	855	85826	419	2566	0	89666
20369	799	2063	322	89046	0	92230
20370	89840	607	368	3153	0	93968
20371	2456	93216	410	1311	0	97393
20372	1121	2501	352	96984	0	100958
20373	739	793	96598	3098	0	101228
20374	96487	465	2669	1533	0	101154
20375	3072	337	885	97133	0	101427
20376	1341	326	621	99184	0	101472
20377	927	306	95394	3818	0	100445
20378	718	315	95386	1764	0	98183
20379	92992	294	3285	1513	0	98084
20380	3029	92188	1370	1086	0	97673
20381	1340	2641	900	93572	0	98453
20382	93866	876	707	3350	0	98799
20383	3200	618	93222	1482	0	98522
20384	1254	91977	3020	1285	0	97536
20385	1105	2737	1216	92741	0	97799
20386	93124	875	886	3695	0	98580
20387	91675	597	711	1964	0	94947
20388	94472	378	706	1522	0	97078
20389	3852	90463	736	1584	0	96635
20390	1704	2713	91196	1161	0	96774
20391	1429	938	2951	92630	0	97948
20392	1570	768	1401	85521	0	89260
20393	1096	481	899	95371	0	97847
20394	1017	468	806	95554	0	97845
20395	92105	423	793	4637	0	97958
20396	92330	454	676	2360	0	95820
20397	3980	469	88775	1704	0	94928
20398	1834	441	88386	1501	0	92162
20399	87380	333	3550	1560	0	92823
20400	90155	421	1496	1380	0	93452
20401	4146	458	1126	85957	0	91687
20402	1857	85955	1002	3542	0	92356
20403	86464	2804	823	1953	0	92044
20404	3571	84041	791	1601	0	90004
20405	1630	85657	761	1465	0	89513
20406	1493	3423	732	87221	0	92869
20407	1323	1344	663	89566	0	92896
20408	1194	884	723	89614	0	92415
20409	1077	681	797	89964	0	92519
20410	1039	632	84940	4636	0	91247
20411	84166	602	2994	2292	0	90054
20412	87538	571	1232	1849	0	91190
20413	4052	580	931	84877	0	90440
20414	2018	591	762	86629	0	90000
20415	84771	541	719	4362	0	90393
20416	3684	612	79022	2248	0	85566
20417	84076	569	2767	1788	0	89200
20418	86043	547	1216	1646	0	89452
20419	4127	526	82310	1480	0	88443
20420	85279	551	3073	1576	0	90479
20421	4079	465	1296	85844	0	91684
20422	1975	433	1048	88141	0	91597
20423	1765	387	868	88219	0	91239
20424	1600	417	734	88097	0	90848
20425	82931	408	651	4577	0	88567
20426	3694	409	739	82378	0	87220
20427	1572	359	608	78992	0	81531
20428	1203	72005	620	3883	0	77711
20429	1022	75111	571	2011	0	78715
20430	1130	2463	502	73907	0	78002
20431	72876	862	426	3141	0	77305
20432	2932	701	394	68517	0	72544
20433	1105	418	63596	2609	0	67728
20434	973	384	59821	1215	0	62393
20435	59609	323	2044	1175	0	63151
20436	2101	59894	862	890	0	63747
20437	54648	1331	894	701	0	57574
20438	1896	452	54025	544	0	56917
20439	1258	1868	1361	48486	0	52973
20440	48485	203	647	1255	0	50590
20441	1150	47829	340	528	0	49847
20442	47193	889	314	492	0	48888
20443	1295	289	49776	357	0	51717
20444	603	344	828	48845	0	50620
20445	501	179	368	50170	0	51218
20446	50595	172	363	1269	0	52399
20447	51055	125	243	639	0	52062
20448	52562	121	167	516	0	53366
20449	52698	136	111	472	0	53417
20450	53082	126	97	471	0	53776
20451	1289	52131	135	339	0	53894
20452	660	740	135	53594	0	55129
20453	54526	258	127	1088	0	55999
20454	1121	212	90	54326	0	55749
20455	608	125	98	54636	0	55467
20456	538	117	101	54908	0	55664
20457	389	52810	127	1210	0	54536
20458	53860	738	101	692	0	55391
20459	930	313	133	53780	0	55156
20460	52634	178	133	1157	0	54102
20461	52232	108	90	649	0	53079
20462	1074	50745	96	501	0	52416
20463	51377	657	81	466	0	52581
20464	1107	237	49769	277	0	51390
20465	49346	190	759	279	0	50574
20466	1076	547	567	49183	0	51373
20467	526	128	50578	683	0	51915
20468	450	50149	602	350	0	51551
20469	516	556	50088	310	0	51470
20470	207	47589	483	187	0	48466
20471	43971	721	673	462	0	45827
20472	43620	107	165	285	0	44177
20473	43421	40	38	163	0	43662
20474	239	42824	42	171	0	43276
20475	42958	141	27	162	0	43288
20476	214	58	42580	23	0	42875
20477	95	86	42568	31	0	42780
20478	167	188	163	42587	0	43105
20479	91	68	113	44758	0	45030
20480	26	44471	44	188	0	44729
20481	45609	151	13	182	0	45955
20482	221	58	18	46043	0	46340
20483	57	45604	40	215	0	45916
20484	81	215	9	47623	0	47928
20485	47461	65	14	398	0	47938
20486	46500	45	6	255	0	46806
20487	323	34	44875	64	0	45296
20488	190	32	218	45750	0	46190
20489	83	49	45664	254	0	46050
20490	102	25	263	46111	0	46501
20491	62	42	46393	303	0	46800
20492	88	29	309	46209	0	46635
20493	53	43	46786	332	0	47214
20494	96	20	314	46490	0	46920
20495	65	44	47683	355	0	48147
20496	137	20	323	47295	0	47775
20497	95	23	102	48641	0	48861
20498	45	49088	122	383	0	49638
20499	73	283	37	51375	0	51768
20500	57	118	50373	391	0	50939
20501	124	63	317	50023	0	50527
20502	84	21	121	50617	0	50843
20503	50548	20	88	611	0	51267
20504	348	25	46	51336	0	51755
20505	167	27	53	50969	0	51216
20506	97	57	49391	465	0	50010
20507	48740	19	323	419	0	49501
20508	367	19	117	51360	0	51863
20509	170	24	94	51597	0	51885
20510	127	11	42	52148	0	52328
20511	51794	21	66	722	0	52603
20512	381	21	48	52573	0	53023
20513	158	14	46	52779	0	52997
20514	52089	17	50	748	0	52904
20515	351	51967	67	312	0	52697
20516	159	314	46	51905	0	52424
20517	134	108	31	52512	0	52785
20518	70	85	51017	551	0	51723
20519	46159	33	409	490	0	47091
20520	426	44	128	50618	0	51216
20521	153	63	48979	472	0	49667
20522	49345	19	369	465	0	50198
20523	445	31	141	51871	0	52488
20524	236	23	90	52777	0	53126
20525	177	21	47	53478	0	53723
20526	128	31	49	54195	0	54403
20527	86	57	56810	750	0	57703
20528	167	32	608	57440	0	58247
20529	240	27	193	68241	0	68701
20530	114	78	76842	1505	0	78539
20531	79635	20	1744	843	0	82242
20532	83946	19	692	766	0	85423
20533	84969	20	647	423	0	86059
20534	3510	29	388	82832	0	86759
20535	84646	17	238	2292	0	87193
20536	86585	16	126	1136	0	87863
20537	3611	26	93	85261	0	88991
20538	85479	25	92	2781	0	88377
20539	86339	18	91	1459	0	87907
20540	86674	21	82	1182	0	87959
20541	87659	19	104	856	0	88638
20542	4047	27	107	83713	0	87894
20543	2240	79301	135	2252	0	83928
20544	1627	80746	196	986	0	83555
20545	1135	82821	182	861	0	84999
20546	80137	3214	140	852	0	84343
20547	83122	1643	87	622	0	85474
20548	3236	1246	79361	461	0	84304
20549	82146	698	2056	530	0	85430
20550	3739	412	795	82687	0	87633
20551	2113	183	658	83740	0	86694
20552	1729	130	446	85077	0	87382
20553	82486	85	286	3985	0	86842
20554	3051	103	138	82907	0	86199
20555	1418	80316	139	3586	0	85459
20556	1319	2125	75	83294	0	86813
20557	888	986	83230	3372	0	88476
20558	860	872	2079	84753	0	88564
20559	84594	690	854	3508	0	89646
20560	3092	507	83813	1559	0	88971
20561	1648	217	2437	85214	0	89516
20562	1546	182	1151	84853	0	87732
20563	1227	147	821	86827	0	89022
20564	755	84674	595	3959	0	89983
20565	801	2102	334	87652	0	90889
20566	85819	837	222	4166	0	91044
20567	85824	684	187	2195	0	88890
20568	3559	495	82748	1574	0	88376
20569	1987	454	83831	1112	0	87384
20570	1746	271	2835	84011	0	88863
20571	1371	212	1515	86873	0	89971
20572	796	209	85805	3674	0	90484
20573	875	264	2828	82975	0	86942
20574	638	83606	1325	3521	0	89090
20575	87380	2360	943	2103	0	92786
20576	88177	965	690	1664	0	91496
20577	88062	733	444	1358	0	90597
20578	4248	632	85727	927	0	91534
20579	2542	547	2437	87092	0	92618
20580	2021	257	86043	2923	0	91244
20581	84945	201	2913	1585	0	89644
20582	3142	84786	1456	1404	0	90788
20583	1675	2216	1143	85433	0	90467
20584	85389	890	751	3229	0	90259
20585	3175	818	506	85567	0	90066
20586	1777	646	422	88313	0	91158
20587	1453	463	84697	3972	0	90585
20588	82712	332	2413	2465	0	87922
20589	3387	84250	1129	1752	0	90518
20590	1990	2171	947	86491	0	91599
20591	86408	874	726	3253	0	91261
20592	3540	796	597	86422	0	91355
20593	85821	657	427	3735	0	90640
20594	3539	85051	426	2140	0	91156
20595	87395	2385	280	1877	0	91937
20596	4111	1145	85735	1219	0	92210
20597	87394	962	2447	1297	0	92100
20598	88327	641	1152	1060	0	91180
20599	88767	488	1075	1081	0	91411
20600	4871	443	784	84985	0	91083
20601	3159	563	638	82162	0	86522
20602	2523	498	419	86140	0	89580
20603	1886	82614	374	4108	0	88982
20604	85086	2456	278	2724	0	90544
20605	3472	1050	364	85384	0	90270
20606	2091	905	382	86542	0	89920
20607	1843	676	352	86919	0	89790
20608	84024	590	422	4589	0	89625
20609	3536	410	369	85422	0	89737
20610	1949	403	81765	4392	0	88509
20611	1646	82280	2324	2665	0	88915
20612	1480	2520	965	85199	0	90164
20613	1273	1246	813	87067	0	90399
20614	1019	1030	730	88272	0	91051
20615	959	769	83544	4718	0	89990
20616	1010	514	83680	3008	0	88212
20617	977	395	3282	86047	0	90701
20618	973	385	87725	4008	0	93091
20619	968	299	3204	89704	0	94175
20620	89203	271	1602	4614	0	95690
20621	92803	288	1161	3021	0	97273
20622	93631	366	790	2416	0	97203
20623	4492	414	88897	1731	0	95534
20624	89270	420	2563	1537	0	93790
20625	4450	639	1377	90215	0	96681
20626	2372	292	88934	3257	0	94855
20627	1869	277	86509	1916	0	90571
20628	1349	84193	3339	1983	0	90864
20629	901	76801	1418	1171	0	80291
20630	65740	1420	1732	690	0	69582
20631	1243	406	378	63975	0	66002
20632	401	173	64524	1016	0	66114
20633	369	190	798	65123	0	66480
20634	65894	104	321	1170	0	67489
20635	1015	100	69217	448	0	70780
20636	69561	69	1045	554	0	71229
20637	73332	63	353	444	0	74192
20638	72941	66	231	401	0	73639
20639	1492	71219	193	269	0	73173
20640	74254	1056	154	361	0	75825
20641	1491	292	175	74705	0	76663
20642	686	204	145	74638	0	75673
20643	561	105	124	75796	0	76586
20644	429	126	132	75166	0	75853
20645	73088	74	149	1787	0	75098
20646	1234	70999	176	702	0	73111
20647	443	69342	133	403	0	70321
20648	322	71788	122	305	0	72537
20649	71846	1246	282	379	0	73753
20650	72121	383	238	340	0	73082
20651	71720	221	111	333	0	72385
20652	71730	141	106	288	0	72265
20653	1546	113	98	71010	0	72767
20654	652	112	96	71486	0	72346
20655	70953	72	106	1435	0	72566
20656	1126	70341	121	553	0	72141
20657	69283	981	84	454	0	70802
20658	70406	297	107	399	0	71209
20659	1421	169	89	69507	0	71186
20660	565	69206	115	1119	0	71005
20661	466	1036	103	71580	0	73185
20662	71010	302	98	1399	0	72809
20663	1291	195	71222	462	0	73170
20664	632	160	968	69449	0	71209
20665	377	70852	331	1072	0	72632
20666	71560	1009	229	535	0	73333
20667	71046	299	164	462	0	71971
20668	1452	244	70945	238	0	72879
20669	589	69336	1043	260	0	71228
20670	473	1072	70735	197	0	72477
20671	456	625	1085	68257	0	70423
20672	286	202	68530	1045	0	70063
20673	277	149	67422	374	0	68222
20674	198	67280	1095	291	0	68864
20675	67221	903	422	291	0	68837
20676	68058	288	239	355	0	68940
20677	1176	68248	186	182	0	69792
20678	514	68793	136	178	0	69621
20679	369	1147	66004	131	0	67651
20680	339	489	64819	157	0	65804
20681	282	283	66967	160	0	67692
20682	320	187	1229	67003	0	68739
20683	240	147	68185	997	0	69569
20684	345	145	1060	66140	0	67690
20685	430	130	362	65132	0	66054
20686	271	156	67411	1204	0	69042
20687	262	66564	958	506	0	68290
20688	323	951	287	67564	0	69125
20689	67488	313	224	1142	0	69167
20690	1195	243	141	67580	0	69159
20691	471	192	67602	1143	0	69408
20692	391	66674	980	445	0	68490
20693	291	70046	356	358	0	71051
20694	370	1237	273	69141	0	71021
20695	68810	439	170	1261	0	70680
20696	68943	294	152	591	0	69980
20697	1519	239	136	67986	0	69880
20698	662	69949	151	1130	0	71892
20699	560	1174	131	71526	0	73391
20700	513	418	130	73539	0	74600
20701	484	287	120	74017	0	74908
20702	76279	199	140	2013	0	78631
20703	1678	76619	172	787	0	79256
20704	77845	1575	127	712	0	80259
20705	79597	583	164	506	0	80850
20706	79848	421	138	476	0	80883
20707	81871	303	137	413	0	82724
20708	2665	301	142	79494	0	82602
20709	1092	274	79314	1822	0	82502
20710	657	79388	1641	806	0	82492
20711	80624	1783	672	768	0	83847
20712	82501	644	346	604	0	84095
20713	83769	381	186	588	0	84924
20714	2640	311	80364	340	0	83655
20715	80393	284	1710	400	0	82787
20716	82865	291	578	374	0	84108
20717	2744	332	348	81158	0	84582
20718	1214	246	77729	1791	0	80980
20719	750	76603	1737	758	0	79848
20720	761	1822	725	76537	0	79845
20721	75526	691	578	2001	0	78796
20722	2017	354	237	75425	0	78033
20723	993	242	237	77543	0	79015
20724	78073	254	215	2442	0	80984
20725	2124	252	76256	922	0	79554
20726	77131	211	1696	711	0	79749
20727	77897	169	660	550	0	79276
20728	77932	192	486	533	0	79143
20729	78022	213	296	514	0	79045
20730	2758	226	74562	316	0	77862
20731	1406	325	1762	73783	0	77276
20732	781	212	74259	1823	0	77075
20733	717	420	1878	72648	0	75663
20734	554	184	72843	2006	0	75587
20735	66482	222	1790	958	0	69452
20736	1783	64972	763	547	0	68065
20737	836	66920	401	293	0	68450
20738	862	1853	335	69421	0	72471
20739	769	754	279	71643	0	73445
20740	455	72557	225	2287	0	75524
20741	73643	1914	189	1028	0	76774
20742	78043	697	174	604	0	79518
20743	80891	367	173	459	0	81890
20744	84366	179	223	438	0	85206
20745	3658	142	174	82065	0	86039
20746	1770	154	190	85762	0	87876
20747	86227	169	148	3410	0	89954
20748	3077	139	193	85875	0	89284
20749	1436	191	82880	2999	0	87506
20750	871	248	83809	1309	0	86237
20751	905	168	3111	84855	0	89039
20752	640	143	84808	2831	0	88422
20753	83864	119	2828	1396	0	88207
20754	2994	167	1162	84582	0	88905
20755	85443	113	670	2943	0	89169
20756	3185	169	84779	1337	0	89470
20757	1734	194	2537	85183	0	89648
20758	1020	170	85756	2909	0	89855
20759	712	84745	2917	1436	0	89810
20760	84099	2562	1466	1096	0	89223
20761	85633	973	750	805	0	88161
20762	3671	83115	479	669	0	87934
20763	83534	2552	432	629	0	87147
20764	3581	984	354	81836	0	86755
20765	1820	545	318	84051	0	86734
20766	81922	329	356	3743	0	86350
20767	3154	79362	341	1711	0	84568
20768	1606	81857	349	1057	0	84869
20769	1271	3262	317	80673	0	85523
20770	79770	1330	368	3016	0	84484
20771	82224	738	296	1531	0	84789
20772	82882	487	355	960	0	84684
20773	4451	448	78538	670	0	84107
20774	2278	351	78691	663	0	81983
20775	1465	78107	3313	648	0	83533
20776	78809	2646	1425	755	0	83635
20777	3673	1118	793	77048	0	82632
20778	78420	697	521	3027	0	82665
20779	79914	426	490	1493	0	82323
20780	4493	378	456	76959	0	82286
20781	2355	353	76141	3100	0	81949
20782	77346	326	2725	1596	0	81993
20783	3726	269	1170	77238	0	82403
20784	1949	305	76575	3183	0	82012
20785	76711	304	2802	1737	0	81554
20786	78941	254	1281	1311	0	81787
20787	4303	280	871	76372	0	81826
20788	2170	319	75505	3302	0	81296
20789	1632	388	2834	74628	0	79482
20790	1333	75144	1359	3374	0	81210
20791	1283	2574	75556	1589	0	81002
20792	1329	76354	2856	1128	0	81667
20793	75644	2820	1408	910	0	80782
20794	77520	1157	913	909	0	80499
20795	77856	662	705	854	0	80077
20796	77798	451	630	846	0	79725
20797	4810	454	539	73466	0	79269
20798	72592	371	632	2953	0	76548
20799	3856	377	501	71000	0	75734
20800	69122	310	534	3177	0	73143
20801	3455	66787	469	1739	0	72450
20802	1826	2219	427	63309	0	67781
20803	1252	63471	375	2448	0	67546
20804	63698	2208	467	1367	0	67740
20805	64009	1006	450	989	0	66454
20806	3221	61405	379	796	0	65801
20807	1744	2084	402	60830	0	65060
20808	1250	914	59770	2220	0	64154
20809	1153	868	1910	59530	0	63461
20810	1032	475	59267	2416	0	63190
20811	1112	670	2132	55688	0	59602
20812	873	56724	986	2182	0	60765
20813	56866	1807	651	1173	0	60497
20814	58175	786	464	841	0	60266
20815	2937	541	387	56569	0	60434
20816	58683	390	363	2248	0	61684
20817	2760	384	341	58206	0	61691
20818	1562	354	308	59366	0	61590
20819	1155	328	354	60020	0	61857
20820	58365	290	317	3055	0	62027
20821	59477	296	281	1600	0	61654
20822	59778	279	329	1082	0	61468
20823	3044	56194	326	768	0	60332
20824	56044	1660	320	669	0	58693
20825	2554	54457	321	608	0	57940
20826	55528	1873	326	603	0	58330
20827	2666	806	298	54293	0	58063
20828	1478	551	293	55873	0	58195
20829	54716	420	240	2488	0	57864
20830	55495	367	252	1175	0	57289
20831	2724	53306	236	847	0	57113
20832	54466	1679	207	692	0	57044
20833	2607	709	181	53029	0	56526
20834	1480	479	176	54290	0	56425
20835	53245	335	153	2469	0	56202
20836	2378	313	51688	1214	0	55593
20837	1287	50327	1460	828	0	53902
20838	1086	1510	515	46789	0	49900
20839	632	444	43734	1312	0	46122
20840	756	1570	1088	40791	0	44205
20841	41132	232	631	1330	0	43325
20842	1158	37803	268	666	0	39895
20843	533	35145	198	441	0	36317
20844	335	33095	161	248	0	33839
20845	787	1135	586	30534	0	33042
20846	30419	171	611	707	0	31908
20847	558	125	48	29756	0	30487
20848	29581	71	31	592	0	30275
20849	29888	52	29	215	0	30184
20850	581	49	45	29631	0	30306
20851	29789	51	46	545	0	30431
20852	583	54	35	30151	0	30823
20853	184	63	30286	532	0	31065
20854	30372	59	419	231	0	31081
20855	550	65	32648	150	0	33413
20856	31546	60	422	159	0	32187
20857	539	45	31597	109	0	32290
20858	193	44	306	30591	0	31134
20859	161	43	94	31196	0	31494
20860	31611	42	41	491	0	32185
20861	449	48	29	32370	0	32896
20862	32540	40	30	465	0	33075
20863	436	32268	41	158	0	32903
20864	33599	341	27	206	0	34173
20865	508	76	28	34210	0	34822
20866	210	50	30	34646	0	34936
20867	162	44	35	34894	0	35135
20868	149	45	26	34797	0	35017
20869	100	48	33970	536	0	34654
20870	99	49	33601	200	0	33949
20871	139	77	381	33854	0	34451
20872	96	38	34297	396	0	34827
20873	87	33941	366	152	0	34546
20874	132	387	111	34287	0	34917
20875	87	96	34945	422	0	35550
20876	88	86	34301	177	0	34652
20877	138	143	426	35119	0	35826
20878	105	29	138	35521	0	35793
20879	65	35568	77	486	0	36196
20880	111	403	44	36547	0	37105
20881	65	98	36510	500	0	37173
20882	36294	66	484	227	0	37071
20883	539	32	143	37580	0	38294
20884	37871	25	93	667	0	38656
20885	38223	31	75	272	0	38601
20886	38910	35	61	250	0	39256
20887	633	34	38766	130	0	39563
20888	204	54	38485	108	0	38851
20889	37241	26	611	186	0	38064
20890	571	48	39049	116	0	39784
20891	238	40	561	37541	0	38380
20892	200	38	159	38307	0	38704
20893	118	48	38235	662	0	39063
20894	96	38153	555	241	0	39045
20895	38274	499	175	248	0	39196
20896	574	38176	139	161	0	39050
20897	198	39678	108	143	0	40127
20898	39618	602	101	206	0	40527
20899	607	162	40688	122	0	41579
20900	214	108	41199	123	0	41644
20901	188	57	732	40558	0	41535
20902	41057	41	244	713	0	42055
20903	632	41264	179	243	0	42318
20904	41783	626	118	216	0	42743
20905	725	173	42345	137	0	43380
20906	209	44701	713	124	0	45747
20907	212	703	227	46097	0	47239
20908	143	197	46540	815	0	47695
20909	200	132	778	46761	0	47871
20910	347	153	306	42105	0	42911
20911	211	81	177	47770	0	48239
20912	198	82	152	47569	0	48001
20913	46687	67	131	1127	0	48012
20914	47016	80	126	424	0	47646
20915	1030	93	46872	234	0	48229
20916	45463	87	817	273	0	46640
20917	930	45597	295	179	0	47001
20918	46154	748	203	237	0	47342
20919	927	210	46263	202	0	47602
20920	390	253	821	45632	0	47096
20921	219	98	46256	891	0	47464
20922	218	87	46372	318	0	46995
20923	215	153	1013	45681	0	47062
20924	224	86	335	46422	0	47067
20925	190	97	45644	1023	0	46954
20926	175	44427	868	391	0	45861
20927	169	45546	311	287	0	46313
20928	183	903	223	45855	0	47164
20929	44984	254	232	991	0	46461
20930	780	46715	213	387	0	48095
20931	322	810	46849	270	0	48251
20932	210	249	46262	230	0	46951
20933	205	196	47130	201	0	47732
20934	219	152	1048	45914	0	47333
20935	46650	99	429	984	0	48162
20936	884	46045	301	366	0	47596
20937	314	865	46010	263	0	47452
20938	213	45850	925	252	0	47240
20939	222	849	379	46662	0	48112
20940	177	282	46744	926	0	48129
20941	162	46823	929	391	0	48305
20942	228	810	362	46678	0	48078
20943	225	262	283	48219	0	48989
20944	192	217	48322	1040	0	49771
20945	261	164	905	47331	0	48661
20946	196	47698	357	958	0	49209
20947	195	839	47676	380	0	49090
20948	47186	299	931	313	0	48729
20949	945	229	336	48129	0	49639
20950	365	197	301	48153	0	49016
20951	224	47746	290	1012	0	49272
20952	47595	808	258	468	0	49129
20953	853	297	46381	322	0	47853
20954	46021	220	899	340	0	47480
20955	921	293	307	45102	0	46623
20956	279	45273	249	800	0	46601
20957	232	768	235	45710	0	46945
20958	209	251	207	47244	0	47911
20959	46404	196	186	1115	0	47901
20960	47114	153	192	454	0	47913
20961	959	151	177	46975	0	48262
20962	342	139	46321	935	0	47737
20963	44331	121	843	455	0	45750
20964	839	46126	318	295	0	47578
20965	326	814	214	46513	0	47867
20966	311	245	187	47723	0	48466
20967	210	193	185	48025	0	48613
20968	170	173	47013	1142	0	48498
20969	176	173	877	46438	0	47664
20970	134	46986	340	1020	0	48480
20971	194	808	219	46779	0	48000
20972	133	46930	215	951	0	48229
20973	207	930	186	46949	0	48272
20974	150	318	46375	1033	0	47876
20975	44012	191	807	494	0	45504
20976	865	221	333	46189	0	47608
20977	274	142	45982	887	0	47285
20978	150	45780	773	386	0	47089
20979	45624	704	357	398	0	47083
20980	755	272	44944	270	0	46241
20981	43981	315	888	404	0	45588
20982	805	158	326	45220	0	46509
20983	330	102	207	45446	0	46085
20984	173	44881	189	771	0	46014
20985	45285	601	165	385	0	46436
20986	44745	222	128	298	0	45393
20987	755	45840	115	246	0	46956
20988	310	664	128	46735	0	47837
20989	243	231	121	47138	0	47733
20990	171	150	106	46908	0	47335
20991	134	150	45798	868	0	46950
20992	44935	108	652	449	0	46144
20993	680	103	209	46337	0	47329
20994	259	126	171	46629	0	47185
20995	178	142	45332	831	0	46483
20996	154	123	44586	402	0	45265
20997	187	204	718	46192	0	47301
20998	149	124	46683	789	0	47745
20999	44860	138	704	393	0	46095
21000	630	89	256	46099	0	47074
21001	272	89	183	46975	0	47519
21002	165	91	47987	837	0	49080
21003	201	220	623	48734	0	49778
21004	99	81	49570	817	0	50567
21005	99	48266	691	356	0	49412
21006	45612	645	480	432	0	47169
21007	45509	137	174	242	0	46062
21008	551	44921	110	174	0	45756
21009	267	477	91	45795	0	46630
21010	156	158	46241	531	0	47086
21011	141	123	464	46104	0	46832
21012	46224	55	184	655	0	47118
21013	468	46245	132	247	0	47092
21014	46645	445	84	264	0	47438
21015	549	158	86	46421	0	47214
21016	46473	107	71	591	0	47242
21017	526	45966	63	246	0	46801
21018	46559	457	81	254	0	47351
21019	536	191	45205	158	0	46090
21020	204	45809	450	166	0	46629
21021	254	457	204	46246	0	47161
21022	47992	142	199	590	0	48923
21023	48645	104	66	288	0	49103
21024	617	57	78	48805	0	49557
21025	49335	59	56	658	0	50108
21026	49282	57	62	301	0	49702
21027	50224	68	62	291	0	50645
21028	733	67	79	49980	0	50859
21029	295	57	49872	570	0	50794
21030	238	82	46856	209	0	47385
21031	144	97	48315	186	0	48742
21032	49271	61	618	197	0	50147
21033	598	53	204	49715	0	50570
21034	207	50228	142	552	0	51129
21035	212	497	80	50601	0	51390
21036	166	51460	95	562	0	52283
21037	52967	558	76	320	0	53921
21038	628	157	73	53711	0	54569
21039	263	140	80	54852	0	55335
21040	55410	69	84	875	0	56438
21041	712	62	91	55961	0	56826
21042	308	63	73	57278	0	57722
21043	57769	59	88	966	0	58882
21044	814	92	57996	348	0	59250
21045	323	73	747	58561	0	59704
21046	231	82	58672	876	0	59861
21047	58221	69	825	388	0	59503
21048	914	70	248	59729	0	60961
21049	59711	58	166	964	0	60899
21050	990	70	104	60411	0	61575
21051	336	78	61311	1012	0	62737
21052	318	57	815	62335	0	63525
21053	63975	47	285	1131	0	65438
21054	949	64138	206	400	0	65693
21055	372	829	63965	298	0	65464
21056	61987	208	853	363	0	63411
21057	1015	63570	298	236	0	65119
21058	340	64039	176	264	0	64819
21059	273	68466	154	237	0	69130
21060	425	1136	144	71981	0	73686
21061	73034	283	189	1316	0	74822
21062	75116	168	126	497	0	75907
21063	1604	151	73245	274	0	75274
21064	72944	119	1213	302	0	74578
21065	1513	72321	353	205	0	74392
21066	622	1189	211	74369	0	76391
21067	77221	305	155	1504	0	79185
21068	78284	213	121	600	0	79218
21069	78855	123	153	434	0	79565
21070	78250	131	139	358	0	78878
21071	79047	159	140	281	0	79627
21072	1984	185	118	77551	0	79838
21073	715	196	77100	1414	0	79425
21074	734	158	1212	78227	0	80331
21075	643	165	280	80016	0	81104
21076	79055	134	215	1744	0	81148
21077	1701	76739	191	627	0	79258
21078	78671	1274	150	553	0	80648
21079	80344	332	155	478	0	81309
21080	81862	222	201	536	0	82821
21081	82899	145	189	531	0	83764
21082	2179	180	79079	395	0	81833
21083	80455	192	1277	457	0	82381
21084	82604	156	357	453	0	83570
21085	73796	252	317	788	0	75153
21086	82461	138	177	450	0	83226
21087	2380	141	142	79073	0	81736
21088	1097	169	76881	1501	0	79648
21089	77177	96	1308	665	0	79246
21090	2026	77546	440	479	0	80491
21091	1100	1243	308	77334	0	79985
21092	915	78205	243	1505	0	80868
21093	906	1349	222	80400	0	82877
21094	80954	375	218	1807	0	83354
21095	81587	283	226	739	0	82835
21096	81684	232	232	572	0	82720
21097	2335	263	75856	407	0	78861
21098	77294	248	1284	445	0	79271
21099	2127	259	75241	380	0	78007
21100	1133	242	74426	398	0	76199
21101	984	284	75841	401	0	77510
21102	1197	430	1707	71526	0	74860
21103	918	186	613	74579	0	76296
21104	902	177	369	74433	0	75881
21105	856	199	339	73913	0	75307
21106	1015	197	331	71006	0	72549
21107	798	196	337	73865	0	75196
21108	708	73314	335	1804	0	76161
21109	72991	1284	299	877	0	75451
21110	1706	73639	310	711	0	76366
21111	923	1379	268	74800	0	77370
21112	812	421	266	76279	0	77778
21113	74857	285	262	2070	0	77474
21114	1816	74019	302	906	0	77043
21115	75533	1299	266	798	0	77896
21116	2002	462	314	75265	0	78043
21117	1073	338	301	75803	0	77515
21118	850	345	307	76156	0	77658
21119	772	311	74210	2028	0	77321
21120	829	348	1333	74253	0	76763
21121	791	324	72913	1939	0	75967
21122	779	304	70282	928	0	72293
21123	836	258	73916	808	0	75818
21124	921	235	1617	74416	0	77189
21125	822	212	627	76916	0	78577
21126	795	247	417	78072	0	79531
21127	77413	264	402	2234	0	80313
21128	1905	311	377	79634	0	82227
21129	80624	234	399	2265	0	83522
21130	2149	80350	395	1029	0	83923
21131	84707	1587	338	1034	0	87666
21132	88195	435	296	1087	0	90013
21133	2480	88933	340	781	0	92534
21134	89129	1700	282	1070	0	92181
21135	90010	462	369	982	0	91823
21136	91711	325	516	913	0	93465
21137	91759	266	392	815	0	93232
21138	2940	338	87843	580	0	91701
21139	1398	86731	1797	546	0	90472
21140	1348	1964	624	85605	0	89541
21141	86417	516	514	2178	0	89625
21142	2313	390	85405	858	0	88966
21143	1128	83453	1701	734	0	87016
21144	1118	1459	547	81460	0	84584
21145	887	82741	385	1834	0	85847
21146	999	1732	286	83416	0	86433
21147	1015	731	276	84115	0	86137
21148	918	413	83265	2117	0	86713
21149	949	432	81376	809	0	83566
21150	78772	377	1804	820	0	81773
21151	2053	382	82146	492	0	85073
21152	998	356	80974	501	0	82829
21153	1043	476	1817	78966	0	82302
21154	910	428	725	79280	0	81343
21155	696	78204	594	1913	0	81407
21156	676	83777	496	998	0	85947
21157	785	1813	84240	698	0	87536
21158	949	1337	2106	85780	0	90172
21159	476	416	85254	1963	0	88109
21160	327	257	78850	631	0	80065
21161	258	78714	1841	468	0	81281
21162	605	1439	769	77108	0	79921
21163	77492	434	480	1508	0	79914
21164	1479	297	294	77987	0	80057
21165	78417	183	233	1733	0	80566
21166	78500	155	208	733	0	79596
21167	78119	159	204	615	0	79097
21168	1908	210	76079	298	0	78495
21169	76839	157	1366	372	0	78734
21170	1818	155	481	78471	0	80925
21171	79192	114	394	1595	0	81295
21172	79766	128	274	709	0	80877
21173	1812	77696	271	441	0	80220
21174	78604	1303	197	435	0	80539
21175	1781	441	78002	250	0	80474
21176	76842	309	1383	380	0	78914
21177	78219	194	484	371	0	79268
21178	1807	77348	341	245	0	79741
21179	78000	1300	237	309	0	79846
21180	1838	437	211	74955	0	77441
21181	831	321	220	75103	0	76475
21182	546	74470	239	1626	0	76881
21183	596	1327	194	76339	0	78456
21184	534	421	209	77403	0	78567
21185	419	368	75718	1799	0	78304
21186	451	341	74405	716	0	75913
21187	73559	221	1632	686	0	76098
21188	76764	156	599	529	0	78048
21189	2060	159	402	76166	0	78787
21190	945	190	75998	1523	0	78656
21191	714	75322	1462	592	0	78090
21192	653	1386	524	75785	0	78348
21193	474	505	75675	1630	0	78284
21194	73964	369	1512	836	0	76681
21195	1830	264	522	77746	0	80362
21196	770	78723	439	1772	0	81704
21197	743	1675	328	80113	0	82859
21198	673	537	332	81524	0	83066
21199	605	385	338	82365	0	83693
21200	80468	288	334	2527	0	83617
21201	2047	212	310	80543	0	83112
21202	80731	263	270	2341	0	83605
21203	81805	294	252	1017	0	83368
21204	2481	276	79892	688	0	83337
21205	1082	79888	1795	598	0	83363
21206	928	1728	622	75878	0	79156
21207	601	83017	524	1678	0	85820
21208	84377	2072	398	920	0	87767
21209	2214	737	307	84689	0	87947
21210	930	485	83919	2268	0	87602
21211	824	350	83105	930	0	85209
21212	686	341	83686	727	0	85440
21213	82767	255	2485	767	0	86274
21214	2220	83726	1031	583	0	87560
21215	83896	1930	685	637	0	87148
21216	2413	84438	522	568	0	87941
21217	1173	2164	439	84453	0	88229
21218	1072	769	444	84000	0	86285
21219	759	84463	393	2481	0	88096
21220	740	2096	84258	1082	0	88176
21221	586	85404	2010	822	0	88822
21222	83952	2188	737	870	0	87747
21223	2273	796	540	81481	0	85090
21224	922	571	80002	2150	0	83645
21225	858	471	79950	871	0	82150
21226	914	690	2358	79036	0	82998
21227	678	376	78444	2054	0	81552
21228	619	353	75427	850	0	77249
21229	71015	434	2297	750	0	74496
21230	1733	72128	954	510	0	75325
21231	69359	1510	591	610	0	72070
21232	1857	623	68511	406	0	71397
21233	845	64707	1689	405	0	67646
21234	624	67054	741	435	0	68854
21235	916	2199	921	65576	0	69612
21236	508	693	436	67443	0	69080
21237	473	423	374	68830	0	70100
21238	387	361	67578	2308	0	70634
21239	519	311	1671	68206	0	70707
21240	503	250	629	70085	0	71467
21241	68434	249	455	2455	0	71593
21242	1842	67414	351	1075	0	70682
21243	793	1675	322	68999	0	71789
21244	68669	687	252	2136	0	71744
21245	68966	459	272	983	0	70680
21246	2371	353	271	68061	0	71056
21247	957	352	67518	2026	0	70853
21248	719	277	1678	68108	0	70782
21249	472	261	67662	2258	0	70653
21250	68055	234	1962	1132	0	71383
21251	73116	211	812	859	0	74998
21252	2744	520	611	73832	0	77707
21253	1079	243	74528	2390	0	78240
21254	701	77223	2272	935	0	81131
21255	614	2381	78590	627	0	82212
21256	831	1512	2547	70226	0	75116
21257	374	74361	882	2190	0	77807
21258	70975	2045	390	680	0	74090
21259	2281	561	242	68838	0	71922
21260	595	69960	295	2063	0	72913
21261	71014	2041	251	770	0	74076
21262	2297	581	254	70108	0	73240
21263	630	70121	304	2176	0	73231
21264	599	2119	241	71065	0	74024
21265	334	653	70075	2315	0	73377
21266	68366	367	2070	887	0	71690
21267	69928	318	580	638	0	71464
21268	2509	305	67284	423	0	70521
21269	774	66700	2046	403	0	69923
21270	67477	1968	683	449	0	70577
21271	2354	615	362	66660	0	69991
21272	864	382	304	67197	0	68747
21273	598	309	253	68387	0	69547
21274	549	271	252	68483	0	69555
21275	496	198	234	68052	0	68980
21276	65525	234	239	3013	0	69011
21277	67551	220	224	1172	0	69167
21278	2644	195	271	65825	0	68935
21279	991	169	249	67544	0	68953
21280	588	236	64852	2759	0	68435
21281	500	204	65308	1028	0	67040
21282	64063	224	2389	792	0	67468
21283	2452	249	713	64168	0	67582
21284	806	220	63344	2448	0	66818
21285	645	225	2169	63818	0	66857
21286	63571	188	699	2679	0	67137
21287	65681	174	462	1122	0	67439
21288	2699	195	359	64098	0	67351
21289	1027	201	343	65632	0	67203
21290	64062	171	319	2897	0	67449
21291	2485	169	308	63297	0	66259
21292	840	62818	257	2583	0	66498
21293	770	2017	281	62924	0	65992
21294	668	618	286	63914	0	65486
21295	493	335	60957	2677	0	64462
21296	479	272	59866	1070	0	61687
21297	409	59842	2160	827	0	63238
21298	58648	1897	828	758	0	62131
21299	59066	561	421	667	0	60715
21300	59630	320	365	611	0	60926
21301	2457	56252	358	622	0	59689
21302	909	59081	288	577	0	60855
21303	57105	2059	327	675	0	60166
21304	2007	58006	309	615	0	60937
21305	782	2036	56371	547	0	59736
21306	575	56779	1812	643	0	59809
21307	585	1941	54779	575	0	57880
21308	53285	659	1892	580	0	56416
21309	54755	436	600	626	0	56417
21310	2102	53293	400	560	0	56355
21311	54406	1769	305	628	0	57108
21312	58382	581	305	563	0	59831
21313	59234	411	278	596	0	60519
21314	2743	387	268	57559	0	60957
21315	58172	343	302	2206	0	61023
21316	2567	330	55388	881	0	59166
21317	56885	309	1824	779	0	59797
21318	2594	329	626	56982	0	60531
21319	1132	319	55745	2159	0	59355
21320	899	316	56513	935	0	58663
21321	904	340	2224	56005	0	59473
21322	724	271	848	57756	0	59599
21323	56599	276	605	2641	0	60121
21324	2230	271	403	56839	0	59743
21325	993	249	55439	2582	0	59263
21326	902	191	1875	54991	0	57959
21327	671	55689	668	2468	0	59496
21328	56462	1678	526	1216	0	59882
21329	2246	557	426	56593	0	59822
21330	978	437	55154	2262	0	58831
21331	810	54728	1829	1072	0	58439
21332	53167	1648	684	863	0	56362
21333	2092	688	552	53439	0	56771
21334	900	391	52897	2044	0	56232
21335	753	51816	1730	941	0	55240
21336	51001	1711	860	895	0	54467
21337	50596	481	518	685	0	52280
21338	51341	336	392	623	0	52692
21339	2283	289	307	49493	0	52372
21340	1142	213	282	50615	0	52252
21341	49169	200	242	2126	0	51737
21342	1852	48310	265	1056	0	51483
21343	49058	1350	222	863	0	51493
21344	1952	456	252	48803	0	51463
21345	49619	390	238	1793	0	52040
21346	2029	277	264	49073	0	51643
21347	1001	251	254	49839	0	51345
21348	868	258	243	50151	0	51520
21349	883	288	247	50155	0	51573
21350	605	227	46204	2044	0	49080
21351	523	209	42724	880	0	44336
21352	39108	161	995	666	0	40930
21353	1008	132	39805	416	0	41361
21354	359	87	34805	224	0	35475
21355	33544	100	1036	214	0	34894
21356	34065	70	630	186	0	34951
21357	845	148	325	35509	0	36827
21358	35902	50	204	648	0	36804
21359	743	36178	128	320	0	37369
21360	37434	452	110	366	0	38362
21361	37215	225	79	240	0	37759
21362	38440	213	87	233	0	38973
21363	916	157	83	37759	0	38915
21364	548	36450	102	520	0	37620
21365	421	37620	92	294	0	38427
21366	38036	595	117	301	0	39049
21367	38302	345	81	291	0	39019
21368	718	266	99	37887	0	38970
21369	486	158	96	37812	0	38552
21370	364	37232	95	646	0	38337
21371	37675	450	71	475	0	38671
21372	644	232	37387	338	0	38601
21373	430	218	413	37275	0	38336
21374	386	109	206	37942	0	38643
21375	247	83	37799	702	0	38831
21376	246	80	448	37416	0	38190
21377	275	30693	331	741	0	32040
21378	221	453	228	38713	0	39615
21379	229	235	128	38329	0	38921
21380	193	35709	136	698	0	36736
21381	184	38265	105	481	0	39035
21382	196	520	102	38777	0	39595
21383	39005	326	80	679	0	40090
21384	511	233	92	39181	0	40017
21385	319	147	106	39552	0	40124
21386	318	39908	136	685	0	41047
21387	251	398	106	41979	0	42734
21388	221	208	102	41937	0	42468
21389	227	177	94	42043	0	42541
21390	41692	113	74	918	0	42797
21391	547	91	83	42278	0	42999
21392	343	111	69	42278	0	42801
21393	363	103	66	42490	0	43022
21394	259	91	41079	840	0	42269
21395	38932	77	382	590	0	39981
21396	558	40999	223	420	0	42200
21397	42035	382	179	304	0	42900
21398	680	217	104	41913	0	42914
21399	393	211	40966	486	0	42056
21400	39794	150	412	363	0	40719
21401	619	119	47433	305	0	48476
21402	440	149	482	48084	0	49155
21403	50283	75	337	611	0	51306
21404	49780	69	194	373	0	50416
21405	51529	77	108	410	0	52124
21406	767	68	76	52049	0	52960
21407	496	101	67	52811	0	53475
21408	388	194	61	52958	0	53601
21409	237	50400	83	764	0	51484
21410	183	50327	84	520	0	51114
21411	155	49810	74	407	0	50446
21412	64	49144	44	78	0	49330
21413	168	172	118	51163	0	51621
21414	79	48	29	51347	0	51503
21415	51461	22	33	268	0	51784
21416	50750	24	37	148	0	50959
21417	51865	17	21	166	0	52069
21418	227	24	17	52043	0	52311
21419	99	20	26	52725	0	52870
21420	52421	31	10	326	0	52788
21421	51377	44	33	171	0	51625
21422	220	51	50752	89	0	51112
21423	152	107	48539	105	0	48903
21424	124	75	50147	65	0	50411
21425	83	61	53520	61	0	53725
21426	69	26	173	54200	0	54468
21427	54509	31	60	255	0	54855
21428	174	53872	62	121	0	54229
21429	84	165	18	56282	0	56549
21430	63	84	56443	206	0	56796
21431	59	58587	179	123	0	58948
21432	68	139	34	61107	0	61348
21433	55	62	60774	215	0	61106
21434	103	34	145	60288	0	60570
21435	73	17	42	61460	0	61592
21436	62587	18	38	307	0	62950
21437	190	29	22	63064	0	63305
21438	86	59	63447	195	0	63787
21439	101	34	149	62835	0	63119
21440	57	67585	87	257	0	67986
21441	100	146	43	72006	0	72295
21442	81	48	37	72574	0	72740
21443	81	35	33	72494	0	72643
21444	73921	16	33	403	0	74373
21445	74074	15	27	247	0	74363
21446	75570	11	26	275	0	75882
21447	75677	15	28	263	0	75983
21448	276	75	74104	72	0	74527
21449	73519	16	150	186	0	73871
21450	76004	13	50	192	0	76259
21451	237	57	74192	68	0	74554
21452	132	88	77200	48	0	77468
21453	117	71	161	79473	0	79822
21454	46	79783	86	153	0	80068
21455	82886	129	80	229	0	83324
21456	84497	42	24	250	0	84813
21457	85408	21	24	280	0	85733
21458	240	13	16	85127	0	85396
21459	91	87594	75	178	0	87938
21460	92594	126	21	382	0	93123
21461	93880	39	16	274	0	94209
21462	233	27	17	93859	0	94136
21463	120	66	91507	179	0	91872
21464	92366	18	153	205	0	92742
21465	211	19	65	96391	0	96686
21466	97941	16	35	370	0	98362
21467	226	13	19	99771	0	100029
21468	126	65	98829	178	0	99198
21469	104526	13	153	474	0	105166
21470	256	19	52	108511	0	108838
21471	183	17	32	108600	0	108832
21472	99	13	21	109718	0	109851
21473	94	20	18	109414	0	109546
21474	110939	10	12	495	0	111456
21475	254	22	12	110654	0	110942
21476	115	109586	78	280	0	110059
21477	90	259	15	113714	0	114078
21478	47	113094	69	366	0	113576
21479	85	334	22	117221	0	117662
21480	130	109	15	118143	0	118397
21481	55	116714	59	458	0	117286
21482	73	336	16	120039	0	120464
21483	108	90	13	119525	0	119736
21484	119506	32	17	738	0	120293
21485	472	111	120545	147	0	121275
21486	234	27	485	122526	0	123272
21487	123830	19	108	848	0	124805
21488	123596	21	53	377	0	124047
21489	123945	22	42	332	0	124341
21490	845	92	122475	83	0	123495
21491	351	168	122152	90	0	122761
21492	359	202	837	127151	0	128549
21493	130496	21	278	1073	0	131868
21494	811	109	127439	219	0	128578
21495	124932	44	774	429	0	126179
21496	808	129107	286	186	0	130387
21497	432	672	120	137982	0	139206
21498	314	201	90	140913	0	141518
21499	142442	82	64	1341	0	143929
21500	880	95	47	144171	0	145193
21501	140288	56	47	1249	0	141640
21502	142275	40	47	726	0	143088
21503	1097	65	50	141331	0	142543
21504	452	39	55	142071	0	142617
21505	142004	29	56	1371	0	143460
21506	966	100	147793	343	0	149202
21507	146705	28	741	914	0	148388
21508	1000	127	155113	183	0	156423
21509	157049	47	775	793	0	158664
21510	167018	32	251	789	0	168090
21511	165671	38	145	656	0	166510
21512	164000	34	118	533	0	164685
21513	1187	162119	170	212	0	163688
21514	167686	747	91	621	0	169145
21515	168435	183	91	526	0	169235
21516	1188	172389	143	230	0	173950
21517	176110	817	80	717	0	177724
21518	1193	318	172537	137	0	174185
21519	171738	123	843	527	0	173231
21520	1259	266	173825	142	0	175492
21521	730	71	1000	176153	0	177954
21522	560	59	331	178320	0	179270
21523	388	156	177118	1214	0	178876
21524	573	61	1054	177400	0	179088
21525	3936	1222	1960	113366	0	120484
21526	186645	72	174	1947	0	188838
21527	1414	70	160	188350	0	189994
21528	776	58	128	187656	0	188618
21529	493	81	119	190087	0	190780
21530	353	184754	240	1819	0	187166
21531	432	1174	123	188484	0	190213
21532	188913	341	108	2066	0	191428
21533	1635	267	189328	680	0	191910
21534	854	155	1501	192080	0	194590
21535	474	193	192561	1873	0	195101
21536	188235	98	1744	1083	0	191160
21537	2194	97	574	199815	0	202680
21538	866	244	230950	2317	0	234377
21539	972	99	3959	232796	0	237826
21540	831	107	2332	232373	0	235643
21541	417	230409	1889	6539	0	239254
21542	903	3885	1102	241726	0	247616
21543	982	2269	463	254033	0	257747
21544	500	1917	248764	8649	0	259830
21545	1123	1005	4857	250374	0	257359
21546	973	498	2631	257632	0	261734
21547	248643	281	1927	9849	0	260700
21548	248318	222	1371	6328	0	256239
21549	7361	247166	890	4148	0	259565
21550	253902	4866	735	3546	0	263049
21551	256044	2696	881	3029	0	262650
21552	8964	258635	1206	2488	0	271293
21553	5801	6100	810	261490	0	274201
21554	263847	3088	538	7877	0	275350
21555	265899	2243	550	5105	0	273797
21556	262781	1656	551	4195	0	269183
21557	10940	252416	802	2656	0	266814
21558	7591	5974	257905	1953	0	273423
21559	263473	3343	5425	2666	0	274907
21560	269268	2959	2823	2677	0	277727
21561	10536	264891	2249	2263	0	279939
21562	270546	6910	1365	2820	0	281641
21563	277397	3560	950	2339	0	284246
21564	13205	2811	791	268697	0	285504
21565	7649	2425	268551	7654	0	286279
21566	6371	1541	6895	274026	0	288833
21567	5507	1050	3497	277840	0	287894
21568	4668	1396	2392	281182	0	289638
21569	3498	1762	265523	12275	0	283058
21570	4603	1255	6962	259338	0	272158
21571	4085	1132	3501	273995	0	282713
21572	3440	881	2686	277613	0	284620
21573	3250	909	2125	277345	0	283629
21574	2989	824	1409	277419	0	282641
21575	2338	264632	1252	16593	0	284815
21576	2614	6900	1164	275843	0	286521
21577	2400	3304	1707	284381	0	291792
21578	1750	2546	269852	14531	0	288679
21579	2532	1602	7404	291430	0	302968
21580	2412	1167	3681	298651	0	305911
21581	2426	998	2759	309212	0	315395
21582	2599	1082	2065	315844	0	321590
21583	302263	1350	1460	20408	0	325481
21584	10766	1550	1221	313900	0	327437
21585	6134	1362	1243	317657	0	326396
21586	4510	1524	295776	18553	0	320363
21587	3467	281558	9026	12755	0	306806
21588	2221	302765	4956	10521	0	320463
21589	294482	11173	4169	9454	0	319278
21590	9283	299872	3163	7921	0	320239
21591	6065	11392	1759	299797	0	319013
21592	294410	5863	1596	16149	0	318018
21593	11004	4311	292362	10805	0	318482
21594	6419	3214	9609	298496	0	317738
21595	4677	293763	5301	15180	0	318921
21596	4245	10257	3579	298484	0	316565
21597	2942	295902	2607	16932	0	318383
21598	3460	12414	1719	300930	0	318523
21599	292934	6895	1443	17999	0	319271
21600	11808	5129	294648	10971	0	322556
21601	7572	3672	10338	291190	0	312772
21602	5475	294561	5750	15439	0	321225
21603	294260	11396	4233	11060	0	320949
21604	12191	6595	290423	9235	0	318444
21605	7606	5141	10476	292703	0	315926
21606	6307	3983	282079	15500	0	307869
21607	6254	2935	12654	284096	0	305939
21608	4456	2715	276376	17149	0	300696
21609	3898	3011	13520	274127	0	294556
21610	3695	2933	7791	279864	0	294283
21611	265611	2916	5371	19703	0	293601
21612	273586	2918	4293	12571	0	293368
21613	16361	2720	3213	267295	0	289589
21614	9643	261697	3218	16291	0	290849
21615	7570	10993	2694	270618	0	291875
21616	5533	5914	2983	272362	0	286792
21617	253164	4234	3108	21685	0	282191
21618	11738	255115	2829	14993	0	284675
21619	256742	11404	2383	11971	0	282500
21620	259747	6553	2402	9871	0	278573
21621	16093	244402	2423	9141	0	272059
21622	9358	260866	2051	9400	0	281675
21623	253690	14155	2406	10150	0	280401
21624	14297	7802	244481	10234	0	276814
21625	248799	5755	10795	9845	0	275194
21626	251908	4871	5792	9276	0	271847
21627	18429	239079	4772	8491	0	270771
21628	12167	11548	3865	226617	0	254197
21629	8369	240282	3483	15727	0	267861
21630	238602	14150	3695	11436	0	267883
21631	245938	8637	3786	9574	0	267935
21632	17433	6842	3586	237268	0	265129
21633	11983	6094	2911	242804	0	263792
21634	228185	4855	2338	19753	0	255131
21635	15013	223871	2175	13918	0	254977
21636	10043	222340	2292	11784	0	246459
21637	8479	220930	2711	9448	0	241568
21638	4851	180951	1985	6678	0	194465
21639	4411	186721	1970	6888	0	199990
21640	5024	12630	2238	180174	0	200066
21641	3964	6519	170354	12296	0	193133
21642	4282	173395	6629	7377	0	191683
21643	161271	9028	2928	5284	0	178511
21644	9364	4930	2500	159735	0	176529
21645	159053	4159	2251	9083	0	174546
21646	9026	157946	2131	5522	0	174625
21647	158774	8065	2550	4611	0	174000
21648	9538	157647	3054	4054	0	174293
21649	5963	8285	3079	158585	0	175912
21650	158312	4269	2751	9331	0	174663
21651	162600	3520	2759	6170	0	175049
21652	9796	3177	2504	159975	0	175452
21653	5942	3053	2270	161717	0	172982
21654	5076	153663	1814	11431	0	171984
21655	5169	7379	1487	158756	0	172791
21656	5148	4096	1106	162261	0	172611
21657	4999	4370	963	159571	0	169903
21658	4261	147558	1070	12062	0	164951
21659	137841	6661	1005	7321	0	152828
21660	7055	140023	849	5855	0	153782
21661	136700	7397	991	4627	0	149715
21662	8136	136307	1062	3774	0	149279
21663	5852	7443	130489	3239	0	147023
21664	5343	5014	5084	130392	0	145833
21665	4424	3897	127273	6378	0	141972
21666	4007	3645	127258	3623	0	138533
21667	4262	3543	6784	124602	0	139191
21668	4116	2759	125083	6461	0	138419
21669	4398	2440	6331	123757	0	136926
21670	4607	2336	3353	125910	0	136206
21671	4120	2546	2284	129209	0	138159
21672	124273	2786	1705	9120	0	137884
21673	7357	2678	1220	125735	0	136990
21674	5299	2634	942	126953	0	135828
21675	119197	2074	662	9125	0	131058
21676	7475	114239	642	6127	0	128483
21677	4758	108575	523	5123	0	118979
21678	4423	111762	445	3983	0	120613
21679	3190	7992	786	88876	0	100844
21680	2257	2489	87948	4426	0	97120
21681	75034	2528	2905	2507	0	82974
21682	3072	76824	1032	1511	0	82439
21683	71899	2609	787	1177	0	76472
21684	72628	1361	401	790	0	75180
21685	72780	1261	305	705	0	75051
21686	3186	1262	70367	721	0	75536
21687	1939	1170	1705	71134	0	75948
21688	1692	941	874	72824	0	76331
21689	1718	738	583	73436	0	76475
21690	1559	702	550	71373	0	74184
21691	1247	68671	443	2988	0	73349
21692	69350	1936	359	1795	0	73440
21693	2042	1080	65196	1093	0	69411
21694	63021	649	1341	1017	0	66028
21695	2307	1551	601	59275	0	63734
21696	1260	57695	274	1972	0	61201
21697	924	60297	212	1219	0	62652
21698	1238	3580	381	54931	0	60130
21699	681	55297	257	1640	0	57875
21700	49211	861	256	692	0	51020
21701	866	421	46903	431	0	48621
21702	436	321	576	45559	0	46892
21703	229	170	220	46790	0	47409
21704	199	161	114	47396	0	47870
21705	197	159	104	47106	0	47566
21706	47162	140	92	936	0	48330
21707	631	48047	86	420	0	49184
21708	51521	651	84	377	0	52633
21709	953	315	67	52976	0	54311
21710	494	193	86	54809	0	55582
21711	293	56263	100	1271	0	57927
21712	57927	938	107	755	0	59727
21713	59099	399	84	521	0	60103
21714	1361	58144	86	312	0	59903
21715	639	1073	63	55427	0	57202
21716	330	57126	79	1012	0	58547
21717	56962	1145	109	544	0	58760
21718	1129	486	56634	304	0	58553
21719	501	331	54853	228	0	55913
21720	53432	189	1179	337	0	55137
21721	1012	54668	489	225	0	56394
21722	494	986	256	54993	0	56729
21723	386	422	159	55468	0	56435
21724	242	300	55118	1328	0	56988
21725	292	192	941	55001	0	56426
21726	302	146	365	56007	0	56820
21727	177	54687	235	1407	0	56506
21728	217	997	128	55578	0	56920
21729	219	446	105	55816	0	56586
21730	54230	264	111	1536	0	56141
21731	991	52798	170	695	0	54654
21732	417	53847	148	483	0	54895
21733	359	1193	123	54155	0	55830
21734	274	548	99	55163	0	56084
21735	266	312	81	54797	0	55456
21736	149	53428	108	1538	0	55223
21737	244	986	91	54913	0	56234
21738	229	445	81	54872	0	55627
21739	259	294	55	55287	0	55895
21740	218	219	48	55048	0	55533
21741	155	51880	103	1701	0	53839
21742	124	55303	92	850	0	56369
21743	54464	1258	52	627	0	56401
21744	55091	533	72	481	0	56177
21745	1481	390	46	54757	0	56674
21746	607	270	54515	1315	0	56707
21747	478	272	1009	54931	0	56690
21748	354	218	333	55455	0	56360
21749	53779	214	217	1716	0	55926
21750	1145	54934	173	746	0	56998
21751	582	1080	94	55410	0	57166
21752	404	482	90	56265	0	57241
21753	288	336	54243	1622	0	56489
21754	222	283	54827	843	0	56175
21755	251	243	1327	54888	0	56709
21756	275	256	540	54863	0	55934
21757	191	53503	341	1589	0	55624
21758	176	55274	223	865	0	56538
21759	54578	1316	168	716	0	56778
21760	1147	590	207	55360	0	57304
21761	480	376	54793	1282	0	56931
21762	292	54605	928	752	0	56577
21763	305	1069	430	55824	0	57628
21764	55462	518	234	1431	0	57645
21765	1030	355	156	56422	0	57963
21766	55335	234	138	1585	0	57292
21767	1129	55681	129	800	0	57739
21768	55250	1104	122	675	0	57151
21769	1282	518	91	56293	0	58184
21770	545	388	58132	1400	0	60465
21771	466	317	1122	58046	0	59951
21772	275	59589	433	1561	0	61858
21773	322	1406	271	60767	0	62766
21774	227	62511	205	1725	0	64668
21775	338	1586	151	65159	0	67234
21776	224	646	63454	1967	0	66291
21777	285	468	61980	975	0	63708
21778	226	385	63417	757	0	64785
21779	62584	302	1870	734	0	65490
21780	1497	62627	783	592	0	65499
21781	641	65051	483	494	0	66669
21782	63427	1825	310	612	0	66174
21783	64352	778	270	574	0	65974
21784	1959	550	251	63265	0	66025
21785	840	386	62968	1756	0	65950
21786	619	352	60930	827	0	62728
21787	459	307	1802	61553	0	64121
21788	61399	291	746	1963	0	64399
21789	1476	61105	512	940	0	64033
21790	692	1524	367	62285	0	64868
21791	61427	607	298	2055	0	64387
21792	61998	428	308	1067	0	63801
21793	1841	363	60552	782	0	63538
21794	59460	355	1414	787	0	62016
21795	1869	324	61663	561	0	64417
21796	850	343	62463	525	0	64181
21797	714	324	1876	60383	0	63297
21798	536	284	810	61632	0	63262
21799	465	308	532	62813	0	64118
21800	387	317	60282	2287	0	63273
21801	60255	317	1449	1232	0	63253
21802	1689	286	617	63085	0	65677
21803	61481	295	473	2059	0	64308
21804	62026	299	350	1137	0	63812
21805	2055	61216	347	834	0	64452
21806	908	62872	389	708	0	64877
21807	599	63303	375	575	0	64852
21808	729	2054	497	58204	0	61484
21809	384	630	57897	1440	0	60351
21810	498	1553	1249	54363	0	57663
21811	335	54278	551	1323	0	56487
21812	262	54738	311	575	0	55886
21813	441	1371	267	54145	0	56224
21814	53288	499	222	1338	0	55347
21815	1163	52126	251	587	0	54127
21816	456	53173	237	436	0	54302
21817	54055	1280	219	506	0	56060
21818	1281	516	200	54109	0	56106
21819	567	365	161	54587	0	55680
21820	453	244	156	55688	0	56541
21821	53613	217	158	1661	0	55649
21822	54500	217	191	789	0	55697
21823	1536	171	208	54141	0	56056
21824	682	224	52314	1304	0	54524
21825	52550	178	1112	680	0	54520
21826	1361	169	424	53679	0	55633
21827	578	209	52711	1357	0	54855
21828	425	214	52524	637	0	53800
21829	402	214	1371	54142	0	56129
21830	325	152	56035	1458	0	57970
21831	455	167	1372	59275	0	61269
21832	523	240	590	58082	0	59435
21833	377	209	370	63884	0	64840
21834	62361	208	312	2308	0	65189
21835	1683	204	251	62973	0	65111
21836	788	235	247	64022	0	65292
21837	514	301	256	64072	0	65143
21838	475	292	260	64215	0	65242
21839	332	297	60603	2394	0	63626
21840	294	60565	1459	1206	0	63524
21841	343	1458	525	60464	0	62790
21842	310	676	381	59739	0	61106
21843	265	56940	352	1918	0	59475
21844	262	60455	310	903	0	61930
21845	59296	1646	304	840	0	62086
21846	1432	58225	276	591	0	60524
21847	667	1580	236	58177	0	60660
21848	478	612	58044	1640	0	60774
21849	56756	425	1283	828	0	59292
21850	1506	382	56405	665	0	58958
21851	56317	238	1468	674	0	58697
21852	57547	162	562	615	0	58886
21853	1881	179	57027	555	0	59642
21854	914	171	1489	54655	0	57229
21855	655	55150	617	1627	0	58049
21856	524	1316	466	59189	0	61495
21857	60363	416	398	1966	0	63143
21858	61824	281	312	1034	0	63451
21859	1923	60608	357	783	0	63671
21860	61233	1432	331	821	0	63817
21861	1971	522	295	59993	0	62781
21862	59952	313	288	2057	0	62610
21863	61353	246	283	1065	0	62947
21864	2185	245	204	60414	0	63048
21865	60171	260	218	2110	0	62759
21866	58511	237	227	1213	0	60188
21867	1955	279	57941	889	0	61064
21868	57826	274	1354	887	0	60341
21869	1921	287	57016	685	0	59909
21870	772	249	54062	558	0	55641
21871	560	55208	1561	591	0	57920
21872	716	1400	781	52724	0	55621
21873	390	439	53575	1296	0	55700
21874	406	358	51739	642	0	53145
21875	52741	387	1328	543	0	54999
21876	1180	239	528	53076	0	55023
21877	508	199	354	54814	0	55875
21878	422	176	261	55437	0	56296
21879	362	232	209	55456	0	56259
21880	349	220	194	55963	0	56726
21881	378	190	54346	1673	0	56587
21882	396	198	53915	789	0	55298
21883	394	192	1239	55205	0	57030
21884	54650	173	494	1459	0	56776
21885	1201	53875	378	719	0	56173
21886	616	1026	280	54667	0	56589
21887	54391	315	248	1477	0	56431
21888	1306	53963	296	718	0	56283
21889	681	1068	230	55118	0	57097
21890	624	376	235	56202	0	57437
21891	477	257	259	56158	0	57151
21892	55067	194	221	1787	0	57269
21893	1320	164	53815	924	0	56223
21894	54498	150	1129	770	0	56547
21895	1466	156	455	55457	0	57534
21896	666	146	354	54476	0	55642
21897	514	54070	345	1693	0	56622
21898	426	1034	53445	894	0	55799
21899	53714	333	1115	845	0	56007
21900	55647	262	471	741	0	57121
21901	1512	214	54300	629	0	56655
21902	52797	192	1167	636	0	54792
21903	1396	54216	492	580	0	56684
21904	637	55129	365	580	0	56711
21905	504	55797	338	489	0	57128
21906	53895	1385	419	488	0	56187
21907	1302	547	53611	431	0	55891
21908	664	823	1025	51739	0	54251
21909	426	50748	458	1139	0	52771
21910	365	51802	337	525	0	53029
21911	410	52205	284	398	0	53297
21912	962	1532	340	42588	0	45422
21913	49961	442	225	1170	0	51798
21914	1033	50358	182	526	0	52099
21915	479	951	157	51167	0	52754
21916	405	349	157	51907	0	52818
21917	50326	280	190	1296	0	52092
21918	1120	227	194	50468	0	52009
21919	584	186	163	51690	0	52623
21920	448	208	50826	1339	0	52821
21921	447	221	863	50856	0	52387
21922	406	161	335	52710	0	53612
21923	51966	151	237	1387	0	53741
21924	52365	136	179	678	0	53358
21925	1304	144	192	52237	0	53877
21926	50004	139	178	1328	0	51649
21927	51729	158	172	610	0	52669
21928	1283	51019	245	435	0	52982
21929	630	871	49970	310	0	51781
21930	486	48358	918	290	0	50052
21931	665	1445	465	44648	0	47223
21932	43448	296	437	674	0	44855
21933	472	42711	122	255	0	43560
21934	227	453	120	43284	0	44084
21935	43057	162	120	615	0	43954
21936	42928	133	98	303	0	43462
21937	593	117	75	42969	0	43754
21938	214	131	44157	621	0	45123
21939	205	90	390	45046	0	45731
21940	190	103	101	46029	0	46423
21941	147	99	45591	654	0	46491
21942	189	85	420	45298	0	45992
21943	181	71	169	45847	0	46268
21944	47313	57	118	783	0	48271
21945	499	76	84	47937	0	48596
21946	237	82	80	48197	0	48596
21947	47399	72	71	773	0	48315
21948	46938	59	58	436	0	47491
21949	46865	86	83	319	0	47353
21950	655	98	46103	232	0	47088
21951	310	199	425	45786	0	46720
21952	219	46283	157	549	0	47208
21953	242	502	102	48121	0	48967
21954	223	182	49279	570	0	50254
21955	393	370	477	46322	0	47562
21956	201	131	47631	522	0	48485
21957	44808	132	536	254	0	45730
21958	45844	34	153	228	0	46259
21959	463	48	67	46964	0	47542
21960	221	44	39	47147	0	47451
21961	160	47	54	47340	0	47601
21962	90	48290	61	464	0	48905
21963	48931	294	38	363	0	49626
21964	49529	84	41	303	0	49957
21965	458	71	42	49395	0	49966
21966	188	38	41	49375	0	49642
21967	148	36	31	49635	0	49850
21968	139	27	48	49620	0	49834
21969	115	47	48754	494	0	49410
21970	141	22	303	49152	0	49618
21971	48217	21	85	580	0	48903
21972	48082	20	65	282	0	48449
21973	411	37	41	47196	0	47685
21974	171	55	45985	403	0	46614
21975	44337	33	294	283	0	44947
21976	426	146	96	46019	0	46687
21977	162	44561	104	453	0	45280
21978	104	46224	60	192	0	46580
21979	47178	394	94	338	0	48004
21980	459	131	51	47709	0	48350
21981	196	72	34	48633	0	48935
21982	158	25	18	50296	0	50497
21983	139	23	38	50457	0	50657
21984	135	30	28	52195	0	52388
21985	70	46	51602	812	0	52530
21986	104	47	50772	348	0	51271
21987	96	52	51250	223	0	51621
21988	117	19	798	51378	0	52312
21989	97	40	52717	711	0	53565
21990	138	25	730	52121	0	53014
21991	152	20	257	52312	0	52741
21992	135	17	180	54066	0	54398
21993	54180	19	128	1235	0	55562
21994	762	34	112	55350	0	56258
21995	316	62	133	56274	0	56785
21996	55621	17	142	1174	0	56954
21997	769	55010	155	518	0	56452
21998	265	56895	139	350	0	57649
21999	57107	945	80	428	0	58560
22000	812	57866	88	293	0	59059
22001	57748	927	121	425	0	59221
22002	58538	293	85	373	0	59289
22003	58376	181	45	369	0	58971
22004	57483	102	47	366	0	57998
22005	58044	88	37	320	0	58489
22006	1257	56957	61	210	0	58485
22007	57315	879	46	264	0	58504
22008	58172	324	52	276	0	58824
22009	1234	58349	79	173	0	59835
22010	62605	881	73	351	0	63910
22011	64288	328	70	295	0	64981
22012	69136	218	71	257	0	69682
22013	71976	138	46	326	0	72486
22014	2538	190	73461	170	0	76359
22015	1314	168	1836	78016	0	81334
22016	914	141	571	81440	0	83066
22017	517	197	79626	2724	0	83064
22018	551	222	78024	1049	0	79846
22019	78607	134	2679	741	0	82161
22020	2670	182	982	79581	0	83415
22021	1097	135	80018	2239	0	83489
22022	829	191	79347	782	0	81149
22023	78813	132	2901	704	0	82550
22024	81567	91	1083	594	0	83335
22025	81852	107	651	525	0	83135
22026	3381	118	79370	304	0	83173
22027	1768	77	2335	78941	0	83121
22028	1088	143	79895	2295	0	83421
22029	79280	77	2670	1052	0	83079
22030	2770	155	80953	647	0	84525
22031	1326	166	2834	79322	0	83648
22032	1226	132	1053	80317	0	82728
22033	728	80690	835	2770	0	85023
22034	82308	2227	543	1344	0	86422
22035	2827	701	81772	773	0	86073
22036	82358	410	2665	730	0	86163
22037	3141	252	84039	500	0	87932
22038	1615	169	2962	81254	0	86000
22039	1241	151	1255	83414	0	86061
22040	1049	121	901	84245	0	86316
22041	81853	111	632	3705	0	86301
22042	3266	169	544	80844	0	84823
22043	1627	157	583	82565	0	84932
22044	1131	79022	601	3430	0	84184
22045	1155	2265	562	80735	0	84717
22046	79142	715	619	3499	0	83975
22047	2970	507	78769	1478	0	83724
22048	1565	286	2710	78952	0	83513
22049	1151	245	78918	3190	0	83504
22050	969	76372	3116	1517	0	81974
22051	903	2218	78659	1215	0	82995
22052	77103	877	3271	1295	0	82546
22053	79966	495	1463	1067	0	82991
22054	3668	315	1201	76663	0	81847
22055	77477	275	964	3211	0	81927
22056	78841	173	939	1663	0	81616
22057	3976	172	926	77256	0	82330
22058	2121	204	918	79367	0	82610
22059	1454	270	76205	3723	0	81652
22060	1226	74974	2980	1866	0	81046
22061	75552	2295	1380	1578	0	80805
22062	3243	73785	1131	1161	0	79320
22063	1837	2728	877	74269	0	79711
22064	1646	935	797	75911	0	79289
22065	1462	660	790	76284	0	79196
22066	1316	456	825	76454	0	79051
22067	996	392	72541	4294	0	78223
22068	71623	301	3041	2254	0	77219
22069	75106	349	1447	1706	0	78608
22070	3932	347	1124	73131	0	78534
22071	73568	340	831	3572	0	78311
22072	3796	367	759	73741	0	78663
22073	1944	388	71812	3872	0	78016
22074	1705	347	2818	72012	0	76882
22075	1348	70471	1283	3847	0	76949
22076	1221	2291	1089	70884	0	75485
22077	1123	70625	882	3704	0	76334
22078	1141	2643	893	69234	0	73911
22079	948	69662	772	3803	0	75185
22080	68531	2725	772	2154	0	74182
22081	3080	1067	67516	1836	0	73499
22082	1511	63756	2657	1636	0	69560
22083	1258	66284	1346	1512	0	70400
22084	1485	2661	1475	63825	0	69446
22085	1222	970	927	64856	0	67975
22086	1185	654	868	65161	0	67868
22087	1150	523	820	65457	0	67950
22088	1073	61672	856	3762	0	67363
22089	1111	2150	816	62928	0	67005
22090	1180	859	758	63844	0	66641
22091	61013	710	687	3557	0	65967
22092	2888	565	649	61855	0	65957
22093	1473	529	59499	3445	0	64946
22094	1162	520	58796	2014	0	62492
22095	57137	516	2473	1900	0	62026
22096	2467	57258	1199	1567	0	62491
22097	1152	58867	785	1510	0	62314
22098	1223	2464	836	56856	0	61379
22099	876	1140	575	58494	0	61085
22100	775	809	55187	3235	0	60006
22101	54102	688	2009	1950	0	58749
22102	56543	530	891	1666	0	59630
22103	2686	455	56277	1563	0	60981
22104	1352	429	55507	1485	0	58773
22105	55748	378	2375	1584	0	60085
22106	58462	393	1111	1479	0	61445
22107	58475	447	734	1369	0	61025
22108	57571	437	580	1345	0	59933
22109	3023	53858	463	1218	0	58562
22110	50611	1662	422	977	0	53672
22111	2286	586	47579	1011	0	51462
22112	872	438	42961	700	0	44971
22113	736	388	42831	620	0	44575
22114	901	2978	1674	32512	0	38065
22115	32046	92	671	553	0	33362
22116	32010	84	103	245	0	32442
22117	472	80	74	31984	0	32610
22118	261	87	73	31003	0	31424
22119	158	82	69	32434	0	32743
22120	118	33535	85	546	0	34284
22121	34214	346	76	347	0	34983
22122	34598	106	76	297	0	35077
22123	34868	88	75	237	0	35268
22124	34862	56	84	213	0	35215
22125	34956	68	55	209	0	35288
22126	559	58	64	34073	0	34754
22127	211	33353	75	485	0	34124
22128	287	373	52	32544	0	33256
22129	165	275	51	32868	0	33359
22130	32351	70	61	430	0	32912
22131	337	53	31496	160	0	32046
22132	156	59	29778	95	0	30088
22133	141	96	29895	82	0	30214
22134	31759	32	297	113	0	32201
22135	32482	23	289	111	0	32905
22136	271	72	55	33009	0	33407
22137	120	16	33	32455	0	32624
22138	75	20	27	33285	0	33407
22139	49	23	33538	281	0	33891
22140	86	22	217	32914	0	33239
22141	51	21	35435	257	0	35764
22142	88	16	239	35464	0	35807
22143	71	15	64	35820	0	35970
22144	70	19	43	36861	0	36993
22145	36862	17	23	387	0	37289
22146	37038	12	24	208	0	37282
22147	295	28	36823	94	0	37240
22148	36648	15	222	139	0	37024
22149	37396	11	77	111	0	37595
22150	329	9	54	37302	0	37694
22151	37853	5	40	314	0	38212
22152	291	8	41	38356	0	38696
22153	141	10	33	38705	0	38889
22154	86	28	37760	364	0	38238
22155	36650	10	225	229	0	37114
22156	309	21	84	38465	0	38879
22157	120	16	38616	297	0	39049
22158	126	47	39787	131	0	40091
22159	158	26	321	39635	0	40140
22160	122	14	136	40389	0	40661
22161	41466	4	61	440	0	41971
22162	289	8	57	41882	0	42236
22163	163	4	60	42070	0	42297
22164	117	6	40	42870	0	43033
22165	107	2	47	44878	0	45034
22166	46443	4	63	629	0	47139
22167	46801	2	65	383	0	47251
22168	48082	13	60	256	0	48411
22169	49148	4	58	232	0	49442
22170	778	11	43	50526	0	51358
22171	51498	3	52	749	0	52302
22172	777	10	53	51732	0	52572
22173	52400	2	46	844	0	53292
22174	825	6	57	52460	0	53348
22175	427	3	58	52585	0	53073
22176	222	52297	79	900	0	53498
22177	198	575	45	53140	0	53958
22178	52570	216	54	905	0	53745
22179	52074	75	35	530	0	52714
22180	941	48	52029	244	0	53262
22181	410	52263	643	200	0	53516
22182	52939	593	278	289	0	54099
22183	767	53711	130	200	0	54808
22184	54015	667	88	328	0	55098
22185	816	55867	103	191	0	56977
22186	387	728	56375	188	0	57678
22187	232	56143	681	259	0	57315
22188	184	56963	289	208	0	57644
22189	215	811	122	59056	0	60204
22190	59989	327	63	996	0	61375
22191	839	126	67	60557	0	61589
22192	443	97	51	61005	0	61596
22193	60348	89	42	1231	0	61710
22194	61662	66	46	696	0	62470
22195	1205	58	45	61832	0	63140
22196	599	55	60	62100	0	62814
22197	365	84	57	62427	0	62933
22198	61123	77	68	1292	0	62560
22199	944	90	60869	526	0	62429
22200	554	84	687	61128	0	62453
22201	317	90	62777	938	0	64122
22202	237	61605	797	515	0	63154
22203	245	745	61093	316	0	62399
22204	309	335	824	60478	0	61946
22205	218	179	61123	930	0	62450
22206	59622	110	814	609	0	61155
22207	917	119	328	61686	0	63050
22208	476	62805	203	937	0	64421
22209	370	749	101	63760	0	64980
22210	267	62682	137	995	0	64081
22211	297	63017	120	521	0	63955
22212	263	63765	95	402	0	64525
22213	309	952	96	61557	0	62914
22214	241	62284	99	883	0	63507
22215	62110	830	102	587	0	63629
22216	903	414	60396	351	0	62064
22217	530	275	58470	329	0	59604
22218	376	217	60780	310	0	61683
22219	320	145	965	62285	0	63715
22220	350	135	404	60386	0	61275
22221	372	128	211	60438	0	61149
22222	348	122	166	61007	0	61643
22223	487	181	145	58713	0	59526
22224	380	61231	137	1274	0	63022
22225	369	822	60414	638	0	62243
22226	397	433	59158	454	0	60442
22227	346	61582	965	413	0	63306
22228	380	803	433	63207	0	64823
22229	371	406	218	64055	0	65050
22230	341	269	183	63854	0	64647
22231	63040	217	147	1471	0	64875
22232	970	262	62301	746	0	64279
22233	61341	218	766	644	0	62969
22234	62492	205	347	592	0	63636
22235	1174	60646	230	482	0	62532
22236	612	62138	172	395	0	63317
22237	63033	1028	231	478	0	64770
22238	1060	505	189	63512	0	65266
22239	617	318	152	65470	0	66557
22240	405	286	66561	1333	0	68585
22241	324	330	65013	632	0	66299
22242	404	548	1161	67073	0	69186
22243	68320	299	550	1304	0	70473
22244	1148	325	70678	629	0	72780
22245	71940	286	1213	620	0	74059
22246	1409	292	536	74494	0	76731
22247	720	257	308	77903	0	79188
22248	553	266	229	80456	0	81504
22249	358	267	79443	2067	0	82135
22250	325	76826	1435	998	0	79584
22251	325	81431	551	676	0	82983
22252	81791	1711	299	717	0	84518
22253	84084	588	237	636	0	85545
22254	2095	309	217	84028	0	86649
22255	84655	195	230	2046	0	87126
22256	1921	198	82606	851	0	85576
22257	758	216	82223	586	0	83783
22258	560	213	1918	81201	0	83892
22259	83484	161	775	2036	0	86456
22260	1794	203	449	84458	0	86904
22261	814	158	370	86500	0	87842
22262	84796	185	339	2582	0	87902
22263	86764	199	340	1184	0	88487
22264	2210	88297	335	750	0	91592
22265	88671	1778	297	583	0	91329
22266	2326	833	262	86604	0	90025
22267	693	87391	256	2055	0	90395
22268	87723	1778	233	861	0	90595
22269	2023	87784	265	564	0	90636
22270	790	2007	234	87043	0	90074
22271	86762	418	225	2015	0	89420
22272	1951	277	85341	573	0	88142
22273	592	235	84875	409	0	86111
22274	714	344	1922	83518	0	86498
22275	491	196	535	86318	0	87540
22276	487	155	286	84805	0	85733
22277	352	85196	228	1988	0	87764
22278	88221	1820	152	842	0	91035
22279	89393	510	144	686	0	90733
22280	90043	324	148	596	0	91111
22281	2401	91394	181	404	0	94380
22282	1056	2022	142	97327	0	100547
22283	730	545	156	99148	0	100579
22284	614	363	169	99791	0	100937
22285	94277	252	156	3296	0	97981
22286	2358	93778	217	1112	0	97465
22287	967	2183	178	94865	0	98193
22288	738	611	125	96718	0	98192
22289	501	434	92443	3003	0	96381
22290	445	91743	2090	1155	0	95433
22291	613	2355	539	92447	0	95954
22292	692	683	299	94348	0	96022
22293	662	433	188	94209	0	95492
22294	89943	335	170	3395	0	93843
22295	2420	89827	202	1393	0	93842
22296	90976	2314	171	1093	0	94554
22297	2849	720	196	90865	0	94630
22298	91443	493	189	2915	0	95040
22299	2777	472	89111	1162	0	93522
22300	90496	366	2201	1096	0	94159
22301	91765	346	620	1017	0	93748
22302	3072	405	89593	780	0	93850
22303	1349	378	2219	90629	0	94575
22304	1079	387	674	90396	0	92536
22305	92677	343	438	3505	0	96963
22306	2822	349	325	93644	0	97140
22307	1332	339	294	94119	0	96084
22308	979	363	290	94584	0	96216
22309	860	378	90411	3480	0	95129
22310	87665	303	2330	1693	0	91991
22311	2787	91759	749	1153	0	96448
22312	1316	2419	475	92082	0	96292
22313	945	91619	414	2919	0	95897
22314	757	96578	359	1422	0	99116
22315	805	3004	280	96646	0	100735
22316	743	1003	95418	3349	0	100513
22317	740	717	96122	1505	0	99084
22318	875	516	2960	97605	0	101956
22319	772	488	96917	3430	0	101607
22320	96606	480	2807	1672	0	101565
22321	3059	489	913	99963	0	104424
22322	1282	442	587	101732	0	104043
22323	887	99465	500	3913	0	104765
22324	845	2750	434	100873	0	104902
22325	815	982	397	101271	0	103465
22326	659	97638	440	4018	0	102755
22327	756	2741	432	100957	0	104886
22328	771	965	420	101551	0	103707
22329	713	98662	502	4096	0	103973
22330	99517	2751	452	2029	0	104749
22331	3119	1014	98370	1465	0	103968
22332	1316	737	97576	1230	0	100859
22333	1098	1003	3101	97575	0	102777
22334	888	762	1120	100649	0	103419
22335	728	540	97381	4081	0	102730
22336	699	545	95466	1986	0	98696
22337	90966	601	3059	1761	0	96387
22338	2782	95050	1101	1416	0	100349
22339	94494	2584	701	1448	0	99227
22340	3046	884	92249	1262	0	97441
22341	1122	92277	2629	1213	0	97241
22342	1081	3077	1054	93986	0	99198
22343	711	991	94988	3336	0	100026
22344	604	649	92827	1498	0	95578
22345	929	1234	3099	93069	0	98331
22346	578	538	93249	3351	0	97716
22347	459	90319	2762	1539	0	95079
22348	681	2589	1097	90269	0	94636
22349	585	887	90708	2947	0	95127
22350	514	91286	2630	1395	0	95825
22351	90850	2545	1108	1178	0	95681
22352	2726	960	89206	875	0	93767
22353	1017	89398	2559	875	0	93849
22354	962	2578	1157	88774	0	93471
22355	610	985	775	92876	0	95246
22356	90878	654	609	3551	0	95692
22357	2757	449	598	90810	0	94614
22358	1148	430	565	91873	0	94016
22359	88548	471	528	3656	0	93203
22360	2681	443	437	88581	0	92142
22361	984	422	85820	3190	0	90416
22362	914	696	2377	85863	0	89850
22363	495	353	85162	3173	0	89183
22364	502	316	80768	1486	0	83072
22365	465	370	82164	1045	0	84044
22366	730	534	2773	78349	0	82386
22367	477	259	1328	81382	0	83446
22368	79729	271	678	2894	0	83572
22369	1972	273	543	78267	0	81055
22370	849	79679	552	2483	0	83563
22371	620	1730	500	83455	0	86305
22372	448	688	569	83122	0	84827
22373	265	81947	563	2795	0	85570
22374	82224	1786	509	1587	0	86106
22375	81802	710	516	1226	0	84254
22376	2248	79780	580	921	0	83529
22377	857	80628	459	817	0	82761
22378	967	3481	716	77788	0	82952
22379	78847	948	737	2180	0	82712
22380	1910	602	78346	1149	0	82007
22381	821	483	72447	842	0	74593
22382	68307	363	1678	562	0	70910
22383	1373	70401	785	465	0	73024
22384	687	1409	479	70868	0	73443
22385	580	663	375	70308	0	71926
22386	440	383	318	71864	0	73005
22387	380	270	291	72343	0	73284
22388	297	70382	324	2020	0	73023
22389	307	1244	265	72658	0	74474
22390	71988	556	227	1922	0	74693
22391	1448	405	240	73271	0	75364
22392	627	288	258	74312	0	75485
22393	73864	241	228	2234	0	76567
22394	74592	217	262	1241	0	76312
22395	75616	210	234	938	0	76998
22396	76218	201	249	744	0	77412
22397	2132	223	231	74997	0	77583
22398	75258	164	248	1810	0	77480
22399	1775	180	233	74912	0	77100
22400	74193	145	248	1969	0	76555
22401	74613	155	249	1029	0	76046
22402	2067	166	220	74002	0	76455
22403	988	212	73458	1699	0	76357
22404	74012	186	1321	1069	0	76588
22405	75831	174	581	869	0	77455
22406	75617	182	404	727	0	76930
22407	76028	166	265	672	0	77131
22408	2271	222	256	75185	0	77934
22409	1126	223	74247	1626	0	77222
22410	854	289	71959	863	0	73965
22411	72916	247	1693	885	0	75741
22412	75470	218	784	646	0	77118
22413	1867	72905	461	533	0	75766
22414	877	73215	304	466	0	74862
22415	74591	1346	394	544	0	76875
22416	1588	586	289	72886	0	75349
22417	863	415	254	74713	0	76245
22418	73729	226	246	1781	0	75982
22419	1400	73986	211	828	0	76425
22420	76080	1134	137	811	0	78162
22421	1574	493	74292	482	0	76841
22422	74225	323	1028	615	0	76191
22423	1552	279	447	74481	0	76759
22424	784	196	75159	1372	0	77511
22425	591	75322	1072	775	0	77760
22426	622	1091	507	77848	0	80068
22427	520	462	79963	1379	0	82324
22428	605	385	1156	79740	0	81886
22429	82000	140	582	1748	0	84470
22430	1457	191	80565	819	0	83032
22431	79553	129	1284	772	0	81738
22432	1582	81766	660	535	0	84543
22433	949	1184	412	84084	0	86629
22434	680	545	87016	1460	0	89701
22435	684	357	1268	86369	0	88678
22436	549	228	88678	1615	0	91070
22437	481	86811	1364	884	0	89540
22438	86521	1154	649	728	0	89052
22439	1335	88710	447	459	0	90951
22440	835	1308	286	88555	0	90984
22441	626	620	277	88944	0	90467
22442	424	411	85259	1645	0	87739
22443	74550	295	1121	1090	0	77056
22444	1256	80833	591	576	0	83256
22445	517	76904	274	338	0	78033
22446	329	78723	202	325	0	79579
22447	611	1690	474	76311	0	79086
22448	242	76281	261	875	0	77659
22449	423	1108	190	75161	0	76882
22450	163	74924	157	837	0	76081
22451	230	965	89	74162	0	75446
22452	162	75684	96	720	0	76662
22453	75530	747	121	541	0	76939
22454	680	382	74265	257	0	75584
22455	72300	298	699	353	0	73650
22456	75411	129	299	341	0	76180
22457	76559	160	144	309	0	77172
22458	873	76074	125	147	0	77219
22459	77744	610	122	283	0	78759
22460	77821	260	104	268	0	78453
22461	78455	151	104	255	0	78965
22462	1059	148	76598	125	0	77930
22463	595	138	576	77863	0	79172
22464	290	140	80030	710	0	81170
22465	357	115	720	78288	0	79480
22466	79603	107	314	974	0	80998
22467	815	78622	232	392	0	80061
22468	407	764	86013	238	0	87422
22469	548	348	1086	85717	0	87699
22470	310	176	380	92184	0	93050
22471	198	169	98964	1657	0	100988
22472	96805	145	1762	726	0	99438
22473	101893	146	561	480	0	103080
22474	104415	117	255	392	0	105179
22475	2676	121	176	102959	0	105932
22476	880	98846	246	2010	0	101982
22477	504	105046	192	733	0	106475
22478	592	2252	184	104558	0	107586
22479	577	845	139	104354	0	105915
22480	271	102755	152	2354	0	105532
22481	103107	1877	126	1036	0	106146
22482	1944	102465	165	482	0	105056
22483	844	2008	109	102011	0	104972
22484	401	759	100852	1996	0	104008
22485	516	403	1833	100174	0	102926
22486	101528	272	586	2392	0	104778
22487	2057	312	100373	808	0	103550
22488	101311	250	1946	647	0	104154
22489	105005	217	769	598	0	106589
22490	106210	224	347	549	0	107330
22491	106290	172	241	614	0	107317
22492	108938	197	253	526	0	109914
22493	3035	234	103056	277	0	106602
22494	1392	304	102033	233	0	103962
22495	110947	181	2525	454	0	114107
22496	116214	188	849	355	0	117606
22497	3554	198	400	118219	0	122371
22498	1361	118286	371	2683	0	122701
22499	1032	2605	263	122473	0	126373
22500	124441	945	233	3269	0	128888
22501	3357	490	207	121235	0	125289
22502	1329	124735	241	2972	0	129277
22503	125965	2809	170	1537	0	130481
22504	124646	1032	199	1040	0	126917
22505	125614	542	216	930	0	127302
22506	4022	122231	248	510	0	127011
22507	2054	2734	219	123425	0	128432
22508	1440	1046	185	123534	0	126205
22509	964	118296	231	3640	0	123131
22510	1079	2862	159	122456	0	126556
22511	120750	1110	170	3684	0	125714
22512	122150	626	171	1743	0	124690
22513	3954	118648	263	972	0	123837
22514	1934	2872	192	120369	0	125367
22515	1358	1087	246	122314	0	125005
22516	1145	648	286	123218	0	125297
22517	118546	486	280	4485	0	123797
22518	3474	518	115406	1914	0	121312
22519	113774	430	2712	1494	0	118410
22520	3816	505	115243	1117	0	120681
22521	2153	621	2928	111952	0	117654
22522	1392	111303	1260	3255	0	117210
22523	1173	117977	647	1694	0	121491
22524	114724	3821	547	1436	0	120528
22525	115009	1620	427	1485	0	118541
22526	4114	110381	368	1178	0	116041
22527	1790	111547	332	1077	0	114746
22528	111972	3739	459	1133	0	117303
22529	115605	1610	344	1190	0	118749
22530	4303	115432	370	900	0	121005
22531	118572	3351	433	1006	0	123362
22532	4289	1516	115264	756	0	121825
22533	117216	1004	2743	989	0	121952
22534	117749	913	1052	1002	0	120716
22535	4831	799	648	114398	0	120676
22536	2480	112478	601	3439	0	118998
22537	2279	3051	423	114567	0	120320
22538	116707	1223	425	3771	0	122126
22539	4441	836	392	113461	0	119130
22540	2524	768	455	116568	0	120315
22541	1862	710	114802	4421	0	121795
22542	1863	615	2865	116711	0	122054
22543	1662	567	1139	120365	0	123733
22544	118084	621	746	4982	0	124433
22545	3960	726	116353	2252	0	123291
22546	117888	661	3162	1777	0	123488
22547	4307	712	1184	118745	0	124948
22548	2324	708	713	120671	0	124416
22549	1705	844	589	120025	0	123163
22550	1624	113195	464	4649	0	119932
22551	1608	117769	464	2204	0	122045
22552	1712	3766	404	116487	0	122369
22553	116365	1682	372	3976	0	122395
22554	118105	1134	378	2037	0	121654
22555	5021	1009	348	115820	0	122198
22556	116160	870	361	3995	0	121386
22557	4708	759	350	115483	0	121300
22558	2640	792	400	117855	0	121687
22559	111782	695	369	4993	0	117839
22560	4281	115585	417	2372	0	122655
22561	116888	3140	338	1993	0	122359
22562	116937	1313	332	1877	0	120459
22563	115621	806	359	1753	0	118539
22564	4753	112028	339	1498	0	118618
22565	2639	3535	447	113271	0	119892
22566	2074	1474	472	115813	0	119833
22567	1616	867	109988	4616	0	117087
22568	1648	1492	2558	104209	0	109907
22569	1326	630	100858	3636	0	106450
22570	1163	94110	2452	1969	0	99694
22571	880	84766	1090	1245	0	87981
22572	952	86586	616	1014	0	89168
22573	1418	2410	977	87222	0	92027
22574	967	1096	449	88013	0	90525
22575	628	705	223	88271	0	89827
22576	544	639	198	89006	0	90387
22577	547	562	87580	3058	0	91747
22578	551	592	100936	1769	0	103848
22579	738	525	2604	106897	0	110764
22580	867	410	108505	3162	0	112944
22581	108628	324	2616	1836	0	113404
22582	111585	301	1099	1349	0	114334
22583	3391	334	109302	1331	0	114358
22584	1796	263	2564	110456	0	115079
22585	1455	320	1129	112698	0	115602
22586	1278	356	656	114264	0	116554
22587	1386	335	601	112538	0	114860
22588	1206	395	506	113830	0	115937
22589	83880	1007	722	5151	0	90760
22590	110128	412	382	2525	0	113447
22591	3194	108651	330	1939	0	114114
22592	1517	2371	104250	1522	0	109660
22593	972	102754	2287	1419	0	107432
22594	843	105267	932	1338	0	108380
22595	98658	2482	629	1108	0	102877
22596	2140	97241	558	947	0	100886
22597	789	93236	407	522	0	94954
22598	91559	2114	595	628	0	94896
22599	1861	877	90080	444	0	93262
22600	87826	579	1557	561	0	90523
22601	1897	463	573	90254	0	93187
22602	937	376	268	88552	0	90133
22603	619	296	305	89557	0	90777
22604	524	234	86522	2353	0	89633
22605	454	86929	1597	1215	0	90195
22606	87694	1460	605	1069	0	90828
22607	1748	523	505	88736	0	91512
22608	645	88600	419	2289	0	91953
22609	533	1754	536	92055	0	94878
22610	667	764	91114	2132	0	94677
22611	843	543	1752	92177	0	95315
22612	675	505	748	94730	0	96658
22613	584	412	378	95568	0	96942
22614	93535	377	355	3209	0	97476
22615	2098	257	427	95030	0	97812
22616	796	254	93020	3113	0	97183
22617	574	92929	1900	1794	0	97197
22618	863	1780	657	95081	0	98381
22619	872	698	500	95450	0	97520
22620	570	619	93409	2917	0	97515
22621	581	509	91328	1423	0	93841
22622	90487	691	2773	1356	0	95307
22623	89752	691	1105	1391	0	92939
22624	2736	90496	958	1102	0	95292
22625	90979	2062	703	1136	0	94880
22626	2648	935	90253	886	0	94722
22627	1463	526	88617	1042	0	91648
22628	88013	727	2713	1528	0	92981
22629	86976	475	1105	1591	0	90147
22630	2546	433	83455	1617	0	88051
22631	82047	404	2073	1624	0	86148
22632	2454	352	82884	1228	0	86918
22633	82541	514	2212	898	0	86165
22634	83511	864	1028	756	0	86159
22635	2920	914	788	79251	0	83873
22636	1237	84674	898	2148	0	88957
22637	66363	2656	1457	1794	0	72270
22638	2087	1166	84902	915	0	89070
22639	1329	84893	2131	870	0	89223
22640	85483	2538	920	1187	0	90128
22641	82698	1102	725	1234	0	85759
22642	2808	82193	829	1095	0	86925
22643	1738	2056	826	82717	0	87337
22644	1285	802	80882	2838	0	85807
22645	1065	688	2251	82144	0	86148
22646	985	756	81001	3044	0	85786
22647	808	630	2379	81567	0	85384
22648	745	688	1298	82972	0	85703
22649	783	707	79984	3207	0	84681
22650	818	79803	2447	1816	0	84884
22651	1130	2138	1011	79941	0	84220
22652	1106	1254	61330	3248	0	66938
22653	79171	846	1754	1760	0	83531
22654	2359	745	1026	81151	0	85281
22655	1204	592	914	82990	0	85700
22656	80893	557	921	3326	0	85697
22657	2792	482	708	80689	0	84671
22658	1720	494	666	79558	0	82438
22659	1120	78716	862	3039	0	83737
22660	1348	1991	827	78434	0	82600
22661	856	1078	76918	2854	0	81706
22662	1132	549	2197	75643	0	79521
22663	1037	74219	1273	2717	0	79246
22664	802	76343	1174	1701	0	80020
22665	1039	2372	917	76317	0	80645
22666	76233	1098	866	2532	0	80729
22667	2447	961	1021	76277	0	80706
22668	76554	1049	823	2423	0	80849
22669	2875	653	904	76517	0	80949
22670	76608	618	956	2575	0	80757
22671	78798	573	810	1709	0	81890
22672	3387	1021	882	76217	0	81507
22673	2115	2988	1178	73789	0	80070
22674	1480	72343	1047	3004	0	77874
22675	1434	74880	948	1742	0	79004
22676	1517	2067	73577	1514	0	78675
22677	1306	71326	1861	1592	0	76085
22678	53484	1859	1648	1102	0	58093
22679	1534	561	553	51913	0	54561
22680	506	49878	304	1084	0	51772
22681	51122	948	239	693	0	53002
22682	1160	352	218	51335	0	53065
22683	632	239	233	50730	0	51834
22684	450	222	275	51716	0	52663
22685	416	371	294	51603	0	52684
22686	386	50651	282	1399	0	52718
22687	370	53858	242	686	0	55156
22688	55018	1020	263	588	0	56889
22689	1259	55460	242	438	0	57399
22690	531	1112	267	55481	0	57391
22691	546	388	186	56221	0	57341
22692	499	318	164	56360	0	57341
22693	432	258	157	56881	0	57728
22694	55671	271	151	1661	0	57754
22695	56961	175	191	834	0	58161
22696	1467	209	55674	567	0	57917
22697	732	213	1091	56431	0	58467
22698	562	206	56979	1470	0	59217
22699	514	222	1257	57219	0	59212
22700	466	218	439	58528	0	59651
22701	57682	230	322	1837	0	60071
22702	1465	247	295	58146	0	60153
22703	554	229	57409	1670	0	59862
22704	456	251	55771	744	0	57222
22705	56798	198	1361	839	0	59196
22706	1332	202	57633	603	0	59770
22707	601	341	1244	55350	0	57536
22708	375	165	56473	1456	0	58469
22709	368	451	1155	54663	0	56637
22710	231	54116	458	1352	0	56157
22711	311	1086	344	54274	0	56015
22712	177	53289	284	1288	0	55038
22713	164	54058	212	613	0	55047
22714	280	1233	227	53087	0	54827
22715	52250	396	209	1247	0	54102
22716	843	52690	134	561	0	54228
22717	422	886	109	53138	0	54555
22718	52974	326	115	1223	0	54638
22719	53740	245	91	685	0	54761
22720	54609	179	99	571	0	55458
22721	1276	193	101	53830	0	55400
22722	567	176	132	54709	0	55584
22723	54571	134	127	1369	0	56201
22724	54447	147	123	743	0	55460
22725	54976	155	110	599	0	55840
22726	1296	163	101	54294	0	55854
22727	550	173	52292	1046	0	54061
22728	52655	131	714	581	0	54081
22729	1097	130	250	52620	0	54097
22730	494	52854	201	1060	0	54609
22731	520	1042	137	52619	0	54318
22732	360	52355	124	1066	0	53905
22733	411	907	109	53436	0	54863
22734	286	300	52155	1148	0	53889
22735	222	51531	743	577	0	53073
22736	349	776	260	49237	0	50622
22737	276	249	196	49535	0	50256
22738	242	211	101	49333	0	49887
22739	49628	154	107	1208	0	51097
22740	862	50142	117	580	0	51701
22741	385	878	94	51763	0	53120
22742	52513	334	99	1241	0	54187
22743	53236	238	83	636	0	54193
22744	1341	168	86	53418	0	55013
22745	559	183	53983	1267	0	55992
22746	473	164	959	53810	0	55406
22747	279	53847	337	1359	0	55822
22748	336	1002	206	55484	0	57028
22749	54983	345	130	1513	0	56971
22750	1215	245	130	57114	0	58704
22751	508	179	57386	1485	0	59558
22752	369	59804	1018	745	0	61936
22753	61099	1190	355	659	0	63303
22754	1327	470	61113	456	0	63366
22755	62152	261	1261	495	0	64169
22756	1583	192	483	63785	0	66043
22757	750	158	317	64836	0	66061
22758	420	64657	216	1802	0	67095
22759	67415	1241	205	902	0	69763
22760	1592	450	199	68397	0	70638
22761	792	268	188	69701	0	70949
22762	565	169	190	71243	0	72167
22763	364	187	70013	2167	0	72731
22764	368	149	1387	70529	0	72433
22765	71079	136	527	2078	0	73820
22766	72703	168	305	1046	0	74222
22767	2007	145	203	71918	0	74273
22768	908	147	195	73005	0	74255
22769	71607	149	175	2201	0	74132
22770	1624	199	69827	990	0	72640
22771	69921	172	1382	792	0	72267
22772	1785	174	68520	527	0	71006
22773	816	181	68912	462	0	70371
22774	676	172	1714	69258	0	71820
22775	455	132	70579	1666	0	72832
22776	70231	146	1660	884	0	72921
22777	1695	114	645	72218	0	74672
22778	711	99	71793	1666	0	74269
22779	70491	81	1440	939	0	72951
22780	72738	92	572	724	0	74126
22781	2005	131	73461	468	0	76065
22782	1053	547	1408	70655	0	73663
22783	631	73987	606	1420	0	76644
22784	75607	1231	414	820	0	78072
22785	1696	461	75046	486	0	77689
22786	71134	468	1406	657	0	73665
22787	1619	72852	573	456	0	75500
22788	71452	1065	554	443	0	73514
22789	71192	385	268	444	0	72289
22790	72207	195	210	433	0	73045
22791	1704	352	202	71468	0	73726
22792	805	71303	225	1238	0	73571
22793	563	1085	70324	592	0	72564
22794	423	72024	1117	448	0	74012
22795	630	1331	472	67120	0	69553
22796	337	69627	291	1126	0	71381
22797	298	71452	281	577	0	72608
22798	70166	1245	263	490	0	72164
22799	1205	549	68960	333	0	71047
22800	625	340	69994	320	0	71279
22801	470	287	69528	284	0	70569
22802	365	70743	1219	297	0	72624
22803	71506	905	644	421	0	73476
22804	71603	407	328	404	0	72742
22805	71242	222	219	429	0	72112
22806	1308	69809	230	387	0	71734
22807	700	887	202	72718	0	74507
22808	461	423	71570	1141	0	73595
22809	461	311	69674	667	0	71113
22810	73005	192	1144	682	0	75023
22811	75525	208	522	532	0	76787
22812	75763	178	348	499	0	76788
22813	1520	160	73467	424	0	75571
22814	74252	113	1049	494	0	75908
22815	1432	105	528	74802	0	76867
22816	813	140	315	75026	0	76294
22817	558	196	76802	1468	0	79024
22818	555	76495	1036	744	0	78830
22819	559	901	534	78539	0	80533
22820	465	374	77121	1340	0	79300
22821	75125	201	1207	958	0	77491
22822	1262	187	654	78696	0	80799
22823	773	121	479	79364	0	80737
22824	78858	115	437	1678	0	81088
22825	1487	98	312	79042	0	80939
22826	78900	99	322	1642	0	80963
22827	79311	121	364	1041	0	80837
22828	1710	145	323	79166	0	81344
22829	1032	106	397	79842	0	81377
22830	79442	129	412	1700	0	81683
22831	1508	127	436	80487	0	82558
22832	81342	147	466	1583	0	83538
22833	81082	163	448	909	0	82602
22834	81188	152	442	708	0	82490
22835	1942	171	383	80110	0	82606
22836	1156	283	350	80762	0	82551
22837	80771	166	393	1600	0	82930
22838	1502	78327	451	703	0	80983
22839	799	77214	416	361	0	78790
22840	77437	848	416	477	0	79178
22841	1115	413	75144	312	0	76984
22842	75289	221	892	398	0	76800
22843	1096	212	422	78766	0	80496
22844	620	200	77746	743	0	79309
22845	77948	140	748	540	0	79376
22846	1072	174	306	79687	0	81239
22847	682	189	207	81076	0	82154
22848	617	175	215	82533	0	83540
22849	658	174	137	82452	0	83421
22850	81190	151	223	1147	0	82711
22851	783	79294	219	460	0	80756
22852	76167	463	105	407	0	77142
22853	642	231	75412	121	0	76406
22854	435	179	71693	100	0	72407
22855	267	75988	462	146	0	76863
22856	675	976	466	75246	0	77363
22857	201	208	74902	336	0	75647
22858	188	68576	363	216	0	69343
22859	100	254	70727	83	0	71164
22860	129	54	179	70299	0	70661
22861	96	28	65	69926	0	70115
22862	70959	21	20	384	0	71384
22863	212	19	26	69824	0	70081
22864	69932	15	14	377	0	70338
22865	215	63	69109	62	0	69449
22866	70	70005	183	96	0	70354
22867	125	147	44	74002	0	74318
22868	142	53	25	77976	0	78196
22869	58	53	78363	215	0	78689
22870	138	144	72035	110	0	72427
22871	74887	19	206	319	0	75431
22872	79815	19	55	273	0	80162
22873	239	25	27	79891	0	80182
22874	125	18	24	79192	0	79359
22875	53	77320	55	239	0	77667
22876	75	160	26	80746	0	81007
22877	80556	42	30	487	0	81115
22878	81041	21	29	318	0	81409
22879	303	81280	53	102	0	81738
22880	83190	299	15	274	0	83778
22881	81785	86	19	220	0	82110
22882	537	47	28	85961	0	86573
22883	186	85333	66	624	0	86209
22884	194	598	23	88307	0	89122
22885	181	132	22	88819	0	89154
22886	82	97	86855	853	0	87887
22887	86708	46	686	441	0	87881
22888	1021	38	142	94651	0	95852
22889	453	53	63	99732	0	100301
22890	168	111083	102	1579	0	112932
22891	365	1891	29	120353	0	122638
22892	123164	501	52	2826	0	126543
22893	132263	344	34	1072	0	133713
22894	3582	336	129027	565	0	133510
22895	1216	318	129996	476	0	132006
22896	1151	225	3383	134783	0	139542
22897	968	124	1030	140259	0	142381
22898	574	129	137498	3891	0	142092
22899	593	133	137953	1373	0	140052
22900	822	131	4062	133108	0	138123
22901	315	119	139721	3713	0	143868
22902	467	251	139389	1411	0	141518
22903	566	71	4383	138135	0	143155
22904	141133	83	1798	3997	0	147011
22905	145147	67	1294	1612	0	148120
22906	4235	57	920	143349	0	148561
22907	1754	73	753	144989	0	147569
22908	142593	59	741	4612	0	148005
22909	4009	97	554	141550	0	146210
22910	140375	73	480	4722	0	145650
22911	142684	73	461	2092	0	145310
22912	4847	147	383	141315	0	146692
22913	2144	126	370	144244	0	146884
22914	140203	90	359	5079	0	145731
22915	4119	136636	425	2276	0	143456
22916	1738	140783	479	1654	0	144654
22917	1631	3586	400	138235	0	143852
22918	1109	1243	135802	4263	0	142417
22919	1164	763	3341	136163	0	141431
22920	136592	549	1202	4724	0	143067
22921	3937	475	866	137317	0	142595
22922	137547	436	686	4819	0	143488
22923	4127	434	135137	2220	0	141918
22924	136437	287	3512	1932	0	142168
22925	4499	268	1274	138892	0	144933
22926	2279	192	846	142703	0	146020
22927	1616	244	142050	4936	0	148846
22928	1712	233	3429	143366	0	148740
22929	1364	229	1298	147531	0	150422
22930	1328	288	925	149971	0	152512
22931	145181	233	745	6213	0	152372
22932	4017	312	143079	3036	0	150444
22933	1934	366	141264	2316	0	145880
22934	141641	190	4257	2456	0	148544
22935	146437	181	1860	2145	0	150623
22936	5080	266	145038	1718	0	152102
22937	2610	364	4097	142317	0	149388
22938	1813	144454	2053	4254	0	152574
22939	1670	3119	1636	150675	0	157100
22940	149208	926	1500	5254	0	156888
22941	151892	574	1515	2845	0	156826
22942	5021	487	1502	148754	0	155764
22943	2292	145593	1395	5222	0	154502
22944	2144	3251	1313	145944	0	152652
22945	1778	146105	1381	4881	0	154145
22946	148108	3561	1151	3203	0	156023
22947	144395	1300	1188	2751	0	149634
22948	146499	817	1213	2566	0	151095
22949	5411	136742	1251	2461	0	145865
22950	2848	143363	1148	2417	0	149776
22951	2541	4162	1004	145801	0	153508
22952	2357	1523	976	147766	0	152622
22953	2373	997	900	146126	0	150396
22954	2306	817	883	149201	0	153207
22955	1933	853	140313	6556	0	149655
22956	137257	839	3747	4010	0	145853
22957	5037	852	142644	3010	0	151543
22958	144888	699	4273	3007	0	152867
22959	5406	798	147246	2677	0	156127
22960	147513	600	4439	2996	0	155548
22961	5624	657	150502	2451	0	159234
22962	148073	606	4680	2527	0	155886
22963	5937	566	2315	152679	0	161497
22964	155604	561	1716	5702	0	163583
22965	6055	556	1497	156961	0	165069
22966	3432	483	1401	158655	0	163971
22967	2801	510	1397	154930	0	159638
22968	2431	146058	1241	6734	0	156464
22969	147883	3524	1066	4209	0	156682
22970	149172	1354	1015	3438	0	154979
22971	5979	146487	1026	3034	0	156526
22972	3299	3930	918	150128	0	158275
22973	2581	1559	145374	5863	0	155377
22974	145135	1027	4049	3652	0	153863
22975	150800	841	1809	3142	0	156592
22976	149854	677	1502	2789	0	154822
22977	6757	695	1253	143454	0	152159
22978	3647	140394	1227	5204	0	150472
22979	2902	3560	1301	143510	0	151273
22980	142887	1379	1114	5484	0	150864
22981	5869	1007	1090	138101	0	146067
22982	2893	134504	1021	4854	0	143272
22983	133808	3375	952	3088	0	141223
22984	5099	1531	132328	2309	0	141267
22985	3735	1305	129333	2204	0	136577
22986	2366	128860	4106	2003	0	137335
22987	2126	128667	1947	1713	0	134453
22988	3336	3911	120833	1549	0	129629
22989	2883	2028	114047	1443	0	120401
22990	2157	6019	3124	91614	0	102914
22991	95530	620	1464	2021	0	99635
22992	1841	444	94291	860	0	97436
22993	711	87724	1046	517	0	89998
22994	87701	870	905	664	0	90140
22995	1015	86105	329	313	0	87762
22996	83539	681	256	386	0	84862
22997	790	81810	250	193	0	83043
22998	425	83138	185	208	0	83956
22999	464	810	288	84136	0	85698
23000	455	429	279	83823	0	84986
23001	299	235	79592	714	0	80840
23002	340	175	503	78364	0	79382
23003	79277	191	251	866	0	80585
23004	79312	146	133	640	0	80231
23005	855	161	83	78188	0	79287
23006	426	153	76561	653	0	77793
23007	315	168	74048	410	0	74941
23008	306	110	688	76710	0	77814
23009	215	135	78037	640	0	79027
23010	302	115	673	77439	0	78529
23011	379	100	379	75540	0	76398
23012	183	133	82151	840	0	83307
23013	78931	113	842	744	0	80630
23014	82862	115	497	471	0	83945
23015	1153	107	83027	224	0	84511
23016	622	154	82879	231	0	83886
23017	521	124	1472	84931	0	87048
23018	420	113	603	92916	0	94052
23019	348	100	335	95960	0	96743
23020	396	128	264	94460	0	95248
23021	95710	99	210	2223	0	98242
23022	100632	135	186	1099	0	102052
23023	2234	121	197	107000	0	109552
23024	1051	122	194	112420	0	113787
23025	463	170	117522	2818	0	120973
23026	624	96	2411	121943	0	125074
23027	504	86	1187	128447	0	130224
23028	131004	92	530	5000	0	136626
23029	3588	138493	336	2202	0	144619
23030	1870	3774	227	141371	0	147242
23031	1005	1406	206	144549	0	147166
23032	776	592	227	142831	0	144426
23033	458	127437	373	6360	0	134628
23034	355	139438	306	2843	0	142942
23035	649	4938	233	139530	0	145350
23036	635	1936	217	140176	0	142964
23037	604	926	227	142208	0	143965
23038	132291	575	228	7035	0	140129
23039	3813	133790	270	3265	0	141138
23040	135879	4084	213	2172	0	142348
23041	139372	1810	205	1613	0	143000
23042	6004	976	199	134103	0	141282
23043	2428	132192	211	4929	0	139760
23044	133529	4273	273	2813	0	140888
23045	4957	1937	119	134122	0	141135
23046	135355	1040	171	5412	0	141978
23047	5296	779	163	136559	0	142797
23048	2437	705	132811	5511	0	141464
23049	1465	665	135371	2872	0	140373
23050	1291	556	5102	136149	0	143098
23051	1149	559	2010	138774	0	142492
23052	1180	503	948	136914	0	139545
23053	900	128455	662	6769	0	136786
23054	885	138461	509	3353	0	143208
23055	134704	5261	447	2400	0	142812
23056	134812	2281	447	2031	0	139571
23057	5619	130711	451	1625	0	138406
23058	2292	129377	341	1543	0	133553
23059	1265	134246	300	1536	0	137347
23060	125435	5682	441	1685	0	133243
23061	4136	127216	400	1341	0	133093
23062	2227	4780	306	127462	0	134775
23063	126400	2152	298	4925	0	133775
23064	128420	1257	292	2612	0	132581
23065	5876	1026	304	123145	0	130351
23066	2552	1003	119397	5033	0	127985
23067	1592	1027	121544	2502	0	126665
23068	1479	865	4848	122172	0	129364
23069	1149	882	123735	5008	0	130774
23070	1265	789	4436	124552	0	131042
23071	1211	785	1867	125662	0	129525
23072	1025	795	122311	6411	0	130542
23073	980	801	123514	3242	0	128537
23074	1090	766	5431	122626	0	129913
23075	1044	746	2397	128718	0	132905
23076	122243	697	1326	6950	0	131216
23077	4409	119729	1035	3748	0	128921
23078	2041	127863	850	2810	0	133564
23079	122474	5385	797	2608	0	131264
23080	128036	2464	770	2403	0	133673
23081	5698	122859	811	2352	0	131720
23082	2725	127489	721	2301	0	133236
23083	125945	5678	636	2454	0	134713
23084	5247	2650	619	125542	0	134058
23085	123546	1748	677	5986	0	131957
23086	5342	122905	697	3792	0	132736
23087	125054	4731	613	2931	0	133329
23088	5718	2432	121069	2535	0	131754
23089	123152	1637	4052	2530	0	131371
23090	5832	1534	122303	2364	0	132033
23091	3310	1465	4603	121922	0	131300
23092	120932	1285	2126	6232	0	130575
23093	5551	1260	117243	3906	0	127960
23094	3109	1361	4480	119536	0	128486
23095	118665	1331	2139	6297	0	128432
23096	5581	1452	116832	4000	0	127865
23097	3264	1366	4433	119913	0	128976
23098	117127	1329	2032	6625	0	127113
23099	5259	115632	1275	4148	0	126314
23100	3143	4775	997	119614	0	128529
23101	2442	2639	882	120256	0	126219
23102	2150	1971	824	122051	0	126996
23103	2082	117127	794	7484	0	127487
23104	2179	5093	749	123386	0	131407
23105	2173	2581	771	126426	0	131951
23106	2411	1822	738	126788	0	131759
23107	2418	1612	751	130186	0	134967
23108	2353	1588	122295	7923	0	134159
23109	120118	1516	4469	4506	0	130609
23110	125866	1291	2109	3462	0	132728
23111	6889	122340	1373	2905	0	133507
23112	3515	4577	1033	120397	0	129522
23113	2524	2297	962	122596	0	128379
23114	2010	117520	1107	7303	0	127940
23115	1722	4164	1164	120510	0	127560
23116	114072	1991	1266	6459	0	123788
23117	4297	112378	1295	3878	0	121848
23118	108177	4028	1217	2739	0	116161
23119	4608	2030	941	107805	0	115384
23120	2196	1399	105315	5484	0	114394
23121	1532	106309	3612	3305	0	114758
23122	99807	4200	2500	2408	0	108915
23123	3695	92879	969	1584	0	99127
23124	1897	92643	762	1273	0	96575
23125	81073	3100	1347	1161	0	86681
23126	2773	1209	79482	853	0	84317
23127	934	72784	1597	747	0	76062
23128	61367	2694	2781	1182	0	68024
23129	56386	514	527	417	0	57844
23130	890	55647	127	146	0	56810
23131	452	756	100	57218	0	58526
23132	290	300	57998	766	0	59354
23133	267	220	663	57889	0	59039
23134	282	169	249	56554	0	57254
23135	188	149	150	60350	0	60837
23136	168	159	59758	1029	0	61114
23137	266	163	645	58287	0	59361
23138	158	130	59589	910	0	60787
23139	195	160	56520	365	0	57240
23140	54245	141	823	364	0	55573
23141	721	57377	337	211	0	58646
23142	285	58646	228	189	0	59348
23143	371	835	174	60382	0	61762
23144	64901	358	107	1054	0	66420
23145	65884	216	89	554	0	66743
23146	64681	158	110	440	0	65389
23147	65776	129	95	305	0	66305
23148	64520	100	113	251	0	64984
23149	1178	164	62009	159	0	63510
23150	598	124	754	62439	0	63915
23151	350	61374	294	850	0	62868
23152	302	796	202	63391	0	64691
23153	64074	339	105	1063	0	65581
23154	856	62992	132	473	0	64453
23155	416	860	92	65224	0	66592
23156	65509	369	93	1028	0	66999
23157	67530	230	93	615	0	68468
23158	1202	162	120	67299	0	68783
23159	638	143	119	66666	0	67566
23160	449	139	95	67673	0	68356
23161	269	166	66267	1221	0	67923
23162	252	218	66399	587	0	67456
23163	284	164	985	68309	0	69742
23164	284	170	398	69712	0	70564
23165	69308	162	260	1278	0	71008
23166	69358	142	161	720	0	70381
23167	70434	128	142	583	0	71287
23168	71671	154	136	536	0	72497
23169	71234	139	128	430	0	71931
23170	1310	71041	144	323	0	72818
23171	73432	867	137	487	0	74923
23172	74011	347	128	484	0	74970
23173	74067	269	153	412	0	74901
23174	1400	201	124	75349	0	77074
23175	698	146	74397	1223	0	76464
23176	622	198	993	75921	0	77734
23177	438	172	79120	1323	0	81053
23178	522	175	1140	76637	0	78474
23179	344	78909	447	1219	0	80919
23180	79942	1059	261	634	0	81896
23181	82523	427	179	577	0	83706
23182	1585	299	125	83137	0	85146
23183	819	241	119	86134	0	87313
23184	573	185	102	86540	0	87400
23185	441	86498	160	1546	0	88645
23186	87275	1092	126	837	0	89330
23187	87975	388	138	594	0	89095
23188	1572	87461	161	388	0	89582
23189	796	1180	146	89019	0	91141
23190	550	455	130	88252	0	89387
23191	378	88832	137	1466	0	90813
23192	90273	1226	111	798	0	92408
23193	90825	448	121	581	0	91975
23194	1746	280	103	90393	0	92522
23195	793	218	90112	1377	0	92500
23196	608	226	87016	622	0	88472
23197	520	131	1487	92609	0	94747
23198	505	156	543	93031	0	94235
23199	430	144	329	95519	0	96422
23200	94031	147	221	2143	0	96542
23201	95452	152	190	1096	0	96890
23202	1791	97504	209	684	0	100188
23203	99230	1296	214	638	0	101378
23204	1871	435	97895	367	0	100568
23205	807	311	97619	315	0	99052
23206	530	101033	1646	393	0	103602
23207	98340	1419	888	513	0	101160
23208	1325	97600	300	254	0	99479
23209	97796	1287	167	430	0	99680
23210	1496	448	96787	235	0	98966
23211	653	302	95659	222	0	96836
23212	645	172	1430	94996	0	97243
23213	401	212	98644	1337	0	100594
23214	510	168	1291	99398	0	101367
23215	975	227	571	88881	0	90654
23216	291	99307	368	1616	0	101582
23217	394	1230	254	101767	0	103645
23218	393	440	227	103013	0	104073
23219	104431	293	236	1906	0	106866
23220	1474	103588	227	761	0	106050
23221	702	1404	182	106347	0	108635
23222	484	459	105542	1612	0	108097
23223	97544	299	1406	967	0	100216
23224	1587	285	104764	578	0	107214
23225	751	339	1489	103117	0	105696
23226	447	106954	549	1635	0	109585
23227	505	1620	332	108014	0	110471
23228	109389	567	257	2158	0	112371
23229	109809	327	207	1076	0	111419
23230	2237	111720	223	589	0	114769
23231	115192	1768	214	892	0	118066
23232	115848	680	205	808	0	117541
23233	115769	447	216	873	0	117305
23234	119375	303	222	699	0	120599
23235	113169	259	284	870	0	114582
23236	2576	314	115058	382	0	118330
23237	1309	255	1779	114915	0	118258
23238	1061	290	697	113687	0	115735
23239	728	257	419	116843	0	118247
23240	513	115688	327	2518	0	119046
23241	675	1794	252	116392	0	119113
23242	575	679	115947	2140	0	119341
23243	526	112528	1766	956	0	115776
23244	460	111930	691	660	0	113741
23245	759	2056	464	111507	0	114786
23246	620	753	371	112099	0	113843
23247	602	467	309	110926	0	112304
23248	434	106943	348	2476	0	110201
23249	446	110345	314	1077	0	112182
23250	109923	1986	287	927	0	113123
23251	110395	811	264	803	0	112273
23252	2163	110285	327	602	0	113377
23253	112515	1770	365	823	0	115473
23254	115764	710	294	917	0	117685
23255	2423	516	360	116014	0	119313
23256	1190	411	327	118416	0	120344
23257	858	414	284	118690	0	120246
23258	667	445	116064	2635	0	119811
23259	706	497	114334	1222	0	116759
23260	623	121388	2225	852	0	125088
23261	124275	2044	829	951	0	128099
23262	2470	924	124131	574	0	128099
23263	123908	589	2165	923	0	127585
23264	2768	462	131172	595	0	134997
23265	131700	395	2651	869	0	135615
23266	3026	136996	1090	662	0	141774
23267	138395	2653	587	904	0	142539
23268	3297	1101	471	136524	0	141393
23269	1713	649	437	139828	0	142627
23270	1089	638	136000	3534	0	141261
23271	759	139638	2485	1581	0	144463
23272	1043	2881	960	141731	0	146615
23273	838	1157	140051	2906	0	144952
23274	131137	658	2646	1614	0	136055
23275	2611	137812	1115	922	0	142460
23276	136638	2493	568	1059	0	140758
23277	2656	133198	531	856	0	137241
23278	1431	2684	432	134175	0	138722
23279	132432	1032	445	2954	0	136863
23280	2503	132574	526	1308	0	136911
23281	1287	2575	405	133904	0	138171
23282	845	1075	130810	2808	0	135538
23283	125517	704	2332	1431	0	129984
23284	2819	608	829	131096	0	135352
23285	1205	558	128811	2694	0	133268
23286	832	128575	2269	1286	0	132962
23287	918	2355	862	129807	0	133942
23288	794	986	129291	2691	0	133762
23289	968	908	2343	125084	0	129303
23290	695	128419	979	2568	0	132661
23291	667	131750	658	1216	0	134291
23292	733	2856	129627	715	0	133931
23293	969	1284	2299	128053	0	132605
23294	591	722	130298	2573	0	134184
23295	126838	580	2355	1474	0	131247
23296	2641	686	992	126823	0	131142
23297	1044	123345	594	2409	0	127392
23298	780	130189	428	1084	0	132481
23299	127214	2649	485	1004	0	131352
23300	2181	130648	377	635	0	133841
23301	130014	2321	470	961	0	133766
23302	2492	950	126591	466	0	130499
23303	121112	611	1990	726	0	124439
23304	2223	123951	809	424	0	127407
23305	124032	2074	628	628	0	127362
23306	2208	122238	390	458	0	125294
23307	1147	2191	301	121740	0	125379
23308	732	933	290	125506	0	127461
23309	516	640	123196	2616	0	126968
23310	118202	513	1949	1455	0	122119
23311	2111	516	123405	646	0	126678
23312	124811	466	2185	661	0	128123
23313	2598	425	851	124514	0	128388
23314	1253	451	508	126284	0	128496
23315	630	127238	452	2892	0	131212
23316	781	2390	332	132075	0	135578
23317	738	1032	376	135182	0	137328
23318	494	647	132099	3305	0	136545
23319	123120	449	2325	1801	0	127695
23320	2406	128688	1026	826	0	132946
23321	129230	2290	526	867	0	132913
23322	2746	971	401	129023	0	133141
23323	1330	612	397	130805	0	133144
23324	128482	408	361	3396	0	132647
23325	2502	129738	450	1419	0	134109
23326	126507	2162	330	930	0	129929
23327	2482	124622	344	557	0	128005
23328	989	125858	318	460	0	127625
23329	124783	2684	735	707	0	128909
23330	2733	1052	468	121672	0	125925
23331	1000	653	120108	2259	0	124020
23332	859	542	2099	119100	0	122600
23333	665	423	766	119710	0	121564
23334	450	118369	503	2908	0	122230
23335	615	2329	313	121241	0	124498
23336	621	1034	255	121833	0	123743
23337	584	579	243	123635	0	125041
23338	567	479	235	125157	0	126438
23339	376	517	122074	3442	0	126409
23340	404	481	123788	1435	0	126108
23341	573	464	2896	126562	0	130495
23342	411	433	126877	2935	0	130656
23343	519	427	126158	1237	0	128341
23344	690	409	3227	127102	0	131428
23345	434	471	131428	3068	0	135401
23346	716	421	2942	126530	0	130609
23347	366	130278	1179	2957	0	134780
23348	135495	2693	684	1768	0	140640
23349	2942	1052	141717	916	0	146627
23350	1422	631	3265	141503	0	146821
23351	665	507	145489	3601	0	150262
23352	860	415	3590	151762	0	156627
23353	866	393	1317	156323	0	158899
23354	153245	382	824	5496	0	159947
23355	4330	377	637	156617	0	161961
23356	150538	415	542	5219	0	156714
23357	156016	346	575	2466	0	159403
23358	5118	152550	572	1329	0	159569
23359	151244	3867	565	1331	0	157007
23360	4438	147084	518	943	0	152983
23361	1646	152492	474	862	0	155474
23362	147527	4781	906	1101	0	154315
23363	4392	1780	146277	784	0	153233
23364	1624	918	142086	663	0	145291
23365	137146	1070	5103	919	0	144238
23366	139640	516	1817	918	0	142891
23367	4364	138148	798	601	0	143911
23368	141233	3368	559	851	0	146011
23369	142579	1268	512	937	0	145296
23370	142050	637	421	793	0	143901
23371	5218	463	408	137498	0	143587
23372	137052	416	398	3881	0	141747
23373	4057	138904	448	1591	0	145000
23374	2140	3268	380	142831	0	148619
23375	1467	1247	396	144276	0	147386
23376	920	142013	499	4536	0	147968
23377	1084	3405	425	145109	0	150023
23378	142619	1377	464	4418	0	148878
23379	144999	772	460	2137	0	148368
23380	4722	138365	554	1285	0	144926
23381	2046	143685	442	1000	0	147173
23382	142885	4176	382	1105	0	148548
23383	4197	1655	140384	879	0	147115
23384	2024	973	141111	840	0	144948
23385	1713	820	4237	138489	0	145259
23386	1437	591	1604	143354	0	146986
23387	1143	675	139465	4628	0	145911
23388	1083	133436	3602	2104	0	140225
23389	1753	3606	1492	129918	0	136769
23390	1106	1610	138806	3870	0	145392
23391	1261	940	3597	138499	0	144297
23392	1202	785	1575	138936	0	142498
23393	942	141046	982	4786	0	147756
23394	1198	3598	709	142570	0	148075
23395	1199	1537	702	144201	0	147639
23396	1185	973	680	145738	0	148576
23397	142091	715	635	5393	0	148834
23398	4208	665	611	139377	0	144861
23399	2016	139893	598	4319	0	146826
23400	140364	3455	545	2300	0	146664
23401	4238	1561	136317	1406	0	143522
23402	2065	1044	134790	1289	0	139188
23403	136849	750	4241	1422	0	143262
23404	4299	836	1850	138767	0	145752
23405	1962	764	139457	4131	0	146314
23406	1615	641	3597	139723	0	145576
23407	1341	640	1611	144927	0	148519
23408	141303	713	1000	5407	0	148423
23409	142731	707	760	2731	0	146929
23410	4980	141762	737	1694	0	149173
23411	2584	3719	768	141563	0	148634
23412	1543	1557	141567	4104	0	148771
23413	1217	146225	3557	2162	0	153161
23414	145385	3651	1578	1846	0	152460
23415	3788	147672	997	1385	0	153842
23416	146545	3686	884	1400	0	152515
23417	4160	1576	144510	1105	0	151351
23418	143534	933	3443	1345	0	149255
23419	150977	780	1410	1294	0	154461
23420	5064	816	151828	1104	0	158812
23421	2402	1267	3738	149433	0	156840
23422	1591	148580	1526	4086	0	155783
23423	1261	158399	979	1953	0	162592
23424	1144	160091	770	1475	0	163480
23425	1602	5153	718	154689	0	162162
23426	1153	1987	156822	4074	0	164036
23427	1338	1315	3576	155872	0	162101
23428	1359	958	1359	160938	0	164614
23429	1155	916	157543	4923	0	164537
23430	1022	156696	3815	2113	0	163646
23431	1205	3725	1459	156820	0	163209
23432	158078	1403	982	4457	0	164920
23433	4087	927	871	159397	0	165282
23434	1961	770	734	159386	0	162851
23435	1256	156982	607	5008	0	163853
23436	159037	3689	575	2495	0	165796
23437	4306	1549	590	163444	0	169889
23438	1841	1047	161081	4261	0	168230
23439	1165	160391	3325	2198	0	167079
23440	158679	3469	1428	1661	0	165237
23441	3688	1512	158373	1101	0	164674
23442	156880	1022	3492	1290	0	162684
23443	4089	1035	1456	156886	0	163466
23444	1663	158246	913	3402	0	164224
23445	157137	3276	759	1833	0	163005
23446	156815	1387	672	1410	0	160284
23447	4106	159166	669	983	0	164924
23448	2080	3148	549	157059	0	162836
23449	1258	1122	478	154619	0	157477
23450	149993	678	462	3737	0	154870
23451	2743	149453	539	1598	0	154333
23452	1208	2814	365	141555	0	145942
23453	592	138564	330	2191	0	141677
23454	426	139073	310	935	0	140744
23455	808	2265	493	135506	0	139072
23456	134595	752	396	2095	0	137838
23457	1525	135156	261	756	0	137698
23458	816	1712	218	135663	0	138409
23459	618	659	169	136593	0	138039
23460	418	510	134228	1892	0	137048
23461	553	507	126644	822	0	128526
23462	359	132367	1685	675	0	135086
23463	419	1606	130983	481	0	133489
23464	549	756	1644	130996	0	133945
23465	364	501	132553	1640	0	135058
23466	489	396	1533	134756	0	137174
23467	429	375	499	137218	0	138521
23468	404	349	338	137889	0	138980
23469	135083	290	286	2422	0	138081
23470	1610	343	239	135388	0	137580
23471	656	314	209	135653	0	136832
23472	458	133670	262	2042	0	136432
23473	454	1542	217	133870	0	136083
23474	134017	542	247	2447	0	137253
23475	1457	137161	237	905	0	139760
23476	138200	1656	193	1085	0	141134
23477	1800	656	136448	576	0	139480
23478	716	624	137799	526	0	139665
23479	745	479	1789	142514	0	145527
23480	532	402	657	146408	0	147999
23481	324	145160	512	2334	0	148330
23482	970	1920	422	136342	0	139654
23483	145791	663	325	2608	0	149387
23484	145078	527	315	1319	0	147239
23485	2269	434	296	148056	0	151055
23486	840	486	155938	2290	0	159554
23487	832	390	1786	157846	0	160854
23488	651	403	680	163390	0	165124
23489	533	391	472	165233	0	166629
23490	505	376	413	163673	0	164967
23491	476	419	341	161205	0	162441
23492	323	160759	391	3056	0	164529
23493	159352	2074	326	1812	0	163564
23494	161548	736	342	1543	0	164169
23495	163233	549	315	1389	0	165486
23496	2750	164099	378	975	0	168202
23497	163769	2306	287	1247	0	167609
23498	2512	163502	328	896	0	167238
23499	981	2609	162065	793	0	166448
23500	1152	918	2206	159193	0	163469
23501	714	666	163826	2772	0	167978
23502	543	164761	2468	1256	0	169028
23503	164185	2519	775	1490	0	168969
23504	2574	976	166946	901	0	171397
23505	1086	821	171412	827	0	174146
23506	821	177982	3292	853	0	182948
23507	1039	3089	1444	181274	0	186846
23508	717	1263	190394	3238	0	195612
23509	1340	887	3293	184150	0	189670
23510	1045	559	1298	205125	0	208027
23511	964	464	785	217732	0	219945
23512	222931	465	548	6125	0	230069
23513	223986	396	419	2953	0	227754
23514	6255	551	366	222121	0	229293
23515	223996	343	447	6041	0	230827
23516	5736	447	218795	2361	0	227339
23517	2498	476	215897	1734	0	220605
23518	1814	438	219269	1507	0	223028
23519	1615	464	221053	1278	0	224410
23520	1121	215713	5856	1233	0	223923
23521	2424	4238	2949	212732	0	222343
23522	1423	1253	217837	4256	0	224769
23523	204785	731	4971	2371	0	212858
23524	217721	545	2264	1817	0	222347
23525	5444	214628	1991	1409	0	223472
23526	215832	4024	1929	1282	0	223067
23527	5577	1481	1926	214792	0	223776
23528	2252	1087	221019	4366	0	228724
23529	2078	1036	5235	210715	0	219064
23530	1303	222683	2507	4575	0	231068
23531	216555	4418	1749	3002	0	225724
23532	223817	1720	1342	2165	0	229044
23533	5833	221704	1230	1523	0	230290
23534	225733	4547	1023	1678	0	232981
23535	225889	1806	946	1673	0	230314
23536	6388	222526	959	1362	0	231235
23537	3647	4668	903	217470	0	226688
23538	2277	219215	960	4841	0	227293
23539	222495	5009	970	2539	0	231013
23540	5859	2813	948	220878	0	230498
23541	221774	1693	890	5393	0	229750
23542	6467	1595	735	220276	0	229073
23543	3482	1578	215357	5167	0	225584
23544	212939	1386	4174	2888	0	221387
23545	6127	1399	215885	1815	0	225226
23546	3808	1193	4704	215244	0	224949
23547	2557	1320	214387	5278	0	223542
23548	2706	1165	4940	214329	0	223140
23549	2071	1137	214133	5933	0	223274
23550	207804	823	5195	3614	0	217436
23551	5471	212627	2533	2651	0	223282
23552	215073	4265	2012	2635	0	223985
23553	6191	1696	1874	213870	0	223631
23554	211675	1170	2026	5852	0	220723
23555	5721	207997	1914	2852	0	218484
23556	3078	206652	1996	2085	0	213811
23557	2265	218025	1734	2099	0	224123
23558	218360	5823	1647	2436	0	228266
23559	5909	2748	1445	217476	0	227578
23560	3341	1993	1283	220827	0	227444
23561	2667	1926	213320	6257	0	224170
23562	2680	1936	209430	3016	0	217062
23563	2911	1684	5327	215053	0	224975
23564	2362	1744	218265	5693	0	228064
23565	2057	216253	5395	3032	0	226737
23566	215536	5296	2700	2822	0	226354
23567	5594	2620	218425	1981	0	228620
23568	2870	1939	217694	2059	0	224562
23569	2668	1591	6544	215522	0	226325
23570	221182	1112	3402	6447	0	232143
23571	5900	1011	2778	222885	0	232574
23572	222099	957	2545	6861	0	232462
23573	6356	1049	2588	222869	0	232862
23574	3309	1249	224481	6069	0	235108
23575	2660	218495	6234	3205	0	230594
23576	2558	4946	224078	2333	0	233915
23577	2130	223019	6424	2433	0	234006
23578	2523	5809	3605	221030	0	232967
23579	218846	2195	2514	6303	0	229858
23580	5772	1582	218208	3192	0	228754
23581	3599	1377	5256	217934	0	228166
23582	3145	1270	2516	224820	0	231751
23583	227099	1252	2160	7192	0	237703
23584	5814	1448	2032	224024	0	233318
23585	2877	224421	2167	6047	0	235512
23586	217884	5058	2118	3632	0	228692
23587	5585	2566	215135	2538	0	225824
23588	209263	1929	4950	2743	0	218885
23589	6059	212838	2408	2239	0	223544
23590	3810	5204	1669	208363	0	219046
23591	2790	215672	1511	5234	0	225207
23592	215064	5136	1345	3345	0	224890
23593	6088	2549	213441	2392	0	224470
23594	208271	2352	4518	2788	0	217929
23595	5995	212245	2060	3148	0	223448
23596	3627	4810	1572	215789	0	225798
23597	217092	2360	1429	5639	0	226520
23598	219739	1791	1565	2935	0	226030
23599	6728	1594	1422	216809	0	226553
23600	3708	1942	1351	218112	0	225113
23601	2831	214126	1417	6061	0	224435
23602	2909	5330	1369	215940	0	225548
23603	2491	235330	1539	5816	0	245176
23604	2334	248489	1578	3247	0	255648
23605	2898	8698	1476	230606	0	243678
23606	2132	236838	1248	6280	0	246498
23607	2787	6080	236625	2845	0	248337
23608	3632	2818	237919	2605	0	246974
23609	2030	244183	6682	2740	0	255635
23610	1985	5935	243948	1707	0	253575
23611	1446	2495	241065	1475	0	246481
23612	776	1481	228963	597	0	231817
23613	378	224601	7014	589	0	232582
23614	217704	5186	3897	1242	0	228029
23615	4068	218231	1863	432	0	224594
23616	1721	5287	218449	267	0	225724
23617	1894	2170	4814	213338	0	222216
23618	215450	1508	1992	4804	0	223754
23619	4645	974	212543	1711	0	219873
23620	2515	773	4950	212081	0	220319
23621	1292	711	216207	4638	0	222848
23622	1361	484	5718	212051	0	219614
23623	210694	466	2643	5924	0	219727
23624	4665	677	212779	2217	0	220338
23625	1904	212648	5286	1707	0	221545
23626	2046	4837	2387	208281	0	217551
23627	216512	2057	1709	5280	0	225558
23628	5143	1492	210430	2020	0	219085
23629	2828	1007	5340	200465	0	209640
23630	1511	208170	2506	4710	0	216897
23631	211714	4864	1867	2621	0	221066
23632	217730	1994	1456	1989	0	223169
23633	7227	1505	1289	212425	0	222446
23634	3206	211437	1233	5647	0	221523
23635	2020	224981	1084	2576	0	230661
23636	227988	6937	1047	2093	0	238065
23637	6801	3366	1034	222261	0	233462
23638	2697	226786	1075	6289	0	236847
23639	228226	6227	1003	3065	0	238521
23640	7019	2828	980	229524	0	240351
23641	3457	1917	995	234297	0	240666
23642	2123	1578	217403	8073	0	229177
23643	1458	222164	5291	4098	0	233011
23644	1407	235167	2354	2433	0	241361
23645	1684	7433	1666	233894	0	244677
23646	232756	3495	1099	7241	0	244591
23647	6157	233370	1150	3105	0	243782
23648	233776	6882	961	2650	0	244269
23649	7225	232739	1004	1606	0	242574
23650	3620	7322	913	233873	0	245728
23651	234364	3353	757	6942	0	245416
23652	7504	2401	816	234484	0	245205
23653	3375	1805	231593	7580	0	244353
23654	2685	1674	6059	223323	0	233741
23655	1598	229234	2761	7279	0	240872
23656	226274	6824	1796	3866	0	238760
23657	6627	226847	1365	2547	0	237386
23658	3483	7493	1146	221459	0	233581
23659	2787	3562	1086	228970	0	236405
23660	1807	2712	220028	8450	0	232997
23661	1629	2163	220615	4219	0	228626
23662	1874	2148	7850	220376	0	232248
23663	1401	1933	218943	7460	0	229737
23664	1257	216350	7416	3805	0	228828
23665	214884	6765	3500	3214	0	228363
23666	6454	3570	216217	2234	0	228475
23667	212863	2620	6890	2500	0	224873
23668	220925	2119	3406	2251	0	228701
23669	220880	1948	2555	2117	0	227500
23670	221701	1877	1958	1990	0	227526
23671	9880	1726	1841	214069	0	227516
23672	5212	1607	1862	210220	0	218901
23673	3221	206758	2090	8215	0	220284
23674	205738	6467	1911	4550	0	218666
23675	7334	3652	200437	2849	0	214272
23676	4070	2827	6446	199993	0	213336
23677	3167	2178	3376	204697	0	213418
23678	2299	2033	195593	8729	0	208654
23679	2369	196783	6924	4745	0	210821
23680	2993	6617	3690	190790	0	204090
23681	2554	3359	2615	204587	0	213115
23682	196575	2472	1990	9391	0	210428
23683	6740	193655	1745	5441	0	207581
23684	4209	6605	1541	193723	0	206078
23685	2858	192006	1630	7784	0	204278
23686	2735	7135	1551	197938	0	209359
23687	192660	3515	1563	8690	0	206428
23688	198638	2610	1447	4951	0	207646
23689	8911	1970	1500	195077	0	207458
23690	193732	1817	1418	8408	0	205375
23691	194871	1797	1483	4826	0	202977
23692	9160	188367	1272	3713	0	202512
23693	5708	6429	1080	185453	0	198670
23694	3911	187856	1276	7156	0	200199
23695	3394	7340	955	189777	0	201466
23696	188102	3821	953	8284	0	201160
23697	7510	3160	917	188395	0	199982
23698	4653	2507	865	192165	0	200190
23699	3527	2293	179425	9536	0	194781
23700	3115	170283	5245	5691	0	184334
23701	2871	182839	2416	4129	0	192255
23702	177820	7431	1708	4091	0	191050
23703	6349	4291	1075	151413	0	163128
23704	141559	2144	928	5558	0	150189
23705	5288	135690	782	3383	0	145143
23706	2897	128546	731	2527	0	134701
23707	2101	134878	671	2151	0	139801
23708	115236	4536	2627	2011	0	124410
23709	3207	115606	778	1582	0	121173
23710	107994	2879	1627	1599	0	114099
23711	105954	1108	504	1121	0	108687
23712	108753	719	315	969	0	110756
23713	3107	669	270	112615	0	116661
23714	1567	602	265	116162	0	118596
23715	1138	539	313	117493	0	119483
23716	1030	553	259	116512	0	118354
23717	114560	487	257	3962	0	119266
23718	2837	111858	341	1722	0	116758
23719	1438	2352	255	114539	0	118584
23720	115077	895	306	3218	0	119496
23721	2889	609	279	114354	0	118131
23722	1430	510	258	115557	0	117755
23723	113477	475	269	3808	0	118029
23724	2882	589	110192	1589	0	115252
23725	1497	516	2082	111077	0	115172
23726	882	450	111947	2931	0	116210
23727	881	403	2195	110749	0	114228
23728	944	991	848	111117	0	113900
23729	107939	320	457	3510	0	112226
23730	2375	104112	427	1575	0	108489
23731	1042	103908	315	1013	0	106278
23732	100426	2037	323	941	0	103727
23733	1935	101824	244	635	0	104638
23734	100931	1678	613	1088	0	104310
23735	2168	606	98545	578	0	101897
23736	90922	319	1261	516	0	93018
23737	93748	144	319	502	0	94713
23738	94284	122	142	424	0	94972
23739	1553	123	95	91979	0	93750
23740	626	135	83	92034	0	92878
23741	291	90466	112	1413	0	92282
23742	440	1771	110	90420	0	92741
23743	89906	351	121	1464	0	91842
23744	1121	88827	102	545	0	90595
23745	335	89361	83	275	0	90054
23746	88794	1147	53	428	0	90422
23747	1071	398	87945	142	0	89556
23748	570	257	896	86435	0	88158
23749	250	169	88586	981	0	89986
23750	320	127	903	87158	0	88508
23751	169	87440	308	965	0	88882
23752	246	883	117	90265	0	91511
23753	89198	274	53	1290	0	90815
23754	1062	133	60	89503	0	90758
23755	367	150	91054	1089	0	92660
23756	86012	102	1010	752	0	87876
23757	1133	91348	395	259	0	93135
23758	445	98227	173	243	0	99088
23759	102032	1405	121	533	0	104091
23760	107814	492	82	484	0	108872
23761	2019	305	107198	137	0	109659
23762	104618	129	1562	439	0	106748
23763	1827	107570	550	218	0	110165
23764	109713	1624	193	496	0	112026
23765	2044	585	118	105879	0	108626
23766	763	101157	142	1545	0	103607
23767	104135	1670	112	874	0	106791
23768	2020	671	103332	277	0	106300
23769	1032	325	1600	104572	0	107529
23770	107343	251	538	2168	0	110300
23771	2032	338	105831	708	0	108909
23772	107198	205	1683	737	0	109823
23773	2273	203	575	106408	0	109459
23774	1100	200	289	109009	0	110598
23775	570	231	108566	2359	0	111726
23776	635	141	1803	107945	0	110524
23777	110092	132	645	2553	0	113422
23778	1923	108078	405	1027	0	111433
23779	110293	1730	259	859	0	113141
23780	111430	648	192	741	0	113011
23781	2699	348	157	110408	0	113612
23782	1077	293	111603	2131	0	115104
23783	785	201	1881	111506	0	114373
23784	112772	190	660	2589	0	116211
23785	2109	111007	424	998	0	114538
23786	114756	1844	218	833	0	117651
23787	2559	699	169	114182	0	117609
23788	1236	334	185	116699	0	118454
23789	811	229	264	118015	0	119319
23790	495	265	114582	2980	0	118322
23791	759	217	1967	115775	0	118718
23792	553	325	115230	2463	0	118571
23793	621	378	114594	1061	0	116654
23794	766	254	2493	123506	0	127019
23795	513	293	125145	2780	0	128731
23796	132589	241	2695	1756	0	137281
23797	3483	213	1160	139184	0	144040
23798	1930	201	712	139320	0	142163
23799	883	141112	559	4466	0	147020
23800	143734	3179	479	2428	0	149820
23801	149140	1390	429	1763	0	152722
23802	4828	148793	408	917	0	154946
23803	2694	3484	346	150448	0	156972
23804	1347	1615	150348	3753	0	157063
23805	147225	822	3405	2356	0	153808
23806	154715	487	1506	1601	0	158309
23807	5422	634	879	146865	0	153800
23808	2649	598	143310	3852	0	150409
23809	1590	141845	3455	1932	0	148822
23810	141075	3561	1550	1500	0	147686
23811	4288	1717	140653	947	0	147605
23812	2137	139288	3768	891	0	146084
23813	134747	3272	2021	1026	0	141066
23814	136176	1451	1008	925	0	139560
23815	4996	886	630	132674	0	139186
23816	2566	131544	645	3257	0	138012
23817	1861	3392	498	140123	0	145874
23818	1358	1591	558	143276	0	146783
23819	1484	973	533	139572	0	142562
23820	1244	659	523	144216	0	146642
23821	996	600	139656	5574	0	146826
23822	1296	539	3338	141523	0	146696
23823	1226	557	1500	145315	0	148598
23824	978	574	140408	5452	0	147412
23825	757	140355	3545	2995	0	147652
23826	140510	3525	1609	2344	0	147988
23827	143620	1622	1001	1917	0	148160
23828	5218	923	683	142535	0	149359
23829	143747	566	657	4793	0	149763
23830	4874	589	580	145027	0	151070
23831	2390	542	144356	4997	0	152285
23832	1684	649	142578	2724	0	147635
23833	1112	142854	4715	2065	0	150746
23834	142441	3590	2294	1913	0	150238
23835	4374	1785	148020	1407	0	155586
23836	2988	1011	4142	142894	0	151035
23837	2308	638	2127	153007	0	158080
23838	1685	560	1406	159672	0	163323
23839	1591	619	1003	159121	0	162334
23840	1596	624	940	158149	0	161309
23841	1214	776	153072	7925	0	162987
23842	1502	757	4477	155651	0	162387
23843	152847	719	2395	6779	0	162740
23844	4953	151503	1501	3854	0	161811
23845	152761	4287	1095	3051	0	161194
23846	5278	153488	1020	2316	0	162102
23847	154749	5036	911	2452	0	163148
23848	159129	2405	955	2328	0	164817
23849	7225	1396	937	154937	0	164495
23850	4018	928	814	158611	0	164371
23851	154855	809	894	7636	0	164194
23852	152810	866	904	4458	0	159038
23853	155837	915	830	2989	0	160571
23854	7334	146006	940	2136	0	156416
23855	3786	150796	851	1856	0	157289
23856	2647	5660	147175	1788	0	157270
23857	2585	3586	4222	143950	0	154343
23858	1888	1536	142090	5575	0	151089
23859	1562	138125	4597	3671	0	147955
23860	1612	4019	2273	134062	0	141966
23861	1490	1960	1201	135954	0	140605
23862	1480	1168	864	138646	0	142158
23863	132765	938	765	6960	0	141428
23864	133990	930	792	4008	0	139720
23865	5554	132299	821	2589	0	141263
23866	3338	3729	807	134505	0	142379
23867	2003	2182	132712	4798	0	141695
23868	1715	1528	127848	2991	0	134082
23869	130054	1161	5041	2436	0	138692
23870	133925	887	2633	2121	0	139566
23871	5980	756	1417	131739	0	139892
23872	133213	643	1158	5197	0	140211
23873	5266	812	129282	3192	0	138552
23874	3153	128055	3957	2273	0	137438
23875	2345	3779	2331	129431	0	137886
23876	1617	2148	131897	4808	0	140470
23877	1781	1385	4187	132986	0	140339
23878	1716	971	2413	136013	0	141113
23879	1460	812	133288	6627	0	142187
23880	129234	703	3937	4650	0	138524
23881	136581	631	2240	3553	0	143005
23882	5535	138940	1507	2752	0	148734
23883	143525	4073	1112	2702	0	151412
23884	147877	2272	1066	2486	0	153701
23885	6969	1459	143693	2157	0	154278
23886	144440	1044	4467	2330	0	152281
23887	6155	151017	2464	2080	0	161716
23888	153114	4714	1519	2149	0	161496
23889	157993	2496	1119	2090	0	163698
23890	162459	1489	1094	1787	0	166829
23891	155504	1160	866	2094	0	159624
23892	161721	964	741	2166	0	165592
23893	8843	154710	841	1730	0	166124
23894	149511	4341	753	1864	0	156469
23895	6393	145362	802	1313	0	153870
23896	2719	131337	680	1038	0	135774
23897	1745	136785	746	917	0	140193
23898	133019	4840	1807	1193	0	140859
23899	133581	1947	715	1124	0	137367
23900	5284	1052	127950	851	0	135137
23901	133499	786	3192	1077	0	138554
23902	135079	637	1442	1131	0	138289
23903	5581	734	133695	865	0	140875
23904	3068	514	3744	132452	0	139778
23905	2188	604	1820	131175	0	135787
23906	1610	547	850	140762	0	143769
23907	1669	552	617	140596	0	143434
23908	1527	537	537	141758	0	144359
23909	1222	585	135783	6016	0	143606
23910	1207	135676	3852	2637	0	143372
23911	133649	3803	1679	1585	0	140716
23912	4470	134463	818	1108	0	140859
23913	135526	4193	618	1118	0	141455
23914	136207	1914	574	1026	0	139721
23915	6004	1028	130327	799	0	138158
23916	3120	1339	3722	121585	0	129766
23917	1658	126022	1799	3595	0	133074
23918	127839	3705	948	1965	0	134457
23919	128786	1645	691	1402	0	132524
23920	130643	919	601	1137	0	133300
23921	5843	128284	626	808	0	135561
23922	130798	3599	680	963	0	136040
23923	132821	1741	521	874	0	135957
23924	133185	1003	441	839	0	135468
23925	6310	769	490	127256	0	134825
23926	3361	681	434	130390	0	134866
23927	2279	662	387	132351	0	135679
23928	128224	699	440	5262	0	134625
23929	4789	127428	403	2261	0	134881
23930	129335	3568	354	1245	0	134502
23931	127781	1764	432	835	0	130812
23932	124372	948	368	865	0	126553
23933	126029	869	362	740	0	128000
23934	6197	120113	416	647	0	127373
23935	114649	3289	286	686	0	118910
23936	4681	110690	308	521	0	116200
23937	2225	110885	269	417	0	113796
23938	110194	3376	411	646	0	114627
23939	3654	106814	301	479	0	111248
23940	2110	110972	261	410	0	113753
23941	111076	3350	558	585	0	115569
23942	112606	1589	257	562	0	115014
23943	4294	1033	205	108597	0	114129
23944	2390	780	152	111056	0	114378
23945	110734	765	200	3783	0	115482
23946	114769	657	279	1782	0	117487
23947	112207	742	263	1255	0	114467
23948	4310	749	107772	626	0	113457
23949	113626	662	2376	791	0	117455
23950	4026	737	945	113389	0	119097
23951	2486	598	536	115257	0	118877
23952	1831	613	400	116441	0	119285
23953	1659	569	381	116535	0	119144
23954	1470	600	110823	4039	0	116932
23955	1387	669	111939	1885	0	115880
23956	1432	593	3151	112895	0	118071
23957	1369	671	112767	3288	0	118095
23958	1502	757	111954	1725	0	115938
23959	1765	599	3345	113175	0	118884
23960	1747	610	1424	116643	0	120424
23961	1569	629	851	120427	0	123476
23962	1724	658	614	117133	0	120129
23963	118714	658	532	4657	0	124561
23964	123264	625	516	2531	0	126936
23965	4754	584	467	120754	0	126559
23966	2677	560	510	122333	0	126080
23967	1932	626	475	122790	0	125823
23968	1844	550	480	122362	0	125236
23969	1827	590	436	121595	0	124448
23970	1727	118446	551	4644	0	125368
23971	119128	2929	447	2597	0	125101
23972	3859	119229	433	1839	0	125360
23973	120616	3205	364	1883	0	126068
23974	121931	1494	282	1734	0	125441
23975	122509	985	283	1604	0	125381
23976	5161	817	378	115936	0	122292
23977	116673	860	293	3645	0	121471
23978	4511	896	280	115031	0	120718
23979	2950	1104	269	114683	0	119006
23980	113840	834	241	4297	0	119212
23981	4305	109088	250	2129	0	115772
23982	2090	106383	198	1274	0	109945
23983	104749	2574	242	1256	0	108821
23984	3198	1130	101689	941	0	106958
23985	96777	738	1964	1094	0	100573
23986	3438	1336	840	97809	0	103423
23987	1645	91066	329	2182	0	95222
23988	1271	93658	204	1144	0	96277
23989	93311	2151	359	1069	0	96890
23990	2471	1238	166	92680	0	96555
23991	1357	94552	132	1831	0	97872
23992	94163	1488	272	1204	0	97127
23993	94852	659	112	881	0	96504
23994	95075	503	79	840	0	96497
23995	95421	448	77	823	0	96769
23996	2453	90697	134	563	0	93847
23997	979	91271	89	359	0	92698
23998	92371	1430	161	530	0	94492
23999	94743	632	166	563	0	96104
24000	2017	412	92082	305	0	94816
24001	657	89640	992	258	0	91547
24002	89909	1062	466	370	0	91807
24003	92248	315	181	338	0	93082
24004	1589	258	91751	157	0	93755
24005	90981	145	1230	422	0	92778
24006	1766	129	95332	107	0	97334
24007	487	145	100959	105	0	101696
24008	660	388	1903	94387	0	97338
24009	253	96252	733	1528	0	98766
24010	103897	1678	355	772	0	106702
24011	2055	500	149	104033	0	106737
24012	885	285	107	105616	0	106893
24013	649	157	96	107188	0	108090
24014	105596	115	113	2715	0	108539
24015	2157	79	93	105188	0	107517
24016	857	105	112	108617	0	109691
24017	510	163	106609	2462	0	109744
24018	104912	77	1854	1338	0	108181
24019	109557	113	564	840	0	111074
24020	2656	172	107475	417	0	110720
24021	105209	116	1989	539	0	107853
24022	2712	121	652	104553	0	108038
24023	923	105026	446	2123	0	108518
24024	921	1951	217	106782	0	109871
24025	105640	556	238	2704	0	109138
24026	2236	105723	244	969	0	109172
24027	1083	2188	166	107537	0	110974
24028	926	653	153	110503	0	112235
24029	680	366	208	111174	0	112428
24030	755	248	168	107687	0	108858
24031	425	110499	212	3022	0	114158
24032	111649	2238	184	1496	0	115567
24033	113528	740	174	1117	0	115559
24034	3101	115048	198	930	0	119277
24035	124540	2605	154	879	0	128178
24036	129678	924	155	829	0	131586
24037	129535	537	127	808	0	131007
24038	4744	420	123922	520	0	129606
24039	2463	282	2946	124125	0	129816
24040	1398	361	120391	3399	0	125549
24041	122249	274	3149	1682	0	127354
24042	3672	123292	1171	1066	0	129201
24043	122611	3052	749	1002	0	127414
24044	3981	124518	509	662	0	129670
24045	2176	3567	440	120147	0	126330
24046	1771	1342	396	124222	0	127731
24047	1109	984	122342	4126	0	128561
24048	965	124380	3241	1939	0	130525
24049	123451	3606	1232	1483	0	129772
24050	4008	1470	123021	878	0	129377
24051	123854	1029	3470	982	0	129335
24052	4617	724	1426	124018	0	130785
24053	2035	742	124601	3825	0	131203
24054	1469	123792	3718	1858	0	130837
24055	1404	3618	1492	124219	0	130733
24056	1125	1520	124771	3918	0	131334
24057	1069	1080	125072	1770	0	128991
24058	1027	123269	4427	1343	0	130066
24059	1398	3636	2013	121246	0	128293
24060	1166	1460	1268	120916	0	124810
24061	935	119668	932	4471	0	126006
24062	121564	3629	836	2368	0	128397
24063	4119	1665	782	119199	0	125765
24064	1880	117984	760	4025	0	124649
24065	120541	3661	803	2240	0	127245
24066	120959	1659	764	1762	0	125144
24067	122995	1187	768	1451	0	126401
24068	5355	119454	751	1209	0	126769
24069	122550	3746	731	1338	0	128365
24070	124228	1719	630	1340	0	127917
24071	5547	1386	624	120403	0	127960
24072	122345	942	603	4334	0	128224
24073	5276	1052	465	121902	0	128695
24074	2650	916	118495	4765	0	126826
24075	2150	937	121397	2336	0	126820
24076	1886	812	4407	123227	0	130332
24077	1622	810	123535	4623	0	130590
24078	122035	723	4374	2657	0	129789
24079	4801	755	1931	125233	0	132720
24080	2619	705	1385	127719	0	132428
24081	2027	720	123450	5639	0	131836
24082	1609	118451	4208	2928	0	127196
24083	1497	125570	1869	2132	0	131068
24084	1656	4582	1433	122887	0	130558
24085	1517	2081	987	126531	0	131116
24086	1315	1448	121207	5543	0	129513
24087	1346	1150	123223	2796	0	128515
24088	1535	1011	4840	124001	0	131387
24089	1329	993	121642	4944	0	128908
24090	119254	1030	4556	2695	0	127535
24091	4859	928	1952	120324	0	128063
24092	120994	927	1437	5211	0	128569
24093	5240	931	1090	120607	0	127868
24094	2648	833	1075	124342	0	128898
24095	2072	846	118830	5982	0	127730
24096	1620	119928	4280	3108	0	128936
24097	1966	4061	1917	120958	0	128902
24098	1488	1724	119993	5068	0	128273
24099	1451	116764	4122	2570	0	124907
24100	1677	3851	2044	118875	0	126447
24101	118789	1676	1636	4844	0	126945
24102	4292	1204	118697	2541	0	126734
24103	114244	838	4043	2200	0	121325
24104	4653	854	113531	1574	0	120612
24105	106851	702	4261	1528	0	113342
24106	4137	106614	2037	1396	0	114184
24107	1657	104430	1385	1154	0	108626
24108	1611	4329	1383	98671	0	105994
24109	1051	98451	1016	3112	0	103630
24110	98892	3235	924	2644	0	105695
24111	3206	1461	812	100069	0	105548
24112	1612	1093	710	102091	0	105506
24113	1170	863	666	103469	0	106168
24114	799	861	98585	4341	0	104586
24115	984	758	2880	99002	0	103624
24116	740	758	97412	3929	0	102839
24117	762	95321	3313	2031	0	101427
24118	92083	2594	1457	1672	0	97806
24119	2802	95226	1120	1253	0	100401
24120	97202	2735	950	1425	0	102312
24121	98756	1179	784	1283	0	102002
24122	99421	903	643	1239	0	102206
24123	97690	693	707	1147	0	100237
24124	3900	737	92931	958	0	98526
24125	2123	648	2582	92911	0	98264
24126	1627	695	1314	91226	0	94862
24127	1284	663	917	95667	0	98531
24128	86268	657	717	4059	0	91701
24129	88510	547	782	2274	0	92113
24130	3332	91023	646	1623	0	96624
24131	1739	2122	88802	1199	0	93862
24132	1562	873	87516	1104	0	91055
24133	1030	86472	2839	1094	0	91435
24134	938	86959	1488	1081	0	90466
24135	1809	2330	1796	75194	0	81129
24136	777	683	479	72705	0	74644
24137	74530	468	349	1929	0	77276
24138	1487	73675	348	908	0	76418
24139	809	1415	321	76204	0	78749
24140	594	591	77299	1746	0	80230
24141	614	409	1450	80183	0	82656
24142	571	289	626	82159	0	83645
24143	482	299	488	83579	0	84848
24144	526	290	349	82944	0	84109
24145	457	264	80040	2302	0	83063
24146	421	76552	1586	1121	0	79680
24147	389	78496	600	768	0	80253
24148	75702	1555	423	591	0	78271
24149	1393	74696	352	445	0	76886
24150	590	78309	296	431	0	79626
24151	686	1611	345	78114	0	80756
24152	524	580	245	78834	0	80183
24153	437	419	315	78656	0	79827
24154	376	360	77181	1912	0	79829
24155	341	76513	1306	932	0	79092
24156	443	1473	436	75791	0	78143
24157	303	76918	360	1524	0	79105
24158	76756	1341	320	836	0	79253
24159	1297	76639	346	610	0	78892
24160	77045	1406	271	669	0	79391
24161	1436	606	75574	461	0	78077
24162	76021	469	1308	573	0	78371
24163	1515	429	447	77481	0	79872
24164	612	475	77616	1414	0	80117
24165	76196	335	1263	737	0	78531
24166	78074	416	413	620	0	79523
24167	78600	353	322	555	0	79830
24168	1747	321	295	77891	0	80254
24169	706	345	77277	1536	0	79864
24170	77842	266	1236	932	0	80276
24171	1532	307	465	80336	0	82640
24172	663	286	361	81119	0	82429
24173	521	308	82430	1719	0	84978
24174	407	81716	1223	794	0	84140
24175	562	1358	433	80255	0	82608
24176	397	81689	385	1236	0	83707
24177	81126	1348	334	701	0	83509
24178	81396	483	235	585	0	82699
24179	1559	377	231	80739	0	82906
24180	80604	273	189	1499	0	82565
24181	1389	79970	224	642	0	82225
24182	80480	1050	189	690	0	82409
24183	1343	80606	204	492	0	82645
24184	728	1220	248	81642	0	83838
24185	517	541	228	81166	0	82452
24186	405	81153	243	1367	0	83168
24187	466	1234	230	81277	0	83207
24188	393	507	80926	1362	0	83188
24189	338	79808	1031	666	0	81843
24190	78194	1019	338	564	0	80115
24191	1036	78335	265	364	0	80000
24192	473	970	192	79115	0	80750
24193	365	415	79151	1033	0	80964
24194	411	321	903	79636	0	81271
24195	341	297	268	80521	0	81427
24196	78826	173	208	1629	0	80836
24197	1155	192	78698	607	0	80652
24198	441	78874	970	593	0	80878
24199	409	1041	82033	441	0	83924
24200	261	368	80417	326	0	81372
24201	248	301	80221	299	0	81069
24202	600	1004	1313	77881	0	80798
24203	81112	136	573	1207	0	83028
24204	979	80722	230	377	0	82308
24205	82907	1049	147	408	0	84511
24206	85081	323	118	467	0	85989
24207	1379	227	133	83352	0	85091
24208	401	83635	130	1125	0	85291
24209	84191	1076	113	571	0	85951
24210	1114	84077	124	328	0	85643
24211	509	1140	107	83765	0	85521
24212	348	367	111	87026	0	87852
24213	199	86187	160	1349	0	87895
24214	237	1132	130	87482	0	88981
24215	228	389	85476	1243	0	87336
24216	226	363	84192	413	0	85194
24217	343	224	1223	86322	0	88112
24218	290	192	394	87858	0	88734
24219	210	202	84278	1380	0	86070
24220	210	187	82492	525	0	83414
24221	78766	147	1323	538	0	80774
24222	1119	81431	482	307	0	83339
24223	402	86747	303	456	0	87908
24224	391	1354	222	84877	0	86844
24225	328	443	157	86007	0	86935
24226	345	276	151	86761	0	87533
24227	242	239	85413	1463	0	87357
24228	244	233	83721	564	0	84762
24229	339	201	1323	86400	0	88263
24230	210	200	86065	1317	0	87792
24231	175	84781	1329	557	0	86842
24232	84845	1206	486	539	0	87076
24233	1267	371	84412	322	0	86372
24234	462	289	84569	289	0	85609
24235	461	342	1451	84946	0	87200
24236	261	235	90685	1397	0	92578
24237	228	92354	1533	586	0	94701
24238	514	1484	520	92611	0	95129
24239	237	481	93966	1567	0	96251
24240	161	91599	1577	662	0	93999
24241	90499	1484	624	600	0	93207
24242	1522	563	387	90224	0	92696
24243	588	357	245	91373	0	92563
24244	90626	240	243	1904	0	93013
24245	1353	90419	253	748	0	92773
24246	91500	1387	217	649	0	93753
24247	92003	500	222	579	0	93304
24248	92470	338	188	523	0	93519
24249	2037	238	199	90550	0	93024
24250	88804	226	235	1661	0	90926
24251	1668	84857	252	640	0	87417
24252	738	87040	216	510	0	88504
24253	90862	1638	221	492	0	93213
24254	1819	650	201	92102	0	94772
24255	835	443	197	93042	0	94517
24256	640	344	185	93897	0	95066
24257	402	346	90139	2233	0	93120
24258	334	90143	1542	982	0	93001
24259	437	1558	555	92657	0	95207
24260	92692	561	392	2083	0	95728
24261	1750	403	303	92907	0	95363
24262	648	364	92004	2027	0	95043
24263	492	91788	1650	927	0	94857
24264	92540	1639	630	870	0	95679
24265	92946	642	469	747	0	94804
24266	93589	478	354	677	0	95098
24267	2456	365	376	93467	0	96664
24268	1044	383	92585	1920	0	95932
24269	801	414	94146	904	0	96265
24270	607	97498	2248	641	0	100994
24271	776	2205	814	97350	0	101145
24272	681	727	470	100620	0	102498
24273	95752	506	380	2990	0	99628
24274	2402	449	295	97761	0	100907
24275	99759	314	273	2935	0	103281
24276	2744	404	97410	1195	0	101753
24277	1091	400	99344	939	0	101774
24278	1033	263	2787	98619	0	102702
24279	792	264	1084	101334	0	103474
24280	731	284	669	103924	0	105608
24281	103219	267	531	3607	0	107624
24282	108916	295	508	1576	0	111295
24283	3766	312	421	108500	0	112999
24284	1406	299	106337	3539	0	111581
24285	953	300	108645	1589	0	111487
24286	905	244	3759	109599	0	114507
24287	111106	209	1539	3756	0	116610
24288	3507	253	912	110518	0	115190
24289	1616	265	651	113592	0	116124
24290	869	262	110675	4500	0	116306
24291	714	281	111252	2003	0	114250
24292	107872	267	3973	1506	0	113618
24293	3487	276	110427	1098	0	115288
24294	1719	273	3520	107212	0	112724
24295	1280	262	1503	110723	0	113768
24296	108764	154	1059	4363	0	114340
24297	3392	106516	873	1890	0	112671
24298	106276	2879	806	1537	0	111498
24299	3462	104164	625	1073	0	109324
24300	103340	3023	658	1135	0	108156
24301	3659	1083	100974	955	0	106671
24302	96261	840	3335	1022	0	101458
24303	99040	379	1334	876	0	101629
24304	4072	569	952	96776	0	102369
24305	1830	346	96093	3064	0	101333
24306	1466	312	3035	92203	0	97016
24307	1123	319	1258	94815	0	97515
24308	876	91917	915	4049	0	97757
24309	1025	2581	697	92104	0	96407
24310	961	92108	616	3461	0	97146
24311	1091	2827	594	93401	0	97913
24312	91949	1096	619	3800	0	97464
24313	3378	704	596	92802	0	97480
24314	1699	482	91205	3723	0	97109
24315	90723	482	2913	1992	0	96110
24316	3572	368	92953	1506	0	98399
24317	93037	371	3234	1411	0	98053
24318	96225	361	1368	1373	0	99327
24319	4253	92692	1072	1172	0	99189
24320	2041	98067	866	1074	0	102048
24321	96437	3716	808	1214	0	102175
24322	99974	1468	739	1166	0	103347
24323	98919	805	685	1246	0	101655
24324	99127	552	638	1290	0	101607
24325	99388	454	669	1240	0	101751
24326	5077	489	653	95677	0	101896
24327	2589	458	718	98571	0	102336
24328	1778	562	94906	4339	0	101585
24329	93944	424	3228	2205	0	99801
24330	4186	502	1382	94374	0	100444
24331	2303	511	942	97358	0	101114
24332	1720	586	94231	4446	0	100983
24333	1557	89818	3412	2363	0	97150
24334	1556	95255	1537	1632	0	99980
24335	92989	3581	1276	1642	0	99488
24336	89943	1349	908	1283	0	93483
24337	4363	82885	766	1222	0	89236
24338	2100	85162	730	995	0	88987
24339	84799	3111	822	1126	0	89858
24340	87850	1229	682	1165	0	90926
24341	4160	729	597	85051	0	90537
24342	2184	538	630	86953	0	90305
24343	1700	524	568	88657	0	91449
24344	84477	513	571	4377	0	89938
24345	86660	551	548	2164	0	89923
24346	4225	546	565	85921	0	91257
24347	88007	584	547	3587	0	92725
24348	4123	610	87080	1781	0	93594
24349	2361	581	2922	88214	0	94078
24350	1746	556	87398	3673	0	93373
24351	1448	85895	3311	1784	0	92438
24352	1792	3158	1572	85915	0	92437
24353	85061	1195	1016	3612	0	90884
24354	3809	755	686	84554	0	89804
24355	2052	594	592	86144	0	89382
24356	1533	587	82864	4242	0	89226
24357	1421	647	83485	2068	0	87621
24358	1461	84443	3230	1481	0	90615
24359	85420	2852	1294	1310	0	90876
24360	87412	1151	826	1177	0	90566
24361	87479	752	653	1183	0	90067
24362	88060	570	581	1181	0	90392
24363	4675	506	599	84696	0	90476
24364	2492	454	543	85304	0	88793
24365	1729	84359	558	3803	0	90449
24366	85460	2684	571	1904	0	90619
24367	86405	1108	573	1449	0	89535
24368	4186	731	81845	1106	0	87868
24369	75430	489	2347	814	0	79080
24370	3242	76096	930	748	0	81016
24371	1833	3333	637	73299	0	79102
24372	1410	75848	429	2390	0	80077
24373	75633	2588	478	1379	0	80078
24374	2963	74661	345	976	0	78945
24375	1698	2284	381	72657	0	77020
24376	1206	827	286	74367	0	76686
24377	1028	549	307	72908	0	74792
24378	835	69916	329	3153	0	74233
24379	1052	2714	358	70431	0	74555
24380	1208	1440	357	69885	0	72890
24381	694	63491	298	2628	0	67111
24382	545	62838	220	1088	0	64691
24383	59595	1672	268	738	0	62273
24384	1620	60149	194	547	0	62510
24385	58234	1410	197	482	0	60323
24386	1672	544	56849	358	0	59423
24387	660	56262	1104	336	0	58362
24388	56234	1244	501	417	0	58396
24389	56199	480	292	397	0	57368
24390	1645	357	54490	351	0	56843
24391	805	327	1068	54099	0	56299
24392	535	227	55305	1320	0	57387
24393	381	54434	1199	596	0	56610
24394	53621	1257	508	555	0	55941
24395	1231	53110	294	356	0	54991
24396	592	1216	179	53245	0	55232
24397	505	462	167	54473	0	55607
24398	394	358	53504	1419	0	55675
24399	351	297	51351	637	0	52636
24400	51469	281	1293	534	0	53577
24401	53662	205	461	437	0	54765
24402	54000	218	262	424	0	54904
24403	53748	232	203	409	0	54592
24404	1633	53053	191	353	0	55230
24405	783	1159	176	53492	0	55610
24406	595	458	161	54511	0	55725
24407	409	54884	169	1475	0	56937
24408	56006	1190	160	739	0	58095
24409	56964	482	144	530	0	58120
24410	1657	344	55730	346	0	58077
24411	56462	253	1187	382	0	58284
24412	1614	248	415	56416	0	58693
24413	767	236	56010	1307	0	58320
24414	719	471	1272	55301	0	57763
24415	471	229	56517	1433	0	58650
24416	419	208	55318	532	0	56477
24417	473	709	1390	52615	0	55187
24418	289	52984	555	1109	0	54937
24419	53053	1018	387	534	0	54992
24420	52090	423	209	430	0	53152
24421	1351	53518	183	335	0	55387
24422	622	54923	187	271	0	56003
24423	55503	1161	286	455	0	57405
24424	56255	487	160	357	0	57259
24425	56557	302	168	270	0	57297
24426	56712	239	147	270	0	57368
24427	1549	277	150	56559	0	58535
24428	691	207	56063	1015	0	57976
24429	487	56000	936	447	0	57870
24430	55745	999	359	436	0	57539
24431	1059	57232	231	241	0	58763
24432	57487	1033	177	309	0	59006
24433	57849	374	115	287	0	58625
24434	1291	271	57663	131	0	59356
24435	581	59169	898	154	0	60802
24436	491	1032	305	59261	0	61089
24437	362	385	204	60572	0	61523
24438	409	255	129	58521	0	59314
24439	59491	216	98	1350	0	61155
24440	58150	168	104	609	0	59031
24441	58444	166	111	447	0	59168
24442	1278	57972	126	261	0	59637
24443	57698	880	103	313	0	58994
24444	1090	57836	105	242	0	59273
24445	436	960	57148	203	0	58747
24446	310	57034	767	206	0	58317
24447	618	1122	615	53712	0	56067
24448	191	204	154	53148	0	53697
24449	149	129	52692	677	0	53647
24450	237	111	556	51324	0	52228
24451	198	96	178	52778	0	53250
24452	53074	84	92	821	0	54071
24453	52461	107	78	367	0	53013
24454	53408	70	71	270	0	53819
24455	756	53121	114	130	0	54121
24456	52980	602	66	223	0	53871
24457	51845	178	62	222	0	52307
24458	764	52119	90	140	0	53113
24459	388	603	91	52304	0	53386
24460	357	209	69	52718	0	53353
24461	52392	115	80	822	0	53409
24462	683	146	51592	260	0	52681
24463	251	50305	546	189	0	51291
24464	241	920	149	49055	0	50365
24465	141	48417	110	548	0	49216
24466	135	49845	70	190	0	50240
24467	50101	600	171	246	0	51118
24468	50136	166	78	204	0	50584
24469	692	158	48	50160	0	51058
24470	317	103	42	49553	0	50015
24471	227	82	47	49853	0	50209
24472	198	93	49	49405	0	49745
24473	143	117	48300	662	0	49222
24474	170	120	46281	257	0	46828
24475	219	72	554	48784	0	49629
24476	145	108	50774	569	0	51596
24477	147	51244	573	225	0	52189
24478	52050	543	158	315	0	53066
24479	52931	193	118	268	0	53510
24480	774	143	96	53164	0	54177
24481	373	99	79	53496	0	54047
24482	239	95	83	54273	0	54690
24483	141	54200	90	782	0	55213
24484	54583	587	59	416	0	55645
24485	54759	184	40	391	0	55374
24486	862	160	53854	179	0	55055
24487	435	109	623	56348	0	57515
24488	282	114	58006	898	0	59300
24489	282	130	829	62175	0	63416
24490	316	112	212	62035	0	62675
24491	347	109	127	62370	0	62953
24492	279	111	100	64437	0	64927
24493	63948	112	98	1768	0	65926
24494	65591	94	101	789	0	66575
24495	67004	89	81	533	0	67707
24496	1873	95	97	66427	0	68492
24497	696	124	65250	1319	0	67389
24498	64299	75	1152	649	0	66175
24499	1492	80	363	66130	0	68065
24500	65991	82	266	1489	0	67828
24501	1543	88	114	65766	0	67511
24502	537	63421	143	1524	0	65625
24503	374	67351	129	610	0	68464
24504	457	1479	140	67115	0	69191
24505	431	524	144	67218	0	68317
24506	389	322	68	67255	0	68034
24507	211	65563	84	1742	0	67600
24508	65242	1168	64	832	0	67306
24509	1254	65515	99	482	0	67350
24510	446	1369	65315	307	0	67437
24511	453	462	1178	65054	0	67147
24512	202	67081	391	1338	0	69012
24513	275	1294	241	67168	0	68978
24514	340	398	127	68026	0	68891
24515	203	295	66616	1781	0	68895
24516	63538	140	1231	1030	0	65939
24517	1341	68384	415	584	0	70724
24518	68920	1279	259	610	0	71068
24519	70831	412	125	510	0	71878
24520	71238	296	118	488	0	72140
24521	2043	211	66863	315	0	69432
24522	993	153	1303	66052	0	68501
24523	670	176	436	67428	0	68710
24524	398	163	65430	1868	0	67859
24525	62223	166	1372	1001	0	64762
24526	1596	178	65782	586	0	68142
24527	583	135	64630	431	0	65779
24528	372	64633	1571	440	0	67016
24529	553	1371	714	64499	0	67137
24530	312	440	64858	1435	0	67045
24531	61373	328	1317	753	0	63771
24532	63327	172	472	587	0	64558
24533	1677	199	63025	348	0	65249
24534	824	192	1326	63027	0	65369
24535	480	197	64092	1413	0	66182
24536	309	64193	1492	636	0	66630
24537	67602	1366	569	669	0	70206
24538	69245	482	408	462	0	70597
24539	70698	334	248	441	0	71721
24540	2285	222	224	69286	0	72017
24541	987	190	245	71511	0	72933
24542	599	204	69688	2144	0	72635
24543	69301	178	1612	953	0	72044
24544	1944	175	574	70493	0	73186
24545	70200	133	395	1923	0	72651
24546	2043	161	69742	794	0	72740
24547	799	170	71676	552	0	73197
24548	763	161	2014	69195	0	72133
24549	557	161	828	72970	0	74516
24550	447	176	71489	2180	0	74292
24551	70090	140	1750	1063	0	73043
24552	1984	202	742	70131	0	73059
24553	782	72431	532	1846	0	75591
24554	73471	1614	372	997	0	76454
24555	1920	74104	358	706	0	77088
24556	74837	1814	410	612	0	77673
24557	2254	578	75298	470	0	78600
24558	1002	420	74255	463	0	76140
24559	738	75278	2128	475	0	78619
24560	75932	1694	935	588	0	79149
24561	2114	582	74788	455	0	77939
24562	73371	402	1888	572	0	76233
24563	2207	74431	811	515	0	77964
24564	1054	1618	612	76007	0	79291
24565	818	619	448	75842	0	77727
24566	546	73576	477	2212	0	76811
24567	77829	1742	419	1159	0	81149
24568	80787	620	419	757	0	82583
24569	82418	439	375	631	0	83863
24570	2733	345	80885	501	0	84464
24571	1311	298	1919	81226	0	84754
24572	891	281	811	82909	0	84892
24573	751	303	571	84872	0	86497
24574	605	318	82263	2683	0	85869
24575	566	80750	1928	1167	0	84411
24576	79609	1846	775	836	0	83066
24577	2133	718	79870	447	0	83168
24578	78618	442	2019	549	0	81628
24579	2221	79186	872	440	0	82719
24580	80345	1813	656	484	0	83298
24581	2380	869	450	79247	0	82946
24582	80744	453	463	2018	0	83678
24583	2423	367	439	80540	0	83769
24584	1058	301	81550	2118	0	85027
24585	936	818	1815	80930	0	84499
24586	703	322	80908	2098	0	84031
24587	75230	340	1815	971	0	78356
24588	1855	76711	812	598	0	79976
24589	888	1599	460	70886	0	73833
24590	547	74189	396	1215	0	76347
24591	73993	1333	472	697	0	76495
24592	74083	467	388	562	0	75500
24593	1643	72720	333	412	0	75108
24594	72887	1231	362	543	0	75023
24595	74192	405	270	491	0	75358
24596	1639	281	256	72868	0	75044
24597	782	240	231	73910	0	75163
24598	75120	215	240	1564	0	77139
24599	76269	194	244	695	0	77402
24600	1815	185	216	74881	0	77097
24601	891	206	196	79357	0	80650
24602	80242	153	191	1903	0	82489
24603	1735	198	79144	719	0	81796
24604	76664	176	1457	719	0	79016
24605	1817	223	77978	454	0	80472
24606	713	76822	1578	393	0	79506
24607	721	1466	645	76821	0	79653
24608	596	473	78906	1395	0	81370
24609	474	80305	1534	528	0	82841
24610	79686	1558	590	727	0	82561
24611	1614	528	79648	378	0	82168
24612	78037	347	1399	473	0	80256
24613	81309	294	424	450	0	82477
24614	82123	250	310	446	0	83129
24615	2027	214	276	78320	0	80837
24616	908	79356	284	1338	0	81886
24617	79172	1249	230	824	0	81475
24618	1665	395	80029	448	0	82537
24619	74582	296	1272	708	0	76858
24620	1588	292	79399	366	0	81645
24621	710	78692	1358	398	0	81158
24622	633	1190	566	79814	0	82203
24623	582	425	346	80140	0	81493
24624	450	78448	385	1519	0	80802
24625	585	1297	312	80392	0	82586
24626	473	517	80857	1496	0	83343
24627	479	80932	1315	597	0	83323
24628	536	1450	463	80651	0	83100
24629	80356	504	369	1633	0	82862
24630	83050	380	284	696	0	84410
24631	2071	314	254	83469	0	86108
24632	900	84600	276	1622	0	87398
24633	883	1366	240	85301	0	87790
24634	778	464	223	84878	0	86343
24635	538	382	80554	1971	0	83445
24636	472	81255	1374	918	0	84019
24637	556	1371	429	79884	0	82240
24638	373	459	78563	1411	0	80806
24639	341	77622	1207	540	0	79710
24640	500	1305	437	78313	0	80555
24641	78123	463	437	1504	0	80527
24642	1335	79378	254	563	0	81530
24643	707	1285	175	80437	0	82604
24644	82037	465	190	1597	0	84289
24645	83004	349	161	756	0	84270
24646	83085	283	183	662	0	84213
24647	82199	240	193	589	0	83221
24648	1889	238	169	80899	0	83195
24649	792	260	81534	1412	0	83998
24650	713	474	1162	79754	0	82103
24651	472	80796	457	1403	0	83128
24652	82167	1189	305	870	0	84531
24653	1430	461	79618	502	0	82011
24654	77601	323	1170	563	0	79657
24655	1474	332	78536	318	0	80660
24656	793	279	1219	78222	0	80513
24657	564	264	78806	1206	0	80840
24658	657	238	1199	77616	0	79710
24659	477	238	78396	1358	0	80469
24660	599	244	1192	77259	0	79294
24661	78481	167	490	1590	0	80728
24662	1267	81223	419	663	0	83572
24663	726	1206	319	82293	0	84544
24664	633	460	287	82395	0	83775
24665	553	354	83569	1456	0	85932
24666	505	316	79484	683	0	80988
24667	78326	291	1434	794	0	80845
24668	1283	80047	606	457	0	82393
24669	79667	983	583	534	0	81767
24670	80890	329	377	534	0	82130
24671	1433	255	347	79433	0	81468
24672	608	80845	335	1094	0	82882
24673	82695	1076	332	794	0	84897
24674	84002	352	255	647	0	85256
24675	84837	303	224	597	0	85961
24676	85119	263	236	587	0	86205
24677	84219	175	255	558	0	85207
24678	1638	223	81947	304	0	84112
24679	81711	188	1106	443	0	83448
24680	1561	252	81661	246	0	83720
24681	954	227	1091	80560	0	82832
24682	691	185	452	83817	0	85145
24683	568	213	81608	1352	0	83741
24684	80614	193	1149	791	0	82747
24685	1462	214	431	82635	0	84742
24686	758	193	355	85261	0	86567
24687	630	191	296	86190	0	87307
24688	644	175	239	85089	0	86147
24689	561	175	228	86194	0	87158
24690	432	230	85529	1758	0	87949
24691	546	174	1253	84605	0	86578
24692	421	182	86058	1601	0	88262
24693	487	230	83657	794	0	85168
24694	84822	143	1718	786	0	87469
24695	88217	146	684	699	0	89746
24696	93306	146	574	649	0	94675
24697	2335	163	94260	518	0	97276
24698	1126	201	93923	517	0	95767
24699	674	221	96341	524	0	97760
24700	511	98888	2629	580	0	102608
24701	1073	2246	1439	98009	0	102767
24702	102113	573	609	2232	0	105527
24703	2308	271	385	107500	0	110464
24704	897	109004	407	2478	0	112786
24705	111222	2122	384	1275	0	115003
24706	2704	788	381	110154	0	114027
24707	1143	111535	410	2453	0	115541
24708	1017	2172	400	113243	0	116832
24709	846	858	384	113398	0	115486
24710	110724	449	412	3434	0	115019
24711	2751	341	432	111007	0	114531
24712	1226	424	109138	2932	0	113720
24713	1057	337	2380	108325	0	112099
24714	646	104989	1128	3001	0	109764
24715	574	110066	807	1524	0	112971
24716	735	2920	588	107335	0	111578
24717	692	1255	611	107308	0	109866
24718	547	104688	573	3498	0	109306
24719	589	106068	489	1899	0	109045
24720	543	108626	415	1366	0	110950
24721	878	3487	313	101469	0	106147
24722	631	107139	323	2866	0	110959
24723	106111	3041	329	1888	0	111369
24724	2691	1570	106210	1301	0	111772
24725	1457	1224	2309	104539	0	109529
24726	759	107372	960	3057	0	112148
24727	106105	2853	586	1973	0	111517
24728	2667	1495	106069	1463	0	111694
24729	1261	106530	2474	1240	0	111505
24730	104243	2723	1145	1397	0	109508
24731	2375	103065	728	1047	0	107215
24732	1083	105247	533	949	0	107812
24733	1022	3573	509	103102	0	108206
24734	587	105222	381	2710	0	108900
24735	104047	3046	416	1719	0	109228
24736	2605	1773	354	103842	0	108574
24737	1155	1396	102445	2691	0	107687
24738	771	1269	101412	1473	0	104925
24739	754	1386	2639	102590	0	107369
24740	601	1203	103732	2669	0	108205
24741	762	1106	2442	104031	0	108341
24742	101134	915	1125	3226	0	106400
24743	2446	935	101324	1551	0	106256
24744	1378	832	2353	99288	0	103851
24745	773	98625	1302	2689	0	103389
24746	734	2581	875	101946	0	106136
24747	848	1394	710	102051	0	105003
24748	686	99662	808	3238	0	104394
24749	769	2659	657	103481	0	107566
24750	723	1522	621	104582	0	107448
24751	534	1296	101978	3441	0	107249
24752	547	100983	2338	1940	0	105808
24753	101502	2762	1131	1665	0	107060
24754	2408	1536	789	102950	0	107683
24755	1209	1063	103127	3070	0	108469
24756	924	881	2491	103015	0	107311
24757	569	837	102748	3282	0	107436
24758	98329	788	2795	2273	0	104185
24759	2338	102005	1461	1569	0	107373
24760	1341	2500	1102	104090	0	109033
24761	990	1313	809	107114	0	110226
24762	101616	956	833	3835	0	107240
24763	2652	863	766	103009	0	107290
24764	1294	926	100931	3536	0	106687
24765	931	981	2489	98257	0	102658
24766	641	95401	1343	3533	0	100918
24767	645	99469	903	2261	0	103278
24768	589	101460	787	1845	0	104681
24769	743	3515	689	100604	0	105551
24770	654	1871	98119	3367	0	104011
24771	619	98135	2464	2175	0	103393
24772	95571	2848	1289	1785	0	101493
24773	2291	97954	885	1527	0	102657
24774	98227	2965	756	1738	0	103686
24775	99141	1552	811	1556	0	103060
24776	3083	1283	96605	1326	0	102297
24777	98872	1093	2506	1487	0	103958
24778	103746	1033	1243	1604	0	107626
24779	99393	1028	837	1687	0	102945
24780	104184	940	637	1513	0	107274
24781	3541	967	101055	1244	0	106807
24782	101222	899	2447	1333	0	105901
24783	105278	959	1223	1309	0	108769
24784	3335	105772	871	1092	0	111070
24785	1826	2959	550	105517	0	110852
24786	1349	1805	556	106362	0	110072
24787	1033	105672	653	3297	0	110655
24788	105233	2862	621	1840	0	110556
24789	2789	106353	733	1060	0	110935
24790	104332	2948	750	966	0	108996
24791	105632	1602	521	975	0	108730
24792	3484	105461	509	791	0	110245
24793	2103	2764	523	104941	0	110331
24794	1485	1273	105158	2609	0	110525
24795	1216	102960	2423	1325	0	107924
24796	1495	3790	1177	94689	0	101151
24797	1008	96472	752	1906	0	100138
24798	808	101615	415	918	0	103756
24799	1306	3827	620	96218	0	101971
24800	677	1240	98061	2144	0	102122
24801	512	94011	2009	1236	0	97768
24802	438	94650	1023	704	0	96815
24803	85186	2019	579	404	0	88188
24804	1483	840	153	86707	0	89183
24805	780	367	98	87579	0	88824
24806	415	242	73	89690	0	90420
24807	226	243	87468	2300	0	90237
24808	354	175	1555	87915	0	89999
24809	131	90017	685	1953	0	92786
24810	93011	1764	261	1028	0	96064
24811	2037	769	136	93259	0	96201
24812	818	407	92481	2034	0	95740
24813	93515	243	1878	1046	0	96682
24814	2366	243	740	97131	0	100480
24815	971	238	101478	2162	0	104849
24816	456	267	101786	977	0	103486
24817	101990	215	2996	694	0	105895
24818	107975	185	1077	602	0	109839
24819	107883	204	465	519	0	109071
24820	109277	192	303	521	0	110293
24821	3518	267	105867	287	0	109939
24822	1395	107396	2256	350	0	111397
24823	107873	2338	945	618	0	111774
24824	2565	107675	426	348	0	111014
24825	107715	2579	276	551	0	111121
24826	2705	107904	282	363	0	111254
24827	1382	2640	240	108092	0	112354
24828	783	1062	255	109535	0	111635
24829	711	523	251	109024	0	110509
24830	460	104537	306	3377	0	108680
24831	447	107982	293	1383	0	110105
24832	624	3038	232	104323	0	108217
24833	425	105576	296	2510	0	108807
24834	438	2711	104743	1094	0	108986
24835	653	1211	2458	104551	0	108873
24836	490	673	105530	2573	0	109266
24837	103288	497	2607	1391	0	107783
24838	106212	470	1049	814	0	108545
24839	3509	482	104482	482	0	108955
24840	1535	488	103761	502	0	106286
24841	998	442	3218	103250	0	107908
24842	657	514	104682	2642	0	108495
24843	770	491	2722	100402	0	104385
24844	730	93525	1500	2682	0	98437
24845	682	2746	610	105034	0	109072
24846	640	1237	480	106093	0	108450
24847	653	698	417	106185	0	107953
24848	426	601	102205	3889	0	107121
24849	628	519	2589	101486	0	105222
24850	601	569	1150	102709	0	105029
24851	637	541	640	100988	0	102806
24852	451	101058	563	3510	0	105582
24853	101667	2606	537	1745	0	106555
24854	102696	1194	516	1267	0	105673
24855	102654	632	535	1108	0	104929
24856	3775	566	573	99695	0	104609
24857	1646	575	98647	2964	0	103832
24858	1981	564	96863	1571	0	100979
24859	760	99019	3292	1094	0	104165
24860	96584	2675	1481	1165	0	101905
24861	2523	98130	813	986	0	102452
24862	98593	2754	701	1060	0	103108
24863	2779	98196	631	1031	0	102637
24864	97990	2906	582	1043	0	102521
24865	2937	101272	584	1032	0	105825
24866	1684	2998	519	102012	0	107213
24867	1051	1414	100249	3139	0	105853
24868	947	894	101162	1685	0	104688
24869	974	772	3474	100207	0	105427
24870	909	711	1653	101400	0	104673
24871	939	645	865	103770	0	106219
24872	877	673	100262	3980	0	105792
24873	997	569	2706	99238	0	103510
24874	97400	556	1350	3614	0	102920
24875	98766	517	874	2030	0	102187
24876	3598	96286	746	1274	0	101904
24877	95323	2664	735	1140	0	99862
24878	3119	94250	592	980	0	98941
24879	94526	2971	618	988	0	99103
24880	95650	1439	700	963	0	98752
24881	93892	937	648	976	0	96453
24882	3928	751	91340	845	0	96864
24883	1963	803	89600	835	0	93201
24884	89337	588	3285	965	0	94175
24885	93179	552	1659	878	0	96268
24886	3872	609	938	91275	0	96694
24887	2096	493	639	94761	0	97989
24888	1343	460	656	97159	0	99618
24889	1075	553	672	98266	0	100566
24890	1015	575	616	100914	0	103120
24891	97374	624	535	4511	0	103044
24892	3308	613	432	98359	0	102712
24893	1756	628	96748	3545	0	102677
24894	94734	587	2652	2147	0	100120
24895	98747	482	1397	1439	0	102065
24896	3928	95741	777	1235	0	101681
24897	1616	98119	532	1081	0	101348
24898	91016	2603	508	839	0	94966
24899	2278	93447	409	659	0	96793
24900	91986	2245	706	781	0	95718
24901	96769	860	531	796	0	98956
24902	97986	365	323	702	0	99376
24903	3558	326	352	93110	0	97346
24904	1454	93630	361	2398	0	97843
24905	95858	2079	275	1219	0	99431
24906	2850	849	281	95523	0	99503
24907	1548	454	199	94908	0	97109
24908	90935	265	181	3068	0	94449
24909	2211	89179	211	1379	0	92980
24910	1132	1963	127	89539	0	92761
24911	89967	777	143	2424	0	93311
24912	2164	90868	150	1081	0	94263
24913	92422	1856	95	828	0	95201
24914	2383	880	84320	524	0	88107
24915	86663	394	1372	544	0	88973
24916	2237	88493	526	345	0	91601
24917	88079	1745	498	484	0	90806
24918	87886	698	150	439	0	89173
24919	2467	88075	92	304	0	90938
24920	88890	1731	88	429	0	91138
24921	2177	86883	119	274	0	89453
24922	89536	1872	92	458	0	91958
24923	2373	819	84	89004	0	92280
24924	1342	494	63	89723	0	91622
24925	945	359	64	91047	0	92415
24926	582	389	86920	2470	0	90361
24927	728	320	1568	87688	0	90304
24928	525	388	87539	2076	0	90528
24929	730	292	1765	86843	0	89630
24930	524	87037	718	1949	0	90228
24931	619	1766	313	89299	0	91997
24932	563	816	88167	2058	0	91604
24933	540	583	89939	957	0	92019
24934	594	391	2104	89966	0	93055
24935	89643	292	868	2243	0	93046
24936	90787	265	447	1179	0	92678
24937	2422	90094	309	802	0	93627
24938	1309	1740	236	91311	0	94596
24939	769	805	92676	2072	0	96322
24940	743	483	1744	93184	0	96154
24941	545	389	93486	2327	0	96747
24942	90946	313	1994	1403	0	94656
24943	2245	367	821	94103	0	97536
24944	1161	371	92457	2155	0	96144
24945	974	323	1871	92924	0	96092
24946	759	370	820	95073	0	97022
24947	652	316	93360	2801	0	97129
24948	714	296	1947	93504	0	96461
24949	93499	287	858	2675	0	97319
24950	95069	304	558	1422	0	97353
24951	2825	321	420	95164	0	98730
24952	95864	306	348	2598	0	99116
24953	2520	379	95124	1249	0	99272
24954	1312	380	93692	974	0	96358
24955	95823	261	2496	969	0	99549
24956	99567	239	1151	945	0	101902
24957	2911	253	702	97140	0	101006
24958	1536	264	504	99238	0	101542
24959	998	262	96885	2952	0	101097
24960	910	297	2076	93627	0	96910
24961	705	96638	1010	2476	0	100829
24962	98340	1902	648	1443	0	102333
24963	105333	780	536	1138	0	107787
24964	3217	104304	457	842	0	108820
24965	102380	2310	408	972	0	106070
24966	103127	870	484	907	0	105388
24967	3393	102737	484	721	0	107335
24968	103684	2441	441	910	0	107476
24969	3039	103861	504	695	0	108099
24970	105255	2670	400	879	0	109204
24971	3189	1124	103585	675	0	108573
24972	1642	651	2500	104289	0	109082
24973	1225	463	993	107679	0	110360
24974	1055	373	689	111712	0	113829
24975	109733	373	524	4101	0	114731
24976	3363	402	394	112808	0	116967
24977	1641	393	111324	3588	0	116946
24978	112294	374	2859	1780	0	117307
24979	3582	347	1041	112445	0	117415
24980	1614	108753	829	3456	0	114652
24981	1131	114224	651	1603	0	117609
24982	1155	3381	504	112716	0	117756
24983	1151	1333	527	113373	0	116384
24984	1141	764	515	114815	0	117235
24985	850	543	108621	4432	0	114446
24986	771	107478	2732	2116	0	113097
24987	105619	2493	1035	1548	0	110695
24988	104692	1008	819	1323	0	107842
24989	3327	101328	592	965	0	106212
24990	1449	103578	530	883	0	106440
24991	1625	3211	712	100622	0	106170
24992	893	1117	99252	2782	0	104044
24993	95342	1068	2449	1567	0	100426
24994	98552	531	909	1194	0	101186
24995	2982	356	665	96976	0	100979
24996	1432	296	472	98022	0	100222
24997	94637	297	329	3186	0	98449
24998	2576	334	92848	1532	0	97290
24999	90609	334	2046	1366	0	94355
25000	2637	90765	833	834	0	95069
25001	917	1718	386	85220	0	88241
25002	660	85561	334	1926	0	88481
25003	86858	1773	371	1012	0	90014
25004	2115	651	339	85472	0	88577
25005	1045	493	272	84904	0	86714
25006	716	84065	259	2236	0	87276
25007	85253	1670	271	1097	0	88291
25008	86047	586	247	918	0	87798
25009	2321	508	83597	595	0	87021
25010	1010	416	80052	591	0	82069
25011	80411	265	1842	612	0	83130
25012	2012	264	80198	495	0	82969
25013	852	315	76500	438	0	78105
25014	75831	409	2134	624	0	78998
25015	1805	249	81510	448	0	84012
25016	925	231	2051	80718	0	83925
25017	697	196	800	82247	0	83940
25018	85532	181	575	2832	0	89120
25019	2570	284	86033	1190	0	90077
25020	89449	240	2421	941	0	93051
25021	3375	246	931	90404	0	94956
25022	91250	225	717	2910	0	95102
25023	92922	203	467	1363	0	94955
25024	94171	160	390	1092	0	95813
25025	4606	211	345	91033	0	96195
25026	93179	180	309	3114	0	96782
25027	4348	171	279	92380	0	97178
25028	2427	173	312	93959	0	96871
25029	1945	203	318	94757	0	97223
25030	1613	201	268	95633	0	97715
25031	92522	220	276	4783	0	97801
25032	94313	210	301	2603	0	97427
25033	4213	223	91893	1848	0	98177
25034	94053	203	2755	1573	0	98584
25035	97789	139	1072	1440	0	100440
25036	4714	185	818	93943	0	99660
25037	2527	92772	519	3475	0	99293
25038	95561	2701	471	1728	0	100461
25039	4390	1011	437	92387	0	98225
25040	92331	690	411	3618	0	97050
25041	4290	90263	485	1734	0	96772
25042	92906	2882	361	1492	0	97641
25043	4583	1172	294	90347	0	96396
25044	2185	89293	278	3525	0	95281
25045	91635	3101	292	1845	0	96873
25046	3889	88649	311	1548	0	94397
25047	1958	93869	356	1257	0	97440
25048	93918	3709	389	1287	0	99303
25049	3871	1879	91030	1117	0	97897
25050	93103	1271	2766	1031	0	98171
25051	4682	909	1082	91929	0	98602
25052	2532	752	92094	3202	0	98580
25053	2453	647	3077	90742	0	96919
25054	2069	647	1326	93501	0	97543
25055	1800	593	91073	4528	0	97994
25056	91448	473	3244	2565	0	97730
25057	4378	396	1402	92469	0	98645
25058	2511	423	987	94390	0	98311
25059	2183	406	651	94538	0	97778
25060	91532	407	604	5741	0	98284
25061	4126	458	88280	3217	0	96081
25062	2287	466	89175	2386	0	94314
25063	1942	540	3269	84105	0	89856
25064	1555	388	83257	3712	0	88912
25065	81968	386	3223	2234	0	87811
25066	3463	81673	1698	1781	0	88615
25067	82185	2439	1493	1407	0	87524
25068	4252	1094	1009	78930	0	85285
25069	2251	78935	975	3123	0	85284
25070	2067	3119	881	79321	0	85388
25071	1720	79962	699	3590	0	85971
25072	1689	3256	574	81065	0	86584
25073	1540	1413	78550	3861	0	85364
25074	1326	1301	75279	2189	0	80095
25075	1239	75822	2829	2032	0	81922
25076	72311	2395	1670	1694	0	78070
25077	2814	1296	1009	71616	0	76735
25078	1725	1022	758	72728	0	76233
25079	71688	784	738	3494	0	76704
25080	72433	711	746	2136	0	76026
25081	3717	578	727	71502	0	76524
25082	2255	503	69684	2981	0	75423
25083	1885	69298	2364	1820	0	75367
25084	1635	2223	1137	70873	0	75868
25085	1516	1036	1060	70658	0	74270
25086	1291	71254	705	3507	0	76757
25087	72164	2470	588	2352	0	77574
25088	2957	1338	71696	1725	0	77716
25089	1791	1142	2339	71764	0	77036
25090	1361	921	1171	72724	0	76177
25091	1071	865	70668	3929	0	76533
25092	1177	748	2521	72155	0	76601
25093	71751	691	1359	3851	0	77652
25094	72579	611	1282	2323	0	76795
25095	73118	508	1053	2009	0	76688
25096	3823	70297	897	1804	0	76821
25097	74660	2235	836	1588	0	79319
25098	3915	1056	735	73542	0	79248
25099	2357	998	703	73713	0	77771
25100	2052	77185	659	3627	0	83523
25101	83380	2872	612	2315	0	89179
25102	87549	1441	622	1918	0	91530
25103	88985	1233	605	1676	0	92499
25104	90631	1045	525	1639	0	93840
25105	90542	809	568	1725	0	93644
25106	5454	769	85697	1428	0	93348
25107	89373	730	3128	1351	0	94582
25108	91374	697	1411	1327	0	94809
25109	90734	497	1272	1292	0	93795
25110	5872	444	947	86520	0	93783
25111	3579	484	836	88354	0	93253
25112	2823	462	83752	4362	0	91399
25113	75072	547	3098	3032	0	81749
25114	3904	81579	1467	2110	0	89060
25115	2005	77606	908	1393	0	81912
25116	1743	2601	76055	1117	0	81516
25117	1270	74286	2393	1094	0	79043
25118	1089	73803	1026	937	0	76855
25119	1544	3521	1266	64442	0	70773
25120	681	66580	437	1742	0	69440
25121	66035	1904	234	784	0	68957
25122	65971	724	221	624	0	67540
25123	2518	502	215	64141	0	67376
25124	1268	374	63435	1718	0	66795
25125	63358	234	1591	766	0	65949
25126	2280	235	63635	594	0	66744
25127	1090	191	64507	500	0	66288
25128	1043	280	2010	61712	0	65045
25129	882	283	850	63857	0	65872
25130	639	181	63657	2085	0	66562
25131	492	61091	1745	1011	0	64339
25132	502	64994	673	804	0	66973
25133	63308	1899	617	727	0	66551
25134	64214	691	373	526	0	65804
25135	1937	452	61898	255	0	64542
25136	61643	344	1356	293	0	63636
25137	64800	213	436	368	0	65817
25138	2112	201	312	63182	0	65807
25139	1089	178	218	64254	0	65739
25140	905	182	163	64665	0	65915
25141	64242	172	124	2006	0	66544
25142	65136	139	133	928	0	66336
25143	66055	131	140	672	0	66998
25144	2444	112	181	64830	0	67567
25145	1277	167	63381	1478	0	66303
25146	63086	143	1382	665	0	65276
25147	63661	137	523	535	0	64856
25148	2213	174	414	61635	0	64436
25149	1127	62165	300	1472	0	65064
25150	986	1393	233	62496	0	65108
25151	692	63013	226	1730	0	65661
25152	688	1745	248	61592	0	64273
25153	571	63633	269	1708	0	66181
25154	63002	1617	286	687	0	65592
25155	1809	711	226	62850	0	65596
25156	809	62561	231	1464	0	65065
25157	734	1505	61935	588	0	64762
25158	61392	597	1414	559	0	63962
25159	1704	576	472	61827	0	64579
25160	736	61428	390	1568	0	64122
25161	805	1413	271	60537	0	63026
25162	620	59128	248	1573	0	61569
25163	532	63296	262	674	0	64764
25164	62405	1702	263	690	0	65060
25165	63908	715	280	503	0	65406
25166	1813	560	63058	299	0	65730
25167	63128	391	1356	421	0	65296
25168	64030	318	553	473	0	65374
25169	1901	62263	440	373	0	64977
25170	1009	1352	317	63224	0	65902
25171	849	527	264	63651	0	65291
25172	684	506	61950	1624	0	64764
25173	659	408	60675	723	0	62465
25174	62214	270	1602	655	0	64741
25175	63912	167	761	519	0	65359
25176	64123	153	568	463	0	65307
25177	2198	171	61789	295	0	64453
25178	1178	153	1397	61429	0	64157
25179	62490	161	487	1637	0	64775
25180	1669	188	404	62370	0	64631
25181	766	198	60952	1684	0	63600
25182	59219	204	1306	804	0	61533
25183	1731	263	62682	529	0	65205
25184	784	61755	1423	427	0	64389
25185	62813	1244	620	447	0	65124
25186	1635	453	61849	303	0	64240
25187	875	502	1336	60973	0	63686
25188	61672	286	533	1447	0	63938
25189	1613	249	337	62008	0	64207
25190	62790	207	226	1766	0	64989
25191	1665	230	158	62546	0	64599
25192	63826	206	191	1848	0	66071
25193	64713	216	156	891	0	65976
25194	64669	210	185	653	0	65717
25195	64186	207	198	555	0	65146
25196	2177	507	302	62905	0	65891
25197	974	213	61136	1182	0	63505
25198	837	218	60505	522	0	62082
25199	547	59956	1317	510	0	62330
25200	356	55651	573	333	0	56913
25201	49990	808	1114	243	0	52155
25202	683	229	204	48083	0	49199
25203	205	91	48500	433	0	49229
25204	160	106	48818	149	0	49233
25205	239	271	489	49375	0	50374
25206	49813	36	171	560	0	50580
25207	408	49885	113	158	0	50564
25208	52206	379	77	271	0	52933
25209	497	112	66	52732	0	53407
25210	219	67	68	52987	0	53341
25211	199	58	54	52924	0	53235
25212	139	73	52712	538	0	53462
25213	125	74	51087	213	0	51499
25214	111	51935	522	150	0	52718
25215	134	432	163	53918	0	54647
25216	53420	118	109	572	0	54219
25217	512	87	52418	169	0	53186
25218	199	106	52628	130	0	53063
25219	210	73	584	54091	0	54958
25220	159	59	177	55676	0	56071
25221	134	60	118	56205	0	56517
25222	205	58	101	59433	0	59797
25223	61136	47	105	1093	0	62381
25224	920	43	96	62264	0	63323
25225	62556	54	81	1108	0	63799
25226	1024	68	63261	381	0	64734
25227	341	63658	914	235	0	65148
25228	297	943	270	64177	0	65687
25229	186	254	64908	1013	0	66361
25230	201	137	63831	383	0	64552
25231	156	64639	1131	267	0	66193
25232	299	840	340	63623	0	65102
25233	191	235	190	64448	0	65064
25234	129	145	64274	1106	0	65654
25235	62475	100	975	548	0	64098
25236	1034	75	338	64841	0	66288
25237	367	79	217	64497	0	65160
25238	193	130	65239	1212	0	66774
25239	115	63939	1098	530	0	65682
25240	135	69774	328	343	0	70580
25241	70346	1321	235	412	0	72314
25242	1406	414	192	71186	0	73198
25243	73753	210	168	1545	0	75676
25244	1610	180	73192	543	0	75525
25245	682	104	1467	73454	0	75707
25246	73764	128	483	1757	0	76132
25247	75188	114	295	714	0	76311
25248	2056	135	181	74167	0	76539
25249	763	99	73471	1646	0	75979
25250	455	120	74587	609	0	75771
25251	511	255	1782	74166	0	76714
25252	306	131	74512	1627	0	76576
25253	71676	103	1616	826	0	74221
25254	1508	73402	618	519	0	76047
25255	74830	1331	450	478	0	77089
25256	76162	451	295	502	0	77410
25257	2044	235	254	75531	0	78064
25258	868	167	352	76663	0	78050
25259	76447	171	278	2069	0	78965
25260	1734	186	244	76506	0	78670
25261	665	175	75761	1829	0	78430
25262	470	75630	1474	817	0	78391
25263	449	1398	562	75550	0	77959
25264	476	463	360	76082	0	77381
25265	411	307	284	76765	0	77767
25266	401	219	74219	2243	0	77082
25267	396	73473	1547	1031	0	76447
25268	434	1402	593	75502	0	77931
25269	310	483	74731	1898	0	77422
25270	421	325	1618	74596	0	76960
25271	74787	282	589	2178	0	77836
25272	1725	214	441	76071	0	78451
25273	711	261	74938	2008	0	77918
25274	74241	195	1636	1268	0	77340
25275	1660	75807	797	719	0	78983
25276	668	79082	536	750	0	81036
25277	79846	1682	489	861	0	82878
25278	1818	663	81422	576	0	84479
25279	959	425	1600	81040	0	84024
25280	725	273	663	83642	0	85303
25281	511	293	82608	2172	0	85584
25282	422	82324	1733	1135	0	85614
25283	812	1506	715	75224	0	78257
25284	498	569	82179	1895	0	85141
25285	598	352	1712	81890	0	84552
25286	82081	335	802	2258	0	85476
25287	1766	397	83886	1009	0	87058
25288	893	357	1672	84705	0	87627
25289	661	293	672	85867	0	87493
25290	510	304	83606	2420	0	86840
25291	637	281	1738	81302	0	83958
25292	554	73550	1014	2244	0	77362
25293	525	1514	694	78399	0	81132
25294	439	82142	580	2001	0	85162
25295	82453	1634	505	1328	0	85920
25296	81321	666	519	1064	0	83570
25297	2116	419	80562	922	0	84019
25298	900	409	79826	765	0	81900
25299	681	390	79292	745	0	81108
25300	525	79055	2098	690	0	82368
25301	607	1588	1118	81224	0	84537
25302	586	604	82086	1869	0	85145
25303	708	419	1777	78896	0	81800
25304	571	324	859	80688	0	82442
25305	492	310	81126	2299	0	84227
25306	619	325	1737	81235	0	83916
25307	535	366	807	80209	0	81917
25308	458	79166	663	2349	0	82636
25309	551	1419	617	81482	0	84069
25310	471	597	618	83511	0	85197
25311	432	431	81720	2522	0	85105
25312	465	338	1747	81078	0	83628
25313	390	280	82001	2442	0	85113
25314	337	379	80387	1328	0	82431
25315	79040	315	2079	1171	0	82605
25316	1626	451	1031	79705	0	82813
25317	683	80462	811	2067	0	84023
25318	573	82813	597	1241	0	85224
25319	577	1993	693	83557	0	86820
25320	507	731	82663	2144	0	86045
25321	482	82104	1812	1274	0	85672
25322	543	1572	794	79884	0	82793
25323	339	482	81412	1600	0	83833
25324	315	81679	1271	801	0	84066
25325	84808	1252	741	885	0	87686
25326	85096	517	548	747	0	86908
25327	85688	385	386	815	0	87274
25328	1622	285	376	90053	0	92336
25329	702	270	378	90835	0	92185
25330	483	284	357	90903	0	92027
25331	313	243	88930	2145	0	91631
25332	89230	280	1496	1203	0	92209
25333	1598	254	634	90397	0	92883
25334	583	263	88528	1715	0	91089
25335	90044	265	1497	1035	0	92841
25336	92842	197	679	939	0	94657
25337	1911	767	75294	1051	0	79023
25338	90165	226	1146	840	0	92377
25339	1563	93032	649	613	0	95857
25340	557	1020	90907	335	0	92819
25341	87972	502	1418	607	0	90499
25342	1082	88786	502	493	0	90863
25343	333	819	260	86518	0	87930
25344	176	87110	184	879	0	88349
25345	212	848	186	88561	0	89807
25346	144	247	88494	1013	0	89898
25347	81336	136	966	600	0	83038
25348	917	143	88820	279	0	90159
25349	251	86316	1030	282	0	87879
25350	162	88708	310	233	0	89413
25351	87551	1011	224	332	0	89118
25352	926	331	87197	203	0	88657
25353	364	174	939	85912	0	87389
25354	171	168	87642	943	0	88924
25355	128	87654	1011	331	0	89124
25356	297	928	309	83793	0	85327
25357	101	87541	242	798	0	88682
25358	89570	1026	171	471	0	91238
25359	90488	286	159	365	0	91298
25360	90455	158	168	358	0	91139
25361	1206	170	88744	161	0	90281
25362	404	173	86403	174	0	87154
25363	87151	101	1182	347	0	88781
25364	1068	144	90962	163	0	92337
25365	464	96	1113	86771	0	88444
25366	197	89087	385	913	0	90582
25367	92165	973	232	499	0	93869
25368	91929	233	178	479	0	92819
25369	93916	151	165	424	0	94656
25370	1419	114	137	93926	0	95596
25371	534	87	152	95052	0	95825
25372	93996	87	163	1485	0	95731
25373	1168	92695	157	537	0	94557
25374	92516	1045	134	433	0	94128
25375	1292	275	128	91264	0	92959
25376	502	146	108	91488	0	92244
25377	88916	110	115	1521	0	90662
25378	1141	87228	126	468	0	88963
25379	87623	1083	110	485	0	89301
25380	1227	87775	131	228	0	89361
25381	87785	1161	138	290	0	89374
25382	1400	344	85	95911	0	97740
25383	96829	180	117	1322	0	98448
25384	99719	153	92	520	0	100484
25385	106503	146	265	511	0	107425
25386	1897	109371	125	216	0	111609
25387	662	1673	107066	133	0	109534
25388	107688	439	1661	315	0	110103
25389	110504	260	413	346	0	111523
25390	2133	108275	285	203	0	110896
25391	967	1674	178	109944	0	112763
25392	707	498	130	111306	0	112641
25393	110514	279	197	2277	0	113267
25394	2132	267	147	111694	0	114240
25395	772	220	111224	2034	0	114250
25396	593	265	109487	695	0	111040
25397	112692	160	2060	653	0	115565
25398	2169	171	608	113331	0	116279
25399	922	136	374	114928	0	116360
25400	699	124	287	116303	0	117413
25401	504	176	115452	2446	0	118578
25402	641	128	1918	114780	0	117467
25403	657	126	598	118104	0	119485
25404	525	116	366	119817	0	120824
25405	116789	131	260	2948	0	120128
25406	2338	141	237	117755	0	120471
25407	766	208	118365	2526	0	121865
25408	119284	211	2028	1299	0	122822
25409	2495	229	122787	700	0	126211
25410	124018	168	2373	860	0	127419
25411	124934	196	735	718	0	126583
25412	3345	203	443	126733	0	130724
25413	1220	127182	402	2745	0	131549
25414	1130	2397	313	128904	0	132744
25415	954	1116	351	130384	0	132805
25416	665	129884	361	3319	0	134229
25417	129734	2433	357	1555	0	134079
25418	2646	129012	383	962	0	133003
25419	129665	2650	333	944	0	133592
25420	131377	835	244	953	0	133409
25421	3546	540	244	129168	0	133498
25422	1620	480	256	129545	0	131901
25423	946	380	124224	3368	0	128918
25424	813	403	120179	1383	0	122778
25425	118110	376	2846	1296	0	122628
25426	120875	314	1013	1113	0	123315
25427	3174	114670	629	895	0	119368
25428	1492	2089	559	113065	0	117205
25429	1003	642	116490	2594	0	120729
25430	1206	1314	2423	115471	0	120414
25431	114100	555	1156	3018	0	118829
25432	111224	292	568	1364	0	113448
25433	2943	109561	455	961	0	113920
25434	1502	2124	324	110455	0	114405
25435	1087	797	298	112151	0	114333
25436	938	536	283	112965	0	114722
25437	772	462	107223	3248	0	111705
25438	101223	406	2095	1724	0	105448
25439	106327	432	668	1259	0	108686
25440	3182	439	104962	912	0	109495
25441	1450	104623	2205	934	0	109212
25442	105399	2113	834	1026	0	109372
25443	106631	708	627	1037	0	109003
25444	3173	548	102400	933	0	107054
25445	1522	467	104700	853	0	107542
25446	1420	578	2668	103786	0	108452
25447	1088	473	104623	2418	0	108602
25448	102302	458	2603	1210	0	106573
25449	104278	406	1045	975	0	106704
25450	105413	364	814	1001	0	107592
25451	3303	337	705	100693	0	105038
25452	1600	104786	672	2484	0	109542
25453	107224	1949	612	1472	0	111257
25454	107417	742	556	1201	0	109916
25455	3344	571	103758	919	0	108592
25456	1794	545	101402	904	0	104645
25457	100325	436	2472	1078	0	104311
25458	3018	432	1050	103495	0	107995
25459	1575	435	102685	2601	0	107296
25460	1286	101820	2400	1342	0	106848
25461	1390	2023	1160	102990	0	107563
25462	102196	763	890	2649	0	106498
25463	2729	103863	768	1241	0	108601
25464	1531	2156	668	103113	0	107468
25465	1298	100866	722	2573	0	105459
25466	1087	104796	747	1336	0	107966
25467	1254	2387	715	104575	0	108931
25468	1161	1016	722	104838	0	107737
25469	1027	104560	720	2900	0	109207
25470	105094	2256	669	1493	0	109512
25471	2987	1000	104632	965	0	109584
25472	104235	747	2159	1177	0	108318
25473	3109	674	928	106851	0	111562
25474	1629	610	732	108215	0	111186
25475	1398	542	672	108742	0	111354
25476	1384	443	719	108296	0	110842
25477	1194	556	107391	3112	0	112253
25478	1363	471	2330	107377	0	111541
25479	1287	781	1033	108419	0	111520
25480	1076	110682	754	3235	0	115747
25481	1048	2286	112611	1799	0	117744
25482	820	115004	2515	1573	0	119912
25483	1160	2689	116654	1178	0	121681
25484	886	116973	2666	1190	0	121715
25485	1660	2766	1466	106545	0	112437
25486	106412	823	677	2241	0	110153
25487	2200	106609	560	1061	0	110430
25488	1284	2074	489	108719	0	112566
25489	889	920	109363	2363	0	113535
25490	656	111511	2207	1167	0	115541
25491	110090	2222	1042	1195	0	114549
25492	111643	997	764	1013	0	114417
25493	2657	111007	615	735	0	115014
25494	1250	2247	108824	618	0	112939
25495	106877	1008	2188	709	0	110782
25496	2709	863	894	110963	0	115429
25497	109977	599	704	2643	0	113923
25498	2525	110387	594	1204	0	114710
25499	1187	114260	496	962	0	116905
25500	974	2710	111708	695	0	116087
25501	109966	1342	2256	887	0	114451
25502	2806	1151	1002	111861	0	116820
25503	112174	569	651	2434	0	115828
25504	2396	112594	555	1107	0	116652
25505	113223	2231	483	1049	0	116986
25506	112625	951	539	941	0	115056
25507	2961	756	112026	575	0	116318
25508	1277	107001	1846	526	0	110650
25509	904	109583	831	515	0	111833
25510	827	2835	577	101773	0	106012
25511	529	101548	442	1534	0	104053
25512	102324	1879	342	868	0	105413
25513	1631	102223	270	517	0	104641
25514	889	2159	217	99713	0	102978
25515	540	98798	226	1432	0	100996
25516	459	97562	232	629	0	98882
25517	466	100679	214	434	0	101793
25518	844	2173	330	99180	0	102527
25519	581	951	196	100439	0	102167
25520	510	639	181	99433	0	100763
25521	363	97102	209	1922	0	99596
25522	378	1612	96256	848	0	99094
25523	415	888	94359	546	0	96208
25524	94600	655	1662	597	0	97514
25525	1620	620	642	97407	0	100289
25526	736	555	98003	1505	0	100799
25527	552	582	96630	695	0	98459
25528	413	100390	1720	545	0	103068
25529	528	1675	694	95891	0	98788
25530	426	865	422	99200	0	100913
25531	97893	676	378	2184	0	101131
25532	1536	565	281	98543	0	100925
25533	757	517	288	99231	0	100793
25534	655	540	99759	2132	0	103086
25535	589	491	1446	99618	0	102144
25536	504	503	657	103520	0	105184
25537	368	495	102769	2114	0	105746
25538	398	471	101465	1047	0	103381
25539	302	101808	1907	814	0	104831
25540	340	1645	102126	641	0	104752
25541	418	844	1730	100562	0	103554
25542	1137	770	1102	84641	0	87650
25543	330	538	103187	2138	0	106193
25544	309	102190	1643	1211	0	105353
25545	98489	1606	820	1126	0	102041
25546	1374	101213	624	807	0	104018
25547	737	1826	536	102170	0	105269
25548	549	939	524	103415	0	105427
25549	363	102584	586	2238	0	105771
25550	428	1790	542	103186	0	105946
25551	447	916	566	103714	0	105643
25552	373	754	98823	2393	0	102343
25553	331	98184	1710	1410	0	101635
25554	411	1803	889	99813	0	102916
25555	410	997	99658	2046	0	103111
25556	537	739	1739	99299	0	102314
25557	527	691	934	99835	0	101987
25558	498	608	692	101906	0	103704
25559	538	649	571	101288	0	103046
25560	523	667	494	99526	0	101210
25561	519	99951	493	2521	0	103484
25562	99042	1710	489	1669	0	102910
25563	1581	1012	97046	1083	0	100722
25564	88706	757	1684	1423	0	92570
25565	1670	676	100518	923	0	103787
25566	745	103044	1823	977	0	106589
25567	627	1879	102189	855	0	105550
25568	429	103374	1986	952	0	106741
25569	808	2084	1174	97339	0	101405
25570	572	989	670	100240	0	102471
25571	435	100075	523	2427	0	103460
25572	361	105001	481	1365	0	107208
25573	104577	2111	461	1333	0	108482
25574	107012	1089	420	1189	0	109710
25575	107350	735	444	1015	0	109544
25576	108644	660	470	951	0	110725
25577	2369	723	422	106401	0	109915
25578	995	106292	420	1870	0	109577
25579	105732	1786	385	1276	0	109179
25580	1715	851	318	102668	0	105552
25581	99615	586	315	1731	0	102247
25582	96937	420	277	1105	0	98739
25583	1542	92363	280	646	0	94831
25584	586	89820	237	475	0	91118
25585	341	93978	216	374	0	94909
25586	482	2174	523	89347	0	92526
25587	232	92031	259	1006	0	93528
25588	91548	929	242	777	0	93496
25589	92783	340	156	667	0	93946
25590	92293	224	116	524	0	93157
25591	93707	214	117	515	0	94553
25592	94642	185	142	490	0	95459
25593	1361	187	95847	225	0	97620
25594	96501	138	1122	489	0	98250
25595	1427	204	97597	196	0	99424
25596	96887	126	1154	372	0	98539
25597	1456	263	411	97397	0	99527
25598	580	197	93241	1164	0	95182
25599	391	187	96722	415	0	97715
25600	256	102406	1280	344	0	104286
25601	102724	1383	736	505	0	105348
25602	105175	437	300	493	0	106405
25603	1819	111972	201	210	0	114202
25604	1017	1806	119	126012	0	128954
25605	134398	616	127	2647	0	137788
25606	2915	468	136165	875	0	140423
25607	1099	136464	2645	545	0	140753
25608	134383	2790	966	711	0	138850
25609	2972	136232	554	449	0	140207
25610	1693	3254	361	131194	0	136502
25611	850	137349	418	2568	0	141185
25612	1014	3692	253	133317	0	138276
25613	613	133771	304	3227	0	137915
25614	464	140037	262	1286	0	142049
25615	135607	3970	241	1151	0	140969
25616	139524	1868	201	934	0	142527
25617	3895	1213	136355	635	0	142098
25618	1809	1034	133365	451	0	136659
25619	1178	993	136589	394	0	139154
25620	1289	771	4034	136443	0	142537
25621	919	849	139549	2906	0	144223
25622	1089	806	3669	136963	0	142527
25623	1005	731	1640	137986	0	141362
25624	551	137859	1174	4072	0	143656
25625	138728	3269	776	2263	0	145036
25626	3077	140133	762	1329	0	145301
25627	1669	3713	591	144371	0	150344
25628	1318	1697	577	145996	0	149588
25629	1220	1243	563	146946	0	149972
25630	1042	934	143869	4672	0	150517
25631	1168	879	3386	143465	0	148898
25632	1163	730	1560	146172	0	149625
25633	1132	721	1097	148458	0	151408
25634	654	851	141948	5241	0	148694
25635	653	141268	3393	2796	0	148110
25636	140406	3523	1409	2406	0	147744
25637	137413	1695	912	2314	0	142334
25638	3908	141893	679	1724	0	148204
25639	2132	3847	669	142295	0	148943
25640	1591	1982	661	146682	0	150916
25641	1240	1465	142065	4757	0	149527
25642	1081	140792	3363	2693	0	147929
25643	1206	3608	1565	143821	0	150200
25644	856	1708	143394	4441	0	150399
25645	1051	1318	3678	141930	0	147977
25646	1052	1042	1826	142592	0	146512
25647	776	1150	142242	5283	0	149451
25648	1041	1101	3711	140991	0	146844
25649	1218	1050	1830	139855	0	143953
25650	1050	968	142772	5356	0	150146
25651	1138	962	3754	143409	0	149263
25652	1251	903	1927	139327	0	143408
25653	775	827	1351	147565	0	150518
25654	553	809	143047	6027	0	150436
25655	748	703	3914	143773	0	149138
25656	140713	693	1927	5872	0	149205
25657	141863	649	1529	3699	0	147740
25658	3979	141250	1276	2879	0	149384
25659	143993	3271	1225	2807	0	151296
25660	4032	1565	147887	2267	0	155751
25661	2258	1063	3705	150020	0	157046
25662	1699	907	1775	152681	0	157062
25663	1382	954	1316	155821	0	159473
25664	147447	813	1133	6268	0	155661
25665	3404	145953	1150	3622	0	154129
25666	1681	3287	965	143397	0	149330
25667	1077	143835	992	4966	0	150870
25668	143006	3623	926	3452	0	151007
25669	3494	143714	929	2434	0	150571
25670	142619	3804	927	2365	0	149715
25671	3798	139383	826	2081	0	146088
25672	1928	141791	913	1891	0	146523
25673	1616	4379	909	141413	0	148317
25674	1278	2170	878	142627	0	146953
25675	1254	1570	847	142130	0	145801
25676	950	1331	798	142510	0	145589
25677	893	1452	137815	5735	0	145895
25678	886	136829	3109	3556	0	144380
25679	894	3574	1393	135187	0	141048
25680	754	137059	1094	4700	0	143607
25681	866	3827	136221	2891	0	143805
25682	1146	2025	3363	135392	0	141926
25683	1050	1624	1590	141804	0	146068
25684	932	1324	137905	5131	0	145292
25685	1075	134080	3465	3150	0	141770
25686	851	3363	1803	136111	0	142128
25687	579	1682	133731	4980	0	140972
25688	480	132779	3589	3604	0	140452
25689	725	3569	1809	132763	0	138866
25690	623	1812	131101	4757	0	138293
25691	753	1542	127132	2888	0	132315
25692	656	125652	3882	2366	0	132556
25693	629	134660	1738	1959	0	138986
25694	938	4168	1589	137131	0	143826
25695	995	2111	1122	145262	0	149490
25696	593	1563	143258	5463	0	150877
25697	137209	1302	3805	3585	0	145901
25698	140598	1307	2074	2917	0	146896
25699	4480	1204	139952	2233	0	147869
25700	1824	134013	3809	2025	0	141671
25701	1236	135163	1837	1877	0	140113
25702	1019	132727	1353	1668	0	136767
25703	1793	105954	1925	1885	0	111557
25704	2628	5098	1531	106531	0	115788
25705	630	1032	376	124388	0	126426
25706	393	632	140	125318	0	126483
25707	363	464	128	127801	0	128756
25708	127	127000	168	4983	0	132278
25709	408	3021	135	129210	0	132774
25710	142	128082	199	4160	0	132583
25711	382	3557	142	131394	0	135475
25712	128392	1682	141	4390	0	134605
25713	3180	965	155	130287	0	134587
25714	1404	127565	179	4284	0	133432
25715	1044	3250	144	132516	0	136954
25716	789	1598	167	135380	0	137934
25717	636	1058	155	136597	0	138446
25718	129599	839	128	6757	0	137323
25719	3411	946	117	134432	0	138906
25720	1495	900	128757	5651	0	136803
25721	875	131335	3013	3475	0	138698
25722	985	3854	1379	135919	0	142137
25723	1039	1955	806	140555	0	144355
25724	959	1376	490	142871	0	145696
25725	135311	1129	394	7403	0	144237
25726	3915	999	131262	4226	0	140402
25727	2222	979	3289	130034	0	136524
25728	1279	130660	1490	5556	0	138985
25729	1145	4108	804	134341	0	140398
25730	126089	2195	608	6516	0	135408
25731	3618	129504	597	3996	0	137715
25732	2030	4422	380	131567	0	138399
25733	1342	2237	335	133394	0	137308
25734	790	128547	374	7390	0	137101
25735	1036	4186	351	133430	0	139003
25736	1138	2257	450	135882	0	139727
25737	746	1689	127937	7529	0	137901
25738	654	128226	3573	4864	0	137317
25739	128104	4513	1672	3996	0	138285
25740	4179	2444	127252	3187	0	137062
25741	126156	1768	3921	3260	0	135105
25742	4806	1544	126967	3139	0	136456
25743	2708	1277	4316	129402	0	137703
25744	126669	1274	2095	6983	0	137021
25745	4710	1397	1259	130426	0	137792
25746	128609	1284	965	7628	0	138486
25747	130510	1374	851	5199	0	137934
25748	130227	1486	890	4084	0	136687
25749	6410	126893	843	3329	0	137475
25750	3870	4566	851	127677	0	136964
25751	2636	2595	975	131529	0	137735
25752	2175	1788	961	132172	0	137096
25753	1791	1416	125474	8347	0	137028
25754	1865	1223	4239	130022	0	137349
25755	126790	969	2354	7711	0	137824
25756	130012	1044	1593	5217	0	137866
25757	6786	1099	124984	3796	0	136665
25758	127716	1152	4421	3375	0	136664
25759	130734	1304	2296	3098	0	137432
25760	7264	1353	1561	122001	0	132179
25761	121758	1172	1130	6916	0	130976
25762	123765	1115	1023	4992	0	130895
25763	7232	1109	1103	121760	0	131204
25764	121708	1048	1231	7091	0	131078
25765	123191	1090	1128	4859	0	130268
25766	7661	1161	1178	120102	0	130102
25767	4899	1593	93881	6793	0	107166
25768	114778	1172	3653	4316	0	123919
25769	6634	1173	116726	3409	0	127942
25770	4444	1033	117303	3290	0	126070
25771	3526	114338	5788	3337	0	126989
25772	3496	4036	3049	115237	0	125818
25773	3177	2055	1879	119817	0	126928
25774	3349	1279	1333	119063	0	125024
25775	3353	1128	114552	8123	0	127156
25776	3433	989	114634	5054	0	124110
25777	3119	113650	5761	3876	0	126406
25778	3157	4164	3137	113588	0	124046
25779	3115	2030	2330	118276	0	125751
25780	2774	1339	2064	119983	0	126160
25781	2780	1007	113120	8169	0	125076
25782	2698	111153	4900	5353	0	124104
25783	2692	3869	2835	115017	0	124413
25784	2820	2036	113615	6806	0	125277
25785	2827	1355	114300	4578	0	123060
25786	112709	1125	6422	3654	0	123910
25787	114859	1101	3698	3295	0	122953
25788	116922	1114	2476	3201	0	123713
25789	7429	1037	1968	111592	0	122026
25790	4508	910	109811	6542	0	121771
25791	3161	106772	4857	4830	0	119620
25792	2675	112533	3079	4066	0	122353
25793	2650	4745	100614	3119	0	111128
25794	3050	4115	5004	91923	0	104092
25795	2351	2352	3116	86105	0	93924
25796	2192	81890	2295	4991	0	91368
25797	2398	85839	1782	3137	0	93156
25798	83828	3792	1690	2519	0	91829
25799	85542	1909	1519	2214	0	91184
25800	86452	1152	1457	2219	0	91280
25801	85311	968	1391	2174	0	89844
25802	82189	1086	1159	2166	0	86600
25803	5674	76110	1337	2092	0	85213
25804	2354	63805	915	1532	0	68606
25805	1283	53647	708	894	0	56532
25806	50233	1680	2199	909	0	55021
25807	2563	1257	967	46381	0	51168
25808	852	272	397	45505	0	47026
25809	44626	197	368	1500	0	46691
25810	1242	44255	359	816	0	46672
25811	677	986	388	44802	0	46853
25812	606	444	400	45519	0	46969
25813	585	319	387	45753	0	47044
25814	44085	215	334	1453	0	46087
25815	1314	200	341	44516	0	46371
25816	681	213	42639	1202	0	44735
25817	42089	256	887	597	0	43829
25818	1285	396	430	42673	0	44784
25819	681	223	42342	993	0	44239
25820	612	41461	847	561	0	43481
25821	367	40453	328	377	0	41525
25822	38013	1008	801	413	0	40235
25823	37751	297	318	305	0	38671
25824	675	38367	103	151	0	39296
25825	351	543	97	40424	0	41415
25826	41719	143	98	826	0	42786
25827	820	80	76	44649	0	45625
25828	434	76	59	46803	0	47372
25829	260	51	69	47370	0	47750
25830	203	62	96	47058	0	47419
25831	116	45601	98	1392	0	47207
25832	145	812	63	46855	0	47875
25833	153	310	67	47191	0	47721
25834	175	192	84	47534	0	47985
25835	118	171	45397	1450	0	47136
25836	91	45457	851	711	0	47110
25837	177	968	326	46240	0	47711
25838	100	367	45465	1143	0	47075
25839	129	240	43473	575	0	44417
25840	108	45026	1109	390	0	46633
25841	44800	928	511	403	0	46642
25842	906	382	283	45331	0	46902
25843	45128	226	190	1104	0	46648
25844	1001	45394	159	559	0	47113
25845	481	964	105	46119	0	47669
25846	44408	383	103	1220	0	46114
25847	45594	267	84	614	0	46559
25848	1280	174	77	45139	0	46670
25849	613	140	113	45268	0	46134
25850	357	155	44295	1367	0	46174
25851	309	124	883	44487	0	45803
25852	259	237	375	45655	0	46526
25853	44176	108	252	1516	0	46052
25854	971	44213	170	778	0	46132
25855	438	876	43148	513	0	44975
25856	42534	358	798	508	0	44198
25857	1022	43617	317	340	0	45296
25858	541	920	204	43911	0	45576
25859	43590	379	187	1112	0	45268
25860	1046	254	113	43439	0	44852
25861	513	185	117	43968	0	44783
25862	321	160	42653	1424	0	44558
25863	290	126	820	43364	0	44600
25864	43045	114	347	1420	0	44926
25865	1012	105	225	43583	0	44925
25866	42647	125	169	1396	0	44337
25867	1109	41113	145	738	0	43105
25868	525	42840	120	577	0	44062
25869	429	1071	127	43014	0	44641
25870	341	507	104	43624	0	44576
25871	41849	352	112	1487	0	43800
25872	941	41813	104	863	0	43721
25873	42574	943	84	708	0	44309
25874	43137	403	130	606	0	44276
25875	1375	286	115	42631	0	44407
25876	42756	245	124	1253	0	44378
25877	1295	206	40867	654	0	43022
25878	702	156	908	41618	0	43384
25879	480	189	41895	1211	0	43775
25880	427	200	1011	42655	0	44293
25881	42042	176	444	1434	0	44096
25882	42942	159	307	823	0	44231
25883	1330	42241	209	619	0	44399
25884	717	968	148	42502	0	44335
25885	614	416	131	42926	0	44087
25886	477	42057	127	1502	0	44163
25887	442	1039	103	43455	0	45039
25888	377	445	121	43743	0	44686
25889	289	42333	145	1676	0	44443
25890	41437	1007	145	997	0	43586
25891	41905	461	149	828	0	43343
25892	1379	304	140	41673	0	43496
25893	734	301	143	42142	0	43320
25894	529	274	40840	1561	0	43204
25895	503	248	883	40649	0	42283
25896	439	40309	397	1402	0	42547
25897	41219	939	280	918	0	43356
25898	1087	457	223	41315	0	43082
25899	570	347	202	41237	0	42356
25900	39902	290	130	1652	0	41974
25901	1142	39781	149	973	0	42045
25902	663	923	98	41231	0	42915
25903	551	483	127	41400	0	42561
25904	427	40338	136	1581	0	42482
25905	40743	1008	153	944	0	42848
25906	1154	515	39720	723	0	42112
25907	599	363	40110	629	0	41701
25908	483	310	1099	40545	0	42437
25909	377	256	40209	1276	0	42118
25910	39542	247	1019	821	0	41629
25911	1164	206	499	40600	0	42469
25912	634	194	40717	1296	0	42841
25913	555	203	40318	749	0	41825
25914	420	41078	1101	653	0	43252
25915	40917	884	544	578	0	42923
25916	1047	41199	387	491	0	43124
25917	41510	984	361	517	0	43372
25918	41470	486	276	499	0	42731
25919	1229	40128	200	457	0	42014
25920	40262	858	222	422	0	41764
25921	40146	420	169	417	0	41152
25922	1316	340	38961	355	0	40972
25923	835	1897	720	36106	0	39558
25924	462	35411	296	827	0	36996
25925	302	34641	161	335	0	35439
25926	799	1197	425	31538	0	33959
25927	29924	307	242	784	0	31257
25928	380	93	46	29391	0	29910
25929	166	59	43	30363	0	30631
25930	156	54	35	31134	0	31379
25931	87	31985	50	558	0	32680
25932	153	422	39	33984	0	34598
25933	106	177	35526	611	0	36420
25934	35060	118	573	281	0	36032
25935	37590	52	178	219	0	38039
25936	791	36640	101	114	0	37646
25937	37432	644	52	126	0	38254
25938	852	192	42	37805	0	38891
25939	256	135	37498	675	0	38564
25940	36676	75	629	265	0	37645
25941	727	37774	155	162	0	38818
25942	265	643	89	37971	0	38968
25943	39028	193	58	735	0	40014
25944	700	38655	57	241	0	39653
25945	207	39615	63	171	0	40056
25946	39517	800	54	164	0	40535
25947	758	285	38216	96	0	39355
25948	38954	180	624	121	0	39879
25949	828	108	171	38990	0	40097
25950	338	102	106	39372	0	39918
25951	220	96	38618	828	0	39762
25952	177	94	38478	309	0	39058
25953	179	69	810	39238	0	40296
25954	154	80	38626	745	0	39605
25955	156	83	38812	280	0	39331
25956	210	68	834	38896	0	40008
25957	175	80	312	39672	0	40239
25958	39438	88	208	892	0	40626
25959	786	73	129	39542	0	40530
25960	39479	83	118	889	0	40569
25961	813	39350	119	318	0	40600
25962	339	668	86	40367	0	41460
25963	216	224	40872	804	0	42116
25964	40795	153	672	374	0	41994
25965	42141	126	232	265	0	42764
25966	42567	90	184	233	0	43074
25967	42226	70	131	182	0	42609
25968	41945	78	133	212	0	42368
25969	1067	292	142	40719	0	42220
25970	450	78	40420	785	0	41733
25971	300	69	40007	326	0	40702
25972	245	54	40816	235	0	41350
25973	39907	83	939	235	0	41164
25974	41574	73	365	206	0	42218
25975	979	71	235	40298	0	41583
25976	401	41449	196	720	0	42766
25977	329	673	154	42680	0	43836
25978	251	221	42359	847	0	43678
25979	241	165	41611	341	0	42358
25980	40713	115	891	302	0	42021
25981	910	86	43058	195	0	44249
25982	408	124	841	43065	0	44438
25983	44539	76	300	911	0	45826
25984	42788	78	271	455	0	43592
25985	45666	71	204	270	0	46211
25986	46045	57	166	250	0	46518
25987	1205	85	44392	147	0	45829
25988	44070	66	814	209	0	45159
25989	1066	44614	298	191	0	46169
25990	533	706	230	45544	0	47013
25991	376	258	45583	818	0	47035
25992	382	185	834	45150	0	46551
25993	314	129	46192	951	0	47586
25994	338	127	922	45688	0	47075
25995	314	115	361	46705	0	47495
25996	265	127	45712	1120	0	47224
25997	330	91	905	45606	0	46932
25998	46237	79	390	1090	0	47796
25999	997	91	274	46637	0	47999
26000	468	96	240	47556	0	48360
26001	46598	94	228	1221	0	48141
26002	981	46734	255	528	0	48498
26003	47417	766	234	417	0	48834
26004	1054	47625	199	310	0	49188
26005	48952	843	208	350	0	50353
26006	1105	315	48513	268	0	50201
26007	551	194	865	48610	0	50220
26008	406	155	339	49454	0	50354
26009	48749	120	297	1180	0	50346
26010	978	48072	266	527	0	49843
26011	462	782	235	48143	0	49622
26012	370	226	227	48347	0	49170
26013	270	46568	238	1140	0	48216
26014	46392	735	208	632	0	47967
26015	915	46542	211	415	0	48083
26016	481	767	159	46723	0	48130
26017	379	270	196	46109	0	46954
26018	320	45393	175	1034	0	46922
26019	45429	772	155	594	0	46950
26020	941	311	44529	383	0	46164
26021	44225	203	782	371	0	45581
26022	1000	44680	318	288	0	46286
26023	518	739	202	45426	0	46885
26024	45771	283	164	939	0	47157
26025	1009	178	165	45879	0	47231
26026	490	209	148	46490	0	47337
26027	46217	109	147	1195	0	47668
26028	963	44815	183	541	0	46502
26029	437	46135	144	371	0	47087
26030	45803	721	181	378	0	47083
26031	865	254	45407	232	0	46758
26032	351	43826	563	227	0	44967
26033	598	757	430	42858	0	44643
26034	189	170	47614	436	0	48409
26035	185	262	676	46353	0	47476
26036	47139	67	297	803	0	48306
26037	673	47578	145	339	0	48735
26038	383	663	75	46141	0	47262
26039	160	47644	84	620	0	48508
26040	48318	738	54	351	0	49461
26041	49248	342	62	258	0	49910
26042	981	49339	67	178	0	50565
26043	525	747	38	48747	0	50057
26044	236	50465	72	730	0	51503
26045	51438	908	59	391	0	52796
26046	52620	389	80	278	0	53367
26047	1283	221	82	51766	0	53352
26048	644	151	30	52816	0	53641
26049	371	166	51151	1200	0	52888
26050	49406	145	846	645	0	51042
26051	990	150	51196	333	0	52669
26052	533	142	956	51033	0	52664
26053	51174	95	409	1037	0	52715
26054	1002	52207	223	468	0	53900
26055	50457	951	120	490	0	52018
26056	1028	483	48062	313	0	49886
26057	50347	290	664	304	0	51605
26058	1184	52117	306	196	0	53803
26059	52653	942	180	274	0	54049
26060	1168	53356	168	261	0	54953
26061	618	1063	137	53200	0	55018
26062	386	531	52180	1000	0	54097
26063	366	356	50446	465	0	51633
26064	328	252	1185	51039	0	52804
26065	302	215	51822	1089	0	53428
26066	390	185	1027	51475	0	53077
26067	378	233	461	51433	0	52505
26068	264	186	52677	1370	0	54497
26069	47320	171	1161	796	0	49448
26070	52559	163	453	480	0	53655
26071	1357	51593	257	298	0	53505
26072	52218	943	183	299	0	53643
26073	1238	452	164	51998	0	53852
26074	596	254	52984	1072	0	54906
26075	460	252	982	52944	0	54638
26076	387	270	510	53617	0	54784
26077	52126	115	276	1462	0	53979
26078	973	51009	248	697	0	52927
26079	516	51951	149	459	0	53075
26080	412	1128	155	52402	0	54097
26081	345	540	199	51572	0	52656
26082	327	50816	153	1173	0	52469
26083	309	967	152	50866	0	52294
26084	295	507	135	50662	0	51599
26085	236	49680	136	1354	0	51406
26086	49740	857	184	738	0	51519
26087	901	431	193	49785	0	51310
26088	438	49758	171	1141	0	51508
26089	385	904	152	50286	0	51727
26090	49608	453	140	1209	0	51410
26091	933	49544	117	627	0	51221
26092	50513	998	119	528	0	52158
26093	50665	485	110	530	0	51790
26094	1353	347	84	50993	0	52777
26095	52339	304	102	1157	0	53902
26096	53309	257	63	751	0	54380
26097	53616	244	72	509	0	54441
26098	53733	227	95	431	0	54486
26099	1552	194	106	53087	0	54939
26100	765	225	109	53882	0	54981
26101	505	220	52863	1401	0	54989
26102	517	172	823	53323	0	54835
26103	445	207	350	54030	0	55032
26104	351	242	52595	1499	0	54687
26105	51805	171	961	874	0	53811
26106	1234	167	420	53693	0	55514
26107	673	176	54246	1305	0	56400
26108	53062	164	1044	814	0	55084
26109	1392	218	57759	475	0	59844
26110	758	58208	1221	672	0	60859
26111	544	61526	551	416	0	63037
26112	464	1483	339	64340	0	66626
26113	364	636	68945	1547	0	71492
26114	69184	339	1521	910	0	71954
26115	73457	276	593	779	0	75105
26116	2105	224	71827	482	0	74638
26117	72754	168	1635	496	0	75053
26118	74234	151	685	495	0	75565
26119	2190	73219	513	429	0	76351
26120	74304	1447	376	417	0	76544
26121	2040	579	373	73518	0	76510
26122	952	411	73459	1642	0	76464
26123	770	369	1498	70679	0	73316
26124	478	73463	674	1704	0	76319
26125	463	76537	508	831	0	78339
26126	75983	1828	422	596	0	78829
26127	76073	792	349	507	0	77721
26128	76238	478	383	492	0	77591
26129	2448	381	354	74377	0	77560
26130	1306	627	328	72796	0	75057
26131	800	72500	372	1988	0	75660
26132	72466	1575	363	1160	0	75564
26133	1923	73663	451	827	0	76864
26134	68374	1261	349	455	0	70439
26135	1753	68257	345	341	0	70696
26136	68418	1294	479	354	0	70545
26137	67409	563	251	376	0	68599
26138	2185	705	298	66534	0	69722
26139	1135	68328	287	1210	0	70960
26140	1107	1277	65173	548	0	68105
26141	64476	633	1062	726	0	66897
26142	1547	63428	484	491	0	65950
26143	794	1216	65489	480	0	67979
26144	619	648	65973	395	0	67635
26145	734	739	1114	63704	0	66291
26146	780	438	318	62925	0	64461
26147	662	65750	182	1104	0	67698
26148	67690	1125	113	633	0	69561
26149	1474	557	121	66862	0	69014
26150	817	67902	157	1179	0	70055
26151	681	71783	138	555	0	73157
26152	658	1249	70304	451	0	72662
26153	621	790	69558	325	0	71294
26154	69086	597	1071	356	0	71110
26155	1406	569	70327	245	0	72547
26156	943	524	1000	69384	0	71851
26157	870	459	369	71865	0	73563
26158	617	481	71045	1297	0	73440
26159	727	509	1031	69909	0	72176
26160	743	410	552	66731	0	68436
26161	70047	418	430	1430	0	72325
26162	72011	560	473	690	0	73734
26163	1397	393	611	70958	0	73359
26164	707	69560	599	1169	0	72035
26165	467	73438	538	692	0	75135
26166	74022	1232	504	705	0	76463
26167	1250	678	73125	583	0	75636
26168	765	480	1135	73527	0	75907
26169	75463	501	574	1566	0	78104
26170	76466	620	473	800	0	78359
26171	1572	531	436	76042	0	78581
26172	735	529	75667	1394	0	78325
26173	780	601	70821	640	0	72842
26174	71706	457	1534	695	0	74392
26175	74793	353	1010	687	0	76843
26176	1688	74034	733	689	0	77144
26177	1011	76528	676	761	0	78976
26178	78560	1298	688	891	0	81437
26179	79791	607	521	1059	0	81978
26180	1926	508	474	80580	0	83488
26181	1325	417	537	81806	0	84085
26182	1213	375	445	82464	0	84497
26183	81435	437	507	1934	0	84313
26184	2052	556	444	81778	0	84830
26185	1257	628	81628	1517	0	85030
26186	81185	539	1196	935	0	83855
26187	1876	621	601	82701	0	85799
26188	1183	640	83021	1484	0	86328
26189	81452	573	1203	1009	0	84237
26190	77741	580	702	985	0	80008
26191	1753	85331	552	891	0	88527
26192	1174	87967	629	669	0	90439
26193	1095	1473	82905	720	0	86193
26194	85889	802	1141	841	0	88673
26195	1937	88663	654	585	0	91839
26196	1335	1527	84114	653	0	87629
26197	85678	856	1104	814	0	88452
26198	2062	92276	480	703	0	95521
26199	1159	1573	91411	798	0	94941
26200	89107	781	1242	1016	0	92146
26201	1977	91686	497	796	0	94956
26202	1189	1311	360	91853	0	94713
26203	91751	640	427	1783	0	94601
26204	1692	90759	417	1597	0	94465
26205	1061	1761	498	91020	0	94340
26206	90968	463	487	1741	0	93659
26207	1525	359	90043	864	0	92791
26208	715	88614	1381	593	0	91303
26209	940	1161	87107	497	0	89705
26210	631	1092	1209	84390	0	87322
26211	450	371	84906	976	0	86703
26212	393	80213	902	462	0	81970
26213	235	77410	385	213	0	78243
26214	374	831	241	76315	0	77761
26215	234	181	94	73608	0	74117
26216	184	105	82	74620	0	74991
26217	116	110	76406	668	0	77300
26218	175	70	562	76503	0	77310
26219	76748	73	177	827	0	77825
26220	76312	84	114	399	0	76909
26221	785	111	77795	171	0	78862
26222	257	77162	594	163	0	78176
26223	77616	559	161	344	0	78680
26224	622	76955	142	143	0	77862
26225	77220	614	91	301	0	78226
26226	77424	179	83	307	0	77993
26227	759	163	76275	113	0	77310
26228	288	77324	625	116	0	78353
26229	288	606	180	78405	0	79479
26230	186	201	78232	622	0	79241
26231	75184	167	648	375	0	76374
26232	784	186	176	78013	0	79159
26233	246	109	76902	598	0	77855
26234	74289	67	613	421	0	75390
26235	752	144	78473	128	0	79497
26236	419	120	690	78764	0	79993
26237	82514	67	232	939	0	83752
26238	749	83862	183	279	0	85073
26239	286	723	85234	172	0	86415
26240	83994	209	784	382	0	85369
26241	90320	126	241	335	0	91022
26242	1138	91911	216	122	0	93387
26243	509	956	131	93237	0	94833
26244	391	295	85	93107	0	93878
26245	91849	215	89	1471	0	93624
26246	1227	135	95	92642	0	94099
26247	409	135	92705	1218	0	94467
26248	429	91	1033	91810	0	93363
26249	91814	107	311	1518	0	93750
26250	1143	90486	264	502	0	92395
26251	508	1127	143	88716	0	90494
26252	288	89823	141	1152	0	91404
26253	91759	1333	105	588	0	93785
26254	1449	401	103	97877	0	99830
26255	577	266	118	100342	0	101303
26256	331	100272	139	2012	0	102754
26257	254	1694	98659	727	0	101334
26258	433	518	1632	97950	0	100533
26259	314	350	473	100839	0	101976
26260	359	226	305	100233	0	101123
26261	197	98502	261	2277	0	101237
26262	228	1669	98597	894	0	101388
26263	226	602	98784	553	0	100165
26264	98357	353	2105	659	0	101474
26265	101112	231	750	584	0	102677
26266	2285	211	100715	309	0	103520
26267	98668	152	1877	593	0	101290
26268	2186	199	101751	303	0	104439
26269	98666	216	2072	555	0	101509
26270	2047	101664	773	345	0	104829
26271	103168	1788	470	587	0	106013
26272	2291	613	103625	341	0	106870
26273	837	485	105003	343	0	106668
26274	816	306	2356	109905	0	113383
26275	112974	199	915	2809	0	116897
26276	2617	118217	637	939	0	122410
26277	991	2813	128595	582	0	132981
26278	1123	828	3478	129763	0	135192
26279	843	485	1133	136233	0	138694
26280	132761	310	683	4775	0	138529
26281	135100	254	493	1786	0	137633
26282	4915	297	336	132916	0	138464
26283	133698	285	354	4263	0	138600
26284	4501	313	130067	1335	0	136216
26285	1917	237	3630	129439	0	135223
26286	1309	268	1161	134282	0	137020
26287	131471	258	722	5049	0	137500
26288	132485	277	588	2048	0	135398
26289	5040	269	435	130302	0	136046
26290	130155	244	476	4587	0	135462
26291	4608	296	125147	1616	0	131667
26292	1709	124313	3659	1268	0	130949
26293	1203	3388	124977	953	0	130521
26294	1311	1549	3896	125408	0	132164
26295	122736	560	1448	4421	0	129165
26296	3983	121670	881	1670	0	128204
26297	1762	3488	667	121725	0	127642
26298	1337	1108	619	119783	0	122847
26299	947	117643	586	4732	0	123908
26300	1101	3721	517	120685	0	126024
26301	1176	1294	533	122233	0	125236
26302	1089	726	544	123497	0	125856
26303	1071	567	554	122918	0	125110
26304	1099	373	585	121214	0	123271
26305	901	115573	620	5734	0	122828
26306	1158	3494	602	118854	0	124108
26307	1161	1164	607	120457	0	123389
26308	997	776	113539	5611	0	120923
26309	966	113150	3613	2638	0	120367
26310	1173	3733	1240	115354	0	121500
26311	1169	1239	876	117269	0	120553
26312	1152	876	745	116780	0	119553
26313	978	111557	700	5919	0	119154
26314	1031	3578	111771	2901	0	119281
26315	1245	1289	3752	114850	0	121136
26316	1041	926	112989	5164	0	120120
26317	992	767	112389	2530	0	116678
26318	1064	719	4660	112671	0	119114
26319	112555	628	1900	5371	0	120454
26320	4192	670	1195	113496	0	119553
26321	1791	649	889	113312	0	116641
26322	1279	111256	786	5745	0	119066
26323	1213	3625	712	116043	0	121593
26324	1073	1307	1058	118474	0	121912
26325	963	977	114815	6058	0	122813
26326	838	114139	3822	3164	0	121963
26327	886	3692	1533	117606	0	123717
26328	113471	1384	1160	5551	0	121566
26329	3921	1008	113020	2851	0	120800
26330	1759	792	3876	114892	0	121319
26331	1297	740	1486	117825	0	121348
26332	112434	729	1125	6242	0	120530
26333	3861	111814	860	3422	0	119957
26334	110526	3759	701	3016	0	118002
26335	4023	109911	749	2597	0	117280
26336	1707	4087	723	110807	0	117324
26337	107919	1605	778	5618	0	115920
26338	4008	1134	106668	3059	0	114869
26339	1648	103798	3603	2685	0	111734
26340	1213	105652	1629	3565	0	112059
26341	100436	4047	1361	2285	0	108129
26342	3592	1700	988	98200	0	104480
26343	1570	95348	886	4837	0	102641
26344	1278	100263	748	2848	0	105137
26345	1328	3980	740	99884	0	105932
26346	1161	1794	601	102286	0	105842
26347	97031	1200	662	5714	0	104607
26348	3606	96514	744	3151	0	104015
26349	1631	3835	1001	97564	0	104031
26350	1149	1589	95297	4666	0	102701
26351	1035	95438	3404	2742	0	102619
26352	1064	3436	93879	2346	0	100725
26353	1023	93221	3536	2172	0	99952
26354	1543	3559	1883	87345	0	94330
26355	967	1364	714	86724	0	89769
26356	778	84932	655	4139	0	90504
26357	703	2836	84808	2338	0	90685
26358	84297	1403	2564	1955	0	90219
26359	2777	1111	1085	87934	0	92907
26360	1175	1008	707	90300	0	93190
26361	821	992	87202	4277	0	93292
26362	746	1092	2652	88434	0	92924
26363	636	1056	87611	4071	0	93374
26364	725	1119	2825	88664	0	93333
26365	586	934	89595	4077	0	95192
26366	466	90082	2810	2529	0	95887
26367	552	3202	92154	2032	0	97940
26368	767	1583	2961	93188	0	98499
26369	91866	1047	1144	4384	0	98441
26370	2911	90808	735	2350	0	96804
26371	1324	3818	734	91029	0	96905
26372	898	1420	88914	3978	0	95210
26373	591	89936	3030	2109	0	95666
26374	843	3552	1124	82562	0	88081
26375	473	1223	82372	2897	0	86965
26376	308	74744	1942	1201	0	78195
26377	61036	1918	1232	1043	0	65229
26378	58473	513	532	498	0	60016
26379	1099	174	116	58070	0	59459
26380	58318	127	129	1066	0	59640
26381	989	111	96	57968	0	59164
26382	343	93	90	59222	0	59748
26383	195	112	60423	1126	0	61856
26384	232	123	825	59594	0	60774
26385	154	119	252	61278	0	61803
26386	59988	99	154	1310	0	61551
26387	59320	110	122	577	0	60129
26388	1014	59571	111	271	0	60967
26389	350	837	59862	190	0	61239
26390	318	421	843	59409	0	60991
26391	193	190	59032	929	0	60344
26392	55092	129	874	519	0	56614
26393	899	114	57209	249	0	58471
26394	390	136	814	56063	0	57403
26395	147	56586	293	850	0	57876
26396	169	754	164	57071	0	58158
26397	184	233	147	57038	0	57602
26398	111	154	57932	1040	0	59237
26399	234	109	760	57728	0	58831
26400	57481	88	269	1086	0	58924
26401	57875	87	157	522	0	58641
26402	57905	75	142	390	0	58512
26403	58115	84	105	368	0	58672
26404	1012	56220	161	251	0	57644
26405	366	56906	160	248	0	57680
26406	550	884	183	52651	0	54268
26407	272	260	139	56581	0	57252
26408	171	53716	172	1066	0	55125
26409	214	733	113	57305	0	58365
26410	216	315	94	57629	0	58254
26411	216	164	130	57409	0	57919
26412	224	136	117	57338	0	57815
26413	204	122	140	58008	0	58474
26414	56368	103	140	1366	0	57977
26415	861	55252	160	523	0	56796
26416	365	816	54739	345	0	56265
26417	311	304	756	54880	0	56251
26418	197	215	280	55963	0	56655
26419	184	182	189	55358	0	55913
26420	54632	168	163	1402	0	56365
26421	848	58422	186	629	0	60085
26422	419	1219	167	58527	0	60332
26423	269	59561	147	1650	0	61627
26424	346	1616	144	59265	0	61371
26425	228	58246	155	1851	0	60480
26426	267	1772	61384	765	0	64188
26427	368	646	1869	64677	0	67560
26428	243	407	75389	2425	0	78464
26429	407	247	2768	75965	0	79387
26430	420	234	861	82943	0	84458
26431	81267	223	543	4056	0	86089
26432	83005	205	332	1835	0	85377
26433	84774	179	234	1253	0	86440
26434	84699	237	253	851	0	86040
26435	85168	207	256	751	0	86382
26436	4428	229	264	80051	0	84972
26437	1591	80733	351	3150	0	85825
26438	1204	2922	204	80769	0	85099
26439	705	927	77490	3716	0	82838
26440	78033	631	2746	1669	0	83079
26441	82617	345	874	1149	0	84985
26442	4270	202	560	80196	0	85228
26443	1934	246	308	80771	0	83259
26444	1227	76903	272	4018	0	82420
26445	937	2776	204	80254	0	84171
26446	841	970	210	80793	0	82814
26447	661	77678	244	4174	0	82757
26448	742	2949	293	80365	0	84349
26449	74660	932	268	4433	0	80293
26450	3205	744	75755	1658	0	81362
26451	75193	433	2785	1544	0	79955
26452	3607	391	76025	1133	0	81156
26453	1512	376	3251	75660	0	80799
26454	1115	344	1010	76060	0	78529
26455	736	72385	693	4161	0	77975
26456	634	76905	431	1947	0	79917
26457	965	3639	329	72770	0	77703
26458	675	1363	72837	3656	0	78531
26459	70883	748	2899	1727	0	76257
26460	3381	447	1011	72222	0	77061
26461	1220	71104	767	3572	0	76663
26462	1261	2904	391	72617	0	77173
26463	980	1206	287	72772	0	75245
26464	707	69496	291	4145	0	74639
26465	963	3124	288	67391	0	71766
26466	666	946	62633	3526	0	67771
26467	552	858	61963	1436	0	64809
26468	620	757	2756	60856	0	64989
26469	367	62055	1123	2740	0	66285
26470	523	2505	679	62946	0	66653
26471	62348	887	347	3339	0	66921
26472	64404	659	312	1491	0	66866
26473	61844	472	261	1210	0	63787
26474	3186	59676	326	909	0	64097
26475	1238	2412	59379	791	0	63820
26476	59063	898	2415	866	0	63242
26477	61525	754	852	912	0	64043
26478	3079	59249	617	860	0	63805
26479	1476	2484	378	59846	0	64184
26480	59944	990	328	2924	0	64186
26481	61486	704	371	1338	0	63899
26482	62207	453	420	1066	0	64146
26483	3836	421	458	57568	0	62283
26484	58994	370	466	3057	0	62887
26485	3466	361	407	58701	0	62935
26486	1699	396	324	60729	0	63148
26487	58663	468	301	3846	0	63278
26488	3376	445	356	58624	0	62801
26489	58240	415	361	3662	0	62678
26490	3738	387	402	58248	0	62775
26491	1927	408	383	60551	0	63269
26492	57767	464	306	4416	0	62953
26493	3618	474	55844	2332	0	62268
26494	2028	434	2398	58596	0	63456
26495	1910	366	906	60071	0	63253
26496	1712	395	668	59520	0	62295
26497	1505	441	448	60593	0	62987
26498	1446	406	378	58518	0	60748
26499	1206	54924	425	4590	0	61145
26500	1221	2569	405	57577	0	61772
26501	1259	1057	55027	4061	0	61404
26502	1321	795	2509	57264	0	61889
26503	1343	565	903	59106	0	61917
26504	1234	513	687	60235	0	62669
26505	1057	553	55769	4798	0	62177
26506	908	654	56212	2702	0	60476
26507	55342	630	3180	2154	0	61306
26508	57386	559	1385	1902	0	61232
26509	3543	56802	903	1748	0	62996
26510	1795	2793	576	59041	0	64205
26511	1356	1174	469	62013	0	65012
26512	989	859	625	63073	0	65546
26513	59912	635	623	4759	0	65929
26514	62343	471	709	2600	0	66123
26515	3683	538	647	61486	0	66354
26516	1779	621	539	62951	0	65890
26517	1325	662	466	63516	0	65969
26518	952	752	492	63661	0	65857
26519	59272	615	515	4995	0	65397
26520	2937	584	57172	2761	0	63454
26521	1233	49231	2113	2063	0	54640
26522	943	50230	773	1545	0	53491
26523	48190	1953	641	1385	0	52169
26524	2223	2051	624	46970	0	51868
26525	981	723	46288	2675	0	50667
26526	720	604	42429	1453	0	45206
26527	457	42653	1513	1317	0	45940
26528	31466	574	759	469	0	33268
26529	577	181	30603	339	0	31700
26530	25836	195	434	178	0	26643
26531	261	41	98	26458	0	26858
26532	123	47	39	26499	0	26708
26533	61	25787	38	278	0	26164
26534	62	26402	28	143	0	26635
26535	26926	187	27	153	0	27293
26536	27109	52	38	142	0	27341
26537	231	26904	37	90	0	27262
26538	79	168	26197	84	0	26528
26539	82	96	25994	62	0	26234
26540	111	98	177	26920	0	27306
26541	27851	28	115	216	0	28210
26542	206	27386	45	109	0	27746
26543	84	140	28	29034	0	29286
26544	29226	53	23	271	0	29573
26545	206	33	51	29684	0	29974
26546	116	29	31	30567	0	30743
26547	30620	21	18	360	0	31019
26548	238	30417	43	162	0	30860
26549	99	31984	33	124	0	32240
26550	71	258	32747	82	0	33158
26551	76	91	215	33478	0	33860
26552	86	54	88	33335	0	33563
26553	47	56	34079	328	0	34510
26554	31128	40	237	256	0	31661
26555	32729	23	99	166	0	33017
26556	311	40	34235	78	0	34664
26557	30781	34	251	167	0	31233
26558	291	50	35259	69	0	35669
26559	137	36572	262	91	0	37062
26560	103	235	96	38719	0	39153
26561	84	94	59	39868	0	40105
26562	39853	50	33	428	0	40364
26563	39117	51	33	265	0	39466
26564	39397	20	33	173	0	39623
26565	39838	31	42	132	0	40043
26566	39689	30	40	160	0	39919
26567	372	57	38602	80	0	39111
26568	158	38855	239	102	0	39354
26569	115	274	99	39586	0	40074
26570	76	39154	90	232	0	39552
26571	60	39840	51	128	0	40079
26572	80	283	48	39740	0	40151
26573	85	115	44	40116	0	40360
26574	99	75	39518	304	0	39996
26575	37291	45	236	201	0	37773
26576	39572	37	99	138	0	39846
26577	288	38713	81	70	0	39152
26578	39632	208	55	91	0	39986
26579	40665	79	51	156	0	40951
26580	324	96	36	40643	0	41099
26581	151	53	41860	236	0	42300
26582	131	65	40931	113	0	41240
26583	41710	37	221	111	0	42079
26584	42434	35	97	89	0	42655
26585	269	41448	53	62	0	41832
26586	149	43002	41	41	0	43233
26587	117	248	22	44771	0	45158
26588	44952	112	29	283	0	45376
26589	241	84	45019	114	0	45458
26590	164	33	240	46286	0	46723
26591	47544	33	85	364	0	48026
26592	47695	60	65	206	0	48026
26593	369	45	29	48773	0	49216
26594	48960	26	35	401	0	49422
26595	349	57	46889	122	0	47417
26596	169	70	49277	89	0	49605
26597	202	40	333	49286	0	49861
26598	117	50	134	52255	0	52556
26599	107	55	84	52056	0	52302
26600	76	50450	68	403	0	50997
26601	68	52148	56	194	0	52466
26602	83	341	39	53059	0	53522
26603	53426	144	47	437	0	54054
26604	315	75	38	54167	0	54595
26605	175	49	32	54340	0	54596
26606	107	53132	62	422	0	53723
26607	74	55170	63	199	0	55506
26608	87	339	34	56044	0	56504
26609	78	159	31	54640	0	54908
26610	54000	87	31	490	0	54608
26611	302	53201	43	218	0	53764
26612	54132	285	16	227	0	54660
26613	391	131	31	54537	0	55090
26614	158	97	53557	320	0	54132
26615	180	99	51833	182	0	52294
26616	54391	77	412	248	0	55128
26617	343	58	162	56907	0	57470
26618	177	48	76	57139	0	57440
26619	136	42	33	57674	0	57885
26620	65	58	57767	491	0	58381
26621	146	46	299	58382	0	58873
26622	79	57619	156	485	0	58339
26623	89	395	81	60549	0	61114
26624	111	124	40	60543	0	60818
26625	87	60502	54	569	0	61212
26626	98	449	42	62869	0	63458
26627	61675	158	29	760	0	62622
26628	562	61400	64	236	0	62262
26629	64269	622	26	323	0	65240
26630	65052	179	45	230	0	65506
26631	957	129	47	64822	0	65955
26632	443	70	38	64548	0	65099
26633	236	75	23	66080	0	66414
26634	150	70	63549	1078	0	64847
26635	134	61582	725	463	0	62904
26636	97	64088	227	260	0	64672
26637	168	839	98	63745	0	64850
26638	63097	276	56	937	0	64366
26639	815	154	61	62769	0	63799
26640	269	131	62921	931	0	64252
26641	175	61104	733	393	0	62405
26642	103	63098	229	288	0	63718
26643	62769	845	145	318	0	64077
26644	63656	302	117	320	0	64395
26645	891	66042	104	183	0	67220
26646	67295	738	59	310	0	68402
26647	962	288	65468	165	0	66883
26648	365	270	63750	155	0	64540
26649	66333	137	1051	273	0	67794
26650	68416	116	320	281	0	69133
26651	1245	121	147	67858	0	69371
26652	67651	110	95	1213	0	69069
26653	1180	133	66748	342	0	68403
26654	463	143	69838	262	0	70706
26655	597	115	1257	75948	0	77917
26656	337	94	391	86415	0	87237
26657	309	91	209	89854	0	90463
26658	465	127	184	89062	0	89838
26659	339	87	121	96499	0	97046
26660	211	131	92965	3314	0	96621
26661	361	95	2150	93543	0	96149
26662	93423	102	618	3325	0	97468
26663	2438	90	414	94705	0	97647
26664	93850	65	307	3422	0	97644
26665	2779	87	235	94752	0	97853
26666	95605	88	295	3573	0	99561
26667	99228	113	221	1847	0	101409
26668	3400	127	258	97669	0	101454
26669	1533	113	267	100172	0	102085
26670	97983	118	238	3750	0	102089
26671	99036	114	186	2013	0	101349
26672	3649	179	96780	1369	0	101977
26673	1876	129	2180	98513	0	102698
26674	1517	113	646	102164	0	104440
26675	100283	127	448	3771	0	104629
26676	102280	139	359	1845	0	104623
26677	3753	123	235	101729	0	105840
26678	1892	107	323	103627	0	105949
26679	1494	88	315	103578	0	105475
26680	1187	120	336	102263	0	103906
26681	890	93444	397	5712	0	100443
26682	818	98102	337	2276	0	101533
26683	920	2691	273	98197	0	102081
26684	744	97179	295	3699	0	101917
26685	801	2666	249	99674	0	103390
26686	624	917	96605	4054	0	102200
26687	599	779	93782	2240	0	97400
26688	549	97014	2676	1964	0	102203
26689	729	2710	963	97375	0	101777
26690	515	1085	96403	3580	0	101583
26691	704	824	2583	95734	0	99845
26692	694	690	996	99417	0	101797
26693	96001	502	852	4338	0	101693
26694	2950	551	695	98482	0	102678
26695	1215	455	98596	4011	0	104277
26696	1113	420	97896	2118	0	101547
26697	1003	96062	3035	1870	0	101970
26698	882	103683	1341	1763	0	107669
26699	104823	2687	992	1933	0	110435
26700	3058	940	110338	1676	0	116012
26701	1625	635	2816	111169	0	116245
26702	112142	436	1166	3915	0	117659
26703	112529	414	1013	2152	0	116108
26704	3517	112132	881	1749	0	118279
26705	2014	2577	731	111275	0	116597
26706	1513	945	659	117819	0	120936
26707	1359	753	550	117002	0	119664
26708	114369	578	571	4632	0	120150
26709	3251	564	111602	2506	0	117923
26710	1464	114199	2519	2187	0	120369
26711	1523	2640	837	114740	0	119740
26712	1228	1004	731	118876	0	121839
26713	959	873	114970	4435	0	121237
26714	1115	727	2574	114942	0	119358
26715	990	595	1041	118989	0	121615
26716	991	608	843	118729	0	121171
26717	842	535	876	118359	0	120612
26718	705	573	113458	5342	0	120078
26719	811	560	2847	114808	0	119026
26720	671	547	114873	5009	0	121100
26721	619	113420	3154	3149	0	120342
26722	756	2391	1380	116603	0	121130
26723	884	935	1110	119182	0	122111
26724	890	633	114472	5044	0	121039
26725	890	112484	2719	3370	0	119463
26726	1083	2555	1294	114104	0	119036
26727	1102	918	113241	4078	0	119339
26728	884	111653	2644	2716	0	117897
26729	995	2409	1136	113992	0	118532
26730	1155	979	113170	3621	0	118925
26731	1217	920	2452	113032	0	117621
26732	1136	694	1195	112606	0	115631
26733	934	635	1100	117320	0	119989
26734	114057	692	857	4365	0	119971
26735	2508	112697	841	2726	0	118772
26736	114496	2217	771	2424	0	119908
26737	2786	962	113567	2259	0	119574
26738	116510	794	2314	2703	0	122321
26739	123723	589	998	2612	0	127922
26740	3135	562	905	123780	0	128382
26741	125157	728	728	4035	0	130648
26742	126758	714	638	2655	0	130765
26743	128742	718	644	2611	0	132715
26744	3390	741	563	128002	0	132696
26745	1932	716	622	126115	0	129385
26746	1382	570	120193	3597	0	125742
26747	1246	627	113751	2195	0	117819
26748	116975	523	2775	2128	0	122401
26749	2434	1065	1276	119872	0	124647
26750	1140	119997	1200	2866	0	125203
26751	121002	1757	1150	2098	0	126007
26752	2112	119199	853	1917	0	124081
26753	1126	119740	856	1893	0	123615
26754	1522	2282	114561	1813	0	120178
26755	861	765	113865	1080	0	116571
26756	1169	2288	1910	110448	0	115815
26757	519	328	116581	1276	0	118704
26758	352	321	106429	466	0	107568
26759	103251	149	454	500	0	104354
26760	108496	44	150	470	0	109160
26761	327	62	107	110238	0	110734
26762	287	63	83	110906	0	111339
26763	134	113	112846	306	0	113399
26764	80	113038	296	211	0	113625
26765	244	257	132	113266	0	113899
26766	118094	71	90	741	0	118996
26767	357	65	69	118846	0	119337
26768	117	119365	97	400	0	119979
26769	175	307	118033	146	0	118661
26770	84	120917	342	163	0	121506
26771	122666	317	115	498	0	123596
26772	120614	111	96	446	0	121267
26773	502	103	60	120499	0	121164
26774	227	97	122301	345	0	122970
26775	254	176	113662	216	0	114308
26776	93	120728	556	526	0	121903
26777	466	415	211	116213	0	117305
26778	191	160	117	123486	0	123954
26779	116	144	122131	506	0	122897
26780	262	71	410	119544	0	120287
26781	57	124742	243	524	0	125566
26782	189	599	88	127461	0	128337
26783	203	203	77	127376	0	127859
26784	122	182	126712	847	0	127863
26785	330	123	645	123506	0	124604
26786	124692	64	267	1185	0	126208
26787	758	127	124211	292	0	125388
26788	395	156	121441	189	0	122181
26789	131	125783	1055	184	0	127153
26790	283	793	402	130007	0	131485
26791	270	270	177	134303	0	135020
26792	107	179	131939	1232	0	133457
26793	125073	87	1060	941	0	127161
26794	1164	94	440	133096	0	134794
26795	467	138	131748	1073	0	133426
26796	500	109	1056	127193	0	128858
26797	167	118	132045	1234	0	133564
26798	207	155	126230	549	0	127141
26799	98	128287	1493	376	0	130254
26800	297	1027	618	123379	0	125321
26801	99	126141	334	1029	0	127603
26802	124293	1126	213	911	0	126543
26803	1038	517	125276	289	0	127120
26804	404	123363	1155	279	0	125201
26805	360	1038	526	125178	0	127102
26806	123999	469	317	1553	0	126338
26807	1015	123433	273	629	0	125350
26808	552	1085	206	126030	0	127873
26809	359	494	181	126263	0	127297
26810	128	126200	260	1555	0	128143
26811	127725	1280	190	1162	0	130357
26812	1455	570	185	141941	0	144151
26813	731	305	176	148450	0	149662
26814	317	301	145525	3102	0	149245
26815	159	151701	2372	1512	0	155744
26816	492	2667	1034	155512	0	159705
26817	499	1028	579	171196	0	173302
26818	161	172966	488	4121	0	177736
26819	581	3588	262	175941	0	180372
26820	835	1380	316	183233	0	185764
26821	625	710	237	186649	0	188221
26822	151	184605	293	5695	0	190744
26823	184124	3918	264	2922	0	191228
26824	4073	1605	183846	1249	0	190773
26825	178356	784	3934	1568	0	184642
26826	4407	183525	1554	876	0	190362
26827	1944	4067	773	184572	0	191356
26828	907	1694	184686	4360	0	191647
26829	996	971	4136	184623	0	190726
26830	890	599	1611	186144	0	189244
26831	832	519	878	191030	0	193259
26832	409	657	185635	6229	0	192930
26833	344	183710	4282	3079	0	191415
26834	432	4096	186807	1802	0	193137
26835	280	187713	4830	1546	0	194369
26836	394	4794	190451	1230	0	196869
26837	769	1988	4779	189328	0	196864
26838	184505	1190	2032	5745	0	193472
26839	3841	187723	1253	2624	0	195441
26840	1514	4617	188312	1856	0	196299
26841	809	188112	4450	1657	0	195028
26842	659	5122	190143	1490	0	197414
26843	1106	2204	4995	183725	0	192030
26844	1035	1506	2126	184397	0	189064
26845	532	183344	1532	6104	0	191512
26846	548	193304	1162	3028	0	198042
26847	191852	5959	975	2511	0	201297
26848	4947	2758	1008	194067	0	202780
26849	2010	1846	193720	5724	0	203300
26850	1613	1310	4928	193786	0	201637
26851	927	1247	195894	6434	0	204502
26852	813	1325	195509	3272	0	200919
26853	1144	1068	6315	189146	0	197673
26854	651	191595	3022	5651	0	200919
26855	187871	5079	1891	3577	0	198418
26856	4952	2400	1515	187273	0	196140
26857	2251	1719	1455	185289	0	190714
26858	1154	186633	1450	6705	0	195942
26859	184794	5360	1231	3885	0	195270
26860	187797	2596	1301	2700	0	194394
26861	6332	1835	1274	182009	0	191450
26862	2558	180088	1500	5869	0	190015
26863	1458	193152	1443	3176	0	199229
26864	188609	6452	1298	2842	0	199201
26865	4944	3253	187859	2004	0	198060
26866	183181	2227	5372	2171	0	192951
26867	186836	1830	2546	2307	0	193519
26868	186187	1563	1715	2195	0	191660
26869	6631	182679	1274	2000	0	192584
26870	3257	5366	1361	185389	0	195373
26871	185638	2523	1330	6118	0	195609
26872	186500	1858	1287	3462	0	193107
26873	6117	184657	1443	2427	0	194644
26874	188167	5182	1257	2430	0	197036
26875	5744	2598	1286	189723	0	199351
26876	2849	1913	1212	190453	0	196427
26877	1777	186547	1174	6843	0	196341
26878	1777	5177	1071	191761	0	199786
26879	1719	2742	1003	193200	0	198664
26880	1435	188446	1175	7261	0	198317
26881	1626	5212	974	183760	0	191572
26882	1258	187505	1065	6369	0	196197
26883	187302	5619	1107	3616	0	197644
26884	183486	2962	1178	2957	0	190583
26885	5997	183683	1030	2495	0	193205
26886	3040	5153	181775	2203	0	192171
26887	2382	3375	4303	181744	0	191804
26888	1899	2283	181130	5319	0	190631
26889	1773	174156	4890	3273	0	184092
26890	1712	179531	2287	2525	0	186055
26891	172692	5494	1524	2126	0	181836
26892	4926	176038	1136	1697	0	183797
26893	2959	5035	1130	171984	0	181108
26894	2056	170987	1256	4493	0	178792
26895	1943	177067	874	2521	0	182405
26896	174416	5842	831	2275	0	183364
26897	5138	2867	899	173091	0	181995
26898	2580	2106	170716	4997	0	180399
26899	1940	1835	166971	3009	0	173755
26900	1602	171273	4819	2389	0	180083
26901	170024	4999	2119	2317	0	179459
26902	4610	172655	1550	1651	0	180466
26903	2467	5656	1041	175309	0	184473
26904	175076	2784	1054	5464	0	184378
26905	5270	2179	842	177371	0	185662
26906	2741	1921	909	178844	0	184415
26907	2017	175622	858	6372	0	184869
26908	2101	5189	734	179631	0	187655
26909	1539	2826	177324	5723	0	187412
26910	175125	1963	4462	3437	0	184987
26911	5011	180633	1959	2453	0	190056
26912	1849	178135	1059	1505	0	182548
26913	170104	4683	869	1518	0	177174
26914	4696	2081	169684	1069	0	177530
26915	160750	2090	4125	1477	0	168442
26916	4091	176532	1438	969	0	183030
26917	1219	187094	783	651	0	189747
26918	870	5344	186210	467	0	192891
26919	639	188645	4692	621	0	194597
26920	1671	5259	1755	170999	0	179684
26921	1043	1918	786	177230	0	180977
26922	336	179129	381	4858	0	184704
26923	902	4363	260	181445	0	186970
26924	181164	1647	231	5234	0	188276
26925	4301	1234	178566	1694	0	185795
26926	178905	792	4109	1588	0	185394
26927	185540	758	1504	1179	0	188981
26928	185037	757	872	1092	0	187758
26929	6352	862	179157	659	0	187030
26930	3125	711	4301	179372	0	187509
26931	1479	821	181177	4678	0	188155
26932	176168	646	4949	2393	0	184156
26933	178015	537	1805	1901	0	182258
26934	5898	177565	1258	842	0	185563
26935	3239	4665	711	176722	0	185337
26936	1738	181435	658	4537	0	188368
26937	1310	5219	182131	1609	0	190269
26938	1808	2078	4752	181023	0	189661
26939	179692	1311	1901	5774	0	188678
26940	182981	744	1154	2458	0	187337
26941	6954	813	804	173904	0	182475
26942	2825	173283	712	4779	0	181599
26943	1716	4893	176506	1938	0	185053
26944	1309	2091	178617	1297	0	183314
26945	170642	1344	6265	1394	0	179645
26946	5394	1022	177513	895	0	184824
26947	2226	175294	5687	1037	0	184244
26948	2249	4972	2253	173691	0	183165
26949	1288	1991	176588	4926	0	184793
26950	1840	1304	5270	172262	0	180676
26951	1064	970	174524	5693	0	182251
26952	165690	843	5884	2539	0	174956
26953	5618	695	2522	168974	0	177809
26954	2290	164898	1790	5230	0	174208
26955	1467	172723	1354	2307	0	177851
26956	1471	6217	1181	168975	0	177844
26957	1513	2572	1074	168937	0	174096
26958	1062	166854	1140	6578	0	175634
26959	1120	5331	166714	2851	0	176016
26960	1438	2293	5262	167737	0	176730
26961	1139	1550	169655	5715	0	178059
26962	1043	1195	166163	2670	0	171071
26963	154287	1092	6805	2151	0	164335
26964	5254	158607	3098	1550	0	168509
26965	159515	5456	1730	1607	0	168308
26966	6230	2465	1362	154317	0	164374
26967	2528	158150	1311	5418	0	167407
26968	2024	5713	1391	160417	0	169545
26969	1552	2574	1446	160685	0	166257
26970	1254	156878	1400	7056	0	166588
26971	1268	5719	155857	3343	0	166187
26972	1659	2639	5591	157088	0	166977
26973	156129	1994	2520	6472	0	167115
26974	6070	1527	1817	155444	0	164858
26975	3035	1413	1489	157012	0	162949
26976	1984	1541	150762	7582	0	161869
26977	1576	149774	5635	3812	0	160797
26978	1681	5728	2579	150976	0	160964
26979	1316	2871	150020	6391	0	160598
26980	1245	2288	149870	3435	0	156838
26981	143600	1737	7242	3011	0	155590
26982	5658	147021	3521	2440	0	158640
26983	145964	5846	2410	2471	0	156691
26984	6240	144689	2011	2395	0	155335
26985	3001	149570	1799	2676	0	157046
26986	146186	7228	1790	2356	0	157560
26987	6311	3462	1773	142075	0	153621
26988	3254	144378	1960	6088	0	155680
26989	2792	5773	1742	148265	0	158572
26990	147213	2737	1674	6930	0	158554
26991	6744	2145	145742	3351	0	157982
26992	3534	1837	144183	2580	0	152134
26993	141642	1687	7069	2239	0	152637
26994	6211	142386	3771	2051	0	154419
26995	3304	5886	143119	1809	0	154118
26996	2618	142678	6241	1967	0	153504
26997	2256	6434	3110	141648	0	153448
26998	2031	3202	142930	6243	0	154406
26999	1961	2288	6111	142872	0	153232
27000	1539	1893	141476	6938	0	151846
27001	134739	1692	6758	3768	0	146957
27002	5843	138626	3464	2721	0	150654
27003	138179	5600	2503	2121	0	148403
27004	6367	3047	2047	134978	0	146439
27005	2917	143151	2005	5916	0	153989
27006	142533	6201	2088	3223	0	154045
27007	138316	2954	2273	3039	0	146582
27008	6948	2259	142482	2077	0	153766
27009	3531	1682	142730	1924	0	149867
27010	127940	1533	7029	1883	0	138385
27011	5288	128267	3597	1955	0	139107
27012	2281	126560	2356	1622	0	132819
27013	3312	7808	2579	117348	0	131047
27014	1763	2765	118577	4729	0	127834
27015	1517	112965	4584	2475	0	121541
27016	1290	104219	2015	1702	0	109226
27017	2482	2932	1210	76433	0	83057
27018	77493	786	583	1944	0	80806
27019	78411	517	317	884	0	80129
27020	79643	381	301	642	0	80967
27021	2394	369	77815	361	0	80939
27022	77857	314	1772	434	0	80377
27023	79173	335	722	435	0	80665
27024	80708	360	425	384	0	81877
27025	2529	478	343	77047	0	80397
27026	982	77581	306	1706	0	80575
27027	77862	1701	282	825	0	80670
27028	1874	77641	287	456	0	80258
27029	808	1787	267	77543	0	80405
27030	528	683	79654	1720	0	82585
27031	561	716	1751	78911	0	81939
27032	554	388	630	80584	0	82156
27033	439	313	79800	2106	0	82658
27034	370	78677	1648	832	0	81527
27035	563	1653	556	74881	0	77653
27036	73647	518	397	1666	0	76228
27037	1462	72617	258	606	0	74943
27038	71787	1381	184	476	0	73828
27039	1682	918	167	69810	0	72577
27040	668	71397	184	1338	0	73587
27041	72087	1351	208	588	0	74234
27042	1454	72920	193	341	0	74908
27043	572	1385	71059	213	0	73229
27044	69317	705	1437	533	0	71992
27045	72004	545	438	381	0	73368
27046	1628	71396	246	218	0	73488
27047	688	1296	69303	160	0	71447
27048	375	71894	1237	195	0	73701
27049	1405	1925	781	54486	0	58597
27050	353	539	294	73701	0	74887
27051	345	370	147	74186	0	75048
27052	236	73038	114	1905	0	75293
27053	387	1471	123	74050	0	76031
27054	357	558	116	74828	0	75859
27055	73087	399	113	1944	0	75543
27056	1689	245	98	73013	0	75045
27057	732	222	103	74621	0	75678
27058	72986	188	94	2048	0	75316
27059	1597	73536	143	754	0	76030
27060	74765	1506	134	585	0	76990
27061	75212	536	117	408	0	76273
27062	75823	357	131	392	0	76703
27063	2244	288	146	74307	0	76985
27064	1008	249	155	76265	0	77677
27065	619	296	73434	2049	0	76398
27066	483	339	72372	840	0	74034
27067	454	311	72705	591	0	74061
27068	70517	288	1926	520	0	73251
27069	1774	353	72330	397	0	74854
27070	736	72599	1717	479	0	75531
27071	645	1614	618	73085	0	75962
27072	505	704	421	72524	0	74154
27073	443	73791	300	1931	0	76465
27074	447	1762	74579	844	0	77632
27075	475	75956	1546	564	0	78541
27076	76165	1868	598	566	0	79197
27077	1935	750	76089	426	0	79200
27078	884	75854	1698	484	0	78920
27079	742	1747	76738	370	0	79597
27080	661	747	1807	76460	0	79675
27081	571	535	77276	1783	0	80165
27082	644	397	1894	75799	0	78734
27083	77476	363	695	2108	0	80642
27084	1977	384	76992	866	0	80219
27085	872	77191	1768	668	0	80499
27086	77993	1816	638	695	0	81142
27087	2007	748	78432	550	0	81737
27088	856	561	78990	620	0	81027
27089	702	446	2094	78037	0	81279
27090	506	382	78549	2101	0	81538
27091	75813	418	2009	1088	0	79328
27092	1892	76771	812	817	0	80292
27093	889	1862	537	78248	0	81536
27094	614	81445	476	1939	0	84474
27095	82761	2039	409	1040	0	86249
27096	2090	824	81789	741	0	85444
27097	953	609	84218	618	0	86398
27098	759	522	2276	83647	0	87204
27099	712	460	931	85645	0	87748
27100	636	444	632	86904	0	88616
27101	692	461	518	87041	0	88712
27102	609	464	86683	2666	0	90422
27103	501	85600	2032	1224	0	89357
27104	563	1760	711	81094	0	84128
27105	324	607	78463	1605	0	80999
27106	329	77382	1540	697	0	79948
27107	76920	1540	779	611	0	79850
27108	1986	746	547	76071	0	79350
27109	74784	365	343	1595	0	77087
27110	1413	74493	274	719	0	76899
27111	74781	1311	313	604	0	77009
27112	1540	565	76313	407	0	78825
27113	734	942	1392	73524	0	76592
27114	402	75817	552	1339	0	78110
27115	377	1295	75206	591	0	77469
27116	259	74674	1351	493	0	76777
27117	1069	1818	732	57126	0	60745
27118	71570	434	362	1300	0	73666
27119	1119	71231	284	600	0	73234
27120	71262	1130	243	457	0	73092
27121	1284	465	69919	307	0	71975
27122	562	340	68687	287	0	69876
27123	69214	227	1391	334	0	71166
27124	1222	339	659	69415	0	71635
27125	582	319	408	70043	0	71352
27126	334	210	70332	1367	0	72243
27127	321	240	68498	574	0	69633
27128	234	71015	1341	371	0	72961
27129	69673	1190	760	514	0	72137
27130	67798	408	382	327	0	68915
27131	1157	66484	252	230	0	68123
27132	589	961	249	68322	0	70121
27133	69023	367	220	1133	0	70743
27134	1023	219	221	69052	0	70515
27135	69759	177	224	1195	0	71355
27136	70313	176	234	522	0	71245
27137	72424	164	193	473	0	73254
27138	1350	155	201	71120	0	72826
27139	597	158	198	74292	0	75245
27140	72527	176	169	1393	0	74265
27141	72775	135	201	675	0	73786
27142	72704	153	202	436	0	73495
27143	1342	71067	190	266	0	72865
27144	69672	761	169	266	0	70868
27145	893	69011	172	224	0	70300
27146	68769	800	159	294	0	70022
27147	933	287	67563	194	0	68977
27148	62100	397	840	326	0	63663
27149	718	63840	269	155	0	64982
27150	279	64436	147	115	0	64977
27151	65653	620	158	221	0	66652
27152	663	219	81	65371	0	66334
27153	312	144	81	67230	0	67767
27154	165	66437	129	768	0	67499
27155	148	70418	96	275	0	70937
27156	72244	769	75	285	0	73373
27157	863	298	73561	100	0	74822
27158	394	158	751	76435	0	77738
27159	78316	110	216	1151	0	79793
27160	1161	116	77519	278	0	79074
27161	340	83110	1031	199	0	84680
27162	87411	1329	270	234	0	89244
27163	1805	349	89219	110	0	91483
27164	682	229	1797	93205	0	95913
27165	313	124	96099	1994	0	98530
27166	92651	91	2075	735	0	95552
27167	1994	97637	523	380	0	100534
27168	99254	2008	389	373	0	102024
27169	100085	481	168	292	0	101026
27170	2649	293	123	98477	0	101542
27171	99646	161	119	2202	0	102128
27172	2471	172	92	99729	0	102464
27173	830	145	106	101041	0	102122
27174	430	160	97449	2449	0	100488
27175	294	97253	1902	764	0	100213
27176	412	1957	443	98780	0	101592
27177	381	470	262	100128	0	101241
27178	362	246	158	100052	0	100818
27179	201	199	97403	2505	0	100308
27180	154	96344	1908	779	0	99185
27181	325	1841	419	98505	0	101090
27182	326	448	237	100123	0	101134
27183	186	304	97443	2351	0	100284
27184	377	214	1860	95375	0	97826
27185	96857	107	475	2452	0	99891
27186	1853	96708	323	703	0	99587
27187	96504	1840	158	582	0	99084
27188	2183	485	96016	231	0	98915
27189	783	337	1828	96254	0	99202
27190	98226	161	469	2173	0	101029
27191	98462	112	307	739	0	99620
27192	2423	162	97936	372	0	100893
27193	1036	289	1905	96469	0	99699
27194	494	152	96702	1992	0	99340
27195	93144	109	1996	769	0	96018
27196	1916	96309	599	436	0	99260
27197	98342	1840	354	482	0	101018
27198	98865	453	239	428	0	99985
27199	2436	98255	210	257	0	101158
27200	100425	2047	159	504	0	103135
27201	2409	535	98660	275	0	101879
27202	98182	314	1923	399	0	100818
27203	2466	224	467	99654	0	102811
27204	783	203	101702	2131	0	104819
27205	716	155	2047	101769	0	104687
27206	683	187	578	99880	0	101328
27207	539	124	404	103126	0	104193
27208	371	101321	340	2556	0	104588
27209	102776	2019	242	1086	0	106123
27210	2354	492	257	102842	0	105945
27211	690	101615	298	2356	0	104959
27212	631	2104	261	99909	0	102905
27213	505	99889	288	2378	0	103060
27214	487	2285	99907	836	0	103515
27215	597	603	2079	99891	0	103170
27216	629	406	594	102109	0	103738
27217	430	362	100451	2773	0	104016
27218	94166	306	2147	1347	0	97966
27219	2260	99988	652	862	0	103762
27220	890	2109	510	102137	0	105646
27221	768	618	366	101900	0	103652
27222	661	435	358	101494	0	102948
27223	544	100688	378	2862	0	104472
27224	101062	2160	357	1397	0	104976
27225	2447	711	100891	915	0	104964
27226	917	530	98218	779	0	100444
27227	716	414	2482	99225	0	102837
27228	665	323	825	102595	0	104408
27229	100709	310	592	3163	0	104774
27230	2427	99038	563	1279	0	103307
27231	932	2192	442	101732	0	105298
27232	100550	677	431	2897	0	104555
27233	2665	546	387	99821	0	103419
27234	100005	397	381	3081	0	103864
27235	2787	373	96255	1164	0	100579
27236	1045	98815	2301	982	0	103143
27237	99875	2258	749	974	0	103856
27238	2766	719	99282	686	0	103453
27239	96501	451	2383	942	0	100277
27240	2768	420	96593	678	0	100459
27241	97695	315	2428	794	0	101232
27242	2791	352	813	98900	0	102856
27243	99663	335	616	2732	0	103346
27244	2757	365	440	99426	0	102988
27245	1100	299	391	100956	0	102746
27246	99207	337	424	3236	0	103204
27247	2624	97924	398	1232	0	102178
27248	1059	2251	382	100885	0	104577
27249	101595	692	370	2970	0	105627
27250	105093	530	364	1301	0	107288
27251	3088	430	344	103852	0	107714
27252	1284	376	356	106784	0	108800
27253	106867	341	326	3418	0	110952
27254	3180	332	304	108242	0	112058
27255	1300	365	328	108409	0	110402
27256	105291	302	327	3480	0	109400
27257	3017	296	359	103132	0	106804
27258	906	273	96357	2886	0	100422
27259	93409	211	2009	1355	0	96984
27260	2477	260	96547	802	0	100086
27261	904	271	88958	511	0	90644
27262	84865	638	2534	585	0	88622
27263	1484	84323	775	313	0	86895
27264	763	1195	506	81867	0	84331
27265	460	286	193	81778	0	82717
27266	450	152	111	84609	0	85322
27267	342	71	74	87020	0	87507
27268	83832	106	121	2280	0	86339
27269	91841	64	56	812	0	92773
27270	95457	61	64	597	0	96179
27271	2281	96	100319	279	0	102975
27272	1071	56	2120	104933	0	108180
27273	686	62	765	108438	0	109951
27274	578	62	336	107005	0	107981
27275	345	100038	322	3908	0	104613
27276	307	104948	266	1751	0	107272
27277	107926	3271	132	1143	0	112472
27278	3098	1261	139	108770	0	113268
27279	1549	554	121	115102	0	117326
27280	923	333	123	118134	0	119513
27281	544	317	112669	4812	0	118342
27282	530	308	110640	2140	0	113618
27283	111278	171	3986	1442	0	116877
27284	117482	135	1549	1084	0	120250
27285	4612	185	758	113595	0	119150
27286	1791	114043	576	3494	0	119904
27287	1345	3084	358	115768	0	120555
27288	1074	1132	271	117428	0	119905
27289	612	572	112047	4837	0	118068
27290	112275	322	3066	2492	0	118155
27291	3782	263	1240	117439	0	122724
27292	1811	203	709	117410	0	120133
27293	113576	184	490	5233	0	119483
27294	3833	114987	448	2477	0	121745
27295	118462	3395	287	1705	0	123849
27296	4623	1573	241	115402	0	121839
27297	1836	113053	259	4051	0	119199
27298	115463	3547	252	2098	0	121360
27299	4361	1549	323	114722	0	120955
27300	114153	753	225	4338	0	119469
27301	113049	469	229	2413	0	116160
27302	113811	421	235	1606	0	116073
27303	5527	107369	312	1161	0	114369
27304	2523	108417	338	1068	0	112346
27305	1948	4404	265	105372	0	111989
27306	1252	106800	283	3886	0	112221
27307	109591	4025	214	2091	0	115921
27308	4387	1809	256	109557	0	116009
27309	110105	1005	247	4415	0	115772
27310	112940	643	281	2372	0	116236
27311	5735	586	296	109113	0	115730
27312	3042	492	301	113883	0	117718
27313	111769	552	261	5844	0	118426
27314	113909	566	264	3035	0	117774
27315	117591	527	223	2093	0	120434
27316	118828	586	189	1817	0	121420
27317	120743	556	167	1538	0	123004
27318	6745	514	164	115948	0	123371
27319	3577	568	225	118507	0	122877
27320	2517	543	236	120229	0	123525
27321	116274	469	248	6488	0	123479
27322	5251	437	211	115434	0	121333
27323	2797	112669	264	5453	0	121183
27324	2162	3789	232	117101	0	123284
27325	114252	1677	286	5558	0	121773
27326	116705	1022	297	2883	0	120907
27327	6257	860	110939	2016	0	120072
27328	3448	878	3429	109494	0	117249
27329	2174	111379	1429	4808	0	119790
27330	113724	3729	725	2931	0	121109
27331	4892	113893	530	2099	0	121414
27332	3010	4169	420	116039	0	123638
27333	117085	1878	334	5147	0	124444
27334	119218	1166	294	2933	0	123611
27335	6455	114994	331	2403	0	124183
27336	3636	4022	218	115813	0	123689
27337	2536	1853	113642	5010	0	123041
27338	112591	1072	3628	2957	0	120248
27339	5439	989	113673	2050	0	122151
27340	115564	809	4074	1957	0	122404
27341	118824	747	1671	2019	0	123261
27342	6781	779	846	115986	0	124392
27343	118865	781	498	5293	0	125437
27344	121476	810	436	3227	0	125949
27345	122811	911	373	2374	0	126469
27346	7567	876	353	117902	0	126698
27347	119355	646	456	5239	0	125696
27348	6348	695	418	118092	0	125553
27349	3700	627	542	118931	0	123800
27350	2683	113874	551	6310	0	123418
27351	2797	3770	448	112936	0	119951
27352	2382	111949	349	5026	0	119706
27353	111233	3923	193	2899	0	118248
27354	111752	1839	302	2262	0	116155
27355	6112	1151	210	108593	0	116066
27356	3518	830	222	110666	0	115236
27357	108338	689	293	5751	0	115071
27358	5285	606	103769	3146	0	112806
27359	107336	528	3101	2252	0	113217
27360	5651	638	1266	105488	0	113043
27361	3196	626	100237	4532	0	108591
27362	101252	642	3106	2742	0	107742
27363	105210	578	1344	2062	0	109194
27364	6002	603	100996	1660	0	109261
27365	102460	505	3124	1833	0	107922
27366	5140	516	99135	1438	0	106229
27367	3212	98620	3180	1301	0	106313
27368	99923	2914	2399	1539	0	106775
27369	98401	1506	1188	1518	0	102613
27370	5016	91334	617	1040	0	98007
27371	2198	86185	559	874	0	89816
27372	81830	1962	947	802	0	85541
27373	82296	710	367	757	0	84130
27374	2912	656	242	83013	0	86823
27375	1465	373	81130	1882	0	84850
27376	1169	382	77785	889	0	80225
27377	80509	353	1786	845	0	83493
27378	2144	324	80798	581	0	83847
27379	77568	570	1857	640	0	80635
27380	1930	299	610	76807	0	79646
27381	1042	156	347	77557	0	79102
27382	799	199	77537	1678	0	80213
27383	77046	111	1233	961	0	79351
27384	1723	178	550	78655	0	81106
27385	986	132	357	84485	0	85960
27386	83027	129	303	1892	0	85351
27387	84247	97	216	1083	0	85643
27388	84403	98	245	809	0	85555
27389	1963	84674	274	498	0	87409
27390	916	959	82157	366	0	84398
27391	81166	363	1094	499	0	83122
27392	83137	213	433	495	0	84278
27393	1590	80739	304	362	0	82995
27394	79166	725	411	322	0	80624
27395	1230	271	154	78265	0	79920
27396	516	200	79931	801	0	81448
27397	79155	181	809	587	0	80732
27398	81340	153	388	512	0	82393
27399	81839	127	161	442	0	82569
27400	82180	89	144	350	0	82763
27401	1230	98	116	81672	0	83116
27402	658	80	105	81711	0	82554
27403	82192	61	122	1167	0	83542
27404	1061	52	139	82180	0	83432
27405	577	44	126	81961	0	82708
27406	405	79777	171	1057	0	81410
27407	431	739	123	82263	0	83556
27408	419	201	106	82704	0	83430
27409	422	130	107	83082	0	83741
27410	432	82	90	83275	0	83879
27411	342	81539	118	1121	0	83120
27412	347	744	85	81405	0	82581
27413	395	348	75	79741	0	80559
27414	279	164	78799	1009	0	80251
27415	275	149	73874	455	0	74753
27416	236	76718	724	309	0	77987
27417	85990	591	329	431	0	87341
27418	1092	87424	172	240	0	88928
27419	546	1088	97	92239	0	93970
27420	277	321	96752	1303	0	98653
27421	100490	177	1419	773	0	102859
27422	1841	114	375	105274	0	107604
27423	104109	83	278	2078	0	106548
27424	106354	103	172	848	0	107477
27425	1958	105492	169	464	0	108083
27426	106047	1513	111	641	0	108312
27427	1885	108082	153	296	0	110416
27428	914	2039	98	109831	0	112882
27429	471	110233	157	1821	0	112682
27430	461	1997	109954	561	0	112973
27431	278	111608	1698	466	0	114050
27432	639	2176	497	109038	0	112350
27433	109478	596	322	2199	0	112595
27434	1727	111481	229	672	0	114109
27435	898	1979	151	112101	0	115129
27436	743	638	110	114814	0	116305
27437	371	493	112995	2590	0	116449
27438	694	314	2014	112612	0	115634
27439	337	311	113371	2537	0	116556
27440	109603	221	2286	1283	0	113393
27441	2408	260	115632	590	0	118890
27442	844	115675	2357	536	0	119412
27443	967	2273	708	115642	0	119590
27444	792	710	457	116703	0	118662
27445	749	543	308	117082	0	118682
27446	116730	373	241	3500	0	120844
27447	2784	385	196	115537	0	118902
27448	831	115902	271	2896	0	119900
27449	113626	2500	206	1443	0	117775
27450	2447	113100	289	939	0	116775
27451	1249	2670	257	113122	0	117298
27452	113194	917	219	3066	0	117396
27453	2663	110606	288	1175	0	114732
27454	969	115435	250	893	0	117547
27455	114424	2899	254	1090	0	118667
27456	116533	1119	242	1031	0	118925
27457	3156	820	113807	664	0	118447
27458	115485	546	2445	1005	0	119481
27459	3331	609	117071	614	0	121625
27460	1532	554	2784	118140	0	123010
27461	874	518	118833	2974	0	123199
27462	923	511	2886	118965	0	123285
27463	661	496	119826	3359	0	124342
27464	901	480	2911	117028	0	121320
27465	828	472	997	120743	0	123040
27466	117288	444	637	4083	0	122452
27467	2997	480	115738	1637	0	120852
27468	111578	510	2803	1396	0	116287
27469	3293	461	114206	998	0	118958
27470	1338	518	114899	806	0	117561
27471	1223	710	3293	112988	0	118214
27472	113813	457	1343	3299	0	118912
27473	2890	113650	890	1401	0	118831
27474	111871	2725	664	1322	0	116582
27475	112976	918	606	1159	0	115659
27476	3530	111027	562	917	0	116036
27477	111787	2803	569	951	0	116110
27478	3467	1091	111747	719	0	117024
27479	1607	856	2833	112037	0	117333
27480	112427	565	1087	3336	0	117415
27481	3175	112099	886	1404	0	117564
27482	1540	2717	684	111428	0	116369
27483	1287	980	631	112406	0	115304
27484	1132	754	629	113785	0	116300
27485	1028	604	617	114443	0	116692
27486	111462	480	594	4228	0	116764
27487	113087	482	675	2048	0	116292
27488	112836	443	658	1630	0	115567
27489	110216	435	655	1396	0	112702
27490	4099	517	108236	1023	0	113875
27491	108998	512	2817	1129	0	113456
27492	112401	487	1099	1059	0	115046
27493	4055	107997	854	913	0	113819
27494	1912	111279	706	966	0	114863
27495	1674	3288	633	108410	0	114005
27496	1397	1283	595	110059	0	113334
27497	1191	911	107120	3647	0	112869
27498	1120	107834	2900	1661	0	113515
27499	1217	2875	1084	106671	0	111847
27500	1043	108129	931	3152	0	113255
27501	1085	3061	675	111053	0	115874
27502	1135	1075	612	112176	0	114998
27503	1065	112695	626	3887	0	118273
27504	1131	3052	600	115036	0	119819
27505	1083	1126	115128	3782	0	121119
27506	1067	874	115274	1750	0	118965
27507	113492	634	3610	1563	0	119299
27508	118022	541	1559	1385	0	121507
27509	3921	115524	1124	1159	0	121728
27510	117171	2906	755	1185	0	122017
27511	4040	1233	671	116522	0	122466
27512	116432	940	574	3635	0	121581
27513	3755	115720	547	1854	0	121876
27514	2286	2942	114107	1383	0	120718
27515	113168	1189	3484	1422	0	119263
27516	4076	992	117367	1004	0	123439
27517	1700	708	105381	679	0	108468
27518	1385	664	104544	683	0	107276
27519	952	101440	2963	691	0	106046
27520	94698	2733	2759	1028	0	101218
27521	92772	894	844	803	0	95313
27522	2579	486	474	90342	0	93881
27523	1279	471	424	90044	0	92218
27524	793	91792	476	2295	0	95356
27525	92578	1688	460	1326	0	96052
27526	2019	92228	463	801	0	95511
27527	966	91168	410	574	0	93118
27528	89619	1755	604	667	0	92645
27529	2030	639	544	88651	0	91864
27530	898	439	312	89180	0	90829
27531	798	350	302	89810	0	91260
27532	575	88346	302	2000	0	91223
27533	87808	1334	249	1002	0	90393
27534	1833	842	235	86663	0	89573
27535	711	83506	237	1455	0	85909
27536	540	84099	209	616	0	85464
27537	573	1601	276	81529	0	83979
27538	414	82496	226	1227	0	84363
27539	641	1479	227	81977	0	84324
27540	80495	536	269	1573	0	82873
27541	1128	418	78369	584	0	80499
27542	494	79351	941	470	0	81256
27543	622	1245	354	80052	0	82273
27544	378	503	81306	1106	0	83293
27545	79041	379	1137	756	0	81313
27546	1448	500	427	81412	0	83787
27547	81285	185	315	1499	0	83284
27548	81193	198	198	805	0	82394
27549	1359	84140	190	435	0	86124
27550	85738	1055	154	599	0	87546
27551	85907	473	125	532	0	87037
27552	86272	329	140	496	0	87237
27553	1693	246	96	84361	0	86396
27554	865	232	104	83985	0	85186
27555	644	247	139	84843	0	85873
27556	450	287	83091	1440	0	85268
27557	353	82198	976	699	0	84226
27558	80640	920	352	676	0	82588
27559	957	79582	237	301	0	81077
27560	482	996	132	79298	0	80908
27561	341	381	78349	926	0	79997
27562	73538	290	882	685	0	75395
27563	907	78006	301	355	0	79569
27564	529	870	210	77659	0	79268
27565	405	346	120	77819	0	78690
27566	248	278	76745	1038	0	78309
27567	193	76319	786	529	0	77827
27568	301	907	262	76806	0	78276
27569	257	350	194	77570	0	78371
27570	313	245	106	76017	0	76681
27571	73939	198	122	1465	0	75724
27572	865	232	73098	557	0	74752
27573	356	72909	770	452	0	74487
27574	72210	793	320	503	0	73826
27575	810	72875	240	288	0	74213
27576	453	930	139	72174	0	73696
27577	331	73138	140	795	0	74404
27578	71175	905	118	633	0	72831
27579	71995	387	109	553	0	73044
27580	1154	274	93	73328	0	74849
27581	599	233	93	73649	0	74574
27582	474	188	81	76482	0	77225
27583	291	207	76386	1508	0	78392
27584	238	78815	1194	669	0	80916
27585	453	1423	380	89783	0	92039
27586	413	485	240	92754	0	93892
27587	455	310	142	93932	0	94839
27588	458	221	108	94253	0	95040
27589	251	277	92539	2965	0	96032
27590	234	97513	1935	1273	0	100955
27591	494	2288	690	102032	0	105504
27592	482	917	309	111263	0	112971
27593	214	550	109218	3606	0	113588
27594	533	321	2473	106419	0	109746
27595	206	105102	1035	3268	0	109611
27596	186	110301	531	1617	0	112635
27597	515	3402	273	108660	0	112850
27598	233	1374	105376	3260	0	110243
27599	98786	695	2625	2127	0	104233
27600	2429	104332	1161	1287	0	109209
27601	965	2750	102528	815	0	107058
27602	531	1276	102890	748	0	105445
27603	298	101363	3412	764	0	105837
27604	367	2813	102826	681	0	106687
27605	930	1947	3166	98825	0	104868
27606	98493	720	1362	2929	0	103504
27607	100199	533	764	1480	0	102976
27608	100551	510	560	1047	0	102668
27609	103238	433	524	963	0	105158
27610	3588	103577	500	635	0	108300
27611	104897	2669	499	871	0	108936
27612	3165	106404	527	633	0	110729
27613	1455	3164	104504	494	0	109617
27614	1245	1410	2797	101567	0	107019
27615	677	106417	1209	2724	0	111027
27616	940	3090	705	103795	0	108530
27617	101660	1376	552	3475	0	107063
27618	3224	813	498	100738	0	105273
27619	1357	102810	498	3163	0	107828
27620	103690	2951	488	1655	0	108784
27621	3143	1384	102960	946	0	108433
27622	1787	940	2803	102445	0	107975
27623	1194	644	1209	105663	0	108710
27624	99982	627	680	4148	0	105437
27625	3010	99644	587	1940	0	105181
27626	1445	3014	98516	1150	0	104125
27627	1328	1400	2762	98753	0	104243
27628	744	966	99566	3270	0	104546
27629	678	95779	3002	1777	0	101236
27630	589	100405	1341	1278	0	103613
27631	98065	3666	886	1161	0	103778
27632	2924	1693	97683	986	0	103286
27633	98870	1071	3058	1067	0	104066
27634	3318	819	1425	96626	0	102188
27635	1395	98760	948	3097	0	104200
27636	98627	3057	730	1755	0	104169
27637	3165	1504	98821	1158	0	104648
27638	1785	1011	2982	98453	0	104231
27639	1228	860	1464	100588	0	104140
27640	1049	899	936	99784	0	102668
27641	747	97708	792	4145	0	103392
27642	94680	3039	753	2262	0	100734
27643	3009	94586	686	1809	0	100090
27644	1404	96416	736	1105	0	99661
27645	1313	3759	750	95167	0	100989
27646	95213	1719	779	3340	0	101051
27647	94932	1177	684	1901	0	98694
27648	95306	1133	576	1383	0	98398
27649	3895	89849	650	1072	0	95466
27650	2015	2973	586	90640	0	96214
27651	1305	1599	89895	3190	0	95989
27652	1330	1049	2728	90320	0	95427
27653	1141	996	1316	90041	0	93494
27654	1031	90286	812	3898	0	96027
27655	91368	3143	654	2200	0	97365
27656	3246	1672	641	90140	0	95699
27657	1644	91213	707	3455	0	97019
27658	91907	3115	697	1992	0	97711
27659	3285	1746	90165	1443	0	96639
27660	90219	1305	2692	1311	0	95527
27661	3353	91898	1332	1202	0	97785
27662	93026	3211	922	1129	0	98288
27663	94250	1747	745	1132	0	97874
27664	4055	1320	91845	1037	0	98257
27665	92936	1051	2845	1033	0	97865
27666	3788	958	94904	958	0	100608
27667	2187	1026	95998	827	0	100038
27668	94607	958	3614	912	0	100091
27669	97322	877	1738	923	0	100860
27670	4245	929	96095	830	0	102099
27671	2359	768	3228	94919	0	101274
27672	1769	776	1585	95698	0	99828
27673	1429	98377	1119	3539	0	104464
27674	95243	3009	886	2011	0	101149
27675	100683	1556	707	1336	0	104282
27676	4305	1040	98160	952	0	104457
27677	100063	864	2922	1088	0	104937
27678	103095	827	1393	1055	0	106370
27679	4379	99945	980	903	0	106207
27680	2455	3059	827	99545	0	105886
27681	2182	1449	696	98459	0	102786
27682	1749	981	710	98774	0	102214
27683	94270	720	745	3664	0	99399
27684	2969	90662	629	1872	0	96132
27685	1364	2496	458	79205	0	83523
27686	906	78318	405	1904	0	81533
27687	973	3641	410	73963	0	78987
27688	765	74567	368	1731	0	77431
27689	640	76105	491	1038	0	78274
27690	67473	1989	903	1131	0	71496
27691	67053	755	726	856	0	69390
27692	1149	353	196	62487	0	64185
27693	515	176	122	63148	0	63961
27694	381	142	112	63800	0	64435
27695	304	132	113	63638	0	64187
27696	299	117	111	62436	0	62963
27697	189	61386	122	1141	0	62838
27698	263	795	93	62878	0	64029
27699	281	275	89	63885	0	64530
27700	62678	181	98	1176	0	64133
27701	1022	150	109	62885	0	64166
27702	453	119	96	63152	0	63820
27703	325	155	62846	1105	0	64431
27704	355	182	792	61604	0	62933
27705	353	487	307	64189	0	65336
27706	354	137	64607	1196	0	66294
27707	209	65177	890	568	0	66844
27708	239	872	66243	389	0	67743
27709	237	283	64802	265	0	65587
27710	137	63622	940	225	0	64924
27711	64248	809	491	331	0	65879
27712	63979	183	194	266	0	64622
27713	957	105	60	62857	0	63979
27714	63882	64	55	975	0	64976
27715	896	70	65119	228	0	66313
27716	369	77	775	66370	0	67591
27717	171	99	71734	908	0	72912
27718	245	83	875	72379	0	73582
27719	225	81	242	73144	0	73692
27720	217	59	136	74093	0	74505
27721	73276	69	97	1364	0	74806
27722	994	59	82	74312	0	75447
27723	73826	77	89	1265	0	75257
27724	74924	64	104	566	0	75658
27725	1091	74061	120	319	0	75591
27726	75328	852	97	431	0	76708
27727	1018	76584	125	327	0	78054
27728	407	935	90	76833	0	78265
27729	375	261	83	78120	0	78839
27730	321	169	84	79189	0	79763
27731	219	169	76876	1418	0	78682
27732	217	76340	980	591	0	78128
27733	310	1044	251	74868	0	76473
27734	292	332	175	75839	0	76638
27735	187	77134	139	1157	0	78617
27736	77680	1033	97	638	0	79448
27737	1061	76054	123	395	0	77633
27738	75817	1101	94	474	0	77486
27739	1143	76800	129	357	0	78429
27740	475	1120	87	75696	0	77378
27741	276	77756	107	1120	0	79259
27742	79099	1117	76	720	0	81012
27743	80147	361	61	629	0	81198
27744	80177	245	95	535	0	81052
27745	79908	191	85	548	0	80732
27746	1403	263	78783	310	0	80759
27747	79775	159	933	535	0	81402
27748	82250	185	272	518	0	83225
27749	82128	173	152	565	0	83018
27750	1426	253	79676	322	0	81677
27751	80096	166	920	513	0	81695
27752	1253	81628	287	338	0	83506
27753	83173	982	186	527	0	84868
27754	1279	424	86597	286	0	88586
27755	86133	259	1048	595	0	88035
27756	88451	191	305	515	0	89462
27757	1410	167	183	87674	0	89434
27758	616	209	85802	1109	0	87736
27759	86582	131	922	725	0	88360
27760	1303	126	303	88723	0	90455
27761	651	151	210	89924	0	90936
27762	463	178	89578	1280	0	91499
27763	85180	151	1004	840	0	87175
27764	90521	130	330	617	0	91598
27765	1328	89621	271	395	0	91615
27766	643	1016	183	90118	0	91960
27767	497	342	177	90420	0	91436
27768	474	224	168	89861	0	90727
27769	346	89411	234	1360	0	91351
27770	89855	994	154	797	0	91800
27771	1256	320	145	89884	0	91605
27772	624	225	143	90306	0	91298
27773	87496	170	151	1576	0	89393
27774	87101	148	135	787	0	88171
27775	1429	140	165	88061	0	89795
27776	696	177	163	87326	0	88362
27777	443	204	83376	1328	0	85351
27778	79512	161	889	860	0	81422
27779	1155	83858	331	473	0	85817
27780	588	969	162	88171	0	89890
27781	549	287	125	90171	0	91132
27782	366	91623	171	1579	0	93739
27783	473	1332	106	95610	0	97521
27784	101504	536	181	2086	0	104307
27785	2180	305	121	116991	0	119597
27786	1071	223	106	120654	0	122054
27787	778	181	102	124266	0	125327
27788	437	251	120050	4543	0	125281
27789	698	172	2444	121581	0	124895
27790	387	239	119569	4108	0	124303
27791	296	116453	2945	2284	0	121978
27792	661	2598	1529	117759	0	122547
27793	553	1168	842	120377	0	122940
27794	486	647	559	123890	0	125582
27795	530	444	445	124259	0	125678
27796	440	357	336	126521	0	127654
27797	119652	296	232	5580	0	125760
27798	2588	262	120650	2953	0	126453
27799	1249	117158	2534	2151	0	123092
27800	782	125221	1215	1670	0	128888
27801	741	3457	690	127453	0	132341
27802	719	1608	520	130735	0	133582
27803	605	993	486	129455	0	131539
27804	312	126657	384	4614	0	131967
27805	568	2841	286	128931	0	132626
27806	279	1533	124677	4039	0	130528
27807	187	123171	2359	2501	0	128218
27808	489	2928	1125	125364	0	129906
27809	122314	1409	852	4051	0	128626
27810	2522	863	426	124363	0	128174
27811	1459	653	373	124005	0	126490
27812	812	117632	389	4199	0	123032
27813	558	125636	335	2538	0	129067
27814	764	3364	321	125677	0	130126
27815	644	1712	182	126361	0	128899
27816	283	1014	122388	4543	0	128228
27817	559	811	2225	120238	0	123833
27818	414	607	1175	122660	0	124856
27819	392	555	722	122931	0	124600
27820	401	409	580	124456	0	125846
27821	119128	505	564	5549	0	125746
27822	121260	386	394	3666	0	125706
27823	3596	304	267	123540	0	127707
27824	2048	296	279	127519	0	130142
27825	123760	226	256	5824	0	130066
27826	3388	303	269	128925	0	132885
27827	1761	426	126966	5086	0	134239
27828	1089	126835	2743	3393	0	134060
27829	1011	2650	1544	130890	0	136095
27830	817	1354	1008	133761	0	136940
27831	130561	928	807	5671	0	137967
27832	2912	742	576	134449	0	138679
27833	1604	634	555	137481	0	140274
27834	134340	507	330	6423	0	141600
27835	3437	480	317	136934	0	141168
27836	1872	134668	360	5380	0	142280
27837	1443	3037	353	143010	0	147843
27838	1160	1628	361	148393	0	151542
27839	1108	999	385	147680	0	150172
27840	937	871	374	148978	0	151160
27841	558	928	141373	6777	0	149636
27842	526	875	139324	4237	0	144962
27843	551	768	3994	143354	0	148667
27844	543	702	1891	143343	0	146479
27845	321	140808	1235	6365	0	148729
27846	613	3279	1008	140127	0	145027
27847	400	139786	933	5578	0	146697
27848	138572	3759	709	4068	0	147108
27849	3241	144702	628	2983	0	151554
27850	1817	4112	420	148578	0	154927
27851	1246	2183	287	152061	0	155777
27852	868	1477	145403	6456	0	154204
27853	139695	1079	3071	4496	0	148341
27854	141795	951	1492	3487	0	147725
27855	4467	140821	1058	2909	0	149255
27856	2513	3396	988	140515	0	147412
27857	1433	1874	145656	4719	0	153682
27858	1064	147904	3445	3418	0	155831
27859	147077	3725	1600	3111	0	155513
27860	148606	2002	969	2738	0	154315
27861	5007	1344	141743	2416	0	150510
27862	144424	1008	3276	2287	0	150995
27863	4927	907	1587	145272	0	152693
27864	2714	143991	1049	4801	0	152555
27865	145422	3423	819	3353	0	153017
27866	4459	1841	775	145510	0	152585
27867	146244	1181	689	5235	0	153349
27868	151528	971	576	3582	0	156657
27869	5517	999	487	149302	0	156305
27870	2885	892	148672	5403	0	157852
27871	150004	678	3271	3981	0	157934
27872	155331	676	1610	3024	0	160641
27873	155502	612	1021	2831	0	159966
27874	5807	154691	862	2422	0	163782
27875	3453	3517	711	156167	0	163848
27876	2387	1812	571	162408	0	167178
27877	1737	1342	157705	6396	0	167180
27878	1738	1335	3417	156798	0	163288
27879	1170	155506	1688	5826	0	164190
27880	152666	3463	1053	3876	0	161058
27881	3667	152074	899	2918	0	159558
27882	1990	3607	149270	2117	0	156984
27883	1313	149366	3436	2231	0	156346
27884	1097	150193	1823	1690	0	154803
27885	1681	2485	1486	129787	0	135439
27886	129551	874	622	2250	0	133297
27887	129038	428	211	1258	0	130935
27888	127577	360	193	951	0	129081
27889	2268	129026	239	597	0	132130
27890	960	1749	127636	515	0	130860
27891	127606	738	1626	846	0	130816
27892	131411	424	635	830	0	133300
27893	2318	129254	380	543	0	132495
27894	132264	1757	255	811	0	135087
27895	2378	759	243	132234	0	135614
27896	999	562	136997	1982	0	140540
27897	136862	395	1805	1434	0	140496
27898	138345	355	693	1147	0	140540
27899	143095	330	379	831	0	144635
27900	2876	310	276	140352	0	143814
27901	1494	382	230	142505	0	144611
27902	1022	315	230	148585	0	150152
27903	715	145476	355	3176	0	149722
27904	1744	2516	334	147706	0	152300
27905	918	990	209	166879	0	168996
27906	659	721	164997	4261	0	170638
27907	946	454	3119	165027	0	169546
27908	939	418	976	170598	0	172931
27909	885	382	607	170859	0	172733
27910	927	368	430	169692	0	171417
27911	593	165637	497	5265	0	171992
27912	903	3318	444	169455	0	174120
27913	903	1101	431	169937	0	172372
27914	165370	708	416	5716	0	172210
27915	3878	623	163159	2583	0	170243
27916	1607	639	158872	1942	0	163060
27917	157685	517	4196	2068	0	164466
27918	165272	515	1515	1788	0	169090
27919	4966	637	862	154816	0	161281
27920	2024	161598	660	3840	0	168122
27921	163535	3400	595	2155	0	169685
27922	4504	1316	685	160168	0	166673
27923	1862	161816	763	3836	0	168277
27924	162569	3092	543	2098	0	168302
27925	3862	163026	466	1289	0	168643
27926	161010	3569	389	1413	0	166381
27927	158236	1354	327	1388	0	161305
27928	4482	153391	409	965	0	159247
27929	2326	3294	322	153945	0	159887
27930	1470	1411	152050	3670	0	158601
27931	1492	1575	2953	150123	0	156143
27932	150626	808	1014	4388	0	156836
27933	3762	873	147097	1805	0	153537
27934	1688	146604	2941	1442	0	152675
27935	1661	3788	1056	144785	0	151290
27936	897	1411	143188	3687	0	149183
27937	727	141073	3108	1902	0	146810
27938	139767	3146	1365	1943	0	146221
27939	3415	1157	914	140791	0	146277
27940	1740	847	660	142170	0	145417
27941	1252	784	655	140778	0	143469
27942	696	138668	652	4316	0	144332
27943	138634	3019	536	2546	0	144735
27944	3207	136205	591	1547	0	141550
27945	1358	140728	416	1392	0	143894
27946	140125	3527	392	1663	0	145707
27947	140993	1511	425	1701	0	144630
27948	3917	1196	135696	1126	0	141935
27949	133239	906	2660	1303	0	138108
27950	134117	885	978	1036	0	137016
27951	4413	915	621	130889	0	136838
27952	2203	877	129233	3208	0	135521
27953	1931	786	2733	129452	0	134902
27954	131667	597	1075	3948	0	137287
27955	3851	651	131840	1585	0	137927
27956	2223	527	3216	140798	0	146764
27957	2125	582	1171	151484	0	155362
27958	1651	560	903	165959	0	169073
27959	163284	505	739	7499	0	172027
27960	5622	165607	759	2918	0	174906
27961	167504	5314	601	2391	0	175810
27962	6456	1690	165953	1582	0	175681
27963	2658	1073	5381	163128	0	172240
27964	1524	167632	1675	6317	0	177148
27965	169680	5472	1018	3164	0	179334
27966	6507	1860	757	170219	0	179343
27967	2383	1449	166087	6541	0	176460
27968	2064	1016	5331	165435	0	173846
27969	160677	848	1777	7335	0	170637
27970	5656	159289	1265	3119	0	169329
27971	2674	6104	789	149491	0	159058
27972	1628	158070	744	5905	0	166347
27973	157911	5729	727	2953	0	167320
27974	157985	1992	736	2544	0	163257
27975	6863	153828	767	1778	0	163236
27976	154307	5452	732	1760	0	162251
27977	6904	2008	628	146527	0	156067
27978	2497	150908	642	5478	0	159525
27979	151209	5648	530	2467	0	159854
27980	155801	2082	492	1870	0	160245
27981	7371	144696	627	1382	0	154076
27982	3158	150433	519	1290	0	155400
27983	147711	6205	487	1370	0	155773
27984	6798	2560	419	146250	0	156027
27985	148250	1637	482	5914	0	156283
27986	7090	1348	369	147407	0	156214
27987	3006	1227	143587	6042	0	153862
27988	2647	1182	4705	147174	0	155708
27989	145519	1095	1281	6679	0	154574
27990	6414	1182	144267	2389	0	154252
27991	3114	854	5051	146010	0	155029
27992	2379	841	1482	152091	0	156793
27993	1704	885	145443	7058	0	155090
27994	142611	691	5320	3277	0	151899
27995	6445	769	1750	145750	0	154714
27996	2367	790	137253	6233	0	146643
27997	130018	725	5319	2895	0	138957
27998	5449	134633	1917	2287	0	144286
27999	2164	135261	1434	1963	0	140822
28000	1702	138615	1077	1791	0	143185
28001	1450	5833	130698	1578	0	139559
28002	1912	3158	4841	125408	0	135319
28003	1216	1252	125205	5437	0	133110
28004	1225	3156	4312	111400	0	120093
28005	717	107093	1473	4459	0	113742
28006	605	109835	755	1567	0	112762
28007	1129	4388	659	107340	0	113516
28008	106476	1441	579	4356	0	112852
28009	3881	891	383	108501	0	113656
28010	1400	731	413	109366	0	111910
28011	859	106321	429	4640	0	112249
28012	105814	3476	356	2114	0	111760
28013	3714	106807	388	1384	0	112293
28014	1653	3856	329	107977	0	113815
28015	1243	1563	385	108806	0	111997
28016	963	105660	438	4973	0	112034
28017	1105	3747	391	108655	0	113898
28018	106900	1506	385	5311	0	114102
28019	4641	1660	306	107836	0	114443
28020	2352	1471	394	108741	0	112958
28021	1949	105323	663	4831	0	112766
28022	1677	3938	848	108332	0	114795
28023	103365	1704	707	5142	0	110918
28024	107283	1557	515	2644	0	111999
28025	109400	1378	450	2156	0	113384
28026	5684	1252	541	107144	0	114621
28027	2643	1086	103813	5196	0	112738
28028	2149	1103	104737	2527	0	110516
28029	2073	1225	4138	106862	0	114298
28030	107293	1509	1325	5034	0	115161
28031	4834	1480	745	108281	0	115340
28032	109457	1469	588	5250	0	116764
28033	5728	1288	491	110006	0	117513
28034	3238	1213	475	113114	0	118040
28035	111199	1323	449	5465	0	118436
28036	5417	1351	106395	2440	0	115603
28037	108835	1293	3583	2144	0	115855
28038	5461	1348	107280	1742	0	115831
28039	3109	1069	3823	107677	0	115678
28040	109468	1070	1308	4805	0	116651
28041	5265	1294	109433	2046	0	118038
28042	2624	1401	110322	1635	0	115982
28043	109679	1115	4606	1733	0	117133
28044	5293	976	109835	1853	0	117957
28045	2679	108349	4352	1951	0	117331
28046	2015	3782	1833	113303	0	120933
28047	117781	1261	1596	5714	0	126352
28048	4818	910	117840	2833	0	126401
28049	119446	622	4543	2521	0	127132
28050	124550	576	2140	2207	0	129473
28051	124596	635	1664	2386	0	129281
28052	124837	683	1387	2294	0	129201
28053	6025	1678	1441	118376	0	127520
28054	2783	117911	1272	5048	0	127014
28055	116062	3694	1342	2915	0	124013
28056	4503	1258	106454	1862	0	114077
28057	1493	89455	2280	1098	0	94326
28058	80194	1466	1253	777	0	83690
28059	1500	74451	562	449	0	76962
28060	705	76980	316	412	0	78413
28061	2119	1482	1086	74645	0	79332
28062	688	475	428	76422	0	78013
28063	463	279	240	76504	0	77486
28064	76985	193	206	1687	0	79071
28065	79663	134	203	857	0	80857
28066	1839	143	221	81548	0	83751
28067	930	152	235	86421	0	87738
28068	604	179	88212	2018	0	91013
28069	87651	149	1769	1002	0	90571
28070	91918	166	599	672	0	93355
28071	2511	159	383	90751	0	93804
28072	1179	147	242	92396	0	93964
28073	717	150	90485	2423	0	93775
28074	790	142	1849	90752	0	93533
28075	558	132	93040	2264	0	95994
28076	553	92093	2059	1037	0	95742
28077	519	1662	94115	683	0	96979
28078	640	780	2107	91454	0	94981
28079	407	375	95385	2009	0	98176
28080	447	326	91956	785	0	93514
28081	94202	286	2493	690	0	97671
28082	2193	296	975	99455	0	102919
28083	849	217	100098	2138	0	103302
28084	95179	190	2219	1026	0	98614
28085	2303	220	100651	585	0	103759
28086	961	250	106541	528	0	108280
28087	652	107776	2634	662	0	111724
28088	716	1862	1053	107809	0	111440
28089	519	559	107837	2086	0	111001
28090	559	400	104740	803	0	106502
28091	692	252	2489	105815	0	109248
28092	645	185	1063	106092	0	107985
28093	423	106536	734	2545	0	110238
28094	645	1787	538	108844	0	111814
28095	110087	552	501	2717	0	113857
28096	110756	364	481	1384	0	112985
28097	113360	256	473	1096	0	115185
28098	2978	270	505	110282	0	114035
28099	1216	110525	559	2353	0	114653
28100	111635	1897	526	1279	0	115337
28101	2271	110958	548	828	0	114605
28102	965	109254	519	762	0	111500
28103	646	111573	540	736	0	113495
28104	112101	2348	643	800	0	115892
28105	2314	859	584	111590	0	115347
28106	1032	572	553	112017	0	114174
28107	715	111701	525	2435	0	115376
28108	111151	1991	525	1315	0	114982
28109	2225	782	109844	766	0	113617
28110	1044	502	2202	110937	0	114685
28111	111159	363	1012	2399	0	114933
28112	2164	113636	779	1017	0	117596
28113	118587	2006	555	1240	0	122388
28114	2499	835	566	119961	0	123861
28115	1012	121373	558	2244	0	125187
28116	848	2034	119710	1001	0	123593
28117	120728	799	2065	1024	0	124616
28118	2402	612	817	123870	0	127701
28119	125261	469	593	2625	0	128948
28120	2576	548	470	124520	0	128114
28121	1141	122554	512	2546	0	126753
28122	966	2002	125608	1120	0	129696
28123	794	910	125232	943	0	127879
28124	933	1438	2290	125690	0	130351
28125	127354	491	1246	2419	0	131510
28126	128033	373	666	1185	0	130257
28127	2570	333	471	126632	0	130006
28128	1257	307	453	127696	0	129713
28129	128826	308	391	2768	0	132293
28130	2229	338	464	129666	0	132697
28131	129364	369	418	2733	0	132884
28132	2226	128215	465	1214	0	132120
28133	128810	1879	452	1197	0	132338
28134	2448	811	130840	770	0	134869
28135	1300	575	2083	131604	0	135562
28136	1048	437	944	134987	0	137416
28137	919	420	710	135473	0	137522
28138	816	130026	633	3010	0	134485
28139	947	119719	642	1672	0	122980
28140	698	2185	524	133097	0	136504
28141	537	880	130391	2517	0	134325
28142	661	665	1999	130075	0	133400
28143	658	486	929	132976	0	135049
28144	518	129902	755	2679	0	133854
28145	129347	1843	679	1445	0	133314
28146	1935	125332	665	982	0	128914
28147	890	127353	693	797	0	129733
28148	832	2155	622	127450	0	131059
28149	872	863	583	128430	0	130748
28150	872	571	427	127332	0	129202
28151	784	417	456	128569	0	130226
28152	126196	411	490	2943	0	130040
28153	1847	125484	601	1312	0	129244
28154	127842	1817	543	1254	0	131456
28155	131108	732	529	1181	0	133550
28156	2397	586	411	130099	0	133493
28157	1172	476	351	131939	0	133938
28158	130869	395	382	2839	0	134485
28159	131639	375	332	1686	0	134032
28160	2573	445	200	129667	0	132885
28161	1322	565	151	130540	0	132578
28162	999	504	128540	2488	0	132531
28163	866	124809	1547	1277	0	128499
28164	802	130638	502	982	0	132924
28165	127629	1577	488	1011	0	130705
28166	1678	670	128008	655	0	131011
28167	751	521	118760	536	0	120568
28168	114837	417	1350	633	0	117237
28169	119701	167	570	560	0	120998
28170	1053	125371	287	302	0	127013
28171	444	129816	168	343	0	130771
28172	521	894	119	132723	0	134257
28173	136508	374	98	1403	0	138383
28174	136997	253	76	873	0	138199
28175	137587	187	71	795	0	138640
28176	1211	250	77	136372	0	137910
28177	605	234	110	137651	0	138600
28178	416	246	134493	1027	0	136182
28179	469	266	124755	612	0	126102
28180	304	221	133182	423	0	134130
28181	488	1688	913	131288	0	134377
28182	130486	98	384	1025	0	131993
28183	639	159	132877	257	0	133932
28184	410	106	518	132400	0	133434
28185	201	134511	235	673	0	135620
28186	230	533	104	134115	0	134982
28187	272	176	72	134333	0	134853
28188	163	184	138420	966	0	139733
28189	337	94	888	136919	0	138238
28190	146533	82	267	1540	0	148422
28191	1522	178	150387	406	0	152493
28192	776	116	1461	150864	0	153217
28193	389	136	155034	1554	0	157113
28194	256	155153	1811	653	0	157873
28195	304	1698	157405	417	0	159824
28196	646	704	1996	148415	0	151761
28197	357	365	759	158968	0	160449
28198	202	337	162760	2282	0	165581
28199	453	198	1914	159055	0	161620
28200	499	193	747	158143	0	159582
28201	175	159512	494	2664	0	162845
28202	225	1772	162307	1108	0	165412
28203	593	584	1976	161227	0	164380
28204	420	364	776	166201	0	167761
28205	178	165305	536	2699	0	168718
28206	331	1947	379	169490	0	172147
28207	169039	698	325	3001	0	173063
28208	2215	428	324	170204	0	173171
28209	760	374	170355	2729	0	174218
28210	166787	217	2218	1837	0	171059
28211	180331	204	863	1422	0	182820
28212	3373	290	180122	722	0	184507
28213	174981	172	2748	1278	0	179179
28214	3124	180925	1238	720	0	186007
28215	1632	2644	695	186191	0	191162
28216	1193	1122	538	203580	0	206433
28217	1117	601	436	201283	0	203437
28218	853	428	385	207690	0	209356
28219	794	334	327	208515	0	209970
28220	204894	256	302	6596	0	212048
28221	3945	344	200814	2863	0	207966
28222	194936	194	3740	2346	0	201216
28223	4425	290	198776	1733	0	205224
28224	2444	234	4196	198618	0	205492
28225	200548	277	1839	5098	0	207762
28226	4746	270	1150	199345	0	205511
28227	2174	200072	990	4835	0	208071
28228	207204	3566	913	3030	0	214713
28229	4987	1508	788	214852	0	222135
28230	2213	1010	201331	5280	0	209834
28231	201118	574	3414	3350	0	208456
28232	4672	217257	1558	2016	0	225503
28233	2334	3973	221905	1629	0	229841
28234	2061	1808	4390	219222	0	227481
28235	2064	994	2084	212482	0	217624
28236	1175	217845	1338	6205	0	226563
28237	1128	4086	219275	3080	0	227569
28238	1569	1843	4306	218124	0	225842
28239	951	1246	226309	5647	0	234153
28240	1351	827	4899	223934	0	231011
28241	1230	688	2296	227627	0	231841
28242	994	707	225225	7106	0	234032
28243	1347	625	4787	225292	0	232051
28244	3003	906	3343	187131	0	194383
28245	1499	530	1714	238188	0	241931
28246	1416	482	1593	239196	0	242687
28247	229840	473	1373	9272	0	240958
28248	5282	589	225767	4877	0	236515
28249	234370	538	5338	4103	0	244349
28250	6532	584	2742	245676	0	255534
28251	3543	612	2069	251647	0	257871
28252	2412	649	1644	251005	0	255710
28253	1707	243664	1673	9777	0	256821
28254	248954	5547	1409	5656	0	261566
28255	6155	2353	1431	270899	0	280838
28256	2847	267888	1530	7805	0	280070
28257	2075	5228	1295	276346	0	284944
28258	275475	2291	1381	9050	0	288197
28259	276059	1599	1393	5798	0	284849
28260	275806	1369	1470	4508	0	283153
28261	7787	271633	1535	3799	0	284754
28262	3779	5501	273618	3522	0	286420
28263	272488	2503	5658	4167	0	284816
28264	281602	1541	2702	4215	0	290060
28265	7879	279181	2025	3420	0	292505
28266	281484	5571	1569	3868	0	292492
28267	278463	2572	1433	3896	0	286364
28268	284181	1639	1334	3882	0	291036
28269	9015	286353	1551	3510	0	300429
28270	5409	5659	1298	288683	0	301049
28271	290378	2640	1232	8470	0	302720
28272	296922	1850	1183	5124	0	305079
28273	291770	1483	1074	4381	0	298708
28274	297479	1369	918	3927	0	303693
28275	10423	1422	987	290297	0	303129
28276	5797	1544	286750	7900	0	301991
28277	4947	1185	5757	286716	0	298605
28278	3927	288270	2630	8255	0	303082
28279	4018	6019	1653	300988	0	312678
28280	3542	2834	299347	8720	0	314443
28281	300467	1826	6400	5359	0	314052
28282	9100	1545	2926	308547	0	322118
28283	306831	1588	1930	8957	0	319306
28284	309615	1587	1572	5637	0	318411
28285	11213	1426	1340	308478	0	322457
28286	6403	1330	306633	8577	0	322943
28287	5667	1525	286035	4732	0	297959
28288	286612	1507	7646	4050	0	299815
28289	8639	292447	3580	3265	0	307931
28290	4878	288253	2060	2698	0	297889
28291	3963	288855	1737	2764	0	297319
28292	3632	298619	1696	2744	0	306691
28293	290732	7378	2512	3237	0	303859
28294	293469	3280	1493	2876	0	301118
28295	292086	2234	1055	2637	0	298012
28296	293247	1951	985	2707	0	298890
28297	9276	1963	925	284364	0	296528
28298	5056	280459	1064	6083	0	292662
28299	282880	5313	1083	3853	0	293129
28300	7910	2618	279812	2447	0	292787
28301	5083	279024	4901	2388	0	291396
28302	4141	5167	280799	2344	0	292451
28303	276816	2601	5594	2753	0	287764
28304	285558	1856	2625	2659	0	292698
28305	286201	1789	1785	2476	0	292251
28306	9064	1770	1442	281001	0	293277
28307	5142	1664	279603	5567	0	291976
28308	4023	277727	4933	3152	0	289835
28309	273872	5011	2493	2855	0	284231
28310	7570	270353	1648	2206	0	281777
28311	4438	262644	1056	1967	0	270105
28312	3707	262347	1024	1907	0	268985
28313	3360	264314	1169	1915	0	270758
28314	3169	5622	251793	1552	0	262136
28315	2814	254098	4449	1737	0	263098
28316	237674	4025	1880	1734	0	245313
28317	4467	1785	867	237544	0	244663
28318	2705	1365	758	240165	0	244993
28319	237933	1086	729	4488	0	244236
28320	4201	233516	863	2113	0	240693
28321	2632	3468	237888	1259	0	245247
28322	2664	1668	3058	235954	0	243344
28323	2541	1224	1358	242155	0	247278
28324	2409	1207	939	243334	0	247889
28325	1968	1279	239554	4117	0	246918
28326	1984	1305	235388	1938	0	240615
28327	2373	1276	3723	236396	0	243768
28328	1949	1248	237099	3231	0	243527
28329	2001	1355	219874	1536	0	224766
28330	205429	1223	3691	1846	0	212189
28331	3716	221114	1782	1214	0	227826
28332	1979	215514	1041	1065	0	219599
28333	2032	219719	887	937	0	223575
28334	2312	3989	904	215034	0	222239
28335	1652	223603	838	2678	0	228771
28336	226942	3128	922	2097	0	233089
28337	3625	1649	226999	1236	0	233509
28338	229627	1202	3156	1606	0	235591
28339	4272	1087	1493	233196	0	240048
28340	2405	1008	1121	236132	0	240666
28341	1595	242802	1017	4358	0	249772
28342	243268	3864	1013	2661	0	250806
28343	244017	1711	1629	1964	0	249321
28344	5783	256676	942	1274	0	264675
28345	3088	5449	771	251502	0	260810
28346	1901	1989	255180	4697	0	263767
28347	1554	1443	252790	1978	0	257765
28348	1277	260018	6083	1392	0	268770
28349	256442	5739	2566	2077	0	266824
28350	5467	2053	255999	565	0	264084
28351	3256	1317	4970	250714	0	260257
28352	256910	880	2102	5517	0	265409
28353	261152	765	1186	2709	0	265812
28354	6928	299884	1182	1311	0	309305
28355	2848	318841	1019	963	0	323671
28356	319685	9377	841	1395	0	331298
28357	8502	3902	317193	617	0	330214
28358	316843	2234	7777	1339	0	328193
28359	326075	1384	2753	1253	0	331465
28360	11904	1327	1724	317349	0	332304
28361	4713	1260	323682	7762	0	337417
28362	2976	1234	319592	2680	0	326482
28363	312177	908	10489	2434	0	326008
28364	9539	1095	323819	940	0	335393
28365	310921	904	9690	1511	0	323026
28366	322603	800	3556	1590	0	328549
28367	11026	315822	2385	1163	0	330396
28368	5141	8213	316024	751	0	330129
28369	3108	311319	8753	824	0	324004
28370	308372	9118	3711	1435	0	322636
28371	9460	3574	305717	659	0	319410
28372	5493	2734	8858	292820	0	309905
28373	3388	1498	304850	7776	0	317512
28374	2963	1197	305075	2829	0	312064
28375	2689	1153	304991	1603	0	310436
28376	2631	1162	304371	1089	0	309253
28377	2168	292680	12498	1076	0	308422
28378	2577	8108	294109	930	0	305724
28379	2085	289112	10327	1049	0	302573
28380	2227	8928	285982	954	0	298091
28381	280933	3356	10276	1251	0	295816
28382	9867	2297	4617	262906	0	279687
28383	4254	285306	3508	6119	0	299187
28384	282378	8089	2923	3124	0	296514
28385	286458	3685	2710	2345	0	295198
28386	270622	2603	2809	2140	0	278174
28387	284083	1908	2958	1612	0	290561
28388	11906	279534	2875	1198	0	295513
28389	266507	8435	2797	2227	0	279966
28390	283526	3874	2818	1868	0	292086
28391	11374	272065	2962	1338	0	287739
28392	5935	9221	261189	1055	0	277400
28393	5118	4132	9236	258343	0	276829
28394	3499	269415	5174	7343	0	285431
28395	3349	9150	271788	3128	0	287415
28396	3504	4464	273927	2035	0	283930
28397	3513	266195	12262	1522	0	283492
28398	3552	272557	6411	1379	0	283899
28399	3738	282472	4599	1413	0	292222
28400	4013	277705	3641	1416	0	286775
28401	277512	13442	3369	1840	0	296163
28402	284865	6750	3131	1748	0	296494
28403	14341	4412	280893	1346	0	300992
28404	7856	3855	285277	1285	0	298273
28405	6513	3350	13164	277247	0	300274
28406	5744	3423	6819	285523	0	301509
28407	5384	3306	4907	290183	0	303780
28408	282545	3177	4618	12779	0	303119
28409	12309	278682	4419	5580	0	300990
28410	7099	292154	4440	3258	0	306951
28411	5775	302193	4474	2427	0	314869
28412	292137	15279	4344	2318	0	314078
28413	300985	7882	4400	2267	0	315534
28414	16715	5682	4445	290929	0	317771
28415	302282	4653	5024	10532	0	322491
28416	309648	4499	4548	4718	0	323413
28417	18024	4613	4680	299166	0	326483
28418	303703	4420	4601	12048	0	324772
28419	16189	296051	5672	5252	0	323164
28420	9722	12328	5964	296443	0	324457
28421	8411	6375	293520	11079	0	319385
28422	6905	292957	14843	5287	0	319992
28423	7307	13492	297919	4062	0	322780
28424	7897	7270	15747	278041	0	308955
28425	6944	297825	9322	10553	0	324644
28426	8169	12982	8047	294871	0	324069
28427	7340	7525	7062	303701	0	325628
28428	7682	5726	296133	14663	0	324204
28429	6653	5342	312727	6888	0	331610
28430	6875	4748	17751	306592	0	335966
28431	7307	4715	10938	297234	0	320194
28432	6294	309083	8487	14459	0	338323
28433	297919	13742	7056	7231	0	325948
28434	15195	302070	7014	4849	0	329128
28435	8631	313050	5997	4007	0	331685
28436	6576	17021	295980	3664	0	323241
28437	4861	297454	14391	3944	0	320650
28438	5885	15212	9621	273033	0	303751
28439	4928	291502	7458	11405	0	315293
28440	5204	14454	5927	277995	0	303580
28441	4084	283997	6179	12200	0	306460
28442	279790	14067	5225	6636	0	305718
28443	12862	283424	5758	4365	0	306409
28444	6827	13414	4057	250311	0	274609
28445	5304	266721	3734	9278	0	285037
28446	263712	12633	4011	4483	0	284839
28447	264286	7272	2643	3997	0	278198
28448	13868	258988	3056	2877	0	278789
28449	254086	11209	2332	2722	0	270349
28450	13141	9189	2832	241412	0	266574
28451	6534	5320	243140	9418	0	264412
28452	5824	4505	245775	4640	0	260744
28453	4521	245877	10821	4019	0	265238
28454	187728	6310	4183	1967	0	200188
28455	187151	2552	1580	1654	0	192937
28456	6556	1856	181464	1405	0	191281
28457	2733	1688	178561	1283	0	184265
28458	175262	1567	5753	1434	0	184016
28459	181910	1434	2271	1405	0	187020
28460	6105	1575	174248	1203	0	183131
28461	165984	1557	4704	1292	0	173537
28462	5254	166286	2077	1185	0	174802
28463	2081	173931	1348	1069	0	178429
28464	2201	6111	1395	166713	0	176420
28465	1720	2703	1017	170604	0	176044
28466	169437	1833	1142	5760	0	178172
28467	169820	1503	1094	2535	0	174952
28468	170444	1451	1056	1823	0	174774
28469	6231	1433	965	166612	0	175241
28470	2864	1590	810	167793	0	173057
28471	1971	157989	946	5789	0	166695
28472	1611	163085	969	2492	0	168157
28473	1506	168817	882	1705	0	172910
28474	1753	6243	882	159461	0	168339
28475	1601	164469	807	4478	0	171355
28476	1661	5213	159439	2017	0	168330
28477	153954	2550	4087	1743	0	162334
28478	5162	2087	159933	1262	0	168444
28479	2372	1876	159061	1199	0	164508
28480	154644	1718	5087	1444	0	162893
28481	4894	159260	2001	1259	0	167414
28482	160713	5069	1269	1443	0	168494
28483	162608	2443	1028	1431	0	167510
28484	6067	1941	155168	1211	0	164387
28485	2969	1670	160243	1214	0	166096
28486	2146	161680	5306	1266	0	170398
28487	1987	5088	163327	1166	0	171568
28488	2163	2585	5039	163087	0	172874
28489	2608	2080	2431	142545	0	149664
28490	1645	161068	1681	5422	0	169816
28491	1670	169239	1473	2218	0	174600
28492	165888	6386	1199	1692	0	175165
28493	172335	3165	1145	1517	0	178162
28494	6395	2217	1264	169653	0	179529
28495	3059	1887	1353	173863	0	180162
28496	168830	1582	1433	5840	0	177685
28497	171269	1684	1318	2670	0	176941
28498	6035	170749	1267	1891	0	179942
28499	163442	4505	1058	1312	0	170317
28500	5226	156593	893	1097	0	163809
28501	2391	164000	885	1025	0	168301
28502	162366	5199	1164	1180	0	169909
28503	163185	2474	981	1104	0	167744
28504	5779	1886	720	159776	0	168161
28505	160272	1419	759	3928	0	166378
28506	5297	1308	156524	1463	0	164592
28507	2607	158422	3505	1277	0	165811
28508	158083	3904	1530	1450	0	164967
28509	4576	1683	157777	1164	0	165200
28510	2175	2529	3396	145191	0	153291
28511	1672	146194	1481	2794	0	152141
28512	1756	151452	1012	1108	0	155328
28513	151175	3689	1135	1050	0	157049
28514	3899	1584	146738	725	0	152946
28515	142529	913	2864	587	0	146893
28516	3941	843	1380	143613	0	149777
28517	1933	670	142726	2413	0	147742
28518	141573	746	2799	1415	0	146533
28519	3165	146364	1343	747	0	151619
28520	1474	154037	961	596	0	157068
28521	155633	3235	1130	904	0	160902
28522	156065	1472	606	950	0	159093
28523	158784	948	454	1102	0	161288
28524	3973	945	533	155412	0	160863
28525	2350	871	579	156638	0	160438
28526	1656	557	153830	2729	0	158772
28527	1385	572	148100	1413	0	151470
28528	1120	152544	2588	1142	0	157394
28529	1033	2410	1074	142940	0	147457
28530	141803	686	507	1609	0	144605
28531	1601	140596	257	675	0	143129
28532	803	1685	223	142695	0	145406
28533	143006	621	281	1744	0	145652
28534	1710	141122	301	727	0	143860
28535	803	148205	284	519	0	149811
28536	877	1785	143296	355	0	146313
28537	142449	795	1556	638	0	145438
28538	147280	563	598	586	0	149027
28539	1836	435	142620	380	0	145271
28540	136772	303	1247	462	0	138784
28541	1511	341	142771	185	0	144808
28542	593	140524	1200	218	0	142535
28543	903	1588	688	140076	0	143255
28544	139912	454	380	1284	0	142030
28545	1212	137052	260	422	0	138946
28546	532	138469	226	263	0	139490
28547	136400	1059	203	372	0	138034
28548	1097	443	142267	141	0	143948
28549	138809	314	921	588	0	140632
28550	1001	145262	405	212	0	146880
28551	503	895	140471	100	0	141969
28552	139596	327	825	299	0	141047
28553	144752	181	282	273	0	145488
28554	1147	169	145	143520	0	144981
28555	564	147	118	145336	0	146165
28556	277	143784	164	957	0	145182
28557	307	925	144620	297	0	146149
28558	544	312	874	144167	0	145897
28559	291	238	152141	1030	0	153700
28560	310	216	149870	354	0	150750
28561	458	178	1398	158024	0	160058
28562	287	177	161972	1439	0	163875
28563	344	236	158175	508	0	159263
28564	578	224	1954	157575	0	160331
28565	238	185	162779	1584	0	164786
28566	152659	171	1881	868	0	155579
28567	1592	157321	759	598	0	160270
28568	625	1557	163400	225	0	165807
28569	580	621	171035	231	0	172467
28570	741	442	2080	165858	0	169121
28571	179155	186	855	1942	0	182138
28572	180055	151	501	853	0	181560
28573	179256	168	361	675	0	180460
28574	180409	152	373	541	0	181475
28575	2489	139	324	176604	0	179556
28576	999	210	178944	1666	0	181819
28577	179395	149	1721	1014	0	182279
28578	183659	146	651	817	0	185273
28579	185424	148	484	605	0	186661
28580	2484	230	178909	252	0	181875
28581	174056	167	1721	507	0	176451
28582	2293	259	724	187050	0	190326
28583	888	188633	632	1768	0	191921
28584	977	2096	409	186567	0	190049
28585	483	188770	508	1893	0	191654
28586	189899	1957	428	1084	0	193368
28587	2272	638	191323	520	0	194753
28588	1088	613	2200	186317	0	190218
28589	556	188210	969	2072	0	191807
28590	437	194924	736	812	0	196909
28591	195027	2375	641	893	0	198936
28592	194623	856	480	685	0	196644
28593	2754	631	186401	326	0	190112
28594	187782	326	2359	617	0	191084
28595	2970	277	858	189705	0	193810
28596	1192	299	195117	2258	0	198866
28597	1154	352	190811	759	0	193076
28598	1248	247	2696	196173	0	200364
28599	207870	198	1071	3191	0	212330
28600	3314	182	695	207194	0	211385
28601	1613	164	574	207732	0	210083
28602	1260	198	596	207510	0	209564
28603	862	207399	542	3753	0	212556
28604	1120	2523	453	210995	0	215091
28605	206279	854	525	3857	0	211515
28606	3058	206577	582	1384	0	211601
28607	1535	2879	456	210218	0	215088
28608	208612	1050	438	3875	0	213975
28609	3153	203202	573	1514	0	208442
28610	1241	208211	581	1073	0	211106
28611	1390	3801	469	208971	0	214631
28612	205026	1418	497	3901	0	210842
28613	3573	849	202721	1484	0	208627
28614	1637	806	198274	1028	0	201745
28615	202423	645	3947	1324	0	208339
28616	212476	551	1576	1226	0	215829
28617	4690	213539	1034	820	0	220083
28618	2442	3504	771	209234	0	215951
28619	1507	1336	209117	3585	0	215545
28620	1256	917	201733	1599	0	205505
28621	1085	703	217955	1088	0	220831
28622	871	214203	5470	1054	0	221598
28623	845	219750	2286	954	0	223835
28624	218333	4657	1303	1457	0	225750
28625	4633	1829	218623	875	0	225960
28626	213527	1022	4358	1394	0	220301
28627	220572	707	1822	1453	0	224554
28628	5714	830	220939	863	0	228346
28629	2452	226162	4511	1016	0	234141
28630	2721	4661	1762	220128	0	229272
28631	1418	1873	232387	4615	0	240293
28632	1493	1469	220534	1891	0	225387
28633	218454	1091	5507	1974	0	227026
28634	4843	227270	2435	1042	0	235590
28635	2493	4845	1438	221513	0	230289
28636	1883	2011	980	222737	0	227611
28637	1249	221086	1150	5652	0	229137
28638	1244	226238	1216	2335	0	231033
28639	1205	230739	1228	1517	0	234689
28640	1748	6195	962	235396	0	244301
28641	242915	2480	930	5917	0	252242
28642	6511	1637	843	246495	0	255486
28643	2369	1376	244828	6693	0	255266
28644	1610	1294	244611	2568	0	250083
28645	1781	1167	7270	247930	0	258148
28646	1360	1161	249981	6309	0	258811
28647	1247	248196	6820	2559	0	258822
28648	1863	6252	2534	256636	0	267285
28649	268114	2334	1770	7769	0	279987
28650	270603	1513	1487	3397	0	277000
28651	8869	272130	1397	2101	0	284497
28652	271989	7608	1292	2437	0	283326
28653	280560	2849	1192	2148	0	286749
28654	282209	1835	1276	2075	0	287395
28655	10565	1930	247461	1794	0	261750
28656	265186	1315	6684	2131	0	275316
28657	8939	266449	2631	1655	0	279674
28658	3755	7246	267094	1243	0	279338
28659	2805	2795	266691	1225	0	273516
28660	2026	263397	8874	1503	0	275800
28661	261632	7550	3660	1654	0	274496
28662	8630	2714	2045	252358	0	265747
28663	3102	254098	1498	6738	0	265436
28664	258999	7233	1256	3011	0	270499
28665	8541	2791	1202	259663	0	272197
28666	262394	1787	1229	8246	0	273656
28667	9080	1420	1249	264217	0	275966
28668	3754	1384	258351	8210	0	271699
28669	2509	1548	253647	3124	0	260828
28670	2172	1611	256067	2083	0	261933
28671	2830	1546	9473	246330	0	260179
28672	2574	1531	3556	258843	0	266504
28673	2191	1601	252920	9297	0	266009
28674	2220	251111	8085	3996	0	265412
28675	256296	7599	3290	2716	0	269901
28676	257849	2962	2458	2229	0	265498
28677	10192	256424	2203	1830	0	270649
28678	5218	8653	2017	260313	0	276201
28679	3319	3215	265204	8388	0	280126
28680	261589	2106	9090	3781	0	276566
28681	9792	1760	266140	2436	0	280128
28682	4475	1701	251001	1707	0	258884
28683	3292	1798	260262	1533	0	266885
28684	250678	1726	11242	1928	0	265574
28685	9609	1679	255396	1531	0	268215
28686	4241	244111	9659	1739	0	259750
28687	3298	256465	4406	1623	0	265792
28688	3639	9488	3254	244393	0	260774
28689	3305	3720	2659	251435	0	261119
28690	2644	2375	246539	9519	0	261077
28691	240037	1822	8924	4279	0	255062
28692	253907	1815	4028	2818	0	262568
28693	10984	1708	3197	248400	0	264289
28694	249036	1473	2897	8660	0	262066
28695	9477	247199	2791	3806	0	263273
28696	244537	8103	2404	2963	0	258007
28697	9594	237236	2432	2680	0	251942
28698	4130	244136	2209	2421	0	252896
28699	234210	9015	2390	2416	0	248031
28700	234685	3595	2239	2398	0	242917
28701	242854	2395	2150	2158	0	249557
28702	246241	1942	2165	2135	0	252483
28703	11268	1980	227821	1960	0	243029
28704	231101	1710	8147	1987	0	242945
28705	10311	1939	3714	224033	0	239997
28706	4725	228565	2889	7255	0	243434
28707	230045	7400	2426	3283	0	243154
28708	9189	229747	2348	2403	0	243687
28709	231714	8075	2217	2067	0	244073
28710	10010	3230	2117	228152	0	243509
28711	5198	2555	2061	234095	0	243909
28712	4020	2311	219182	9013	0	234526
28713	3899	2170	226622	3746	0	236437
28714	3438	227406	8856	2923	0	242623
28715	221427	7420	3938	2579	0	235364
28716	9071	218540	2853	1942	0	232406
28717	4842	215155	2219	1968	0	224184
28718	4145	224132	2114	1865	0	232256
28719	4169	8945	214579	1604	0	229297
28720	3574	217866	7395	1739	0	230574
28721	202451	8084	3457	1911	0	215903
28722	205265	3268	2455	1617	0	212605
28723	9408	2615	1946	196046	0	210015
28724	4525	193292	2003	6548	0	206368
28725	3594	200626	2009	2819	0	209048
28726	3613	8135	1847	196727	0	210322
28727	3374	3779	196648	6489	0	210290
28728	3205	191662	6737	2772	0	204376
28729	3744	7684	2798	185592	0	199818
28730	180501	3394	2059	6872	0	192826
28731	183584	2596	1734	3106	0	191020
28732	7849	183732	1825	2289	0	195695
28733	185183	6816	1760	2051	0	195810
28734	188117	3021	1820	1932	0	194890
28735	8935	2652	1825	178775	0	192187
28736	4405	2232	176269	6201	0	189107
28737	3189	177157	6348	2841	0	189535
28738	3416	7893	3008	173886	0	188203
28739	2764	3206	173805	5770	0	185545
28740	2512	168392	5542	2603	0	179049
28741	157250	5693	2676	2262	0	167881
28742	159958	2687	1842	1800	0	166287
28743	6756	2378	1383	154883	0	165400
28744	3518	155695	1409	4660	0	165282
28745	2948	5182	154339	2046	0	164515
28746	3026	3428	4647	151477	0	162578
28747	2376	2375	154503	4656	0	163910
28748	1807	141624	4136	2018	0	149585
28749	3043	4269	2307	124464	0	134083
28750	123033	1631	1279	3237	0	129180
28751	3179	122166	843	1429	0	127617
28752	121016	3064	717	1321	0	126118
28753	120010	1587	720	1093	0	123410
28754	3937	120291	631	925	0	125784
28755	2322	3110	669	120108	0	126209
28756	1852	2018	590	120150	0	124610
28757	1399	115754	641	3289	0	121083
28758	1298	120077	659	1652	0	123686
28759	1509	3589	663	112808	0	118569
28760	1311	115978	628	2510	0	120427
28761	115921	3034	565	1306	0	120826
28762	115819	1421	542	1068	0	118850
28763	3519	1332	112833	755	0	118439
28764	1864	1108	109586	723	0	113281
28765	108442	1025	2610	943	0	113020
28766	112095	898	1155	890	0	115038
28767	2847	113648	835	718	0	118048
28768	113023	2627	766	906	0	117322
28769	112876	1324	501	878	0	115579
28770	3099	110040	425	737	0	114301
28771	111848	2606	416	865	0	115735
28772	3217	1630	436	123046	0	128329
28773	1790	1492	515	127536	0	131333
28774	1212	1028	131560	3625	0	137425
28775	889	126558	2960	1465	0	131872
28776	712	132098	973	965	0	134748
28777	121532	4837	1589	1778	0	129736
28778	121455	1288	654	997	0	124394
28779	117567	693	329	831	0	119420
28780	123855	461	294	624	0	125234
28781	3442	555	115032	440	0	119469
28782	1195	583	120193	327	0	122298
28783	769	120980	2788	418	0	124955
28784	1058	2807	957	119559	0	124381
28785	994	1002	490	118862	0	121348
28786	723	122203	354	2625	0	125905
28787	1042	2875	310	120267	0	124494
28788	120018	888	336	2936	0	124178
28789	2940	120267	395	890	0	124492
28790	1173	2750	121873	558	0	126354
28791	796	124091	2530	589	0	128006
28792	123923	2932	849	705	0	128409
28793	2843	1070	122368	528	0	126809
28794	121027	788	2733	735	0	125283
28795	124828	605	744	677	0	126854
28796	3376	641	121859	430	0	126306
28797	1266	558	120771	386	0	122981
28798	932	563	119651	308	0	121454
28799	113333	556	3180	504	0	117573
28800	2924	469	118953	280	0	122626
28801	1041	116890	2768	297	0	120996
28802	116421	2405	977	415	0	120218
28803	2658	764	116103	206	0	119731
28804	112430	481	2663	378	0	115952
28805	2915	419	114782	181	0	118297
28806	1192	379	119179	189	0	120939
28807	823	120146	3060	254	0	124283
28808	725	2426	122037	175	0	125363
28809	756	810	120477	192	0	122235
28810	768	108521	3318	284	0	112891
28811	118071	2540	1282	347	0	122240
28812	2759	867	119999	158	0	123783
28813	1313	634	2798	111612	0	116357
28814	809	120213	1189	1993	0	124204
28815	121474	2514	977	874	0	125839
28816	120798	893	856	727	0	123274
28817	3064	750	121351	322	0	125487
28818	1211	117185	2868	299	0	121563
28819	826	122386	1333	296	0	124841
28820	1010	3187	878	117768	0	122843
28821	941	112949	798	2218	0	116906
28822	1394	3050	749	108715	0	113908
28823	1145	1108	664	121853	0	124770
28824	880	122012	839	2913	0	126644
28825	1008	2855	779	120736	0	125378
28826	809	120995	746	3335	0	125885
28827	838	3101	119469	1020	0	124428
28828	907	1360	2810	118779	0	123856
28829	857	1159	1140	119608	0	122764
28830	769	118510	857	3140	0	123276
28831	812	123089	765	1248	0	125914
28832	905	3530	697	117493	0	122625
28833	758	120171	835	2751	0	124515
28834	119265	3323	779	1368	0	124735
28835	3144	1377	792	118968	0	124281
28836	1241	120134	856	2811	0	125042
28837	117958	3090	800	1300	0	123148
28838	2964	117944	911	959	0	122778
28839	1340	3305	116840	853	0	122338
28840	1204	1515	3041	116082	0	121842
28841	117438	1222	1379	3182	0	123221
28842	3170	1123	118088	1235	0	123616
28843	1450	1234	3144	114038	0	119866
28844	1236	116355	1340	2778	0	121709
28845	1217	3233	114823	1016	0	120289
28846	1100	117529	3147	891	0	122667
28847	111568	3154	1531	864	0	117117
28848	116224	1402	1431	754	0	119811
28849	3462	115021	1295	617	0	120395
28850	114786	3107	1258	759	0	119910
28851	3254	1405	113137	609	0	118405
28852	1479	1284	3287	110993	0	117043
28853	1281	1078	1620	110494	0	114473
28854	1166	113328	1269	2934	0	118697
28855	118941	3088	1291	1492	0	124812
28856	123319	1429	1113	1153	0	127014
28857	3448	1385	122238	528	0	127599
28858	122180	1045	3137	758	0	127120
28859	125806	979	1566	735	0	129086
28860	126524	946	1227	776	0	129473
28861	3944	995	1023	122347	0	128309
28862	1830	1016	1078	123072	0	126996
28863	1268	123202	1027	2943	0	128440
28864	120553	2979	1013	1389	0	125934
28865	121809	1248	940	1126	0	125123
28866	3433	120885	893	732	0	125943
28867	1648	3460	863	116233	0	122204
28868	1188	117458	719	2508	0	121873
28869	965	123285	713	1107	0	126070
28870	119298	3380	1061	1238	0	124977
28871	3133	1538	116729	917	0	122317
28872	1037	756	101998	475	0	104266
28873	702	102065	1702	472	0	104941
28874	94197	1204	1109	444	0	96954
28875	1179	518	93647	230	0	95574
28876	502	87596	1129	293	0	89520
28877	88352	829	486	308	0	89975
28878	824	333	86898	108	0	88163
28879	407	306	748	85605	0	87066
28880	91537	192	229	1016	0	92974
28881	1055	224	91236	265	0	92780
28882	367	207	94391	204	0	95169
28883	293	210	97500	153	0	98156
28884	222	206	97526	128	0	98082
28885	94567	256	1416	328	0	96567
28886	101700	138	396	270	0	102504
28887	1126	101087	213	216	0	102642
28888	428	1091	136	104071	0	105726
28889	347	281	115	106331	0	107074
28890	171	103167	141	1384	0	104863
28891	285	1346	114	105426	0	107171
28892	147	107104	175	1388	0	108814
28893	119	110196	140	451	0	110906
28894	274	1727	103	108910	0	111014
28895	171	598	110023	1453	0	112245
28896	128	110383	1490	505	0	112506
28897	274	1533	418	111720	0	113945
28898	112353	475	278	1688	0	114794
28899	1574	353	110923	459	0	113309
28900	108749	236	1545	516	0	111046
28901	113310	206	486	384	0	114386
28902	2236	197	308	114075	0	116816
28903	734	240	118158	1848	0	120980
28904	506	238	117579	573	0	118896
28905	303	125088	2492	370	0	128253
28906	593	2404	902	122142	0	126041
28907	296	673	124400	2117	0	127486
28908	267	473	122802	679	0	124221
28909	178	126080	2740	504	0	129502
28910	126767	2251	1045	508	0	130571
28911	129430	761	578	460	0	131229
28912	3014	476	411	133329	0	137230
28913	1145	344	137654	2788	0	141931
28914	714	342	136742	969	0	138767
28915	439	142195	3708	714	0	147056
28916	510	2825	144562	359	0	148256
28917	408	1071	143721	351	0	145551
28918	785	858	4012	135801	0	141456
28919	286	392	145246	2934	0	148858
28920	139720	320	3566	1200	0	144806
28921	3093	306	1485	146496	0	151380
28922	1095	293	151015	3039	0	155442
28923	610	151054	3368	1194	0	156226
28924	706	2853	1465	153053	0	158077
28925	424	1125	155490	3072	0	160111
28926	331	157768	3582	1304	0	162985
28927	587	3296	1562	155428	0	160873
28928	341	161347	1126	3152	0	165966
28929	542	3656	890	162499	0	167587
28930	613	1347	808	163154	0	165922
28931	337	862	161257	4446	0	166902
28932	356	162160	3670	1927	0	168113
28933	543	3492	1563	163668	0	169266
28934	521	1307	1160	165057	0	168045
28935	497	893	932	167332	0	169654
28936	333	709	162251	4847	0	168140
28937	299	160489	3809	2193	0	166790
28938	495	3473	1689	163130	0	168787
28939	340	1426	162072	3972	0	167810
28940	285	160982	3880	1945	0	167092
28941	489	3658	1742	162699	0	168588
28942	363	1622	164230	3892	0	170107
28943	271	163500	3880	1986	0	169637
28944	532	3718	1754	162750	0	168754
28945	519	1582	1219	168523	0	171843
28946	322	1115	169742	4949	0	176128
28947	159525	814	3935	2857	0	167131
28948	3104	169236	1792	1712	0	175844
28949	171193	3754	1274	1646	0	177867
28950	3690	1735	171278	1275	0	177978
28951	171584	1178	4088	1516	0	178366
28952	3966	965	1881	174334	0	181146
28953	1544	936	1329	179776	0	183585
28954	855	917	175120	5071	0	181963
28955	162133	832	4072	2804	0	169841
28956	167047	754	1932	2065	0	171798
28957	4215	164405	1377	1614	0	171611
28958	1644	172552	1245	1394	0	176835
28959	171965	4533	1142	1439	0	179079
28960	3899	2053	170807	1244	0	178003
28961	1645	178626	4114	1283	0	185668
28962	1365	4030	2006	182876	0	190277
28963	1035	1749	1413	188039	0	192236
28964	772	1193	184361	5167	0	191493
28965	178811	969	4340	2809	0	186929
28966	4142	929	188087	1721	0	194879
28967	187599	832	4868	1657	0	194956
28968	4832	918	196744	1204	0	203698
28969	2213	197787	5011	1237	0	206248
28970	201278	4359	2571	1545	0	209753
28971	203529	2011	1715	1496	0	208751
28972	201365	1249	1381	1468	0	205463
28973	203982	1019	1278	1315	0	207594
28974	6257	970	1150	199588	0	207965
28975	2783	997	198603	4636	0	207019
28976	2021	1131	4592	195309	0	203053
28977	1417	197622	2313	4761	0	206113
28978	1512	4118	1636	202372	0	209638
28979	1148	1896	200572	4890	0	208506
28980	1100	1272	198063	2261	0	202696
28981	1489	1349	5342	196163	0	204343
28982	195564	823	2917	4799	0	204103
28983	192409	832	1620	2508	0	197369
28984	194651	791	1288	1840	0	198570
28985	5816	815	193545	1211	0	201387
28986	2900	841	190360	1168	0	195269
28987	1842	190934	5150	1168	0	199094
28988	1367	197233	2458	1219	0	202277
28989	192342	4446	2168	1470	0	200426
28990	195053	1954	1351	1448	0	199806
28991	4716	198547	1209	1083	0	205555
28992	197942	3461	1024	1378	0	203805
28993	198945	1525	972	1328	0	202770
28994	4729	197833	978	1025	0	204565
28995	202194	3469	916	1397	0	207976
28996	201255	1627	1060	1304	0	205246
28997	4765	201814	1041	995	0	208615
28998	204530	3476	1058	1253	0	210317
28999	204660	1581	1177	1247	0	208665
29000	5069	1263	201835	841	0	209008
29001	2864	939	197224	827	0	201854
29002	1818	197653	3981	806	0	204258
29003	1490	202219	1966	778	0	206453
29004	200944	3921	2207	1159	0	208231
29005	195181	1642	1133	950	0	198906
29006	193443	903	815	788	0	195949
29007	4200	192153	866	492	0	197711
29008	2270	2716	662	194550	0	200198
29009	1595	1377	195269	2438	0	200679
29010	1799	2096	2600	188442	0	194937
29011	1344	194358	1331	2619	0	199652
29012	191432	2098	778	1083	0	195391
29013	2589	186431	548	540	0	190108
29014	1627	2315	427	187289	0	191658
29015	195280	899	428	2490	0	199097
29016	194408	617	416	1185	0	196626
29017	3508	626	190202	450	0	194786
29018	194002	614	2232	744	0	197592
29019	205283	466	929	708	0	207386
29020	207869	485	628	686	0	209668
29021	4215	696	514	199683	0	205108
29022	1934	199187	562	2536	0	204219
29023	1624	2812	482	205168	0	210086
29024	1245	1320	206508	2827	0	211900
29025	1118	208198	2924	1242	0	213482
29026	1356	3052	1080	207206	0	212694
29027	1044	1272	207566	2729	0	212611
29028	948	206071	2874	1171	0	211064
29029	1623	3061	1178	199336	0	205198
29030	1037	1340	205290	2795	0	210462
29031	186790	880	3041	1910	0	192621
29032	3498	748	208662	722	0	213630
29033	1856	784	206176	577	0	209393
29034	1292	209817	3817	635	0	215561
29035	1505	3236	1591	211547	0	217879
29036	1487	1535	864	208147	0	212033
29037	1236	203831	963	3565	0	209595
29038	1523	3217	711	216618	0	222069
29039	218707	1407	646	4236	0	224996
29040	219385	849	699	1885	0	222818
29041	4657	950	207396	1012	0	214015
29042	214993	757	3037	1227	0	220014
29043	222924	710	1247	1275	0	226156
29044	4777	945	220773	763	0	227258
29045	2133	218765	3716	830	0	225444
29046	1368	221893	1611	704	0	225576
29047	1752	4589	974	204781	0	212096
29048	1207	218189	909	2914	0	223219
29049	1562	4154	200448	1375	0	207539
29050	1650	1900	206475	852	0	210877
29051	1322	215207	4400	613	0	221542
29052	215026	3843	1750	1126	0	221745
29053	220737	1834	1020	1067	0	224658
29054	222894	1279	760	1136	0	226069
29055	222750	1106	689	1135	0	225680
29056	210072	1231	691	1502	0	213496
29057	5081	213970	753	700	0	220504
29058	2486	3979	212063	515	0	219043
29059	2276	1687	3516	211290	0	218769
29060	209681	1099	1484	3984	0	216248
29061	4315	204069	1000	1503	0	210887
29062	2620	4297	759	201876	0	209552
29063	1838	1686	201983	3305	0	208812
29064	1377	194340	3641	1412	0	200770
29065	1099	202730	1548	865	0	206242
29066	193437	4856	1566	1669	0	201528
29067	3427	192124	667	614	0	196832
29068	1942	3274	583	185093	0	190892
29069	185204	1262	590	3276	0	190332
29070	184653	836	497	1406	0	187392
29071	185505	761	431	964	0	187661
29072	4197	812	178807	426	0	184242
29073	1757	180974	2886	488	0	186105
29074	185539	3094	1065	797	0	190495
29075	3650	1405	627	183261	0	188943
29076	185165	943	470	3437	0	190015
29077	3720	182237	560	1249	0	187766
29078	191167	3230	437	1144	0	195978
29079	205752	1371	490	956	0	208569
29080	5685	967	488	201225	0	208365
29081	2535	900	208319	4111	0	215865
29082	2103	827	4227	212686	0	219843
29083	213294	716	1614	5385	0	221009
29084	216327	741	1021	2371	0	220460
29085	6240	210066	900	1305	0	218511
29086	206243	4408	844	1329	0	212824
29087	5461	207382	725	1020	0	214588
29088	208817	4906	653	1228	0	215604
29089	203364	2039	642	1606	0	207651
29090	6162	1492	204288	877	0	212819
29091	2744	203021	4332	911	0	211008
29092	2300	4921	1734	205683	0	214638
29093	1881	1992	1143	209837	0	214853
29094	1895	1493	838	202935	0	207161
29095	1387	202746	825	5867	0	210825
29096	1394	4858	202324	2428	0	211004
29097	1458	2246	204101	1451	0	209256
29098	1219	238773	5803	1327	0	247122
29099	240265	6480	2316	1472	0	250533
29100	6916	2668	237965	922	0	248471
29101	233330	1924	6675	1370	0	243299
29102	7683	235281	2792	917	0	246673
29103	3405	6811	237803	832	0	248851
29104	3192	2845	6709	234152	0	246898
29105	1798	2226	241302	6533	0	251859
29106	1659	1605	246364	2609	0	252237
29107	2537	1449	8539	226341	0	238866
29108	1772	231463	3888	6210	0	243333
29109	1752	244755	2415	2245	0	251167
29110	241503	8016	1665	1827	0	253011
29111	7352	3566	238371	1136	0	250425
29112	239809	2528	6721	1424	0	250482
29113	243703	1637	3137	1401	0	249878
29114	8558	242038	2184	916	0	253696
29115	236262	6491	1271	968	0	244992
29116	238550	2855	1045	983	0	243433
29117	231702	2022	944	1134	0	235802
29118	9330	220847	1073	876	0	232126
29119	4216	206712	1163	857	0	212948
29120	2803	220621	901	644	0	224969
29121	218374	7748	1974	869	0	228965
29122	219674	3454	1224	1010	0	225362
29123	8058	2221	203370	604	0	214253
29124	4112	1538	203375	462	0	209487
29125	208787	1139	6325	768	0	217019
29126	214107	944	2896	792	0	218739
29127	216251	843	1987	965	0	220046
29128	8360	830	1395	207610	0	218195
29129	4515	795	960	212460	0	218730
29130	3308	965	857	214960	0	220090
29131	2567	1080	779	216506	0	220932
29132	1843	1262	195812	7661	0	206578
29133	1820	1007	203981	3307	0	210115
29134	1752	930	204407	2013	0	209102
29135	1936	860	202115	1121	0	206032
29136	201100	835	7263	1055	0	210253
29137	5886	201033	3430	879	0	211228
29138	3187	209904	2149	870	0	216110
29139	207487	6281	1433	1141	0	216342
29140	6437	3167	205378	868	0	215850
29141	3140	2322	200750	958	0	207170
29142	200663	1730	6882	1364	0	210639
29143	206673	1222	3532	1292	0	212719
29144	6960	202678	2464	992	0	213094
29145	4431	4803	1711	202955	0	213900
29146	207137	2169	1507	4768	0	215581
29147	211729	1943	1344	2145	0	217161
29148	7865	1596	1078	205296	0	215835
29149	4465	211418	1025	4735	0	221643
29150	215169	5201	1016	2506	0	223892
29151	6558	2478	208648	2004	0	219688
29152	206520	1965	5138	1830	0	215453
29153	6509	208886	2683	1440	0	219518
29154	213033	5105	2307	1576	0	222021
29155	209203	2402	1778	1620	0	215003
29156	7187	2116	210697	1103	0	221103
29157	4171	1637	206479	1016	0	213303
29158	209968	1366	6903	1046	0	219283
29159	215854	1422	3630	1046	0	221952
29160	7152	215328	2558	731	0	225769
29161	4395	5422	1847	218325	0	229989
29162	3422	2472	216819	4570	0	227283
29163	215624	2037	5767	2088	0	225516
29164	6718	1608	2979	218680	0	229985
29165	3926	1385	2456	223547	0	231314
29166	221353	1310	1956	6515	0	231134
29167	6435	225614	1699	3401	0	237149
29168	229620	5319	1554	2670	0	239163
29169	231683	2343	1588	1830	0	237444
29170	234084	2143	1402	1646	0	239275
29171	8506	227434	1438	1352	0	238730
29172	233030	5327	1407	1279	0	241043
29173	8262	2537	1382	229536	0	241717
29174	4837	2320	1359	230334	0	238850
29175	4809	1701	225567	6280	0	238357
29176	4059	1568	220934	3147	0	229708
29177	3052	222553	6259	2300	0	234164
29178	2760	226827	3085	1450	0	234122
29179	2484	5157	212145	792	0	220578
29180	2153	213521	4600	805	0	221079
29181	212810	5639	2508	1555	0	222512
29182	214629	1922	1362	903	0	218816
29183	217197	1526	908	861	0	220492
29184	6745	1095	801	207039	0	215680
29185	3713	892	783	213233	0	218621
29186	2471	932	213033	5075	0	221511
29187	1687	210851	3930	2760	0	219228
29188	211756	4034	1711	2124	0	219625
29189	4613	211836	1472	924	0	218845
29190	214186	4665	987	888	0	220726
29191	216217	1786	700	937	0	219640
29192	6370	1346	684	209180	0	217580
29193	3861	817	706	211171	0	216555
29194	2830	906	575	216878	0	221189
29195	2314	757	205990	6036	0	215097
29196	1462	200731	3674	3293	0	209160
29197	1193	202822	1789	2307	0	208111
29198	568	166796	427	519	0	168310
29199	501	166604	433	480	0	168018
29200	574	169066	368	500	0	170508
29201	159248	2236	757	772	0	163013
29202	1940	942	161062	343	0	164287
29203	745	161249	1704	393	0	164091
29204	732	1801	155942	240	0	158715
29205	494	161576	1622	346	0	164038
29206	2103	2614	863	123920	0	129500
29207	674	752	409	155467	0	157302
29208	414	159626	327	1699	0	162066
29209	158043	1638	304	1064	0	161049
29210	1741	789	154781	425	0	157736
29211	688	157768	1500	420	0	160376
29212	601	1821	155327	304	0	158053
29213	697	736	1568	154690	0	157691
29214	862	552	587	147260	0	149261
29215	484	154040	400	1772	0	156696
29216	623	1630	292	157733	0	160278
29217	620	705	263	158551	0	160139
29218	495	157146	366	1956	0	159963
29219	473	1757	155236	754	0	158220
29220	487	891	152494	566	0	154438
29221	149669	564	1831	732	0	152796
29222	158530	534	657	576	0	160297
29223	2072	529	447	154257	0	157305
29224	873	535	154067	1654	0	157129
29225	775	559	1572	149508	0	152414
29226	525	156858	715	1821	0	159919
29227	448	1769	157345	756	0	160318
29228	401	154419	1669	684	0	157173
29229	440	1931	154528	461	0	157360
29230	306	155962	1727	480	0	158475
29231	155563	1845	724	614	0	158746
29232	1694	861	481	154078	0	157114
29233	903	726	365	151822	0	153816
29234	614	582	153150	1861	0	156207
29235	598	629	145783	847	0	147857
29236	436	151918	1818	691	0	154863
29237	152537	1722	769	917	0	155945
29238	1689	746	568	150472	0	153475
29239	660	676	153412	1601	0	156349
29240	586	660	145486	743	0	147475
29241	137892	563	1961	890	0	141306
29242	144507	538	785	755	0	146585
29243	1896	553	147159	415	0	150023
29244	983	1077	1538	141493	0	145091
29245	555	144709	719	1514	0	147497
29246	146601	1573	621	1090	0	149885
29247	1467	145378	478	691	0	148014
29248	141910	1510	460	779	0	144659
29249	1412	139764	381	448	0	142005
29250	554	142250	386	442	0	143632
29251	603	1635	351	143023	0	145612
29252	500	835	339	143477	0	145151
29253	358	142457	339	1774	0	144928
29254	358	1531	138570	637	0	141096
29255	433	798	134296	475	0	136002
29256	373	625	136236	364	0	137598
29257	131979	466	1694	638	0	134777
29258	137994	416	687	685	0	139782
29259	1443	142243	495	482	0	144663
29260	616	1828	141025	337	0	143806
29261	600	834	1723	140292	0	143449
29262	317	618	147692	1832	0	150459
29263	319	626	149747	786	0	151478
29264	621	540	2698	161613	0	165472
29265	646	432	1068	171503	0	173649
29266	318	575	184133	4290	0	189316
29267	179730	380	3647	2749	0	186506
29268	3894	192109	1917	1501	0	199421
29269	1937	203820	1339	870	0	207966
29270	1807	6091	808	199151	0	207857
29271	204534	3098	670	4657	0	212959
29272	4908	208296	584	2366	0	216154
29273	208510	5634	479	2028	0	216651
29274	5705	210951	448	1005	0	218109
29275	219076	6266	415	1395	0	227152
29276	6955	3370	215648	746	0	226719
29277	3531	2460	219593	694	0	226278
29278	3440	2395	7279	211536	0	224650
29279	1621	1535	216179	5255	0	224590
29280	1508	202297	6930	2574	0	213309
29281	1155	204669	3599	1620	0	211043
29282	205620	7458	2583	1433	0	217094
29283	6300	3799	1593	198733	0	210425
29284	2761	206842	1495	5148	0	216246
29285	210023	6417	1118	2930	0	220488
29286	208020	3568	1017	1950	0	214555
29287	214952	2369	905	1441	0	219667
29288	10103	1620	785	206868	0	219376
29289	5804	1492	764	212430	0	220490
29290	3458	1312	208229	7974	0	220973
29291	2530	1328	207471	4123	0	215452
29292	205472	963	7691	2916	0	217042
29293	7481	1023	3914	205126	0	217544
29294	3835	1081	205655	6611	0	217182
29295	202039	961	6629	4026	0	213655
29296	6917	209768	3792	2710	0	223187
29297	213112	5787	2693	2200	0	223792
29298	217860	2989	1775	2069	0	224693
29299	219528	1929	1664	1872	0	224993
29300	10764	1309	207888	1403	0	221364
29301	210365	1282	6289	1422	0	219358
29302	9904	1105	3262	201570	0	215841
29303	5513	196289	2429	5919	0	210150
29304	4419	212279	1780	3101	0	221579
29305	211626	7456	1707	2511	0	223300
29306	214703	3843	1405	1869	0	221820
29307	217627	2432	1237	1847	0	223143
29308	11726	1780	1084	206310	0	220900
29309	7010	1673	1019	211297	0	220999
29310	5328	1503	979	206258	0	214068
29311	3802	205797	1073	9282	0	219954
29312	206449	6266	1021	5142	0	218878
29313	211124	3294	895	3787	0	219100
29314	214919	2486	937	3012	0	221354
29315	11361	1927	205830	2406	0	221524
29316	213408	1859	6082	2280	0	223629
29317	10989	1850	2952	200339	0	216130
29318	6535	205656	2035	6211	0	220437
29319	208636	6659	1287	3728	0	220310
29320	208770	3388	2527	2999	0	217684
29321	11516	2632	204675	1927	0	220750
29322	7416	1819	6448	202106	0	217789
29323	5047	207081	3343	6934	0	222405
29324	215244	6930	2296	4192	0	228662
29325	9825	3793	1680	213869	0	229167
29326	6352	2735	1712	214289	0	225088
29327	5102	1925	1428	219905	0	228360
29328	4135	1951	1384	226612	0	234082
29329	3775	1844	215761	12113	0	233493
29330	3412	216408	7108	6878	0	233806
29331	3802	7511	3376	220452	0	235141
29332	3219	4022	220022	9810	0	237073
29333	218432	3014	7647	6038	0	235131
29334	227746	2171	3988	4669	0	238574
29335	11716	2164	2965	223888	0	240733
29336	226657	1969	2315	9672	0	240613
29337	232081	1849	2186	5768	0	241884
29338	12890	1931	223052	4244	0	242117
29339	7817	222478	7787	3473	0	241555
29340	228051	7552	4109	3548	0	243260
29341	11246	3826	3085	226200	0	244357
29342	231895	2714	2418	9373	0	246400
29343	11832	2026	2508	228581	0	244947
29344	7213	2250	1973	234691	0	246127
29345	5766	2011	222741	11798	0	242316
29346	212989	1717	7807	7530	0	230043
29347	10271	225301	3905	5266	0	244743
29348	6622	7655	224342	4377	0	242996
29349	5231	226669	7942	3926	0	243768
29350	225197	9056	4286	3495	0	242034
29351	10953	4511	3026	222731	0	241221
29352	223436	3188	2385	9267	0	238276
29353	11222	220291	2247	5423	0	239183
29354	227738	8161	1998	4476	0	242373
29355	232711	4026	1868	3844	0	242449
29356	234075	2918	1734	3664	0	242391
29357	232468	2071	1690	3474	0	239703
29358	14177	222169	1799	3171	0	241316
29359	225783	7476	1635	2657	0	237551
29360	12838	4258	1615	218314	0	237025
29361	8750	4046	1375	216975	0	231146
29362	6849	198927	1422	9627	0	216825
29363	5562	200798	1288	5626	0	213274
29364	4789	198454	1126	3368	0	207737
29365	184668	7772	1766	3174	0	197380
29366	7140	169347	947	2335	0	179769
29367	3812	156610	969	1519	0	162910
29368	153501	5006	2504	1842	0	162853
29369	150634	2152	866	1554	0	155206
29370	5778	149328	650	1401	0	157157
29371	147739	3852	615	1444	0	153650
29372	5264	1847	140968	1081	0	149160
29373	139614	1522	2985	1281	0	145402
29374	5194	1280	139173	1203	0	146850
29375	2285	126481	2648	939	0	132353
29376	1845	129423	1160	981	0	133409
29377	3374	3913	1347	123208	0	131842
29378	125822	1205	739	2610	0	130376
29379	127679	913	406	1317	0	130315
29380	129379	837	426	1239	0	131881
29381	129254	756	442	1159	0	131611
29382	127594	805	390	1013	0	129802
29383	3356	858	121382	812	0	126408
29384	1878	1048	116741	761	0	120428
29385	122498	845	2121	989	0	126453
29386	2848	123792	951	798	0	128389
29387	123232	1959	763	843	0	126797
29388	126228	889	451	906	0	128474
29389	129420	711	385	975	0	131491
29390	129644	650	442	888	0	131624
29391	129818	687	469	951	0	131925
29392	3187	720	125827	758	0	130492
29393	130001	780	1866	983	0	133630
29394	131969	742	794	1024	0	134529
29395	3145	974	122218	884	0	127221
29396	121177	877	1563	1123	0	124740
29397	129063	814	749	946	0	131572
29398	3395	756	131101	725	0	135977
29399	2234	763	129280	597	0	132874
29400	1992	131963	2236	549	0	136740
29401	2106	2222	1042	132792	0	138162
29402	1846	1041	133680	1872	0	138439
29403	133965	822	1960	1059	0	137806
29404	3233	736	940	139675	0	144584
29405	1927	773	142192	1988	0	146880
29406	141332	771	2047	1136	0	145286
29407	145502	788	811	923	0	148024
29408	145970	728	584	882	0	148164
29409	3674	146504	489	805	0	151472
29410	2453	2254	419	144692	0	149818
29411	1879	146824	614	2066	0	151383
29412	148996	2421	863	1047	0	153327
29413	148211	1085	681	925	0	150902
29414	3389	956	145490	488	0	150323
29415	1736	139598	1915	413	0	143662
29416	1371	142175	818	378	0	144742
29417	1545	2298	658	140758	0	145259
29418	1512	1117	372	142240	0	145241
29419	141822	795	282	2248	0	145147
29420	2899	139566	361	808	0	143634
29421	1754	139661	340	526	0	142281
29422	2019	2213	137588	287	0	142107
29423	1366	140271	1672	355	0	143664
29424	138748	2079	861	645	0	142333
29425	2773	925	135716	394	0	139808
29426	125016	629	1581	576	0	127802
29427	2235	479	130397	310	0	133421
29428	117648	305	1298	462	0	119713
29429	1617	130337	531	167	0	132652
29430	134967	1487	397	430	0	137281
29431	2070	613	136847	116	0	139646
29432	136226	517	1848	577	0	139168
29433	137953	293	583	501	0	139330
29434	2327	331	139640	101	0	142399
29435	139562	257	1638	441	0	141898
29436	144369	228	576	426	0	145599
29437	142140	227	371	443	0	143181
29438	2586	138929	282	157	0	141954
29439	142468	1729	258	473	0	144928
29440	2401	786	138965	201	0	142353
29441	1058	148008	1709	173	0	150948
29442	150199	2073	844	517	0	153633
29443	148769	662	463	476	0	150370
29444	151042	364	244	454	0	152104
29445	2980	148266	286	200	0	151732
29446	1646	2134	227	166096	0	170103
29447	865	770	165715	2941	0	170291
29448	1123	454	3111	165243	0	169931
29449	643	402	169741	3446	0	174232
29450	163717	301	3585	1417	0	169020
29451	3705	170839	1237	609	0	176390
29452	1870	3421	610	169285	0	175186
29453	961	173168	467	3161	0	177757
29454	1183	3863	339	173173	0	178558
29455	1098	1313	331	174156	0	176898
29456	647	176445	386	4594	0	182072
29457	1100	4093	293	178900	0	184386
29458	1085	1437	305	186224	0	189051
29459	671	183558	459	5364	0	190052
29460	596	191219	494	2035	0	194344
29461	1125	5442	402	189091	0	196060
29462	722	2086	187969	4720	0	195497
29463	665	190803	4467	1813	0	197748
29464	1296	4914	1373	190877	0	198460
29465	809	1884	197359	5065	0	205117
29466	670	199570	5147	2009	0	207396
29467	198409	5492	1601	1842	0	207344
29468	5375	2067	197113	996	0	205551
29469	195664	1401	5273	1259	0	203597
29470	6321	1044	1651	195462	0	204478
29471	2624	993	1056	199454	0	204127
29472	1909	1001	673	201000	0	204583
29473	1050	1050	195007	7289	0	204396
29474	926	1056	194030	2889	0	198901
29475	187801	1055	6320	2276	0	197452
29476	5861	955	2320	194712	0	203848
29477	2050	975	195712	5915	0	204652
29478	193632	1016	5512	2750	0	202910
29479	6283	1019	2016	195991	0	205309
29480	2862	975	1372	198980	0	204189
29481	2194	907	1092	198515	0	202708
29482	1284	196146	1078	7416	0	205924
29483	1653	5555	872	192259	0	200339
29484	1147	190800	979	6398	0	199324
29485	966	200993	978	2893	0	205830
29486	196383	6774	968	2485	0	206610
29487	183439	2705	1154	2695	0	189993
29488	197783	1693	994	2083	0	202553
29489	7100	191941	1052	1665	0	201758
29490	191949	5717	874	2013	0	200553
29491	196045	2161	905	1953	0	201064
29492	7573	1512	1044	189420	0	199549
29493	3414	1325	1028	193163	0	198930
29494	2053	1192	186081	7603	0	196929
29495	1452	189310	5493	3632	0	199887
29496	185240	5660	2247	2952	0	196099
29497	188131	2283	1567	2353	0	194334
29498	6501	185208	1176	2004	0	194889
29499	185292	5845	1108	2231	0	194476
29500	186980	2355	906	2304	0	192545
29501	7434	2033	946	180984	0	191397
29502	3381	174821	1085	6149	0	185436
29503	2244	184853	961	3001	0	191059
29504	180640	6492	890	2772	0	190794
29505	6467	3012	857	178067	0	188403
29506	2649	2068	175204	6480	0	186401
29507	172620	1574	5120	3477	0	182791
29508	6133	1767	178088	2471	0	188459
29509	2777	175705	5465	2222	0	186169
29510	176272	5494	2303	2428	0	186497
29511	6105	2629	175374	2154	0	186262
29512	3103	2297	5352	177309	0	188061
29513	2311	1827	181990	6307	0	192435
29514	1809	182663	5744	3219	0	193435
29515	2221	5964	2257	184292	0	194734
29516	1925	2708	181411	6436	0	192480
29517	172957	2090	5413	3696	0	184156
29518	5658	185059	2164	2761	0	195642
29519	3053	5704	1664	181002	0	191423
29520	2185	187297	1495	5915	0	196892
29521	185912	6182	1301	3225	0	196620
29522	186119	2961	1183	3004	0	193267
29523	6608	185216	1347	2541	0	195712
29524	3410	6042	1375	182744	0	193571
29525	2217	187344	1370	5944	0	196875
29526	186060	6051	1511	3333	0	196955
29527	6054	2943	183546	2335	0	194878
29528	3113	2528	180916	2189	0	188746
29529	2370	179631	5767	2031	0	189799
29530	1954	182992	2876	1818	0	189640
29531	2180	5840	1946	178905	0	188871
29532	177811	2587	1534	5556	0	187488
29533	180214	1872	1409	2860	0	186355
29534	176873	1564	1155	2455	0	182047
29535	6567	179906	1404	2038	0	189915
29536	3473	4770	1170	178311	0	187724
29537	2678	180939	1187	5011	0	189815
29538	182223	5065	1259	2812	0	191359
29539	5897	2247	1088	180585	0	189817
29540	2893	1599	176149	5066	0	185707
29541	1962	173839	4260	2662	0	182723
29542	172849	4327	1795	2107	0	181078
29543	4875	2160	170982	1509	0	179526
29544	167987	1873	3931	1954	0	175745
29545	5036	168953	1553	1792	0	177334
29546	1668	156085	749	854	0	159356
29547	153187	3277	822	930	0	158216
29548	3193	155983	575	754	0	160505
29549	153006	2809	683	900	0	157398
29550	2861	153277	457	720	0	157315
29551	154511	2808	696	821	0	158836
29552	154935	1153	651	728	0	157467
29553	3366	967	155011	498	0	159842
29554	1574	842	150133	388	0	152937
29555	1085	152857	2329	438	0	156709
29556	151384	2182	1374	701	0	155641
29557	2286	929	146616	379	0	150210
29558	140943	734	1824	508	0	144009
29559	2082	1146	918	140344	0	144490
29560	812	436	142658	1182	0	145088
29561	742	487	134194	461	0	135884
29562	696	424	142148	330	0	143598
29563	384	143291	1417	230	0	145322
29564	1465	2504	1380	138683	0	144032
29565	136170	221	298	777	0	137466
29566	665	99	89	137465	0	138318
29567	138802	80	77	901	0	139860
29568	806	84	77	139111	0	140078
29569	140786	84	71	1138	0	142079
29570	139618	147	132	963	0	140860
29571	156362	90	95	629	0	157176
29572	1649	158756	132	158	0	160695
29573	622	1597	160758	62	0	163039
29574	547	528	1551	162008	0	164634
29575	3568	1415	1764	94395	0	101142
29576	419	171	242	167532	0	168364
29577	511	169	144	164844	0	165668
29578	192	160788	201	2628	0	163809
29579	278	1889	158941	950	0	162058
29580	160	162756	1878	637	0	165431
29581	745	2240	630	155455	0	159070
29582	330	808	288	167294	0	168720
29583	338	429	172	168619	0	169558
29584	387	286	163	167421	0	168257
29585	201	161431	249	2940	0	164821
29586	191	164320	228	1171	0	165910
29587	234	2491	161538	704	0	164967
29588	400	923	1983	163268	0	166574
29589	419	515	671	166359	0	167964
29590	321	414	361	171060	0	172156
29591	171179	391	191	3524	0	175285
29592	2265	171021	294	1310	0	174890
29593	929	2385	169872	681	0	173867
29594	170666	798	2175	881	0	174520
29595	2570	501	694	173585	0	177350
29596	177060	333	370	3046	0	180809
29597	2832	359	210	178309	0	181710
29598	179818	360	248	3178	0	183604
29599	2970	338	243	179725	0	183276
29600	178827	299	300	3237	0	182663
29601	2965	381	181948	1091	0	186385
29602	1488	283	2137	182068	0	185976
29603	833	186890	790	2467	0	190980
29604	846	2414	422	192528	0	196210
29605	190880	959	297	3403	0	195539
29606	2759	188176	454	1226	0	192615
29607	1327	2826	282	198210	0	202645
29608	731	195764	314	3262	0	200071
29609	777	3339	221	200827	0	205164
29610	777	1172	197	202673	0	204819
29611	607	807	197454	4163	0	203031
29612	854	486	3065	193763	0	198168
29613	504	560	191385	3818	0	196267
29614	334	188458	3447	1743	0	193982
29615	190199	3142	1149	1455	0	195945
29616	3323	1177	188826	876	0	194202
29617	185031	708	3325	1176	0	190240
29618	197272	510	1201	1207	0	200190
29619	4498	486	798	197590	0	203372
29620	1624	453	202372	3755	0	208204
29621	197970	368	3682	2149	0	204169
29622	215099	333	1359	1613	0	218404
29623	5079	338	849	210392	0	216658
29624	2294	444	520	213127	0	216385
29625	1250	212053	544	5138	0	218985
29626	1215	4005	525	214270	0	220015
29627	770	213775	485	4739	0	219769
29628	839	4144	212146	2079	0	219208
29629	961	1662	3410	212085	0	218118
29630	208596	881	1325	4840	0	215642
29631	211937	574	685	2354	0	215550
29632	4566	209354	454	1571	0	215945
29633	2133	3670	500	213596	0	219899
29634	214070	1330	472	4703	0	220575
29635	4055	206474	426	2091	0	213046
29636	209631	3911	279	1908	0	215729
29637	4821	1526	283	215504	0	222134
29638	223684	1150	321	5161	0	230316
29639	5349	1019	235652	2027	0	244047
29640	2005	238864	5083	1783	0	247735
29641	240348	5304	1720	1896	0	249268
29642	5460	246084	1132	1409	0	254085
29643	250948	6015	658	1684	0	259305
29644	258072	2104	520	1704	0	262400
29645	7814	1551	252552	1070	0	262987
29646	4022	1097	5613	250166	0	260898
29647	259915	918	1946	6720	0	269499
29648	6916	981	253930	2442	0	264269
29649	255360	815	6097	2121	0	264393
29650	7794	843	1933	256929	0	267499
29651	3156	796	255174	6671	0	265797
29652	2730	750	6125	253063	0	262668
29653	251338	675	2277	7696	0	261986
29654	8293	899	253871	2934	0	265997
29655	3662	758	6008	257071	0	267499
29656	2784	738	2210	262110	0	267842
29657	261523	620	1646	8680	0	272469
29658	262762	623	1224	4234	0	268843
29659	8215	261446	1334	2673	0	273668
29660	4319	6109	1104	264502	0	276034
29661	3349	2260	1110	267397	0	274116
29662	2778	1572	1043	266196	0	271589
29663	259753	1027	1045	9481	0	271306
29664	262992	1008	1061	4380	0	269441
29665	9423	1041	997	258215	0	269676
29666	4519	251609	1084	7432	0	264644
29667	3687	6280	1168	252355	0	263490
29668	2845	255534	1126	7385	0	266890
29669	253959	6357	1040	4377	0	265733
29670	7589	248356	1286	3147	0	260378
29671	237098	5504	1247	2463	0	246312
29672	7632	2319	1115	232717	0	243783
29673	231850	1435	1216	6636	0	241137
29674	7306	1188	227361	3214	0	239069
29675	3738	233322	5168	2816	0	245044
29676	234080	5397	2713	3008	0	245198
29677	237193	1992	1685	2783	0	243653
29678	7824	1543	1211	229985	0	240563
29679	4053	229184	1233	6117	0	240587
29680	3476	4913	1014	240141	0	249544
29681	3021	1849	1070	242184	0	248124
29682	2877	1411	1025	241763	0	247076
29683	238428	1157	846	8676	0	249107
29684	240821	1145	928	4728	0	247622
29685	8120	1297	721	237416	0	247554
29686	4165	235545	746	6871	0	247327
29687	240586	5143	710	4290	0	250729
29688	7045	2259	234561	3375	0	247240
29689	4105	2067	4536	239223	0	249931
29690	3337	1643	237884	6963	0	249827
29691	3318	1488	4965	238664	0	248435
29692	2833	1556	239091	7284	0	250764
29693	3060	1453	5238	238829	0	248580
29694	239601	1580	2008	7680	0	250869
29695	241289	1476	1432	4201	0	248398
29696	7725	232494	1194	3059	0	244472
29697	239893	5346	877	3229	0	249345
29698	7747	2436	991	236980	0	248154
29699	4464	1919	997	241980	0	249360
29700	239535	1554	1482	8297	0	250868
29701	7404	1612	228961	4244	0	242221
29702	4459	1460	226495	3460	0	235874
29703	3899	1678	224738	3021	0	233336
29704	223698	1342	6013	3461	0	234514
29705	7174	1380	230765	2799	0	242118
29706	4123	1481	220299	2981	0	228884
29707	213879	1384	5956	3252	0	224471
29708	6262	222849	2839	2878	0	234828
29709	3840	4259	2098	228907	0	239104
29710	3321	1849	1700	233582	0	240452
29711	2797	1528	231122	7051	0	242498
29712	226159	1144	6117	4604	0	238024
29713	231864	1000	2553	3880	0	239297
29714	222347	1076	2130	3850	0	229403
29715	7056	1034	229060	2944	0	240094
29716	222955	974	5057	3551	0	232537
29717	6901	1112	221003	3013	0	232029
29718	3838	216508	4932	3026	0	228304
29719	3295	222028	2452	2935	0	230710
29720	213587	4564	2068	2895	0	223114
29721	5564	208313	1759	2540	0	218176
29722	3266	209780	1635	2280	0	216961
29723	208733	4451	1757	2543	0	217484
29724	5303	209133	1719	2190	0	218345
29725	208179	4270	1603	2374	0	216426
29726	6107	1887	1516	210373	0	219883
29727	3476	1587	1658	213860	0	220581
29728	3006	1302	1643	215105	0	221056
29729	2548	1517	1631	211408	0	217104
29730	2482	209196	1657	6019	0	219354
29731	213863	4220	1643	3526	0	223252
29732	5792	225495	1691	2419	0	235397
29733	3703	235146	1923	2825	0	243597
29734	3368	6659	241489	1930	0	253446
29735	234333	2486	6766	2756	0	246341
29736	8160	1809	252950	1828	0	264747
29737	4079	1363	260689	1708	0	267839
29738	2513	253151	7931	1797	0	265392
29739	1158	259377	2537	1007	0	264079
29740	259435	7934	2342	1777	0	271488
29741	6761	272561	1258	1100	0	281680
29742	3106	7725	269538	615	0	280984
29743	1743	266428	7106	781	0	276058
29744	1411	7729	269972	491	0	279603
29745	1152	3137	265530	389	0	270208
29746	253346	2097	9454	915	0	265812
29747	7005	1451	261922	331	0	270709
29748	3606	1227	8348	252973	0	266154
29749	251563	720	3910	7232	0	263425
29750	6740	248747	2652	2729	0	260868
29751	3065	6410	252900	1338	0	263713
29752	248680	2831	7509	1531	0	260551
29753	8185	1422	3026	240599	0	253232
29754	3265	235184	2082	6207	0	246738
29755	1932	6410	243644	2489	0	254475
29756	239854	2483	7267	1838	0	251442
29757	7569	1522	244618	874	0	254583
29758	4006	928	7893	241716	0	254543
29759	1938	968	239550	6900	0	249356
29760	2210	690	8137	238503	0	249540
29761	235048	607	3559	8501	0	247715
29762	6789	239223	2522	3405	0	251939
29763	243784	6597	1650	2532	0	254563
29764	8181	2663	241152	1358	0	253354
29765	4271	1502	7403	244292	0	257468
29766	2348	1132	247866	7221	0	258567
29767	242112	977	8338	3543	0	254970
29768	250299	773	3520	2442	0	257034
29769	9667	247275	2546	1371	0	260859
29770	251961	7224	1758	1725	0	262668
29771	257209	2711	1666	1339	0	262925
29772	11722	1664	1250	247425	0	262061
29773	5130	1408	246148	7242	0	259928
29774	3296	236987	7512	2881	0	250676
29775	3316	7493	2918	240978	0	254705
29776	242886	3007	1924	8268	0	256085
29777	8628	1898	239366	3270	0	253162
29778	3847	1512	241904	1906	0	249169
29779	2449	1451	237756	1464	0	243120
29780	230105	1303	10866	1680	0	243954
29781	8633	1328	235453	831	0	246245
29782	229157	1063	10063	1238	0	241521
29783	9349	1145	216689	801	0	227984
29784	4082	226088	9146	770	0	240086
29785	3321	7439	4592	223797	0	239149
29786	2351	3072	226686	7108	0	239217
29787	2068	217304	9116	3038	0	231526
29788	1765	226319	4514	1848	0	234446
29789	2161	9847	2977	221485	0	236470
29790	219441	4378	2387	8175	0	234381
29791	8167	2916	2266	221234	0	234583
29792	217297	2363	1932	9030	0	230622
29793	9450	2125	1843	216886	0	230304
29794	4331	2001	214192	8912	0	229436
29795	3208	1786	216283	4085	0	225362
29796	208996	1261	10626	3407	0	224290
29797	215539	1168	5299	2770	0	224776
29798	10852	1302	209119	2055	0	223328
29799	205772	1360	9604	2045	0	218781
29800	10344	1628	207260	1370	0	220602
29801	5585	195498	10076	1325	0	212484
29802	4319	198983	5274	1300	0	209876
29803	3515	200044	4033	1356	0	208948
29804	3552	10473	3449	193142	0	210616
29805	192779	4845	3286	7934	0	208844
29806	197975	3514	2909	3625	0	208023
29807	11411	2793	2615	191914	0	208733
29808	5789	2725	183045	8180	0	199739
29809	4251	2228	8705	184317	0	199501
29810	3704	1841	183126	9210	0	197881
29811	3468	1510	9867	180375	0	195220
29812	177216	1269	5480	9898	0	193863
29813	183412	1284	4110	4979	0	193785
29814	184025	1157	3718	3711	0	192611
29815	184973	1228	3282	3018	0	192501
29816	12933	1127	2907	174530	0	191497
29817	7251	1091	2754	181010	0	192106
29818	176745	1139	2624	10696	0	191204
29819	182592	1205	2204	5104	0	191105
29820	12670	1204	2307	174580	0	190761
29821	7002	1141	2052	179786	0	189981
29822	5138	1105	1919	179301	0	187463
29823	4431	1179	1853	180591	0	188054
29824	171517	1233	2066	12541	0	187357
29825	9713	1189	166548	6613	0	184063
29826	5490	1026	8074	165583	0	180173
29827	163663	1039	3981	10273	0	178956
29828	9567	1058	159628	5691	0	175944
29829	6102	1114	8434	160989	0	176639
29830	4502	955	160015	9186	0	174658
29831	3777	150246	9246	4760	0	168029
29832	4294	6002	4773	133833	0	148902
29833	124996	2237	3476	6917	0	137626
29834	6787	3651	2934	110627	0	123999
29835	3842	105410	2598	6424	0	118274
29836	2992	98907	2031	3318	0	107248
29837	2315	80756	1468	2124	0	86663
29838	2171	76301	1658	1801	0	81931
29839	44332	5614	4964	3638	0	58548
29840	3117	1837	1494	32916	0	39364
29841	655	245	27926	1272	0	30098
29842	502	227	1042	26316	0	28087
29843	561	156	25757	1166	0	27640
29844	25730	114	1014	562	0	27420
29845	1307	120	406	25482	0	27315
29846	687	152	308	26120	0	27267
29847	509	182	275	26069	0	27035
29848	452	187	223	26226	0	27088
29849	25215	210	166	1329	0	26920
29850	25778	172	156	684	0	26790
29851	1255	144	177	25160	0	26736
29852	24402	132	175	1303	0	26012
29853	1086	142	23645	719	0	25592
29854	495	23252	833	692	0	25272
29855	556	771	353	23519	0	25199
29856	424	213	373	23372	0	24382
29857	359	22467	224	1339	0	24389
29858	478	728	241	22481	0	23928
29859	415	767	307	22226	0	23715
29860	21821	97	303	1284	0	23505
29861	977	121	20616	505	0	22219
29862	388	141	19027	388	0	19944
29863	18217	86	796	467	0	19566
29864	908	90	17244	251	0	18493
29865	9903	190	796	146	0	11035
29866	8276	31	349	144	0	8800
29867	497	309	148	6417	0	7371
29868	117	40	5453	224	0	5834
29869	4425	66	206	108	0	4805
29870	178	4287	69	67	0	4601
29871	2285	323	442	157	0	3207
29872	1501	128	222	112	0	1963
29873	680	34	67	40	0	821
29874	401	15	7	17	0	440
29875	365	27	13	8	0	413
29876	320	14	6	12	0	352
29877	319	6	4	12	0	341
29878	307	7	2	9	0	325
29879	292	6	4	14	0	316
29880	293	2	6	9	0	310
29881	267	4	11	5	0	287
29882	257	4	2	11	0	274
29883	239	4	6	11	0	260
29884	185	3	5	5	0	198
29885	154	4	0	9	0	167
29886	206	3	1	8	0	218
29887	241	4	5	8	0	258
29888	222	0	1	10	0	233
29889	227	2	2	2	0	233
29890	223	2	4	2	0	231
29891	237	1	2	6	0	246
29892	238	0	4	0	0	242
29893	235	3	3	3	0	244
29894	236	4	1	2	0	243
29895	235	0	0	6	0	241
29896	229	1	2	5	0	237
29897	233	3	0	2	0	238
29898	229	1	0	5	0	235
29899	221	1	2	5	0	229
29900	220	0	4	1	0	225
29901	188	0	9	2	0	199
29902	178	0	11	2	0	191
29903	129	0	33	1	0	163
29904	1	0	3	1	0	5
29905	4	0	0	0	0	4
29906	2	0	0	0	0	2
29907	1	0	0	1	0	2
29908	1	0	0	0	0	1
29909	2	0	0	0	0	2
29910	1	1	0	0	0	2
29911	2	0	0	0	0	2
29912	2	0	0	0	0	2
29913	2	0	0	0	0	2
29914	2	0	0	0	0	2
29915	2	0	0	0	0	2
29916	2	0	0	0	0	2
29917	1	0	0	0	0	1
29918	1	0	0	0	0	1
