Pos	A	C	G	T	Other	Total
1	0	0	0	0	0	0
2	0	0	0	0	0	0
3	0	0	0	0	0	0
4	0	0	0	0	0	0
5	0	0	0	0	0	0
6	0	0	0	0	0	0
7	0	0	0	0	0	0
8	0	0	0	0	0	0
9	0	0	0	0	0	0
10	0	0	0	0	0	0
11	0	0	0	0	0	0
12	0	0	0	0	0	0
13	0	0	0	0	0	0
14	0	0	1	0	0	1
15	0	1	0	0	0	1
16	0	1230	4	1	0	1235
17	0	2	0	2456	0	2458
18	0	2	0	3214	0	3216
19	0	3177	4	1	0	3182
20	2	3200	4	2	0	3208
21	1	3215	1	1	0	3218
22	3295	0	2	1	0	3298
23	2	0	3303	0	0	3305
24	5	2	3174	3	0	3184
25	0	0	0	3109	0	3109
26	3255	0	1	1	0	3257
27	3253	0	0	0	0	3253
28	0	3178	3	0	0	3181
29	3323	0	0	0	0	3323
30	3876	0	0	0	0	3876
31	3954	2	0	0	0	3956
32	0	3915	2	2	0	3919
33	0	3924	4	3	0	3931
34	4667	1	0	1	0	4669
35	5893	3	0	0	0	5896
36	0	5687	10	4	0	5701
37	1	6193	5	5	0	6204
38	6529	0	1	0	0	6530
39	6468	1	2	0	0	6471
40	0	6303	3	4	0	6310
41	1	1	0	6456	0	6458
42	1	2	0	6440	0	6443
43	0	4	1	6355	0	6360
44	1	6387	5	3	0	6396
45	6	8	6220	0	0	6234
46	5469	7	8	4	0	5488
47	0	1	0	6496	0	6497
48	0	6194	9	0	0	6203
49	1	1	0	6568	0	6570
50	1	6281	7	1	0	6290
51	0	1	0	6524	0	6525
52	0	3	0	6457	0	6460
53	1	0	6443	0	0	6444
54	1	1	2	6140	0	6144
55	6428	1	0	1	0	6430
56	3	4	6297	5	0	6309
57	5971	1	2	3	0	5977
58	0	0	0	6398	0	6398
59	0	6244	4	3	0	6251
60	0	2	1	6512	0	6515
61	4	0	6398	1	0	6403
62	0	2	2	6108	0	6112
63	1	1	0	6392	0	6394
64	0	6200	6	2	0	6208
65	0	1	0	6526	0	6527
66	0	6243	5	1	0	6249
67	0	18	0	6476	0	6494
68	6363	0	1	3	0	6367
69	5795	3	4	3	0	5805
70	6098	1	2	4	0	6105
71	0	5965	14	2	0	5981
72	3	7	5880	1	0	5891
73	5662	3	6	3	0	5674
74	6223	2	0	0	0	6225
75	1	6519	9	5	0	6534
76	2	27	1	6412	0	6442
77	0	12	0	6366	0	6378
78	0	7	0	6343	0	6350
79	6454	6	0	40	0	6500
80	6291	2	5	22	0	6320
81	6302	2	1	19	0	6324
82	6451	0	1	9	0	6461
83	48	0	0	6313	0	6361
84	23	6167	9	27	0	6226
85	15	26	1	6461	0	6503
86	13	17	6318	35	0	6383
87	6	6	23	6137	0	6172
88	4	14	6305	37	0	6360
89	1	6	31	6079	0	6117
90	4	6	6264	40	0	6314
91	9	7	5962	21	0	5999
92	1	5838	43	17	0	5899
93	3	28	16	6913	0	6960
94	10	17	7341	32	0	7400
95	6	8	54	7142	0	7210
96	6	7010	32	55	0	7103
97	7413	54	14	22	0	7503
98	51	7135	18	13	0	7217
99	16	63	4	7278	0	7361
100	10	7178	10	55	0	7253
101	8	82	6745	20	0	6855
102	16	26	6752	13	0	6807
103	2	6673	92	17	0	6784
104	1	59	26	7201	0	7287
105	9	29	7098	53	0	7189
106	5	6732	82	24	0	6843
107	7196	61	17	12	0	7286
108	58	26	9	7030	0	7123
109	18	23	7086	62	0	7189
110	11	6790	75	24	0	6900
111	11	61	14	7157	0	7243
112	7	24	12	7085	0	7128
113	6889	13	9	75	0	6986
114	56	25	7030	28	0	7139
115	16	9	54	6976	0	7055
116	15	11	5880	64	0	5970
117	6	4732	79	32	0	4849
118	4500	61	25	10	0	4596
119	54	5048	18	16	0	5136
120	21	71	12	5100	0	5204
121	13	5102	15	57	0	5187
122	5107	70	5	17	0	5199
123	58	5053	12	19	0	5142
124	21	78	4877	8	0	4984
125	7	4985	66	14	0	5072
126	5144	73	18	10	0	5245
127	60	34	5055	7	0	5156
128	23	17	61	5034	0	5135
129	6153	12	20	60	0	6245
130	144	12	13	5471	0	5640
131	5545	6	10	159	0	5720
132	5586	14	5	64	0	5669
133	206	12	3	5372	0	5593
134	76	12	3	5009	0	5100
135	3746	6	7	206	0	3965
136	3810	11	2	84	0	3907
137	208	8	5	3313	0	3534
138	3341	6	11	166	0	3524
139	3396	10	5	69	0	3480
140	214	3168	19	26	0	3427
141	76	139	8	3297	0	3520
142	3522	59	10	156	0	3747
143	3610	26	7	67	0	3710
144	208	15	3	3489	0	3715
145	82	14	11	3658	0	3765
146	3513	10	10	218	0	3751
147	173	3425	10	84	0	3692
148	74	126	12	3572	0	3784
149	35	70	3364	174	0	3643
150	32	19	135	3440	0	3626
151	32	3333	55	164	0	3584
152	31	129	3337	91	0	3588
153	29	59	147	3427	0	3662
154	36	25	53	3509	0	3623
155	34	27	3371	224	0	3656
156	3302	13	152	105	0	3572
157	187	3400	64	58	0	3709
158	3549	146	18	52	0	3765
159	193	66	3407	65	0	3731
160	105	26	3483	43	0	3657
161	3404	27	192	39	0	3662
162	193	3393	64	49	0	3699
163	3457	144	32	48	0	3681
164	195	3431	35	38	0	3699
165	98	166	3368	32	0	3664
166	3428	81	141	58	0	3708
167	201	41	3410	40	0	3692
168	101	29	165	3456	0	3751
169	3505	25	66	184	0	3780
170	3532	19	29	109	0	3689
171	227	3358	34	54	0	3673
172	107	160	21	3398	0	3686
173	50	3387	32	173	0	3642
174	50	163	3318	99	0	3630
175	33	60	122	2765	0	2980
176	24	2861	57	132	0	3074
177	25	123	27	3004	0	3179
178	3065	70	29	154	0	3318
179	141	18	24	3250	0	3433
180	73	3130	29	147	0	3379
181	31	116	26	3286	0	3459
182	49	60	22	3286	0	3417
183	45	3117	24	177	0	3363
184	34	123	31	3260	0	3448
185	47	60	3055	135	0	3297
186	38	3036	138	81	0	3293
187	3150	136	51	28	0	3365
188	167	71	3140	25	0	3403
189	86	43	3180	31	0	3340
190	48	3078	177	38	0	3341
191	45	134	64	3176	0	3419
192	49	68	3078	141	0	3336
193	34	2428	150	91	0	2703
194	39	94	51	2122	0	2306
195	47	53	15	2215	0	2330
196	2093	27	22	147	0	2289
197	115	2023	12	87	0	2237
198	65	117	2001	41	0	2224
199	36	70	2080	46	0	2232
200	30	31	125	2099	0	2285
201	27	31	50	3089	0	3197
202	32	31	19	3135	0	3217
203	37	4499	31	236	0	4803
204	33	253	4318	123	0	4727
205	35	134	230	4258	0	4657
206	21	4929	126	259	0	5335
207	25	5271	54	140	0	5490
208	25	388	5056	73	0	5542
209	14	169	283	5467	0	5933
210	21	60	5414	338	0	5833
211	20	48	324	5536	0	5928
212	28	41	147	5773	0	5989
213	35	38	5173	440	0	5686
214	23	5301	323	190	0	5837
215	5382	304	148	71	0	5905
216	300	162	5131	54	0	5647
217	129	5196	328	62	0	5715
218	46	5597	160	59	0	5862
219	28	422	4781	46	0	5277
220	4871	189	309	65	0	5434
221	302	109	165	4192	0	4768
222	135	5122	90	287	0	5634
223	5154	348	75	125	0	5702
224	325	173	72	4831	0	5401
225	150	5052	74	330	0	5606
226	5175	327	62	180	0	5744
227	337	177	4811	113	0	5438
228	156	5117	361	81	0	5715
229	4069	267	105	42	0	4483
230	235	4200	73	46	0	4554
231	4176	290	52	29	0	4547
232	264	152	54	3912	0	4382
233	109	4037	64	234	0	4444
234	61	242	63	4233	0	4599
235	4140	126	45	305	0	4616
236	241	87	3974	147	0	4449
237	119	71	4155	87	0	4432
238	83	64	315	4079	0	4541
239	51	66	154	4206	0	4477
240	55	72	80	4119	0	4326
241	50	4061	54	334	0	4499
242	43	279	3729	138	0	4189
243	48	149	238	3705	0	4140
244	67	3629	129	234	0	4059
245	55	3848	80	118	0	4101
246	65	331	3856	79	0	4331
247	59	171	4007	66	0	4303
248	53	104	4060	55	0	4272
249	65	70	341	3950	0	4426
250	61	65	3916	276	0	4318
251	41	75	301	4026	0	4443
252	56	75	3843	292	0	4266
253	3826	70	277	158	0	4331
254	257	3790	143	97	0	4287
255	134	3993	85	78	0	4290
256	71	358	3777	82	0	4288
257	3816	168	272	86	0	4342
258	4116	97	128	91	0	4432
259	4207	85	106	71	0	4469
260	361	73	3847	85	0	4366
261	159	54	4071	108	0	4392
262	66	79	374	3987	0	4506
263	4905	81	201	317	0	5504
264	5191	73	134	192	0	5590
265	389	90	4895	132	0	5506
266	5017	114	369	96	0	5596
267	358	101	208	4960	0	5627
268	149	110	5426	376	0	6061
269	95	107	5618	186	0	6006
270	5348	106	495	147	0	6096
271	342	91	5588	110	0	6131
272	5418	83	452	112	0	6065
273	377	105	5433	114	0	6029
274	189	5235	447	108	0	5979
275	140	5622	239	124	0	6125
276	114	433	191	5403	0	6141
277	109	231	153	5791	0	6284
278	116	161	5034	442	0	5753
279	135	111	406	4987	0	5639
280	131	4865	209	384	0	5589
281	138	5252	167	161	0	5718
282	153	5502	132	122	0	5909
283	154	475	128	5212	0	5969
284	141	235	5091	359	0	5826
285	152	142	5308	176	0	5778
286	125	106	460	5181	0	5872
287	148	107	222	5409	0	5886
288	153	113	155	5001	0	5422
289	154	5192	115	428	0	5889
290	5261	366	120	209	0	5956
291	5326	184	126	152	0	5788
292	470	5142	128	130	0	5870
293	226	385	5168	122	0	5901
294	5252	190	386	117	0	5945
295	425	138	5238	113	0	5914
296	5263	94	450	117	0	5924
297	5537	100	228	134	0	5999
298	5536	112	178	154	0	5980
299	5446	107	135	167	0	5855
300	459	5232	153	176	0	6020
301	4072	286	96	126	0	4580
302	314	4223	124	127	0	4788
303	2516	162	39	35	0	2752
304	175	2523	38	35	0	2771
305	46	181	2717	32	0	2976
306	26	40	92	2188	0	2346
307	28	2224	30	117	0	2399
308	17	2399	38	46	0	2500
309	2038	100	23	32	0	2193
310	2053	40	19	24	0	2136
311	103	2026	19	17	0	2165
312	29	117	12	1949	0	2107
313	28	2022	25	86	0	2161
314	2063	116	16	32	0	2227
315	110	26	2005	30	0	2171
316	36	27	102	1991	0	2156
317	47	18	30	2076	0	2171
318	39	20	22	2139	0	2220
319	31	41	2005	117	0	2194
320	47	1997	96	39	0	2179
321	47	2111	26	30	0	2214
322	48	79	40	1861	0	2028
323	51	32	1807	74	0	1964
324	44	29	99	1758	0	1930
325	40	20	49	1858	0	1967
326	51	17	40	1875	0	1983
327	44	23	41	1901	0	2009
328	1858	19	26	96	0	1999
329	105	1833	35	28	0	2001
330	1860	92	24	40	0	2016
331	105	50	1831	32	0	2018
332	43	43	1844	30	0	1960
333	36	48	92	1612	0	1788
334	42	41	35	1723	0	1841
335	22	1834	38	90	0	1984
336	30	97	1773	42	0	1942
337	16	1797	85	59	0	1957
338	24	101	1805	36	0	1966
339	1625	49	90	33	0	1797
340	82	1814	29	30	0	1955
341	34	100	1790	37	0	1961
342	27	44	83	1770	0	1924
343	19	54	1790	101	0	1964
344	17	1775	99	41	0	1932
345	31	93	33	1763	0	1920
346	18	1791	41	97	0	1947
347	28	92	1753	55	0	1928
348	25	34	77	1804	0	1940
349	1789	34	41	105	0	1969
350	88	1797	34	34	0	1953
351	37	96	1751	37	0	1921
352	46	48	76	1743	0	1913
353	35	38	1778	96	0	1947
354	32	32	1752	41	0	1857
355	37	1715	90	41	0	1883
356	29	95	32	1774	0	1930
357	42	26	28	1777	0	1873
358	40	44	19	2404	0	2507
359	43	36	2356	91	0	2526
360	37	38	2291	39	0	2405
361	2139	38	100	27	0	2304
362	93	45	2369	28	0	2535
363	1174	0	0	0	0	1174
364	0	1280	2	0	0	1282
365	0	1	0	1312	0	1313
366	0	1281	0	1	0	1282
367	2	1261	0	1	0	1264
368	1	0	882	0	0	883
369	0	1	0	794	0	795
370	0	0	893	0	0	893
371	0	4	797	0	0	801
372	779	0	0	1	0	780
373	1	0	880	0	0	881
374	0	1	861	0	0	862
375	816	0	3	0	0	819
376	0	0	865	0	0	865
377	1	0	859	1	0	861
378	1	1	0	797	0	799
379	0	843	0	0	0	843
380	0	0	0	893	0	893
381	0	1	0	853	0	854
382	894	0	0	0	0	894
383	0	0	0	857	0	857
384	0	849	1	0	0	850
385	895	0	0	0	0	895
386	1	1	883	0	0	885
387	1014	0	2	0	0	1016
388	12	1	1110	0	0	1123
389	2	3	1087	0	0	1092
390	0	1048	19	0	0	1067
391	1133	11	3	0	0	1147
392	12	1085	4	5	0	1106
393	3	15	1092	2	0	1112
394	2	3	13	1004	0	1022
395	1	1085	6	8	0	1100
396	1133	14	1	2	0	1150
397	1098	2	4	0	0	1104
398	11	1106	3	0	0	1120
399	1123	12	2	0	0	1137
400	16	3	0	1110	0	1129
401	3	1085	3	14	0	1105
402	2	10	2	1123	0	1137
403	2	2	0	1109	0	1113
404	1137	3	1	14	0	1155
405	839	2	1	3	0	845
406	832	1	1	3	0	837
407	15	2	812	1	0	830
408	779	2	12	0	0	793
409	16	1	3	813	0	833
410	5	4	818	13	0	840
411	3	5	754	4	0	766
412	4	789	15	3	0	811
413	824	12	7	2	0	845
414	13	790	2	0	0	805
415	6	13	2	814	0	835
416	2	5	2	814	0	823
417	3	6	1600	15	0	1624
418	3	3	15	1408	0	1429
419	2	2	1608	14	0	1626
420	2	5	1512	4	0	1523
421	7	1490	16	2	0	1515
422	3	14	5	1612	0	1634
423	1	5	6	1598	0	1610
424	1627	2	2	20	0	1651
425	13	5	1586	8	0	1612
426	7	3	15	1593	0	1618
427	1614	2	9	16	0	1641
428	15	3	1582	7	0	1607
429	1539	2	16	3	0	1560
430	1619	3	4	3	0	1629
431	20	3	2414	4	0	2441
432	5	3	15	2301	0	2324
433	6	2	5	2466	0	2479
434	8	4	2419	20	0	2451
435	2299	3	20	6	0	2328
436	2466	4	8	5	0	2483
437	2426	6	7	4	0	2443
438	2428	3	5	4	0	2440
439	2416	9	7	5	0	2437
440	23	6	2340	4	0	2373
441	7	5	2335	9	0	2356
442	5	2282	24	6	0	2317
443	11	15	2379	6	0	2411
444	7	9	20	2270	0	2306
445	10	16	9	1986	0	2021
446	10	2	1	2371	0	2384
447	5	4	6	2402	0	2417
448	12	8	2380	23	0	2423
449	6	2251	22	14	0	2293
450	1	2327	11	10	0	2349
451	9	23	1	2368	0	2401
452	7	2315	4	19	0	2345
453	2401	13	6	8	0	2428
454	2323	5	6	5	0	2339
455	24	2308	12	7	0	2351
456	6	16	9	2381	0	2412
457	8	7	7	2384	0	2406
458	7	6	1942	22	0	1977
459	1727	9	24	8	0	1768
460	1943	3	9	7	0	1962
461	20	1903	8	8	0	1939
462	1932	18	3	8	0	1961
463	23	9	1940	7	0	1979
464	7	1859	23	7	0	1896
465	5	2589	13	12	0	2619
466	8	2662	11	6	0	2687
467	5	60	7	2696	0	2768
468	2675	17	7	56	0	2755
469	56	4	7	3313	0	3380
470	11	10	3269	71	0	3361
471	6	5	58	3285	0	3354
472	8	7	3220	74	0	3309
473	10	3	60	3161	0	3234
474	9	10	11	3074	0	3104
475	11	3208	14	65	0	3298
476	4065	62	3	17	0	4147
477	66	10	8	3901	0	3985
478	17	3854	14	62	0	3947
479	4013	64	8	17	0	4102
480	3715	13	12	17	0	3757
481	3938	8	9	15	0	3970
482	67	3907	10	14	0	3998
483	17	70	3885	13	0	3985
484	15	12	61	3903	0	3991
485	13	244	12	3605	0	3874
486	13	3836	14	53	0	3916
487	5	46	3613	12	0	3676
488	7	9	3636	6	0	3658
489	3602	10	48	3	0	3663
490	52	5	6	3676	0	3739
491	11	10	3685	52	0	3758
492	7	3554	53	17	0	3631
493	10	59	7	3543	0	3619
494	6	3598	10	49	0	3663
495	11	59	3610	17	0	3697
496	3489	14	48	14	0	3565
497	3677	5	16	12	0	3710
498	55	3634	19	15	0	3723
499	14	54	8	3734	0	3810
500	8	12	3625	61	0	3706
501	3	3597	52	25	0	3677
502	3635	63	12	9	0	3719
503	59	3583	10	19	0	3671
504	13	3690	10	12	0	3725
505	12	66	8	3645	0	3731
506	16	3639	11	51	0	3717
507	3740	54	7	13	0	3814
508	61	13	5	3708	0	3787
509	12	20	3573	58	0	3663
510	10	16	3460	13	0	3499
511	11	11	51	3606	0	3679
512	12	3539	20	56	0	3627
513	3711	59	10	10	0	3790
514	49	16	14	3649	0	3728
515	9	15	3655	58	0	3737
516	17	13	48	3617	0	3695
517	11	9	7	3021	0	3048
518	2951	10	17	61	0	3039
519	52	15	10	2853	0	2930
520	11	16	2880	62	0	2969
521	10	16	2868	19	0	2913
522	5	13	59	2895	0	2972
523	13	11	18	2918	0	2960
524	12	12	2903	56	0	2983
525	2654	16	51	21	0	2742
526	60	16	2888	19	0	2983
527	12	2781	63	20	0	2876
528	15	63	16	2916	0	3010
529	15	22	2886	61	0	2984
530	9	27	2830	21	0	2887
531	10	16	56	2082	0	2164
532	2105	10	18	73	0	2206
533	61	21	2048	17	0	2147
534	17	1989	59	19	0	2084
535	2095	55	16	27	0	2193
536	52	21	2061	30	0	2164
537	2018	12	73	23	0	2126
538	2080	16	21	28	0	2145
539	64	2047	20	23	0	2154
540	20	61	16	1892	0	1989
541	15	2015	19	63	0	2112
542	18	60	2007	28	0	2113
543	1997	18	59	23	0	2097
544	2087	20	13	25	0	2145
545	69	14	2068	18	0	2169
546	29	12	2052	17	0	2110
547	22	2016	66	15	0	2119
548	2097	54	25	18	0	2194
549	60	21	19	2045	0	2145
550	18	14	21	1996	0	2049
551	12	2058	22	60	0	2152
552	2087	61	27	16	0	2191
553	60	17	2062	16	0	2155
554	18	14	62	2826	0	2920
555	2770	12	23	134	0	2939
556	113	3016	37	32	0	3198
557	24	127	3737	20	0	3908
558	24	29	3833	19	0	3905
559	19	23	154	3543	0	3739
560	14	3640	45	137	0	3836
561	18	167	3718	17	0	3920
562	27	26	155	3706	0	3914
563	3787	20	33	163	0	4003
564	163	31	3769	25	0	3988
565	14	10	108	3006	0	3138
566	12	11	2992	122	0	3137
567	14	11	3074	14	0	3113
568	9	8	126	3002	0	3145
569	4	1	2383	106	0	2494
570	2017	5	123	9	0	2154
571	103	1	2343	8	0	2455
572	2229	2	103	7	0	2341
573	99	2298	16	3	0	2416
574	2953	100	9	3	0	3065
575	99	2895	16	4	0	3014
576	12	107	5	2398	0	2522
577	13	13	3	2533	0	2562
578	11	10	2340	111	0	2472
579	2	12	2420	17	0	2451
580	5	2	113	2433	0	2553
581	4	5	2375	111	0	2495
582	6	9	109	2277	0	2401
583	0	2310	31	98	0	2439
584	8	2466	22	19	0	2515
585	7	114	11	2394	0	2526
586	10	21	9	2516	0	2556
587	5	21	2325	115	0	2466
588	9	6	105	2334	0	2454
589	8	2271	21	109	0	2409
590	2	2397	19	24	0	2442
591	2	2465	17	18	0	2502
592	7	116	16	2281	0	2420
593	8	2346	22	93	0	2469
594	2407	111	14	21	0	2553
595	104	17	16	2433	0	2570
596	19	14	2390	110	0	2533
597	14	16	106	2395	0	2531
598	12	14	2390	119	0	2535
599	7	10	2437	26	0	2480
600	8	17	2432	25	0	2482
601	9	2279	129	18	0	2435
602	6	107	2378	21	0	2512
603	2363	19	119	28	0	2529
604	2492	15	38	17	0	2562
605	3325	16	29	15	0	3385
606	114	13	20	3231	0	3378
607	3208	12	25	123	0	3368
608	113	2962	32	30	0	3137
609	14	3178	25	37	0	3254
610	3247	108	27	18	0	3400
611	112	27	3162	23	0	3324
612	18	15	116	3171	0	3320
613	18	22	3175	110	0	3325
614	18	22	3182	31	0	3253
615	9	3102	120	27	0	3258
616	20	125	35	3034	0	3214
617	18	24	28	3310	0	3380
618	3206	22	24	139	0	3391
619	113	3097	34	46	0	3290
620	26	3243	27	45	0	3341
621	31	127	3100	31	0	3289
622	18	3104	136	25	0	3283
623	3176	135	39	39	0	3389
624	3228	32	50	30	0	3340
625	128	34	3228	20	0	3410
626	24	28	3798	42	0	3892
627	34	29	150	3618	0	3831
628	23	34	59	3678	0	3794
629	22	3643	55	148	0	3868
630	34	124	38	3765	0	3961
631	22	35	51	3785	0	3893
632	31	3639	34	149	0	3853
633	24	130	42	3769	0	3965
634	19	36	55	3780	0	3890
635	19	3578	48	163	0	3808
636	27	120	3595	43	0	3785
637	30	33	137	3733	0	3933
638	3738	29	52	145	0	3964
639	3815	34	50	38	0	3937
640	136	36	3666	38	0	3876
641	3633	44	115	40	0	3832
642	3779	44	36	34	0	3893
643	127	3526	50	42	0	3745
644	36	136	3569	57	0	3798
645	33	41	3603	48	0	3725
646	25	33	141	4099	0	4298
647	4211	33	59	160	0	4463
648	4306	34	54	49	0	4443
649	155	28	45	4843	0	5071
650	4892	25	28	215	0	5160
651	4970	45	40	54	0	5109
652	4953	43	32	59	0	5087
653	204	48	4733	64	0	5049
654	37	16	3884	24	0	3961
655	3881	1	119	24	0	4025
656	104	10	3689	22	0	3825
657	20	2947	68	2	0	3037
658	6	54	19	3062	0	3141
659	9	21	3051	53	0	3134
660	9	10	3044	19	0	3082
661	6	0	71	2970	0	3047
662	9	4	3043	57	0	3113
663	7	2	2942	20	0	2971
664	6	2997	92	12	0	3107
665	5	3468	31	6	0	3510
666	3468	96	13	3	0	3580
667	77	27	5	3500	0	3609
668	3521	8	11	81	0	3621
669	88	10	3397	23	0	3518
670	26	3	81	3375	0	3485
671	10	2	23	3563	0	3598
672	3431	3	13	99	0	3546
673	83	3320	10	32	0	3445
674	29	79	2756	9	0	2873
675	13	33	2802	5	0	2853
676	7	2887	100	10	0	3004
677	14	87	2892	6	0	2999
678	13	3283	95	4	0	3395
679	9	3310	33	11	0	3363
680	10	104	3169	6	0	3289
681	3143	25	92	5	0	3265
682	85	11	30	3302	0	3428
683	32	3281	17	79	0	3409
684	12	77	12	3411	0	3512
685	3368	26	9	83	0	3486
686	3453	8	11	30	0	3502
687	3430	6	14	9	0	3459
688	104	13	3259	8	0	3384
689	28	6	87	3202	0	3323
690	13	3202	35	79	0	3329
691	3369	80	17	26	0	3492
692	88	34	11	3324	0	3457
693	30	13	9	3361	0	3413
694	18	7	9	3471	0	3505
695	12	11	3203	113	0	3339
696	3106	9	86	38	0	3239
697	88	3193	37	16	0	3334
698	35	74	14	3288	0	3411
699	28	27	5	3419	0	3479
700	4051	13	15	107	0	4186
701	108	21	3904	35	0	4068
702	42	9	4016	22	0	4089
703	23	3719	147	19	0	3908
704	17	97	3937	10	0	4061
705	3206	31	115	15	0	3367
706	95	3322	52	17	0	3486
707	31	103	3350	10	0	3494
708	3308	41	115	10	0	3474
709	110	28	3349	14	0	3501
710	39	3336	124	16	0	3515
711	20	108	38	3388	0	3554
712	21	36	18	3525	0	3600
713	19	22	3371	125	0	3537
714	25	16	3351	41	0	3433
715	17	3347	122	28	0	3514
716	3239	103	46	15	0	3403
717	107	3605	26	21	0	3759
718	41	112	20	3595	0	3768
719	30	34	3568	112	0	3744
720	3451	24	111	43	0	3629
721	110	20	42	3487	0	3659
722	40	3471	25	101	0	3637
723	18	3660	37	31	0	3746
724	15	126	26	3613	0	3780
725	19	55	16	3734	0	3824
726	3172	23	25	141	0	3361
727	113	26	15	3204	0	3358
728	43	22	3116	121	0	3302
729	3154	16	116	47	0	3333
730	3262	13	46	39	0	3360
731	137	20	3061	28	0	3246
732	3150	11	130	16	0	3307
733	123	18	42	3145	0	3328
734	46	27	22	3227	0	3322
735	37	19	19	3246	0	3321
736	30	18	22	3126	0	3196
737	10	3128	34	142	0	3314
738	3166	110	42	45	0	3363
739	3263	38	31	29	0	3361
740	142	30	3344	32	0	3548
741	3443	24	131	24	0	3622
742	3580	24	39	25	0	3668
743	3591	20	24	26	0	3661
744	3681	12	32	21	0	3746
745	170	3905	29	22	0	4126
746	37	106	10	3446	0	3599
747	27	35	3379	108	0	3549
748	35	25	3436	35	0	3531
749	2657	5	81	16	0	2759
750	2809	13	23	9	0	2854
751	89	2676	13	14	0	2792
752	2778	72	9	13	0	2872
753	83	2729	10	10	0	2832
754	30	77	4	2777	0	2888
755	2784	16	7	83	0	2890
756	2787	14	8	20	0	2829
757	2804	10	7	12	0	2833
758	96	2720	10	11	0	2837
759	2777	74	11	12	0	2874
760	98	13	6	2780	0	2897
761	2798	13	9	81	0	2901
762	96	11	2660	23	0	2790
763	30	2673	87	19	0	2809
764	2292	50	9	11	0	2362
765	65	19	2204	13	0	2301
766	21	10	57	2250	0	2338
767	21	13	2254	53	0	2341
768	21	12	2246	12	0	2291
769	25	6	62	2249	0	2342
770	22	11	2232	56	0	2321
771	19	10	58	2246	0	2333
772	13	14	23	2317	0	2367
773	2419	10	13	63	0	2505
774	62	2374	13	29	0	2478
775	20	2433	19	14	0	2486
776	26	2313	8	15	0	2362
777	24	76	2198	12	0	2310
778	15	24	53	1942	0	2034
779	14	22	1916	62	0	2014
780	1905	17	63	14	0	1999
781	1960	13	21	17	0	2011
782	73	1924	18	12	0	2027
783	28	65	12	1881	0	1986
784	29	1936	12	54	0	2031
785	1977	65	8	13	0	2063
786	66	23	9	1967	0	2065
787	29	19	1901	66	0	2015
788	22	1914	56	24	0	2016
789	20	66	3352	18	0	3456
790	12	22	63	3349	0	3446
791	23	13	3441	68	0	3545
792	3283	7	64	23	0	3377
793	70	15	3419	22	0	3526
794	27	3346	70	17	0	3460
795	19	57	30	3396	0	3502
796	22	19	24	3538	0	3603
797	3488	12	19	75	0	3594
798	3441	17	21	24	0	3503
799	75	3305	19	28	0	3427
800	23	41	2679	10	0	2753
801	17	15	2608	13	0	2653
802	2614	9	45	11	0	2679
803	54	12	2701	5	0	2772
804	19	12	2649	6	0	2686
805	24	16	2617	8	0	2665
806	20	10	2651	9	0	2690
807	13	2608	60	15	0	2696
808	2738	46	22	7	0	2813
809	49	13	24	2687	0	2773
810	2754	12	18	48	0	2832
811	53	2653	13	15	0	2734
812	2715	46	18	8	0	2787
813	57	2639	11	14	0	2721
814	14	49	15	2651	0	2729
815	23	2669	15	39	0	2746
816	16	52	2611	14	0	2693
817	16	2440	50	16	0	2522
818	17	50	19	2857	0	2943
819	2851	17	16	64	0	2948
820	65	18	10	2865	0	2958
821	20	19	2820	63	0	2922
822	23	17	53	2731	0	2824
823	15	2735	18	65	0	2833
824	20	52	2786	11	0	2869
825	2631	14	60	24	0	2729
826	59	23	29	2847	0	2958
827	2846	17	20	63	0	2946
828	2830	12	26	22	0	2890
829	65	2761	25	22	0	2873
830	2862	52	20	21	0	2955
831	2863	20	16	17	0	2916
832	65	2763	19	17	0	2864
833	37	55	16	2836	0	2944
834	25	25	12	2865	0	2927
835	21	3011	20	65	0	3117
836	21	86	13	3147	0	3267
837	14	39	3021	94	0	3168
838	12	35	83	3073	0	3203
839	23	23	3081	102	0	3229
840	11	21	2709	26	0	2767
841	10	2617	74	30	0	2731
842	11	2719	39	12	0	2781
843	11	2756	27	21	0	2815
844	4	71	9	2650	0	2734
845	6	27	2234	52	0	2319
846	2188	26	46	17	0	2277
847	51	6	23	2321	0	2401
848	17	14	2270	53	0	2354
849	14	13	2233	24	0	2284
850	6	2161	59	21	0	2247
851	9	52	28	2282	0	2371
852	2252	20	14	54	0	2340
853	46	2230	11	24	0	2311
854	22	2292	15	15	0	2344
855	15	2301	10	11	0	2337
856	4	64	7	2274	0	2349
857	5	2239	15	45	0	2304
858	9	62	6	2304	0	2381
859	7	24	12	2351	0	2394
860	8	24	2229	63	0	2324
861	1774	14	53	45	0	1886
862	50	15	2227	22	0	2314
863	21	12	65	2187	0	2285
864	21	16	2228	55	0	2320
865	5	2107	73	22	0	2207
866	2267	58	23	28	0	2376
867	46	25	20	2214	0	2305
868	16	21	23	2291	0	2351
869	2274	14	15	65	0	2368
870	2219	16	17	34	0	2286
871	2855	11	14	23	0	2903
872	77	19	2789	16	0	2901
873	2472	7	51	14	0	2544
874	60	2510	27	9	0	2606
875	19	2645	15	20	0	2699
876	17	53	11	2692	0	2773
877	10	32	16	2684	0	2742
878	12	2630	7	58	0	2707
879	8	46	6	2693	0	2753
880	2561	21	6	63	0	2651
881	49	19	2598	25	0	2691
882	17	2512	51	24	0	2604
883	2630	51	17	12	0	2710
884	40	2600	21	26	0	2687
885	23	57	2563	15	0	2658
886	18	27	49	2482	0	2576
887	9	26	2592	54	0	2681
888	10	2442	68	31	0	2551
889	16	48	24	1296	0	1384
890	10	29	1245	47	0	1331
891	17	24	1241	28	0	1310
892	11	10	60	1285	0	1366
893	1285	21	31	45	0	1382
894	1300	11	16	25	0	1352
895	1321	10	12	21	0	1364
896	64	14	1243	18	0	1339
897	34	1233	47	19	0	1333
898	23	42	19	1268	0	1352
899	16	23	22	1275	0	1336
900	9	1265	17	65	0	1356
901	1259	41	16	35	0	1351
902	50	26	12	1282	0	1370
903	24	26	1237	48	0	1335
904	22	1236	39	37	0	1334
905	1251	51	23	23	0	1348
906	44	1269	13	18	0	1344
907	19	55	13	1251	0	1338
908	25	21	16	1284	0	1346
909	13	23	19	1299	0	1354
910	16	13	1220	66	0	1315
911	12	16	48	1248	0	1324
912	9	1185	28	53	0	1275
913	8	1217	24	29	0	1278
914	10	58	1448	31	0	1547
915	1434	34	47	17	0	1532
916	1523	24	19	20	0	1586
917	57	1484	16	23	0	1580
918	1191	34	9	8	0	1242
919	1206	15	10	14	0	1245
920	42	1145	10	10	0	1207
921	27	32	6	1156	0	1221
922	17	19	1108	32	0	1176
923	9	19	1064	20	0	1112
924	1123	12	41	14	0	1190
925	28	1094	27	10	0	1159
926	16	29	14	1159	0	1218
927	13	14	10	1190	0	1227
928	4	22	7	1196	0	1229
929	1169	8	4	45	0	1226
930	37	6	7	1174	0	1224
931	19	5	7	1204	0	1235
932	17	8	1134	43	0	1202
933	1031	7	30	29	0	1097
934	35	1104	24	13	0	1176
935	889	0	3	0	0	892
936	2	824	5	1	0	832
937	0	2	0	884	0	886
938	886	0	1	0	0	887
939	866	2	1	0	0	869
940	0	0	1931	1	0	1932
941	1897	0	28	0	0	1925
942	28	0	2002	0	0	2030
943	10	5	1999	0	0	2014
944	10	1	1942	0	0	1953
945	0	7	2421	3	0	2431
946	1	0	62	2432	0	2495
947	2	9	2427	44	0	2482
948	1	5	61	2528	0	2595
949	2448	1	24	66	0	2539
950	46	3	19	2510	0	2578
951	2304	4	3	71	0	2382
952	56	2442	8	20	0	2526
953	16	42	3	2505	0	2566
954	24	54	2988	46	0	3112
955	1	3375	44	28	0	3448
956	2	44	22	3441	0	3509
957	6	29	3375	46	0	3456
958	2	3471	74	28	0	3575
959	4	3604	36	23	0	3667
960	13	86	3612	1	0	3712
961	3	41	77	3566	0	3687
962	2	30	3641	71	0	3744
963	3556	2	96	28	0	3682
964	3713	3	31	28	0	3775
965	89	3592	34	12	0	3727
966	3736	66	13	17	0	3832
967	97	26	11	3717	0	3851
968	28	30	3595	83	0	3736
969	3505	5	71	31	0	3612
970	74	15	3544	35	0	3668
971	29	3076	90	13	0	3208
972	3182	72	30	20	0	3304
973	78	27	33	3179	0	3317
974	26	35	3111	72	0	3244
975	3163	11	81	30	0	3285
976	3166	9	44	30	0	3249
977	3187	11	35	13	0	3246
978	108	8	21	3162	0	3299
979	51	8	21	3241	0	3321
980	41	18	3033	97	0	3189
981	15	3095	89	56	0	3255
982	21	67	42	3078	0	3208
983	19	33	35	3239	0	3326
984	19	32	3164	99	0	3314
985	21	8	3139	63	0	3231
986	20	11	117	3177	0	3325
987	3064	18	61	87	0	3230
988	82	3117	50	45	0	3294
989	3120	78	30	47	0	3275
990	99	3105	38	21	0	3263
991	46	103	3104	29	0	3282
992	46	38	3120	18	0	3222
993	2974	39	125	20	0	3158
994	3440	16	66	23	0	3545
995	114	3372	47	39	0	3572
996	72	87	3415	17	0	3591
997	46	50	95	3417	0	3608
998	28	41	59	3349	0	3477
999	20	3414	62	126	0	3622
1000	28	92	37	3517	0	3674
1001	24	49	3376	131	0	3580
1002	3369	41	106	63	0	3579
1003	3511	29	62	51	0	3653
1004	3493	30	53	33	0	3609
1005	3585	17	48	28	0	3678
1006	150	26	3360	42	0	3578
1007	3417	21	121	31	0	3590
1008	148	32	3335	19	0	3534
1009	73	3327	126	37	0	3563
1010	62	100	67	3431	0	3660
1011	3491	40	58	110	0	3699
1012	116	48	41	3473	0	3678
1013	53	34	3385	124	0	3596
1014	3179	32	99	74	0	3384
1015	3245	26	65	58	0	3394
1016	133	28	57	3164	0	3382
1017	84	18	37	3297	0	3436
1018	72	26	3039	137	0	3274
1019	47	3143	96	82	0	3368
1020	3229	98	54	55	0	3436
1021	127	58	3056	37	0	3278
1022	3111	43	97	46	0	3297
1023	135	3161	73	27	0	3396
1024	3154	98	59	29	0	3340
1025	141	3108	39	33	0	3321
1026	73	3224	41	32	0	3370
1027	64	133	40	3133	0	3370
1028	45	62	38	3241	0	3386
1029	49	44	41	3243	0	3377
1030	51	29	32	3302	0	3414
1031	48	28	3053	161	0	3290
1032	3150	34	94	95	0	3373
1033	3258	20	62	64	0	3404
1034	3296	29	55	49	0	3429
1035	169	18	49	3170	0	3406
1036	104	20	33	3276	0	3433
1037	3246	23	35	134	0	3438
1038	3229	22	30	77	0	3358
1039	3337	25	27	73	0	3462
1040	92	12	8	1979	0	2091
1041	57	4	12	2002	0	2075
1042	33	21	1905	68	0	2027
1043	13	14	1863	46	0	1936
1044	16	1905	62	40	0	2023
1045	1442	28	15	14	0	1499
1046	1461	12	14	6	0	1493
1047	1460	4	13	13	0	1490
1048	51	6	1418	8	0	1483
1049	1413	3	35	10	0	1461
1050	1452	9	10	12	0	1483
1051	1453	2	9	11	0	1475
1052	44	10	12	1390	0	1456
1053	26	7	6	1399	0	1438
1054	19	4	8	609	0	640
1055	22	5	533	42	0	602
1056	561	8	30	20	0	619
1057	38	572	13	17	0	640
1058	328	13	6	5	0	352
1059	21	328	2	2	0	353
1060	13	337	0	3	0	353
1061	9	19	5	328	0	361
1062	8	7	1	326	0	342
1063	3	326	1	22	0	352
1064	334	11	2	13	0	360
1065	341	6	2	10	0	359
1066	18	6	5	331	0	360
1067	13	3	323	21	0	360
1068	8	1	333	12	0	354
1069	7	4	339	6	0	356
1070	5	2	337	11	0	355
1071	329	4	21	4	0	358
1072	336	3	8	3	0	350
1073	26	3	5	330	0	364
1074	17	3	310	12	0	342
1075	10	0	14	309	0	333
1076	7	312	8	17	0	344
1077	8	337	6	8	0	359
1078	332	14	8	6	0	360
1079	341	8	3	7	0	359
1080	344	4	3	8	0	359
1081	20	4	1	334	0	359
1082	12	0	5	341	0	358
1083	11	1	8	341	0	361
1084	12	4	2	338	0	356
1085	13	2	310	17	0	342
1086	11	4	9	338	0	362
1087	330	3	3	23	0	359
1088	15	0	4	342	0	361
1089	6	2	4	342	0	354
1090	9	3	3	329	0	344
1091	10	311	5	18	0	344
1092	7	317	1	10	0	335
1093	8	338	1	9	0	356
1094	0	0	0	10	0	10
1095	0	0	0	9	0	9
1096	10	0	0	0	0	10
1097	11	0	0	0	0	11
1098	10	0	0	0	0	10
1099	2	0	0	500	0	502
1100	0	0	0	444	0	444
1101	0	468	0	7	0	475
1102	0	505	0	6	0	511
1103	495	9	0	3	0	507
1104	4	5	0	509	0	518
1105	503	2	0	8	0	513
1106	511	4	0	4	0	519
1107	10	4	0	445	0	459
1108	8	827	2	6	0	843
1109	871	5	1	6	0	883
1110	876	4	0	2	0	882
1111	12	3	1154	14	0	1183
1112	1179	2	5	9	0	1195
1113	7	1164	10	1	0	1182
1114	9	13	1	1216	0	1239
1115	1226	5	1	11	0	1243
1116	8	5	3	1222	0	1238
1117	18	5	0	1160	0	1183
1118	13	1178	1	11	0	1203
1119	1209	5	0	16	0	1230
1120	1207	12	0	7	0	1226
1121	22	1132	3	9	0	1166
1122	16	1176	3	9	0	1204
1123	1231	21	8	8	0	1268
1124	1245	12	1	4	0	1262
1125	19	16	1213	4	0	1252
1126	15	9	1145	10	0	1179
1127	20	5	1560	6	0	1591
1128	14	3	10	1567	0	1594
1129	11	6	6	1615	0	1638
1130	12	12	1586	14	0	1624
1131	1570	3	9	11	0	1593
1132	1632	5	9	11	0	1657
1133	1639	11	4	9	0	1663
1134	1630	11	5	5	0	1651
1135	32	7	1614	5	0	1658
1136	1611	10	7	3	0	1631
1137	1630	9	13	6	0	1658
1138	1614	3	11	11	0	1639
1139	1617	2	13	8	0	1640
1140	1606	2	8	21	0	1637
1141	20	6	1576	16	0	1618
1142	17	1513	22	3	0	1555
1143	28	12	6	1605	0	1651
1144	24	8	2	1619	0	1653
1145	21	7	1592	16	0	1636
1146	1537	8	12	5	0	1562
1147	23	8	18	1601	0	1650
1148	29	1	1615	16	0	1661
1149	24	5	1514	11	0	1554
1150	18	1512	24	10	0	1564
1151	25	8	12	1597	0	1642
1152	20	8	8	1611	0	1647
1153	17	5	16	1627	0	1665
1154	1629	11	8	10	0	1658
1155	24	7	4	1623	0	1658
1156	21	3	1581	22	0	1627
1157	16	10	1538	16	0	1580
1158	26	9	2378	12	0	2425
1159	16	4	20	2389	0	2429
1160	2507	0	24	13	0	2544
1161	23	5	2451	10	0	2489
1162	2439	10	10	12	0	2471
1163	2501	7	15	20	0	2543
1164	23	4	13	2471	0	2511
1165	22	9	5	2438	0	2474
1166	19	2373	12	27	0	2431
1167	21	9	2399	26	0	2455
1168	2365	4	26	16	0	2411
1169	23	1	24	2456	0	2504
1170	16	2387	18	20	0	2441
1171	11	12	16	2508	0	2547
1172	24	9	2471	12	0	2516
1173	16	7	25	2390	0	2438
1174	21	2366	17	21	0	2425
1175	19	15	8	2509	0	2551
1176	2476	7	7	30	0	2520
1177	21	5	7	2442	0	2475
1178	18	2366	9	22	0	2415
1179	11	2414	27	18	0	2470
1180	2406	9	12	17	0	2444
1181	21	13	2427	19	0	2480
1182	16	12	20	2433	0	2481
1183	18	7	15	2913	0	2953
1184	15	9	2852	19	0	2895
1185	15	2738	13	32	0	2798
1186	15	19	2840	19	0	2893
1187	13	8	12	2750	0	2783
1188	18	3292	20	24	0	3354
1189	3469	11	14	22	0	3516
1190	16	3263	20	10	0	3309
1191	17	3276	23	10	0	3326
1192	3505	14	11	15	0	3545
1193	3413	14	13	15	0	3455
1194	3469	11	9	19	0	3508
1195	23	11	11	3431	0	3476
1196	21	7	3350	20	0	3398
1197	3251	14	15	18	0	3298
1198	3746	5	22	20	0	3793
1199	5	0	0	3251	0	3256
1200	2	3	3233	5	0	3243
1201	2	3111	13	2	0	3128
1202	3271	4	1	1	0	3277
1203	3247	1	0	1	0	3249
1204	5	3136	5	2	0	3148
1205	1	3163	5	3	0	3172
1206	3290	4	0	0	0	3294
1207	3238	1	0	1	0	3240
1208	2915	2	0	0	0	2917
1209	7	2	0	2896	0	2905
1210	2	5	2877	4	0	2888
1211	0	4	5	2543	0	2552
1212	2	9	2533	4	0	2548
1213	3	2420	6	2	0	2431
1214	2	2897	6	4	0	2909
1215	4	9	0	2993	0	3006
1216	5	2	0	3000	0	3007
1217	5	1	2	2966	0	2974
1218	5	2908	3	5	0	2921
1219	2994	4	1	4	0	3003
1220	2904	4	2	6	0	2916
1221	6	2927	3	4	0	2940
1222	4	10	2	3003	0	3019
1223	4	2964	8	4	0	2980
1224	6	10	0	3006	0	3022
1225	4	2927	2	6	0	2939
1226	3014	4	3	8	0	3029
1227	6	3	2	2618	0	2629
1228	7	10	3107	7	0	3131
1229	3116	3	9	4	0	3132
1230	3214	2	3	4	0	3223
1231	9	7	3114	4	0	3134
1232	3	5	6	3136	0	3150
1233	5	9	3166	9	0	3189
1234	3	6	5	3161	0	3175
1235	5	10	3138	10	0	3163
1236	3008	6	5	4	0	3023
1237	9	6	1	3190	0	3206
1238	7	3009	15	7	0	3038
1239	3227	8	2	3	0	3240
1240	10	10	0	3185	0	3205
1241	11	5	3	3213	0	3232
1242	7	6	3142	15	0	3170
1243	6	4	7	3454	0	3471
1244	8	8	3453	22	0	3491
1245	11	10	4270	13	0	4304
1246	11	5	25	4395	0	4436
1247	8	14	4696	18	0	4736
1248	4739	7	40	19	0	4805
1249	5359	6	19	10	0	5394
1250	5293	8	6	14	0	5321
1251	92	5188	11	17	0	5308
1252	46	55	7	5333	0	5441
1253	28	33	8	5233	0	5302
1254	11	5239	9	83	0	5342
1255	5355	64	9	44	0	5472
1256	62	37	5	5312	0	5416
1257	39	21	5590	73	0	5723
1258	30	22	4568	43	0	4663
1259	20	5050	108	25	0	5203
1260	5381	72	42	16	0	5511
1261	77	45	5213	9	0	5344
1262	4982	16	80	13	0	5091
1263	82	4906	57	18	0	5063
1264	44	74	5255	6	0	5379
1265	32	34	5156	12	0	5234
1266	17	20	5182	14	0	5233
1267	11	4876	141	23	0	5051
1268	10	81	5192	12	0	5295
1269	5469	39	99	11	0	5618
1270	80	15	47	5531	0	5673
1271	51	16	21	5674	0	5762
1272	38	10	7	5763	0	5818
1273	24	10	9	5780	0	5823
1274	23	15	6380	131	0	6549
1275	20	11	82	6462	0	6575
1276	20	8	44	6678	0	6750
1277	6578	20	25	132	0	6755
1278	7032	14	27	66	0	7139
1279	7014	9	14	38	0	7075
1280	156	50	6665	24	0	6895
1281	73	6888	125	20	0	7106
1282	38	7246	57	32	0	7373
1283	6625	147	35	21	0	6828
1284	100	6827	42	20	0	6989
1285	47	132	18	6936	0	7133
1286	30	49	20	7482	0	7581
1287	26	42	7030	159	0	7257
1288	20	6411	133	75	0	6639
1289	22	112	6667	44	0	6845
1290	6537	51	146	24	0	6758
1291	6867	26	66	20	0	6979
1292	153	19	40	6831	0	7043
1293	79	19	27	6923	0	7048
1294	40	17	19	7010	0	7086
1295	33	13	15	7058	0	7119
1296	28	25	6682	198	0	6933
1297	23	13	130	6824	0	6990
1298	14	18	6386	147	0	6565
1299	22	38	6134	71	0	6265
1300	23	6140	170	35	0	6368
1301	6424	111	57	30	0	6622
1302	121	6268	58	31	0	6478
1303	56	124	27	6439	0	6646
1304	32	67	6322	130	0	6551
1305	6239	30	121	53	0	6443
1306	132	25	6303	39	0	6499
1307	6395	23	134	31	0	6583
1308	6521	22	68	25	0	6636
1309	160	11	39	6443	0	6653
1310	76	19	35	6503	0	6633
1311	56	24	27	6642	0	6749
1312	33	35	6226	187	0	6481
1313	6112	17	138	79	0	6346
1314	136	5724	81	47	0	5988
1315	81	120	42	6087	0	6330
1316	6706	56	31	146	0	6939
1317	6773	35	22	79	0	6909
1318	6752	33	27	67	0	6879
1319	188	30	6451	60	0	6729
1320	6513	30	131	65	0	6739
1321	6678	27	72	57	0	6834
1322	193	35	6594	47	0	6869
1323	84	33	6895	50	0	7062
1324	60	25	204	6889	0	7178
1325	37	45	6829	169	0	7080
1326	35	6552	214	83	0	6884
1327	41	6879	109	56	0	7085
1328	6320	191	73	31	0	6615
1329	178	6373	63	27	0	6641
1330	80	185	48	6489	0	6802
1331	6303	65	49	172	0	6589
1332	165	6371	55	88	0	6679
1333	64	166	41	6496	0	6767
1334	48	68	40	6646	0	6802
1335	41	53	6291	224	0	6609
1336	46	30	157	6410	0	6643
1337	53	34	6296	235	0	6618
1338	44	30	6301	119	0	6494
1339	56	21	197	6313	0	6587
1340	51	29	81	6530	0	6691
1341	6417	33	64	213	0	6727
1342	185	8192	44	125	0	8546
1343	77	221	32	7958	0	8288
1344	76	98	30	8240	0	8444
1345	6966	71	25	299	0	7361
1346	236	6893	45	160	0	7334
1347	90	6667	39	118	0	6914
1348	69	6439	31	64	0	6603
1349	32	6228	25	43	0	6328
1350	6069	239	19	29	0	6356
1351	6181	108	26	34	0	6349
1352	6198	78	16	36	0	6328
1353	6270	37	20	39	0	6366
1354	250	32	20	6102	0	6404
1355	107	50	5812	188	0	6157
1356	69	5809	180	76	0	6134
1357	46	171	58	5839	0	6114
1358	38	76	5707	174	0	5995
1359	33	63	146	5214	0	5456
1360	36	24	58	5389	0	5507
1361	29	38	5134	198	0	5399
1362	22	17	156	5244	0	5439
1363	22	23	63	5338	0	5446
1364	5253	26	66	219	0	5564
1365	5326	33	31	124	0	5514
1366	5375	29	32	100	0	5536
1367	5413	25	25	61	0	5524
1368	254	21	21	5198	0	5494
1369	126	21	20	5059	0	5226
1370	104	24	14	5155	0	5297
1371	4925	42	21	256	0	5244
1372	183	39	13	5009	0	5244
1373	85	30	14	5158	0	5287
1374	90	35	3790	218	0	4133
1375	65	25	134	3915	0	4139
1376	64	3819	45	207	0	4135
1377	43	4089	51	98	0	4281
1378	3503	163	23	89	0	3778
1379	152	88	3346	60	0	3646
1380	59	3205	117	53	0	3434
1381	3251	127	46	37	0	3461
1382	136	60	47	3262	0	3505
1383	65	59	3121	138	0	3383
1384	60	30	119	3059	0	3268
1385	28	3178	50	169	0	3425
1386	2767	127	59	78	0	3031
1387	112	2869	29	79	0	3089
1388	2885	159	21	57	0	3122
1389	2979	65	19	48	0	3111
1390	179	63	15	2854	0	3111
1391	113	27	17	2822	0	2979
1392	87	2799	22	163	0	3071
1393	2896	121	11	116	0	3144
1394	157	59	2781	88	0	3085
1395	2895	64	113	58	0	3130
1396	3016	39	40	51	0	3146
1397	191	38	2763	54	0	3046
1398	107	23	127	2894	0	3151
1399	2904	24	58	163	0	3149
1400	148	28	2838	91	0	3105
1401	83	44	2814	83	0	3024
1402	2783	33	155	62	0	3033
1403	151	2770	107	60	0	3088
1404	93	2916	67	35	0	3111
1405	86	160	34	2853	0	3133
1406	63	113	2775	136	0	3087
1407	2833	80	116	83	0	3112
1408	141	57	2760	92	0	3050
1409	80	2828	157	64	0	3129
1410	2861	151	55	53	0	3120
1411	170	82	54	2857	0	3163
1412	2913	78	27	161	0	3179
1413	195	48	2691	101	0	3035
1414	99	56	132	2765	0	3052
1415	102	2819	55	146	0	3122
1416	54	150	56	2322	0	2582
1417	65	88	49	2457	0	2659
1418	88	74	2219	180	0	2561
1419	81	2262	129	125	0	2597
1420	73	2357	69	95	0	2594
1421	75	158	2326	83	0	2642
1422	1949	68	109	70	0	2196
1423	2035	55	78	57	0	2225
1424	146	33	67	1988	0	2234
1425	2019	35	47	116	0	2217
1426	144	1883	48	75	0	2150
1427	80	2018	37	93	0	2228
1428	2010	130	21	70	0	2231
1429	120	86	36	2009	0	2251
1430	2032	54	37	123	0	2246
1431	2085	30	24	94	0	2233
1432	163	39	25	2034	0	2261
1433	131	39	1856	116	0	2142
1434	2035	31	85	84	0	2235
1435	2069	34	50	73	0	2226
1436	166	35	41	1924	0	2166
1437	116	1911	35	120	0	2182
1438	79	86	39	2034	0	2238
1439	75	60	1830	145	0	2110
1440	62	62	1903	91	0	2118
1441	39	1988	133	115	0	2275
1442	2	0	1	9	0	12
1443	0	1	0	8	0	9
1444	1	0	8	0	0	9
1445	7	0	1	1	0	9
1446	8	0	1	1	0	10
1447	8	1	0	0	0	9
1448	8	0	0	1	0	9
1449	0	7	0	1	0	8
1450	1	8	1	0	0	10
1451	7	2	0	0	0	9
1452	0	2	0	8	0	10
1453	0	0	1	8	0	9
1454	1	8	0	1	0	10
1455	1	0	0	8	0	9
1456	0	1	0	9	0	10
1457	1	8	0	1	0	10
1458	0	1	8	1	0	10
1459	0	2	0	8	0	10
1460	9	0	1	0	0	10
1461	8	0	0	2	0	10
1462	2	0	7	0	0	9
1463	2	0	7	0	0	9
1464	0	0	7	1	0	8
1465	0	1	2	7	0	10
1466	1	0	8	1	0	10
1467	1	0	6	1	0	8
1468	0	0	2	8	0	10
1469	0	9	1	0	0	10
1470	0	1	7	1	0	9
1471	0	9	2	0	0	11
1472	9	0	2	0	0	11
1473	1	11	0	0	0	12
1474	0	0	0	10	0	10
1475	9	1	0	1	0	11
1476	0	1	1	9	0	11
1477	1	1	0	7	0	9
1478	2	0	9	1	0	12
1479	1	9	0	2	0	12
1480	2	8	1	0	0	11
1481	1	2	0	9	0	12
1482	0	2	0	10	0	12
1483	1	0	1	8	0	10
1484	1	0	9	1	0	11
1485	1	0	8	1	0	10
1486	6	0	1	1	0	8
1487	0	1	7	0	0	8
1488	1	0	7	1	0	9
1489	0	7	2	0	0	9
1490	0	1	1	7	0	9
1491	0	1	7	1	0	9
1492	0	0	1	7	0	8
1493	0	0	6	2	0	8
1494	0	0	2	6	0	8
1495	1	0	6	0	0	7
1496	1	0	1	6	0	8
1497	0	0	0	7	0	7
1498	1	6	0	1	0	8
1499	0	1	0	5	0	6
1500	0	8	0	0	0	8
1501	1	1	0	7	0	9
1502	0	0	0	9	0	9
1503	7	0	0	2	0	9
1504	1	1	0	7	0	9
1505	0	0	7	1	0	8
1506	0	0	1	7	0	8
1507	0	1	0	8	0	9
1508	0	0	8	1	0	9
1509	0	0	8	1	0	9
1510	1	0	2	7	0	10
1511	1	1	0	8	0	10
1512	0	1	8	1	0	10
1513	0	6	2	1	0	9
1514	0	6	1	0	0	7
1515	6	1	1	1	0	9
1516	1	0	1	267	0	269
1517	546	0	1	1	0	548
1518	542	0	0	0	0	542
1519	1	493	1	2	0	497
1520	551	1	0	0	0	552
1521	544	1	0	0	0	545
1522	1	0	532	1	0	534
1523	1	0	2	528	0	531
1524	0	0	536	2	0	538
1525	0	0	2	534	0	536
1526	1	1	539	2	0	543
1527	0	504	5	0	0	509
1528	0	527	1	1	0	529
1529	0	1	0	550	0	551
1530	545	1	0	1	0	547
1531	1	0	0	535	0	536
1532	0	1	0	527	0	528
1533	0	0	547	2	0	549
1534	0	0	534	1	0	535
1535	1	0	536	0	0	537
1536	0	0	1	519	0	520
1537	0	0	1	544	0	545
1538	0	510	2	2	0	514
1539	0	522	0	1	0	523
1540	546	1	1	0	0	548
1541	1	525	1	2	0	529
1542	0	2	523	1	0	526
1543	1	0	1	514	0	516
1544	0	1	535	0	0	536
1545	0	526	2	0	0	528
1546	0	2	0	545	0	547
1547	533	0	0	1	0	534
1548	1	0	525	2	0	528
1549	1	495	0	0	0	496
1550	1	2	513	1	0	517
1551	0	511	3	0	0	514
1552	1	1	0	538	0	540
1553	537	0	0	2	0	539
1554	536	0	1	0	0	537
1555	1	512	0	1	0	514
1556	540	1	0	0	0	541
1557	1	0	0	526	0	527
1558	530	0	3	0	0	533
1559	1	1	521	0	0	523
1560	0	2	491	0	0	493
1561	0	0	1	496	0	497
1562	1	0	0	527	0	528
1563	0	0	523	2	0	525
1564	0	0	1	517	0	518
1565	526	0	1	1	0	528
1566	526	0	1	0	0	527
1567	1	495	1	0	0	497
1568	0	500	1	2	0	503
1569	526	1	1	1	0	529
1570	1	2	1	521	0	525
1571	531	2	0	1	0	534
1572	2	496	1	1	0	500
1573	530	2	0	0	0	532
1574	1	1	488	1	0	491
1575	1	1	490	1	0	493
1576	0	0	2	501	0	503
1577	0	3	516	1	0	520
1578	1	0	1	514	0	516
1579	1	0	0	508	0	509
1580	0	0	515	1	0	516
1581	0	0	1	506	0	507
1582	1	1	1	761	0	764
1583	0	0	770	13	0	783
1584	0	0	766	2	0	768
1585	746	2	14	0	0	762
1586	13	1	758	0	0	772
1587	757	0	10	0	0	767
1588	781	0	3	0	0	784
1589	15	2	747	1	0	765
1590	2	2	773	1	0	778
1591	0	0	12	755	0	767
1592	1	0	3	744	0	748
1593	0	754	3	12	0	769
1594	0	765	1	4	0	770
1595	0	16	751	0	0	767
1596	740	5	9	1	0	755
1597	760	1	3	0	0	764
1598	16	3	754	0	0	773
1599	4	2	749	0	0	755
1600	1	0	16	741	0	758
1601	0	730	4	10	0	744
1602	0	13	1	763	0	777
1603	0	6	0	772	0	778
1604	761	0	1	17	0	779
1605	766	0	0	3	0	769
1606	13	0	1	768	0	782
1607	3	3	735	12	0	753
1608	725	1	10	4	0	740
1609	12	727	8	0	0	747
1610	769	12	0	1	0	782
1611	763	2	0	0	0	765
1612	15	739	1	0	0	755
1613	3	756	2	2	0	763
1614	0	15	0	771	0	786
1615	0	3	0	763	0	766
1616	0	516	2	16	0	534
1617	0	11	1	263	0	275
1618	1	3	0	502	0	506
1619	1	2	488	16	0	507
1620	507	0	12	3	0	522
1621	517	1	3	1	0	522
1622	519	0	2	0	0	521
1623	18	0	0	509	0	527
1624	497	1	0	14	0	512
1625	15	496	0	7	0	518
1626	3	17	0	450	0	470
1627	3	488	1	14	0	506
1628	0	519	0	2	0	521
1629	507	15	1	1	0	524
1630	520	4	0	0	0	524
1631	527	1	0	0	0	528
1632	525	0	0	1	0	526
1633	531	0	1	0	0	532
1634	18	1	494	0	0	513
1635	521	0	13	0	0	534
1636	16	2	488	1	0	507
1637	512	1	13	1	0	527
1638	528	0	3	1	0	532
1639	532	1	2	0	0	535
1640	20	2	481	3	0	506
1641	6	0	15	471	0	492
1642	3	511	2	14	0	530
1643	515	15	0	4	0	534
1644	519	4	1	2	0	526
1645	18	510	0	0	0	528
1646	519	14	0	1	0	534
1647	17	3	1	479	0	500
1648	5	509	3	13	0	530
1649	512	13	0	3	0	528
1650	523	2	2	2	0	529
1651	20	2	3	517	0	542
1652	509	1	3	15	0	528
1653	20	0	4	510	0	534
1654	7	0	7	531	0	545
1655	9	0	500	18	0	527
1656	7	1	15	513	0	536
1657	7	0	7	531	0	545
1658	5	0	503	20	0	528
1659	4	4	512	6	0	526
1660	3	4	16	522	0	545
1661	2	2	505	21	0	530
1662	513	8	14	3	0	538
1663	20	513	4	4	0	541
1664	12	15	3	490	0	520
1665	8	6	1	527	0	542
1666	12	2	2	527	0	543
1667	524	3	2	20	0	549
1668	531	1	4	8	0	544
1669	526	4	3	3	0	536
1670	23	512	1	4	0	540
1671	9	15	2	516	0	542
1672	9	4	2	531	0	546
1673	521	1	3	20	0	545
1674	533	1	2	10	0	546
1675	22	0	7	522	0	551
1676	10	2	490	17	0	519
1677	820	5	14	5	0	844
1678	833	0	9	5	0	847
1679	25	2	786	2	0	815
1680	803	6	14	2	0	825
1681	22	6	793	2	0	823
1682	1259	1	4	3	0	1267
1683	7	4	0	1247	0	1258
1684	6	1221	2	8	0	1237
1685	7	3	1227	3	0	1240
1686	7	1214	1	6	0	1228
1687	6	1225	0	2	0	1233
1688	1296	3	1	5	0	1305
1689	4	1	2	1267	0	1274
1690	2	4	3	1257	0	1266
1691	1757	1	0	8	0	1766
1692	6	0	2	1722	0	1730
1693	1	1	6	1692	0	1700
1694	7	1	3	1706	0	1717
1695	3	1	2	1688	0	1694
1696	3	0	1732	7	0	1742
1697	5	2	1647	3	0	1657
1698	2	1629	5	9	0	1645
1699	1711	2	5	5	0	1723
1700	5	2	4	2381	0	2392
1701	2	2192	6	7	0	2207
1702	5	4	1	2405	0	2415
1703	3	3	4	2376	0	2386
1704	4	6	1	2369	0	2380
1705	4	5	1	2395	0	2405
1706	3	2	1	2391	0	2397
1707	2	2296	3	12	0	2313
1708	5	4	1	2421	0	2431
1709	7	1	2347	12	0	2367
1710	3	2278	8	12	0	2301
1711	8	2	3	2406	0	2419
1712	5	5	1	2371	0	2382
1713	5	2282	5	11	0	2303
1714	3	2329	5	5	0	2342
1715	2399	6	2	1	0	2408
1716	5	2296	8	3	0	2312
1717	2410	3	3	7	0	2423
1718	2102	1	1	0	0	2104
1719	4	2	3638	0	0	3644
1720	0	4	2	3359	0	3365
1721	3	3	3689	1	0	3696
1722	0	3719	8	3	0	3730
1723	1	0	0	3895	0	3896
1724	1	1	0	3931	0	3933
1725	0	0	1	3915	0	3916
1726	0	1	0	3935	0	3936
1727	1	2	4562	3	0	4568
1728	0	1	1	4512	0	4514
1729	0	1	4567	1	0	4569
1730	3	5	4435	0	0	4443
1731	4211	0	4	1	0	4216
1732	4505	0	0	0	0	4505
1733	4594	0	0	2	0	4596
1734	0	4320	3	4	0	4327
1735	0	3	0	4653	0	4656
1736	2	1	4511	0	0	4514
1737	0	2	1	4389	0	4392
1738	4	1	4481	1	0	4487
1739	4355	0	2	0	0	4357
1740	4514	1	0	3	0	4518
1741	4552	0	2	1	0	4555
1742	1	7	4343	0	0	4351
1743	2	8	4208	1	0	4219
1744	1	0	0	4332	0	4333
1745	0	0	0	4401	0	4401
1746	0	0	0	4527	0	4527
1747	2	2	4441	3	0	4448
1748	4	10	4051	0	0	4065
1749	4225	1	1	3	0	4230
1750	0	0	0	4490	0	4490
1751	0	3	0	4470	0	4473
1752	4567	0	0	2	0	4569
1753	0	0	0	4519	0	4519
1754	4560	0	1	2	0	4563
1755	4497	0	2	0	0	4499
1756	4315	0	4	3	0	4322
1757	3	1	4480	1	0	4485
1758	1	4121	10	4	0	4136
1759	4528	0	0	0	0	4528
1760	1	2	1	4463	0	4467
1761	1	3	0	4467	0	4471
1762	2	4291	7	1	0	4301
1763	4513	1	0	0	0	4514
1764	4429	1	0	3	0	4433
1765	4447	1	1	3	0	4452
1766	2	4233	7	4	0	4246
1767	5302	0	0	0	0	5302
1768	5262	0	1	4	0	5267
1769	5237	3	1	3	0	5244
1770	1	2	1	5094	0	5098
1771	1	1	0	5213	0	5215
1772	3	6	5766	5	0	5780
1773	1	5	1	5510	0	5517
1774	1	2	0	5804	0	5807
1775	5	3	5824	0	0	5832
1776	5504	3	1	5	0	5513
1777	5638	0	0	2	0	5640
1778	1	2	0	5526	0	5529
1779	1	5334	12	1	0	5348
1780	3	5405	16	4	0	5428
1781	1	8	0	5652	0	5661
1782	2	2	4926	0	0	4930
1783	1	4	3	5019	0	5027
1784	3	2	5270	2	0	5277
1785	3	7	5211	1	0	5222
1786	0	3	0	5321	0	5324
1787	5586	1	0	2	0	5589
1788	5433	0	4	3	0	5440
1789	2	4	0	5431	0	5437
1790	2	7	0	5424	0	5433
1791	1	0	0	5160	0	5161
1792	1	1	0	5707	0	5709
1793	5771	0	0	4	0	5775
1794	5605	0	0	3	0	5608
1795	5597	1	2	2	0	5602
1796	2	2	5606	0	0	5610
1797	2	2	1	5546	0	5551
1798	1	1	0	5699	0	5701
1799	5785	0	1	0	0	5786
1800	0	4777	10	5	0	4792
1801	5137	0	0	4	0	5141
1802	5063	1	0	2	0	5066
1803	5040	1	0	1	0	5042
1804	5030	1	1	2	0	5034
1805	6	7	4746	2	0	4761
1806	6	17	4317	1	0	4341
1807	4873	0	1	0	0	4874
1808	4990	0	1	4	0	4995
1809	4938	0	1	0	0	4939
1810	4917	0	0	3	0	4920
1811	4	9	5151	0	0	5164
1812	1	4840	21	6	0	4868
1813	4	2	0	6513	0	6519
1814	7171	1	5	39	0	7216
1815	7157	5	3	13	0	7178
1816	8261	0	2	15	0	8278
1817	8303	2	2	10	0	8317
1818	8313	2	3	7	0	8325
1819	6778	2	10	4	0	6794
1820	167	17	6332	3	0	6519
1821	65	13	6486	1	0	6565
1822	60	2	109	6205	0	6376
1823	53	12	6351	90	0	6506
1824	42	5972	136	28	0	6178
1825	37	6191	54	20	0	6302
1826	24	109	41	6390	0	6564
1827	19	51	5691	100	0	5861
1828	10	39	5468	42	0	5559
1829	5493	23	140	27	0	5683
1830	6671	22	57	22	0	6772
1831	182	23	46	7561	0	7812
1832	7701	17	31	178	0	7927
1833	209	11	29	7640	0	7889
1834	75	6	26	7842	0	7949
1835	56	5	7594	226	0	7881
1836	48	19	7514	69	0	7650
1837	31	5	211	7617	0	7864
1838	39	21	7516	211	0	7787
1839	7242	1	213	88	0	7544
1840	7780	1	75	54	0	7910
1841	218	8016	70	52	0	8356
1842	8377	164	46	32	0	8619
1843	226	51	8087	33	0	8397
1844	8190	26	207	16	0	8439
1845	8434	24	59	24	0	8541
1846	8509	13	43	14	0	8579
1847	287	24	32	7876	0	8219
1848	129	7939	39	170	0	8277
1849	8334	169	32	46	0	8581
1850	8426	45	35	35	0	8541
1851	265	28	27	8250	0	8570
1852	8343	26	19	207	0	8595
1853	259	8068	36	95	0	8458
1854	123	173	15	8344	0	8655
1855	76	73	8042	230	0	8421
1856	7496	42	192	91	0	7821
1857	231	53	8050	65	0	8399
1858	101	26	224	8204	0	8555
1859	90	8098	89	218	0	8495
1860	89	8701	70	82	0	8942
1861	72	261	54	8464	0	8851
1862	71	9678	63	219	0	10031
1863	71	332	53	12461	0	12917
1864	75	99	38	12843	0	13055
1865	54	76	40	13062	0	13232
1866	12434	67	38	559	0	13098
1867	444	53	19	12072	0	12588
1868	154	89	11231	574	0	12048
1869	110	11447	407	244	0	12208
1870	11738	419	105	134	0	12396
1871	487	120	56	11630	0	12293
1872	192	69	70	11530	0	11861
1873	138	71	46	11761	0	12016
1874	160	78	10660	583	0	11481
1875	103	10927	423	263	0	11716
1876	11204	414	130	172	0	11920
1877	473	140	91	10652	0	11356
1878	149	11056	113	480	0	11798
1879	11305	468	90	196	0	12059
1880	506	172	10929	138	0	11745
1881	11144	108	446	160	0	11858
1882	522	133	11019	114	0	11788
1883	226	122	10824	89	0	11261
1884	151	10635	557	108	0	11451
1885	149	441	196	10586	0	11372
1886	142	150	10394	483	0	11169
1887	127	10178	535	199	0	11039
1888	106	452	206	10157	0	10921
1889	94	10301	147	468	0	11010
1890	89	492	10378	171	0	11130
1891	73	177	489	10545	0	11284
1892	73	152	9936	552	0	10713
1893	80	111	481	10184	0	10856
1894	82	80	206	10591	0	10959
1895	87	96	9806	644	0	10633
1896	93	70	512	10254	0	10929
1897	9835	71	182	592	0	10680
1898	464	9837	147	283	0	10731
1899	179	466	9683	210	0	10538
1900	9986	143	492	178	0	10799
1901	546	96	178	9573	0	10393
1902	207	9840	139	481	0	10667
1903	10120	465	132	186	0	10903
1904	10889	179	101	145	0	11314
1905	577	123	98	10502	0	11300
1906	235	147	63	10881	0	11326
1907	180	98	80	11079	0	11437
1908	162	85	68	10932	0	11247
1909	123	10311	66	696	0	11196
1910	115	451	74	10391	0	11031
1911	109	9813	69	638	0	10629
1912	111	10187	92	323	0	10713
1913	75	9304	88	221	0	9688
1914	97	536	7901	211	0	8745
1915	69	8574	414	208	0	9265
1916	7266	425	109	179	0	7979
1917	366	7416	88	180	0	8050
1918	132	408	86	6859	0	7485
1919	109	7434	89	415	0	8047
1920	122	432	66	7368	0	7988
1921	96	204	76	7780	0	8156
1922	92	140	7196	514	0	7942
1923	7229	154	356	229	0	7968
1924	7559	117	110	210	0	7996
1925	7604	94	90	213	0	8001
1926	460	7272	114	204	0	8050
1927	179	593	105	7282	0	8159
1928	155	158	7062	477	0	7852
1929	119	7289	380	231	0	8019
1930	106	358	121	6041	0	6626
1931	89	5422	82	287	0	5880
1932	5484	318	87	121	0	6010
1933	5663	133	97	71	0	5964
1934	5690	107	97	75	0	5969
1935	5726	79	100	79	0	5984
1936	375	77	100	5434	0	5986
1937	149	76	98	5544	0	5867
1938	114	5363	78	341	0	5896
1939	104	301	59	5556	0	6020
1940	74	124	5265	373	0	5836
1941	51	101	276	5047	0	5475
1942	47	109	4764	379	0	5299
1943	43	4809	303	202	0	5357
1944	47	284	4849	133	0	5313
1945	39	103	335	4959	0	5436
1946	39	88	4826	362	0	5315
1947	32	81	323	4951	0	5387
1948	46	79	129	5129	0	5383
1949	66	74	94	5157	0	5391
1950	76	70	103	5160	0	5409
1951	4875	78	64	400	0	5417
1952	289	4856	52	196	0	5393
1953	4961	300	49	167	0	5477
1954	311	119	4731	147	0	5308
1955	4901	72	259	135	0	5367
1956	5165	93	68	122	0	5448
1957	397	76	4754	113	0	5340
1958	163	65	4653	119	0	5000
1959	122	4416	291	128	0	4957
1960	90	4491	87	120	0	4788
1961	78	293	4238	124	0	4733
1962	35	2888	171	82	0	3176
1963	0	0	0	443	0	443
1964	444	0	0	3	0	447
1965	0	1	0	439	0	440
1966	442	0	0	0	0	442
1967	440	0	0	0	0	440
1968	0	414	0	1	0	415
1969	451	0	0	1	0	452
1970	443	0	0	0	0	443
1971	0	0	0	421	0	421
1972	451	1	0	0	0	452
1973	0	417	0	2	0	419
1974	0	0	0	444	0	444
1975	445	0	0	0	0	445
1976	0	1	419	1	0	421
1977	786	0	0	0	0	786
1978	0	0	0	791	0	791
1979	1	1	784	0	0	786
1980	0	1	728	0	0	729
1981	741	0	0	0	0	741
1982	806	0	0	0	0	806
1983	0	0	0	781	0	781
1984	0	0	0	794	0	794
1985	0	1	0	802	0	803
1986	0	743	2	0	0	745
1987	805	0	0	2	0	807
1988	0	764	3	1	0	768
1989	790	0	0	0	0	790
1990	0	0	762	0	0	762
1991	1	1	0	757	0	759
1992	803	0	0	0	0	803
1993	0	2	0	784	0	786
1994	0	0	0	779	0	779
1995	0	739	5	1	0	745
1996	781	0	0	1	0	782
1997	0	773	1	3	0	777
1998	0	0	0	796	0	796
1999	1	1	756	0	0	758
2000	626	0	3	2	0	631
2001	0	1	747	0	0	748
2002	669	0	2	1	0	672
2003	0	715	1	2	0	718
2004	0	0	0	377	0	377
2005	0	583	1	0	0	584
2006	632	0	0	0	0	632
2007	0	0	1	619	0	620
2008	0	0	0	629	0	629
2009	1	0	612	0	0	613
2010	539	0	0	0	0	539
2011	0	1	0	624	0	625
2012	0	0	612	0	0	612
2013	0	575	3	0	0	578
2014	0	1	0	627	0	628
2015	631	0	0	0	0	631
2016	0	0	0	626	0	626
2017	1	0	624	0	0	625
2018	576	0	3	0	0	579
2019	0	0	0	626	0	626
2020	0	1	624	0	0	625
2021	0	0	0	604	0	604
2022	0	0	0	621	0	621
2023	0	576	4	1	0	581
2024	632	0	0	0	0	632
2025	0	592	2	0	0	594
2026	628	0	0	1	0	629
2027	0	0	0	627	0	627
2028	0	602	1	0	0	603
2029	0	0	0	635	0	635
2030	0	0	617	0	0	617
2031	605	0	0	0	0	605
2032	0	1	0	625	0	626
2033	0	0	0	613	0	613
2034	0	0	0	624	0	624
2035	0	0	617	0	0	617
2036	0	0	594	0	0	594
2037	0	560	4	0	0	564
2038	0	1	0	626	0	627
2039	1007	0	0	0	0	1007
2040	8	1012	1	0	0	1021
2041	1	9	0	1042	0	1052
2042	1033	1	0	9	0	1043
2043	1000	2	1	1	0	1004
2044	9	986	9	3	0	1007
2045	1324	11	0	1	0	1336
2046	1332	1	2	1	0	1336
2047	26	6	1	1506	0	1539
2048	17	1472	5	30	0	1524
2049	20	29	0	1581	0	1630
2050	1560	9	0	38	0	1607
2051	42	13	1515	18	0	1588
2052	16	8	27	1554	0	1605
2053	16	13	7	1591	0	1627
2054	14	5	1511	54	0	1584
2055	15	8	34	1560	0	1617
2056	1556	2	19	51	0	1628
2057	1502	3	11	35	0	1551
2058	38	4	12	1562	0	1616
2059	24	7	1513	49	0	1593
2060	22	8	1393	32	0	1455
2061	25	1455	40	19	0	1539
2062	14	1531	24	20	0	1589
2063	8	34	18	1562	0	1622
2064	1513	15	21	33	0	1582
2065	30	1539	18	20	0	1607
2066	1548	50	7	20	0	1625
2067	45	24	9	1541	0	1619
2068	20	15	5	1587	0	1627
2069	1532	16	4	52	0	1604
2070	45	1502	7	23	0	1577
2071	1566	36	4	26	0	1632
2072	52	23	1496	25	0	1596
2073	29	20	1512	18	0	1579
2074	28	16	38	1491	0	1573
2075	20	25	1500	43	0	1588
2076	25	10	1514	17	0	1566
2077	16	7	55	1195	0	1273
2078	17	9	1191	50	0	1267
2079	16	4	56	1207	0	1283
2080	16	4	31	1244	0	1295
2081	10	12	1188	56	0	1266
2082	10	5	48	1220	0	1283
2083	16	5	35	1181	0	1237
2084	11	1149	22	65	0	1247
2085	1190	33	24	51	0	1298
2086	38	12	1162	34	0	1246
2087	16	14	45	1202	0	1277
2088	16	14	22	1248	0	1300
2089	18	21	1156	62	0	1257
2090	1123	6	45	41	0	1215
2091	41	1169	31	41	0	1282
2092	17	45	22	1191	0	1275
2093	23	10	19	1197	0	1249
2094	20	1164	23	57	0	1264
2095	23	54	1103	40	0	1220
2096	15	1168	45	45	0	1273
2097	1186	47	22	39	0	1294
2098	49	32	1162	29	0	1272
2099	22	29	54	1182	0	1287
2100	20	15	1176	53	0	1264
2101	26	26	1154	40	0	1246
2102	23	1115	66	37	0	1241
2103	15	46	44	1176	0	1281
2104	1171	20	26	69	0	1286
2105	974	21	38	33	0	1066
2106	48	966	31	32	0	1077
2107	34	54	19	988	0	1095
2108	955	20	31	60	0	1066
2109	981	23	24	27	0	1055
2110	61	974	14	38	0	1087
2111	984	48	20	35	0	1087
2112	72	20	16	937	0	1045
2113	44	958	17	53	0	1072
2114	36	49	17	969	0	1071
2115	29	26	13	1008	0	1076
2116	31	25	11	1028	0	1095
2117	19	26	912	84	0	1041
2118	25	36	923	46	0	1030
2119	30	961	45	56	0	1092
2120	929	44	31	43	0	1047
2121	42	965	29	44	0	1080
2122	26	45	39	968	0	1078
2123	21	29	966	52	0	1068
2124	21	41	45	925	0	1032
2125	21	19	31	994	0	1065
2126	13	24	30	1025	0	1092
2127	962	14	26	78	0	1080
2128	39	17	39	999	0	1094
2129	14	19	913	83	0	1029
2130	964	12	44	59	0	1079
2131	977	14	24	47	0	1062
2132	994	20	24	40	0	1078
2133	1007	18	22	41	0	1088
2134	995	11	26	29	0	1061
2135	76	958	13	33	0	1080
2136	47	36	17	909	0	1009
2137	51	950	23	57	0	1081
2138	1004	48	14	35	0	1101
2139	574	24	5	17	0	620
2140	542	21	8	20	0	591
2141	47	530	5	22	0	604
2142	34	531	12	11	0	588
2143	32	550	9	11	0	602
2144	36	47	518	13	0	614
2145	6	7	11	234	0	258
2146	7	239	3	13	0	262
2147	0	2	0	0	0	2
2148	0	0	0	2	0	2
2149	0	0	0	2	0	2
2150	0	0	2	0	0	2
2151	1	0	0	0	0	1
2152	0	0	0	2	0	2
2153	0	0	0	2	0	2
2154	0	0	2	0	0	2
2155	0	0	2	0	0	2
2156	0	2	0	0	0	2
2157	0	0	0	2	0	2
2158	0	0	0	2	0	2
2159	0	0	2	0	0	2
2160	1	0	0	0	0	1
2161	2	1	0	0	0	3
2162	0	0	2	2	0	4
2163	4	0	0	0	0	4
2164	1	0	3	0	0	4
2165	3	1	0	0	0	4
2166	3	0	0	1	0	4
2167	1	0	3	0	0	4
2168	1	0	0	3	0	4
2169	0	1	0	4	0	5
2170	1	0	0	3	0	4
2171	4	0	0	1	0	5
2172	3	1	0	0	0	4
2173	0	0	3	1	0	4
2174	0	0	4	1	0	5
2175	4	0	0	1	0	5
2176	5	0	1	0	0	6
2177	0	0	5	0	0	5
2178	0	1	3	0	0	4
2179	1	0	0	5	0	6
2180	0	1	6	0	0	7
2181	0	0	0	7	0	7
2182	6	0	1	0	0	7
2183	0	0	6	0	0	6
2184	6	0	0	1	0	7
2185	0	0	5	1	0	6
2186	1	0	0	5	0	6
2187	0	0	0	7	0	7
2188	0	0	1	6	0	7
2189	1	6	0	0	0	7
2190	1	0	0	6	0	7
2191	1	0	0	6	0	7
2192	8	0	0	0	0	8
2193	1	0	7	0	0	8
2194	7	1	0	0	0	8
2195	0	0	7	0	0	7
2196	5	1	0	0	0	6
2197	1	7	0	0	0	8
2198	1	0	7	0	0	8
2199	1	0	7	0	0	8
2200	0	1	0	6	0	7
2201	0	1	0	7	0	8
2202	0	0	7	0	0	7
2203	0	0	7	0	0	7
2204	0	0	311	0	0	311
2205	341	1	0	0	0	342
2206	353	0	0	0	0	353
2207	353	0	0	0	0	353
2208	0	0	0	350	0	350
2209	0	0	0	349	0	349
2210	0	0	352	0	0	352
2211	0	0	0	334	0	334
2212	0	0	0	351	0	351
2213	353	0	0	0	0	353
2214	340	0	0	0	0	340
2215	352	0	0	0	0	352
2216	0	0	0	350	0	350
2217	0	0	0	350	0	350
2218	0	0	0	354	0	354
2219	353	0	0	0	0	353
2220	0	0	0	353	0	353
2221	0	322	0	0	0	322
2222	0	0	0	357	0	357
2223	0	335	0	0	0	335
2224	354	0	0	0	0	354
2225	348	0	0	0	0	348
2226	0	339	0	1	0	340
2227	0	352	0	0	0	352
2228	0	1	0	352	0	353
2229	0	0	350	0	0	350
2230	0	0	0	322	0	322
2231	0	0	348	0	0	348
2232	0	323	0	0	0	323
2233	0	0	0	352	0	352
2234	0	1	0	345	0	346
2235	0	0	548	0	0	548
2236	0	2	0	510	0	512
2237	1	3	1168	1	0	1173
2238	1195	0	0	0	0	1195
2239	1227	0	1	0	0	1228
2240	1242	0	0	0	0	1242
2241	0	0	1	1217	0	1218
2242	0	1	0	1230	0	1231
2243	1	1	1230	0	0	1232
2244	0	0	1	1177	0	1178
2245	1	1167	3	1	0	1172
2246	0	2	1214	1	0	1217
2247	2	0	1157	1	0	1160
2248	1	0	1	1051	0	1053
2249	0	1	1224	0	0	1225
2250	0	1	1161	0	0	1162
2251	1104	0	1	0	0	1105
2252	1	1398	6	2	0	1407
2253	1567	0	0	2	0	1569
2254	1556	0	0	1	0	1557
2255	1543	0	1	1	0	1545
2256	0	1	1	1501	0	1503
2257	0	0	0	1556	0	1556
2258	0	1	1541	1	0	1543
2259	1	0	0	1503	0	1504
2260	1	1472	4	1	0	1478
2261	1566	0	0	0	0	1566
2262	0	1465	1	1	0	1467
2263	0	1485	3	2	0	1490
2264	1	1	0	1562	0	1564
2265	3	0	1511	0	0	1514
2266	1	2	0	1440	0	1443
2267	1	1	1519	5	0	1526
2268	0	1366	4	2	0	1372
2269	1557	1	0	0	0	1558
2270	1542	0	1	1	0	1544
2271	1531	0	1	0	0	1532
2272	1	5	2195	0	0	2201
2273	0	7	2000	0	0	2007
2274	2275	1	0	2	0	2278
2275	2333	0	1	1	0	2335
2276	3059	0	1	2	0	3062
2277	0	0	1	3008	0	3009
2278	1	2	0	3043	0	3046
2279	3067	0	2	0	0	3069
2280	3008	1	1	1	0	3011
2281	3	3	3858	0	0	3864
2282	0	12	3651	1	0	3664
2283	3779	0	1	0	0	3780
2284	1	4	3855	1	0	3861
2285	3786	0	3	2	0	3791
2286	3	3	3885	1	0	3892
2287	0	1	1	3802	0	3804
2288	2	2	3922	0	0	3926
2289	1	2	0	4088	0	4091
2290	0	0	0	4165	0	4165
2291	0	3886	12	5	0	3903
2292	4186	0	0	0	0	4186
2293	0	3	4154	0	0	4157
2294	3866	1	1	1	0	3869
2295	0	3903	3	2	0	3908
2296	4247	0	0	0	0	4247
2297	0	0	0	4166	0	4166
2298	0	0	0	4167	0	4167
2299	0	4033	15	4	0	4052
2300	0	0	0	4497	0	4497
2301	0	2	0	4429	0	4431
2302	0	0	0	4479	0	4479
2303	4452	0	2	5	0	4459
2304	3975	4	0	5	0	3984
2305	7	5	4043	1	0	4056
2306	0	3853	12	2	0	3867
2307	0	5	0	4171	0	4176
2308	0	2	0	4164	0	4166
2309	2	2	4130	6	0	4140
2310	1	1	4	4034	0	4040
2311	4168	0	0	7	0	4175
2312	4083	0	1	1	0	4085
2313	4101	0	0	2	0	4103
2314	4	0	1	4096	0	4101
2315	4231	1	1	4	0	4237
2316	4178	2	0	5	0	4185
2317	4196	1	0	3	0	4200
2318	5	0	1	4149	0	4155
2319	2	1	1	4146	0	4150
2320	2	1	1	4166	0	4170
2321	2	0	1	4092	0	4095
2322	1	3	1	4114	0	4119
2323	5	5	4025	5	0	4040
2324	3	6	3950	6	0	3965
2325	1	3746	21	3	0	3771
2326	1	7	0	4114	0	4122
2327	1	1	0	4097	0	4099
2328	4	0	0	4073	0	4077
2329	3	1	4122	5	0	4131
2330	1	1	7	4011	0	4020
2331	2	10	4091	5	0	4108
2332	0	2	6	4049	0	4057
2333	5	4	4621	5	0	4635
2334	0	4249	28	10	0	4287
2335	1	4	0	4510	0	4515
2336	3	6	4355	5	0	4369
2337	3286	3	5	4	0	3298
2338	5	3508	19	7	0	3539
2339	1	5	0	3834	0	3840
2340	1	3568	15	7	0	3591
2341	2	5	1	3833	0	3841
2342	3816	0	1	5	0	3822
2343	5	1	0	3804	0	3810
2344	2	3560	14	9	0	3585
2345	3825	4	1	2	0	3832
2346	6	1	0	3759	0	3766
2347	1	1	0	3783	0	3785
2348	3826	0	2	9	0	3837
2349	4	3	2	3778	0	3787
2350	3	2	0	6935	0	6940
2351	6	16	7301	129	0	7452
2352	2	23	7023	38	0	7086
2353	1	3	189	7119	0	7312
2354	6	13	7119	155	0	7293
2355	6	17	6945	49	0	7017
2356	6761	1	207	58	0	7027
2357	160	13	7259	17	0	7449
2358	42	7167	225	15	0	7449
2359	43	160	57	7451	0	7711
2360	7477	39	48	166	0	7730
2361	7505	37	24	47	0	7613
2362	7516	15	13	59	0	7603
2363	237	7272	27	20	0	7556
2364	98	161	13	7234	0	7506
2365	62	43	9	7653	0	7767
2366	7398	48	21	204	0	7671
2367	7463	15	15	94	0	7587
2368	7524	11	9	73	0	7617
2369	265	32	7104	31	0	7432
2370	103	6921	192	32	0	7248
2371	75	7394	79	31	0	7579
2372	32	196	72	6816	0	7116
2373	24	91	31	7083	0	7229
2374	22	71	6724	236	0	7053
2375	6569	31	193	112	0	6905
2376	6380	15	59	79	0	6533
2377	239	15	56	6265	0	6575
2378	115	25	22	6393	0	6555
2379	86	9	17	6532	0	6644
2380	6373	12	18	274	0	6677
2381	222	23	5320	120	0	5685
2382	87	26	5477	88	0	5678
2383	72	21	215	5454	0	5762
2384	42	21	5372	209	0	5644
2385	5402	11	228	91	0	5732
2386	5567	10	78	75	0	5730
2387	5578	4	66	42	0	5690
2388	298	5343	52	35	0	5728
2389	5242	172	37	23	0	5474
2390	262	66	16	5145	0	5489
2391	88	59	14	5303	0	5464
2392	76	23	15	5454	0	5568
2393	48	29	4910	306	0	5293
2394	42	8	196	5117	0	5363
2395	51	5103	85	253	0	5492
2396	5099	167	79	96	0	5441
2397	182	5142	49	123	0	5496
2398	82	228	4977	81	0	5368
2399	81	5184	215	63	0	5543
2400	4907	223	86	44	0	5260
2401	201	4935	122	43	0	5301
2402	84	234	83	4481	0	4882
2403	73	4917	66	200	0	5256
2404	4981	216	62	89	0	5348
2405	5104	76	44	75	0	5299
2406	5093	81	39	45	0	5258
2407	319	66	4878	51	0	5314
2408	153	70	4969	46	0	5238
2409	116	52	4982	69	0	5219
2410	4984	30	274	72	0	5360
2411	253	28	139	4956	0	5376
2412	132	30	105	5118	0	5385
2413	105	46	4838	247	0	5236
2414	64	52	218	5098	0	5432
2415	4867	69	87	268	0	5291
2416	236	4832	89	138	0	5295
2417	5019	201	54	117	0	5391
2418	292	101	4810	53	0	5256
2419	4982	89	217	51	0	5339
2420	5161	61	91	50	0	5363
2421	5139	70	90	62	0	5361
2422	336	55	4776	78	0	5245
2423	179	44	200	4923	0	5346
2424	177	33	4809	231	0	5250
2425	123	30	255	4970	0	5378
2426	105	37	4786	270	0	5198
2427	78	30	270	4942	0	5320
2428	67	27	136	5144	0	5374
2429	4946	28	95	306	0	5375
2430	5027	27	65	155	0	5274
2431	5077	27	62	133	0	5299
2432	335	30	65	4751	0	5181
2433	179	4083	74	229	0	4565
2434	138	4419	51	137	0	4745
2435	4427	210	46	120	0	4803
2436	276	119	4236	84	0	4715
2437	4475	81	210	66	0	4832
2438	292	55	4201	73	0	4621
2439	4453	47	249	65	0	4814
2440	4577	29	97	88	0	4791
2441	301	35	4253	82	0	4671
2442	4468	24	235	93	0	4820
2443	4547	39	103	77	0	4766
2444	4535	27	109	63	0	4734
2445	335	4280	59	70	0	4744
2446	177	185	46	4398	0	4806
2447	145	104	4070	231	0	4550
2448	113	106	4252	105	0	4576
2449	120	4016	235	100	0	4471
2450	26	834	31	23	0	914
2451	15	13	15	242	0	285
2452	229	12	11	18	0	270
2453	19	242	3	15	0	279
2454	15	20	5	234	0	274
2455	20	238	5	16	0	279
2456	247	16	8	12	0	283
2457	25	13	0	241	0	279
2458	16	9	216	17	0	258
2459	17	233	12	12	0	274
2460	12	242	13	11	0	278
2461	9	15	17	224	0	265
2462	12	245	10	11	0	278
2463	15	20	6	235	0	276
2464	234	18	6	15	0	273
2465	241	14	5	12	0	272
2466	987	9	3	15	0	1014
2467	986	9	10	6	0	1011
2468	27	11	1245	7	0	1290
2469	20	1237	30	5	0	1292
2470	18	1241	22	5	0	1286
2471	15	1268	18	11	0	1312
2472	0	1062	2	2	0	1066
2473	1082	30	0	0	0	1112
2474	1090	15	1	0	0	1106
2475	1102	3	0	0	0	1105
2476	1110	0	0	0	0	1110
2477	35	6	1016	0	0	1057
2478	1076	0	20	0	0	1096
2479	1109	0	12	0	0	1121
2480	1112	0	1	0	0	1113
2481	34	0	2	1074	0	1110
2482	14	2	2	1101	0	1119
2483	1096	2	0	33	0	1131
2484	22	2	0	1089	0	1113
2485	13	1029	6	24	0	1072
2486	3	18	1	1104	0	1126
2487	3	12	0	1100	0	1115
2488	3	1418	4	34	0	1459
2489	3	22	1	1511	0	1537
2490	1	15	2	1540	0	1558
2491	1519	3	0	35	0	1557
2492	25	5	1442	14	0	1486
2493	1487	3	19	2	0	1511
2494	27	2	1483	3	0	1515
2495	15	1	1435	3	0	1454
2496	8	1	1478	1	0	1488
2497	1437	1	34	3	0	1475
2498	25	4	1503	1	0	1533
2499	1487	2	25	4	0	1518
2500	1518	2	13	3	0	1536
2501	1517	1	6	3	0	1527
2502	38	1423	5	6	0	1472
2503	1516	24	1	5	0	1546
2504	29	1462	1	4	0	1496
2505	14	26	1	1503	0	1544
2506	9	13	2	1499	0	1523
2507	7	1426	3	36	0	1472
2508	5	1472	4	18	0	1499
2509	4	1499	4	7	0	1514
2510	1505	36	6	7	0	1554
2511	27	1461	8	6	0	1502
2512	1536	25	3	2	0	1566
2513	31	17	1427	1	0	1476
2514	1459	6	23	3	0	1491
2515	1512	4	14	4	0	1534
2516	42	3	1474	1	0	1520
2517	23	4	25	1438	0	1490
2518	11	5	1479	23	0	1518
2519	8	1	25	1456	0	1490
2520	6	2	17	1515	0	1540
2521	1506	3	4	32	0	1545
2522	1501	5	2	18	0	1526
2523	39	1406	3	8	0	1456
2524	1518	25	2	7	0	1552
2525	31	17	1412	4	0	1464
2526	1458	6	22	4	0	1490
2527	28	6	1436	5	0	1475
2528	17	7	1356	2	0	1382
2529	1416	6	34	4	0	1460
2530	1478	6	19	4	0	1507
2531	38	11	1444	2	0	1495
2532	23	11	28	1358	0	1420
2533	12	15	16	1471	0	1514
2534	13	14	1426	37	0	1490
2535	14	14	26	1383	0	1437
2536	18	1314	21	23	0	1376
2537	18	28	6	1448	0	1500
2538	22	16	4	1467	0	1509
2539	21	4	1419	35	0	1479
2540	1358	5	28	17	0	1408
2541	1455	3	21	10	0	1489
2542	1471	3	9	6	0	1489
2543	1485	2	3	8	0	1498
2544	53	1353	8	12	0	1426
2545	31	24	6	1444	0	1505
2546	14	13	1397	38	0	1462
2547	13	13	1395	24	0	1445
2548	10	7	34	1392	0	1443
2549	2	7	1413	42	0	1464
2550	1385	9	23	30	0	1447
2551	26	9	19	1421	0	1475
2552	16	9	10	1429	0	1464
2553	14	5	6	1473	0	1498
2554	1428	3	11	42	0	1484
2555	40	1336	15	21	0	1412
2556	1410	24	18	9	0	1461
2557	1415	13	13	9	0	1450
2558	43	1306	21	7	0	1377
2559	29	1370	18	5	0	1422
2560	1420	33	20	7	0	1480
2561	40	13	13	1371	0	1437
2562	29	6	9	1389	0	1433
2563	1428	3	7	37	0	1475
2564	43	11	1891	15	0	1960
2565	1906	6	22	11	0	1945
2566	1333	10	15	12	0	1370
2567	43	1302	12	10	0	1367
2568	990	0	0	1	0	991
2569	986	0	0	0	0	986
2570	0	1339	4	0	0	1343
2571	2	1371	1	2	0	1376
2572	0	14	0	1418	0	1432
2573	1394	12	0	7	0	1413
2574	7	1377	2	7	0	1393
2575	8	9	0	1420	0	1437
2576	2049	9	3	11	0	2072
2577	31	10	2003	9	0	2053
2578	17	5	26	2032	0	2080
2579	8	2	2021	28	0	2059
2580	1941	2	33	17	0	1993
2581	2021	2	21	8	0	2052
2582	45	3	1974	6	0	2028
2583	18	1943	37	3	0	2001
2584	12	21	17	2051	0	2101
2585	14	17	2023	24	0	2078
2586	4	9	35	1996	0	2044
2587	2	8	18	2078	0	2106
2588	1	5	1625	49	0	1680
2589	1560	2	31	26	0	1619
2590	1672	1	18	15	0	1706
2591	45	6	1593	7	0	1651
2592	23	1617	31	8	0	1679
2593	15	27	15	1568	0	1625
2594	8	1588	16	24	0	1636
2595	2	1670	9	19	0	1700
2596	1640	40	5	12	0	1697
2597	32	24	7	1650	0	1713
2598	27	10	6	1689	0	1732
2599	13	11	1626	48	0	1698
2600	10	5	1639	27	0	1681
2601	7	6	49	1624	0	1686
2602	10	2	26	1696	0	1734
2603	7	6	1637	44	0	1694
2604	5	15	1641	26	0	1687
2605	7	8	44	1675	0	1734
2606	1658	3	28	42	0	1731
2607	30	1631	16	32	0	1709
2608	1662	26	17	20	0	1725
2609	33	1619	16	18	0	1686
2610	25	1628	18	13	0	1684
2611	1670	47	4	11	0	1732
2612	43	23	1633	4	0	1703
2613	23	12	40	1616	0	1691
2614	10	14	20	1677	0	1721
2615	12	7	12	1718	0	1749
2616	8	16	1638	46	0	1708
2617	15	9	29	1691	0	1744
2618	2179	9	18	46	0	2252
2619	53	11	15	2119	0	2198
2620	26	6	13	2249	0	2294
2621	2174	2	25	84	0	2285
2622	2617	2	13	47	0	2679
2623	83	2518	12	37	0	2650
2624	41	62	2591	28	0	2722
2625	31	29	2604	11	0	2675
2626	19	26	2576	24	0	2645
2627	21	2600	103	10	0	2734
2628	19	75	51	2608	0	2753
2629	14	32	33	2725	0	2804
2630	2676	20	26	96	0	2818
2631	78	19	14	2710	0	2821
2632	44	25	2599	101	0	2769
2633	36	9	86	2676	0	2807
2634	22	13	38	2745	0	2818
2635	18	14	2587	126	0	2745
2636	12	2582	87	64	0	2745
2637	15	73	43	2413	0	2544
2638	17	2576	36	84	0	2713
2639	20	89	2575	42	0	2726
2640	2579	36	75	45	0	2735
2641	2639	23	42	37	0	2741
2642	2655	16	35	25	0	2731
2643	111	20	23	2555	0	2709
2644	58	2594	30	80	0	2762
2645	2656	79	23	42	0	2800
2646	2679	33	19	37	0	2768
2647	2674	31	26	30	0	2761
2648	111	27	2558	20	0	2716
2649	2595	23	71	32	0	2721
2650	107	2596	37	30	0	2770
2651	2647	78	32	26	0	2783
2652	100	2622	24	26	0	2772
2653	2690	85	22	29	0	2826
2654	98	52	2552	26	0	2728
2655	2621	26	79	31	0	2757
2656	2685	22	45	24	0	2776
2657	2591	13	42	20	0	2666
2658	2740	22	21	18	0	2801
2659	128	20	2530	24	0	2702
2660	72	22	80	2610	0	2784
2661	2625	23	33	83	0	2764
2662	110	2561	22	45	0	2738
2663	60	78	27	2633	0	2798
2664	47	42	2036	96	0	2221
2665	38	24	75	2152	0	2289
2666	31	27	2056	101	0	2215
2667	39	2024	89	51	0	2203
2668	28	2076	54	35	0	2193
2669	33	2173	37	37	0	2280
2670	24	79	26	1680	0	1809
2671	20	43	11	1764	0	1838
2672	34	24	1604	92	0	1754
2673	28	1688	60	46	0	1822
2674	1626	77	22	36	0	1761
2675	80	1688	32	30	0	1830
2676	13	1060	15	14	0	1102
2677	14	51	13	1027	0	1105
2678	1028	23	14	43	0	1108
2679	1058	19	7	15	0	1099
2680	48	11	3	1036	0	1098
2681	1037	14	4	55	0	1110
2682	55	9	7	1041	0	1112
2683	14	10	996	62	0	1082
2684	1036	6	47	19	0	1108
2685	50	10	8	1037	0	1105
2686	21	5	1007	56	0	1089
2687	13	14	1021	18	0	1066
2688	10	11	43	1028	0	1092
2689	1030	8	13	54	0	1105
2690	1045	9	20	14	0	1088
2691	54	1000	11	18	0	1083
2692	1597	45	10	13	0	1665
2693	1603	12	6	11	0	1632
2694	1602	10	3	13	0	1628
2695	69	1487	9	10	0	1575
2696	1588	50	2	10	0	1650
2697	1625	11	5	7	0	1648
2698	65	10	9	1569	0	1653
2699	1574	5	15	44	0	1638
2700	67	1499	7	15	0	1588
2701	28	1568	6	16	0	1618
2702	25	53	6	1555	0	1639
2703	20	20	9	1578	0	1627
2704	20	1545	5	55	0	1625
2705	1577	44	5	14	0	1640
2706	52	1528	12	10	0	1602
2707	1587	57	2	12	0	1658
2708	65	1530	3	10	0	1608
2709	31	50	1	1507	0	1589
2710	25	1513	8	39	0	1585
2711	1586	57	3	8	0	1654
2712	1607	17	8	12	0	1644
2713	1600	16	3	9	0	1628
2714	58	16	1490	15	0	1579
2715	27	17	1482	15	0	1541
2716	23	1504	44	11	0	1582
2717	16	51	1541	11	0	1619
2718	7	3	992	6	0	1008
2719	0	0	1	500	0	501
2720	0	0	554	0	0	554
2721	0	508	2	0	0	510
2722	558	0	0	0	0	558
2723	0	538	0	1	0	539
2724	0	527	0	0	0	527
2725	556	0	0	0	0	556
2726	540	0	0	0	0	540
2727	0	518	0	0	0	518
2728	564	0	0	0	0	564
2729	541	0	0	0	0	541
2730	539	0	0	0	0	539
2731	0	1	490	0	0	491
2732	0	1	465	0	0	466
2733	0	0	0	510	0	510
2734	0	0	0	526	0	526
2735	547	0	0	0	0	547
2736	0	505	1	1	0	507
2737	0	0	0	535	0	535
2738	0	0	0	529	0	529
2739	0	0	1	531	0	532
2740	0	0	0	508	0	508
2741	0	1	520	0	0	521
2742	0	1	494	0	0	495
2743	0	0	0	507	0	507
2744	0	0	521	0	0	521
2745	473	0	3	0	0	476
2746	2	0	0	764	0	766
2747	0	0	754	2	0	756
2748	698	0	3	0	0	701
2749	2	707	3	0	0	712
2750	780	2	0	0	0	782
2751	2	711	2	1	0	716
2752	0	2	1	774	0	777
2753	0	0	749	1	0	750
2754	0	0	2	733	0	735
2755	0	0	740	2	0	742
2756	726	1	2	0	0	729
2757	2	1	1	763	0	767
2758	774	0	0	2	0	776
2759	2	1	735	2	0	740
2760	719	0	2	2	0	723
2761	762	0	1	0	0	763
2762	4	0	743	0	0	747
2763	0	1	3	1006	0	1010
2764	4	1	1319	3	0	1327
2765	0	1304	9	1	0	1314
2766	1405	2	2	0	0	1409
2767	1368	0	3	1	0	1372
2768	5	1	1386	1	0	1393
2769	2	1	1344	0	0	1347
2770	0	0	3	1304	0	1307
2771	0	0	0	1369	0	1369
2772	1408	0	1	2	0	1411
2773	2	1310	6	1	0	1319
2774	1403	3	0	0	0	1406
2775	1387	1	0	0	0	1388
2776	2	1	1353	0	0	1356
2777	1310	0	4	0	0	1314
2778	2	0	1358	1	0	1361
2779	0	0	2	1336	0	1338
2780	2	2	1379	2	0	1385
2781	0	2	2	1347	0	1351
2782	2	2	1368	2	0	1374
2783	1308	0	2	0	0	1310
2784	1354	0	1	1	0	1356
2785	3	0	0	1369	0	1372
2786	1395	0	1	2	0	1398
2787	2	0	0	1371	0	1373
2788	0	1281	3	3	0	1287
2789	1396	2	0	2	0	1400
2790	3	1309	4	0	0	1316
2791	2	2	0	1383	0	1387
2792	1	0	0	899	0	900
2793	0	0	0	894	0	894
2794	0	0	0	891	0	891
2795	0	2	873	3	0	878
2796	794	3	2	1	0	800
2797	883	0	1	0	0	884
2798	2	842	2	0	0	846
2799	0	2	0	887	0	889
2800	0	0	0	890	0	890
2801	0	0	881	3	0	884
2802	846	0	2	0	0	848
2803	3	0	1	882	0	886
2804	2	0	869	2	0	873
2805	835	0	2	0	0	837
2806	871	1	0	1	0	873
2807	864	0	0	1	0	865
2808	2	0	877	1	0	880
2809	0	2	797	0	0	799
2810	828	1	2	1	0	832
2811	2	0	0	868	0	870
2812	0	1	1	871	0	873
2813	1	1	867	3	0	872
2814	805	2	3	0	0	810
2815	3	0	0	871	0	874
2816	872	0	1	3	0	876
2817	857	0	1	1	0	859
2818	853	0	0	1	0	854
2819	2	0	850	1	0	853
2820	0	1	2	854	0	857
2821	875	0	1	3	0	879
2822	2	839	2	1	0	844
2823	0	2	0	877	0	879
2824	1	0	0	866	0	867
2825	877	0	0	2	0	879
2826	860	0	0	0	0	860
2827	2	0	1	876	0	879
2828	0	0	846	3	0	849
2829	825	0	2	0	0	827
2830	4	1	848	0	0	853
2831	836	2	2	1	0	841
2832	845	1	1	2	0	849
2833	3	1	856	0	0	860
2834	1	0	2	810	0	813
2835	1	0	855	3	0	859
2836	0	811	6	2	0	819
2837	1	2	0	867	0	870
2838	0	796	5	4	0	805
2839	1	2	0	860	0	863
2840	1	0	850	2	0	853
2841	1	752	5	0	0	758
2842	0	787	3	3	0	793
2843	0	2	1	865	0	868
2844	864	0	0	0	0	864
2845	0	0	0	1549	0	1549
2846	1304	0	0	54	0	1358
2847	48	1280	3	1	0	1332
2848	1798	56	4	3	0	1861
2849	77	4	1791	0	0	1872
2850	5	5	67	1824	0	1901
2851	10	0	3	1901	0	1914
2852	0	4	1787	78	0	1869
2853	1775	1	63	16	0	1855
2854	1849	1	4	12	0	1866
2855	67	1790	12	3	0	1872
2856	15	79	1	1605	0	1700
2857	15	1726	7	59	0	1807
2858	5	84	1773	3	0	1865
2859	5	3	1812	15	0	1835
2860	2	12	72	1804	0	1890
2861	1821	1	18	79	0	1919
2862	77	1778	11	6	0	1872
2863	1616	76	5	13	0	1710
2864	88	12	1276	3	0	1379
2865	1527	10	68	9	0	1614
2866	1605	6	7	5	0	1623
2867	78	7	1504	8	0	1597
2868	20	2	74	1781	0	1877
2869	1818	3	9	82	0	1912
2870	1846	2	13	5	0	1866
2871	1837	8	4	12	0	1861
2872	100	3	5	1805	0	1913
2873	16	11	1726	87	0	1840
2874	1804	1	77	7	0	1889
2875	94	7	1734	13	0	1848
2876	11	7	82	1777	0	1877
2877	17	1	9	1732	0	1759
2878	11	2155	16	76	0	2258
2879	22	79	2135	17	0	2253
2880	12	2132	84	13	0	2241
2881	10	2222	12	15	0	2259
2882	14	82	14	2237	0	2347
2883	12	23	2198	79	0	2312
2884	11	13	82	2215	0	2321
2885	11	9	2196	98	0	2314
2886	7	6	86	2234	0	2333
2887	20	4	6	2338	0	2368
2888	10	10	2190	83	0	2293
2889	7	10	79	2244	0	2340
2890	14	8	2701	101	0	2824
2891	10	7	2717	22	0	2756
2892	19	2676	85	30	0	2810
2893	2789	80	27	17	0	2913
2894	94	14	2717	16	0	2841
2895	2683	15	91	15	0	2804
2896	98	9	13	2786	0	2906
2897	15	12	2671	89	0	2787
2898	21	2682	83	24	0	2810
2899	14	80	21	2765	0	2880
2900	25	13	2736	86	0	2860
2901	14	28	85	2594	0	2721
2902	23	2681	22	92	0	2818
2903	2783	92	29	13	0	2917
2904	94	8	19	2799	0	2920
2905	2794	18	20	98	0	2930
2906	2822	8	26	26	0	2882
2907	2837	12	18	30	0	2897
2908	2868	12	13	23	0	2916
2909	2849	9	27	16	0	2901
2910	101	2672	21	24	0	2818
2911	38	89	10	2778	0	2915
2912	33	17	20	2840	0	2910
2913	25	21	17	2856	0	2919
2914	29	15	2692	110	0	2846
2915	30	2680	93	35	0	2838
2916	2781	87	19	35	0	2922
2917	2777	19	23	20	0	2839
2918	100	2675	30	29	0	2834
2919	33	2792	42	20	0	2887
2920	2783	94	14	41	0	2932
2921	103	24	2716	31	0	2874
2922	30	24	94	2742	0	2890
2923	2803	14	21	104	0	2942
2924	108	25	29	2670	0	2832
2925	32	2699	20	105	0	2856
2926	38	92	15	2792	0	2937
2927	25	25	2689	103	0	2842
2928	2683	21	93	31	0	2828
2929	2828	12	30	36	0	2906
2930	101	7	31	2738	0	2877
2931	41	18	23	2840	0	2922
2932	2743	22	16	104	0	2885
2933	95	2687	21	42	0	2845
2934	35	88	24	2766	0	2913
2935	37	15	14	2876	0	2942
2936	2746	23	32	98	0	2899
2937	104	3352	21	42	0	3519
2938	3789	95	13	38	0	3935
2939	140	3712	23	26	0	3901
2940	30	3880	20	31	0	3961
2941	3824	117	14	28	0	3983
2942	118	3772	31	40	0	3961
2943	28	118	29	3875	0	4050
2944	36	31	3764	135	0	3966
2945	20	24	2947	16	0	3007
2946	20	21	2926	27	0	2994
2947	15	2933	76	21	0	3045
2948	2091	27	7	2	0	2127
2949	28	8	4	2048	0	2088
2950	4	3	1	2100	0	2108
2951	1	4	2054	32	0	2091
2952	2002	1	30	7	0	2040
2953	28	0	7	2117	0	2152
2954	5	2	1	2122	0	2130
2955	4	0	2	2148	0	2154
2956	2135	1	4	34	0	2174
2957	49	4	2033	11	0	2097
2958	2057	1	27	7	0	2092
2959	32	5	3	2115	0	2155
2960	8	7	2068	32	0	2115
2961	2041	8	28	7	0	2084
2962	41	10	2082	6	0	2139
2963	12	13	30	2050	0	2105
2964	8	16	2059	57	0	2140
2965	14	9	2069	6	0	2098
2966	2026	11	42	10	0	2089
2967	33	10	2059	11	0	2113
2968	10	3	46	2075	0	2134
2969	2092	2	26	34	0	2154
2970	32	5	15	2082	0	2134
2971	12	14	2087	34	0	2147
2972	17	6	2043	10	0	2076
2973	9	1988	41	22	0	2060
2974	4	31	13	2101	0	2149
2975	2123	8	13	43	0	2187
2976	45	2012	9	17	0	2083
2977	2132	34	4	24	0	2194
2978	38	10	4	1750	0	1802
2979	1738	4	5	49	0	1796
2980	46	1678	10	9	0	1743
2981	17	38	10	1721	0	1786
2982	1732	11	11	35	0	1789
2983	41	1694	8	22	0	1765
2984	19	39	13	1713	0	1784
2985	19	13	13	1736	0	1781
2986	1734	9	21	41	0	1805
2987	38	9	18	1736	0	1801
2988	8	8	24	1748	0	1788
2989	19	6	27	1769	0	1821
2990	20	10	1166	43	0	1239
2991	1187	5	48	24	0	1264
2992	38	11	16	1243	0	1308
2993	26	13	1411	51	0	1501
2994	1439	6	55	35	0	1535
2995	59	14	2033	19	0	2125
2996	22	9	59	2012	0	2102
2997	16	2023	21	61	0	2121
2998	19	51	12	2174	0	2256
2999	33	18	2067	65	0	2183
3000	17	21	2389	23	0	2450
3001	27	7	59	2430	0	2523
3002	23	10	2391	69	0	2493
3003	2372	10	64	23	0	2469
3004	64	23	2365	20	0	2472
3005	23	13	59	2418	0	2513
3006	28	12	20	2478	0	2538
3007	22	19	17	2514	0	2572
3008	2479	10	19	83	0	2591
3009	2497	4	22	45	0	2568
3010	2500	4	17	33	0	2554
3011	71	4	19	2478	0	2572
3012	21	1	20	2535	0	2577
3013	25	11	2339	85	0	2460
3014	19	18	2330	35	0	2402
3015	25	2341	73	27	0	2466
3016	25	49	21	2419	0	2514
3017	21	18	36	2367	0	2442
3018	25	2374	20	67	0	2486
3019	2453	53	22	31	0	2559
3020	59	2379	20	36	0	2494
3021	2479	67	13	31	0	2590
3022	63	17	22	2478	0	2580
3023	2734	10	19	72	0	2835
3024	87	14	22	2721	0	2844
3025	25	14	2585	104	0	2728
3026	26	9	73	2703	0	2811
3027	2735	9	22	94	0	2860
3028	81	8	20	2717	0	2826
3029	28	4	15	2812	0	2859
3030	28	8	2582	119	0	2737
3031	17	6	71	2696	0	2790
3032	40	5	16	2726	0	2787
3033	24	2606	20	106	0	2756
3034	31	61	23	2734	0	2849
3035	20	17	11	2797	0	2845
3036	17	9	19	2799	0	2844
3037	7	1984	16	82	0	2089
3038	1	36	0	1598	0	1635
3039	1573	3	3	44	0	1623
3040	31	1535	7	10	0	1583
3041	6	1509	4	7	0	1526
3042	2	1573	5	7	0	1587
3043	6	42	3	1560	0	1611
3044	2	1463	6	39	0	1510
3045	2	1528	12	9	0	1551
3046	1587	37	8	7	0	1639
3047	42	6	1507	12	0	1567
3048	1536	2	42	13	0	1593
3049	44	8	8	1579	0	1639
3050	10	13	1505	47	0	1575
3051	1470	3	44	19	0	1536
3052	42	4	1458	16	0	1520
3053	6	7	1399	18	0	1430
3054	1464	3	51	16	0	1534
3055	50	4	16	1509	0	1579
3056	9	5	1465	53	0	1532
3057	1471	2	50	16	0	1539
3058	1527	4	11	27	0	1569
3059	46	5	1450	24	0	1525
3060	1489	4	40	21	0	1554
3061	1553	7	7	14	0	1581
3062	63	8	1432	8	0	1511
3063	1481	2	40	21	0	1544
3064	1537	6	6	22	0	1571
3065	50	8	1424	20	0	1502
3066	16	4	1465	12	0	1497
3067	13	11	49	1461	0	1534
3068	10	9	1438	48	0	1505
3069	1452	8	46	21	0	1527
3070	47	13	8	1479	0	1547
3071	11	8	9	1493	0	1521
3072	14	14	1419	46	0	1493
3073	18	13	33	1408	0	1472
3074	14	12	1392	50	0	1468
3075	1415	4	42	17	0	1478
3076	1466	5	7	15	0	1493
3077	47	5	1397	20	0	1469
3078	1421	5	44	12	0	1482
3079	1489	1	11	16	0	1517
3080	57	3	1379	19	0	1458
3081	1390	4	47	19	0	1460
3082	1467	5	12	17	0	1501
3083	50	3	1391	14	0	1458
3084	1382	2	44	20	0	1448
3085	55	9	1393	12	0	1469
3086	14	8	38	1396	0	1456
3087	11	3	12	1437	0	1463
3088	13	3	11	1472	0	1499
3089	9	5	1387	62	0	1463
3090	1280	5	43	26	0	1354
3091	53	5	1359	18	0	1435
3092	16	1305	45	18	0	1384
3093	5	1112	11	4	0	1132
3094	1027	21	8	8	0	1064
3095	20	4	5	529	0	558
3096	5	539	5	25	0	574
3097	560	20	5	5	0	590
3098	558	2	5	9	0	574
3099	24	538	6	7	0	575
3100	5	20	7	231	0	263
3101	8	263	2	19	0	292
3102	263	24	6	4	0	297
3103	286	5	2	4	0	297
3104	27	2	3	268	0	300
3105	271	6	5	23	0	305
3106	29	2	2	267	0	300
3107	12	3	261	21	0	297
3108	270	3	21	7	0	301
3109	27	1	251	4	0	283
3110	8	4	18	268	0	298
3111	273	1	9	22	0	305
3112	29	1	5	269	0	304
3113	8	0	258	26	0	292
3114	4	2	269	7	0	282
3115	5	3	20	272	0	300
3116	273	1	9	21	0	304
3117	22	260	6	4	0	292
3118	8	21	6	266	0	301
3119	5	3	259	25	0	292
3120	272	3	21	6	0	302
3121	291	6	5	2	0	304
3122	29	1	271	3	0	304
3123	4	0	2	0	0	6
3124	2	0	0	4	0	6
3125	0	0	4	2	0	6
3126	4	0	1	0	0	5
3127	2	0	0	3	0	5
3128	0	0	0	5	0	5
3129	4	0	0	2	0	6
3130	2	294	0	1	0	297
3131	0	314	1	0	0	315
3132	333	2	0	0	0	335
3133	294	0	1	0	0	295
3134	3	0	331	0	0	334
3135	0	1	304	0	0	305
3136	0	0	2	306	0	308
3137	334	0	0	2	0	336
3138	329	0	0	0	0	329
3139	328	0	1	0	0	329
3140	2	308	0	0	0	310
3141	0	306	0	0	0	306
3142	0	2	0	330	0	332
3143	0	0	0	328	0	328
3144	0	0	0	320	0	320
3145	0	1	326	2	0	329
3146	0	0	279	0	0	279
3147	306	0	3	0	0	309
3148	337	0	1	0	0	338
3149	3	0	0	325	0	328
3150	1	0	0	321	0	322
3151	0	0	0	340	0	340
3152	0	0	324	4	0	328
3153	0	0	321	1	0	322
3154	0	0	2	321	0	323
3155	0	0	335	1	0	336
3156	0	306	2	1	0	309
3157	0	303	2	0	0	305
3158	336	1	0	0	0	337
3159	1	329	0	0	0	330
3160	1	1	0	333	0	335
3161	0	1	0	337	0	338
3162	0	314	0	3	0	317
3163	1	1	0	335	0	337
3164	0	2	331	1	0	334
3165	0	315	1	2	0	318
3166	0	1	2	329	0	332
3167	1	1	328	1	0	331
3168	1	307	1	1	0	310
3169	0	1	1	331	0	333
3170	1	318	0	1	0	320
3171	0	1	0	331	0	332
3172	0	1	1	328	0	330
3173	1	308	0	2	0	311
3174	312	1	0	1	0	314
3175	299	1	0	1	0	301
3176	3	305	0	0	0	308
3177	1	318	0	0	0	319
3178	0	3	0	327	0	330
3179	2	2	312	1	0	317
3180	291	0	1	1	0	293
3181	300	0	2	0	0	302
3182	2	0	325	0	0	327
3183	280	0	1	1	0	282
3184	305	0	1	0	0	306
3185	2	0	303	0	0	305
3186	281	1	1	0	0	283
3187	2	1	316	0	0	319
3188	2	289	1	1	0	293
3189	317	1	1	0	0	319
3190	307	1	1	1	0	310
3191	2	0	307	1	0	310
3192	308	0	2	1	0	311
3193	718	0	4	0	0	722
3194	4	0	680	0	0	684
3195	692	0	1	1	0	694
3196	715	0	1	2	0	718
3197	3	1	688	1	0	693
3198	700	1	1	1	0	703
3199	1	1	0	709	0	711
3200	2	0	1	704	0	707
3201	2	2	693	3	0	700
3202	0	2	634	1	0	637
3203	0	1	3	693	0	697
3204	0	2	1	702	0	705
3205	723	0	0	2	0	725
3206	3	2	671	1	0	677
3207	690	0	1	1	0	692
3208	1	1	0	719	0	721
3209	1	2	686	1	0	690
3210	681	0	1	3	0	685
3211	1	1	2	718	0	722
3212	2	1	701	2	0	706
3213	677	0	2	2	0	681
3214	1	1	2	714	0	718
3215	719	0	0	1	0	720
3216	2	1	698	1	0	702
3217	1	0	1	703	0	705
3218	0	672	1	2	0	675
3219	707	2	0	1	0	710
3220	704	1	0	0	0	705
3221	3	675	1	1	0	680
3222	717	1	0	0	0	718
3223	1176	2	1	0	0	1179
3224	1211	1	0	1	0	1213
3225	13	1176	3	0	0	1192
3226	6	8	0	1214	0	1228
3227	3	6	1540	7	0	1556
3228	2	2	8	1450	0	1462
3229	1	1	3	1535	0	1540
3230	2	1	1257	12	0	1272
3231	3	1	1227	7	0	1238
3232	5	3	13	1068	0	1089
3233	7	1209	8	7	0	1231
3234	1292	13	3	4	0	1312
3235	1256	7	1	5	0	1269
3236	14	1250	6	5	0	1275
3237	1310	8	5	4	0	1327
3238	1290	6	2	5	0	1303
3239	24	5	1256	5	0	1290
3240	1213	3	20	4	0	1240
3241	15	1202	13	7	0	1237
3242	7	14	1234	15	0	1270
3243	5	15	1163	7	0	1190
3244	9	1186	18	10	0	1223
3245	1268	10	14	12	0	1304
3246	15	10	1243	5	0	1273
3247	13	6	17	1237	0	1273
3248	11	5	1251	12	0	1279
3249	1219	10	16	6	0	1251
3250	20	6	1223	6	0	1255
3251	20	15	1196	1	0	1232
3252	1206	8	23	3	0	1240
3253	28	1216	15	2	0	1261
3254	1272	17	7	4	0	1300
3255	1280	11	18	4	0	1313
3256	25	8	13	1154	0	1200
3257	12	1228	20	16	0	1276
3258	1285	13	17	14	0	1329
3259	18	15	1232	7	0	1272
3260	1206	12	26	10	0	1254
3261	29	1214	24	8	0	1275
3262	1262	25	18	12	0	1317
3263	1248	12	9	23	0	1292
3264	28	1235	28	6	0	1297
3265	31	12	14	1276	0	1333
3266	1268	12	16	19	0	1315
3267	26	1251	21	6	0	1304
3268	32	15	15	1273	0	1335
3269	1462	16	16	13	0	1507
3270	34	25	5	1416	0	1480
3271	40	14	6	1392	0	1452
3272	31	1391	15	17	0	1454
3273	1431	29	13	10	0	1483
3274	1428	21	15	8	0	1472
3275	1446	15	11	10	0	1482
3276	34	1367	26	7	0	1434
3277	1447	21	15	14	0	1497
3278	1453	23	16	10	0	1502
3279	35	12	20	1415	0	1482
3280	19	15	21	1440	0	1495
3281	18	20	1401	31	0	1470
3282	34	13	17	1382	0	1446
3283	25	20	16	1410	0	1471
3284	32	7	1390	34	0	1463
3285	1317	16	27	18	0	1378
3286	41	11	1414	22	0	1488
3287	32	18	1394	13	0	1457
3288	34	17	24	1366	0	1441
3289	41	9	16	1304	0	1370
3290	31	1384	21	16	0	1452
3291	1444	24	13	18	0	1499
3292	1383	26	7	16	0	1432
3293	39	1031	23	22	0	1115
3294	34	1088	21	16	0	1159
3295	32	25	13	957	0	1027
3296	24	1058	24	33	0	1139
3297	1070	19	25	22	0	1136
3298	1072	22	15	35	0	1144
3299	38	17	16	1041	0	1112
3300	38	16	20	1484	0	1558
3301	1524	18	16	26	0	1584
3302	25	19	1454	28	0	1526
3303	1502	21	18	17	0	1558
3304	41	30	1434	19	0	1524
3305	1465	14	21	24	0	1524
3306	41	25	18	1484	0	1568
3307	45	17	1470	25	0	1557
3308	38	23	1403	22	0	1486
3309	1442	23	30	21	0	1516
3310	1456	21	18	21	0	1516
3311	41	1442	22	14	0	1519
3312	44	23	16	1727	0	1810
3313	29	21	19	1822	0	1891
3314	1764	11	21	74	0	1870
3315	73	1703	23	45	0	1844
3316	1719	45	21	35	0	1820
3317	64	1645	31	29	0	1769
3318	41	1734	38	16	0	1829
3319	1796	58	13	25	0	1892
3320	62	39	1705	19	0	1825
3321	51	13	55	1722	0	1841
3322	39	16	27	1811	0	1893
3323	0	1	1190	46	0	1237
3324	1	2	30	1175	0	1208
3325	4	2	9	1138	0	1153
3326	2	1144	4	35	0	1185
3327	892	30	0	15	0	937
3328	30	13	868	3	0	914
3329	823	6	27	1	0	857
3330	34	822	11	1	0	868
3331	11	30	6	878	0	925
3332	1269	8	0	35	0	1312
3333	29	2	2	1274	0	1307
3334	9	0	4	1298	0	1311
3335	4	1	1226	47	0	1278
3336	1204	1	25	19	0	1249
3337	1291	3	10	3	0	1307
3338	45	2	1242	2	0	1291
3339	15	0	31	1241	0	1287
3340	11	2	1245	28	0	1286
3341	1218	6	29	12	0	1265
3342	1289	0	10	7	0	1306
3343	45	2	4	1242	0	1293
3344	1259	1	0	37	0	1297
3345	35	4	1468	16	0	1523
3346	13	2	30	1479	0	1524
3347	10	2	8	1533	0	1553
3348	4	1	4	1551	0	1560
3349	3	2	5	1568	0	1578
3350	1533	0	2	49	0	1584
3351	30	1	1497	14	0	1542
3352	16	1	30	1509	0	1556
3353	5	1	1473	33	0	1512
3354	2	0	1438	18	0	1458
3355	7	2	39	1467	0	1515
3356	1	1	16	1535	0	1553
3357	1522	2	4	50	0	1578
3358	33	2	2	1521	0	1558
3359	13	0	2	1539	0	1554
3360	5	1	1	1570	0	1577
3361	1512	1	2	47	0	1562
3362	1526	2	4	19	0	1551
3363	1527	2	3	8	0	1540
3364	1531	1	5	3	0	1540
3365	41	1416	6	6	0	1469
3366	15	28	2	1511	0	1556
3367	10	13	0	1543	0	1566
3368	1521	3	6	43	0	1573
3369	29	1575	3	22	0	1629
3370	11	53	0	1699	0	1763
3371	4	25	1948	62	0	2039
3372	2028	6	76	25	0	2135
3373	93	2115	18	16	0	2242
3374	2202	90	9	6	0	2307
3375	2236	25	4	3	0	2268
3376	117	16	4	2154	0	2291
3377	43	6	2304	96	0	2449
3378	14	6	80	2364	0	2464
3379	2375	5	21	110	0	2511
3380	95	5	16	2391	0	2507
3381	2384	0	9	113	0	2506
3382	102	2278	11	33	0	2424
3383	2409	94	4	23	0	2530
3384	108	27	4	2672	0	2811
3385	36	12	5	2798	0	2851
3386	2955	4	2	139	0	3100
3387	2989	7	5	44	0	3045
3388	3415	1	7	20	0	3443
3389	3435	2	5	12	0	3454
3390	3423	3	2	9	0	3437
3391	178	5	2	3270	0	3455
3392	71	14	3039	133	0	3257
3393	32	3089	107	60	0	3288
3394	3302	112	32	33	0	3479
3395	141	32	3156	13	0	3342
3396	3240	22	121	11	0	3394
3397	164	3144	42	9	0	3359
3398	3311	119	15	10	0	3455
3399	161	37	12	3270	0	3480
3400	62	20	7	3013	0	3102
3401	40	14	2832	166	0	3052
3402	29	6	122	2867	0	3024
3403	24	8	2867	149	0	3048
3404	18	12	2822	51	0	2903
3405	2863	9	157	29	0	3058
3406	3014	7	53	15	0	3089
3407	189	10	2809	22	0	3030
3408	2879	10	121	26	0	3036
3409	3008	9	44	22	0	3083
3410	177	18	2747	25	0	2967
3411	80	2725	128	27	0	2960
3412	39	88	39	2776	0	2942
3413	2788	33	24	103	0	2948
3414	3255	21	13	37	0	3326
3415	3262	10	22	25	0	3319
3416	3289	4	11	15	0	3319
3417	3307	6	17	9	0	3339
3418	164	12	3037	8	0	3221
3419	82	15	3101	13	0	3211
3420	44	18	115	3127	0	3304
3421	3196	5	58	105	0	3364
3422	3266	8	21	45	0	3340
3423	3790	5	13	36	0	3844
3424	3721	2	15	16	0	3754
3425	156	3493	13	29	0	3691
3426	83	3636	21	17	0	3757
3427	3644	114	21	23	0	3802
3428	3719	47	18	17	0	3801
3429	144	3570	16	19	0	3749
3430	3744	97	13	15	0	3869
3431	155	38	3519	18	0	3730
3432	79	20	96	3227	0	3422
3433	75	19	3210	100	0	3404
3434	58	22	3170	43	0	3293
3435	59	12	124	3188	0	3383
3436	53	8	51	3334	0	3446
3437	52	23	3222	126	0	3423
3438	37	16	101	3169	0	3323
3439	46	14	50	3374	0	3484
3440	3323	18	29	143	0	3513
3441	3377	5	34	59	0	3475
3442	161	12	36	3262	0	3471
3443	83	28	3138	121	0	3370
3444	55	3152	106	69	0	3382
3445	3302	90	49	48	0	3489
3446	130	43	3632	51	0	3856
3447	60	3526	119	37	0	3742
3448	57	3659	60	35	0	3811
3449	3784	119	30	38	0	3971
3450	3856	46	28	30	0	3960
3451	164	24	36	3725	0	3949
3452	98	30	4346	113	0	4587
3453	72	16	111	4435	0	4634
3454	47	15	60	4560	0	4682
3455	56	19	38	4626	0	4739
3456	4477	20	35	176	0	4708
3457	140	4352	41	77	0	4610
3458	86	4466	22	47	0	4621
3459	74	134	26	4450	0	4684
3460	58	56	31	4583	0	4728
3461	4516	36	20	158	0	4730
3462	4332	23	31	83	0	4469
3463	4579	12	22	56	0	4669
3464	184	4335	32	42	0	4593
3465	4549	113	33	31	0	4726
3466	160	52	29	4487	0	4728
3467	79	43	4307	139	0	4568
3468	76	32	4178	56	0	4342
3469	3986	13	108	45	0	4152
3470	131	15	4023	28	0	4197
3471	56	19	3533	21	0	3629
3472	3458	15	70	11	0	3554
3473	70	9	3467	20	0	3566
3474	52	8	3478	22	0	3560
3475	28	13	70	3426	0	3537
3476	31	14	3521	45	0	3611
3477	24	9	53	3204	0	3290
3478	26	10	42	3285	0	3363
3479	29	6	3292	66	0	3393
3480	30	3127	64	38	0	3259
3481	3316	39	43	20	0	3418
3482	61	30	3257	14	0	3362
3483	38	17	3274	22	0	3351
3484	2590	9	50	12	0	2661
3485	39	7	2926	9	0	2981
3486	34	2548	46	15	0	2643
3487	29	2593	40	7	0	2669
3488	2	10	7	2371	0	2390
3489	2	8	2	2345	0	2357
3490	2386	5	3	9	0	2403
3491	2323	6	1	8	0	2338
3492	2342	2	1	8	0	2353
3493	11	1	2	2345	0	2359
3494	2768	1	4	8	0	2781
3495	2696	1	2	5	0	2704
3496	13	3	2712	5	0	2733
3497	8	3	2588	3	0	2602
3498	5	2547	23	7	0	2582
3499	4	6	7	2737	0	2754
3500	2748	4	5	9	0	2766
3501	9	2800	9	6	0	2824
3502	3	9	3	2930	0	2945
3503	2924	5	1	12	0	2942
3504	2897	3	0	7	0	2907
3505	11	2803	7	6	0	2827
3506	2922	8	1	6	0	2937
3507	2866	5	0	3	0	2874
3508	15	5	2	2827	0	2849
3509	6	4	2887	10	0	2907
3510	7	2662	24	6	0	2699
3511	5	2807	16	6	0	2834
3512	2768	8	2	3	0	2781
3513	9	7	2	2702	0	2720
3514	6	8	2541	7	0	2562
3515	5	2403	14	9	0	2431
3516	2615	9	5	7	0	2636
3517	2608	3	5	6	0	2622
3518	12	4	2543	3	0	2562
3519	8	5	9	2481	0	2503
3520	7	1	6	2605	0	2619
3521	7	2	3030	10	0	3049
3522	3604	2	11	7	0	3624
3523	4800	23	6	9	0	4838
3524	98	2	6	5459	0	5565
3525	36	5621	14	127	0	5798
3526	26	114	3	5971	0	6114
3527	17	55	5719	152	0	5943
3528	5696	29	123	70	0	5918
3529	130	18	52	5964	0	6164
3530	54	25	5800	145	0	6024
3531	5662	11	133	72	0	5878
3532	147	7	61	5824	0	6039
3533	66	2	33	6002	0	6103
3534	5934	4	21	187	0	6146
3535	141	5747	25	98	0	6011
3536	5957	124	14	57	0	6152
3537	173	55	7	5938	0	6173
3538	5987	33	6	154	0	6180
3539	184	29	5606	81	0	5900
3540	83	6184	142	59	0	6468
3541	57	134	49	6513	0	6753
3542	6486	56	31	162	0	6735
3543	153	6270	34	74	0	6531
3544	81	140	18	6538	0	6777
3545	6313	67	19	157	0	6556
3546	5954	46	13	86	0	6099
3547	203	25	13	5908	0	6149
3548	115	41	5663	173	0	5992
3549	75	32	5558	97	0	5762
3550	5708	17	177	64	0	5966
3551	173	5613	79	61	0	5926
3552	89	5147	58	37	0	5331
3553	5091	173	38	38	0	5340
3554	160	5044	48	37	0	5289
3555	84	165	35	5072	0	5356
3556	72	89	14	5263	0	5438
3557	5150	62	20	195	0	5427
3558	5249	49	11	97	0	5406
3559	5308	30	5	74	0	5417
3560	228	38	4957	62	0	5285
3561	132	17	124	5091	0	5364
3562	103	22	5025	167	0	5317
3563	86	26	5014	80	0	5206
3564	60	15	5133	77	0	5285
3565	46	26	227	4990	0	5289
3566	48	21	5107	164	0	5340
3567	39	32	5274	87	0	5432
3568	42	32	216	5188	0	5478
3569	5275	16	109	178	0	5578
3570	152	28	5246	87	0	5513
3571	89	16	172	5156	0	5433
3572	56	16	92	5397	0	5561
3573	65	17	5220	213	0	5515
3574	66	23	157	5257	0	5503
3575	59	30	5368	199	0	5656
3576	54	19	185	5403	0	5661
3577	43	22	92	5547	0	5704
3578	40	22	65	5595	0	5722
3579	24	26	59	5654	0	5763
3580	5415	15	54	264	0	5748
3581	5433	20	46	152	0	5651
3582	209	28	5219	101	0	5557
3583	104	5086	163	110	0	5463
3584	87	132	5300	82	0	5601
3585	77	70	5284	53	0	5484
3586	5182	35	217	57	0	5491
3587	166	5298	136	56	0	5656
3588	5524	141	100	46	0	5811
3589	182	5428	86	49	0	5745
3590	5558	174	64	47	0	5843
3591	5662	80	71	36	0	5849
3592	231	64	36	5422	0	5753
3593	121	5370	45	195	0	5731
3594	72	172	27	5216	0	5487
3595	59	72	35	5351	0	5517
3596	78	51	5410	254	0	5793
3597	62	5424	162	137	0	5785
3598	48	150	89	6001	0	6288
3599	5742	73	59	226	0	6100
3600	5941	47	63	109	0	6160
3601	5839	30	46	104	0	6019
3602	236	5659	58	60	0	6013
3603	6146	165	49	63	0	6423
3604	244	6607	39	55	0	6945
3605	109	211	38	6706	0	7064
3606	99	95	6617	202	0	7013
3607	68	61	218	6731	0	7078
3608	65	6744	99	248	0	7156
3609	62	216	64	6901	0	7243
3610	32	115	45	6986	0	7178
3611	45	6866	43	314	0	7268
3612	6968	232	43	162	0	7405
3613	229	111	42	7021	0	7403
3614	105	76	6567	286	0	7034
3615	80	43	210	6834	0	7167
3616	60	41	89	7064	0	7254
3617	64	58	6512	344	0	6978
3618	61	39	220	6494	0	6814
3619	52	6514	110	288	0	6964
3620	44	233	6497	140	0	6914
3621	59	101	6151	116	0	6427
3622	23	5414	258	78	0	5773
3623	27	3985	86	50	0	4148
3624	5	3337	12	27	0	3381
3625	3059	98	17	12	0	3186
3626	3087	29	9	24	0	3149
3627	3135	19	8	23	0	3185
3628	101	10	10	3067	0	3188
3629	34	9	2941	96	0	3080
3630	12	17	75	3031	0	3135
3631	16	12	31	3123	0	3182
3632	3050	11	13	116	0	3190
3633	3085	13	16	42	0	3156
3634	102	2977	25	20	0	3124
3635	3075	80	8	22	0	3185
3636	3109	40	17	17	0	3183
3637	3148	15	15	17	0	3195
3638	125	20	2917	14	0	3076
3639	44	16	2966	15	0	3041
3640	20	10	100	2493	0	2623
3641	11	19	2463	92	0	2585
3642	2486	17	84	39	0	2626
3643	3209	15	31	24	0	3279
3644	118	21	2980	16	0	3135
3645	3102	17	70	19	0	3208
3646	101	3073	35	13	0	3222
3647	3155	82	10	23	0	3270
3648	105	28	11	3147	0	3291
3649	46	11	11	3089	0	3157
3650	26	3079	19	109	0	3233
3651	3143	85	17	42	0	3287
3652	3170	35	17	19	0	3241
3653	108	3081	19	28	0	3236
3654	52	85	14	3137	0	3288
3655	37	35	13	3173	0	3258
3656	33	3110	19	107	0	3269
3657	24	83	20	3148	0	3275
3658	32	37	17	3239	0	3325
3659	3164	27	10	123	0	3324
3660	3207	15	20	56	0	3298
3661	119	18	3095	38	0	3270
3662	3126	20	78	35	0	3259
3663	101	31	3088	28	0	3248
3664	52	20	86	3142	0	3300
3665	36	27	3030	102	0	3195
3666	28	3050	91	54	0	3223
3667	32	85	29	2956	0	3102
3668	27	41	18	3035	0	3121
3669	2976	33	17	115	0	3141
3670	97	20	10	3004	0	3131
3671	54	24	2837	98	0	3013
3672	2911	17	80	58	0	3066
3673	3008	18	41	42	0	3109
3674	3042	15	35	39	0	3131
3675	2901	22	22	35	0	2980
3676	118	20	21	3386	0	3545
3677	56	15	20	3467	0	3558
3678	40	22	14	3497	0	3573
3679	38	23	14	3513	0	3588
3680	3372	14	26	175	0	3587
3681	3455	12	17	82	0	3566
3682	161	15	25	3231	0	3432
3683	71	3274	27	130	0	3502
3684	3381	98	34	65	0	3578
3685	145	53	3168	42	0	3408
3686	64	3288	104	42	0	3498
3687	3144	105	39	38	0	3326
3688	131	3123	28	25	0	3307
3689	63	116	3106	30	0	3315
3690	3196	47	113	34	0	3390
3691	3306	30	35	32	0	3403
3692	165	26	3087	25	0	3303
3693	87	12	103	3166	0	3368
3694	62	10	38	3205	0	3315
3695	51	3096	35	141	0	3323
3696	47	97	19	2846	0	3009
3697	2756	39	24	127	0	2946
3698	118	2372	16	66	0	2572
3699	60	92	8	2436	0	2596
3700	48	39	12	2521	0	2620
3701	30	29	2250	147	0	2456
3702	28	2386	96	69	0	2579
3703	2020	69	24	43	0	2156
3704	68	1410	16	20	0	1514
3705	38	1476	11	17	0	1542
3706	1210	44	2	5	0	1261
3707	40	24	1	1189	0	1254
3708	15	11	0	1238	0	1264
3709	1193	7	2	43	0	1245
3710	40	3	0	1216	0	1259
3711	11	3	1	1242	0	1257
3712	1207	5	0	50	0	1262
3713	37	2	1	1215	0	1255
3714	14	1151	1	45	0	1211
3715	1191	30	2	18	0	1241
3716	39	11	1131	10	0	1191
3717	12	1122	32	16	0	1182
3718	9	34	6	1212	0	1261
3719	11	12	1140	45	0	1208
3720	6	10	1157	22	0	1195
3721	10	24	39	1144	0	1217
3722	1187	5	12	39	0	1243
3723	39	3	12	1175	0	1229
3724	9	8	9	1202	0	1228
3725	14	5	3	1217	0	1239
3726	9	2	6	1214	0	1231
3727	7	6	4	1223	0	1240
3728	10	8	1120	58	0	1196
3729	8	10	1134	23	0	1175
3730	6	3	45	1168	0	1222
3731	10	4	1119	43	0	1176
3732	13	1080	42	19	0	1154
3733	7	33	18	1172	0	1230
3734	1	15	1134	52	0	1202
3735	1000	7	35	30	0	1072
3736	40	1103	13	17	0	1173
3737	10	1115	7	27	0	1159
3738	17	1156	10	11	0	1194
3739	16	52	2	1146	0	1216
3740	1143	21	4	43	0	1211
3741	39	14	2	1141	0	1196
3742	1137	7	8	50	0	1202
3743	43	583	4	17	0	647
3744	593	36	3	13	0	645
3745	49	19	4	574	0	646
3746	17	21	2	585	0	625
3747	23	562	1	46	0	632
3748	11	35	1	590	0	637
3749	6	9	5	623	0	643
3750	13	10	2	622	0	647
3751	570	6	3	63	0	642
3752	597	7	6	31	0	641
3753	51	5	535	27	0	618
3754	592	5	35	20	0	652
3755	46	11	551	10	0	618
3756	26	6	35	575	0	642
3757	16	3	17	605	0	641
3758	7	10	16	610	0	643
3759	7	5	545	66	0	623
3760	5	2	41	595	0	643
3761	3	5	557	48	0	613
3762	2	9	43	598	0	652
3763	581	2	8	53	0	644
3764	38	5	563	22	0	628
3765	578	4	34	27	0	643
3766	50	2	11	588	0	651
3767	572	6	8	53	0	639
3768	46	560	10	26	0	642
3769	14	34	9	586	0	643
3770	13	7	553	48	0	621
3771	6	13	38	584	0	641
3772	10	5	10	601	0	626
3773	0	562	6	51	0	619
3774	6	40	526	32	0	604
3775	8	574	43	24	0	649
3776	8	0	0	0	0	8
3777	0	8	1	0	0	9
3778	7	0	0	0	0	7
3779	8	0	1	0	0	9
3780	8	1	0	0	0	9
3781	0	0	0	9	0	9
3782	0	0	8	0	0	8
3783	0	0	0	5	0	5
3784	0	6	1	1	0	8
3785	1	0	0	7	0	8
3786	8	0	0	1	0	9
3787	0	7	1	1	0	9
3788	0	0	0	9	0	9
3789	0	0	0	9	0	9
3790	8	0	0	1	0	9
3791	0	0	9	0	0	9
3792	0	495	1	0	0	496
3793	0	1	0	562	0	563
3794	0	1	546	1	0	548
3795	0	0	0	551	0	551
3796	0	514	1	1	0	516
3797	0	0	0	571	0	571
3798	0	1	0	537	0	538
3799	0	1	0	557	0	558
3800	1	0	541	0	0	542
3801	512	0	0	0	0	512
3802	0	0	0	569	0	569
3803	571	0	0	0	0	571
3804	543	0	0	0	0	543
3805	533	1	0	0	0	534
3806	547	0	0	0	0	547
3807	561	0	0	0	0	561
3808	0	0	0	566	0	566
3809	0	501	3	0	0	504
3810	0	0	0	575	0	575
3811	0	524	3	1	0	528
3812	0	0	0	568	0	568
3813	570	0	0	0	0	570
3814	0	0	0	564	0	564
3815	0	1	556	0	0	557
3816	529	1	0	1	0	531
3817	0	513	4	2	0	519
3818	571	0	0	0	0	571
3819	557	0	0	2	0	559
3820	568	0	0	0	0	568
3821	0	527	2	1	0	530
3822	0	0	0	569	0	569
3823	0	0	0	553	0	553
3824	1	0	550	0	0	551
3825	0	0	0	501	0	501
3826	0	0	0	542	0	542
3827	0	0	0	550	0	550
3828	0	520	0	0	0	520
3829	551	0	1	0	0	552
3830	515	0	0	0	0	515
3831	0	0	892	0	0	892
3832	0	866	0	5	0	871
3833	0	0	0	927	0	927
3834	0	0	0	923	0	923
3835	0	0	1	926	0	927
3836	0	0	0	914	0	914
3837	0	0	1	924	0	925
3838	1	2	867	0	0	870
3839	1	7	767	1	0	776
3840	879	0	0	0	0	879
3841	905	0	0	1	0	906
3842	910	0	0	0	0	910
3843	0	0	0	907	0	907
3844	0	1	867	3	0	871
3845	879	0	0	1	0	880
3846	895	0	0	1	0	896
3847	0	1	888	0	0	889
3848	1352	0	0	0	0	1352
3849	58	1	1349	0	0	1408
3850	3	0	53	1367	0	1423
3851	0	2	1356	60	0	1418
3852	1339	1	51	3	0	1394
3853	1416	0	1	2	0	1419
3854	1419	0	0	1	0	1420
3855	1409	1	2	0	0	1412
3856	60	2	1298	0	0	1360
3857	3	1297	55	1	0	1356
3858	1378	56	4	1	0	1439
3859	1437	3	0	1	0	1441
3860	62	1	1349	0	0	1412
3861	4	2	54	1324	0	1384
3862	1	0	4	1426	0	1431
3863	1	2	1339	60	0	1402
3864	1307	1	56	3	0	1367
3865	1421	0	3	0	0	1424
3866	61	1303	5	2	0	1371
3867	1372	59	4	0	0	1435
3868	1427	4	1	3	0	1435
3869	1430	0	2	1	0	1433
3870	1432	0	4	1	0	1437
3871	68	3	1307	1	0	1379
3872	1314	1	50	1	0	1366
3873	64	2	5	1322	0	1393
3874	9	1321	7	53	0	1390
3875	10	62	1284	6	0	1362
3876	6	1305	62	2	0	1375
3877	7	55	6	1358	0	1426
3878	7	8	1347	60	0	1422
3879	1319	0	54	6	0	1379
3880	70	4	1331	2	0	1407
3881	1343	4	60	1	0	1408
3882	66	4	7	1335	0	1412
3883	14	4	2	1393	0	1413
3884	6	1299	6	60	0	1371
3885	7	1365	7	4	0	1383
3886	8	59	3	1427	0	1497
3887	1424	5	6	62	0	1497
3888	1471	0	3	8	0	1482
3889	1477	0	4	5	0	1486
3890	73	7	1342	1	0	1423
3891	1367	3	57	3	0	1430
3892	69	7	895	0	0	971
3893	11	4	899	3	0	917
3894	911	1	58	3	0	973
3895	977	2	6	2	0	987
3896	75	2	899	0	0	976
3897	13	1	61	898	0	973
3898	6	1	7	979	0	993
3899	913	1	8	63	0	985
3900	965	3	7	6	0	981
3901	71	8	867	2	0	948
3902	14	868	50	4	0	936
3903	8	944	12	4	0	968
3904	911	65	8	6	0	990
3905	63	8	8	901	0	980
3906	18	2	3	963	0	986
3907	10	0	6	986	0	1002
3908	1063	2	6	72	0	1143
3909	66	5	4	1187	0	1262
3910	1181	6	3	68	0	1258
3911	1238	5	7	7	0	1257
3912	78	1665	5	4	0	1752
3913	20	62	2	1736	0	1820
3914	15	6	1699	64	0	1784
3915	1661	3	60	6	0	1730
3916	1777	0	11	5	0	1793
3917	1785	1	15	5	0	1806
3918	79	3	1717	5	0	1804
3919	20	2	64	2054	0	2140
3920	2110	3	11	91	0	2215
3921	2135	4	7	13	0	2159
3922	2116	4	7	14	0	2141
3923	97	1981	13	7	0	2098
3924	21	2104	9	9	0	2143
3925	18	88	9	2088	0	2203
3926	15	13	8	2135	0	2171
3927	12	2033	14	87	0	2146
3928	2091	90	7	14	0	2202
3929	97	9	2444	17	0	2567
3930	13	12	77	2452	0	2554
3931	21	4	7	2255	0	2287
3932	23	9	2137	98	0	2267
3933	2054	10	84	17	0	2165
3934	2266	11	8	13	0	2298
3935	101	2086	12	7	0	2206
3936	2224	87	7	9	0	2327
3937	112	9	2128	13	0	2262
3938	2139	11	88	6	0	2244
3939	110	9	2136	4	0	2259
3940	2131	5	93	9	0	2238
3941	2269	7	14	11	0	2301
3942	2271	6	13	12	0	2302
3943	2256	4	11	8	0	2279
3944	99	2071	17	12	0	2199
3945	2218	85	9	8	0	2320
3946	2284	11	9	12	0	2316
3947	114	15	2135	7	0	2271
3948	1672	2	27	0	0	1701
3949	33	1	5	1688	0	1727
3950	10	1	1667	25	0	1703
3951	1660	1	23	1	0	1685
3952	35	1	1	1701	0	1738
3953	1714	2	5	29	0	1750
3954	1730	5	0	3	0	1738
3955	34	4	1888	7	0	1933
3956	1921	3	25	4	0	1953
3957	1983	4	3	0	0	1990
3958	1956	2	8	1	0	1967
3959	1955	2	5	4	0	1966
3960	33	2	3	1883	0	1921
3961	8	1840	6	33	0	1887
3962	1940	26	5	5	0	1976
3963	1938	2	3	8	0	1951
3964	1942	5	1	3	0	1951
3965	39	2	1892	2	0	1935
3966	15	1807	26	2	0	1850
3967	12	24	8	1917	0	1961
3968	14	2	5	1945	0	1966
3969	14	7	1913	26	0	1960
3970	14	1	24	1862	0	1901
3971	12	4	1911	32	0	1959
3972	7	5	28	1881	0	1921
3973	12	1	2	1935	0	1950
3974	13	4	2619	29	0	2665
3975	2494	2	25	9	0	2530
3976	2668	5	5	4	0	2682
3977	32	8	2649	4	0	2693
3978	2546	4	24	4	0	2578
3979	2649	3	6	10	0	2668
3980	32	5	2644	8	0	2689
3981	14	3	26	2508	0	2551
3982	14	1	6	2637	0	2658
3983	2677	2	10	34	0	2723
3984	32	2552	7	12	0	2603
3985	2617	25	12	12	0	2666
3986	2598	3	5	6	0	2612
3987	41	2509	5	4	0	2559
3988	2614	26	5	3	0	2648
3989	2582	5	6	3	0	2596
3990	38	2518	6	5	0	2567
3991	15	30	6	2562	0	2613
3992	17	2520	10	27	0	2574
3993	13	29	3	2619	0	2664
3994	16	5	2547	32	0	2600
3995	13	12	2487	5	0	2517
3996	2406	5	27	7	0	2445
3997	2538	4	9	6	0	2557
3998	39	10	2538	3	0	2590
3999	2481	5	30	0	0	2516
4000	2532	4	3	5	0	2544
4001	2581	5	12	6	0	2604
4002	37	2452	7	8	0	2504
4003	11	29	5	2576	0	2621
4004	2602	4	7	31	0	2644
4005	2526	5	8	7	0	2546
4006	40	4	2554	8	0	2606
4007	18	1	30	2429	0	2478
4008	19	3	6	2287	0	2315
4009	13	2459	16	24	0	2512
4010	12	2939	13	8	0	2972
4011	16	25	6	2889	0	2936
4012	11	2408	8	26	0	2453
4013	2451	34	4	7	0	2496
4014	27	3239	5	14	0	3285
4015	3344	71	2	7	0	3424
4016	95	25	3154	4	0	3278
4017	3181	13	66	7	0	3267
4018	3364	4	373	12	0	3753
4019	3322	3	4	4	0	3333
4020	3265	2	1	1	0	3269
4021	79	3189	6	1	0	3275
4022	24	57	1	3313	0	3395
4023	12	24	1	3373	0	3410
4024	14	17	3213	81	0	3325
4025	10	9	59	3250	0	3328
4026	14	6	18	3355	0	3393
4027	3323	6	8	88	0	3425
4028	64	3229	7	39	0	3339
4029	33	61	4	3293	0	3391
4030	14	27	5	3345	0	3391
4031	10	12	1	3381	0	3404
4032	3342	8	2	95	0	3447
4033	74	12	4	3340	0	3430
4034	3354	7	4	79	0	3444
4035	70	1	8	3303	0	3382
4036	36	4	5	3384	0	3429
4037	21	19	3161	101	0	3302
4038	3027	8	60	42	0	3137
4039	76	3189	28	22	0	3315
4040	3352	68	7	16	0	3443
4041	78	21	5	3275	0	3379
4042	41	8	8	3356	0	3413
4043	3309	7	12	94	0	3422
4044	3475	6	4	44	0	3529
4045	106	12	2	3453	0	3573
4046	53	13	3408	76	0	3550
4047	20	16	3273	55	0	3364
4048	10	3404	84	43	0	3541
4049	3496	65	25	19	0	3605
4050	3449	30	11	23	0	3513
4051	96	14	4	3386	0	3500
4052	48	3434	13	77	0	3572
4053	23	69	5	3507	0	3604
4054	23	32	6	3516	0	3577
4055	29	3169	15	108	0	3321
4056	3222	69	11	50	0	3352
4057	78	31	6	3173	0	3288
4058	41	3761	20	86	0	3908
4059	26	3966	16	51	0	4059
4060	4068	88	9	34	0	4199
4061	95	53	4184	26	0	4358
4062	4277	20	85	23	0	4405
4063	115	23	34	4324	0	4496
4064	60	19	15	4339	0	4433
4065	41	4260	24	135	0	4460
4066	58	98	8	4434	0	4598
4067	48	56	4163	118	0	4385
4068	47	4054	96	67	0	4264
4069	34	4302	40	52	0	4428
4070	4279	120	20	56	0	4475
4071	108	4267	21	45	0	4441
4072	63	106	17	4324	0	4510
4073	41	4253	29	127	0	4450
4074	39	127	13	3720	0	3899
4075	41	61	13	3776	0	3891
4076	42	39	3546	176	0	3803
4077	38	44	91	3614	0	3787
4078	43	24	47	3805	0	3919
4079	3702	33	22	162	0	3919
4080	131	39	3573	82	0	3825
4081	80	32	93	3677	0	3882
4082	48	36	3552	163	0	3799
4083	3568	33	108	94	0	3803
4084	117	3583	45	71	0	3816
4085	3744	106	19	82	0	3951
4086	134	56	29	3692	0	3911
4087	80	36	22	3789	0	3927
4088	47	46	3494	188	0	3775
4089	3356	24	104	117	0	3601
4090	131	3586	43	71	0	3831
4091	3325	127	28	65	0	3545
4092	139	52	30	3603	0	3824
4093	59	3526	40	157	0	3782
4094	3578	110	25	90	0	3803
4095	136	3948	33	64	0	4181
4096	80	123	15	4076	0	4294
4097	61	60	18	4133	0	4272
4098	43	30	24	4158	0	4255
4099	33	3928	35	178	0	4174
4100	48	109	28	4107	0	4292
4101	61	70	18	4160	0	4309
4102	4094	49	16	172	0	4331
4103	4121	43	10	114	0	4288
4104	4144	34	27	90	0	4295
4105	162	55	3833	70	0	4120
4106	3994	38	102	75	0	4209
4107	4126	27	52	67	0	4272
4108	4139	38	31	62	0	4270
4109	176	28	3614	72	0	3890
4110	3340	34	106	58	0	3538
4111	152	97	45	3387	0	3681
4112	74	42	3304	147	0	3567
4113	65	3310	113	80	0	3568
4114	40	55	14	3602	0	3711
4115	24	3411	19	64	0	3518
4116	26	4111	27	30	0	4194
4117	4364	64	7	36	0	4471
4118	37	12	2	3947	0	3998
4119	3972	15	13	42	0	4042
4120	41	11	9	3908	0	3969
4121	3974	11	2	48	0	4035
4122	40	17	6	3892	0	3955
4123	3967	16	4	38	0	4025
4124	38	13	3680	22	0	3753
4125	21	13	30	3847	0	3911
4126	22	13	3677	41	0	3753
4127	23	30	3254	26	0	3333
4128	15	9	3654	28	0	3706
4129	13	8	36	3333	0	3390
4130	10	14	3373	47	0	3444
4131	3425	10	41	23	0	3499
4132	36	9	16	3516	0	3577
4133	13	14	3446	53	0	3526
4134	22	9	43	3414	0	3488
4135	23	10	10	3502	0	3545
4136	15	14	3431	50	0	3510
4137	20	12	39	3385	0	3456
4138	24	9	10	3415	0	3458
4139	20	3264	13	51	0	3348
4140	3545	34	16	20	0	3615
4141	3525	9	13	26	0	3573
4142	41	11	3318	33	0	3403
4143	3333	8	43	22	0	3406
4144	34	11	3112	17	0	3174
4145	11	10	2972	17	0	3010
4146	11	8	3070	10	0	3099
4147	17	3	29	3138	0	3187
4148	13	3	3213	34	0	3263
4149	6	3	32	3166	0	3207
4150	12	0	12	3218	0	3242
4151	7	3	15	3253	0	3278
4152	8	3	18	3279	0	3308
4153	3239	3	7	45	0	3294
4154	3122	4	7	21	0	3154
4155	34	3087	10	14	0	3145
4156	12	24	4	3253	0	3293
4157	11	6	3172	35	0	3224
4158	10	2434	27	12	0	2483
4159	12	33	4	2548	0	2597
4160	13	6	2504	40	0	2563
4161	2	0	1	2035	0	2038
4162	0	0	2138	1	0	2139
4163	0	2	2004	2	0	2008
4164	0	1	0	2118	0	2119
4165	0	2	1	2134	0	2137
4166	2154	0	0	2	0	2156
4167	1	2	0	2142	0	2145
4168	2163	1	0	2	0	2166
4169	2	2048	5	1	0	2056
4170	1	2008	3	0	0	2012
4171	0	3	1	2178	0	2182
4172	2182	0	0	1	0	2183
4173	1	2057	8	0	0	2066
4174	0	1	1	2167	0	2169
4175	2179	1	1	1	0	2182
4176	2123	0	0	1	0	2124
4177	2131	0	1	4	0	2136
4178	2115	0	0	2	0	2117
4179	2091	0	1	2	0	2094
4180	1	2	2005	1	0	2009
4181	1	4	1902	2	0	1909
4182	0	1956	5	0	0	1961
4183	1	1	0	2132	0	2134
4184	2	4	2061	0	0	2067
4185	1	3	1989	2	0	1995
4186	1	0	1	2012	0	2014
4187	0	1	2094	0	0	2095
4188	2	3	1969	2	0	1976
4189	0	2362	12	5	0	2379
4190	2676	53	0	2	0	2731
4191	45	2904	12	2	0	2963
4192	2	65	1	3033	0	3101
4193	3063	11	0	58	0	3132
4194	63	2907	3	12	0	2985
4195	10	69	0	2695	0	2774
4196	8	9	2598	70	0	2685
4197	2508	7	60	9	0	2584
4198	3257	9	6	6	0	3278
4199	3250	6	8	8	0	3272
4200	87	3	8	3192	0	3290
4201	27	5	3084	78	0	3194
4202	15	2992	70	13	0	3090
4203	12	73	11	3234	0	3330
4204	3170	11	7	82	0	3270
4205	81	13	3014	11	0	3119
4206	13	3144	84	9	0	3250
4207	15	79	3311	11	0	3416
4208	3239	15	81	7	0	3342
4209	3467	10	20	3	0	3500
4210	3516	16	8	7	0	3547
4211	99	11	3262	7	0	3379
4212	30	3115	75	6	0	3226
4213	23	76	15	3382	0	3496
4214	18	12	10	2461	0	2501
4215	10	10	14	2509	0	2543
4216	11	10	1777	94	0	1892
4217	1885	10	74	26	0	1995
4218	91	9	2407	21	0	2528
4219	2555	5	78	14	0	2652
4220	3315	7	26	8	0	3356
4221	3888	8	10	7	0	3913
4222	4849	9	16	17	0	4891
4223	201	33	5345	11	0	5590
4224	87	10	160	5553	0	5810
4225	58	37	5186	167	0	5448
4226	31	5292	182	82	0	5587
4227	31	5631	69	34	0	5765
4228	5875	222	35	27	0	6159
4229	5766	93	22	29	0	5910
4230	227	5814	28	23	0	6092
4231	6049	189	14	20	0	6272
4232	241	83	5440	15	0	5779
4233	5804	42	157	12	0	6015
4234	221	5924	67	29	0	6241
4235	6188	182	44	13	0	6427
4236	6297	80	21	14	0	6412
4237	280	41	18	6129	0	6468
4238	133	31	13	6308	0	6485
4239	6159	19	28	245	0	6451
4240	221	32	18	6256	0	6527
4241	6197	22	30	223	0	6472
4242	250	25	10	6585	0	6870
4243	6509	11	29	233	0	6782
4244	6490	19	32	88	0	6629
4245	274	6243	29	68	0	6614
4246	135	6510	36	47	0	6728
4247	6316	236	30	44	0	6626
4248	211	6452	35	53	0	6751
4249	109	235	26	6381	0	6751
4250	80	91	38	6689	0	6898
4251	6334	62	23	253	0	6672
4252	226	6229	51	129	0	6635
4253	137	6149	41	74	0	6401
4254	88	6225	56	51	0	6420
4255	103	268	5999	40	0	6410
4256	83	127	6104	45	0	6359
4257	71	70	6256	49	0	6446
4258	65	59	271	5877	0	6272
4259	64	6872	139	180	0	7255
4260	7235	235	67	96	0	7633
4261	251	118	7051	65	0	7485
4262	148	76	6933	56	0	7213
4263	100	55	7109	39	0	7303
4264	112	55	301	6986	0	7454
4265	97	41	135	7252	0	7525
4266	100	48	70	7455	0	7673
4267	7520	35	47	315	0	7917
4268	7577	45	53	127	0	7802
4269	7626	63	44	83	0	7816
4270	346	52	58	7431	0	7887
4271	176	47	7171	259	0	7653
4272	123	50	7171	112	0	7456
4273	97	63	267	7278	0	7705
4274	103	48	112	7510	0	7773
4275	7417	41	70	299	0	7827
4276	295	7233	52	156	0	7736
4277	7430	237	51	83	0	7801
4278	321	7174	51	71	0	7617
4279	166	255	39	7404	0	7864
4280	105	133	7146	257	0	7641
4281	106	82	199	7339	0	7726
4282	7482	67	78	292	0	7919
4283	296	51	7089	147	0	7583
4284	7269	57	226	115	0	7667
4285	302	40	7254	104	0	7700
4286	169	59	7226	69	0	7523
4287	7144	69	282	77	0	7572
4288	310	90	7221	58	0	7679
4289	147	44	6508	61	0	6760
4290	127	6234	247	51	0	6659
4291	6336	173	119	44	0	6672
4292	6384	110	67	54	0	6615
4293	6420	84	60	62	0	6626
4294	255	68	6128	60	0	6511
4295	6088	66	181	39	0	6374
4296	217	6100	91	40	0	6448
4297	6419	206	58	42	0	6725
4298	214	88	5526	22	0	5850
4299	128	43	145	5542	0	5858
4300	73	46	5543	144	0	5806
4301	78	5342	184	79	0	5683
4302	58	129	98	5643	0	5928
4303	77	66	39	5800	0	5982
4304	5679	51	24	224	0	5978
4305	5754	19	16	127	0	5916
4306	5561	22	24	74	0	5681
4307	5572	22	23	68	0	5685
4308	5540	16	25	73	0	5654
4309	257	15	5203	59	0	5534
4310	132	20	135	5234	0	5521
4311	102	35	5325	148	0	5610
4312	58	37	144	5392	0	5631
4313	5412	40	65	167	0	5684
4314	5496	54	48	70	0	5668
4315	5462	63	29	58	0	5612
4316	5502	37	25	58	0	5622
4317	238	37	5202	52	0	5529
4318	114	33	141	4657	0	4945
4319	69	47	4604	165	0	4885
4320	61	4057	157	102	0	4377
4321	44	3643	76	33	0	3796
4322	30	28	7	1788	0	1853
4323	7	8	13	1839	0	1867
4324	6	4	10	1805	0	1825
4325	5	6	12	2077	0	2100
4326	2083	2	7	39	0	2131
4327	36	2005	11	7	0	2059
4328	1826	26	4	4	0	1860
4329	32	4	4	1802	0	1842
4330	10	2	2	1785	0	1799
4331	5	1766	6	24	0	1801
4332	7	23	5	1829	0	1864
4333	1817	2	7	32	0	1858
4334	33	1563	9	8	0	1613
4335	9	1586	8	4	0	1607
4336	1641	22	2	6	0	1671
4337	31	5	5	1598	0	1639
4338	7	1552	7	32	0	1598
4339	7	25	5	1632	0	1669
4340	1620	3	5	32	0	1660
4341	31	3	5	1591	0	1630
4342	11	4	3	1304	0	1322
4343	1309	4	3	27	0	1343
4344	33	5	3	1276	0	1317
4345	13	1245	7	24	0	1289
4346	13	23	6	1276	0	1318
4347	8	1248	8	30	0	1294
4348	6	22	6	1298	0	1332
4349	1281	7	4	31	0	1323
4350	1278	4	6	10	0	1298
4351	30	5	1	1273	0	1309
4352	12	4	1229	38	0	1283
4353	1176	5	24	13	0	1218
4354	35	4	1229	7	0	1275
4355	1191	7	25	9	0	1232
4356	1236	3	3	9	0	1251
4357	35	8	1228	6	0	1277
4358	3	840	8	3	0	854
4359	438	1	1	3	0	443
4360	428	2	2	1	0	433
4361	3	1	800	6	0	810
4362	788	0	4	2	0	794
4363	801	1	1	1	0	804
4364	796	2	1	1	0	800
4365	3	2	2	801	0	808
4366	5	2	1	792	0	800
4367	3	622	0	2	0	627
4368	4	3	1	641	0	649
4369	5	0	2	645	0	652
4370	5	3	629	3	0	640
4371	4	3	605	1	0	613
4372	614	0	2	4	0	620
4373	637	1	0	3	0	641
4374	2	622	2	7	0	633
4375	4	5	0	646	0	655
4376	4	4	1211	4	0	1223
4377	1	2	3	1240	0	1246
4378	0	3	4	1251	0	1258
4379	4	0	2	1274	0	1280
4380	6	1223	5	2	0	1236
4381	4	4	0	1292	0	1300
4382	5	5	0	1294	0	1304
4383	6	2	1265	3	0	1276
4384	1	4	1264	5	0	1274
4385	1217	2	2	5	0	1226
4386	1275	1	1	6	0	1283
4387	2	4	2	2049	0	2057
4388	3	3	3	2116	0	2125
4389	3	2	0	2139	0	2144
4390	3	7	2008	75	0	2093
4391	2	1959	65	20	0	2046
4392	6	72	2029	5	0	2112
4393	2062	9	66	1	0	2138
4394	74	8	2048	7	0	2137
4395	2074	0	64	7	0	2145
4396	2088	1	5	4	0	2098
4397	2143	0	6	6	0	2155
4398	78	1	2	2078	0	2159
4399	12	6	2011	70	0	2099
4400	5	1995	70	12	0	2082
4401	3	68	9	2080	0	2160
4402	5	7	6	2146	0	2164
4403	11	9	2481	82	0	2583
4404	6	2488	126	16	0	2636
4405	2496	135	29	7	0	2667
4406	129	2545	16	5	0	2695
4407	2612	138	11	3	0	2764
4408	142	34	9	2543	0	2728
4409	46	12	2461	131	0	2650
4410	18	2475	133	34	0	2660
4411	2603	133	36	16	0	2788
4412	146	37	3432	14	0	3629
4413	3511	15	192	13	0	3731
4414	3723	22	56	10	0	3811
4415	258	15	3451	19	0	3743
4416	3509	13	192	15	0	3729
4417	3675	9	65	8	0	3757
4418	3627	14	15	10	0	3666
4419	247	3450	31	5	0	3733
4420	3513	201	16	9	0	3739
4421	216	3435	21	14	0	3686
4422	89	195	3530	21	0	3835
4423	42	3601	191	16	0	3850
4424	3739	206	55	14	0	4014
4425	3590	64	27	8	0	3689
4426	3674	30	22	8	0	3734
4427	266	18	25	3365	0	3674
4428	92	24	12	3653	0	3781
4429	3407	19	22	229	0	3677
4430	3612	18	23	58	0	3711
4431	265	17	13	3413	0	3708
4432	95	19	3337	197	0	3648
4433	44	3222	190	63	0	3519
4434	45	3531	51	26	0	3653
4435	36	235	13	3462	0	3746
4436	32	74	3382	207	0	3695
4437	32	36	196	3243	0	3507
4438	38	3317	66	192	0	3613
4439	39	198	31	3435	0	3703
4440	57	63	3434	201	0	3755
4441	38	35	187	3443	0	3703
4442	36	30	3463	214	0	3743
4443	30	29	209	3476	0	3744
4444	36	31	3463	214	0	3744
4445	44	48	3506	80	0	3678
4446	3343	30	256	43	0	3672
4447	3614	38	85	35	0	3772
4448	3645	29	39	34	0	3747
4449	260	3333	59	45	0	3697
4450	96	210	47	3461	0	3814
4451	3383	73	33	223	0	3712
4452	3596	31	48	81	0	3756
4453	3657	28	33	41	0	3759
4454	293	37	3348	40	0	3718
4455	123	3115	235	35	0	3508
4456	73	3542	83	27	0	3725
4457	3472	251	44	30	0	3797
4458	247	96	42	3456	0	3841
4459	3555	48	42	213	0	3858
4460	270	50	3360	74	0	3754
4461	143	37	209	3070	0	3459
4462	88	49	81	3809	0	4027
4463	89	44	41	3632	0	3806
4464	84	3610	60	249	0	4003
4465	3596	249	40	97	0	3982
4466	3784	83	31	59	0	3957
4467	322	3636	49	42	0	4049
4468	142	251	38	3715	0	4146
4469	3701	100	39	252	0	4092
4470	303	55	53	3707	0	4118
4471	3678	81	37	279	0	4075
4472	311	3604	56	117	0	4088
4473	3790	288	44	56	0	4178
4474	328	110	3537	61	0	4036
4475	148	3500	251	64	0	3963
4476	108	261	3003	72	0	3444
4477	80	99	256	3102	0	3537
4478	3137	57	99	282	0	3575
4479	3323	67	64	99	0	3553
4480	3377	41	55	73	0	3546
4481	384	40	64	3089	0	3577
4482	3180	59	58	272	0	3569
4483	337	51	55	3165	0	3608
4484	3130	53	62	301	0	3546
4485	3328	42	56	129	0	3555
4486	370	68	3025	82	0	3545
4487	157	41	2315	50	0	2563
4488	104	59	2332	40	0	2535
4489	96	39	229	2258	0	2622
4490	2277	52	96	207	0	2632
4491	224	31	64	2468	0	2787
4492	137	38	43	2647	0	2865
4493	2562	21	42	258	0	2883
4494	2649	18	57	109	0	2833
4495	2673	26	60	75	0	2834
4496	2682	38	35	79	0	2834
4497	278	27	54	2513	0	2872
4498	2461	25	37	225	0	2748
4499	220	2411	41	108	0	2780
4500	2066	165	45	74	0	2350
4501	2156	72	59	70	0	2357
4502	255	46	2004	82	0	2387
4503	1544	14	101	23	0	1682
4504	128	6	1497	36	0	1667
4505	59	11	1535	31	0	1636
4506	40	15	1557	31	0	1643
4507	51	14	110	1492	0	1667
4508	44	23	1489	93	0	1649
4509	46	9	102	1500	0	1657
4510	41	12	1998	109	0	2160
4511	36	9	2046	54	0	2145
4512	16	2	28	1448	0	1494
4513	13	4	12	1522	0	1551
4514	13	8	1481	36	0	1538
4515	1472	4	33	15	0	1524
4516	43	7	11	1517	0	1578
4517	14	5	18	1539	0	1576
4518	1536	8	21	32	0	1597
4519	34	5	13	1525	0	1577
4520	20	5	1494	46	0	1565
4521	22	12	1469	16	0	1519
4522	18	1	32	1347	0	1398
4523	19	6	1330	40	0	1395
4524	11	1578	45	20	0	1654
4525	16	28	16	1661	0	1721
4526	1679	9	16	39	0	1743
4527	42	11	1607	16	0	1676
4528	1601	4	39	19	0	1663
4529	46	9	13	1652	0	1720
4530	19	0	19	1667	0	1705
4531	19	5	9	1687	0	1720
4532	17	7	7	1700	0	1731
4533	1650	1	13	56	0	1720
4534	37	1593	13	37	0	1680
4535	23	27	7	1683	0	1740
4536	28	6	12	1682	0	1728
4537	26	12	7	1681	0	1726
4538	15	5	15	1705	0	1740
4539	1663	5	10	58	0	1736
4540	41	1593	17	26	0	1677
4541	1660	31	9	25	0	1725
4542	54	1581	11	19	0	1665
4543	15	1633	16	16	0	1680
4544	1670	34	11	20	0	1735
4545	44	11	1842	19	0	1916
4546	19	11	32	1878	0	1940
4547	1921	4	13	42	0	1980
4548	1904	4	9	21	0	1938
4549	1794	6	14	29	0	1843
4550	1917	3	10	16	0	1946
4551	46	2001	10	20	0	2077
4552	2072	35	9	14	0	2130
4553	2093	9	10	14	0	2126
4554	51	2018	7	18	0	2094
4555	30	40	8	2066	0	2144
4556	24	19	2022	40	0	2105
4557	21	12	42	2053	0	2128
4558	2031	4	16	57	0	2108
4559	47	1	2009	20	0	2077
4560	27	1936	37	20	0	2020
4561	27	38	2010	20	0	2095
4562	2	4	7	1337	0	1350
4563	1	1341	9	6	0	1357
4564	1431	8	2	3	0	1444
4565	7	1382	2	2	0	1393
4566	4	9	2	1419	0	1434
4567	2	4	0	1447	0	1453
4568	1447	3	0	10	0	1460
4569	9	0	1	1402	0	1412
4570	2	1374	5	10	0	1391
4571	1443	7	0	3	0	1453
4572	1411	3	2	2	0	1418
4573	10	1836	6	1	0	1853
4574	1868	30	1	2	0	1901
4575	31	1843	4	1	0	1879
4576	1886	38	0	1	0	1925
4577	38	1843	4	1	0	1886
4578	12	40	2	1760	0	1814
4579	8	11	0	1898	0	1917
4580	1871	10	1	34	0	1916
4581	1865	5	3	14	0	1887
4582	40	1799	3	11	0	1853
4583	17	36	1759	7	0	1819
4584	1841	9	31	3	0	1884
4585	41	9	3	1793	0	1846
4586	12	1792	8	27	0	1839
4587	10	37	4	1883	0	1934
4588	1882	8	0	37	0	1927
4589	1876	9	2	8	0	1895
4590	1885	9	1	13	0	1908
4591	44	5	2	1654	0	1705
4592	21	14	1602	36	0	1673
4593	1640	2	30	12	0	1684
4594	1670	11	6	9	0	1696
4595	1671	6	11	8	0	1696
4596	48	1584	12	7	0	1651
4597	29	32	8	1630	0	1699
4598	19	1618	3	40	0	1680
4599	20	39	2	1660	0	1721
4600	19	10	5	1681	0	1715
4601	14	27	1803	43	0	1887
4602	22	5	30	2102	0	2159
4603	19	11	5	2170	0	2205
4604	2088	12	11	67	0	2178
4605	55	2086	11	22	0	2174
4606	2087	53	7	20	0	2167
4607	2153	11	5	21	0	2190
4608	71	13	5	2111	0	2200
4609	33	16	2018	55	0	2122
4610	22	1570	49	25	0	1666
4611	20	1653	22	14	0	1709
4612	1605	57	12	11	0	1685
4613	56	1674	10	16	0	1756
4614	34	58	9	1648	0	1749
4615	21	28	2	1730	0	1781
4616	20	19	1595	71	0	1705
4617	22	23	1586	21	0	1652
4618	10	1639	56	27	0	1732
4619	11	57	16	1664	0	1748
4620	1643	20	16	59	0	1738
4621	56	15	6	1699	0	1776
4622	21	17	1609	77	0	1724
4623	19	13	61	1684	0	1777
4624	1386	11	12	74	0	1483
4625	1392	14	14	23	0	1443
4626	73	1384	8	28	0	1493
4627	1376	63	5	20	0	1464
4628	71	1381	13	19	0	1484
4629	1404	66	7	21	0	1498
4630	71	18	10	1406	0	1505
4631	32	25	1324	61	0	1442
4632	27	35	1337	17	0	1416
4633	18	1385	59	24	0	1486
4634	20	64	16	1371	0	1471
4635	16	20	17	1449	0	1502
4636	1404	20	12	71	0	1507
4637	1424	24	9	39	0	1496
4638	1439	15	7	39	0	1500
4639	88	13	14	1385	0	1500
4640	40	20	6	1436	0	1502
4641	33	16	13	1457	0	1519
4642	21	16	1349	85	0	1471
4643	33	12	1368	40	0	1453
4644	1412	11	64	28	0	1515
4645	1192	18	19	18	0	1247
4646	75	10	1116	14	0	1215
4647	1159	17	50	18	0	1244
4648	1184	8	12	14	0	1218
4649	71	15	1068	17	0	1171
4650	24	1135	63	17	0	1239
4651	23	44	21	962	0	1050
4652	24	19	923	57	0	1023
4653	16	957	58	27	0	1058
4654	22	47	11	898	0	978
4655	30	949	16	47	0	1042
4656	27	49	928	25	0	1029
4657	26	18	979	22	0	1045
4658	19	19	51	986	0	1075
4659	969	13	25	62	0	1069
4660	62	20	15	1775	0	1872
4661	1784	19	12	60	0	1875
4662	62	16	10	1767	0	1855
4663	26	18	1715	67	0	1826
4664	1710	11	59	28	0	1808
4665	53	10	1710	31	0	1804
4666	1764	9	64	19	0	1856
4667	64	12	25	1718	0	1819
4668	27	1705	21	58	0	1811
4669	28	50	16	1740	0	1834
4670	20	1704	18	65	0	1807
4671	27	51	16	1689	0	1783
4672	17	1732	20	68	0	1837
4673	1306	20	8	16	0	1350
4674	1296	8	5	14	0	1323
4675	1269	12	10	13	0	1304
4676	32	10	1261	13	0	1316
4677	16	12	24	1267	0	1319
4678	17	12	1277	27	0	1333
4679	14	1239	28	11	0	1292
4680	16	1284	12	12	0	1324
4681	1290	23	16	10	0	1339
4682	27	15	1271	11	0	1324
4683	15	1230	26	15	0	1286
4684	11	22	10	1299	0	1342
4685	1295	8	9	30	0	1342
4686	34	1260	7	13	0	1314
4687	1313	27	5	13	0	1358
4688	36	6	1242	14	0	1298
4689	9	8	26	1280	0	1323
4690	10	9	6	1301	0	1326
4691	9	5	14	1315	0	1343
4692	7	1255	14	29	0	1305
4693	14	24	10	1275	0	1323
4694	18	7	1268	31	0	1324
4695	16	6	29	1255	0	1306
4696	19	6	10	1308	0	1343
4697	19	3	10	1310	0	1342
4698	21	1249	12	25	0	1307
4699	13	26	14	1297	0	1350
4700	12	10	13	1317	0	1352
4701	9	1038	8	25	0	1080
4702	815	2	2	1	0	820
4703	1	772	3	2	0	778
4704	0	778	0	3	0	781
4705	0	4	0	821	0	825
4706	0	2	788	3	0	793
4707	676	1	4	6	0	687
4708	2	0	1	773	0	776
4709	0	0	796	4	0	800
4710	0	752	3	1	0	756
4711	0	3	0	806	0	809
4712	1	2	791	3	0	797
4713	0	0	0	977	0	977
4714	0	0	0	1021	0	1021
4715	1037	0	0	0	0	1037
4716	0	967	2	0	0	969
4717	1005	1	0	0	0	1006
4718	2	1	979	0	0	982
4719	0	911	1	1	0	913
4720	1	3	974	0	0	978
4721	0	0	1	993	0	994
4722	1027	0	0	0	0	1027
4723	0	0	0	1009	0	1009
4724	1025	0	0	1	0	1026
4725	1013	0	0	0	0	1013
4726	1	0	0	982	0	983
4727	0	2	963	1	0	966
4728	0	1	936	0	0	937
4729	0	0	0	986	0	986
4730	0	1	0	987	0	988
4731	998	0	0	0	0	998
4732	0	0	0	997	0	997
4733	0	950	0	0	0	950
4734	0	0	0	1010	0	1010
4735	0	0	0	1007	0	1007
4736	1011	0	0	0	0	1011
4737	0	947	3	1	0	951
4738	0	0	1	996	0	997
4739	0	0	0	1005	0	1005
4740	0	951	1	0	0	952
4741	0	0	0	1008	0	1008
4742	0	0	0	1006	0	1006
4743	0	958	2	4	0	964
4744	0	0	0	1009	0	1009
4745	0	0	0	1006	0	1006
4746	0	950	3	1	0	954
4747	0	1	0	1010	0	1011
4748	1003	0	1	0	0	1004
4749	983	0	0	2	0	985
4750	980	0	0	0	0	980
4751	974	0	0	3	0	977
4752	0	945	1	0	0	946
4753	1009	0	0	1	0	1010
4754	0	949	1	3	0	953
4755	0	979	1	3	0	983
4756	0	2	0	994	0	996
4757	1	1	961	0	0	963
4758	871	0	0	2	0	873
4759	929	0	0	2	0	931
4760	0	1	398	0	0	399
4761	373	1	0	0	0	374
4762	414	0	0	0	0	414
4763	0	388	2	0	0	390
4764	416	0	0	1	0	417
4765	0	0	1	411	0	412
4766	1	0	0	404	0	405
4767	0	0	0	413	0	413
4768	0	0	1	412	0	413
4769	416	1	0	0	0	417
4770	0	0	0	407	0	407
4771	0	0	1	408	0	409
4772	0	0	406	1	0	407
4773	360	0	0	0	0	360
4774	402	0	0	1	0	403
4775	406	1	0	0	0	407
4776	1	388	0	1	0	390
4777	0	385	2	1	0	388
4778	412	1	0	0	0	413
4779	0	0	2	400	0	402
4780	0	901	2	1	0	904
4781	0	1	0	971	0	972
4782	0	1553	0	2	0	1555
4783	1569	45	2	3	0	1619
4784	43	1852	5	1	0	1901
4785	3	45	0	1941	0	1989
4786	1	3	1	1983	0	1988
4787	2	4	2224	52	0	2282
4788	2	2225	50	5	0	2282
4789	2	56	3	2362	0	2423
4790	4	11	2259	57	0	2331
4791	2	14	2261	9	0	2286
4792	3	5	54	2972	0	3034
4793	1	3	8	2969	0	2981
4794	1	2797	10	66	0	2874
4795	0	2990	5	10	0	3005
4796	0	57	4	3079	0	3140
4797	3051	11	6	57	0	3125
4798	54	6	3	3081	0	3144
4799	3649	3	6	60	0	3718
4800	3716	4	6	7	0	3733
4801	3652	4	1	8	0	3665
4802	68	6	3632	6	0	3712
4803	3518	3	55	9	0	3585
4804	57	7	5	3665	0	3734
4805	8	5	3	3689	0	3705
4806	10	8	3644	64	0	3726
4807	6	10	3554	10	0	3580
4808	8	8	56	3556	0	3628
4809	8	3406	21	55	0	3490
4810	7	3594	11	13	0	3625
4811	4	61	6	3724	0	3795
4812	3673	12	6	64	0	3755
4813	51	5	7	4141	0	4204
4814	6	8	4	4138	0	4156
4815	5	3698	14	379	0	4096
4816	5	54	6	4220	0	4285
4817	9	11	4089	71	0	4180
4818	7	10	3866	18	0	3901
4819	3865	7	53	10	0	3935
4820	60	3945	13	20	0	4038
4821	4202	62	7	11	0	4282
4822	4214	15	6	14	0	4249
4823	60	7	6	4050	0	4123
4824	13	4059	15	62	0	4149
4825	9	63	8	4212	0	4292
4826	4195	13	8	68	0	4284
4827	59	4474	19	16	0	4568
4828	4693	57	11	16	0	4777
4829	59	4497	12	14	0	4582
4830	4692	65	4	17	0	4778
4831	4737	17	3	15	0	4772
4832	64	4464	15	16	0	4559
4833	17	55	5	4708	0	4785
4834	4706	11	5	71	0	4793
4835	68	22	4436	17	0	4543
4836	18	23	4488	17	0	4546
4837	21	10	56	4497	0	4584
4838	4705	9	16	62	0	4792
4839	68	11	7	4658	0	4744
4840	4716	5	7	79	0	4807
4841	72	23	4502	18	0	4615
4842	4470	7	59	27	0	4563
4843	4691	11	19	16	0	4737
4844	69	13	17	4578	0	4677
4845	21	13	10	4607	0	4651
4846	16	18	5	4660	0	4699
4847	24	4483	10	76	0	4593
4848	20	66	9	4637	0	4732
4849	21	15	6	4712	0	4754
4850	4677	11	7	79	0	4774
4851	4623	16	10	35	0	4684
4852	76	22	4491	30	0	4619
4853	4431	11	68	32	0	4542
4854	74	21	4520	22	0	4637
4855	4187	12	80	37	0	4316
4856	71	21	4535	31	0	4658
4857	27	23	4455	21	0	4526
4858	21	15	58	4341	0	4435
4859	26	16	4459	83	0	4584
4860	4208	11	69	29	0	4317
4861	72	14	24	4752	0	4862
4862	4808	12	7	82	0	4909
4863	4770	14	13	34	0	4831
4864	4793	14	11	25	0	4843
4865	4736	11	11	34	0	4792
4866	89	13	5241	22	0	5365
4867	40	13	61	5136	0	5250
4868	29	11	5288	76	0	5404
4869	35	10	62	5280	0	5387
4870	5347	4	11	82	0	5444
4871	78	12	17	5375	0	5482
4872	5395	5	23	77	0	5500
4873	74	12	20	5335	0	5441
4874	22	10	11	5382	0	5425
4875	5377	10	15	88	0	5490
4876	66	5105	25	36	0	5232
4877	5355	59	18	28	0	5460
4878	73	5105	18	30	0	5226
4879	37	68	11	5683	0	5799
4880	5197	16	12	80	0	5305
4881	89	22	5251	34	0	5396
4882	4	4	10	4628	0	4646
4883	4732	1	7	12	0	4752
4884	4256	1	8	5	0	4270
4885	14	1	3	4315	0	4333
4886	8	4190	7	15	0	4220
4887	0	3846	5	3	0	3854
4888	0	3	0	4004	0	4007
4889	4562	0	1	1	0	4564
4890	46	4361	9	4	0	4420
4891	8	4405	7	7	0	4427
4892	3895	60	1	1	0	3957
4893	41	3832	7	0	0	3880
4894	3894	52	0	0	0	3946
4895	51	11	0	3828	0	3890
4896	10	2	0	3877	0	3889
4897	5	3740	4	55	0	3804
4898	2	3818	5	8	0	3833
4899	3279	60	0	2	0	3341
4900	53	3192	5	5	0	3255
4901	9	3757	6	2	0	3774
4902	6	84	1	3830	0	3921
4903	3889	29	2	75	0	3995
4904	77	18	4246	33	0	4374
4905	4206	10	104	12	0	4332
4906	122	7	47	4534	0	4710
4907	60	13	4582	119	0	4774
4908	36	15	4536	62	0	4649
4909	15	9	175	4583	0	4782
4910	14	15	4570	129	0	4728
4911	4987	2	155	75	0	5219
4912	5209	3	84	39	0	5335
4913	226	11	4388	24	0	4649
4914	99	9	158	4479	0	4745
4915	53	9	81	4699	0	4842
4916	4588	5	42	228	0	4863
4917	172	16	27	4335	0	4550
4918	84	4458	23	183	0	4748
4919	4477	162	15	93	0	4747
4920	177	4417	17	53	0	4664
4921	88	4590	16	34	0	4728
4922	59	223	14	4509	0	4805
4923	39	108	19	4593	0	4759
4924	42	52	15	4690	0	4799
4925	30	37	4260	274	0	4601
4926	4233	28	155	134	0	4550
4927	165	3924	80	75	0	4244
4928	4145	164	37	60	0	4406
4929	4221	73	27	38	0	4359
4930	251	46	26	3979	0	4302
4931	130	4169	20	173	0	4492
4932	78	180	15	4432	0	4705
4933	53	81	16	4577	0	4727
4934	4423	49	13	264	0	4749
4935	4512	33	18	143	0	4706
4936	252	35	4556	88	0	4931
4937	4811	32	167	62	0	5072
4938	246	4762	80	50	0	5138
4939	4755	184	41	43	0	5023
4940	224	4796	29	49	0	5098
4941	129	199	23	4883	0	5234
4942	86	93	23	4917	0	5119
4943	63	4702	18	267	0	5050
4944	50	197	20	4946	0	5213
4945	57	91	24	5080	0	5252
4946	57	55	17	4943	0	5072
4947	54	4693	23	307	0	5077
4948	56	199	22	4919	0	5196
4949	48	96	23	5034	0	5201
4950	52	75	17	5124	0	5268
4951	44	64	4635	318	0	5061
4952	4689	46	174	185	0	5094
4953	211	46	4716	124	0	5097
4954	4874	35	195	95	0	5199
4955	241	43	4694	93	0	5071
4956	4852	43	214	79	0	5188
4957	4995	37	100	82	0	5214
4958	304	37	4724	81	0	5146
4959	153	43	192	4779	0	5167
4960	103	52	4681	240	0	5076
4961	4419	33	201	161	0	4814
4962	237	42	4467	108	0	4854
4963	129	44	4419	90	0	4682
4964	4402	36	279	96	0	4813
4965	247	4301	139	79	0	4766
4966	139	205	95	3955	0	4394
4967	3972	106	71	238	0	4387
4968	255	57	96	3993	0	4401
4969	176	54	66	4118	0	4414
4970	4016	52	70	321	0	4459
4971	4117	30	92	202	0	4441
4972	327	42	3958	128	0	4455
4973	190	47	4078	126	0	4441
4974	135	41	291	4161	0	4628
4975	127	47	4026	259	0	4459
4976	131	43	246	4127	0	4547
4977	125	39	146	4271	0	4581
4978	104	64	90	4384	0	4642
4979	3692	43	66	419	0	4220
4980	259	3682	67	235	0	4243
4981	3613	209	44	184	0	4050
4982	3546	140	58	167	0	3911
4983	330	3525	52	134	0	4041
4984	3722	228	41	135	0	4126
4985	270	160	3408	118	0	3956
4986	182	82	196	3618	0	4078
4987	3649	63	114	310	0	4136
4988	271	54	3289	222	0	3836
4989	2965	50	162	137	0	3314
4990	235	4270	118	110	0	4733
4991	4969	169	83	103	0	5324
4992	4974	103	58	77	0	5212
4993	341	4819	73	72	0	5305
4994	4981	198	62	88	0	5329
4995	310	117	60	4890	0	5377
4996	189	93	45	5062	0	5389
4997	4908	49	54	322	0	5333
4998	4496	71	79	201	0	4847
4999	356	4706	42	137	0	5241
5000	214	4934	65	103	0	5316
5001	113	206	40	4029	0	4388
5002	109	4221	36	160	0	4526
5003	94	4504	32	109	0	4739
5004	3800	147	21	59	0	4027
5005	148	3883	28	43	0	4102
5006	3623	126	18	47	0	3814
5007	145	3469	27	46	0	3687
5008	71	123	3341	48	0	3583
5009	57	3533	99	55	0	3744
5010	3096	119	622	39	0	3876
5011	3048	24	23	30	0	3125
5012	76	20	2921	35	0	3052
5013	42	19	59	2961	0	3081
5014	37	27	20	3096	0	3180
5015	29	25	2949	81	0	3084
5016	36	18	53	2988	0	3095
5017	41	21	2977	71	0	3110
5018	42	32	2885	26	0	2985
5019	2921	23	61	30	0	3035
5020	79	2971	43	17	0	3110
5021	3061	65	21	22	0	3169
5022	99	29	19	3028	0	3175
5023	46	44	2895	53	0	3038
5024	47	26	57	2802	0	2932
5025	32	2880	31	58	0	3001
5026	3052	62	26	33	0	3173
5027	3044	37	9	21	0	3111
5028	87	33	21	3031	0	3172
5029	58	32	2979	64	0	3133
5030	3039	25	58	37	0	3159
5031	77	2813	28	35	0	2953
5032	2905	75	20	21	0	3021
5033	122	55	13	2855	0	3045
5034	2916	45	10	70	0	3041
5035	118	42	14	2878	0	3052
5036	49	23	2278	67	0	2417
5037	41	10	2511	61	0	2623
5038	2489	10	56	58	0	2613
5039	70	2555	38	31	0	2694
5040	3336	55	18	21	0	3430
5041	3273	61	11	10	0	3355
5042	69	3258	13	17	0	3357
5043	3374	78	5	24	0	3481
5044	66	69	4457	22	0	4614
5045	47	55	44	4499	0	4645
5046	47	44	20	4592	0	4703
5047	44	33	18	4683	0	4778
5048	44	41	4469	77	0	4631
5049	49	42	4421	35	0	4547
5050	39	40	63	4390	0	4532
5051	38	4349	53	47	0	4487
5052	48	4512	31	39	0	4630
5053	4644	74	25	29	0	4772
5054	4569	51	27	24	0	4671
5055	86	4971	30	50	0	5137
5056	65	61	22	5206	0	5354
5057	41	36	42	5476	0	5595
5058	5447	39	43	94	0	5623
5059	77	31	51	5434	0	5593
5060	68	30	51	5435	0	5584
5061	72	33	33	5466	0	5604
5062	81	49	5296	83	0	5509
5063	69	48	4910	66	0	5093
5064	5240	29	79	63	0	5411
5065	81	24	61	5420	0	5586
5066	66	41	5333	77	0	5517
5067	50	64	5135	61	0	5310
5068	5033	44	83	42	0	5202
5069	102	33	5598	49	0	5782
5070	56	5567	91	58	0	5772
5071	46	80	44	5826	0	5996
5072	57	54	6101	69	0	6281
5073	6067	54	76	49	0	6246
5074	119	38	33	6328	0	6518
5075	81	52	6144	106	0	6383
5076	62	36	77	6243	0	6418
5077	56	24	61	6356	0	6497
5078	6372	15	60	121	0	6568
5079	95	6022	63	81	0	6261
5080	67	78	50	6328	0	6523
5081	6384	49	25	104	0	6562
5082	6368	46	19	70	0	6503
5083	6402	29	32	55	0	6518
5084	6430	28	35	59	0	6552
5085	140	25	38	6351	0	6554
5086	6363	19	57	103	0	6542
5087	6276	10	60	87	0	6433
5088	6158	15	44	85	0	6302
5089	6291	13	45	80	0	6429
5090	79	4689	31	23	0	4822
5091	19	4230	31	13	0	4293
5092	23	29	9	4370	0	4431
5093	18	4219	19	32	0	4288
5094	4426	27	13	18	0	4484
5095	26	14	9	4382	0	4431
5096	4426	10	8	28	0	4472
5097	4349	2	14	24	0	4389
5098	39	12	6	4369	0	4426
5099	20	11	10	4324	0	4365
5100	18	4190	20	41	0	4269
5101	4409	20	1	23	0	4453
5102	33	4088	12	21	0	4154
5103	4281	21	8	8	0	4318
5104	43	12	0	4234	0	4289
5105	35	17	4136	31	0	4219
5106	4171	7	21	11	0	4210
5107	4126	11	9	18	0	4164
5108	51	12	4166	17	0	4246
5109	41	14	4090	12	0	4157
5110	29	11	28	4006	0	4074
5111	4469	7	14	22	0	4512
5112	4411	10	10	17	0	4448
5113	4548	13	6	21	0	4588
5114	4564	14	7	14	0	4599
5115	74	4316	22	14	0	4426
5116	4566	51	4	14	0	4635
5117	76	23	2	4492	0	4593
5118	40	19	4	4499	0	4562
5119	26	11	3	5135	0	5175
5120	18	9	4	5171	0	5202
5121	5094	7	1	89	0	5191
5122	73	7	7	5609	0	5696
5123	42	20	5291	107	0	5460
5124	24	11	75	5515	0	5625
5125	30	5	27	5614	0	5676
5126	23	8	16	5602	0	5649
5127	30	6	12	5626	0	5674
5128	5484	11	15	125	0	5635
5129	83	5194	19	53	0	5349
5130	33	5287	15	26	0	5361
5131	17	97	2	5413	0	5529
5132	5331	31	5	81	0	5448
5133	5408	14	3	35	0	5460
5134	101	11	1	5395	0	5508
5135	42	25	5152	93	0	5312
5136	5170	5	69	37	0	5281
5137	95	3	20	5137	0	5255
5138	34	25	4928	91	0	5078
5139	4751	5	80	40	0	4876
5140	89	4295	33	25	0	4442
5141	5346	73	8	26	0	5453
5142	156	5246	20	20	0	5442
5143	82	144	6	5306	0	5538
5144	39	4324	14	151	0	4528
5145	17	186	7	4512	0	4722
5146	4120	64	8	214	0	4406
5147	167	4206	18	105	0	4496
5148	80	164	4161	46	0	4451
5149	33	75	154	4442	0	4704
5150	26	45	4287	202	0	4560
5151	35	19	178	4357	0	4589
5152	37	23	73	4585	0	4718
5153	26	29	4315	267	0	4637
5154	4129	12	191	128	0	4460
5155	196	22	3876	75	0	4169
5156	90	26	3810	50	0	3976
5157	49	3546	242	49	0	3886
5158	36	162	98	3673	0	3969
5159	27	76	50	3824	0	3977
5160	26	43	27	3884	0	3980
5161	16	19	31	3964	0	4030
5162	21	17	3541	294	0	3873
5163	3623	23	178	141	0	3965
5164	195	24	3541	86	0	3846
5165	82	14	192	3761	0	4049
5166	3633	16	88	211	0	3948
5167	182	3603	48	125	0	3958
5168	84	176	37	3754	0	4051
5169	3241	69	17	203	0	3530
5170	181	3134	31	115	0	3461
5171	94	3857	14	70	0	4035
5172	3885	222	10	40	0	4157
5173	177	3994	20	38	0	4229
5174	3898	185	14	40	0	4137
5175	195	3940	21	39	0	4195
5176	3974	192	16	39	0	4221
5177	3952	87	13	38	0	4090
5178	239	3871	22	38	0	4170
5179	104	170	18	3991	0	4283
5180	67	94	3762	182	0	4105
5181	3783	51	174	89	0	4097
5182	197	36	65	3817	0	4115
5183	102	3644	37	175	0	3958
5184	55	3973	28	107	0	4163
5185	37	209	20	4029	0	4295
5186	3950	82	34	203	0	4269
5187	191	66	3742	101	0	4100
5188	90	28	168	3948	0	4234
5189	43	33	82	4038	0	4196
5190	36	44	38	4167	0	4285
5191	49	16	28	3980	0	4073
5192	39	3881	37	268	0	4225
5193	33	181	32	4098	0	4344
5194	32	103	3829	232	0	4196
5195	27	61	3901	135	0	4124
5196	41	44	3994	87	0	4166
5197	41	37	229	3960	0	4267
5198	3959	41	113	211	0	4324
5199	199	29	3888	118	0	4234
5200	96	38	3995	69	0	4198
5201	54	29	235	3920	0	4238
5202	3950	32	115	213	0	4310
5203	182	3949	48	122	0	4301
5204	4037	195	34	86	0	4352
5205	218	95	52	4010	0	4375
5206	111	72	3818	205	0	4206
5207	78	49	180	3633	0	3940
5208	57	4232	89	196	0	4574
5209	4318	205	47	119	0	4689
5210	214	106	4149	79	0	4548
5211	82	3861	165	71	0	4179
5212	3933	149	94	79	0	4255
5213	166	86	58	3879	0	4189
5214	94	72	48	4044	0	4258
5215	3986	31	38	237	0	4292
5216	3976	40	48	133	0	4197
5217	4084	42	48	80	0	4254
5218	244	29	33	3865	0	4171
5219	103	3249	37	173	0	3562
5220	3294	132	30	117	0	3573
5221	168	3310	18	80	0	3576
5222	2869	131	26	48	0	3074
5223	155	2805	22	40	0	3022
5224	80	139	27	2874	0	3120
5225	2858	80	29	142	0	3109
5226	2890	43	23	89	0	3045
5227	2943	43	19	49	0	3054
5228	2957	31	19	47	0	3054
5229	2954	30	22	49	0	3055
5230	199	37	2682	51	0	2969
5231	115	36	118	2708	0	2977
5232	76	30	2710	127	0	2943
5233	63	39	2669	74	0	2845
5234	2761	33	146	56	0	2996
5235	2867	37	79	31	0	3014
5236	2884	39	37	34	0	2994
5237	199	33	20	2789	0	3041
5238	2810	33	27	134	0	3004
5239	165	2640	31	82	0	2918
5240	105	2752	28	54	0	2939
5241	53	2227	13	20	0	2313
5242	2693	49	16	31	0	2789
5243	56	2932	17	45	0	3050
5244	2761	29	12	14	0	2816
5245	2719	13	9	17	0	2758
5246	42	13	2669	29	0	2753
5247	31	8	34	2585	0	2658
5248	25	9	20	2779	0	2833
5249	2792	8	18	41	0	2859
5250	2749	10	13	30	0	2802
5251	38	14	14	2755	0	2821
5252	31	18	2616	35	0	2700
5253	25	18	2541	25	0	2609
5254	22	9	32	2685	0	2748
5255	25	13	12	2680	0	2730
5256	22	17	12	2792	0	2843
5257	2761	9	13	44	0	2827
5258	2700	10	15	21	0	2746
5259	42	2606	24	21	0	2693
5260	27	27	15	2729	0	2798
5261	34	18	11	2705	0	2768
5262	32	2678	19	31	0	2760
5263	20	27	18	2777	0	2842
5264	2775	18	16	33	0	2842
5265	41	8	17	2737	0	2803
5266	31	10	12	2756	0	2809
5267	2751	8	5	52	0	2816
5268	2677	8	7	27	0	2719
5269	2748	9	7	21	0	2785
5270	54	11	13	2644	0	2722
5271	13	5	2171	16	0	2205
5272	7	8	1987	11	0	2013
5273	12	2	2034	9	0	2057
5274	7	1968	24	10	0	2009
5275	2045	14	9	4	0	2072
5276	21	11	2056	2	0	2090
5277	1970	3	21	5	0	1999
5278	21	4	10	2070	0	2105
5279	2096	2	8	18	0	2124
5280	2083	2	4	15	0	2104
5281	27	1986	7	7	0	2027
5282	2106	14	2	8	0	2130
5283	2081	5	3	8	0	2097
5284	27	2393	25	10	0	2455
5285	13	16	5	2735	0	2769
5286	11	8	2686	17	0	2722
5287	10	3	15	2636	0	2664
5288	3	6	7	2763	0	2779
5289	2762	3	3	29	0	2797
5290	21	2	4	2736	0	2763
5291	10	2647	5	22	0	2684
5292	9	21	1	2739	0	2770
5293	8	9	3	2779	0	2799
5294	11	7	2699	28	0	2745
5295	7	2566	24	19	0	2616
5296	8	2657	7	15	0	2687
5297	2705	20	4	14	0	2743
5298	17	2657	7	20	0	2701
5299	16	21	2	2722	0	2761
5300	18	14	2653	20	0	2705
5301	12	2559	23	14	0	2608
5302	2717	19	11	8	0	2755
5303	16	12	8	2690	0	2726
5304	11	2	11	2743	0	2767
5305	8	7	2677	29	0	2721
5306	10	3	18	2565	0	2596
5307	11	6	5	2756	0	2778
5308	2408	5	7	28	0	2448
5309	2358	4	7	18	0	2387
5310	24	2306	4	17	0	2351
5311	2395	14	2	16	0	2427
5312	27	2354	7	10	0	2398
5313	16	21	1	2364	0	2402
5314	14	2340	3	20	0	2377
5315	12	2343	4	9	0	2368
5316	2378	26	1	12	0	2417
5317	2369	13	3	11	0	2396
5318	25	2280	8	11	0	2324
5319	2414	19	6	9	0	2448
5320	2390	10	3	11	0	2414
5321	2392	4	5	10	0	2411
5322	28	8	4	2280	0	2320
5323	2389	6	7	22	0	2424
5324	24	10	2175	9	0	2218
5325	2236	4	16	15	0	2271
5326	28	5	2259	10	0	2302
5327	17	6	17	2239	0	2279
5328	13	6	6	2331	0	2356
5329	15	9	2240	21	0	2285
5330	2070	8	19	10	0	2107
5331	2275	8	7	12	0	2302
5332	25	9	2926	13	0	2973
5333	13	10	23	2817	0	2863
5334	9	7	8	3023	0	3047
5335	11	2	7	3132	0	3152
5336	3102	3	8	29	0	3142
5337	3126	2	5	19	0	3152
5338	25	0	5	2995	0	3025
5339	11	2894	7	31	0	2943
5340	12	3000	1	19	0	3032
5341	2597	20	3	10	0	2630
5342	26	2148	3	11	0	2188
5343	0	1871	0	0	0	1871
5344	0	0	0	1881	0	1881
5345	1	3	2350	0	0	2354
5346	0	2282	5	3	0	2290
5347	0	0	0	2423	0	2423
5348	0	2335	2	3	0	2340
5349	0	1	0	2419	0	2420
5350	2457	0	0	1	0	2458
5351	0	2264	3	1	0	2268
5352	2433	0	0	0	0	2433
5353	2393	0	0	1	0	2394
5354	1	6	2264	0	0	2271
5355	2279	0	0	1	0	2280
5356	0	2	0	2342	0	2344
5357	1	2	2372	0	0	2375
5358	0	2214	2	2	0	2218
5359	0	0	0	2382	0	2382
5360	1	0	0	2380	0	2381
5361	2409	0	0	0	0	2409
5362	0	0	1	2333	0	2334
5363	0	1	1	2346	0	2348
5364	2429	0	0	0	0	2429
5365	0	2247	5	4	0	2256
5366	2327	1	0	2	0	2330
5367	2	1	2284	0	0	2287
5368	2408	1	3	0	0	2412
5369	2	3	2701	0	0	2706
5370	0	2873	12	2	0	2887
5371	3144	2	2	1	0	3149
5372	2578	2	0	3	0	2583
5373	4	3	2542	1	0	2550
5374	2	1	2468	1	0	2472
5375	1	9	2418	0	0	2428
5376	0	2424	10	1	0	2435
5377	1	1	2	2569	0	2573
5378	1	3	2533	2	0	2539
5379	2	4	2461	2	0	2469
5380	1	0	7	2471	0	2479
5381	2	4	2532	2	0	2540
5382	2653	0	9	4	0	2666
5383	3863	0	5	2	0	3870
5384	51	6	3327	1	0	3385
5385	25	3311	47	6	0	3389
5386	8	39	22	3461	0	3530
5387	7	33	3322	40	0	3402
5388	3	3735	50	23	0	3811
5389	1	44	25	3882	0	3952
5390	3862	23	8	39	0	3932
5391	3797	3	4	25	0	3829
5392	61	3777	16	10	0	3864
5393	32	42	3	3901	0	3978
5394	11	20	4	3912	0	3947
5395	10	9	2	3921	0	3942
5396	4	3	3	3965	0	3975
5397	3	11	3789	79	0	3882
5398	1	5	41	3859	0	3906
5399	3	8	3126	700	0	3837
5400	7	3726	41	44	0	3818
5401	3808	44	15	18	0	3885
5402	41	3778	14	8	0	3841
5403	27	51	3	4185	0	4266
5404	8	27	5	4243	0	4283
5405	4213	9	2	77	0	4301
5406	46	3	5	4173	0	4227
5407	23	4010	11	59	0	4103
5408	12	40	3	4253	0	4308
5409	6	19	6	4222	0	4253
5410	4211	14	3	70	0	4298
5411	56	20	3854	39	0	3969
5412	29	3926	49	15	0	4019
5413	14	4144	19	21	0	4198
5414	7	61	8	4178	0	4254
5415	4147	26	8	52	0	4233
5416	46	4068	11	39	0	4164
5417	26	53	3	4224	0	4306
5418	10	28	4061	56	0	4155
5419	7	14	38	4149	0	4208
5420	4198	5	26	59	0	4288
5421	4093	7	12	32	0	4144
5422	70	11	8	4182	0	4271
5423	4218	10	5	54	0	4287
5424	4167	6	2	45	0	4220
5425	82	8	4071	14	0	4175
5426	4080	12	47	13	0	4152
5427	54	3957	33	24	0	4068
5428	4192	47	16	13	0	4268
5429	63	34	4019	11	0	4127
5430	39	19	49	4073	0	4180
5431	4178	10	27	56	0	4271
5432	63	15	3671	35	0	3784
5433	43	16	3694	20	0	3773
5434	17	7	97	3660	0	3781
5435	16	12	3731	75	0	3834
5436	3700	11	76	40	0	3827
5437	71	17	4282	28	0	4398
5438	37	13	80	4650	0	4780
5439	16	8	42	4911	0	4977
5440	4857	7	21	141	0	5026
5441	108	13	4726	61	0	4908
5442	61	15	4802	28	0	4906
5443	27	12	130	5850	0	6019
5444	13	16	5865	235	0	6129
5445	5319	15	232	72	0	5638
5446	220	11	75	5274	0	5580
5447	60	12	5327	235	0	5634
5448	31	9	222	5310	0	5572
5449	29	12	64	5585	0	5690
5450	5441	10	21	287	0	5759
5451	235	21	5305	78	0	5639
5452	5754	10	218	52	0	6034
5453	245	10	5964	57	0	6276
5454	6036	15	241	32	0	6324
5455	6229	8	74	42	0	6353
5456	6214	2	40	45	0	6301
5457	279	5848	71	36	0	6234
5458	6150	218	25	48	0	6441
5459	6255	58	28	50	0	6391
5460	303	20	28	6105	0	6456
5461	122	24	5947	243	0	6336
5462	5996	15	230	84	0	6325
5463	271	17	5968	51	0	6307
5464	128	16	237	5910	0	6291
5465	74	12	85	6273	0	6444
5466	6047	17	40	292	0	6396
5467	258	6305	45	101	0	6709
5468	120	221	29	6103	0	6473
5469	77	63	29	6377	0	6546
5470	49	31	5972	310	0	6362
5471	53	21	234	6068	0	6376
5472	56	13	74	6373	0	6516
5473	44	13	43	6050	0	6150
5474	34	6013	46	289	0	6382
5475	6171	216	31	115	0	6533
5476	6228	65	26	74	0	6393
5477	274	6028	31	67	0	6400
5478	6233	234	24	62	0	6553
5479	260	66	21	6235	0	6582
5480	105	27	5996	259	0	6387
5481	54	5681	233	132	0	6100
5482	41	5745	77	77	0	5940
5483	4698	202	23	58	0	4981
5484	4815	49	32	42	0	4938
5485	233	30	17	4678	0	4958
5486	70	30	15	4828	0	4943
5487	41	27	19	5070	0	5157
5488	4506	23	20	240	0	4789
5489	218	19	4264	80	0	4581
5490	4399	25	180	62	0	4666
5491	206	29	66	4426	0	4727
5492	83	18	26	4523	0	4650
5493	47	4306	36	242	0	4631
5494	69	173	31	4472	0	4745
5495	55	55	18	4668	0	4796
5496	58	28	4267	271	0	4624
5497	69	4229	193	95	0	4586
5498	4782	179	61	74	0	5096
5499	4657	37	56	68	0	4818
5500	4909	25	41	76	0	5051
5501	4941	30	34	69	0	5074
5502	269	27	4543	62	0	4901
5503	4411	31	209	54	0	4705
5504	253	31	4339	72	0	4695
5505	96	23	199	4313	0	4631
5506	76	4254	80	219	0	4629
5507	78	193	54	4509	0	4834
5508	92	44	56	4668	0	4860
5509	85	29	4365	268	0	4747
5510	4228	29	214	104	0	4575
5511	4549	32	68	88	0	4737
5512	254	4163	50	90	0	4557
5513	124	191	4246	89	0	4650
5514	102	49	222	4415	0	4788
5515	83	28	4306	254	0	4671
5516	85	47	4369	104	0	4605
5517	82	32	251	4395	0	4760
5518	88	33	4355	259	0	4735
5519	86	48	205	4419	0	4758
5520	106	45	4363	234	0	4748
5521	85	52	201	4467	0	4805
5522	4454	34	82	245	0	4815
5523	4554	18	71	119	0	4762
5524	4568	33	55	89	0	4745
5525	4486	37	76	79	0	4678
5526	247	4248	67	89	0	4651
5527	87	190	51	4428	0	4756
5528	83	50	50	4636	0	4819
5529	79	45	4284	289	0	4697
5530	78	33	210	4379	0	4700
5531	57	47	4312	292	0	4708
5532	69	34	4027	128	0	4258
5533	3922	30	211	102	0	4265
5534	200	3891	85	92	0	4268
5535	4124	183	35	103	0	4445
5536	4079	74	45	82	0	4280
5537	233	3418	39	90	0	3780
5538	3066	160	21	70	0	3317
5539	191	47	3260	68	0	3566
5540	79	3278	151	70	0	3578
5541	3454	165	57	67	0	3743
5542	201	44	3420	62	0	3727
5543	2270	8	12	9	0	2299
5544	20	2201	18	8	0	2247
5545	2764	11	8	6	0	2789
5546	2761	8	8	6	0	2783
5547	20	2611	12	8	0	2651
5548	16	2637	7	12	0	2672
5549	13	2645	15	8	0	2681
5550	14	14	6	2770	0	2804
5551	17	8	6	2710	0	2741
5552	2342	0	1	2	0	2345
5553	2014	0	1	1	0	2016
5554	3	4	2491	0	0	2498
5555	2	4	2283	1	0	2290
5556	3	8	2420	1	0	2432
5557	0	0	3	2455	0	2458
5558	2	2	2502	3	0	2509
5559	0	1	4	2493	0	2498
5560	2557	0	1	3	0	2561
5561	5	1	2465	0	0	2471
5562	2442	1	4	0	0	2447
5563	2527	0	1	2	0	2530
5564	5	4	2458	1	0	2468
5565	0	2342	14	2	0	2358
5566	0	2	5	2499	0	2506
5567	2	6	2140	3	0	2151
5568	2	0	6	2073	0	2081
5569	0	1	7	2297	0	2305
5570	1879	0	6	10	0	1895
5571	9	0	6	1886	0	1901
5572	5	2	1858	9	0	1874
5573	2	0	10	1871	0	1883
5574	1881	0	5	10	0	1896
5575	9	2025	11	1	0	2046
5576	2133	7	4	2	0	2146
5577	16	3	4	2122	0	2145
5578	3	1	2094	9	0	2107
5579	3	4	1993	4	0	2004
5580	4	3	2033	7	0	2047
5581	2	2001	19	8	0	2030
5582	2105	8	4	7	0	2124
5583	7	2009	10	9	0	2035
5584	2111	7	5	6	0	2129
5585	12	2055	7	7	0	2081
5586	7	8	5	2088	0	2108
5587	4	4	12	1965	0	1985
5588	3	3	10	1969	0	1985
5589	5	2312	19	15	0	2351
5590	5	22	13	2433	0	2473
5591	6	9	12	3441	0	3468
5592	3824	7	10	129	0	3970
5593	142	5	11	4091	0	4249
5594	32	18	4718	146	0	4914
5595	4828	8	141	33	0	5010
5596	4932	3	40	15	0	4990
5597	168	5753	31	13	0	5965
5598	5784	155	18	16	0	5973
5599	5857	34	19	24	0	5934
5600	180	15	16	5711	0	5922
5601	45	4	17	5833	0	5899
5602	23	4	17	5987	0	6031
5603	5780	8	15	205	0	6008
5604	5923	9	9	56	0	5997
5605	210	17	5581	23	0	5831
5606	5670	7	151	21	0	5849
5607	5805	9	39	17	0	5870
5608	5902	17	13	26	0	5958
5609	206	14	5628	20	0	5868
5610	57	14	5686	24	0	5781
5611	31	5	180	5721	0	5937
5612	31	28	5661	185	0	5905
5613	33	9	165	5558	0	5765
5614	44	12	45	5124	0	5225
5615	55	5585	33	161	0	5834
5616	5780	158	26	66	0	6030
5617	201	50	5815	28	0	6094
5618	5804	22	178	22	0	6026
5619	229	19	46	5960	0	6254
5620	5873	31	25	196	0	6125
5621	226	5650	38	67	0	5981
5622	83	5990	36	53	0	6162
5623	49	210	44	5916	0	6219
5624	54	47	28	6113	0	6242
5625	62	27	5764	263	0	6116
5626	68	24	186	5979	0	6257
5627	5751	20	61	210	0	6042
5628	213	5660	61	76	0	6010
5629	116	179	5775	37	0	6107
5630	98	48	189	5871	0	6206
5631	70	26	5848	211	0	6155
5632	54	31	207	5873	0	6165
5633	49	16	5850	239	0	6154
5634	29	30	5842	102	0	6003
5635	43	19	220	5913	0	6195
5636	5946	19	73	253	0	6291
5637	6021	24	46	85	0	6176
5638	5941	35	27	68	0	6071
5639	272	5388	54	40	0	5754
5640	5605	181	49	59	0	5894
5641	5656	45	51	46	0	5798
5642	263	41	5299	74	0	5677
5643	112	5334	184	66	0	5696
5644	62	219	60	5525	0	5866
5645	5091	77	38	218	0	5424
5646	227	5013	41	114	0	5395
5647	5178	196	44	74	0	5492
5648	5326	61	63	61	0	5511
5649	5336	26	38	72	0	5472
5650	5355	48	48	43	0	5494
5651	274	47	39	5151	0	5511
5652	5183	33	62	225	0	5503
5653	244	34	41	5107	0	5426
5654	62	4398	51	216	0	4727
5655	47	167	39	4676	0	4929
5656	4631	40	47	216	0	4934
5657	230	29	4450	70	0	4779
5658	88	11	185	4629	0	4913
5659	4556	10	49	213	0	4828
5660	237	4489	37	64	0	4827
5661	4642	177	26	56	0	4901
5662	4738	64	18	39	0	4859
5663	254	4503	46	36	0	4839
5664	4683	183	28	43	0	4937
5665	237	65	4463	34	0	4799
5666	81	59	4544	34	0	4718
5667	4527	27	199	48	0	4801
5668	243	46	4860	33	0	5182
5669	108	44	176	4581	0	4909
5670	89	4727	45	179	0	5040
5671	4838	181	34	46	0	5099
5672	244	4716	26	45	0	5031
5673	111	4797	31	42	0	4981
5674	72	198	38	4843	0	5151
5675	64	59	23	4801	0	4947
5676	70	28	28	4783	0	4909
5677	55	37	18	4853	0	4963
5678	55	47	4435	247	0	4784
5679	66	35	178	4627	0	4906
5680	44	30	72	4832	0	4978
5681	4661	31	30	250	0	4972
5682	218	32	30	4683	0	4963
5683	74	50	4463	212	0	4799
5684	4505	31	171	88	0	4795
5685	231	31	55	4632	0	4949
5686	79	53	4461	202	0	4795
5687	75	19	193	4425	0	4712
5688	69	4489	76	187	0	4821
5689	4186	167	55	50	0	4458
5690	222	44	4074	38	0	4378
5691	36	3011	80	16	0	3143
5692	2696	48	21	6	0	2771
5693	45	2760	6	14	0	2825
5694	6	2000	2	5	0	2013
5695	1956	44	1	2	0	2003
5696	39	1940	3	4	0	1986
5697	7	1559	3	4	0	1573
5698	5	36	1	1621	0	1663
5699	5	11	1565	33	0	1614
5700	1	2332	32	13	0	2378
5701	2	34	5	2491	0	2532
5702	1	2396	3	32	0	2432
5703	2559	32	1	8	0	2600
5704	33	8	2449	3	0	2493
5705	4	2	28	3065	0	3099
5706	3124	0	6	34	0	3164
5707	32	1	2	3079	0	3114
5708	8	5	2984	34	0	3031
5709	2840	2	29	5	0	2876
5710	3048	2	1	2	0	3053
5711	34	2855	4	2	0	2895
5712	7	32	2	3071	0	3112
5713	5	4	1	3111	0	3121
5714	3090	2	1	37	0	3130
5715	2988	1	3	7	0	2999
5716	41	2	3020	2	0	3065
5717	3	2670	18	2	0	2693
5718	2912	16	2	1	0	2931
5719	15	2	0	2908	0	2925
5720	5	2	3460	17	0	3484
5721	2	7	3368	2	0	3379
5722	1	3	13	3616	0	3633
5723	3752	3	3	17	0	3775
5724	18	3468	7	5	0	3498
5725	4698	16	1	0	0	4715
5726	14	6	0	4660	0	4680
5727	4	2	1	4665	0	4672
5728	3	1	1	4698	0	4703
5729	4699	3	2	23	0	4727
5730	16	4430	4	13	0	4463
5731	4	19	0	4691	0	4714
5732	4	6	1	4726	0	4737
5733	1	6	4552	21	0	4580
5734	0	3	15	4410	0	4428
5735	5	4	4641	19	0	4669
5736	3	4338	22	9	0	4372
5737	1	18	6	4695	0	4720
5738	4665	5	2	19	0	4691
5739	25	6	4551	5	0	4587
5740	5	6	14	4537	0	4562
5741	1	10	4536	21	0	4568
5742	4294	4	15	7	0	4320
5743	21	9	4877	4	0	4911
5744	8	3	13	4689	0	4713
5745	4932	3	7	20	0	4962
5746	19	4281	24	12	0	4336
5747	4868	20	5	5	0	4898
5748	20	4965	23	7	0	5015
5749	4	20	3	6144	0	6171
5750	4	14	6023	21	0	6062
5751	8	27	5609	13	0	5657
5752	7	1	23	5903	0	5934
5753	6163	6	6	18	0	6193
5754	5907	4	4	8	0	5923
5755	23	6	2	5962	0	5993
5756	6	2	4	6144	0	6156
5757	6110	2	4	24	0	6140
5758	23	5388	24	16	0	5451
5759	8	5626	13	8	0	5655
5760	5970	21	3	11	0	6005
5761	20	9	5580	12	0	5621
5762	11	6	20	5509	0	5546
5763	14	8	6472	23	0	6517
5764	2	5	24	6271	0	6302
5765	4	12	6476	23	0	6515
5766	7	17	6102	12	0	6138
5767	10	4	18	6300	0	6332
5768	5	5337	37	28	0	5407
5769	6220	18	10	11	0	6259
5770	16	5744	24	14	0	5798
5771	13	19	1	6161	0	6194
5772	6175	6	6	24	0	6211
5773	19	5	4	6097	0	6125
5774	6115	2	4	26	0	6147
5775	6012	5	3	14	0	6034
5776	6149	2	3	10	0	6164
5777	25	5518	14	9	0	5566
5778	6220	19	2	7	0	6248
5779	19	5	5	6057	0	6086
5780	6995	0	4	28	0	7027
5781	21	4	4	6835	0	6864
5782	7534	3	3	27	0	7567
5783	7551	3	7	9	0	7570
5784	32	6961	14	6	0	7013
5785	8	24	4	8111	0	8147
5786	9	6	5	8289	0	8309
5787	7	7680	26	92	0	7805
5788	6	63	5	8353	0	8427
5789	9095	20	4	75	0	9194
5790	9025	3	6	30	0	9064
5791	8951	4	3	14	0	8972
5792	93	21	8394	9	0	8517
5793	7840	1	55	11	0	7907
5794	8491	2	13	0	0	8506
5795	8542	1	3	4	0	8550
5796	74	7941	14	3	0	8032
5797	20	49	4	8026	0	8099
5798	12	14	1	8172	0	8199
5799	8	2	1	8131	0	8142
5800	7	13	7258	74	0	7352
5801	4	8	51	7300	0	7363
5802	7461	1	16	65	0	7543
5803	58	4	3	7440	0	7505
5804	23	0	2	7498	0	7523
5805	13	7	6896	71	0	6987
5806	8	6320	77	31	0	6436
5807	7733	55	19	4	0	7811
5808	58	15	2	7618	0	7693
5809	7677	6	2	61	0	7746
5810	56	11	7331	30	0	7428
5811	6885	13	57	16	0	6971
5812	58	7535	39	22	0	7654
5813	34	66	7744	13	0	7857
5814	15	32	7783	9	0	7839
5815	14	8	82	7436	0	7540
5816	18	9	8495	69	0	8591
5817	11	7919	88	32	0	8050
5818	17	56	23	8970	0	9066
5819	16	23	7	9011	0	9057
5820	21	7	2	8672	0	8702
5821	8525	3	7	81	0	8616
5822	62	8045	31	33	0	8171
5823	26	56	8	8545	0	8635
5824	19	20	7	8572	0	8618
5825	7814	11	7	93	0	7925
5826	67	7400	22	45	0	7534
5827	7799	58	12	28	0	7897
5828	7762	25	5	36	0	7828
5829	7686	5	13	27	0	7731
5830	92	18	7550	20	0	7680
5831	43	9	59	7411	0	7522
5832	31	7226	44	65	0	7366
5833	43	7467	20	31	0	7561
5834	36	73	8	7621	0	7738
5835	16	7614	38	79	0	7747
5836	8224	64	12	48	0	8348
5837	75	41	8360	33	0	8509
5838	8201	22	65	35	0	8323
5839	9358	10	26	48	0	9442
5840	97	14	17	9290	0	9418
5841	9474	11	11	91	0	9587
5842	83	9427	29	61	0	9600
5843	9739	71	23	31	0	9864
5844	9687	34	23	25	0	9769
5845	11276	19	13	40	0	11348
5846	190	27	11139	21	0	11377
5847	86	51	10627	32	0	10796
5848	77	18	162	11581	0	11838
5849	51	10408	108	198	0	10765
5850	44	10988	57	94	0	11183
5851	42	227	26	11397	0	11692
5852	11243	94	31	226	0	11594
5853	198	58	25	11294	0	11575
5854	77	35	27	11508	0	11647
5855	11219	24	23	286	0	11552
5856	202	10733	44	153	0	11132
5857	101	200	10749	94	0	11144
5858	88	88	10485	72	0	10733
5859	11337	49	220	65	0	11671
5860	231	31	106	11149	0	11517
5861	100	45	11213	217	0	11575
5862	87	30	185	11087	0	11389
5863	52	37	79	10550	0	10718
5864	54	20	60	10840	0	10974
5865	53	34	36	10684	0	10807
5866	48	10185	48	287	0	10568
5867	39	184	47	10780	0	11050
5868	10638	69	37	260	0	11004
5869	202	10147	64	125	0	10538
5870	10734	201	33	98	0	11066
5871	11313	85	25	64	0	11487
5872	11411	69	13	68	0	11561
5873	305	54	10588	63	0	11010
5874	10993	42	193	53	0	11281
5875	11333	33	66	63	0	11495
5876	11222	27	54	34	0	11337
5877	11251	34	30	51	0	11366
5878	322	10698	43	60	0	11123
5879	11279	215	26	38	0	11558
5880	299	106	10415	27	0	10847
5881	137	71	191	10401	0	10800
5882	123	28	74	10118	0	10343
5883	10597	25	59	241	0	10922
5884	230	10329	46	141	0	10746
5885	9903	135	31	54	0	10123
5886	174	10430	24	40	0	10668
5887	10728	169	13	25	0	10935
5888	10563	58	20	27	0	10668
5889	210	13088	21	27	0	13346
5890	13426	291	17	21	0	13755
5891	14746	111	24	14	0	14895
5892	517	13644	35	32	0	14228
5893	203	14563	48	22	0	14836
5894	15307	502	34	24	0	15867
5895	476	182	12	15437	0	16107
5896	15468	99	15	449	0	16031
5897	15772	62	12	164	0	16010
5898	15743	44	15	101	0	15903
5899	15457	51	22	68	0	15598
5900	647	14254	48	69	0	15018
5901	258	14981	66	59	0	15364
5902	15660	502	40	43	0	16245
5903	530	246	15516	43	0	16335
5904	229	103	426	15900	0	16658
5905	147	69	166	16710	0	17092
5906	16091	66	86	600	0	16843
5907	500	15307	58	266	0	16131
5908	211	448	43	15799	0	16501
5909	147	178	43	16353	0	16721
5910	15854	121	27	659	0	16661
5911	538	79	28	16070	0	16715
5912	15442	66	39	605	0	16152
5913	15523	82	27	254	0	15886
5914	16268	64	33	176	0	16541
5915	751	76	32	15762	0	16621
5916	349	78	20	15765	0	16212
5917	253	82	15171	656	0	16162
5918	202	85	14718	269	0	15274
5919	14999	62	600	183	0	15844
5920	609	51	225	15466	0	16351
5921	306	61	14921	564	0	15852
5922	202	91	15110	254	0	15657
5923	167	64	608	15353	0	16192
5924	184	86	15036	581	0	15887
5925	166	86	548	15104	0	15904
5926	159	68	231	15788	0	16246
5927	196	67	15700	726	0	16689
5928	161	71	497	15998	0	16727
5929	167	69	207	16475	0	16918
5930	169	77	118	16855	0	17219
5931	185	88	15517	814	0	16604
5932	177	60	477	16293	0	17007
5933	16182	66	197	684	0	17129
5934	647	15619	137	322	0	16725
5935	16044	539	76	200	0	16859
5936	729	260	15220	152	0	16361
5937	15349	148	500	120	0	16117
5938	15669	109	217	131	0	16126
5939	15100	115	156	130	0	15501
5940	876	119	95	14516	0	15606
5941	450	96	92	15110	0	15748
5942	294	102	12844	766	0	14006
5943	13061	64	472	360	0	13957
5944	698	13241	227	253	0	14419
5945	301	11725	126	178	0	12330
5946	218	12201	83	168	0	12670
5947	178	581	686	11533	0	12978
5948	10727	219	55	467	0	11468
5949	10982	107	64	244	0	11397
5950	595	77	10335	161	0	11168
5951	296	50	376	10567	0	11289
5952	189	56	177	11045	0	11467
5953	177	83	10290	590	0	11140
5954	155	100	10179	281	0	10715
5955	10342	58	497	210	0	11107
5956	485	10195	210	205	0	11095
5957	10759	394	109	175	0	11437
5958	11020	138	96	178	0	11432
5959	663	80	83	10532	0	11358
5960	343	77	70	10996	0	11486
5961	11082	80	70	601	0	11833
5962	511	62	80	11087	0	11740
5963	236	55	87	11429	0	11807
5964	11013	46	121	635	0	11815
5965	496	56	137	11121	0	11810
5966	11102	33	92	560	0	11787
5967	11329	43	107	314	0	11793
5968	581	75	10466	218	0	11340
5969	10817	61	458	194	0	11530
5970	11164	46	224	202	0	11636
5971	10733	39	165	156	0	11093
5972	596	74	9419	203	0	10292
5973	10050	26	370	191	0	10637
5974	495	9894	204	172	0	10765
5975	10452	359	90	193	0	11094
5976	10635	124	90	214	0	11063
5977	566	66	82	10306	0	11020
5978	291	28	89	10438	0	10846
5979	202	10236	77	614	0	11129
5980	209	366	73	10359	0	11007
5981	174	186	51	10671	0	11082
5982	10395	91	70	588	0	11144
5983	491	65	88	9970	0	10614
5984	309	40	67	10811	0	11227
5985	241	28	88	10758	0	11115
5986	194	9375	87	632	0	10288
5987	9352	400	73	320	0	10145
5988	520	9568	99	236	0	10423
5989	6074	269	36	82	0	6461
5990	338	65	6123	83	0	6609
5991	4957	21	135	28	0	5141
5992	171	28	4895	46	0	5140
5993	71	4826	147	54	0	5098
5994	4339	97	42	187	0	4665
5995	4297	34	17	19	0	4367
5996	135	4140	14	18	0	4307
5997	61	4287	20	11	0	4379
5998	4226	119	6	11	0	4362
5999	4277	38	9	15	0	4339
6000	132	18	9	4056	0	4215
6001	49	8	8	4242	0	4307
6002	34	10	4015	122	0	4181
6003	3263	13	83	45	0	3404
6004	104	12	27	3382	0	3525
6005	43	3299	19	106	0	3467
6006	28	91	7	3437	0	3563
6007	17	34	5	3536	0	3592
6008	20	25	3333	127	0	3505
6009	16	12	82	3445	0	3555
6010	3409	13	24	111	0	3557
6011	99	3289	19	50	0	3457
6012	41	3421	14	17	0	3493
6013	3444	118	8	11	0	3581
6014	2843	39	8	19	0	2909
6015	2867	16	11	15	0	2909
6016	142	2744	15	23	0	2924
6017	19	2320	4	10	0	2353
6018	3412	70	4	8	0	3494
6019	3967	22	5	4	0	3998
6020	175	3823	7	5	0	4010
6021	52	4023	5	5	0	4085
6022	3919	183	1	2	0	4105
6023	149	61	4	3906	0	4120
6024	3969	21	3	144	0	4137
6025	174	17	2	3583	0	3776
6026	60	3689	15	130	0	3894
6027	33	3188	5	37	0	3263
6028	3084	188	2	24	0	3298
6029	3626	66	2	14	0	3708
6030	3727	27	1	27	0	3782
6031	249	3528	5	24	0	3806
6032	92	199	3146	23	0	3460
6033	38	3603	161	19	0	3821
6034	3625	205	41	9	0	3880
6035	3751	73	17	11	0	3852
6036	257	48	3298	10	0	3613
6037	101	3486	181	12	0	3780
6038	51	206	52	3574	0	3883
6039	43	73	24	3492	0	3632
6040	40	3417	26	218	0	3701
6041	46	202	3384	62	0	3694
6042	3621	80	177	25	0	3903
6043	212	39	57	3638	0	3946
6044	3630	41	26	198	0	3895
6045	3769	38	12	80	0	3899
6046	269	19	12	4301	0	4601
6047	120	38	8	4705	0	4871
6048	58	42	19	4797	0	4916
6049	64	38	16	4892	0	5010
6050	4552	30	10	385	0	4977
6051	4765	31	5	160	0	4961
6052	382	34	4333	82	0	4831
6053	162	24	253	4501	0	4940
6054	75	31	88	4786	0	4980
6055	59	36	35	4906	0	5036
6056	65	39	4312	412	0	4828
6057	62	34	260	4664	0	5020
6058	4498	37	93	325	0	4953
6059	291	33	46	4664	0	5034
6060	136	35	4334	340	0	4845
6061	73	35	262	4418	0	4788
6062	64	49	4447	338	0	4898
6063	4657	29	276	147	0	5109
6064	292	29	100	4743	0	5164
6065	4756	32	51	313	0	5152
6066	4918	22	26	166	0	5132
6067	376	32	29	4738	0	5175
6068	4791	37	20	324	0	5172
6069	333	32	30	4449	0	4844
6070	173	4441	40	289	0	4943
6071	4746	254	18	146	0	5164
6072	4893	96	28	90	0	5107
6073	4946	55	27	67	0	5095
6074	405	39	24	4684	0	5152
6075	179	35	15	4911	0	5140
6076	115	23	16	5061	0	5215
6077	74	37	4329	459	0	4899
6078	91	4494	252	206	0	5043
6079	91	240	85	4426	0	4842
6080	90	98	4143	314	0	4645
6081	4350	44	266	175	0	4835
6082	287	27	105	4456	0	4875
6083	145	29	4182	364	0	4720
6084	4715	9	224	203	0	5151
6085	253	22	100	4718	0	5093
6086	167	19	64	4881	0	5131
6087	101	11	36	5059	0	5207
6088	4758	18	45	377	0	5198
6089	4844	11	37	224	0	5116
6090	4511	22	61	138	0	4732
6091	345	3965	46	120	0	4476
6092	182	4371	44	107	0	4704
6093	4504	244	28	94	0	4870
6094	294	90	4135	114	0	4633
6095	158	39	203	4392	0	4792
6096	112	28	101	4622	0	4863
6097	4426	19	59	364	0	4868
6098	4394	32	49	174	0	4649
6099	335	4238	25	113	0	4711
6100	176	213	31	4432	0	4852
6101	145	90	4211	267	0	4713
6102	115	49	4252	176	0	4592
6103	110	15	272	4343	0	4740
6104	96	20	109	4693	0	4918
6105	4436	18	63	404	0	4921
6106	290	42	32	4598	0	4962
6107	4523	25	49	347	0	4944
6108	4669	30	50	198	0	4947
6109	356	28	4167	141	0	4692
6110	4478	20	229	151	0	4878
6111	4571	18	121	140	0	4850
6112	4498	27	67	146	0	4738
6113	373	4332	67	121	0	4893
6114	194	4685	60	130	0	5069
6115	136	249	42	4757	0	5184
6116	116	93	4382	346	0	4937
6117	112	4483	239	225	0	5059
6118	100	125	82	3538	0	3845
6119	91	61	42	3047	0	3241
6120	93	2943	37	191	0	3264
6121	3101	128	31	114	0	3374
6122	3189	62	28	106	0	3385
6123	233	36	2921	84	0	3274
6124	3099	12	126	91	0	3328
6125	201	20	2996	80	0	3297
6126	2975	27	138	75	0	3215
6127	217	37	2911	61	0	3226
6128	143	2870	149	59	0	3221
6129	87	94	64	2475	0	2720
6130	55	44	54	2629	0	2782
6131	2892	22	44	169	0	3127
6132	2942	10	40	113	0	3105
6133	2970	20	16	92	0	3098
6134	172	31	2755	87	0	3045
6135	103	37	108	2824	0	3072
6136	77	20	62	2980	0	3139
6137	2876	17	57	169	0	3119
6138	128	2727	55	111	0	3021
6139	2920	94	27	77	0	3118
6140	167	45	26	2898	0	3136
6141	127	27	23	2941	0	3118
6142	103	25	11	2985	0	3124
6143	69	35	21	3017	0	3142
6144	62	27	29	2983	0	3101
6145	71	2677	41	193	0	2982
6146	28	2057	9	44	0	2138
6147	1	1854	4	2	0	1861
6148	1	16	1	1911	0	1929
6149	0	10	1805	12	0	1827
6150	1705	2	14	9	0	1730
6151	12	1788	9	5	0	1814
6152	5	9	1	1903	0	1918
6153	3	6	0	1918	0	1927
6154	1890	1	1	15	0	1907
6155	1813	2	2	8	0	1825
6156	1752	0	2	5	0	1759
6157	17	0	0	1833	0	1850
6158	7	2	1835	11	0	1855
6159	1	4	1953	8	0	1966
6160	1	5	24	2064	0	2094
6161	0	3	2045	20	0	2068
6162	1620	1	23	10	0	1654
6163	20	1	10	1737	0	1768
6164	10	3	1739	19	0	1771
6165	5	1	19	1689	0	1714
6166	4	1	2417	23	0	2445
6167	6	4	2350	11	0	2371
6168	6	1	29	3020	0	3056
6169	6	2	3046	21	0	3075
6170	5	4	2885	12	0	2906
6171	2	2599	70	12	0	2683
6172	1	23	16	3076	0	3116
6173	3090	10	4	25	0	3129
6174	24	5	3	3036	0	3068
6175	14	2	1	3103	0	3120
6176	3	8	2955	35	0	3001
6177	2680	3	26	22	0	2731
6178	25	1	11	3073	0	3110
6179	11	2	5	3097	0	3115
6180	3042	3	2	36	0	3083
6181	23	1	3	3077	0	3104
6182	3053	1	1	32	0	3087
6183	3008	2	3	15	0	3028
6184	2331	3	0	6	0	2340
6185	33	2211	8	9	0	2261
6186	2350	17	1	5	0	2373
6187	27	2245	1	4	0	2277
6188	14	26	0	2332	0	2372
6189	2337	9	4	26	0	2376
6190	26	3040	9	17	0	3092
6191	3233	22	3	9	0	3267
6192	28	3050	10	5	0	3093
6193	3153	26	2	3	0	3184
6194	26	2928	10	10	0	2974
6195	12	3090	14	6	0	3122
6196	7	3168	10	8	0	3193
6197	5	35	4	3160	0	3204
6198	4	3113	14	22	0	3153
6199	6	25	3	3205	0	3239
6200	6	12	6	3214	0	3238
6201	6	4	9	3204	0	3223
6202	4	5	3	3794	0	3806
6203	3787	3	4	43	0	3837
6204	3781	0	5	25	0	3811
6205	39	18	3611	15	0	3683
6206	3710	1	29	13	0	3753
6207	4150	3	19	7	0	4179
6208	4209	2	9	11	0	4231
6209	76	7	4023	8	0	4114
6210	26	10	3908	13	0	3957
6211	3883	3	68	11	0	3965
6212	61	15	3986	14	0	4076
6213	18	3769	64	11	0	3862
6214	15	57	20	3967	0	4059
6215	4020	16	5	60	0	4101
6216	3983	12	7	28	0	4030
6217	4050	4	9	11	0	4074
6218	83	9	4	3922	0	4018
6219	28	3	12	4008	0	4051
6220	35	11	3831	74	0	3951
6221	21	10	51	3870	0	3952
6222	23	5	21	3994	0	4043
6223	3967	7	19	75	0	4068
6224	75	3839	17	29	0	3960
6225	3986	55	12	20	0	4073
6226	76	21	16	3955	0	4068
6227	3973	17	13	63	0	4066
6228	3926	7	13	39	0	3985
6229	3768	9	20	17	0	3814
6230	82	3771	22	22	0	3897
6231	25	3497	15	19	0	3556
6232	18	53	12	3636	0	3719
6233	3604	18	8	64	0	3694
6234	55	9	15	3541	0	3620
6235	30	6	5	3611	0	3652
6236	18	20	3507	68	0	3613
6237	25	8	44	3533	0	3610
6238	23	8	15	3570	0	3616
6239	45	4	12	3599	0	3660
6240	28	12	3503	76	0	3619
6241	41	11	3373	31	0	3456
6242	50	3373	59	24	0	3506
6243	3611	46	22	17	0	3696
6244	70	25	22	3566	0	3683
6245	43	20	3497	55	0	3615
6246	40	8	54	3495	0	3597
6247	48	9	21	3631	0	3709
6248	3601	20	26	67	0	3714
6249	3537	20	9	47	0	3613
6250	70	3453	17	39	0	3579
6251	3624	53	8	26	0	3711
6252	3609	18	4	34	0	3665
6253	79	12	7	3562	0	3660
6254	44	17	3433	72	0	3566
6255	26	3317	64	36	0	3443
6256	3569	51	25	38	0	3683
6257	3561	20	15	38	0	3634
6258	77	3402	23	43	0	3545
6259	29	46	19	3665	0	3759
6260	3695	17	7	76	0	3795
6261	3694	9	8	39	0	3750
6262	87	9	7	3626	0	3729
6263	3686	6	9	79	0	3780
6264	3758	9	14	22	0	3803
6265	3741	10	10	27	0	3788
6266	97	34	3222	17	0	3370
6267	33	3272	70	27	0	3402
6268	40	3132	20	28	0	3220
6269	3097	116	15	21	0	3249
6270	116	3106	14	37	0	3273
6271	40	107	3750	32	0	3929
6272	38	30	97	3799	0	3964
6273	4567	18	19	132	0	4736
6274	120	13	21	4600	0	4754
6275	4609	14	25	127	0	4775
6276	4635	11	29	48	0	4723
6277	4643	15	14	28	0	4700
6278	145	4352	22	24	0	4543
6279	62	5238	20	32	0	5352
6280	5430	112	25	26	0	5593
6281	5406	39	14	30	0	5489
6282	5450	25	11	44	0	5530
6283	145	17	10	5375	0	5547
6284	5353	26	12	116	0	5507
6285	134	5131	20	38	0	5323
6286	54	5816	12	44	0	5926
6287	74	108	5	5907	0	6094
6288	48	39	5686	132	0	5905
6289	52	33	5627	41	0	5753
6290	49	28	106	5010	0	5193
6291	52	30	4949	119	0	5150
6292	49	22	99	5057	0	5227
6293	5113	28	24	113	0	5278
6294	125	32	15	5120	0	5292
6295	5078	17	15	121	0	5231
6296	148	4912	15	42	0	5117
6297	53	112	4931	47	0	5143
6298	48	33	102	4910	0	5093
6299	54	29	21	5164	0	5268
6300	56	23	4937	135	0	5151
6301	44	14	115	4877	0	5050
6302	11	4333	22	108	0	4474
6303	18	93	11	4470	0	4592
6304	18	16	9	4501	0	4544
6305	29	13	10	4910	0	4962
6306	20	14	5520	126	0	5680
6307	25	12	4912	27	0	4976
6308	4827	9	86	24	0	4946
6309	91	16	4932	16	0	5055
6310	20	4929	93	13	0	5055
6311	5103	78	21	13	0	5215
6312	88	5829	27	14	0	5958
6313	5994	82	34	12	0	6122
6314	6015	21	35	17	0	6088
6315	5944	18	22	14	0	5998
6316	5942	16	26	16	0	6000
6317	103	5631	23	19	0	5776
6318	55	5832	15	22	0	5924
6319	6026	98	15	11	0	6150
6320	121	49	5775	12	0	5957
6321	59	29	80	5803	0	5971
6322	54	21	25	6042	0	6142
6323	60	25	5803	90	0	5978
6324	5554	25	89	37	0	5705
6325	6028	29	26	24	0	6107
6326	6009	37	20	27	0	6093
6327	127	5857	33	29	0	6046
6328	6069	90	25	35	0	6219
6329	121	37	41	5727	0	5926
6330	60	5692	52	89	0	5893
6331	6067	96	31	35	0	6229
6332	5999	43	39	25	0	6106
6333	6499	42	34	25	0	6600
6334	174	43	20	6438	0	6675
6335	103	45	12	6387	0	6547
6336	84	6117	38	151	0	6390
6337	82	139	6099	57	0	6377
6338	97	52	104	6273	0	6526
6339	90	35	44	6293	0	6462
6340	86	41	26	6577	0	6730
6341	71	44	6269	166	0	6550
6342	6236	29	118	89	0	6472
6343	150	39	49	7178	0	7416
6344	66	55	7040	152	0	7313
6345	61	31	123	7150	0	7365
6346	7136	31	65	170	0	7402
6347	178	6891	64	90	0	7223
6348	97	114	41	7186	0	7438
6349	90	52	6938	160	0	7240
6350	6761	50	143	82	0	7036
6351	7146	36	66	67	0	7315
6352	183	56	6905	88	0	7232
6353	109	44	138	6435	0	6726
6354	81	6785	78	136	0	7080
6355	7135	128	49	79	0	7391
6356	182	51	6915	72	0	7220
6357	6899	39	161	79	0	7178
6358	191	38	6952	79	0	7260
6359	94	46	6425	84	0	6649
6360	6348	28	158	60	0	6594
6361	134	6446	83	74	0	6737
6362	93	126	6713	66	0	6998
6363	87	6692	149	70	0	6998
6364	120	134	6662	49	0	6965
6365	84	6680	163	49	0	6976
6366	6514	87	79	49	0	6729
6367	130	64	6345	51	0	6590
6368	83	55	5900	45	0	6083
6369	73	42	5901	40	0	6056
6370	5991	66	97	30	0	6184
6371	5482	36	74	34	0	5626
6372	110	42	71	5340	0	5563
6373	95	32	5410	70	0	5607
6374	89	30	5262	59	0	5440
6375	5409	19	143	41	0	5612
6376	94	36	98	5513	0	5741
6377	5542	33	61	83	0	5719
6378	5546	33	64	41	0	5684
6379	132	33	62	4685	0	4912
6380	93	4630	62	74	0	4859
6381	79	75	84	4783	0	5021
6382	79	63	60	4848	0	5050
6383	95	40	4666	103	0	4904
6384	92	4447	100	78	0	4717
6385	89	4670	86	56	0	4901
6386	66	111	59	4206	0	4442
6387	55	73	4220	104	0	4452
6388	56	4070	118	82	0	4326
6389	66	74	4228	80	0	4448
6390	4089	47	137	66	0	4339
6391	4338	45	91	55	0	4529
6392	114	45	4209	61	0	4429
6393	4279	41	100	78	0	4498
6394	138	35	80	4128	0	4381
6395	103	4139	64	110	0	4416
6396	77	75	100	4367	0	4619
6397	4320	55	78	88	0	4541
6398	4343	30	60	78	0	4511
6399	4299	46	55	73	0	4473
6400	4292	46	53	62	0	4453
6401	139	4017	74	68	0	4298
6402	98	4186	76	51	0	4411
6403	4340	97	64	84	0	4585
6404	129	72	4156	60	0	4417
6405	100	46	75	3778	0	3999
6406	32	3022	50	44	0	3148
6407	37	47	32	3037	0	3153
6408	25	3028	39	50	0	3142
6409	26	57	29	3120	0	3232
6410	37	32	3012	60	0	3141
6411	2965	26	57	41	0	3089
6412	2375	19	46	21	0	2461
6413	77	20	2299	23	0	2419
6414	2341	14	57	15	0	2427
6415	2377	23	32	21	0	2453
6416	93	17	2279	11	0	2400
6417	60	15	63	2289	0	2427
6418	2350	12	40	53	0	2455
6419	70	26	2289	22	0	2407
6420	52	12	56	2300	0	2420
6421	34	17	2285	63	0	2399
6422	30	28	2561	40	0	2659
6423	2621	29	71	27	0	2748
6424	2696	30	36	26	0	2788
6425	2691	21	26	27	0	2765
6426	2997	14	33	25	0	3069
6427	104	18	28	2915	0	3065
6428	60	2788	33	67	0	2948
6429	51	2881	30	22	0	2984
6430	36	92	23	2949	0	3100
6431	2938	36	25	67	0	3066
6432	94	2795	29	38	0	2956
6433	20	2379	21	27	0	2447
6434	2477	41	20	14	0	2552
6435	57	13	13	2463	0	2546
6436	2487	7	19	36	0	2549
6437	61	2377	12	19	0	2469
6438	2505	34	11	15	0	2565
6439	66	19	3009	11	0	3105
6440	3397	20	50	18	0	3485
6441	3447	15	16	15	0	3493
6442	4219	14	12	10	0	4255
6443	90	9	3165	0	0	3264
6444	3318	2	70	2	0	3392
6445	93	3216	36	2	0	3347
6446	44	80	3290	0	0	3414
6447	26	28	85	3311	0	3450
6448	18	7	40	3349	0	3414
6449	14	3285	25	103	0	3427
6450	11	77	14	3419	0	3521
6451	12	34	7	3500	0	3553
6452	8	18	3339	119	0	3484
6453	3249	9	87	48	0	3393
6454	86	19	3371	28	0	3504
6455	38	5	91	3388	0	3522
6456	16	9	3376	91	0	3492
6457	24	4	91	3430	0	3549
6458	3412	10	47	99	0	3568
6459	3446	5	24	50	0	3525
6460	114	10	14	3436	0	3574
6461	42	11	3331	101	0	3485
6462	25	4	82	3127	0	3238
6463	23	8	2975	104	0	3110
6464	3010	6	89	56	0	3161
6465	3140	2	51	31	0	3224
6466	3129	1	20	29	0	3179
6467	3058	1	25	25	0	3109
6468	137	2951	22	17	0	3127
6469	64	73	15	3074	0	3226
6470	2988	31	14	96	0	3129
6471	103	2898	19	46	0	3066
6472	47	2962	15	28	0	3052
6473	32	113	2300	22	0	2467
6474	2418	40	84	19	0	2561
6475	2483	22	36	18	0	2559
6476	129	23	2319	10	0	2481
6477	62	17	86	2395	0	2560
6478	32	11	44	2491	0	2578
6479	42	10	2341	119	0	2512
6480	30	10	96	2449	0	2585
6481	2443	15	41	103	0	2602
6482	108	11	2329	59	0	2507
6483	55	14	2434	26	0	2529
6484	2432	9	119	31	0	2591
6485	110	17	2365	19	0	2511
6486	2418	7	117	20	0	2562
6487	102	2377	59	29	0	2567
6488	2441	84	34	16	0	2575
6489	113	40	28	2416	0	2597
6490	61	16	17	2505	0	2599
6491	2442	16	22	124	0	2604
6492	101	14	24	2473	0	2612
6493	2438	8	15	117	0	2578
6494	105	2401	25	59	0	2590
6495	62	76	18	2318	0	2474
6496	40	38	17	2487	0	2582
6497	2440	23	16	127	0	2606
6498	2472	15	17	54	0	2558
6499	2478	13	11	39	0	2541
6500	136	2300	18	38	0	2492
6501	73	2403	20	34	0	2530
6502	2450	106	11	36	0	2603
6503	132	50	2272	25	0	2479
6504	64	2382	88	30	0	2564
6505	2439	96	36	33	0	2604
6506	2495	43	19	21	0	2578
6507	2527	20	17	23	0	2587
6508	151	23	18	2413	0	2605
6509	2453	20	20	96	0	2589
6510	2520	21	12	49	0	2602
6511	157	19	18	2413	0	2607
6512	2490	15	17	106	0	2628
6513	130	28	2289	52	0	2499
6514	92	21	84	2387	0	2584
6515	52	17	42	2450	0	2561
6516	46	14	24	2523	0	2607
6517	2419	11	17	150	0	2597
6518	2485	9	22	84	0	2600
6519	2535	14	17	51	0	2617
6520	2502	4	17	59	0	2582
6521	2526	2	18	44	0	2590
6522	171	2	22	2071	0	2266
6523	98	6	17	2167	0	2288
6524	2065	6	20	133	0	2224
6525	131	2038	12	73	0	2254
6526	1792	64	15	45	0	1916
6527	110	31	1633	42	0	1816
6528	2473	16	70	30	0	2589
6529	2502	17	33	29	0	2581
6530	139	14	2285	26	0	2464
6531	2487	6	77	23	0	2593
6532	113	13	2344	37	0	2507
6533	94	13	2369	12	0	2488
6534	53	10	103	2281	0	2447
6535	56	11	41	2474	0	2582
6536	54	14	2347	97	0	2512
6537	32	15	2389	60	0	2496
6538	41	2259	109	41	0	2450
6539	26	1696	48	28	0	1798
6540	1307	59	13	14	0	1393
6541	46	1785	19	12	0	1862
6542	1082	1	0	0	0	1083
6543	0	1014	0	1	0	1015
6544	1058	1	2	0	0	1061
6545	1	2	1019	0	0	1022
6546	1005	0	1	0	0	1006
6547	1	0	0	1045	0	1046
6548	0	1007	0	0	0	1007
6549	0	4	0	1078	0	1082
6550	1082	0	0	2	0	1084
6551	1077	0	0	0	0	1077
6552	2	0	0	1030	0	1032
6553	2	1	1052	1	0	1056
6554	0	0	1011	1	0	1012
6555	0	961	5	1	0	967
6556	0	1	0	1065	0	1066
6557	4	1	1048	1	0	1054
6558	0	1049	9	0	0	1058
6559	1	2	0	1209	0	1212
6560	0	0	0	1232	0	1232
6561	1200	3	0	3	0	1206
6562	2	0	0	1209	0	1211
6563	1	1	1216	4	0	1222
6564	4	1	2	1170	0	1177
6565	1160	0	0	6	0	1166
6566	3	2	1782	0	0	1787
6567	1724	1	19	5	0	1749
6568	22	1982	21	0	0	2025
6569	2154	19	7	1	0	2181
6570	2156	13	6	1	0	2176
6571	41	7	4	2049	0	2101
6572	24	7	0	2132	0	2163
6573	14	2000	2	31	0	2047
6574	9	18	0	2157	0	2184
6575	2080	11	0	30	0	2121
6576	23	8	2048	22	0	2101
6577	13	7	19	2084	0	2123
6578	7	1989	17	24	0	2037
6579	7	20	7	2145	0	2179
6580	5	12	6	2150	0	2173
6581	2094	6	3	38	0	2141
6582	18	2011	6	24	0	2059
6583	14	18	0	2139	0	2171
6584	2126	13	0	29	0	2168
6585	27	5	2	2144	0	2178
6586	19	5	1	2156	0	2181
6587	2094	4	0	39	0	2137
6588	2108	3	1	23	0	2135
6589	41	1	2078	13	0	2133
6590	2016	0	21	13	0	2050
6591	2096	0	14	9	0	2119
6592	2434	1	7	4	0	2446
6593	43	2212	10	4	0	2269
6594	32	2334	7	3	0	2376
6595	19	28	5	2415	0	2467
6596	2441	19	1	21	0	2482
6597	2409	14	4	19	0	2446
6598	35	10	3	2347	0	2395
6599	25	13	2341	32	0	2411
6600	2385	6	20	18	0	2429
6601	2761	3	11	11	0	2786
6602	43	5	4	2630	0	2682
6603	25	0	7	2729	0	2761
6604	2735	4	2	40	0	2781
6605	28	5	2	2702	0	2737
6606	25	2544	10	44	0	2623
6607	20	17	4	2725	0	2766
6608	2649	14	4	34	0	2701
6609	30	13	2629	23	0	2695
6610	2443	7	21	19	0	2490
6611	32	4	2638	19	0	2693
6612	25	7	27	2603	0	2662
6613	2701	11	20	28	0	2760
6614	31	10	11	2625	0	2677
6615	32	1	8	2657	0	2698
6616	2604	4	8	46	0	2662
6617	32	2	2578	38	0	2650
6618	29	10	2697	23	0	2759
6619	21	2	33	3572	0	3628
6620	18	2	24	3601	0	3645
6621	16	5	17	3685	0	3723
6622	11	6	3617	48	0	3682
6623	3320	1	23	40	0	3384
6624	3651	5	15	24	0	3695
6625	3674	5	7	21	0	3707
6626	3630	8	7	14	0	3659
6627	61	3361	12	15	0	3449
6628	44	2934	6	5	0	2989
6629	27	3018	8	10	0	3063
6630	18	32	8	2866	0	2924
6631	17	19	4	2850	0	2890
6632	16	14	2838	41	0	2909
6633	8	2722	21	25	0	2776
6634	4	21	11	2934	0	2970
6635	2882	12	2	38	0	2934
6636	23	2737	14	29	0	2803
6637	20	28	5	2873	0	2926
6638	7	2776	9	34	0	2826
6639	2917	22	1	29	0	2969
6640	29	20	7	2765	0	2821
6641	24	9	2680	33	0	2746
6642	13	14	2612	21	0	2660
6643	16	1	31	2682	0	2730
6644	17	4	18	2614	0	2653
6645	12	3	14	2765	0	2794
6646	2737	7	6	47	0	2797
6647	24	5	2645	35	0	2709
6648	23	2554	25	20	0	2622
6649	8	18	24	2729	0	2779
6650	18	14	2640	29	0	2701
6651	7	2542	33	29	0	2611
6652	8	26	16	2744	0	2794
6653	6	18	3113	39	0	3176
6654	9	9	26	3064	0	3108
6655	12	11	18	3151	0	3192
6656	3195	6	6	39	0	3246
6657	3139	6	11	26	0	3182
6658	41	4	4	3156	0	3205
6659	3167	6	6	35	0	3214
6660	33	10	3065	25	0	3133
6661	23	3	21	3090	0	3137
6662	10	7	3110	37	0	3164
6663	12	5	25	3078	0	3120
6664	11	2910	31	36	0	2988
6665	10	2998	12	32	0	3052
6666	0	2359	2	0	0	2361
6667	0	2	1	2334	0	2337
6668	0	0	0	2383	0	2383
6669	3	3	2296	3	0	2305
6670	2	7	2024	1	0	2034
6671	3	8	2121	0	0	2132
6672	2075	0	8	0	0	2083
6673	5	0	0	2315	0	2320
6674	2650	0	0	5	0	2655
6675	30	2510	3	2	0	2545
6676	28	29	1	2649	0	2707
6677	2662	27	1	35	0	2725
6678	35	6	3	2632	0	2676
6679	2621	2	0	43	0	2666
6680	41	7	2475	36	0	2559
6681	33	2430	40	7	0	2510
6682	7	32	27	3104	0	3170
6683	3111	27	5	35	0	3178
6684	3095	6	3	33	0	3137
6685	61	4	1	3049	0	3115
6686	32	1	2	3100	0	3135
6687	3077	0	6	67	0	3150
6688	34	3	6	2954	0	2997
6689	30	3	3032	45	0	3110
6690	12	2833	37	34	0	2916
6691	6	30	22	3106	0	3164
6692	2794	28	6	42	0	2870
6693	2657	11	1	33	0	2702
6694	67	9	2892	10	0	2978
6695	43	2701	46	11	0	2801
6696	13	3041	27	5	0	3086
6697	6	80	5	3072	0	3163
6698	6	36	7	3712	0	3761
6699	5	13	1	4240	0	4259
6700	6	7	5	4263	0	4281
6701	10	3833	7	149	0	3999
6702	8	87	3	4050	0	4148
6703	8	57	3	4114	0	4182
6704	3993	14	4	157	0	4168
6705	3953	10	2	73	0	4038
6706	136	3852	8	23	0	4019
6707	4635	78	5	23	0	4741
6708	4664	53	3	11	0	4731
6709	4684	13	0	16	0	4713
6710	160	13	4354	11	0	4538
6711	83	6	84	4358	0	4531
6712	31	8	53	4905	0	4997
6713	16	17	5042	146	0	5221
6714	20	14	85	4975	0	5094
6715	9	7	51	5015	0	5082
6716	5096	7	18	159	0	5280
6717	96	18	5025	82	0	5221
6718	56	6	96	4995	0	5153
6719	4368	9	41	117	0	4535
6720	97	4139	20	78	0	4334
6721	4372	88	7	33	0	4500
6722	4383	55	5	26	0	4469
6723	152	4163	8	22	0	4345
6724	74	95	3	4339	0	4511
6725	4359	54	4	107	0	4524
6726	112	4223	15	75	0	4425
6727	66	106	5	4371	0	4548
6728	4367	61	5	115	0	4548
6729	4362	18	12	79	0	4471
6730	155	4200	9	37	0	4401
6731	4426	90	11	28	0	4555
6732	119	61	3	4352	0	4535
6733	4429	21	8	114	0	4572
6734	126	19	4186	74	0	4405
6735	80	10	89	4279	0	4458
6736	33	13	50	4399	0	4495
6737	4322	7	21	163	0	4513
6738	97	4202	20	97	0	4416
6739	4320	90	13	42	0	4465
6740	121	4157	16	37	0	4331
6741	78	110	3926	25	0	4139
6742	40	69	3927	30	0	4066
6743	39	27	136	3945	0	4147
6744	37	26	3999	109	0	4171
6745	23	15	104	4029	0	4171
6746	25	17	62	4000	0	4104
6747	30	17	15	4200	0	4262
6748	4063	13	10	191	0	4277
6749	3985	11	14	99	0	4109
6750	4042	22	9	49	0	4122
6751	171	3734	19	47	0	3971
6752	102	3882	14	35	0	4033
6753	59	135	4044	34	0	4272
6754	49	67	121	4338	0	4575
6755	41	46	4301	175	0	4563
6756	44	30	155	4435	0	4664
6757	45	16	94	4543	0	4698
6758	29	21	42	4681	0	4773
6759	25	26	4245	298	0	4594
6760	25	13	150	4504	0	4692
6761	4403	16	93	239	0	4751
6762	155	4204	55	161	0	4575
6763	97	144	36	4508	0	4785
6764	4447	90	19	217	0	4773
6765	4483	47	26	128	0	4684
6766	261	32	27	4370	0	4690
6767	131	19	29	4561	0	4740
6768	4194	15	20	256	0	4485
6769	180	25	20	4286	0	4511
6770	4109	12	22	229	0	4372
6771	201	12	12	4251	0	4476
6772	127	21	3902	230	0	4280
6773	68	3740	147	165	0	4120
6774	55	3689	58	73	0	3875
6775	47	146	23	3816	0	4032
6776	35	78	23	3929	0	4065
6777	3838	44	16	189	0	4087
6778	138	30	10	3869	0	4047
6779	72	26	20	3938	0	4056
6780	37	24	21	3941	0	4023
6781	29	3614	16	237	0	3896
6782	41	98	7	3541	0	3687
6783	28	55	16	3580	0	3679
6784	26	29	8	3624	0	3687
6785	3293	17	22	250	0	3582
6786	131	3277	16	136	0	3560
6787	67	131	13	3454	0	3665
6788	47	68	10	3530	0	3655
6789	35	35	10	3618	0	3698
6790	3311	34	16	234	0	3595
6791	133	20	18	3484	0	3655
6792	84	10	6	3579	0	3679
6793	40	24	3199	244	0	3507
6794	44	2967	94	140	0	3245
6795	22	102	46	3274	0	3444
6796	2978	54	22	174	0	3228
6797	115	2954	27	117	0	3213
6798	2393	62	7	54	0	2516
6799	1937	37	8	40	0	2022
6800	91	27	15	1880	0	2013
6801	53	24	4	1969	0	2050
6802	40	19	1862	112	0	2033
6803	28	12	54	1942	0	2036
6804	26	13	2152	102	0	2293
6805	24	8	70	2243	0	2345
6806	2179	7	43	110	0	2339
6807	62	1637	30	81	0	1810
6808	38	53	21	1734	0	1846
6809	20	36	16	1781	0	1853
6810	19	20	17	1779	0	1835
6811	16	19	11	1810	0	1856
6812	1447	13	9	135	0	1604
6813	76	1155	10	92	0	1333
6814	42	64	4	1244	0	1354
6815	1205	36	12	115	0	1368
6816	71	20	1112	93	0	1296
6817	1185	11	57	77	0	1330
6818	1249	7	36	57	0	1349
6819	110	18	269	948	0	1345
6820	67	14	25	1254	0	1360
6821	1201	16	24	107	0	1348
6822	91	1161	14	81	0	1347
6823	1226	58	18	61	0	1363
6824	1257	37	9	44	0	1347
6825	1288	19	8	50	0	1365
6826	128	14	6	1224	0	1372
6827	81	14	2	2032	0	2129
6828	57	2002	6	144	0	2209
6829	43	97	7	2116	0	2263
6830	2088	63	8	140	0	2299
6831	129	38	1949	102	0	2218
6832	2097	21	90	74	0	2282
6833	2118	28	58	71	0	2275
6834	176	20	23	2090	0	2309
6835	115	26	15	2171	0	2327
6836	2080	17	18	201	0	2316
6837	2166	5	10	121	0	2302
6838	2154	10	22	75	0	2261
6839	207	12	1873	63	0	2155
6840	129	1989	87	63	0	2268
6841	2732	95	58	57	0	2942
6842	145	62	23	2675	0	2905
6843	110	2668	17	126	0	2921
6844	72	121	20	3047	0	3260
6845	2974	75	16	170	0	3235
6846	163	42	16	3068	0	3289
6847	99	50	2685	191	0	3025
6848	58	3010	112	124	0	3304
6849	37	3122	62	104	0	3325
6850	47	196	2980	60	0	3283
6851	3026	97	130	75	0	3328
6852	155	3145	85	68	0	3453
6853	54	291	26	2337	0	2708
6854	2270	38	14	97	0	2419
6855	90	2236	25	47	0	2398
6856	49	96	20	2335	0	2500
6857	2340	47	7	89	0	2483
6858	107	21	9	2373	0	2510
6859	2390	15	11	119	0	2535
6860	125	25	2060	71	0	2281
6861	83	2249	61	50	0	2443
6862	2792	87	25	42	0	2946
6863	2832	40	25	43	0	2940
6864	2894	27	23	33	0	2977
6865	162	34	2587	25	0	2808
6866	2781	26	78	32	0	2917
6867	2839	27	51	30	0	2947
6868	136	45	28	2776	0	2985
6869	2757	25	17	102	0	2901
6870	144	2648	31	60	0	2883
6871	88	91	11	2811	0	3001
6872	56	57	2664	107	0	2884
6873	41	62	79	2748	0	2930
6874	55	43	49	2873	0	3020
6875	2778	32	41	140	0	2991
6876	2868	34	17	94	0	3013
6877	158	39	2711	51	0	2959
6878	2811	12	96	64	0	2983
6879	161	30	2726	41	0	2958
6880	92	36	105	2782	0	3015
6881	93	26	2701	139	0	2959
6882	97	25	97	2560	0	2779
6883	94	2594	58	122	0	2868
6884	97	79	2687	67	0	2930
6885	71	54	2761	56	0	2942
6886	69	43	137	2664	0	2913
6887	2841	26	62	124	0	3053
6888	2833	51	50	80	0	3014
6889	2875	33	52	60	0	3020
6890	171	44	54	2770	0	3039
6891	113	43	28	2863	0	3047
6892	93	21	50	2891	0	3055
6893	89	23	36	2928	0	3076
6894	85	52	2577	175	0	2889
6895	71	41	89	2707	0	2908
6896	91	2650	64	155	0	2960
6897	64	110	65	2820	0	3059
6898	2779	50	42	194	0	3065
6899	145	32	2675	111	0	2963
6900	2753	35	98	99	0	2985
6901	174	36	2693	78	0	2981
6902	103	29	2659	83	0	2874
6903	112	2642	147	45	0	2946
6904	76	92	111	2372	0	2651
6905	111	43	74	2224	0	2452
6906	89	2377	81	138	0	2685
6907	2529	103	63	101	0	2796
6908	171	79	48	2501	0	2799
6909	102	52	64	2959	0	3177
6910	72	36	53	3048	0	3209
6911	2884	48	43	216	0	3191
6912	2961	42	44	137	0	3184
6913	191	25	35	2967	0	3218
6914	142	35	45	3021	0	3243
6915	2906	39	28	240	0	3213
6916	175	43	32	2973	0	3223
6917	127	26	45	3002	0	3200
6918	98	23	55	3070	0	3246
6919	78	23	2715	231	0	3047
6920	2869	25	131	139	0	3164
6921	2944	44	91	121	0	3200
6922	190	31	2689	113	0	3023
6923	137	384	142	2260	0	2923
6924	97	2784	93	151	0	3125
6925	2684	119	72	108	0	2983
6926	178	2792	82	83	0	3135
6927	81	1973	30	69	0	2153
6928	67	72	19	2036	0	2194
6929	2013	28	23	125	0	2189
6930	2054	28	19	86	0	2187
6931	127	22	18	2006	0	2173
6932	72	10	20	2076	0	2178
6933	45	12	34	2107	0	2198
6934	60	16	19	2097	0	2192
6935	57	21	15	2029	0	2122
6936	51	1876	32	167	0	2126
6937	54	56	41	2039	0	2190
6938	1988	29	34	134	0	2185
6939	1994	26	42	85	0	2147
6940	2037	11	52	72	0	2172
6941	69	1208	15	33	0	1325
6942	30	44	17	1268	0	1359
6943	32	14	1213	67	0	1326
6944	994	7	24	21	0	1046
6945	32	6	13	1009	0	1060
6946	796	3	9	276	0	1084
6947	781	4	3	15	0	803
6948	794	2	2	10	0	808
6949	23	5	0	770	0	798
6950	778	3	1	21	0	803
6951	22	5	1	772	0	800
6952	13	1	0	791	0	805
6953	784	2	0	24	0	810
6954	23	1	0	772	0	796
6955	774	3	0	24	0	801
6956	774	5	0	16	0	795
6957	22	0	2	766	0	790
6958	14	2	3	770	0	789
6959	12	5	0	780	0	797
6960	10	3	692	31	0	736
6961	15	3	695	16	0	729
6962	13	1	16	392	0	422
6963	12	1	8	410	0	431
6964	5	2	5	409	0	421
6965	9	1	5	410	0	425
6966	3	0	4	424	0	431
6967	399	0	2	31	0	432
6968	18	391	3	21	0	433
6969	14	10	0	408	0	432
6970	404	7	0	19	0	430
6971	23	4	0	404	0	431
6972	9	3	2	418	0	432
6973	402	1	0	29	0	432
6974	409	1	1	19	0	430
6975	23	3	377	13	0	416
6976	14	2	13	402	0	431
6977	10	2	377	24	0	413
6978	9	0	17	405	0	431
6979	9	0	9	407	0	425
6980	5	0	5	420	0	430
6981	4	0	372	36	0	412
6982	7	385	13	20	0	425
6983	1	402	10	17	0	430
6984	7	16	8	396	0	427
6985	395	8	3	22	0	428
6986	12	8	377	22	0	419
6987	7	6	380	19	0	412
6988	10	1	16	399	0	426
6989	11	1	9	393	0	414
6990	7	393	11	17	0	428
6991	3	15	6	404	0	428
6992	5	5	6	416	0	432
6993	4	5	4	420	0	433
6994	393	2	3	33	0	431
6995	377	3	2	25	0	407
6996	23	374	5	21	0	423
6997	12	404	1	9	0	426
6998	10	17	5	394	0	426
6999	399	9	2	24	0	434
7000	15	395	6	14	0	430
7001	7	14	5	391	0	417
7002	8	394	3	21	0	426
7003	396	15	1	17	0	429
7004	396	10	6	10	0	422
7005	18	395	2	8	0	423
7006	11	401	2	11	0	425
7007	8	16	369	14	0	407
7008	12	402	12	11	0	437
7009	0	1	0	9	0	10
7010	1	0	9	0	0	10
7011	0	8	0	0	0	8
7012	0	0	0	8	0	8
7013	0	0	0	8	0	8
7014	0	0	0	8	0	8
7015	8	0	0	0	0	8
7016	0	0	8	0	0	8
7017	0	0	8	0	0	8
7018	0	0	0	7	0	7
7019	0	0	8	0	0	8
7020	0	0	0	8	0	8
7021	0	0	1	8	0	9
7022	0	0	0	9	0	9
7023	0	0	0	9	0	9
7024	9	0	0	0	0	9
7025	7	0	0	0	0	7
7026	0	0	0	9	0	9
7027	0	4	1304	0	0	1308
7028	0	1	1	1217	0	1219
7029	0	1265	5	0	0	1270
7030	0	0	0	1421	0	1421
7031	1427	0	0	0	0	1427
7032	1408	0	0	1	0	1409
7033	0	1	0	1353	0	1354
7034	0	0	0	1381	0	1381
7035	0	0	0	1404	0	1404
7036	1386	0	1	1	0	1388
7037	1	3	1344	0	0	1348
7038	1	1	1352	0	0	1354
7039	0	1295	1	2	0	1298
7040	1418	0	0	0	0	1418
7041	0	0	1	1344	0	1345
7042	2	2	1857	0	0	1861
7043	0	1745	0	2	0	1747
7044	0	1824	1	0	0	1825
7045	0	0	0	1856	0	1856
7046	0	1	0	1853	0	1854
7047	0	1801	1	2	0	1804
7048	0	0	0	1887	0	1887
7049	0	0	0	1858	0	1858
7050	1886	0	0	1	0	1887
7051	0	1815	2	1	0	1818
7052	0	0	0	1877	0	1877
7053	1	1	1857	0	0	1859
7054	0	1	0	1791	0	1792
7055	1891	0	0	0	0	1891
7056	0	1763	3	0	0	1766
7057	0	0	0	1878	0	1878
7058	0	1	1838	0	0	1839
7059	2	1	2655	0	0	2658
7060	1	4	0	2520	0	2525
7061	0	0	0	2819	0	2819
7062	3985	0	0	0	0	3985
7063	0	3683	11	4	0	3698
7064	3947	0	0	0	0	3947
7065	2	2	3869	0	0	3873
7066	3280	1	1	2	0	3284
7067	0	0	4227	0	0	4227
7068	3764	0	25	2	0	3791
7069	3973	0	5	2	0	3980
7070	28	6	4310	1	0	4345
7071	11	4	4063	1	0	4079
7072	12	3828	29	0	0	3869
7073	8	23	10	4406	0	4447
7074	6114	5	11	25	0	6155
7075	21	11	7	6161	0	6200
7076	6	8	1	6128	0	6143
7077	7	3	2	6329	0	6341
7078	9	2	6213	34	0	6258
7079	4909	7	30	25	0	4971
7080	5994	1	7	16	0	6018
7081	26	5920	12	11	0	5969
7082	11	23	7	6273	0	6314
7083	15	6121	6	23	0	6165
7084	6	26	0	6354	0	6386
7085	6381	9	1	30	0	6421
7086	23	5932	10	12	0	5977
7087	4	25	0	6314	0	6343
7088	6320	4	2	31	0	6357
7089	6060	7	4	10	0	6081
7090	32	11	0	6138	0	6181
7091	14	5	6180	32	0	6231
7092	14	1	22	6004	0	6041
7093	8	5979	7	25	0	6019
7094	6334	23	6	14	0	6377
7095	22	5982	11	11	0	6026
7096	7	31	1	6247	0	6286
7097	7313	12	0	28	0	7353
7098	32	11	1	8350	0	8394
7099	5	11	1	8196	0	8213
7100	11	5	8481	36	0	8533
7101	10	7943	29	18	0	8000
7102	8305	21	4	16	0	8346
7103	8021	7	13	14	0	8055
7104	26	8099	14	5	0	8144
7105	9	8348	8	8	0	8373
7106	14	26	2	8520	0	8562
7107	8594	8	1	25	0	8628
7108	23	8117	21	14	0	8175
7109	5	27	0	8476	0	8508
7110	12	9	8284	31	0	8336
7111	11	9	18	7807	0	7845
7112	8549	8	4	34	0	8595
7113	21	7978	17	13	0	8029
7114	6	23	7	8364	0	8400
7115	11	9	8079	30	0	8129
7116	15	18	8685	7	0	8725
7117	7	14	29	8439	0	8489
7118	2	5	12	9155	0	9174
7119	2	9010	22	36	0	9070
7120	1	24	10	9504	0	9539
7121	9561	7	0	45	0	9613
7122	23	11	4	9304	0	9342
7123	9470	11	4	34	0	9519
7124	33	8889	7	22	0	8951
7125	12	8925	13	15	0	8965
7126	11	32	4	9407	0	9454
7127	6	17	1	8180	0	8204
7128	8	23	8032	32	0	8095
7129	7	13	18	7489	0	7527
7130	8043	5	9	46	0	8103
7131	30	10	8371	22	0	8433
7132	12	8	34	8136	0	8190
7133	14	11	8995	38	0	9058
7134	19	5	36	8591	0	8651
7135	13	9	19	8424	0	8465
7136	6	7	12	8886	0	8911
7137	10	6	8859	49	0	8924
7138	6	8	32	8307	0	8353
7139	0	8254	17	56	0	8327
7140	7	26	9	9027	0	9069
7141	2	9	11	8828	0	8850
7142	8473	9	6	49	0	8537
7143	31	16	8120	28	0	8195
7144	10	6	27	7939	0	7982
7145	16	8	8071	46	0	8141
7146	24	21	8310	13	0	8368
7147	9	18	32	8270	0	8329
7148	3	11	16	8501	0	8531
7149	3	9	17	9097	0	9126
7150	9149	6	12	49	0	9216
7151	35	16	8612	33	0	8696
7152	7673	24	36	44	0	7777
7153	37	6	7	8874	0	8924
7154	21	4	11	8909	0	8945
7155	17	8625	17	39	0	8698
7156	16	27	5	9123	0	9171
7157	6	9	6	8932	0	8953
7158	4	8	5	8832	0	8849
7159	7893	12	5	48	0	7958
7160	29	13	7838	30	0	7910
7161	6249	15	32	40	0	6336
7162	35	6863	8	31	0	6937
7163	7234	24	11	16	0	7285
7164	36	6903	13	19	0	6971
7165	21	6921	16	11	0	6969
7166	18	43	406	8019	0	8486
7167	7968	2	0	19	0	7989
7168	16	7	4	7721	0	7748
7169	3	7346	14	19	0	7382
7170	3	7472	9	8	0	7492
7171	2	15	1	7760	0	7778
7172	1	5	0	7450	0	7456
7173	5	7372	9	22	0	7408
7174	10	15	4	6544	0	6573
7175	5	7	1	6434	0	6447
7176	1	9	0	7735	0	7745
7177	8692	11	0	30	0	8733
7178	23	13	8402	22	0	8460
7179	8454	8	20	24	0	8506
7180	8967	9	7	17	0	9000
7181	8952	0	5	20	0	8977
7182	31	8647	19	20	0	8717
7183	17	29	3	9169	0	9218
7184	9205	11	3	28	0	9247
7185	26	10	8	9036	0	9080
7186	9214	7	2	40	0	9263
7187	37	9385	14	27	0	9463
7188	9875	28	5	26	0	9934
7189	9759	23	3	30	0	9815
7190	10788	16	1	32	0	10837
7191	43	20	4	10892	0	10959
7192	30	23	3	11041	0	11097
7193	11283	24	4	50	0	11361
7194	42	10429	16	45	0	10532
7195	26	10641	15	47	0	10729
7196	11297	38	5	43	0	11383
7197	44	22	11	10241	0	10318
7198	34	26	8	9627	0	9695
7199	31	13	6	9913	0	9963
7200	52	9419	19	72	0	9562
7201	9815	58	14	52	0	9939
7202	74	32	2	9824	0	9932
7203	49	9500	29	72	0	9650
7204	58	47	3	10009	0	10117
7205	42	37	1	9851	0	9931
7206	35	29	6	9824	0	9894
7207	45	41	3	9916	0	10005
7208	9955	24	4	115	0	10098
7209	9731	22	6	77	0	9836
7210	9737	37	5	66	0	9845
7211	105	14	3	9704	0	9826
7212	72	28	9337	101	0	9538
7213	67	56	8534	77	0	8734
7214	63	58	9770	65	0	9956
7215	10883	23	52	57	0	11015
7216	90	20	26	10126	0	10262
7217	57	27	15	10037	0	10136
7218	56	23	14	10285	0	10378
7219	10209	31	17	97	0	10354
7220	9969	26	18	90	0	10103
7221	95	10156	36	86	0	10373
7222	75	48	14	10733	0	10870
7223	69	52	10243	104	0	10468
7224	57	9773	67	89	0	9986
7225	55	72	11	10677	0	10815
7226	52	49	10	10647	0	10758
7227	53	37	9	10475	0	10574
7228	38	48	14	10282	0	10382
7229	58	36	10181	153	0	10428
7230	53	41	9579	133	0	9806
7231	58	9182	70	105	0	9415
7232	59	57	34	9934	0	10084
7233	78	35	35	9609	0	9757
7234	9585	25	32	116	0	9758
7235	103	38	9327	102	0	9570
7236	63	32	58	9196	0	9349
7237	41	49	40	9560	0	9690
7238	80	43	9709	138	0	9970
7239	63	9125	81	122	0	9391
7240	10071	66	28	88	0	10253
7241	100	45	9650	106	0	9901
7242	9544	40	56	108	0	9748
7243	102	33	9639	105	0	9879
7244	77	32	74	9490	0	9673
7245	83	39	9481	119	0	9722
7246	75	48	8592	92	0	8807
7247	79	24	60	8737	0	8900
7248	54	42	64	8920	0	9080
7249	41	48	48	10642	0	10779
7250	39	36	52	10409	0	10536
7251	45	26	56	10434	0	10561
7252	56	33	10316	155	0	10560
7253	52	44	9638	138	0	9872
7254	44	10332	102	132	0	10610
7255	11464	164	59	113	0	11800
7256	185	71	42	11402	0	11700
7257	11571	43	46	239	0	11899
7258	184	57	42	11490	0	11773
7259	11449	42	37	274	0	11802
7260	191	30	53	11478	0	11752
7261	87	30	49	11506	0	11672
7262	82	11524	64	280	0	11950
7263	90	149	37	12505	0	12781
7264	80	57	42	12484	0	12663
7265	81	35	39	12543	0	12698
7266	23	17	19	11251	0	11310
7267	10	10476	52	219	0	10757
7268	11187	120	24	104	0	11435
7269	118	10577	36	85	0	10816
7270	53	147	10	11181	0	11391
7271	11119	53	12	182	0	11366
7272	152	56	10270	77	0	10555
7273	61	47	10374	65	0	10547
7274	291	28	154	9869	0	10342
7275	22	12	60	10718	0	10812
7276	19	15	45	9843	0	9922
7277	20	15	36	8717	0	8788
7278	20	12	35	8890	0	8957
7279	17	7993	37	213	0	8260
7280	21	114	11	8626	0	8772
7281	8461	37	24	197	0	8719
7282	116	26	18	8441	0	8601
7283	53	18	8350	186	0	8607
7284	30	12	126	8290	0	8458
7285	8381	17	40	179	0	8617
7286	123	7943	30	103	0	8199
7287	56	116	16	9171	0	9359
7288	27	47	12	10578	0	10664
7289	42	44	10081	411	0	10578
7290	28	58	14904	107	0	15097
7291	18237	32	656	86	0	19011
7292	866	21	205	18720	0	19812
7293	290	21	186	19824	0	20321
7294	280	65	18216	1190	0	19751
7295	166	81	17848	595	0	18690
7296	68	18287	1120	455	0	19930
7297	56	845	508	19057	0	20466
7298	39	306	17543	961	0	18849
7299	14	17961	976	316	0	19267
7300	18464	962	323	289	0	20038
7301	19267	323	243	178	0	20011
7302	1161	273	124	17993	0	19551
7303	548	18393	89	904	0	19934
7304	18990	919	63	307	0	20279
7305	1115	368	121	15029	0	16633
7306	408	316	17376	740	0	18840
7307	318	18080	863	294	0	19555
7308	18362	936	286	258	0	19842
7309	18874	317	285	151	0	19627
7310	1165	288	164	19239	0	20856
7311	561	168	79	20338	0	21146
7312	393	145	18211	1274	0	20023
7313	217	76	862	19679	0	20834
7314	141	61	299	19043	0	19544
7315	99	55	265	19053	0	19472
7316	85	60	140	19364	0	19649
7317	102	44	106	18608	0	18860
7318	97	17302	97	1621	0	19117
7319	17938	882	41	835	0	19696
7320	1004	341	16558	577	0	18480
7321	372	16663	916	345	0	18296
7322	337	968	350	17674	0	19329
7323	17265	349	311	1102	0	19027
7324	983	303	207	17987	0	19480
7325	375	164	138	18702	0	19379
7326	308	129	100	18881	0	19418
7327	197	101	81	19241	0	19620
7328	182	113	16170	1763	0	18228
7329	134	16950	906	944	0	18934
7330	17635	955	321	686	0	19597
7331	1055	371	17113	428	0	18967
7332	392	340	1043	17765	0	19540
7333	17717	244	416	1138	0	19515
7334	1122	17513	363	477	0	19475
7335	18066	1010	211	464	0	19751
7336	1276	400	155	17745	0	19576
7337	547	377	115	18877	0	19916
7338	482	212	93	18770	0	19557
7339	305	121	79	19175	0	19680
7340	17356	104	100	1855	0	19415
7341	1034	94	77	18213	0	19418
7342	427	78	104	19821	0	20430
7343	18514	95	108	1668	0	20385
7344	1185	141	17039	880	0	19245
7345	477	130	913	18844	0	20364
7346	18157	111	337	1359	0	19964
7347	18637	85	306	664	0	19692
7348	1351	100	192	17593	0	19236
7349	734	89	143	17307	0	18273
7350	580	15703	139	1524	0	17946
7351	313	923	79	17113	0	18428
7352	206	1027	108	17136	0	18477
7353	178	382	15219	1675	0	17454
7354	124	196	14809	955	0	16084
7355	120	15012	1095	757	0	16984
7356	164	871	565	15333	0	16933
7357	160	342	421	16395	0	17318
7358	15486	355	285	1352	0	17478
7359	964	241	219	16129	0	17553
7360	457	171	14933	1469	0	17030
7361	460	159	884	16164	0	17667
7362	306	116	14049	1514	0	15985
7363	257	131	14688	752	0	15828
7364	168	158	1235	14513	0	16074
7365	160	164	626	15718	0	16668
7366	14699	157	425	1439	0	16720
7367	15435	125	243	905	0	16708
7368	1260	117	227	15248	0	16852
7369	15178	162	146	1272	0	16758
7370	15767	88	120	646	0	16621
7371	1466	104	119	14999	0	16688
7372	742	119	99	15969	0	16929
7373	15115	111	89	1487	0	16802
7374	15508	52	143	887	0	16590
7375	1285	46	118	15811	0	17260
7376	691	14937	160	1433	0	17221
7377	559	944	112	15928	0	17543
7378	394	319	99	16997	0	17809
7379	250	333	14118	1783	0	16484
7380	189	188	869	16567	0	17813
7381	14791	107	369	1743	0	17010
7382	1748	14435	402	873	0	17458
7383	15777	901	189	741	0	17608
7384	16351	331	150	547	0	17379
7385	16745	339	114	454	0	17652
7386	1657	937	86	15147	0	17827
7387	817	213	13055	1213	0	15298
7388	604	177	12244	522	0	13547
7389	366	12557	992	605	0	14520
7390	107	6633	277	224	0	7241
7391	34	2735	44	43	0	2856
7392	24	2718	27	65	0	2834
7393	29	184	2532	53	0	2798
7394	2575	143	139	53	0	2910
7395	152	51	45	2669	0	2917
7396	91	38	42	2778	0	2949
7397	78	29	42	2712	0	2861
7398	78	2588	28	213	0	2907
7399	2678	124	36	120	0	2958
7400	185	40	2452	118	0	2795
7401	90	2495	140	82	0	2807
7402	73	142	665	2050	0	2930
7403	1980	58	33	188	0	2259
7404	120	68	24	2092	0	2304
7405	59	50	1909	187	0	2205
7406	52	32	1996	107	0	2187
7407	33	39	168	1994	0	2234
7408	29	29	90	2127	0	2275
7409	2029	23	59	193	0	2304
7410	132	29	1904	130	0	2195
7411	2015	18	118	112	0	2263
7412	2111	19	51	96	0	2277
7413	179	25	53	2042	0	2299
7414	87	22	1894	178	0	2181
7415	62	22	153	2082	0	2319
7416	1969	16	86	187	0	2258
7417	133	1957	76	102	0	2268
7418	2049	107	47	102	0	2305
7419	158	45	19	1994	0	2216
7420	92	3035	35	159	0	3321
7421	103	117	17	3244	0	3481
7422	88	46	18	3247	0	3399
7423	64	3038	30	203	0	3335
7424	86	117	15	3278	0	3496
7425	63	40	23	3354	0	3480
7426	65	38	13	3358	0	3474
7427	69	24	2902	236	0	3231
7428	69	3037	118	138	0	3362
7429	3211	135	53	97	0	3496
7430	135	56	31	3159	0	3381
7431	71	2999	39	179	0	3288
7432	3240	127	32	119	0	3518
7433	148	49	35	3255	0	3487
7434	81	56	26	3126	0	3289
7435	82	53	23	3175	0	3333
7436	83	35	19	3204	0	3341
7437	3070	64	22	210	0	3366
7438	193	38	6	3102	0	3339
7439	105	24	17	3197	0	3343
7440	3076	31	44	212	0	3363
7441	150	25	55	3140	0	3370
7442	60	4	2166	156	0	2386
7443	44	7	94	2260	0	2405
7444	2428	12	35	149	0	2624
7445	108	14	28	2479	0	2629
7446	54	26	2354	131	0	2565
7447	46	25	2256	68	0	2395
7448	2293	13	130	55	0	2491
7449	2509	16	66	32	0	2623
7450	2510	12	37	34	0	2593
7451	2556	7	17	37	0	2617
7452	168	9	2320	25	0	2522
7453	81	6	104	2344	0	2535
7454	61	4	40	2509	0	2614
7455	2431	3	25	152	0	2611
7456	108	10	17	2481	0	2616
7457	61	12	2323	138	0	2534
7458	45	6	107	2426	0	2584
7459	29	12	2365	145	0	2551
7460	20	2306	125	70	0	2521
7461	2409	96	50	53	0	2608
7462	108	36	35	2386	0	2565
7463	43	35	2315	121	0	2514
7464	48	12	112	2355	0	2527
7465	23	11	50	2508	0	2592
7466	23	19	2336	151	0	2529
7467	35	5	99	2420	0	2559
7468	2420	8	35	165	0	2628
7469	114	5	2333	67	0	2519
7470	2223	3	108	66	0	2400
7471	121	2288	40	50	0	2499
7472	44	89	2306	36	0	2475
7473	49	35	2279	33	0	2396
7474	33	1044	144	994	0	2215
7475	0	1	2	1181	0	1184
7476	1	5	1265	5	0	1276
7477	0	0	4	1247	0	1251
7478	1303	3	0	4	0	1310
7479	1289	0	2	0	0	1291
7480	4	0	0	1257	0	1261
7481	1	0	2	1245	0	1248
7482	1	1216	2	5	0	1224
7483	664	18	10	21	0	713
7484	3	1	2	1249	0	1255
7485	0	1205	3	5	0	1213
7486	1271	3	1	0	0	1275
7487	1210	1	2	2	0	1215
7488	5	1217	1	0	0	1223
7489	2	6	1	1237	0	1246
7490	1	0	2	1263	0	1266
7491	1	3	1231	3	0	1238
7492	1	2	4	1167	0	1174
7493	1248	0	0	7	0	1255
7494	5	1	3	1242	0	1251
7495	1	2	1210	7	0	1220
7496	1195	0	4	1	0	1200
7497	6	0	1	1233	0	1240
7498	1	2	1226	4	0	1233
7499	2	0	3	1213	0	1218
7500	0	1	1234	5	0	1240
7501	3	0	4	1171	0	1178
7502	2	0	2	1240	0	1244
7503	1247	2	1	5	0	1255
7504	6	1187	2	3	0	1198
7505	1225	5	2	2	0	1234
7506	1152	5	1	1	0	1159
7507	1181	1	2	2	0	1186
7508	6	1170	1	4	0	1181
7509	3	5	1146	1	0	1155
7510	3	2	5	1181	0	1191
7511	1236	1	0	4	0	1241
7512	1205	0	2	4	0	1211
7513	5	0	3	1170	0	1178
7514	1215	0	0	7	0	1222
7515	5	2	1183	4	0	1194
7516	1105	0	6	4	0	1115
7517	5	0	1182	4	0	1191
7518	2	1093	8	1	0	1104
7519	1175	3	2	2	0	1182
7520	191	2	1	3	0	197
7521	7	196	1	1	0	205
7522	196	4	1	2	0	203
7523	201	0	2	1	0	204
7524	6	2	194	2	0	204
7525	198	0	4	4	0	206
7526	6	3	191	0	0	200
7527	0	0	7	191	0	198
7528	3	188	0	5	0	196
7529	3	5	191	0	0	199
7530	193	0	3	2	0	198
7531	199	1	1	3	0	204
7532	5	1	2	197	0	205
7533	2	0	189	4	0	195
7534	3	0	4	196	0	203
7535	174	1	2	5	0	182
7536	5	198	2	0	0	205
7537	196	3	0	2	0	201
7538	193	1	0	1	0	195
7539	4	194	0	2	0	200
7540	3	4	0	198	0	205
7541	198	0	1	3	0	202
7542	3	2	2	197	0	204
7543	4	1	0	200	0	205
7544	0	0	13	1	0	14
7545	0	0	1	11	0	12
7546	0	0	0	16	0	16
7547	14	0	1	1	0	16
7548	15	0	0	0	0	15
7549	1	0	0	15	0	16
7550	0	0	14	1	0	15
7551	0	0	15	0	0	15
7552	0	0	1	14	0	15
7553	0	0	13	1	0	14
7554	0	0	1	14	0	15
7555	0	0	0	15	0	15
7556	15	0	0	1	0	16
7557	1	0	15	0	0	16
7558	14	0	1	0	0	15
7559	15	0	0	0	0	15
7560	1	0	14	0	0	15
7561	0	0	14	0	0	14
7562	0	2	1	11	0	14
7563	0	13	0	1	0	14
7564	1	16	0	0	0	17
7565	0	2	0	12	0	14
7566	0	0	0	10	0	10
7567	0	0	0	10	0	10
7568	0	0	0	10	0	10
7569	10	0	0	0	0	10
7570	0	0	0	10	0	10
7571	0	0	10	0	0	10
7572	0	0	0	8	0	8
7573	0	9	0	0	0	9
7574	0	0	0	10	0	10
7575	10	0	0	0	0	10
7576	0	0	0	9	0	9
7577	0	0	10	0	0	10
7578	0	10	0	0	0	10
7579	0	0	0	8	0	8
7580	9	0	0	0	0	9
7581	9	0	0	0	0	9
7582	1	0	0	8	0	9
7583	0	0	8	0	0	8
7584	0	0	8	0	0	8
7585	9	0	0	0	0	9
7586	0	0	9	0	0	9
7587	0	0	9	0	0	9
7588	0	0	0	8	0	8
7589	9	0	0	0	0	9
7590	9	0	0	0	0	9
7591	8	0	0	0	0	8
7592	0	0	363	0	0	363
7593	0	1	359	0	0	360
7594	0	366	2	0	0	368
7595	0	1	0	385	0	386
7596	0	0	0	387	0	387
7597	0	0	0	1273	0	1273
7598	0	0	0	1333	0	1333
7599	3	3	1210	18	0	1234
7600	0	1331	14	3	0	1348
7601	1367	17	5	0	0	1389
7602	1267	3	3	0	0	1273
7603	1330	0	1	0	0	1331
7604	19	1327	4	2	0	1352
7605	5	15	0	1352	0	1372
7606	1311	4	6	18	0	1339
7607	14	1336	1	6	0	1357
7608	1320	17	1	5	0	1343
7609	20	1313	4	8	0	1345
7610	1360	17	3	12	0	1392
7611	1330	9	5	8	0	1352
7612	27	5	5	1345	0	1382
7613	17	9	3	2042	0	2071
7614	14	11	1944	26	0	1995
7615	17	11	1852	10	0	1890
7616	1988	12	20	6	0	2026
7617	2037	9	4	13	0	2063
7618	37	10	2	2035	0	2084
7619	20	14	4	2054	0	2092
7620	15	15	1963	30	0	2023
7621	26	9	20	2015	0	2070
7622	20	15	1993	32	0	2060
7623	26	8	23	2002	0	2059
7624	20	11	13	2402	0	2446
7625	2342	14	8	80	0	2444
7626	2367	9	15	25	0	2416
7627	72	21	21	2341	0	2455
7628	41	15	8	2422	0	2486
7629	40	20	2276	62	0	2398
7630	41	10	51	2363	0	2465
7631	33	18	2262	77	0	2390
7632	2302	19	56	39	0	2416
7633	72	14	21	2378	0	2485
7634	2324	19	15	77	0	2435
7635	76	2274	23	29	0	2402
7636	2374	55	10	31	0	2470
7637	72	16	9	2372	0	2469
7638	41	4	16	2339	0	2400
7639	30	2250	16	88	0	2384
7640	26	46	26	2405	0	2503
7641	29	15	2282	86	0	2412
7642	26	9	70	2377	0	2482
7643	34	8	2252	94	0	2388
7644	30	2191	68	54	0	2343
7645	30	48	26	2384	0	2488
7646	35	14	2286	100	0	2435
7647	31	12	2238	45	0	2326
7648	26	15	63	2362	0	2466
7649	2372	8	31	95	0	2506
7650	80	15	2240	62	0	2397
7651	32	17	52	2354	0	2455
7652	2346	14	25	100	0	2485
7653	73	2225	33	68	0	2399
7654	2328	59	32	51	0	2470
7655	78	23	25	2362	0	2488
7656	43	12	29	2387	0	2471
7657	35	23	25	2439	0	2522
7658	2337	13	26	117	0	2493
7659	85	26	35	2365	0	2511
7660	41	27	24	2448	0	2540
7661	2378	18	35	100	0	2531
7662	97	26	2257	55	0	2435
7663	45	26	67	2370	0	2508
7664	49	32	2236	99	0	2416
7665	2287	21	59	74	0	2441
7666	79	25	39	2369	0	2512
7667	43	22	2279	114	0	2458
7668	2247	26	81	63	0	2417
7669	2338	24	33	73	0	2468
7670	97	16	2258	71	0	2442
7671	48	21	74	2309	0	2452
7672	48	16	29	2377	0	2470
7673	36	16	2251	119	0	2422
7674	43	2088	97	64	0	2292
7675	34	54	2275	81	0	2444
7676	2250	12	83	64	0	2409
7677	96	21	3204	57	0	3378
7678	3150	13	69	75	0	3307
7679	107	9	3141	65	0	3322
7680	3094	17	78	67	0	3256
7681	93	3126	29	75	0	3323
7682	50	47	44	3271	0	3412
7683	32	14	42	3355	0	3443
7684	45	15	3179	131	0	3370
7685	44	15	81	3056	0	3196
7686	44	3129	41	106	0	3320
7687	3262	56	38	73	0	3429
7688	90	3120	53	59	0	3322
7689	42	60	47	3297	0	3446
7690	3242	16	44	105	0	3407
7691	82	3145	55	59	0	3341
7692	2952	59	46	59	0	3116
7693	97	27	3768	60	0	3952
7694	53	26	71	3831	0	3981
7695	38	23	53	3920	0	4034
7696	50	18	35	4080	0	4183
7697	2996	5	4	34	0	3039
7698	2944	4	7	9	0	2964
7699	2909	3	5	10	0	2927
7700	2843	3	4	11	0	2861
7701	40	7	2871	8	0	2926
7702	2699	3	31	11	0	2744
7703	38	2744	17	8	0	2807
7704	11	2801	9	7	0	2828
7705	3007	27	5	13	0	3052
7706	2986	2	4	9	0	3001
7707	31	5	9	2924	0	2969
7708	2994	2	2	40	0	3038
7709	2887	5	9	5	0	2906
7710	2909	3	4	9	0	2925
7711	34	4	2	2907	0	2947
7712	8	3328	9	34	0	3379
7713	15	2904	7	8	0	2934
7714	13	66	4	2973	0	3056
7715	2940	23	7	64	0	3034
7716	65	2903	9	18	0	2995
7717	18	58	5	2945	0	3026
7718	17	22	3533	66	0	3638
7719	3197	13	63	23	0	3296
7720	65	3454	22	20	0	3561
7721	25	3553	16	11	0	3605
7722	3672	75	5	7	0	3759
7723	74	27	3593	9	0	3703
7724	13	6	32	3179	0	3230
7725	10	3197	14	27	0	3248
7726	3	32	10	3323	0	3368
7727	1	19	1	3328	0	3349
7728	1	2958	12	46	0	3017
7729	4	34	0	3349	0	3387
7730	1	12	0	3353	0	3366
7731	3352	9	0	47	0	3408
7732	33	3207	7	21	0	3268
7733	3306	32	0	11	0	3349
7734	38	20	1	3241	0	3300
7735	14	3254	8	36	0	3312
7736	15	37	3279	16	0	3347
7737	3	15	33	3240	0	3291
7738	5	11	11	3404	0	3431
7739	2	16	3366	49	0	3433
7740	3120	7	31	31	0	3189
7741	32	5	13	3421	0	3471
7742	3435	8	8	35	0	3486
7743	48	19	3289	17	0	3373
7744	14	10	33	3328	0	3385
7745	19	10	3369	37	0	3435
7746	5	6	41	3306	0	3358
7747	5	7	13	3420	0	3445
7748	3453	8	10	47	0	3518
7749	36	3276	8	29	0	3349
7750	3433	33	3	19	0	3488
7751	41	21	3333	11	0	3406
7752	16	14	33	3324	0	3387
7753	11	6	3701	41	0	3759
7754	3132	5	46	18	0	3201
7755	3684	7	13	19	0	3723
7756	52	9	3665	7	0	3733
7757	3532	3	37	8	0	3580
7758	3719	7	13	8	0	3747
7759	46	4	15	3642	0	3707
7760	22	5	3628	43	0	3698
7761	17	8	4051	27	0	4103
7762	6	6	48	4095	0	4155
7763	11	8	24	4121	0	4164
7764	10	3923	23	46	0	4002
7765	5	4167	14	31	0	4217
7766	4253	40	9	14	0	4316
7767	37	25	9	4124	0	4195
7768	19	4037	8	50	0	4114
7769	15	4177	5	23	0	4220
7770	3899	43	8	17	0	3967
7771	44	25	2	4136	0	4207
7772	17	4083	9	33	0	4142
7773	16	36	3	4205	0	4260
7774	4	19	11	4175	0	4209
7775	9	13	7	4171	0	4200
7776	4145	4	5	65	0	4219
7777	40	3242	11	27	0	3320
7778	20	32	6	3319	0	3377
7779	13	20	5	3344	0	3382
7780	11	13	4	3357	0	3385
7781	10	7	3223	55	0	3295
7782	3036	4	37	29	0	3106
7783	37	5	20	3336	0	3398
7784	3307	5	17	38	0	3367
7785	3249	2	5	28	0	3284
7786	3255	11	3	22	0	3291
7787	55	11	3238	8	0	3312
7788	23	3076	48	17	0	3164
7789	14	33	14	3308	0	3369
7790	8	17	3251	47	0	3323
7791	9	23	3115	15	0	3162
7792	9	8	44	3153	0	3214
7793	7	2270	25	41	0	2343
7794	2395	35	8	24	0	2462
7795	2390	18	7	19	0	2434
7796	2397	13	2	16	0	2428
7797	2407	2	3	13	0	2425
7798	61	11	2304	8	0	2384
7799	2318	5	32	8	0	2363
7800	48	2255	22	11	0	2336
7801	14	33	10	2362	0	2419
7802	12	14	8	2398	0	2432
7803	2368	10	6	55	0	2439
7804	38	2	6	2347	0	2393
7805	20	2	2316	50	0	2388
7806	2277	1	33	25	0	2336
7807	2337	5	15	15	0	2372
7808	2363	3	14	4	0	2384
7809	67	9	2270	3	0	2349
7810	2227	8	36	8	0	2279
7811	48	2247	24	12	0	2331
7812	1762	0	0	0	0	1762
7813	1	0	1	1725	0	1727
7814	1	2	0	1728	0	1731
7815	0	1690	5	0	0	1695
7816	0	0	1	1745	0	1746
7817	0	1697	3	0	0	1700
7818	0	0	0	1083	0	1083
7819	0	1051	0	2	0	1053
7820	0	1	0	1082	0	1083
7821	0	1048	3	0	0	1051
7822	0	1	0	1080	0	1081
7823	0	1037	5	1	0	1043
7824	2413	0	0	3	0	2416
7825	65	1	0	2558	0	2624
7826	44	0	1	2613	0	2658
7827	14	1	1	3538	0	3554
7828	8	0	0	3611	0	3619
7829	25	13	3216	202	0	3456
7830	8	1	107	3536	0	3652
7831	2	0	63	3580	0	3645
7832	3418	0	20	239	0	3677
7833	3320	0	11	147	0	3478
7834	168	3353	35	54	0	3610
7835	90	104	8	3294	0	3496
7836	32	66	3	3411	0	3512
7837	4216	20	2	195	0	4433
7838	217	36	3666	105	0	4024
7839	4020	36	157	42	0	4255
7840	210	4036	88	63	0	4397
7841	4229	172	32	51	0	4484
7842	4136	90	13	23	0	4262
7843	276	4001	48	15	0	4340
7844	167	4157	21	18	0	4363
7845	72	289	3	4132	0	4496
7846	69	135	3948	196	0	4348
7847	4198	55	173	105	0	4531
7848	206	73	4072	50	0	4401
7849	4217	47	211	30	0	4505
7850	235	33	3971	51	0	4290
7851	120	4017	246	36	0	4419
7852	104	176	118	4116	0	4514
7853	3788	90	85	197	0	4160
7854	3946	55	36	107	0	4144
7855	306	29	48	3821	0	4204
7856	3890	43	29	211	0	4173
7857	3900	25	16	134	0	4075
7858	336	3722	15	68	0	4141
7859	3893	182	12	45	0	4132
7860	267	3717	17	62	0	4063
7861	171	216	18	3236	0	3641
7862	3298	108	16	193	0	3615
7863	3447	86	12	120	0	3665
7864	3537	35	20	49	0	3641
7865	363	54	3086	33	0	3536
7866	166	36	3232	59	0	3493
7867	144	15	250	3240	0	3649
7868	110	18	136	3085	0	3349
7869	84	3245	57	254	0	3640
7870	3190	180	62	145	0	3577
7871	230	106	63	3257	0	3656
7872	130	58	24	3496	0	3708
7873	85	38	3014	320	0	3457
7874	67	3122	173	156	0	3518
7875	78	3255	97	100	0	3530
7876	50	258	48	3343	0	3699
7877	3235	128	24	262	0	3649
7878	222	69	54	3345	0	3690
7879	124	72	35	3519	0	3750
7880	3332	56	24	314	0	3726
7881	3432	28	23	202	0	3685
7882	347	21	18	3401	0	3787
7883	185	35	3046	296	0	3562
7884	98	25	196	3453	0	3772
7885	101	22	104	3570	0	3797
7886	3322	24	55	358	0	3759
7887	242	21	36	3520	0	3819
7888	3419	20	64	302	0	3805
7889	272	39	3106	222	0	3639
7890	158	36	181	3388	0	3763
7891	160	25	104	3480	0	3769
7892	90	33	48	3616	0	3787
7893	95	49	34	3599	0	3777
7894	79	21	60	3691	0	3851
7895	76	34	3124	448	0	3682
7896	3313	27	202	274	0	3816
7897	247	31	121	3442	0	3841
7898	181	36	3144	322	0	3683
7899	122	40	3268	219	0	3649
7900	88	36	306	3359	0	3789
7901	3385	46	148	275	0	3854
7902	3497	38	63	216	0	3814
7903	3606	36	99	119	0	3860
7904	404	29	89	3003	0	3525
7905	216	3169	74	267	0	3726
7906	3398	192	47	151	0	3788
7907	3564	132	56	94	0	3846
7908	3665	76	31	89	0	3861
7909	3632	59	40	92	0	3823
7910	395	94	31	3352	0	3872
7911	274	58	3115	269	0	3716
7912	199	26	205	3458	0	3888
7913	164	36	3199	270	0	3669
7914	3426	28	228	174	0	3856
7915	3556	23	147	155	0	3881
7916	382	35	3213	85	0	3715
7917	3431	35	242	120	0	3828
7918	3583	39	129	97	0	3848
7919	431	38	79	3169	0	3717
7920	301	3252	43	242	0	3838
7921	3269	192	75	159	0	3695
7922	336	767	55	2554	0	3712
7923	266	3314	41	211	0	3832
7924	93	125	13	1854	0	2085
7925	68	74	1649	176	0	1967
7926	72	1794	111	103	0	2080
7927	927	80	20	44	0	1071
7928	968	24	27	21	0	1040
7929	1001	27	16	15	0	1059
7930	1004	5	20	25	0	1054
7931	117	6	35	842	0	1000
7932	62	878	16	86	0	1042
7933	939	71	17	35	0	1062
7934	95	31	842	39	0	1007
7935	62	893	65	19	0	1039
7936	51	82	920	29	0	1082
7937	0	0	0	13	0	13
7938	1	13	0	0	0	14
7939	0	0	0	14	0	14
7940	1	0	14	0	0	15
7941	1	0	0	13	0	14
7942	0	0	0	15	0	15
7943	0	0	1	14	0	15
7944	13	0	0	1	0	14
7945	0	14	1	0	0	15
7946	1	0	0	14	0	15
7947	15	0	0	0	0	15
7948	0	14	1	0	0	15
7949	15	0	0	0	0	15
7950	1	0	14	0	0	15
7951	0	0	0	14	0	14
7952	0	13	0	0	0	13
7953	15	0	0	0	0	15
7954	0	0	13	1	0	14
7955	0	13	0	0	0	13
7956	0	0	0	241	0	241
7957	0	0	1	241	0	242
7958	247	1	0	0	0	248
7959	1	0	0	244	0	245
7960	1	0	245	1	0	247
7961	1	0	1	236	0	238
7962	2	0	245	1	0	248
7963	0	0	0	242	0	242
7964	0	237	1	0	0	238
7965	245	0	0	0	0	245
7966	240	0	1	0	0	241
7967	0	234	1	1	0	236
7968	1	240	2	0	0	243
7969	0	1	0	247	0	248
7970	247	1	0	0	0	248
7971	0	0	0	247	0	247
7972	248	0	0	0	0	248
7973	0	226	1	0	0	227
7974	0	0	0	243	0	243
7975	0	0	242	0	0	242
7976	0	0	1	235	0	236
7977	0	0	0	244	0	244
7978	247	0	2	0	0	249
7979	0	238	0	1	0	239
7980	0	0	0	248	0	248
7981	246	0	0	0	0	246
7982	0	0	250	0	0	250
7983	239	0	0	0	0	239
7984	0	0	0	245	0	245
7985	0	236	2	0	0	238
7986	244	0	1	0	0	245
7987	1	0	240	0	0	241
7988	0	0	234	0	0	234
7989	0	224	1	0	0	225
7990	245	0	0	0	0	245
7991	0	0	0	609	0	609
7992	0	0	0	578	0	578
7993	826	0	0	0	0	826
7994	10	0	804	0	0	814
7995	1	0	9	800	0	810
7996	3	1	805	11	0	820
7997	0	1	12	793	0	806
7998	0	767	6	13	0	786
7999	0	11	1	823	0	835
8000	0	1	802	11	0	814
8001	776	1	11	2	0	790
8002	11	0	3	815	0	829
8003	1	1	806	14	0	822
8004	2	1	14	773	0	790
8005	1	0	1	811	0	813
8006	0	2	802	13	0	817
8007	0	0	779	3	0	782
8008	0	1	14	789	0	804
8009	2	3	788	11	0	804
8010	771	1	11	2	0	785
8011	12	0	3	807	0	822
8012	811	0	2	14	0	827
8013	14	2	793	4	0	813
8014	2	0	13	789	0	804
8015	3	1	801	11	0	816
8016	1	1103	15	4	0	1123
8017	3	14	1151	2	0	1170
8018	2	4	1083	1	0	1090
8019	1096	1	11	2	0	1110
8020	1168	2	3	1	0	1174
8021	12	3	1168	0	0	1183
8022	3	2	11	1044	0	1060
8023	2	0	3	1152	0	1157
8024	5	3	1154	11	0	1173
8025	0	1095	19	4	0	1118
8026	1151	11	2	4	0	1168
8027	14	2	1141	1	0	1158
8028	6	1	11	1123	0	1141
8029	1	2	4	1148	0	1155
8030	1177	0	1	16	0	1194
8031	1180	0	2	4	0	1186
8032	1164	0	2	5	0	1171
8033	1170	2	1	1	0	1174
8034	17	1	1	1145	0	1164
8035	3	0	1145	13	0	1161
8036	2	0	10	1134	0	1146
8037	5	0	2	1166	0	1173
8038	3	0	3	1167	0	1173
8039	1	0	1144	14	0	1159
8040	1059	0	14	5	0	1078
8041	13	0	2	1162	0	1177
8042	1	0	1155	15	0	1171
8043	4	1065	16	2	0	1087
8044	2	12	2	1166	0	1182
8045	2	2	1	1178	0	1183
8046	1151	1	5	17	0	1174
8047	11	1111	3	8	0	1133
8048	5	13	1116	2	0	1136
8049	3	2	12	1110	0	1127
8050	3	4	4	1168	0	1179
8051	1153	3	2	16	0	1174
8052	1121	0	4	6	0	1131
8053	15	0	2	1151	0	1168
8054	1165	0	2	16	0	1183
8055	13	1707	5	5	0	1730
8056	2	13	1557	5	0	1577
8057	4	1	11	1515	0	1531
8058	2	2	3	1600	0	1607
8059	4	1	3	1600	0	1608
8060	2	1	4	1589	0	1596
8061	1	1538	2	17	0	1558
8062	1612	11	1	5	0	1629
8063	14	3	0	1593	0	1610
8064	6	2085	5	14	0	2110
8065	2213	10	3	3	0	2229
8066	2162	1	2	5	0	2170
8067	12	2099	6	8	0	2125
8068	2	15	2	2204	0	2223
8069	3	3	2	2218	0	2226
8070	3	3	3	2154	0	2163
8071	3	2	1	2191	0	2197
8072	2165	2	1	15	0	2183
8073	2106	1	4	4	0	2115
8074	14	2128	7	5	0	2154
8075	2	12	2154	5	0	2173
8076	2	2	10	2143	0	2157
8077	2226	3	2	14	0	2245
8078	14	2386	5	9	0	2414
8079	4	2450	5	4	0	2463
8080	2632	12	0	4	0	2648
8081	2563	3	2	6	0	2574
8082	15	5	1	2516	0	2537
8083	7	2	2855	13	0	2877
8084	9	12	3244	5	0	3270
8085	3541	1	12	3	0	3557
8086	3695	2	3	5	0	3705
8087	3648	3	5	2	0	3658
8088	3642	2	1	8	0	3653
8089	3692	0	3	5	0	3700
8090	15	3506	3	6	0	3530
8091	4	9	4	3403	0	3420
8092	4	3214	6	14	0	3238
8093	3210	0	2	0	0	3212
8094	3140	0	0	0	0	3140
8095	3065	1	0	0	0	3066
8096	3144	0	0	1	0	3145
8097	0	2986	5	2	0	2993
8098	3216	0	0	0	0	3216
8099	0	3002	7	0	0	3009
8100	0	0	0	3174	0	3174
8101	3189	0	0	3	0	3192
8102	4	0	3096	1	0	3101
8103	1	0	1	2974	0	2976
8104	0	0	0	3451	0	3451
8105	1	1	3474	0	0	3476
8106	0	3252	12	0	0	3264
8107	3524	0	0	0	0	3524
8108	3449	0	0	1	0	3450
8109	0	3342	5	4	0	3351
8110	0	0	0	3472	0	3472
8111	2	1	3436	0	0	3439
8112	0	3583	10	1	0	3594
8113	3721	0	6	1	0	3728
8114	2	1	3730	0	0	3733
8115	3215	5	2	2	0	3224
8116	3372	0	0	2	0	3374
8117	2	0	3419	0	0	3421
8118	1	3177	9	3	0	3190
8119	1	1	0	3428	0	3430
8120	1	4	3336	0	0	3341
8121	3057	1	1	1	0	3060
8122	3393	1	0	1	0	3395
8123	0	3255	5	4	0	3264
8124	0	2	0	3437	0	3439
8125	0	1	0	3471	0	3472
8126	1	1	3925	0	0	3927
8127	0	3634	5	6	0	3645
8128	3992	0	0	0	0	3992
8129	3923	0	1	2	0	3926
8130	3888	0	0	2	0	3890
8131	0	2	3827	1	0	3830
8132	3690	0	2	1	0	3693
8133	3874	1	0	0	0	3875
8134	0	0	0	3899	0	3899
8135	1	1	3882	0	0	3884
8136	3	0	0	3812	0	3815
8137	0	1	3903	0	0	3904
8138	2	0	0	3793	0	3795
8139	0	3618	13	5	0	3636
8140	0	3723	7	5	0	3735
8141	0	0	0	3925	0	3925
8142	0	2	0	3809	0	3811
8143	3820	1	0	1	0	3822
8144	1	3	3774	0	0	3778
8145	3597	2	2	3	0	3604
8146	0	3568	16	7	0	3591
8147	3905	1	0	0	0	3906
8148	3844	1	1	2	0	3848
8149	2	1	0	3828	0	3831
8150	1	0	3781	0	0	3782
8151	2	0	0	3783	0	3785
8152	0	3587	7	4	0	3598
8153	0	0	0	3886	0	3886
8154	0	0	0	3848	0	3848
8155	3268	0	0	1	0	3269
8156	0	0	0	3252	0	3252
8157	0	3007	10	5	0	3022
8158	0	0	0	3280	0	3280
8159	3262	0	0	2	0	3264
8160	0	3074	10	1	0	3085
8161	0	3	0	3251	0	3254
8162	0	1	0	3238	0	3239
8163	0	0	0	3225	0	3225
8164	0	1	0	2641	0	2642
8165	2670	0	0	2	0	2672
8166	0	0	0	2648	0	2648
8167	0	0	0	2657	0	2657
8168	2	1	1	3520	0	3524
8169	0	3393	4	61	0	3458
8170	3483	60	3	8	0	3554
8171	63	15	3427	6	0	3511
8172	10	3943	54	11	0	4018
8173	4163	81	8	6	0	4258
8174	75	26	4774	1	0	4876
8175	16	4490	69	13	0	4588
8176	12	73	15	4812	0	4912
8177	11	4654	16	64	0	4745
8178	16	78	4362	10	0	4466
8179	11	24	4626	8	0	4669
8180	3	4357	85	13	0	4458
8181	4821	75	18	4	0	4918
8182	4800	18	22	4	0	4844
8183	64	24	4340	2	0	4430
8184	18	23	3553	4	0	3598
8185	16	19	3713	2	0	3750
8186	13	8	86	3665	0	3772
8187	15	4	27	3756	0	3802
8188	5	8	25	3864	0	3902
8189	8	5	3763	78	0	3854
8190	7	3	73	3663	0	3746
8191	1	5	21	3858	0	3885
8192	5	4	3720	87	0	3816
8193	3396	2	74	35	0	3507
8194	61	4	19	3792	0	3876
8195	9	2	13	3809	0	3833
8196	9	3589	24	88	0	3710
8197	3773	63	24	28	0	3888
8198	72	14	3680	25	0	3791
8199	3699	9	63	21	0	3792
8200	73	9	17	3775	0	3874
8201	29	16	3726	73	0	3844
8202	20	8	68	3732	0	3828
8203	3790	7	23	78	0	3898
8204	82	10	3407	17	0	3516
8205	3363	5	64	21	0	3453
8206	3477	6	24	16	0	3523
8207	3541	3	16	19	0	3579
8208	86	3286	22	12	0	3406
8209	28	65	17	3475	0	3585
8210	3869	12	14	75	0	3970
8211	3898	10	11	16	0	3935
8212	3913	10	14	12	0	3949
8213	120	16	3701	12	0	3849
8214	4126	5	82	15	0	4228
8215	124	4	30	4504	0	4662
8216	43	12	4417	130	0	4602
8217	33	2	131	4414	0	4580
8218	23	6	40	4599	0	4668
8219	26	10	4716	162	0	4914
8220	16	4	142	4765	0	4927
8221	12	4	50	4911	0	4977
8222	15	13	5937	208	0	6173
8223	5824	2	208	71	0	6105
8224	6458	6	84	46	0	6594
8225	272	5	50	6960	0	7287
8226	111	13	6240	282	0	6646
8227	62	11	255	6325	0	6653
8228	53	6234	85	284	0	6656
8229	44	236	52	6372	0	6704
8230	28	70	36	6732	0	6866
8231	6515	41	43	353	0	6952
8232	6486	25	31	154	0	6696
8233	6675	30	35	105	0	6845
8234	350	16	29	6461	0	6856
8235	141	23	17	6779	0	6960
8236	105	32	6110	347	0	6594
8237	78	17	221	6246	0	6562
8238	88	6288	84	324	0	6784
8239	6468	247	52	133	0	6900
8240	289	6414	41	126	0	6870
8241	6580	283	47	93	0	7003
8242	316	86	40	6187	0	6629
8243	110	6352	36	305	0	6803
8244	6524	272	44	122	0	6962
8245	6551	112	31	96	0	6790
8246	372	81	21	6423	0	6897
8247	155	6389	36	300	0	6880
8248	121	294	30	6591	0	7036
8249	118	109	6182	327	0	6736
8250	6363	72	228	151	0	6814
8251	300	6352	92	122	0	6866
8252	6543	276	71	90	0	6980
8253	334	99	46	6548	0	7027
8254	6615	75	44	338	0	7072
8255	347	71	7227	140	0	7785
8256	7441	45	302	116	0	7904
8257	7731	33	120	81	0	7965
8258	478	48	7186	97	0	7809
8259	221	49	303	7217	0	7790
8260	165	22	132	7698	0	8017
8261	7294	42	94	453	0	7883
8262	391	7150	88	207	0	7836
8263	171	765	70	7027	0	8033
8264	151	152	7138	378	0	7819
8265	122	107	7089	186	0	7504
8266	126	7051	369	165	0	7711
8267	108	341	7264	136	0	7849
8268	6315	111	288	106	0	6820
8269	303	73	132	6245	0	6753
8270	6536	52	102	299	0	6989
8271	331	70	6832	166	0	7399
8272	166	54	297	6270	0	6787
8273	108	65	137	6532	0	6842
8274	92	65	5556	382	0	6095
8275	110	44	285	5859	0	6298
8276	5660	68	129	353	0	6210
8277	5924	62	81	181	0	6248
8278	401	40	53	5794	0	6288
8279	5501	46	72	348	0	5967
8280	5610	44	64	185	0	5903
8281	428	5309	59	153	0	5949
8282	233	249	67	5488	0	6037
8283	5511	108	61	339	0	6019
8284	371	81	46	5580	0	6078
8285	5488	47	61	391	0	5987
8286	395	61	47	5469	0	5972
8287	221	81	5068	385	0	5755
8288	172	5369	287	209	0	6037
8289	148	290	129	4474	0	5041
8290	137	5425	99	320	0	5981
8291	5231	305	92	185	0	5813
8292	334	5338	113	149	0	5934
8293	228	5553	78	133	0	5992
8294	190	358	90	5499	0	6137
8295	5461	190	81	343	0	6075
8296	336	129	65	5614	0	6144
8297	5501	93	82	408	0	6084
8298	5465	101	65	226	0	5857
8299	404	5404	54	193	0	6055
8300	5511	316	72	152	0	6051
8301	5728	161	85	127	0	6101
8302	5799	102	88	136	0	6125
8303	483	86	5180	124	0	5873
8304	280	87	286	5384	0	6037
8305	241	80	134	5681	0	6136
8306	208	90	5146	412	0	5856
8307	5447	60	290	234	0	6031
8308	5669	64	140	186	0	6059
8309	5768	55	96	170	0	6089
8310	5281	40	100	159	0	5580
8311	467	5007	87	183	0	5744
8312	4864	242	72	144	0	5322
8313	443	94	66	4840	0	5443
8314	256	110	4054	332	0	4752
8315	4115	58	189	161	0	4523
8316	381	4074	91	123	0	4669
8317	4032	234	63	120	0	4449
8318	385	4056	47	101	0	4589
8319	184	3694	59	113	0	4050
8320	172	3677	57	118	0	4024
8321	134	3889	59	147	0	4229
8322	141	160	2330	66	0	2697
8323	105	79	129	2571	0	2884
8324	79	64	2109	162	0	2414
8325	1551	27	91	86	0	1755
8326	107	1521	53	84	0	1765
8327	53	1616	56	75	0	1800
8328	67	102	28	1564	0	1761
8329	73	81	22	1645	0	1821
8330	73	58	1501	119	0	1751
8331	57	71	1532	82	0	1742
8332	77	40	97	1617	0	1831
8333	81	47	1500	101	0	1729
8334	71	1572	87	75	0	1805
8335	91	85	37	1590	0	1803
8336	82	65	42	1625	0	1814
8337	86	45	1479	127	0	1737
8338	95	36	67	1645	0	1843
8339	1617	25	50	116	0	1808
8340	109	34	67	1585	0	1795
8341	67	37	41	1681	0	1826
8342	55	32	1467	150	0	1704
8343	1565	40	88	96	0	1789
8344	119	1531	40	77	0	1767
8345	119	81	24	1589	0	1813
8346	107	59	1463	95	0	1724
8347	91	47	73	1629	0	1840
8348	1641	47	29	101	0	1818
8349	139	45	1484	78	0	1746
8350	114	39	58	1616	0	1827
8351	86	30	1482	122	0	1720
8352	78	1565	91	70	0	1804
8353	81	97	2205	66	0	2449
8354	90	2286	87	58	0	2521
8355	37	17	1370	9	0	1433
8356	26	3	30	1359	0	1418
8357	15	1371	16	39	0	1441
8358	1456	15	16	32	0	1519
8359	18	5	25	1460	0	1508
8360	1481	12	14	20	0	1527
8361	49	9	10	1429	0	1497
8362	36	13	5	1470	0	1524
8363	2744	9	11	17	0	2781
8364	2688	24	5	12	0	2729
8365	40	16	9	2699	0	2764
8366	25	12	2663	37	0	2737
8367	14	2508	32	23	0	2577
8368	26	23	2608	17	0	2674
8369	20	2588	21	15	0	2644
8370	2725	32	13	6	0	2776
8371	0	0	2039	0	0	2039
8372	0	1	1984	1	0	1986
8373	1	4	1	1902	0	1908
8374	2068	0	0	1	0	2069
8375	2	5	2052	1	0	2060
8376	0	2508	7	3	0	2518
8377	2924	0	0	0	0	2924
8378	2850	1	0	0	0	2851
8379	2855	0	0	0	0	2855
8380	2876	0	1	0	0	2877
8381	2791	0	0	1	0	2792
8382	0	0	2864	0	0	2864
8383	0	3	0	2722	0	2725
8384	0	2691	3	2	0	2696
8385	2940	0	1	0	0	2941
8386	1	2748	6	0	0	2755
8387	2897	0	0	0	0	2897
8388	2869	0	0	0	0	2869
8389	0	2737	5	2	0	2744
8390	2916	0	0	0	0	2916
8391	0	1	1	2829	0	2831
8392	0	1	1	2853	0	2855
8393	1	1	2830	0	0	2832
8394	0	2628	8	1	0	2637
8395	1	0	0	2874	0	2875
8396	0	0	2	2837	0	2839
8397	0	0	1	2841	0	2842
8398	1	0	2778	0	0	2779
8399	2528	0	2	2	0	2532
8400	0	0	1	2864	0	2865
8401	2897	2	0	0	0	2899
8402	1	1	0	2830	0	2832
8403	0	1	2823	1	0	2825
8404	2	6	2593	0	0	2601
8405	2422	2	2	0	0	2426
8406	2778	0	0	0	0	2778
8407	1	2546	16	1	0	2564
8408	0	2	2696	2	0	2700
8409	0	2	0	2609	0	2611
8410	1	6	2	2401	0	2410
8411	2794	1	0	0	0	2795
8412	2710	1	0	1	0	2712
8413	2722	1	0	2	0	2725
8414	2	1	2671	0	0	2674
8415	2583	0	0	0	0	2583
8416	0	0	1	2719	0	2720
8417	0	1	0	2697	0	2698
8418	0	0	1	2746	0	2747
8419	0	2589	4	2	0	2595
8420	2754	0	0	1	0	2755
8421	1	0	0	2716	0	2717
8422	1	2	2702	1	0	2706
8423	0	0	1	2653	0	2654
8424	2	2527	6	2	0	2537
8425	2755	0	0	2	0	2757
8426	0	0	0	2666	0	2666
8427	0	0	0	2664	0	2664
8428	0	0	2678	2	0	2680
8429	0	2	1	2608	0	2611
8430	1	2525	5	1	0	2532
8431	2	1	0	2732	0	2735
8432	1	4	2633	0	0	2638
8433	2183	1	3	6	0	2193
8434	2551	1	1	1	0	2554
8435	0	2499	5	5	0	2509
8436	2675	0	0	1	0	2676
8437	2638	0	0	0	0	2638
8438	1	2525	6	2	0	2534
8439	0	1	1	2619	0	2621
8440	2668	0	0	3	0	2671
8441	0	2479	6	4	0	2489
8442	1	4	2553	0	0	2558
8443	2457	2	2	4	0	2465
8444	2538	1	1	1	0	2541
8445	2556	1	1	0	0	2558
8446	2609	1	1	3	0	2614
8447	0	2427	16	0	0	2443
8448	2657	0	0	1	0	2658
8449	2587	1	1	0	0	2589
8450	2602	0	1	0	0	2603
8451	2	0	0	2450	0	2452
8452	2654	0	0	2	0	2656
8453	0	1751	8	1	0	1760
8454	0	1	1821	1	0	1823
8455	0	3	1	1751	0	1755
8456	1827	0	1	3	0	1831
8457	0	0	1820	0	0	1820
8458	1	0	1	1746	0	1748
8459	0	2	1830	0	0	1832
8460	0	1658	12	1	0	1671
8461	1	0	0	1844	0	1845
8462	0	3	1811	0	0	1814
8463	0	694	3	1	0	698
8464	0	0	0	776	0	776
8465	783	0	0	0	0	783
8466	735	0	0	1	0	736
8467	764	0	0	1	0	765
8468	766	1	0	0	0	767
8469	758	0	0	0	0	758
8470	1	0	735	0	0	736
8471	744	0	0	0	0	744
8472	767	0	0	0	0	767
8473	0	0	0	750	0	750
8474	769	0	0	0	0	769
8475	729	0	1	1	0	731
8476	0	650	0	0	0	650
8477	0	89	1	660	0	750
8478	0	11	0	776	0	787
8479	655	3	0	107	0	765
8480	84	628	2	15	0	729
8481	10	724	0	7	0	741
8482	5	99	0	676	0	780
8483	4	13	0	758	0	775
8484	3	9	0	777	0	789
8485	1	3	1	793	0	798
8486	682	1	0	118	0	801
8487	777	1	0	22	0	800
8488	107	6	1364	10	0	1487
8489	15	3	86	1341	0	1445
8490	10	0	11	1529	0	1550
8491	7	2	1413	106	0	1528
8492	1358	4	89	15	0	1466
8493	88	1414	14	15	0	1531
8494	1481	93	3	11	0	1588
8495	95	11	6	1447	0	1559
8496	18	4	1696	96	0	1814
8497	6	8	86	1710	0	1810
8498	6	4	1681	102	0	1793
8499	3	1679	93	20	0	1795
8500	1708	98	18	8	0	1832
8501	1793	14	5	8	0	1820
8502	102	1672	6	9	0	1789
8503	18	96	3	1747	0	1864
8504	1763	14	1	96	0	1874
8505	95	1682	1	15	0	1793
8506	15	99	1	1760	0	1875
8507	1756	15	1	113	0	1885
8508	109	5	1633	18	0	1765
8509	1647	12	81	8	0	1748
8510	94	1702	15	11	0	1822
8511	1782	97	6	12	0	1897
8512	1828	14	8	14	0	1864
8513	109	9	1731	15	0	1864
8514	27	7	88	1674	0	1796
8515	17	7	16	1848	0	1888
8516	19	8	1696	108	0	1831
8517	4	6	91	1667	0	1768
8518	7	2	16	1807	0	1832
8519	1770	4	3	128	0	1905
8520	1843	4	12	29	0	1888
8521	121	1	3	1747	0	1872
8522	25	10	2838	111	0	2984
8523	19	8	95	2783	0	2905
8524	13	5	16	3049	0	3083
8525	7	5	2917	130	0	3059
8526	7	9	100	2937	0	3053
8527	2941	5	21	110	0	3077
8528	3035	12	8	29	0	3084
8529	118	2806	10	16	0	2950
8530	2987	97	7	23	0	3114
8531	2996	19	9	15	0	3039
8532	115	3653	16	22	0	3806
8533	3946	106	11	13	0	4076
8534	3949	30	8	9	0	3996
8535	3991	8	3	15	0	4017
8536	132	14	3748	7	0	3901
8537	3749	13	96	9	0	3867
8538	115	3	11	3900	0	4029
8539	3946	15	10	110	0	4081
8540	120	17	4715	29	0	4881
8541	35	4651	150	23	0	4859
8542	4899	149	49	14	0	5111
8543	160	5370	31	20	0	5581
8544	55	230	22	5424	0	5731
8545	20	70	15	5765	0	5870
8546	5594	30	8	280	0	5912
8547	5765	15	7	82	0	5869
8548	277	25	5973	40	0	6315
8549	83	23	5841	40	0	5987
8550	43	16	6125	38	0	6222
8551	33	14	293	5923	0	6263
8552	30	15	6034	258	0	6337
8553	25	16	6065	84	0	6190
8554	30	12	284	6039	0	6365
8555	6224	4	79	249	0	6556
8556	6294	13	51	75	0	6433
8557	6297	2	52	32	0	6383
8558	6224	17	32	46	0	6319
8559	296	7	35	6054	0	6392
8560	103	11	33	6315	0	6462
8561	59	26	5944	291	0	6320
8562	58	12	206	5940	0	6216
8563	60	9	59	6224	0	6352
8564	6203	11	25	306	0	6545
8565	6266	12	30	96	0	6404
8566	307	14	28	6175	0	6524
8567	6239	14	20	263	0	6536
8568	6309	18	31	92	0	6450
8569	301	9	25	6334	0	6669
8570	104	11	30	6582	0	6727
8571	67	17	6088	335	0	6507
8572	58	31	6386	120	0	6595
8573	53	7	272	6586	0	6918
8574	56	8	88	7000	0	7152
8575	65	19	6685	320	0	7089
8576	5852	3	181	82	0	6118
8577	6074	16	76	63	0	6229
8578	219	21	5902	48	0	6190
8579	80	5633	160	56	0	5929
8580	6146	143	65	44	0	6398
8581	182	57	5929	54	0	6222
8582	94	23	161	5797	0	6075
8583	79	11	68	6115	0	6273
8584	6166	14	47	216	0	6443
8585	6268	5	44	94	0	6411
8586	216	10	69	6004	0	6299
8587	85	8	45	7030	0	7168
8588	6228	11	51	234	0	6524
8589	6302	7	59	100	0	6468
8590	6245	9	38	89	0	6381
8591	248	12	6018	69	0	6347
8592	131	6	154	6047	0	6338
8593	101	2	57	6298	0	6458
8594	6226	5	37	228	0	6496
8595	207	5912	46	111	0	6276
8596	5841	147	42	83	0	6113
8597	190	5677	54	72	0	5993
8598	84	162	45	6256	0	6547
8599	57	48	50	6441	0	6596
8600	56	36	6080	272	0	6444
8601	77	14	174	6175	0	6440
8602	77	34	6084	249	0	6444
8603	81	13	184	6201	0	6479
8604	75	24	75	6300	0	6474
8605	70	5635	86	259	0	6050
8606	65	6013	50	151	0	6279
8607	59	202	57	6177	0	6495
8608	50	88	60	6345	0	6543
8609	46	44	59	6366	0	6515
8610	54	32	37	6725	0	6848
8611	55	28	51	6879	0	7013
8612	75	30	6428	358	0	6891
8613	73	30	204	6432	0	6739
8614	82	18	102	6774	0	6976
8615	68	43	6299	328	0	6738
8616	71	6038	221	190	0	6520
8617	55	190	117	6531	0	6893
8618	51	79	6280	281	0	6691
8619	45	5948	234	184	0	6411
8620	56	195	107	6505	0	6863
8621	6434	76	66	279	0	6855
8622	233	51	50	5440	0	5774
8623	121	38	41	5500	0	5700
8624	102	39	26	5663	0	5830
8625	80	29	36	5572	0	5717
8626	92	5021	57	350	0	5520
8627	53	194	48	5599	0	5894
8628	5403	65	33	349	0	5850
8629	221	47	50	5505	0	5823
8630	111	30	39	5523	0	5703
8631	71	49	23	5719	0	5862
8632	4550	18	32	389	0	4989
8633	4606	50	24	204	0	4884
8634	285	37	23	4680	0	5025
8635	4581	30	30	320	0	4961
8636	4537	28	63	183	0	4811
8637	281	4353	41	167	0	4842
8638	4374	192	49	142	0	4757
8639	248	4364	55	151	0	4818
8640	50	3395	20	71	0	3536
8641	54	151	21	3477	0	3703
8642	39	72	3296	176	0	3583
8643	17	29	54	2643	0	2743
8644	7	15	37	2722	0	2781
8645	10	2630	27	94	0	2761
8646	2726	59	12	74	0	2871
8647	63	24	14	2749	0	2850
8648	34	35	2065	80	0	2214
8649	35	10	48	2109	0	2202
8650	19	2062	25	96	0	2202
8651	2149	60	20	53	0	2282
8652	60	31	7	2175	0	2273
8653	38	29	2043	92	0	2202
8654	25	14	55	2121	0	2215
8655	15	2529	25	110	0	2679
8656	12	62	29	2680	0	2783
8657	3119	32	13	116	0	3280
8658	3163	22	17	64	0	3266
8659	3167	11	12	67	0	3257
8660	146	3014	13	48	0	3221
8661	3580	87	8	40	0	3715
8662	142	60	6	3509	0	3717
8663	3524	35	12	125	0	3696
8664	135	3405	9	100	0	3649
8665	65	105	10	3561	0	3741
8666	42	71	3337	127	0	3577
8667	3212	49	86	93	0	3440
8668	113	3383	59	69	0	3624
8669	46	82	27	3242	0	3397
8670	33	52	7	3307	0	3399
8671	18	29	15	3297	0	3359
8672	20	21	8	2724	0	2773
8673	12	2689	10	158	0	2869
8674	2794	77	8	99	0	2978
8675	2828	57	7	59	0	2951
8676	130	33	2693	45	0	2901
8677	86	24	80	2759	0	2949
8678	60	18	2685	94	0	2857
8679	2720	19	92	68	0	2899
8680	2815	20	52	49	0	2936
8681	2852	13	32	46	0	2943
8682	157	15	15	2688	0	2875
8683	86	2648	16	105	0	2855
8684	3212	84	8	69	0	3373
8685	123	62	5	3225	0	3415
8686	3283	30	5	125	0	3443
8687	145	27	2408	76	0	2656
8688	73	21	2461	62	0	2617
8689	2558	17	132	28	0	2735
8690	122	15	78	2529	0	2744
8691	2540	13	31	111	0	2695
8692	147	2486	21	72	0	2726
8693	2557	99	24	57	0	2737
8694	2647	58	11	42	0	2758
8695	170	49	2433	27	0	2679
8696	130	33	2428	25	0	2616
8697	71	2474	142	36	0	2723
8698	40	74	72	2129	0	2315
8699	2144	53	33	91	0	2321
8700	91	31	20	2155	0	2297
8701	71	18	9	2270	0	2368
8702	54	20	2063	139	0	2276
8703	2135	15	70	86	0	2306
8704	107	16	56	2193	0	2372
8705	77	15	2110	101	0	2303
8706	50	15	2140	69	0	2274
8707	34	16	127	2167	0	2344
8708	43	19	2119	92	0	2273
8709	36	26	2157	76	0	2295
8710	37	7	93	1805	0	1942
8711	33	17	1745	74	0	1869
8712	27	21	79	1711	0	1838
8713	31	1727	41	85	0	1884
8714	1749	62	30	66	0	1907
8715	76	1777	24	46	0	1923
8716	51	91	19	1686	0	1847
8717	41	2439	20	80	0	2580
8718	33	93	2355	55	0	2536
8719	37	45	71	2498	0	2651
8720	26	44	3569	92	0	3731
8721	3666	18	163	75	0	3922
8722	160	4208	88	53	0	4509
8723	4212	175	71	34	0	4492
8724	237	87	30	4151	0	4505
8725	4325	80	29	183	0	4617
8726	263	38	3944	93	0	4338
8727	130	4179	170	72	0	4551
8728	4268	178	105	36	0	4587
8729	212	100	70	3629	0	4011
8730	122	4218	50	149	0	4539
8731	118	184	39	4269	0	4610
8732	3855	115	43	226	0	4239
8733	196	4269	43	102	0	4610
8734	4359	196	24	107	0	4686
8735	259	128	4058	49	0	4494
8736	4274	93	189	55	0	4611
8737	269	44	101	4228	0	4642
8738	4070	36	83	192	0	4381
8739	246	4182	56	112	0	4596
8740	145	195	48	4255	0	4643
8741	123	96	37	4452	0	4708
8742	79	103	4029	281	0	4492
8743	84	42	173	4350	0	4649
8744	74	58	98	4457	0	4687
8745	62	53	92	4386	0	4593
8746	57	39	40	4543	0	4679
8747	58	37	4003	352	0	4450
8748	56	4116	204	207	0	4583
8749	56	203	102	4322	0	4683
8750	4211	99	80	273	0	4663
8751	4257	88	53	166	0	4564
8752	264	4219	58	146	0	4687
8753	4338	200	61	97	0	4696
8754	4364	120	57	85	0	4626
8755	3881	101	39	95	0	4116
8756	371	3803	44	102	0	4320
8757	3377	189	28	60	0	3654
8758	241	457	33	2986	0	3717
8759	144	97	3060	185	0	3486
8760	128	3283	150	97	0	3658
8761	86	157	65	3016	0	3324
8762	70	94	2811	179	0	3154
8763	2928	96	138	90	0	3252
8764	185	43	76	2958	0	3262
8765	122	58	84	3032	0	3296
8766	111	70	44	3011	0	3236
8767	73	40	46	3214	0	3373
8768	85	55	2779	276	0	3195
8769	2854	56	152	156	0	3218
8770	199	2875	69	152	0	3295
8771	2855	166	82	113	0	3216
8772	242	2971	46	89	0	3348
8773	2638	215	386	106	0	3345
8774	230	97	68	2962	0	3357
8775	119	111	2811	197	0	3238
8776	122	62	2889	153	0	3226
8777	88	64	208	2959	0	3319
8778	74	71	132	3021	0	3298
8779	95	57	83	3176	0	3411
8780	2977	52	66	310	0	3405
8781	216	56	2767	182	0	3221
8782	124	2781	166	166	0	3237
8783	132	3057	94	111	0	3394
8784	2504	197	75	111	0	2887
8785	197	132	2425	121	0	2875
8786	130	2511	161	93	0	2895
8787	115	183	2453	89	0	2840
8788	82	111	184	2589	0	2966
8789	86	97	2478	200	0	2861
8790	109	76	2556	132	0	2873
8791	88	72	200	2639	0	2999
8792	89	59	2488	214	0	2850
8793	79	65	2556	139	0	2839
8794	73	53	225	2649	0	3000
8795	2548	60	154	216	0	2978
8796	193	70	2419	145	0	2827
8797	114	61	168	2580	0	2923
8798	102	57	127	2682	0	2968
8799	2541	57	107	256	0	2961
8800	184	46	68	2709	0	3007
8801	2495	49	78	254	0	2876
8802	225	3101	87	143	0	3556
8803	110	161	71	3288	0	3630
8804	3201	70	66	240	0	3577
8805	3305	90	67	162	0	3624
8806	231	44	64	3520	0	3859
8807	173	59	3256	222	0	3710
8808	3193	63	167	139	0	3562
8809	184	3327	76	167	0	3754
8810	3401	166	83	120	0	3770
8811	3524	75	72	95	0	3766
8812	3542	90	55	139	0	3826
8813	270	59	3240	106	0	3675
8814	170	3360	164	95	0	3789
8815	128	156	89	3345	0	3718
8816	111	92	115	3551	0	3869
8817	91	93	2553	188	0	2925
8818	76	2555	146	163	0	2940
8819	72	2733	107	125	0	3037
8820	22	1331	12	17	0	1382
8821	1362	48	12	28	0	1450
8822	3	1	0	893	0	897
8823	0	0	0	896	0	896
8824	0	0	899	3	0	902
8825	810	1	3	0	0	814
8826	3	1	0	907	0	911
8827	0	1	0	893	0	894
8828	2	1	891	3	0	897
8829	0	865	2	2	0	869
8830	0	2	0	910	0	912
8831	0	0	901	3	0	904
8832	0	855	3	0	0	858
8833	885	2	0	1	0	888
8834	2	1	881	1	0	885
8835	0	0	2	883	0	885
8836	0	850	1	3	0	854
8837	907	2	0	1	0	910
8838	2	0	1	882	0	885
8839	905	1	0	2	0	908
8840	890	0	0	0	0	890
8841	2	853	6	0	0	861
8842	904	2	0	1	0	907
8843	896	1	0	1	0	898
8844	2	0	878	0	0	880
8845	838	0	1	1	0	840
8846	1	0	859	0	0	860
8847	869	0	1	0	0	870
8848	883	1	0	0	0	884
8849	5	5	1247	0	0	1257
8850	1	2	2	1229	0	1234
8851	1	1	1264	0	0	1266
8852	2	1	1191	0	0	1194
8853	1	1	1210	0	0	1212
8854	0	0	1	1202	0	1203
8855	1	0	0	1267	0	1268
8856	0	0	1	1277	0	1278
8857	1	1	0	1258	0	1260
8858	1	0	1276	0	0	1277
8859	0	0	2	1212	0	1214
8860	0	1203	1	2	0	1206
8861	1	7	1449	1	0	1458
8862	1	1	9	1398	0	1409
8863	0	3	1470	10	0	1483
8864	0	1364	14	7	0	1385
8865	0	1418	7	2	0	1427
8866	0	17	1	1484	0	1502
8867	0	11	1450	8	0	1469
8868	2	2	1413	7	0	1424
8869	1	2	15	1430	0	1448
8870	1	1	10	1431	0	1443
8871	1	1	1	1474	0	1477
8872	0	3	1444	13	0	1460
8873	0	1366	14	10	0	1390
8874	1	2568	17	3	0	2589
8875	1	16	3	3513	0	3533
8876	2	10	3474	8	0	3494
8877	2	9	4136	8	0	4155
8878	1	4050	23	5	0	4079
8879	4380	9	10	3	0	4402
8880	9	3958	17	1	0	3985
8881	7	13	4200	4	0	4224
8882	4113	10	11	2	0	4136
8883	10	1	6	4363	0	4380
8884	4794	0	5	10	0	4809
8885	11	4	4	4752	0	4771
8886	8	0	2	4755	0	4765
8887	4819	2	4	19	0	4844
8888	9	4555	8	19	0	4591
8889	9	13	4586	11	0	4619
8890	1	4543	13	8	0	4565
8891	4786	11	5	4	0	4806
8892	9	4799	3	4	0	4815
8893	5004	18	5	2	0	5029
8894	4991	7	3	5	0	5006
8895	21	5050	8	6	0	5085
8896	12	15	2	5316	0	5345
8897	5338	11	2	20	0	5371
8898	5273	4	4	10	0	5291
8899	26	3	0	5209	0	5238
8900	13	4	5170	21	0	5208
8901	10	11	4945	8	0	4974
8902	0	3	23	4544	0	4570
8903	3	9	4605	21	0	4638
8904	4254	3	21	7	0	4285
8905	18	3873	23	422	0	4336
8906	10	19	4	4447	0	4480
8907	7	11	0	4483	0	4501
8908	3	3	0	4432	0	4438
8909	4	2	1	4297	0	4304
8910	5	0	0	4425	0	4430
8911	4	3	4371	30	0	4408
8912	3	4079	25	14	0	4121
8913	4462	18	6	5	0	4491
8914	20	8	2	4396	0	4426
8915	11	4	2	4439	0	4456
8916	5	2	3	4480	0	4490
8917	2	4287	5	25	0	4319
8918	6	17	2	4892	0	4917
8919	3	6	1	4891	0	4901
8920	4865	5	3	60	0	4933
8921	52	4603	10	16	0	4681
8922	10	4702	2	8	0	4722
8923	4	58	1	4874	0	4937
8924	4841	9	2	55	0	4907
8925	55	8	4715	14	0	4792
8926	4244	5	47	13	0	4309
8927	52	7	4653	14	0	4726
8928	13	6	51	4645	0	4715
8929	9	8	8	4719	0	4744
8930	8	4	2	4760	0	4774
8931	3	5	6	4750	0	4764
8932	5	2	2	4732	0	4741
8933	4693	2	3	71	0	4769
8934	54	13	4621	18	0	4706
8935	8	3	47	4658	0	4716
8936	6	7	4648	64	0	4725
8937	7	4402	54	18	0	4481
8938	4598	48	11	13	0	4670
8939	54	15	4636	13	0	4718
8940	13	5	49	4541	0	4608
8941	6	4	11	4566	0	4587
8942	7	3	4640	66	0	4716
8943	8	7	4579	19	0	4613
8944	2	6	58	4351	0	4417
8945	4614	3	15	56	0	4688
8946	4622	3	9	16	0	4650
8947	57	4434	11	14	0	4516
8948	4685	51	3	14	0	4753
8949	59	13	7	4206	0	4285
8950	13	4835	8	57	0	4913
8951	9	52	7	5154	0	5222
8952	16	14	5027	55	0	5112
8953	4	10	50	4832	0	4896
8954	6	10	10	5078	0	5104
8955	5156	2	9	64	0	5231
8956	53	4883	9	23	0	4968
8957	5093	55	1	16	0	5165
8958	57	4891	12	18	0	4978
8959	4795	56	7	12	0	4870
8960	62	4885	12	15	0	4974
8961	7	4779	5	6	0	4797
8962	4898	48	2	5	0	4953
8963	47	10	2	4707	0	4766
8964	8	4681	3	39	0	4731
8965	5653	51	3	4	0	5711
8966	5404	5	1	7	0	5417
8967	5596	6	5	4	0	5611
8968	5599	7	7	8	0	5621
8969	49	5325	5	9	0	5388
8970	12	43	6	5581	0	5642
8971	7	7	4	5639	0	5657
8972	5688	6	2	48	0	5744
8973	51	11	2	5451	0	5515
8974	4519	4	4	48	0	4575
8975	53	8	3652	7	0	3720
8976	3418	5	39	9	0	3471
8977	47	6	2931	16	0	3000
8978	12	5	42	2890	0	2949
8979	3013	6	8	49	0	3076
8980	51	2809	9	14	0	2883
8981	3011	42	4	15	0	3072
8982	48	2770	15	14	0	2847
8983	11	45	6	2979	0	3041
8984	10	10	2554	48	0	2622
8985	2358	3	39	13	0	2413
8986	45	2485	6	12	0	2548
8987	10	45	5	2613	0	2673
8988	12	10	6	2637	0	2665
8989	6	12	1	2620	0	2639
8990	11	8	2538	55	0	2612
8991	10	2456	44	20	0	2530
8992	2361	38	8	9	0	2416
8993	2386	5	6	10	0	2407
8994	36	2289	14	6	0	2345
8995	2125	37	3	10	0	2175
8996	42	5	4	2095	0	2146
8997	9	2007	7	42	0	2065
8998	2103	39	2	11	0	2155
8999	45	6	2008	12	0	2071
9000	11	1884	37	7	0	1939
9001	4	42	4	2076	0	2126
9002	12	3	5	2127	0	2147
9003	6	7	2043	41	0	2097
9004	10	9	30	1953	0	2002
9005	8	6	2206	41	0	2261
9006	10	3	37	2189	0	2239
9007	10	6	6	2267	0	2289
9008	5	8	5	2273	0	2291
9009	6	5	8	2255	0	2274
9010	1	8	2157	41	0	2207
9011	9	11	2893	20	0	2933
9012	5	3501	82	12	0	3600
9013	7	124	14	3721	0	3866
9014	13	29	3601	137	0	3780
9015	7	3518	137	31	0	3693
9016	5	140	18	3771	0	3934
9017	9	23	3679	138	0	3849
9018	3078	12	97	16	0	3203
9019	3558	2	17	11	0	3588
9020	117	3	8	3487	0	3615
9021	32	6	3411	108	0	3557
9022	13	5	103	3465	0	3586
9023	3458	4	19	121	0	3602
9024	92	3626	23	24	0	3765
9025	3857	136	5	14	0	4012
9026	3943	30	3	10	0	3986
9027	164	19	5	3770	0	3958
9028	45	9	5	4661	0	4720
9029	25	2	7	4717	0	4751
9030	15	5	3	4702	0	4725
9031	10	5	2	4771	0	4788
9032	4562	7	3	201	0	4773
9033	4679	3	6	55	0	4743
9034	4725	4	10	30	0	4769
9035	198	16	4277	21	0	4512
9036	4471	10	145	21	0	4647
9037	176	19	34	4565	0	4794
9038	51	36	4294	173	0	4554
9039	28	4281	162	70	0	4541
9040	31	158	45	4501	0	4735
9041	27	36	29	4524	0	4616
9042	28	4338	34	200	0	4600
9043	34	144	21	4867	0	5066
9044	53	36	4559	202	0	4850
9045	36	22	4695	82	0	4835
9046	30	11	180	4800	0	5021
9047	4778	13	58	185	0	5034
9048	4841	13	23	69	0	4946
9049	219	32	4531	49	0	4831
9050	86	3659	165	36	0	3946
9051	66	4031	43	42	0	4182
9052	3948	179	29	59	0	4215
9053	159	58	3848	67	0	4132
9054	53	38	147	3994	0	4232
9055	3992	16	42	219	0	4269
9056	183	3733	37	97	0	4050
9057	69	3995	38	59	0	4161
9058	4028	180	15	48	0	4271
9059	203	55	27	4002	0	4287
9060	4012	27	34	179	0	4252
9061	203	28	35	5800	0	6066
9062	87	18	25	6102	0	6232
9063	54	30	5556	262	0	5902
9064	34	36	183	5871	0	6124
9065	36	37	45	5408	0	5526
9066	5137	26	58	292	0	5513
9067	202	34	34	5303	0	5573
9068	66	41	4809	299	0	5215
9069	5118	20	186	125	0	5449
9070	226	20	67	5477	0	5790
9071	5347	15	74	295	0	5731
9072	285	4917	43	121	0	5366
9073	113	5459	35	114	0	5721
9074	5373	242	34	80	0	5729
9075	5476	102	49	57	0	5684
9076	290	88	34	5440	0	5852
9077	151	65	5073	274	0	5563
9078	109	41	230	5524	0	5904
9079	5237	49	75	326	0	5687
9080	267	5259	82	147	0	5755
9081	117	238	48	5402	0	5805
9082	5477	98	37	332	0	5944
9083	300	84	5158	176	0	5718
9084	5413	44	225	161	0	5843
9085	5578	44	81	160	0	5863
9086	337	39	5333	141	0	5850
9087	187	31	5321	145	0	5684
9088	151	32	288	5092	0	5563
9089	139	29	142	4973	0	5283
9090	123	5288	112	320	0	5843
9091	118	224	65	5530	0	5937
9092	128	100	5204	363	0	5795
9093	95	118	242	5443	0	5898
9094	120	72	108	5695	0	5995
9095	137	48	5134	379	0	5698
9096	130	5183	255	227	0	5795
9097	128	225	93	5428	0	5874
9098	98	96	112	5671	0	5977
9099	5453	99	78	366	0	5996
9100	326	72	70	5550	0	6018
9101	161	76	5118	399	0	5754
9102	5362	56	233	212	0	5863
9103	5600	61	112	198	0	5971
9104	5647	52	114	173	0	5986
9105	420	61	4980	139	0	5600
9106	219	46	261	5184	0	5710
9107	158	36	160	5446	0	5800
9108	131	40	158	5584	0	5913
9109	5082	38	102	442	0	5664
9110	310	5143	105	250	0	5808
9111	164	227	4088	196	0	4675
9112	111	3572	153	190	0	4026
9113	91	3605	136	143	0	3975
9114	104	3689	115	141	0	4049
9115	103	187	79	3772	0	4141
9116	116	113	3455	215	0	3899
9117	3507	109	167	149	0	3932
9118	152	3642	106	200	0	4100
9119	3351	142	98	158	0	3749
9120	198	3491	66	159	0	3914
9121	3456	167	74	173	0	3870
9122	222	3454	86	119	0	3881
9123	147	194	3339	114	0	3794
9124	167	78	98	3161	0	3504
9125	130	82	80	3903	0	4195
9126	3861	53	107	230	0	4251
9127	192	54	73	4002	0	4321
9128	72	38	3001	289	0	3400
9129	132	43	134	3250	0	3559
9130	129	66	2934	245	0	3374
9131	83	3032	195	142	0	3452
9132	97	166	110	2688	0	3061
9133	106	3104	91	174	0	3475
9134	3098	200	76	123	0	3497
9135	195	95	94	3186	0	3570
9136	105	80	3041	228	0	3454
9137	103	61	3082	128	0	3374
9138	3098	80	168	159	0	3505
9139	194	79	90	3178	0	3541
9140	114	98	3058	201	0	3471
9141	115	118	2940	101	0	3274
9142	97	3076	188	135	0	3496
9143	75	184	147	2441	0	2847
9144	84	2828	121	202	0	3235
9145	51	187	89	2967	0	3294
9146	2843	78	103	247	0	3271
9147	180	96	89	2931	0	3296
9148	89	64	71	3113	0	3337
9149	2909	58	78	248	0	3293
9150	177	69	97	2972	0	3315
9151	100	75	81	2779	0	3035
9152	110	2827	63	223	0	3223
9153	2848	167	78	159	0	3252
9154	2929	103	54	146	0	3232
9155	197	96	59	2948	0	3300
9156	105	49	96	3049	0	3299
9157	110	69	84	2927	0	3190
9158	92	2488	76	304	0	2960
9159	113	2826	75	193	0	3207
9160	87	173	91	3044	0	3395
9161	915	29	13	104	0	1061
9162	946	20	12	45	0	1023
9163	89	927	13	34	0	1063
9164	880	80	9	38	0	1007
9165	81	896	11	31	0	1019
9166	33	958	10	21	0	1022
9167	27	95	7	950	0	1079
9168	886	31	14	94	0	1025
9169	83	882	23	37	0	1025
9170	15	696	7	22	0	740
9171	14	58	5	683	0	760
9172	6	12	9	758	0	785
9173	5	18	669	61	0	753
9174	659	15	44	30	0	748
9175	721	11	10	23	0	765
9176	56	9	693	16	0	774
9177	17	5	709	24	0	755
9178	17	11	51	695	0	774
9179	12	4	19	727	0	762
9180	12	693	13	67	0	785
9181	17	53	9	725	0	804
9182	10	11	676	86	0	783
9183	19	16	57	717	0	809
9184	9	14	17	778	0	818
9185	710	13	26	69	0	818
9186	62	9	694	45	0	810
9187	707	15	62	38	0	822
9188	63	17	702	41	0	823
9189	21	14	68	736	0	839
9190	22	20	693	75	0	810
9191	17	21	718	31	0	787
9192	14	15	63	749	0	841
9193	683	19	45	72	0	819
9194	704	23	27	34	0	788
9195	68	703	16	52	0	839
9196	717	65	25	35	0	842
9197	728	18	24	36	0	806
9198	56	706	30	40	0	832
9199	29	67	36	717	0	849
9200	29	24	25	768	0	846
9201	29	45	10	758	0	842
9202	30	21	11	796	0	858
9203	23	17	677	98	0	815
9204	706	17	64	56	0	843
9205	58	20	30	727	0	835
9206	35	14	20	717	0	786
9207	30	709	11	86	0	836
9208	24	57	22	751	0	854
9209	37	16	653	86	0	792
9210	726	23	50	49	0	848
9211	74	24	650	47	0	795
9212	27	35	46	739	0	847
9213	678	21	11	104	0	814
9214	55	692	19	50	0	816
9215	30	79	4	732	0	845
9216	43	19	670	88	0	820
9217	35	24	49	746	0	854
9218	707	18	16	97	0	838
9219	72	21	694	42	0	829
9220	16	28	705	51	0	800
9221	35	718	52	26	0	831
9222	674	81	30	20	0	805
9223	71	707	20	39	0	837
9224	43	69	722	39	0	873
9225	0	0	8	0	0	8
9226	0	9	0	0	0	9
9227	8	0	0	0	0	8
9228	0	6	0	0	0	6
9229	0	0	0	7	0	7
9230	0	0	0	8	0	8
9231	0	0	8	0	0	8
9232	0	0	0	8	0	8
9233	0	0	8	0	0	8
9234	8	0	0	0	0	8
9235	7	0	0	0	0	7
9236	8	0	0	0	0	8
9237	0	0	7	0	0	7
9238	8	0	0	0	0	8
9239	0	0	0	6	0	6
9240	0	8	0	0	0	8
9241	8	0	0	0	0	8
9242	0	0	9	0	0	9
9243	9	0	0	0	0	9
9244	9	0	0	0	0	9
9245	0	0	9	0	0	9
9246	0	9	0	0	0	9
9247	0	0	0	9	0	9
9248	0	0	9	0	0	9
9249	0	0	8	0	0	8
9250	0	0	0	9	0	9
9251	0	0	9	0	0	9
9252	0	0	0	9	0	9
9253	0	0	0	8	0	8
9254	0	0	0	9	0	9
9255	0	0	9	0	0	9
9256	0	0	0	9	0	9
9257	0	0	8	0	0	8
9258	0	0	0	9	0	9
9259	9	0	0	0	0	9
9260	0	0	0	7	0	7
9261	0	9	0	0	0	9
9262	0	0	0	9	0	9
9263	9	0	0	0	0	9
9264	0	7	0	0	0	7
9265	0	0	0	9	0	9
9266	9	0	0	0	0	9
9267	0	1	9	0	0	10
9268	0	0	0	10	0	10
9269	1	0	9	0	0	10
9270	0	0	9	0	0	9
9271	0	0	0	10	0	10
9272	9	0	1	0	0	10
9273	0	0	9	0	0	9
9274	8	0	0	1	0	9
9275	1	0	0	9	0	10
9276	0	0	9	0	0	9
9277	0	0	9	0	0	9
9278	0	0	10	1	0	11
9279	0	0	0	9	0	9
9280	9	0	1	0	0	10
9281	0	8	1	0	0	9
9282	1	0	0	8	0	9
9283	1	0	0	9	0	10
9284	9	1	0	0	0	10
9285	8	0	0	0	0	8
9286	0	9	0	1	0	10
9287	10	0	0	0	0	10
9288	9	0	0	0	0	9
9289	0	1	0	9	0	10
9290	1	0	9	0	0	10
9291	10	0	0	0	0	10
9292	0	0	0	9	0	9
9293	0	0	1	9	0	10
9294	9	0	0	0	0	9
9295	0	0	0	10	0	10
9296	0	0	0	10	0	10
9297	9	0	0	0	0	9
9298	0	8	1	0	0	9
9299	8	0	0	1	0	9
9300	1	0	8	0	0	9
9301	8	1	0	0	0	9
9302	1	0	0	9	0	10
9303	0	9	1	0	0	10
9304	1	0	0	9	0	10
9305	0	0	0	9	0	9
9306	0	1	0	7	0	8
9307	8	0	0	1	0	9
9308	0	8	0	1	0	9
9309	0	8	0	1	0	9
9310	9	0	0	0	0	9
9311	0	2	810	0	0	812
9312	0	3	812	1	0	816
9313	849	0	2	0	0	851
9314	1	0	876	0	0	877
9315	0	0	2	870	0	872
9316	1	0	0	877	0	878
9317	0	1	1	887	0	889
9318	0	0	0	889	0	889
9319	0	808	6	1	0	815
9320	0	0	0	912	0	912
9321	1	0	878	1	0	880
9322	0	1	1	867	0	869
9323	1	1	888	1	0	891
9324	0	0	854	0	0	854
9325	0	0	0	2668	0	2668
9326	0	0	2701	0	0	2701
9327	0	0	1	2581	0	2582
9328	2683	0	0	1	0	2684
9329	0	1	2655	0	0	2656
9330	2329	0	3	2	0	2334
9331	1	0	0	2645	0	2646
9332	2	2	2662	0	0	2666
9333	1	2572	3	1	0	2577
9334	0	0	0	3413	0	3413
9335	3	2	3344	0	0	3349
9336	0	1	0	3192	0	3193
9337	3458	0	1	2	0	3461
9338	4397	1	1	0	0	4399
9339	4375	0	0	2	0	4377
9340	1	2	0	4359	0	4362
9341	1	0	0	4354	0	4355
9342	1	0	0	4454	0	4455
9343	4488	0	1	2	0	4491
9344	1	4271	5	2	0	4279
9345	0	1	0	4449	0	4450
9346	1	0	0	4420	0	4421
9347	4429	1	0	1	0	4431
9348	1	4209	4	8	0	4222
9349	0	1	0	4470	0	4471
9350	4453	0	0	2	0	4455
9351	4381	1	0	0	0	4382
9352	1	2	0	4384	0	4387
9353	4476	0	0	2	0	4478
9354	2	0	0	4434	0	4436
9355	1	2	4363	2	0	4368
9356	1	1	2	4228	0	4232
9357	1	1	0	4400	0	4402
9358	0	1	1	4409	0	4411
9359	4478	0	0	2	0	4480
9360	1	4239	3	3	0	4246
9361	4359	1	0	2	0	4362
9362	2	4169	1	1	0	4173
9363	0	4148	5	0	0	4153
9364	4462	1	0	0	0	4463
9365	1	4188	3	1	0	4193
9366	0	1	0	4402	0	4403
9367	4453	0	0	1	0	4454
9368	4250	0	0	1	0	4251
9369	1	3	1	4287	0	4292
9370	0	0	0	4331	0	4331
9371	0	4206	0	1	0	4207
9372	4324	1	1	0	0	4326
9373	4295	0	0	0	0	4295
9374	2	4147	3	0	0	4152
9375	0	4226	6	1	0	4233
9376	0	1	0	4406	0	4407
9377	4418	0	0	1	0	4419
9378	1	0	0	4193	0	4194
9379	0	0	0	4276	0	4276
9380	1	6	4123	1	0	4131
9381	1	9	3820	0	0	3830
9382	0	1	1	4013	0	4015
9383	3	4	4123	1	0	4131
9384	0	3871	14	2	0	3887
9385	0	1	0	4167	0	4168
9386	0	1	1	4129	0	4131
9387	0	0	0	4089	0	4089
9388	1	3	4063	2	0	4069
9389	3	4	3639	1	0	3647
9390	3615	0	3	3	0	3621
9391	1	3764	6	2	0	3773
9392	4141	1	0	0	0	4142
9393	1	6	0	4025	0	4032
9394	4123	0	5	2	0	4130
9395	1	2	0	4038	0	4041
9396	0	3887	4	3	0	3894
9397	4029	1	0	1	0	4031
9398	5	3	3913	0	0	3921
9399	1	3692	8	1	0	3702
9400	4037	2	0	0	0	4039
9401	1	1	1	4011	0	4014
9402	0	3654	9	1	0	3664
9403	0	1	0	4052	0	4053
9404	4023	1	1	2	0	4027
9405	2	1	1	3938	0	3942
9406	3983	0	1	5	0	3989
9407	4	4	3803	0	0	3811
9408	0	2	1	3718	0	3721
9409	3915	0	0	3	0	3918
9410	2	7	3666	0	0	3675
9411	3	2718	14	1	0	2736
9412	1	3	0	2991	0	2995
9413	0	5	2827	1	0	2833
9414	1	12	3419	1	0	3433
9415	0	4	6	3508	0	3518
9416	1	4	3524	5	0	3534
9417	5	5	3381	4	0	3395
9418	0	0	10	3338	0	3348
9419	3640	0	7	5	0	3652
9420	6	0	2	3534	0	3542
9421	3	1	2	3599	0	3605
9422	1	8	3527	7	0	3543
9423	1	4	5	3347	0	3357
9424	3446	0	3	11	0	3460
9425	5	9	2090	4	0	2108
9426	2	2014	11	5	0	2032
9427	1	6	4	2216	0	2227
9428	2184	3	2	7	0	2196
9429	7	2	5	2130	0	2144
9430	2	2087	9	8	0	2106
9431	3	13	2024	5	0	2045
9432	2	2	11	2130	0	2145
9433	2198	1	5	10	0	2214
9434	7	2	1502	6	0	1517
9435	4	2	6	1540	0	1552
9436	1571	0	5	11	0	1587
9437	2032	1	4	9	0	2046
9438	51	1337	5	7	0	1400
9439	1314	51	6	5	0	1376
9440	54	4	7	1364	0	1429
9441	9	12	1195	55	0	1271
9442	5	1273	49	16	0	1343
9443	12	1361	10	10	0	1393
9444	7	58	5	2039	0	2109
9445	8	7	4	2248	0	2267
9446	7	21	1835	158	0	2021
9447	4	2022	110	22	0	2158
9448	12	2176	13	19	0	2220
9449	8	148	13	2137	0	2306
9450	2010	11	13	163	0	2197
9451	135	2046	17	25	0	2223
9452	16	149	18	2149	0	2332
9453	2841	25	7	164	0	3037
9454	155	22	4	2926	0	3107
9455	14	18	6	3064	0	3102
9456	18	9	9	3108	0	3144
9457	17	14	23	3109	0	3163
9458	2926	23	16	187	0	3152
9459	157	14	16	2983	0	3170
9460	15	12	2848	192	0	3067
9461	2910	17	141	50	0	3118
9462	164	28	2793	51	0	3036
9463	31	19	2895	45	0	2990
9464	25	16	142	2838	0	3021
9465	30	19	25	2934	0	3008
9466	18	19	41	3076	0	3154
9467	2982	23	16	199	0	3220
9468	172	14	2848	54	0	3088
9469	2854	14	157	64	0	3089
9470	3067	21	15	81	0	3184
9471	182	25	2775	61	0	3043
9472	2852	23	142	56	0	3073
9473	179	46	2936	51	0	3212
9474	47	3012	149	48	0	3256
9475	37	145	38	3186	0	3406
9476	48	26	28	3324	0	3426
9477	37	26	38	3298	0	3399
9478	45	25	27	3358	0	3455
9479	38	17	3088	218	0	3361
9480	52	14	3182	78	0	3326
9481	32	15	171	3239	0	3457
9482	31	28	3135	218	0	3412
9483	3149	14	165	70	0	3398
9484	3357	19	45	76	0	3497
9485	188	21	48	3261	0	3518
9486	3199	27	58	199	0	3483
9487	196	3090	46	70	0	3402
9488	3249	157	49	62	0	3517
9489	186	30	3068	81	0	3365
9490	46	28	159	3089	0	3322
9491	36	3061	44	211	0	3352
9492	3240	163	34	92	0	3529
9493	190	31	56	3253	0	3530
9494	60	50	3089	205	0	3404
9495	65	39	158	3232	0	3494
9496	3252	24	36	223	0	3535
9497	208	26	3062	73	0	3369
9498	52	25	183	3194	0	3454
9499	46	30	47	3368	0	3491
9500	37	36	3024	247	0	3344
9501	49	2926	149	132	0	3256
9502	67	3064	48	100	0	3279
9503	55	162	45	3231	0	3493
9504	63	28	51	3291	0	3433
9505	66	38	59	3355	0	3518
9506	3195	39	59	221	0	3514
9507	3238	38	51	75	0	3402
9508	199	29	51	3229	0	3508
9509	3166	31	35	251	0	3483
9510	199	3015	35	121	0	3370
9511	63	170	35	3225	0	3493
9512	62	51	36	3350	0	3499
9513	77	44	32	3376	0	3529
9514	2388	21	24	209	0	2642
9515	165	2272	29	73	0	2539
9516	31	156	26	2437	0	2650
9517	2398	28	24	192	0	2642
9518	182	20	25	2382	0	2609
9519	34	13	35	2475	0	2557
9520	42	2141	38	195	0	2416
9521	34	2374	13	78	0	2499
9522	29	138	21	2448	0	2636
9523	36	12	20	2587	0	2655
9524	2376	11	18	238	0	2643
9525	179	12	35	2396	0	2622
9526	44	29	2243	183	0	2499
9527	43	25	157	2302	0	2527
9528	44	2245	32	188	0	2509
9529	2799	143	23	83	0	3048
9530	165	22	17	2794	0	2998
9531	40	19	14	2846	0	2919
9532	43	2693	22	190	0	2948
9533	2772	155	18	76	0	3021
9534	173	2678	20	72	0	2943
9535	56	165	18	4058	0	4297
9536	36	29	3825	230	0	4120
9537	25	9	101	3392	0	3527
9538	3282	13	16	161	0	3472
9539	128	3244	16	30	0	3418
9540	29	127	9	3199	0	3364
9541	17	3231	9	143	0	3400
9542	28	114	8	3482	0	3632
9543	23	14	3295	161	0	3493
9544	1	2	21	2523	0	2547
9545	0	3	10	2516	0	2529
9546	3	1	9	2657	0	2670
9547	2521	6	10	45	0	2582
9548	2478	10	13	23	0	2524
9549	31	2541	6	26	0	2604
9550	2706	47	2	26	0	2781
9551	44	2653	14	27	0	2738
9552	8	2767	11	30	0	2816
9553	2138	59	11	35	0	2243
9554	44	26	2487	45	0	2602
9555	15	5	50	2580	0	2650
9556	19	11	8	2661	0	2699
9557	20	12	5	2729	0	2766
9558	2491	15	6	76	0	2588
9559	69	2562	6	28	0	2665
9560	30	69	8	2486	0	2593
9561	22	2549	13	61	0	2645
9562	2640	70	10	23	0	2743
9563	62	35	10	2611	0	2718
9564	30	28	9	4906	0	4973
9565	23	4972	16	157	0	5168
9566	16	126	13	5386	0	5541
9567	17	55	8	5510	0	5590
9568	5152	35	4	223	0	5414
9569	136	4779	34	104	0	5053
9570	51	4976	28	85	0	5140
9571	56	162	9	5391	0	5618
9572	46	90	5025	197	0	5358
9573	41	66	4769	97	0	4973
9574	35	55	144	5080	0	5314
9575	24	62	4825	224	0	5135
9576	28	52	153	5019	0	5252
9577	24	60	63	4976	0	5123
9578	22	44	48	5322	0	5436
9579	5056	31	33	268	0	5388
9580	143	37	40	5194	0	5414
9581	56	37	39	5138	0	5270
9582	43	4744	44	265	0	5096
9583	44	157	38	5237	0	5476
9584	47	75	4801	251	0	5174
9585	24	60	159	5077	0	5320
9586	35	53	56	5310	0	5454
9587	5006	50	54	268	0	5378
9588	156	49	44	5156	0	5405
9589	58	31	35	5291	0	5415
9590	48	29	44	5377	0	5498
9591	4787	33	38	323	0	5181
9592	157	4823	33	205	0	5218
9593	75	162	33	5221	0	5491
9594	55	80	31	5343	0	5509
9595	45	87	4770	309	0	5211
9596	45	53	148	5105	0	5351
9597	4896	46	60	303	0	5305
9598	153	4899	40	219	0	5311
9599	74	164	53	5068	0	5359
9600	49	79	22	5926	0	6076
9601	57	58	5319	359	0	5793
9602	5172	45	164	241	0	5622
9603	185	5378	72	229	0	5864
9604	5630	193	62	181	0	6066
9605	190	128	35	5769	0	6122
9606	104	94	50	5797	0	6045
9607	70	100	48	5910	0	6128
9608	72	66	53	5978	0	6169
9609	5639	69	53	375	0	6136
9610	189	66	65	5756	0	6076
9611	78	5326	56	398	0	5858
9612	76	151	34	5852	0	6113
9613	117	77	62	5934	0	6190
9614	5604	79	22	374	0	6079
9615	235	5348	39	207	0	5829
9616	142	204	19	5811	0	6176
9617	5615	117	26	331	0	6089
9618	5690	87	25	247	0	6049
9619	233	72	53	5773	0	6131
9620	126	85	5261	339	0	5811
9621	5479	61	150	241	0	5931
9622	215	61	68	5783	0	6127
9623	115	48	5331	385	0	5879
9624	102	78	165	5721	0	6066
9625	107	59	51	5694	0	5911
9626	98	70	51	5591	0	5810
9627	102	5192	57	323	0	5674
9628	89	169	39	5749	0	6046
9629	78	91	52	5429	0	5650
9630	90	55	40	5457	0	5642
9631	84	56	39	5496	0	5675
9632	74	70	38	5476	0	5658
9633	85	77	32	5531	0	5725
9634	5115	52	25	480	0	5672
9635	134	19	3701	158	0	4012
9636	59	3626	118	135	0	3938
9637	3916	109	43	123	0	4191
9638	133	3741	39	101	0	4014
9639	3935	135	32	76	0	4178
9640	159	63	16	3919	0	4157
9641	4013	40	37	182	0	4272
9642	174	31	19	3941	0	4165
9643	85	32	13	4001	0	4131
9644	60	3781	22	213	0	4076
9645	3952	129	11	137	0	4229
9646	141	54	3731	126	0	4052
9647	80	31	109	3931	0	4151
9648	49	28	3779	202	0	4058
9649	54	36	3641	116	0	3847
9650	3506	23	125	99	0	3753
9651	113	29	58	3684	0	3884
9652	66	9	3499	164	0	3738
9653	51	25	3496	103	0	3675
9654	48	18	118	3173	0	3357
9655	39	29	61	3579	0	3708
9656	3504	23	50	174	0	3751
9657	129	22	35	3547	0	3733
9658	63	22	3367	173	0	3625
9659	55	10	109	3492	0	3666
9660	45	9	50	3498	0	3602
9661	33	3346	54	175	0	3608
9662	3341	97	25	132	0	3595
9663	126	3394	29	115	0	3664
9664	1368	13	8	26	0	1415
9665	1	888	1	0	0	890
9666	0	886	0	0	0	886
9667	0	1	0	940	0	941
9668	0	0	0	921	0	921
9669	0	0	0	923	0	923
9670	925	1	0	1	0	927
9671	0	0	926	0	0	926
9672	0	0	0	916	0	916
9673	898	0	0	0	0	898
9674	0	893	0	1	0	894
9675	0	899	1	1	0	901
9676	0	0	0	923	0	923
9677	0	1	0	916	0	917
9678	0	1	0	910	0	911
9679	0	895	0	0	0	895
9680	0	0	0	929	0	929
9681	0	0	905	0	0	905
9682	3	1	870	0	0	874
9683	872	0	1	0	0	873
9684	0	0	0	926	0	926
9685	925	0	0	1	0	926
9686	901	0	1	2	0	904
9687	0	873	4	0	0	877
9688	924	0	0	0	0	924
9689	893	0	0	0	0	893
9690	0	0	1	889	0	890
9691	0	2	0	866	0	868
9692	1	0	886	0	0	887
9693	0	829	5	0	0	834
9694	0	1	0	881	0	882
9695	0	0	0	901	0	901
9696	908	0	0	0	0	908
9697	0	0	0	882	0	882
9698	890	0	0	1	0	891
9699	1	0	0	893	0	894
9700	0	353	3	0	0	356
9701	385	0	0	0	0	385
9702	1	0	0	1316	0	1317
9703	0	3	0	1639	0	1642
9704	0	1	0	1735	0	1736
9705	0	5	1439	157	0	1601
9706	1	1	86	1642	0	1730
9707	1523	1	40	128	0	1692
9708	95	1	12	1631	0	1739
9709	38	0	8	2254	0	2300
9710	14	0	8	2221	0	2243
9711	9	1911	7	202	0	2129
9712	8	2147	7	92	0	2254
9713	2039	160	5	41	0	2245
9714	119	2161	1	31	0	2312
9715	2176	142	3	17	0	2338
9716	2226	79	5	15	0	2325
9717	2288	23	1	18	0	2330
9718	203	19	1928	20	0	2170
9719	82	2092	116	18	0	2308
9720	2104	132	46	16	0	2298
9721	146	69	16	2099	0	2330
9722	76	27	10	2232	0	2345
9723	32	23	10	2279	0	2344
9724	31	2011	6	199	0	2247
9725	21	114	6	2226	0	2367
9726	2077	60	6	163	0	2306
9727	132	29	3	2204	0	2368
9728	67	17	3	2300	0	2387
9729	22	29	1981	239	0	2271
9730	24	21	2028	142	0	2215
9731	20	9	176	2168	0	2373
9732	21	9	76	2223	0	2329
9733	26	2055	36	229	0	2346
9734	28	120	20	2230	0	2398
9735	31	74	14	2271	0	2390
9736	16	21	8	2387	0	2432
9737	2130	21	14	254	0	2419
9738	133	39	2000	139	0	2311
9739	84	38	119	2192	0	2433
9740	2143	34	61	178	0	2416
9741	2171	31	20	103	0	2325
9742	229	26	10	2075	0	2340
9743	126	16	13	2220	0	2375
9744	2057	25	17	232	0	2331
9745	177	1916	42	102	0	2237
9746	89	2783	34	63	0	2969
9747	59	195	15	2803	0	3072
9748	2784	78	8	198	0	3068
9749	2845	32	11	139	0	3027
9750	2891	28	7	101	0	3027
9751	216	36	2695	96	0	3043
9752	2755	34	122	90	0	3001
9753	193	24	2637	88	0	2942
9754	2659	25	141	91	0	2916
9755	174	2376	84	99	0	2733
9756	115	137	2425	64	0	2741
9757	69	73	168	2475	0	2785
9758	44	31	2448	220	0	2743
9759	52	36	140	2562	0	2790
9760	2483	54	76	214	0	2827
9761	165	61	2810	143	0	3179
9762	97	28	156	2881	0	3162
9763	63	2831	79	209	0	3182
9764	82	135	46	3075	0	3338
9765	87	80	48	3094	0	3309
9766	67	32	36	3196	0	3331
9767	3036	21	35	271	0	3363
9768	3109	44	23	155	0	3331
9769	253	12	27	3455	0	3747
9770	106	41	3210	240	0	3597
9771	74	52	3980	152	0	4258
9772	69	50	193	4053	0	4365
9773	54	63	4042	215	0	4374
9774	55	36	158	4194	0	4443
9775	89	26	86	4206	0	4407
9776	95	21	36	4224	0	4376
9777	81	3778	58	272	0	4189
9778	71	4014	79	117	0	4281
9779	61	166	63	4207	0	4497
9780	62	92	46	4273	0	4473
9781	56	43	49	4350	0	4498
9782	4143	48	39	263	0	4493
9783	163	42	3934	187	0	4326
9784	103	24	152	4193	0	4472
9785	4101	27	100	242	0	4470
9786	184	3910	51	162	0	4307
9787	114	136	55	4161	0	4466
9788	54	78	66	4287	0	4485
9789	61	48	35	4327	0	4471
9790	66	38	27	4331	0	4462
9791	34	35	3946	343	0	4358
9792	3892	19	127	220	0	4258
9793	4199	28	75	123	0	4425
9794	248	38	4839	103	0	5228
9795	4905	44	134	105	0	5188
9796	5090	18	86	105	0	5299
9797	243	29	4904	98	0	5274
9798	130	5128	191	93	0	5542
9799	82	121	104	5491	0	5798
9800	99	67	5987	192	0	6345
9801	80	5784	179	159	0	6202
9802	25	52	4958	33	0	5068
9803	16	4593	41	30	0	4680
9804	14	34	15	4857	0	4920
9805	23	21	4789	39	0	4872
9806	21	4	36	4566	0	4627
9807	25	11	4811	42	0	4889
9808	21	4469	49	38	0	4577
9809	4278	0	0	0	0	4278
9810	1	3972	11	0	0	3984
9811	0	4325	17	3	0	4345
9812	1	36	1	4894	0	4932
9813	0	3	0	4896	0	4899
9814	0	4	0	4851	0	4855
9815	2	2	1	4808	0	4813
9816	0	1	2	4928	0	4931
9817	1	5	5384	30	0	5420
9818	2	2	30	5131	0	5165
9819	0	1	1	5462	0	5464
9820	5543	2	0	34	0	5579
9821	5470	0	0	5	0	5475
9822	5515	1	0	2	0	5518
9823	32	2	0	5399	0	5433
9824	6430	0	0	36	0	6466
9825	6668	0	3	5	0	6676
9826	6658	1	1	4	0	6664
9827	81	10	6373	2	0	6466
9828	6251	3	64	5	0	6323
9829	6521	2	5	4	0	6532
9830	6724	2	6	2	0	6734
9831	82	3	3	6417	0	6505
9832	19	8	6576	74	0	6677
9833	13	2	70	6506	0	6591
9834	6703	0	3	82	0	6788
9835	78	2	4	6518	0	6602
9836	12	6267	18	61	0	6358
9837	10	64	5	6702	0	6781
9838	7661	5	8	79	0	7753
9839	7656	7	6	25	0	7694
9840	7539	3	1	16	0	7559
9841	90	7	7385	11	0	7493
9842	23	7	64	7107	0	7201
9843	17	5	4	7500	0	7526
9844	18	7	7414	81	0	7520
9845	17	6620	85	19	0	6741
9846	21	69	6718	15	0	6823
9847	15	5	71	6649	0	6740
9848	7241	4	9	78	0	7332
9849	97	7	7015	12	0	7131
9850	16	3	82	6929	0	7030
9851	18	6	7084	94	0	7202
9852	7027	3	86	19	0	7135
9853	87	1	12	7504	0	7604
9854	22	15	8164	95	0	8296
9855	14	8	81	8534	0	8637
9856	15	18	8683	138	0	8854
9857	15	8157	142	36	0	8350
9858	29	110	13	8954	0	9106
9859	8881	13	15	128	0	9037
9860	129	10	19	8788	0	8946
9861	29	6	6	8483	0	8524
9862	8467	1	11	149	0	8628
9863	125	7975	24	49	0	8173
9864	19	8227	26	54	0	8326
9865	17	123	18	8456	0	8614
9866	14	8097	20	132	0	8263
9867	21	119	7	8425	0	8572
9868	25	20	8	8487	0	8540
9869	8042	15	8	155	0	8220
9870	131	7440	23	47	0	7641
9871	38	127	6784	42	0	6991
9872	34	6843	115	27	0	7019
9873	7363	125	17	20	0	7525
9874	7443	22	16	35	0	7516
9875	141	14	24	7223	0	7402
9876	7400	16	12	148	0	7576
9877	144	12	13	7282	0	7451
9878	7392	17	17	143	0	7569
9879	7429	20	11	46	0	7506
9880	146	15	11	7223	0	7395
9881	8138	7	16	154	0	8315
9882	162	25	7753	37	0	7977
9883	7693	8	115	52	0	7868
9884	145	11	22	7887	0	8065
9885	8099	17	19	142	0	8277
9886	152	7560	25	57	0	7794
9887	53	119	11	7938	0	8121
9888	44	23	22	8021	0	8110
9889	7960	18	16	157	0	8151
9890	145	19	7627	65	0	7856
9891	52	7181	151	44	0	7428
9892	50	138	21	7848	0	8057
9893	35	7486	38	142	0	7701
9894	34	128	19	7103	0	7284
9895	40	34	13	7071	0	7158
9896	40	21	7	7186	0	7254
9897	7106	31	14	165	0	7316
9898	144	28	13	6683	0	6868
9899	6729	29	13	170	0	6941
9900	6180	18	13	59	0	6270
9901	166	25	11	6056	0	6258
9902	6131	12	18	171	0	6332
9903	6010	12	19	64	0	6105
9904	168	26	5837	59	0	6090
9905	54	31	119	5753	0	5957
9906	6069	23	27	147	0	6266
9907	158	6034	42	55	0	6289
9908	6580	116	19	48	0	6763
9909	6604	23	17	56	0	6700
9910	183	28	6135	47	0	6393
9911	59	12	90	6238	0	6399
9912	6506	7	23	154	0	6690
9913	153	12	18	6604	0	6787
9914	61	9	15	6613	0	6698
9915	41	17	12	6702	0	6772
9916	42	15	15	7955	0	8027
9917	8019	6	15	241	0	8281
9918	234	30	8552	103	0	8919
9919	94	18	225	8767	0	9104
9920	56	33	8572	268	0	8929
9921	30	33	8326	131	0	8520
9922	8316	20	282	87	0	8705
9923	262	33	8631	66	0	8992
9924	99	7754	230	46	0	8129
9925	7946	199	83	36	0	8264
9926	7973	89	34	45	0	8141
9927	286	39	15	7696	0	8036
9928	128	33	7726	217	0	8104
9929	55	32	7553	115	0	7755
9930	7611	13	269	76	0	7969
9931	232	16	110	7827	0	8185
9932	7864	15	48	234	0	8161
9933	239	7645	44	125	0	8053
9934	7940	202	28	65	0	8235
9935	7919	82	30	37	0	8068
9936	290	7693	44	45	0	8072
9937	138	209	36	7854	0	8237
9938	7111	74	39	234	0	7458
9939	240	57	6716	117	0	7130
9940	132	6720	222	83	0	7157
9941	95	207	102	7015	0	7419
9942	6921	94	59	235	0	7309
9943	243	7168	34	117	0	7562
9944	7449	203	31	63	0	7746
9945	279	94	7141	53	0	7567
9946	7254	46	229	54	0	7583
9947	297	26	7171	54	0	7548
9948	7279	21	230	54	0	7584
9949	7428	29	111	75	0	7643
9950	323	35	6967	71	0	7396
9951	171	6987	230	81	0	7469
9952	112	205	113	6855	0	7285
9953	75	107	6743	234	0	7159
9954	86	6206	242	120	0	6654
9955	60	172	102	5595	0	5929
9956	65	84	70	5828	0	6047
9957	63	51	5528	259	0	5901
9958	95	24	190	5521	0	5830
9959	69	31	131	5845	0	6076
9960	81	42	5520	258	0	5901
9961	77	35	206	5379	0	5697
9962	82	5557	163	219	0	6021
9963	5680	176	138	115	0	6109
9964	239	100	94	5518	0	5951
9965	154	5609	118	194	0	6075
9966	120	210	77	5192	0	5599
9967	120	5601	63	214	0	5998
9968	141	214	5264	114	0	5733
9969	93	5596	230	95	0	6014
9970	5661	209	161	74	0	6105
9971	5730	108	128	72	0	6038
9972	5838	79	97	81	0	6095
9973	332	58	5909	99	0	6398
9974	208	79	5877	86	0	6250
9975	147	5912	314	75	0	6448
9976	132	249	161	5541	0	6083
9977	137	6059	94	238	0	6528
9978	127	288	72	5190	0	5677
9979	121	6032	84	226	0	6463
9980	6267	272	96	118	0	6753
9981	5743	144	102	76	0	6065
9982	371	99	81	6998	0	7549
9983	220	99	6671	293	0	7283
9984	6871	90	253	176	0	7390
9985	337	6947	151	115	0	7550
9986	216	287	139	6938	0	7580
9987	166	174	109	6719	0	7168
9988	125	7708	125	382	0	8340
9989	7882	342	124	176	0	8524
9990	433	193	7569	115	0	8310
9991	253	143	346	7800	0	8542
9992	7775	90	205	394	0	8464
9993	7858	122	154	198	0	8332
9994	473	7672	100	165	0	8410
9995	273	362	113	7430	0	8178
9996	162	7696	130	368	0	8356
9997	8225	384	96	256	0	8961
9998	470	213	7978	157	0	8818
9999	265	156	8084	136	0	8641
10000	165	132	458	8177	0	8932
10001	131	116	205	8087	0	8539
10002	150	8207	149	484	0	8990
10003	153	421	113	8412	0	9099
10004	125	214	8039	459	0	8837
10005	8187	161	392	253	0	8993
10006	409	116	182	8468	0	9175
10007	207	162	7555	474	0	8398
10008	136	149	396	7975	0	8656
10009	89	130	229	7649	0	8097
10010	124	7816	194	505	0	8639
10011	130	360	96	7268	0	7854
10012	129	180	84	7444	0	7837
10013	124	113	111	7419	0	7767
10014	6878	98	97	527	0	7600
10015	386	6792	129	262	0	7569
10016	134	5888	89	139	0	6250
10017	5006	291	54	129	0	5480
10018	4032	75	43	116	0	4266
10019	238	4027	38	91	0	4394
10020	115	4300	26	76	0	4517
10021	4121	289	20	63	0	4493
10022	223	4100	32	57	0	4412
10023	104	3994	17	38	0	4153
10024	3834	227	19	41	0	4121
10025	199	4608	31	32	0	4870
10026	4649	244	17	48	0	4958
10027	4691	100	33	45	0	4869
10028	4606	94	30	41	0	4771
10029	252	4416	34	49	0	4751
10030	118	4627	26	61	0	4832
10031	91	258	17	4479	0	4845
10032	105	4815	18	201	0	5139
10033	109	210	16	4918	0	5253
10034	4880	122	39	211	0	5252
10035	227	104	23	4841	0	5195
10036	108	4796	37	234	0	5175
10037	4822	221	32	128	0	5203
10038	239	4734	19	111	0	5103
10039	118	4915	22	117	0	5172
10040	106	272	17	4741	0	5136
10041	74	4848	23	234	0	5179
10042	4898	271	35	105	0	5309
10043	259	132	4389	77	0	4857
10044	111	4528	194	86	0	4919
10045	91	252	67	4692	0	5102
10046	85	133	4458	262	0	4938
10047	102	121	168	4648	0	5039
10048	102	103	82	4454	0	4741
10049	85	108	78	4505	0	4776
10050	78	117	57	4557	0	4809
10051	87	91	4192	308	0	4678
10052	73	4256	223	189	0	4741
10053	4371	214	107	172	0	4864
10054	219	101	4198	189	0	4707
10055	4315	99	190	179	0	4783
10056	248	97	4263	163	0	4771
10057	104	98	224	4405	0	4831
10058	125	104	4206	270	0	4705
10059	115	96	4318	156	0	4685
10060	111	88	259	4312	0	4770
10061	121	82	142	4415	0	4760
10062	88	90	119	4527	0	4824
10063	74	92	91	4597	0	4854
10064	4365	89	105	334	0	4893
10065	230	93	4174	192	0	4689
10066	4309	85	188	196	0	4778
10067	5020	97	96	193	0	5406
10068	5049	82	80	176	0	5387
10069	5020	94	49	167	0	5330
10070	5068	76	69	134	0	5347
10071	351	86	66	4878	0	5381
10072	229	75	4632	271	0	5207
10073	173	84	4203	136	0	4596
10074	158	4301	170	119	0	4748
10075	4462	183	74	112	0	4831
10076	217	134	55	5070	0	5476
10077	127	101	56	5114	0	5398
10078	121	4870	79	233	0	5303
10079	106	4924	67	118	0	5215
10080	128	4960	34	83	0	5205
10081	4938	216	28	100	0	5282
10082	143	821	13	2743	0	3720
10083	20	2638	11	60	0	2729
10084	28	61	7	2725	0	2821
10085	25	29	2688	50	0	2792
10086	34	27	2613	11	0	2685
10087	47	11	41	2645	0	2744
10088	2991	13	6	46	0	3056
10089	3000	19	6	11	0	3036
10090	2965	17	2	13	0	2997
10091	70	19	2874	17	0	2980
10092	17	22	49	2840	0	2928
10093	15	21	15	2993	0	3044
10094	25	15	2890	59	0	2989
10095	2667	21	39	28	0	2755
10096	69	16	2920	30	0	3035
10097	9	6	2534	5	0	2554
10098	2	0	2367	3	0	2372
10099	1	1	2	2240	0	2244
10100	0	0	3	2372	0	2375
10101	3	2	2403	1	0	2409
10102	0	0	4	2319	0	2323
10103	2408	0	3	4	0	2415
10104	1	0	3	2412	0	2416
10105	0	2	2396	3	0	2401
10106	1	2	2336	2	0	2341
10107	0	0	3	2373	0	2376
10108	2422	0	1	5	0	2428
10109	4	2858	10	1	0	2873
10110	2979	39	0	3	0	3021
10111	2975	17	6	2	0	3000
10112	59	13	2907	1	0	2980
10113	29	6	42	2867	0	2944
10114	2978	1	20	46	0	3045
10115	2902	2	16	20	0	2940
10116	55	2827	13	14	0	2909
10117	32	41	3	2917	0	2993
10118	14	18	4	3017	0	3053
10119	6	14	2906	58	0	2984
10120	5	7	41	2799	0	2852
10121	5	2	2938	64	0	3009
10122	1	13	3359	26	0	3399
10123	4	1	64	3351	0	3420
10124	3457	2	25	54	0	3538
10125	38	2617	20	21	0	2696
10126	2789	42	7	19	0	2857
10127	2796	16	6	10	0	2828
10128	63	2683	7	8	0	2761
10129	33	50	4	2734	0	2821
10130	2810	23	3	42	0	2878
10131	58	2723	9	18	0	2808
10132	2575	52	5	15	0	2647
10133	57	2451	13	13	0	2534
10134	32	53	6	2514	0	2605
10135	25	28	6	2595	0	2654
10136	2557	16	7	66	0	2646
10137	2496	15	1	39	0	2551
10138	65	2404	8	33	0	2510
10139	34	52	2488	22	0	2596
10140	23	32	2428	14	0	2497
10141	14	15	64	2371	0	2464
10142	8	2383	44	51	0	2486
10143	16	44	30	2546	0	2636
10144	11	22	14	2544	0	2591
10145	13	13	12	2572	0	2610
10146	10	17	2694	78	0	2799
10147	20	16	3150	49	0	3235
10148	18	3130	76	26	0	3250
10149	17	52	35	3327	0	3431
10150	19	30	23	3414	0	3486
10151	25	24	3289	69	0	3407
10152	2639	26	58	49	0	2772
10153	67	7	31	3343	0	3448
10154	34	19	3242	62	0	3357
10155	3007	17	57	36	0	3117
10156	67	3061	36	41	0	3205
10157	47	58	3211	19	0	3335
10158	27	26	52	3228	0	3333
10159	3312	24	29	64	0	3429
10160	58	19	3667	30	0	3774
10161	32	8	79	3697	0	3816
10162	21	10	48	3684	0	3763
10163	16	14	32	3870	0	3932
10164	3949	13	18	125	0	4105
10165	89	3813	18	77	0	3997
10166	42	75	15	4019	0	4151
10167	34	48	3384	96	0	3562
10168	20	29	80	3455	0	3584
10169	19	3298	45	93	0	3455
10170	18	3467	40	63	0	3588
10171	3450	113	17	44	0	3624
10172	3508	70	14	35	0	3627
10173	130	33	3378	28	0	3569
10174	3433	26	77	29	0	3565
10175	109	3350	73	22	0	3554
10176	2919	77	34	27	0	3057
10177	111	50	22	2885	0	3068
10178	68	37	3040	88	0	3233
10179	46	26	72	3103	0	3247
10180	37	24	3026	104	0	3191
10181	3043	14	109	66	0	3232
10182	81	8	58	3024	0	3171
10183	50	3540	44	103	0	3737
10184	33	127	25	3723	0	3908
10185	31	82	3546	167	0	3826
10186	22	3586	123	97	0	3828
10187	3589	138	65	61	0	3853
10188	115	3318	56	33	0	3522
10189	66	3464	23	36	0	3589
10190	36	191	17	3256	0	3500
10191	23	3790	18	126	0	3957
10192	17	159	11	3895	0	4082
10193	32	89	3699	156	0	3976
10194	3595	57	121	82	0	3855
10195	3884	15	71	44	0	4014
10196	191	26	3711	29	0	3957
10197	3732	24	128	24	0	3908
10198	170	3689	70	32	0	3961
10199	3892	139	38	27	0	4096
10200	167	64	29	3793	0	4053
10201	81	52	4167	144	0	4444
10202	49	4175	119	85	0	4428
10203	28	138	76	4300	0	4542
10204	18	72	33	4502	0	4625
10205	4333	45	21	202	0	4601
10206	4303	28	25	112	0	4468
10207	191	4139	36	53	0	4419
10208	96	4257	31	38	0	4422
10209	28	3770	14	9	0	3821
10210	20	125	2	3760	0	3907
10211	3769	55	5	86	0	3915
10212	3785	26	5	46	0	3862
10213	120	18	7	3720	0	3865
10214	62	12	11	3827	0	3912
10215	3771	9	9	138	0	3927
10216	94	7	8	4003	0	4112
10217	64	18	3858	105	0	4045
10218	3851	9	77	58	0	3995
10219	3950	15	42	27	0	4034
10220	132	30	4205	22	0	4389
10221	4366	8	75	23	0	4472
10222	107	12	39	3968	0	4126
10223	68	15	15	4014	0	4112
10224	29	20	6	4112	0	4167
10225	4371	14	13	146	0	4544
10226	112	4226	18	86	0	4442
10227	63	110	11	4371	0	4555
10228	33	4279	19	118	0	4449
10229	4368	118	10	61	0	4557
10230	125	55	9	4371	0	4560
10231	62	33	13	4444	0	4552
10232	32	4189	27	169	0	4417
10233	33	109	4169	71	0	4382
10234	28	58	100	4373	0	4559
10235	4395	23	45	126	0	4589
10236	4394	20	22	72	0	4508
10237	152	33	4197	39	0	4421
10238	68	20	99	4706	0	4893
10239	35	4661	66	133	0	4895
10240	29	128	20	4941	0	5118
10241	4857	59	9	159	0	5084
10242	4941	41	14	79	0	5075
10243	172	33	12	4819	0	5036
10244	79	4676	21	147	0	4923
10245	5100	138	7	76	0	5321
10246	158	64	6	5474	0	5702
10247	4894	49	8	199	0	5150
10248	4989	27	11	83	0	5110
10249	244	27	11	4909	0	5191
10250	106	22	11	5032	0	5171
10251	74	13	16	5052	0	5155
10252	51	4733	16	270	0	5070
10253	55	177	10	4961	0	5203
10254	36	68	11	5127	0	5242
10255	32	59	4659	264	0	5014
10256	29	48	4694	121	0	4892
10257	36	28	201	4887	0	5152
10258	4752	15	72	235	0	5074
10259	185	4709	56	101	0	5051
10260	4424	163	19	71	0	4677
10261	189	54	4284	61	0	4588
10262	68	54	4258	45	0	4425
10263	60	4198	170	39	0	4467
10264	24	167	45	4165	0	4401
10265	19	53	4084	172	0	4328
10266	21	44	4349	57	0	4471
10267	16	22	173	4357	0	4568
10268	4380	6	60	186	0	4632
10269	4469	11	35	62	0	4577
10270	193	15	30	4363	0	4601
10271	64	19	4517	191	0	4791
10272	51	16	141	4647	0	4855
10273	36	22	43	4582	0	4683
10274	27	4539	43	189	0	4798
10275	4637	158	25	77	0	4897
10276	4686	39	24	60	0	4809
10277	175	4504	33	44	0	4756
10278	72	167	14	4206	0	4459
10279	57	4330	15	169	0	4571
10280	4454	178	12	64	0	4708
10281	185	61	4215	52	0	4513
10282	58	48	4265	53	0	4424
10283	35	37	3701	21	0	3794
10284	22	17	110	3668	0	3817
10285	16	18	42	3869	0	3945
10286	3821	10	37	124	0	3992
10287	108	8	26	3733	0	3875
10288	20	17	19	3859	0	3915
10289	39	22	4162	129	0	4352
10290	34	25	4040	61	0	4160
10291	3756	12	102	53	0	3923
10292	114	3714	54	36	0	3918
10293	3937	105	32	32	0	4106
10294	129	26	25	3892	0	4072
10295	42	31	22	3882	0	3977
10296	44	3822	19	127	0	4012
10297	30	111	15	3957	0	4113
10298	3913	26	15	150	0	4104
10299	118	25	17	3947	0	4107
10300	36	35	3750	159	0	3980
10301	47	3300	93	64	0	3504
10302	3449	106	27	56	0	3638
10303	3522	25	30	59	0	3636
10304	3525	31	29	46	0	3631
10305	3561	18	21	50	0	3650
10306	150	23	15	3456	0	3644
10307	79	22	16	3567	0	3684
10308	62	26	3940	153	0	4181
10309	47	14	105	4080	0	4246
10310	41	29	3973	152	0	4195
10311	26	20	108	4107	0	4261
10312	4048	14	40	162	0	4264
10313	121	4123	46	73	0	4363
10314	48	98	37	4228	0	4411
10315	39	33	33	4365	0	4470
10316	4056	24	33	167	0	4280
10317	4105	28	23	74	0	4230
10318	141	23	3921	71	0	4156
10319	62	3883	114	56	0	4115
10320	49	106	42	3575	0	3772
10321	33	30	40	3717	0	3820
10322	3620	42	44	138	0	3844
10323	3379	27	335	71	0	3812
10324	153	21	3578	63	0	3815
10325	55	23	3140	38	0	3256
10326	55	18	94	3114	0	3281
10327	42	10	45	3255	0	3352
10328	31	20	3123	112	0	3286
10329	2909	17	268	54	0	3248
10330	100	14	33	3201	0	3348
10331	3145	13	43	108	0	3309
10332	105	3058	38	57	0	3258
10333	3145	91	33	56	0	3325
10334	117	30	3304	48	0	3499
10335	48	3347	89	51	0	3535
10336	47	3759	41	41	0	3888
10337	3326	110	517	34	0	3987
10338	3329	16	8	18	0	3371
10339	77	10	13	3284	0	3384
10340	20	3208	19	81	0	3328
10341	15	3291	18	24	0	3348
10342	11	70	8	3343	0	3432
10343	3655	19	7	70	0	3751
10344	3651	18	6	25	0	3700
10345	85	16	3398	18	0	3517
10346	2696	0	4	0	0	2700
10347	7	2694	5	4	0	2710
10348	3218	5	1	2	0	3226
10349	39	4317	9	1	0	4366
10350	18	5202	13	3	0	5236
10351	6	171	0	5288	0	5465
10352	5496	87	4	136	0	5723
10353	5606	48	3	62	0	5719
10354	206	33	5330	53	0	5622
10355	115	21	137	5457	0	5730
10356	5528	10	57	165	0	5760
10357	173	4	51	5582	0	5810
10358	5594	7	13	201	0	5815
10359	5680	4	13	77	0	5774
10360	227	23	5341	73	0	5664
10361	139	2	137	5392	0	5670
10362	86	11	56	5603	0	5756
10363	36	10	44	5737	0	5827
10364	48	14	5292	260	0	5614
10365	31	8	145	5516	0	5700
10366	19	6	74	5239	0	5338
10367	12	5101	68	240	0	5421
10368	26	166	4902	143	0	5237
10369	11	5178	169	91	0	5449
10370	5236	198	70	45	0	5549
10371	162	86	42	4961	0	5251
10372	75	75	30	4912	0	5092
10373	61	4955	21	212	0	5249
10374	4959	170	16	130	0	5275
10375	5083	87	9	84	0	5263
10376	239	5166	25	53	0	5483
10377	136	5429	17	56	0	5638
10378	5477	205	18	34	0	5734
10379	192	138	5200	36	0	5566
10380	118	76	5170	38	0	5402
10381	5241	42	207	29	0	5519
10382	174	5763	130	35	0	6102
10383	6007	160	63	37	0	6267
10384	233	86	5698	34	0	6051
10385	5716	79	171	33	0	5999
10386	219	5679	95	40	0	6033
10387	111	177	58	5819	0	6165
10388	110	94	26	6001	0	6231
10389	65	72	36	5537	0	5710
10390	61	32	31	5644	0	5768
10391	59	49	20	5516	0	5644
10392	42	5293	32	292	0	5659
10393	5475	159	18	188	0	5840
10394	194	100	5704	124	0	6122
10395	111	80	155	5934	0	6280
10396	114	37	6218	225	0	6594
10397	51	41	212	6308	0	6612
10398	47	53	96	6520	0	6716
10399	6391	29	84	263	0	6767
10400	194	38	6138	182	0	6552
10401	102	6053	192	133	0	6480
10402	86	165	116	6256	0	6623
10403	56	90	70	6571	0	6787
10404	63	110	6539	263	0	6975
10405	67	48	188	6682	0	6985
10406	37	53	102	6972	0	7164
10407	6625	54	56	286	0	7021
10408	177	6022	41	203	0	6443
10409	6202	176	38	152	0	6568
10410	6312	101	34	98	0	6545
10411	267	96	21	6132	0	6516
10412	175	55	5922	225	0	6377
10413	128	72	5824	119	0	6143
10414	72	59	224	5946	0	6301
10415	84	40	143	5760	0	6027
10416	63	5828	105	275	0	6271
10417	5881	185	63	171	0	6300
10418	200	5851	77	112	0	6240
10419	110	6065	51	90	0	6316
10420	5987	260	32	95	0	6374
10421	204	158	44	5894	0	6300
10422	130	6853	54	214	0	7251
10423	112	220	25	7081	0	7438
10424	56	139	6751	283	0	7229
10425	67	109	6746	160	0	7082
10426	59	56	231	6956	0	7302
10427	43	60	6867	275	0	7245
10428	59	52	224	6930	0	7265
10429	62	36	104	7041	0	7243
10430	39	48	126	7179	0	7392
10431	6908	27	68	350	0	7353
10432	176	6562	75	235	0	7048
10433	88	6873	54	176	0	7191
10434	6707	241	54	107	0	7109
10435	6638	132	42	122	0	6934
10436	247	97	23	6340	0	6707
10437	159	77	6175	207	0	6618
10438	99	71	179	6229	0	6578
10439	74	65	6196	258	0	6593
10440	68	6007	216	149	0	6440
10441	56	169	100	6478	0	6803
10442	6342	85	108	237	0	6772
10443	181	97	61	6094	0	6433
10444	109	60	5810	278	0	6257
10445	5720	47	192	145	0	6104
10446	209	66	5787	144	0	6206
10447	132	55	5821	105	0	6113
10448	114	5234	204	95	0	5647
10449	34	4074	71	74	0	4253
10450	18	3256	29	24	0	3327
10451	3219	20	221	26	0	3486
10452	3155	8	11	17	0	3191
10453	8	3	10	3155	0	3176
10454	9	7	9	3120	0	3145
10455	9	7	10	4010	0	4036
10456	9	3759	18	22	0	3808
10457	4063	9	7	14	0	4093
10458	14	3789	13	18	0	3834
10459	10	14	5	4033	0	4062
10460	4047	6	10	16	0	4079
10461	17	12	9	3894	0	3932
10462	4	15	5	4578	0	4602
10463	4658	15	10	13	0	4696
10464	4431	13	9	13	0	4466
10465	17	8	4539	16	0	4580
10466	12	28	4289	13	0	4342
10467	15	12	4404	18	0	4449
10468	6	16	10	4275	0	4307
10469	8	13	5	4472	0	4498
10470	8	4320	14	16	0	4358
10471	4605	11	10	20	0	4646
10472	13	11	15	4525	0	4564
10473	5	8	12	4547	0	4572
10474	7	4305	18	19	0	4349
10475	9	4808	18	20	0	4855
10476	4	13	9	4765	0	4791
10477	10	11	8	4744	0	4773
10478	5225	10	4	23	0	5262
10479	5060	12	5	18	0	5095
10480	21	17	5	5107	0	5150
10481	22	11	5021	27	0	5081
10482	24	12	4205	18	0	4259
10483	10	8	14	4507	0	4539
10484	11	8	11	4521	0	4551
10485	15	4419	17	28	0	4479
10486	4691	21	11	20	0	4743
10487	21	10	16	4647	0	4694
10488	9	18	4578	24	0	4629
10489	10	11	18	4989	0	5028
10490	21	13	4950	27	0	5011
10491	19	16	4789	21	0	4845
10492	22	9	18	4920	0	4969
10493	5108	5	15	27	0	5155
10494	12	2	4550	4	0	4568
10495	2	3	11	4358	0	4374
10496	4	1	4205	12	0	4222
10497	2	4	11	4099	0	4116
10498	1	3	4	4072	0	4080
10499	10	2	4138	11	0	4161
10500	9	5	3932	6	0	3952
10501	0	5	18	3607	0	3630
10502	2	2	6	4055	0	4065
10503	2	1	6	4118	0	4127
10504	1	0	5	3756	0	3762
10505	3782	0	2	15	0	3799
10506	3748	0	6	4	0	3758
10507	9	3575	21	3	0	3608
10508	3839	5	2	7	0	3853
10509	9	4	2	3782	0	3797
10510	3818	2	5	12	0	3837
10511	12	2	3672	7	0	3693
10512	3645	0	10	4	0	3659
10513	10	0	6	3726	0	3742
10514	2	4	3	3789	0	3798
10515	3833	1	3	11	0	3848
10516	9	1	2	3735	0	3747
10517	11	9	5181	13	0	5214
10518	4985	1	28	8	0	5022
10519	33	5300	22	5	0	5360
10520	6	64	7	5688	0	5765
10521	20	21	6928	66	0	7035
10522	10	9	112	6180	0	6311
10523	7	29	5870	143	0	6049
10524	13	5	125	5988	0	6131
10525	5	5940	43	156	0	6144
10526	8	128	28	6084	0	6248
10527	2	5993	31	158	0	6184
10528	8	155	9	6063	0	6235
10529	3	37	14	6697	0	6751
10530	5	30	16	6748	0	6799
10531	18	24	10	6708	0	6760
10532	9	16	17	6861	0	6903
10533	18	36	6292	251	0	6597
10534	26	13	148	6556	0	6743
10535	8	24	46	6752	0	6830
10536	6536	12	58	252	0	6858
10537	151	6397	51	125	0	6724
10538	6562	164	25	121	0	6872
10539	180	47	35	6622	0	6884
10540	68	76	6059	222	0	6425
10541	40	6342	156	103	0	6641
10542	6378	170	51	106	0	6705
10543	162	6209	54	89	0	6514
10544	47	6529	36	91	0	6703
10545	6472	218	18	90	0	6798
10546	174	73	30	6522	0	6799
10547	6537	57	18	238	0	6850
10548	196	36	31	6558	0	6821
10549	76	32	6281	253	0	6642
10550	55	44	6245	130	0	6474
10551	6129	24	185	102	0	6440
10552	6485	33	77	83	0	6678
10553	222	33	66	6332	0	6653
10554	105	35	38	6585	0	6763
10555	5685	29	40	245	0	5999
10556	188	5444	49	115	0	5796
10557	67	5704	32	98	0	5901
10558	5684	197	19	79	0	5979
10559	5710	97	27	77	0	5911
10560	232	5593	34	60	0	5919
10561	128	205	23	5725	0	6081
10562	90	76	4973	227	0	5366
10563	85	64	5053	104	0	5306
10564	5101	53	199	99	0	5452
10565	221	41	4992	75	0	5329
10566	94	30	231	4958	0	5313
10567	99	29	83	5028	0	5239
10568	75	5070	78	233	0	5456
10569	5082	186	56	132	0	5456
10570	219	72	30	5175	0	5496
10571	108	83	4802	244	0	5237
10572	88	4980	160	114	0	5342
10573	72	206	56	5142	0	5476
10574	71	101	4910	249	0	5331
10575	66	93	4508	114	0	4781
10576	50	4697	224	110	0	5081
10577	4606	187	105	117	0	5015
10578	172	5142	110	75	0	5499
10579	5282	196	70	89	0	5637
10580	215	94	5034	86	0	5429
10581	5070	55	204	103	0	5432
10582	219	5125	98	93	0	5535
10583	110	187	65	5175	0	5537
10584	69	128	48	5415	0	5660
10585	5301	82	45	274	0	5702
10586	211	85	4985	172	0	5453
10587	5163	59	198	145	0	5565
10588	5389	71	93	116	0	5669
10589	239	70	4687	132	0	5128
10590	106	54	4818	103	0	5081
10591	93	67	233	4868	0	5261
10592	4904	77	116	220	0	5317
10593	4910	57	90	121	0	5178
10594	251	4723	60	129	0	5163
10595	149	202	51	4848	0	5250
10596	128	93	50	5002	0	5273
10597	118	65	55	5009	0	5247
10598	79	79	51	5122	0	5331
10599	4859	55	65	317	0	5296
10600	235	64	36	4996	0	5331
10601	133	60	4660	287	0	5140
10602	120	68	4616	135	0	4939
10603	4657	55	199	106	0	5017
10604	239	4599	108	99	0	5045
10605	130	5599	124	68	0	5921
10606	137	217	82	5649	0	6085
10607	128	103	58	5813	0	6102
10608	92	94	65	5792	0	6043
10609	94	75	59	5927	0	6155
10610	95	71	5484	307	0	5957
10611	98	52	155	5703	0	6008
10612	92	50	61	5904	0	6107
10613	72	54	6129	338	0	6593
10614	6015	35	202	174	0	6426
10615	213	6243	93	150	0	6699
10616	6520	180	85	118	0	6903
10617	190	60	5125	58	0	5433
10618	110	40	5034	62	0	5246
10619	65	4576	134	54	0	4829
10620	3780	113	1156	47	0	5096
10621	3286	17	17	7	0	3327
10622	3362	11	6	8	0	3387
10623	42	3205	10	14	0	3271
10624	3377	30	9	13	0	3429
10625	36	16	3289	20	0	3361
10626	18	3379	29	22	0	3448
10627	3570	33	15	12	0	3630
10628	34	3442	14	20	0	3510
10629	3183	0	0	0	0	3183
10630	3111	0	0	1	0	3112
10631	2	0	3061	0	0	3063
10632	0	2955	3	3	0	2961
10633	3067	0	1	0	0	3068
10634	1	1	3084	2	0	3088
10635	0	2941	6	3	0	2950
10636	0	1	0	3122	0	3123
10637	2	2	3131	0	0	3135
10638	3	4	2994	0	0	3001
10639	2	0	0	2991	0	2993
10640	3153	0	2	1	0	3156
10641	0	2926	8	5	0	2939
10642	3	1	3058	0	0	3062
10643	2	6	2949	0	0	2957
10644	2770	2	3	1	0	2776
10645	0	2887	10	1	0	2898
10646	3139	0	0	1	0	3140
10647	0	2969	4	1	0	2974
10648	3099	1	0	0	0	3100
10649	3080	1	1	1	0	3083
10650	0	2928	6	3	0	2937
10651	0	0	0	3107	0	3107
10652	3133	0	0	0	0	3133
10653	0	1	0	3067	0	3068
10654	0	1	0	3039	0	3040
10655	3136	0	1	1	0	3138
10656	0	2939	8	2	0	2949
10657	3103	0	1	3	0	3107
10658	1	4	2937	0	0	2942
10659	0	0	0	3012	0	3012
10660	0	0	0	3038	0	3038
10661	3091	1	0	1	0	3093
10662	3047	1	0	1	0	3049
10663	0	0	0	3025	0	3025
10664	2	1	3003	0	0	3006
10665	1	1	0	2996	0	2998
10666	0	2	0	3009	0	3011
10667	1	1	2	3011	0	3015
10668	1	0	0	3008	0	3009
10669	3024	0	0	5	0	3029
10670	0	2	2995	1	0	2998
10671	1	2754	12	2	0	2769
10672	0	1	0	3032	0	3033
10673	2	0	0	3047	0	3049
10674	2	6	3001	0	0	3009
10675	2	1	2878	3	0	2884
10676	1	1	0	3254	0	3256
10677	2	0	0	3306	0	3308
10678	1	0	2430	17	0	2448
10679	1	0	12	2402	0	2415
10680	2453	0	7	18	0	2478
10681	10	2302	12	9	0	2333
10682	8	11	2347	10	0	2376
10683	7	2316	17	4	0	2344
10684	3	19	4	2454	0	2480
10685	2	15	2398	10	0	2425
10686	0	2224	20	9	0	2253
10687	1	14	4	2462	0	2481
10688	1	7	2383	13	0	2404
10689	0	8	12	2367	0	2387
10690	0	3	5	2414	0	2422
10691	2438	0	8	17	0	2463
10692	10	1	2	2421	0	2434
10693	2453	0	1	22	0	2476
10694	2382	0	2	11	0	2395
10695	2389	0	1	9	0	2399
10696	26	2	0	2342	0	2370
10697	18	3	2334	10	0	2365
10698	12	3	2172	6	0	2193
10699	2189	4	17	9	0	2219
10700	11	4	2309	2	0	2326
10701	2643	1	22	3	0	2669
10702	27	2706	16	5	0	2754
10703	2862	15	10	2	0	2889
10704	33	9	3696	3	0	3741
10705	14	12	2917	2	0	2945
10706	12	6	30	2824	0	2872
10707	7	4	2903	21	0	2935
10708	7	11	2840	11	0	2869
10709	4	4	34	3617	0	3659
10710	4	0	20	3656	0	3680
10711	4	6	12	3675	0	3697
10712	1	3658	14	104	0	3777
10713	2	62	8	2951	0	3023
10714	1	3022	8	82	0	3113
10715	3434	74	2	41	0	3551
10716	3460	35	9	27	0	3531
10717	85	34	2	3103	0	3224
10718	46	3037	10	64	0	3157
10719	32	74	3000	25	0	3131
10720	3132	22	61	18	0	3233
10721	68	17	26	3156	0	3267
10722	26	9	25	3150	0	3210
10723	21	13	18	3284	0	3336
10724	3143	0	14	99	0	3256
10725	73	3049	12	62	0	3196
10726	23	2978	3	52	0	3056
10727	2927	82	6	31	0	3046
10728	71	2979	7	22	0	3079
10729	2998	94	8	7	0	3107
10730	2959	51	6	9	0	3025
10731	98	2965	15	12	0	3090
10732	61	66	15	2889	0	3031
10733	35	2935	14	68	0	3052
10734	31	78	12	2949	0	3070
10735	22	42	16	3364	0	3444
10736	3884	36	14	120	0	4054
10737	3991	15	7	81	0	4094
10738	151	20	6	4014	0	4191
10739	76	26	3752	147	0	4001
10740	3837	10	102	75	0	4024
10741	150	3842	47	47	0	4086
10742	77	112	29	3937	0	4155
10743	49	56	30	4050	0	4185
10744	35	39	26	4121	0	4221
10745	3982	28	6	207	0	4223
10746	3935	33	16	111	0	4095
10747	168	3812	19	94	0	4093
10748	85	3893	17	87	0	4082
10749	69	164	13	3952	0	4198
10750	64	85	14	4088	0	4251
10751	57	75	3802	175	0	4109
10752	26	59	104	4033	0	4222
10753	30	47	3917	186	0	4180
10754	42	32	3811	110	0	3995
10755	51	3844	171	77	0	4143
10756	41	129	96	3982	0	4248
10757	3943	67	55	173	0	4238
10758	136	48	57	4018	0	4259
10759	91	45	3819	176	0	4131
10760	3923	56	110	113	0	4202
10761	4029	31	55	98	0	4213
10762	219	36	3626	80	0	3961
10763	114	29	133	3975	0	4251
10764	3954	30	77	153	0	4214
10765	201	3865	48	84	0	4198
10766	4018	133	44	76	0	4271
10767	4053	77	34	74	0	4238
10768	201	61	26	3968	0	4256
10769	125	42	35	5524	0	5726
10770	5436	54	32	249	0	5771
10771	232	35	24	5517	0	5808
10772	128	49	5117	261	0	5555
10773	5185	32	182	169	0	5568
10774	5240	29	91	122	0	5482
10775	259	5160	56	94	0	5569
10776	122	5008	43	74	0	5247
10777	92	206	39	4906	0	5243
10778	71	4945	39	183	0	5238
10779	72	192	24	5137	0	5425
10780	5041	105	21	218	0	5385
10781	5039	53	41	123	0	5256
10782	221	4934	42	101	0	5298
10783	5018	187	26	65	0	5296
10784	213	4974	25	76	0	5288
10785	5127	182	20	55	0	5384
10786	5199	88	30	59	0	5376
10787	259	79	4799	73	0	5210
10788	4973	47	152	76	0	5248
10789	243	4835	83	56	0	5217
10790	151	5054	50	64	0	5319
10791	5116	197	53	57	0	5423
10792	239	102	41	5048	0	5430
10793	154	69	4811	193	0	5227
10794	91	96	148	4999	0	5334
10795	85	75	63	5165	0	5388
10796	93	54	4781	265	0	5193
10797	4727	55	160	158	0	5100
10798	214	4881	94	127	0	5316
10799	5105	172	34	106	0	5417
10800	231	86	33	4703	0	5053
10801	4172	57	40	172	0	4441
10802	242	4030	27	80	0	4379
10803	121	189	16	4141	0	4467
10804	3384	83	19	191	0	3677
10805	226	47	3174	121	0	3568
10806	121	50	3183	85	0	3439
10807	3168	46	190	64	0	3468
10808	199	3217	88	70	0	3574
10809	87	2463	39	42	0	2631
10810	78	152	35	2284	0	2549
10811	59	2352	26	136	0	2573
10812	41	139	36	2430	0	2646
10813	41	71	19	2523	0	2654
10814	31	51	25	2504	0	2611
10815	39	2333	55	166	0	2593
10816	65	118	25	2472	0	2680
10817	64	83	2227	147	0	2521
10818	78	2324	100	85	0	2587
10819	49	132	46	2226	0	2453
10820	65	2388	26	112	0	2591
10821	2439	155	21	65	0	2680
10822	2494	65	17	67	0	2643
10823	2510	35	25	56	0	2626
10824	169	2313	68	55	0	2605
10825	103	120	40	2907	0	3170
10826	94	74	2837	125	0	3130
10827	69	88	2777	61	0	2995
10828	2835	69	133	54	0	3091
10829	2938	42	54	69	0	3103
10830	145	68	38	2943	0	3194
10831	89	30	28	3051	0	3198
10832	77	46	2749	209	0	3081
10833	63	2706	108	133	0	3010
10834	75	2857	59	70	0	3061
10835	78	127	2527	90	0	2822
10836	28	44	63	1842	0	1977
10837	39	39	19	1744	0	1841
10838	42	25	9	1947	0	2023
10839	32	45	12	1969	0	2058
10840	1960	29	5	86	0	2080
10841	81	23	1850	38	0	1992
10842	1922	30	52	15	0	2019
10843	74	32	31	1932	0	2069
10844	1958	16	15	68	0	2057
10845	77	29	24	1927	0	2057
10846	43	36	1867	69	0	2015
10847	47	19	48	1941	0	2055
10848	32	27	1902	67	0	2028
10849	38	10	57	1918	0	2023
10850	36	17	1871	74	0	1998
10851	22	1828	65	50	0	1965
10852	20	74	22	1896	0	2012
10853	23	43	18	1872	0	1956
10854	10	1874	31	72	0	1987
10855	1937	70	14	53	0	2074
10856	59	29	7	1932	0	2027
10857	31	17	25	1997	0	2070
10858	2365	9	22	88	0	2484
10859	2361	12	13	42	0	2428
10860	2383	24	21	24	0	2452
10861	2386	28	9	26	0	2449
10862	85	23	2213	41	0	2362
10863	2291	19	56	16	0	2382
10864	2350	15	36	44	0	2445
10865	99	10	22	2307	0	2438
10866	48	16	14	2387	0	2465
10867	2307	18	32	96	0	2453
10868	60	2260	22	74	0	2416
10869	0	0	0	946	0	946
10870	0	0	932	0	0	932
10871	0	867	3	0	0	870
10872	953	0	0	0	0	953
10873	945	0	0	0	0	945
10874	928	0	0	0	0	928
10875	947	0	0	0	0	947
10876	0	0	0	927	0	927
10877	0	0	922	0	0	922
10878	1	2	1291	1	0	1295
10879	0	3	0	1976	0	1979
10880	2036	0	2	11	0	2049
10881	10	0	1	2012	0	2023
10882	3	4	2005	12	0	2024
10883	1988	1	11	2	0	2002
10884	2005	1	2	6	0	2014
10885	11	1	3	1997	0	2012
10886	7	1	1979	12	0	1999
10887	6	4	1917	4	0	1931
10888	1883	2	13	5	0	1903
10889	12	1878	11	3	0	1904
10890	6	14	1934	3	0	1957
10891	8	3	9	1958	0	1978
10892	2000	3	4	16	0	2023
10893	14	1871	13	5	0	1903
10894	10	1930	4	9	0	1953
10895	2017	16	5	2	0	2040
10896	13	7	3	1990	0	2013
10897	2011	3	6	15	0	2035
10898	20	1	4	2268	0	2293
10899	8	3	1	2280	0	2292
10900	8	6	2582	16	0	2612
10901	6	7	2423	9	0	2445
10902	6	5	2534	12	0	2557
10903	8	1	21	2603	0	2633
10904	2654	5	9	21	0	2689
10905	20	8	2580	14	0	2622
10906	12	2	20	2592	0	2626
10907	14	12	2539	23	0	2588
10908	12	3016	42	10	0	3080
10909	15	16	7	3243	0	3281
10910	13	3	12	3201	0	3229
10911	9	5	13	3260	0	3287
10912	3263	1	13	35	0	3312
10913	21	4	20	3255	0	3300
10914	9	7	16	3276	0	3308
10915	3270	5	12	26	0	3313
10916	22	9	3468	16	0	3515
10917	3484	7	21	25	0	3537
10918	3571	5	10	9	0	3595
10919	26	14	3482	11	0	3533
10920	3307	11	17	23	0	3358
10921	31	8	10	3497	0	3546
10922	11	13	3490	30	0	3544
10923	3466	3	18	19	0	3506
10924	3502	2	10	33	0	3547
10925	23	2	16	3069	0	3110
10926	26	0	10	3084	0	3120
10927	13	3	14	3128	0	3158
10928	3083	1	15	35	0	3134
10929	34	2974	13	21	0	3042
10930	3060	15	14	20	0	3109
10931	34	2912	20	14	0	2980
10932	15	2945	20	20	0	3000
10933	20	23	17	3072	0	3132
10934	16	13	8	3063	0	3100
10935	14	11	7	3056	0	3088
10936	11	2	16	3082	0	3111
10937	18	8	2960	48	0	3034
10938	2928	4	21	28	0	2981
10939	31	6	7	3112	0	3156
10940	20	7	3019	42	0	3088
10941	27	3	17	3036	0	3083
10942	25	9	14	3073	0	3121
10943	26	19	3020	26	0	3091
10944	32	9	21	2993	0	3055
10945	15	8	21	3001	0	3045
10946	3011	10	28	31	0	3080
10947	31	13	2978	34	0	3056
10948	2870	1	31	41	0	2943
10949	40	3103	22	30	0	3195
10950	3273	37	29	34	0	3373
10951	3244	5	19	28	0	3296
10952	62	17	18	3219	0	3316
10953	27	19	3152	64	0	3262
10954	26	3060	57	25	0	3168
10955	18	50	14	3110	0	3192
10956	17	3128	18	64	0	3227
10957	3251	54	13	26	0	3344
10958	48	21	2820	40	0	2929
10959	17	17	2790	36	0	2860
10960	23	13	48	2834	0	2918
10961	18	7	3279	68	0	3372
10962	29	11	47	3275	0	3362
10963	17	7	17	3366	0	3407
10964	3392	2	23	59	0	3476
10965	59	3248	21	32	0	3360
10966	12	41	17	3393	0	3463
10967	21	11	23	3397	0	3452
10968	19	17	15	3348	0	3399
10969	17	3608	22	71	0	3718
10970	23	3737	25	34	0	3819
10971	4150	45	21	36	0	4252
10972	4138	10	21	29	0	4198
10973	4102	10	15	35	0	4162
10974	71	17	3990	31	0	4109
10975	36	8	55	4065	0	4164
10976	31	26	3984	70	0	4111
10977	33	3930	61	27	0	4051
10978	3777	55	9	36	0	3877
10979	46	12	2991	9	0	3058
10980	12	7	36	3026	0	3081
10981	13	6	2995	54	0	3068
10982	2926	5	39	14	0	2984
10983	3057	11	8	19	0	3095
10984	3062	10	12	14	0	3098
10985	3018	6	10	8	0	3042
10986	58	12	2958	13	0	3041
10987	2947	5	39	10	0	3001
10988	3058	3	15	16	0	3092
10989	42	2915	21	19	0	2997
10990	3081	40	15	9	0	3145
10991	3072	9	4	10	0	3095
10992	59	7	18	2939	0	3023
10993	26	2928	16	46	0	3016
10994	3079	38	16	15	0	3148
10995	3064	7	17	12	0	3100
10996	71	17	4008	15	0	4111
10997	35	11	4003	14	0	4063
10998	34	22	3771	16	0	3843
10999	27	18	123	3821	0	3989
11000	3493	11	49	77	0	3630
11001	101	3396	37	28	0	3562
11002	3495	82	23	16	0	3616
11003	107	3458	20	16	0	3601
11004	3479	88	13	12	0	3592
11005	108	3379	21	8	0	3516
11006	54	3485	16	13	0	3568
11007	3421	106	12	10	0	3549
11008	103	2899	6	11	0	3019
11009	53	102	11	2971	0	3137
11010	40	47	3278	81	0	3446
11011	43	34	3307	32	0	3416
11012	26	28	155	3300	0	3509
11013	40	17	59	3494	0	3610
11014	35	22	3300	161	0	3518
11015	25	25	134	3380	0	3564
11016	27	12	55	3223	0	3317
11017	3061	16	47	167	0	3291
11018	138	3029	33	83	0	3283
11019	53	138	34	2939	0	3164
11020	50	3039	40	134	0	3263
11021	3068	150	31	55	0	3304
11022	137	3086	21	59	0	3303
11023	3144	149	21	30	0	3344
11024	3197	72	23	25	0	3317
11025	200	43	16	3080	0	3339
11026	104	34	17	3177	0	3332
11027	67	38	23	3234	0	3362
11028	51	25	32	3289	0	3397
11029	40	48	2893	212	0	3193
11030	2909	19	132	105	0	3165
11031	142	2989	64	69	0	3264
11032	82	126	37	3120	0	3365
11033	60	55	42	3161	0	3318
11034	47	3012	44	196	0	3299
11035	3024	132	31	97	0	3284
11036	155	3019	33	77	0	3284
11037	83	156	20	3101	0	3360
11038	70	77	22	3219	0	3388
11039	72	64	14	3250	0	3400
11040	57	54	25	3287	0	3423
11041	3124	46	19	229	0	3418
11042	164	41	2956	114	0	3275
11043	66	51	135	3137	0	3389
11044	75	40	60	3223	0	3398
11045	50	45	69	3257	0	3421
11046	44	33	51	3320	0	3448
11047	3102	36	42	262	0	3442
11048	185	30	2910	156	0	3281
11049	88	39	116	2787	0	3030
11050	68	2602	66	163	0	2899
11051	61	2878	48	114	0	3101
11052	2877	160	43	84	0	3164
11053	145	97	2727	71	0	3040
11054	2847	91	101	62	0	3101
11055	165	73	2766	66	0	3070
11056	110	48	130	2864	0	3152
11057	2863	56	58	179	0	3156
11058	132	2789	66	128	0	3115
11059	67	140	62	2679	0	2948
11060	68	2760	49	171	0	3048
11061	2425	142	36	120	0	2723
11062	2896	62	44	107	0	3109
11063	195	44	53	2910	0	3202
11064	98	50	2685	233	0	3066
11065	83	40	2749	152	0	3024
11066	69	48	173	2736	0	3026
11067	50	2757	86	193	0	3086
11068	60	174	52	2880	0	3166
11069	64	103	27	2598	0	2792
11070	82	80	20	2654	0	2836
11071	47	62	1946	234	0	2289
11072	56	27	130	2177	0	2390
11073	46	29	70	2164	0	2309
11074	34	1957	48	239	0	2278
11075	31	132	28	2138	0	2329
11076	25	57	32	2278	0	2392
11077	32	34	28	2293	0	2387
11078	35	38	33	2291	0	2397
11079	59	25	21	2292	0	2397
11080	44	43	23	2283	0	2393
11081	23	27	27	2304	0	2381
11082	26	49	21	2293	0	2389
11083	43	64	1441	271	0	1819
11084	51	52	103	2199	0	2405
11085	2082	42	51	230	0	2405
11086	164	21	38	2311	0	2534
11087	69	19	2073	248	0	2409
11088	2186	19	127	162	0	2494
11089	2298	30	53	128	0	2509
11090	2283	27	48	107	0	2465
11091	2348	20	43	97	0	2508
11092	203	17	38	2269	0	2527
11093	117	32	1993	226	0	2368
11094	76	2037	129	136	0	2378
11095	54	2226	68	132	0	2480
11096	522	101	19	1050	0	1692
11097	21	43	7	1128	0	1199
11098	18	21	12	1140	0	1191
11099	21	14	5	1159	0	1199
11100	26	5	14	1176	0	1221
11101	1024	3	15	145	0	1187
11102	74	962	14	77	0	1127
11103	37	1052	13	46	0	1148
11104	25	93	22	1054	0	1194
11105	18	33	13	1128	0	1192
11106	19	23	14	1143	0	1199
11107	26	8	8	1169	0	1211
11108	24	5	978	148	0	1155
11109	31	1011	72	76	0	1190
11110	2	25	4	599	0	630
11111	577	5	1	33	0	616
11112	31	2	0	597	0	630
11113	5	1	565	40	0	611
11114	3	2	570	11	0	586
11115	2	3	591	10	0	606
11116	4	1	31	588	0	624
11117	592	7	6	34	0	639
11118	31	0	5	597	0	633
11119	8	1	2	625	0	636
11120	583	1	3	42	0	629
11121	29	3	9	594	0	635
11122	9	5	1	616	0	631
11123	10	4	786	43	0	843
11124	6	810	31	15	0	862
11125	3	29	5	849	0	886
11126	819	6	8	43	0	876
11127	29	5	5	853	0	892
11128	7	8	801	46	0	862
11129	1	6	29	830	0	866
11130	3	818	7	50	0	878
11131	4	30	2	861	0	897
11132	1	9	1333	54	0	1397
11133	1	1328	40	19	0	1388
11134	4	31	9	1416	0	1460
11135	7	8	5	1579	0	1599
11136	3	11	6	1561	0	1581
11137	3	1	5	1585	0	1594
11138	11	1	1485	63	0	1560
11139	8	1427	39	30	0	1504
11140	1540	37	13	15	0	1605
11141	1557	7	6	17	0	1587
11142	42	4	5	1557	0	1608
11143	12	6	1502	50	0	1570
11144	1493	4	35	23	0	1555
11145	40	7	12	2121	0	2180
11146	9	4	2614	59	0	2686
11147	6	3	36	2599	0	2644
11148	4	4	12	2694	0	2714
11149	3	4	7	2747	0	2761
11150	9	5	2617	67	0	2698
11151	10	2	32	2531	0	2575
11152	6	2573	11	43	0	2633
11153	2702	39	2	23	0	2766
11154	2668	7	6	22	0	2703
11155	2710	6	5	18	0	2739
11156	44	2563	7	14	0	2628
11157	2706	43	1	17	0	2767
11158	44	9	5	2702	0	2760
11159	2709	8	3	47	0	2767
11160	2658	4	6	23	0	2691
11161	51	7	2656	15	0	2729
11162	2	2083	9	1	0	2095
11163	2208	10	2	0	0	2220
11164	9	1	0	2229	0	2239
11165	3	3	2179	10	0	2195
11166	1	2071	13	5	0	2090
11167	2216	9	1	3	0	2229
11168	8	2	0	2189	0	2199
11169	1	0	0	2207	0	2208
11170	0	0	0	2226	0	2226
11171	0	2068	4	13	0	2085
11172	0	10	1	2246	0	2257
11173	0	2104	4	14	0	2122
11174	0	11	1	2237	0	2249
11175	2	5	2844	10	0	2861
11176	1	1	7	2828	0	2837
11177	1	1	1	2891	0	2894
11178	0	0	0	2939	0	2939
11179	2	3	2875	11	0	2891
11180	1	1	9	2800	0	2811
11181	1	0	2	2352	0	2355
11182	1	0	1	2358	0	2360
11183	0	2	0	2334	0	2336
11184	1	2	0	2356	0	2359
11185	2	1	2332	12	0	2347
11186	1	2	9	2997	0	3009
11187	1	1	2	3078	0	3082
11188	3090	1	1	10	0	3102
11189	12	2862	6	4	0	2884
11190	4	2924	13	1	0	2942
11191	3	12	0	3094	0	3109
11192	0	3	2	3060	0	3065
11193	1	2908	7	12	0	2928
11194	1	9	0	3693	0	3703
11195	1	3534	5	24	0	3564
11196	4	19	1	3706	0	3730
11197	0	1	3	3448	0	3452
11198	1	16	3309	20	0	3346
11199	2	3137	18	9	0	3166
11200	2	3274	8	7	0	3291
11201	3367	17	1	3	0	3388
11202	13	3247	8	6	0	3274
11203	4	16	0	3433	0	3453
11204	6	13	3314	17	0	3350
11205	0	2	12	3232	0	3246
11206	3376	3	3	17	0	3399
11207	14	15	3202	7	0	3238
11208	4	3560	24	7	0	3595
11209	3	21	6	3726	0	3756
11210	4	9	1	3930	0	3944
11211	3945	3	2	20	0	3970
11212	19	3	3	3880	0	3905
11213	4	3	1	3925	0	3933
11214	4	1	4	3931	0	3940
11215	1	5	5	3952	0	3963
11216	3936	3	3	28	0	3970
11217	3869	2	6	18	0	3895
11218	18	6	2	3930	0	3956
11219	3940	5	1	26	0	3972
11220	17	9	2	3908	0	3936
11221	12	11	3805	24	0	3852
11222	6	15	3578	15	0	3614
11223	3	6	18	3760	0	3787
11224	7	3545	19	22	0	3593
11225	6	16	4	3918	0	3944
11226	3906	5	6	24	0	3941
11227	21	3	4	3861	0	3889
11228	3822	3	4	26	0	3855
11229	16	3	4	3861	0	3884
11230	13	6	3773	27	0	3819
11231	5	3526	24	18	0	3573
11232	2	3208	12	16	0	3238
11233	2	17	2	3370	0	3391
11234	6	8	3240	28	0	3282
11235	4	2941	19	23	0	2987
11236	9	11	5	3224	0	3249
11237	3213	6	3	18	0	3240
11238	17	12	3098	9	0	3136
11239	10	7	8	3049	0	3074
11240	6	5	7	3156	0	3174
11241	5	8	3094	27	0	3134
11242	1	17	2852	12	0	2882
11243	2	8	3059	21	0	3090
11244	6	6	11	3034	0	3057
11245	8	9	3076	15	0	3108
11246	2435	11	12	17	0	2475
11247	14	9	7	2602	0	2632
11248	15	11	3485	22	0	3533
11249	9	3282	28	19	0	3338
11250	4	18	3482	18	0	3522
11251	3	11	20	3451	0	3485
11252	3642	9	14	30	0	3695
11253	18	9	9	3597	0	3633
11254	10	9	12	3594	0	3625
11255	3651	11	2	26	0	3690
11256	12	4	6	3585	0	3607
11257	11	7	3533	26	0	3577
11258	3914	5	13	20	0	3952
11259	24	3796	18	26	0	3864
11260	4082	23	12	26	0	4143
11261	25	15	11	2838	0	2889
11262	20	7	2760	37	0	2824
11263	18	14	3204	27	0	3263
11264	21	9	34	3253	0	3317
11265	15	2	16	3352	0	3385
11266	23	10	3324	37	0	3394
11267	12	14	3069	35	0	3130
11268	3325	5	44	14	0	3388
11269	22	11	24	3398	0	3455
11270	3445	8	12	33	0	3498
11271	19	10	24	3425	0	3478
11272	20	9	3836	35	0	3900
11273	17	10	4265	35	0	4327
11274	11	8	29	4964	0	5012
11275	25	3	19	5102	0	5149
11276	14	7	5005	50	0	5076
11277	4599	2	30	37	0	4668
11278	29	8	23	5129	0	5189
11279	5195	10	9	40	0	5254
11280	23	6001	33	30	0	6087
11281	27	70	19	6409	0	6525
11282	6395	52	9	92	0	6548
11283	90	15	6110	81	0	6296
11284	57	21	84	6178	0	6340
11285	11	25	50	6208	0	6294
11286	14	6	11	5773	0	5804
11287	24	12	5476	140	0	5652
11288	6	14	108	5451	0	5579
11289	8	5282	72	132	0	5494
11290	18	65	18	5719	0	5820
11291	7	44	5471	131	0	5653
11292	12	20	5336	75	0	5443
11293	20	18	127	5409	0	5574
11294	5	16	51	5481	0	5553
11295	7	4	25	5661	0	5697
11296	3	11	32	5709	0	5755
11297	5660	8	22	147	0	5837
11298	5077	6	463	97	0	5643
11299	90	9	5388	41	0	5528
11300	37	5285	111	47	0	5480
11301	20	71	44	5671	0	5806
11302	7228	45	8	105	0	7386
11303	6942	10	31	71	0	7054
11304	7162	17	21	27	0	7227
11305	7156	17	16	30	0	7219
11306	142	15	6864	39	0	7060
11307	6791	10	86	24	0	6911
11308	109	6207	63	35	0	6414
11309	85	77	18	6666	0	6846
11310	40	47	6474	98	0	6659
11311	33	12	100	6471	0	6616
11312	37	30	6473	107	0	6647
11313	22	19	89	6505	0	6635
11314	24	9	63	6715	0	6811
11315	6695	7	33	155	0	6890
11316	89	9	20	6685	0	6803
11317	54	21	6537	118	0	6730
11318	14	10	95	6654	0	6773
11319	6687	9	60	133	0	6889
11320	110	14	25	6668	0	6817
11321	65	9	6455	141	0	6670
11322	18	6051	131	106	0	6306
11323	7605	82	69	63	0	7819
11324	112	49	40	7309	0	7510
11325	63	8014	43	124	0	8244
11326	8343	101	28	80	0	8552
11327	122	72	8123	53	0	8370
11328	81	7576	128	74	0	7859
11329	31	90	80	8392	0	8593
11330	45	78	8278	106	0	8507
11331	38	26	106	7923	0	8093
11332	8340	27	71	139	0	8577
11333	101	41	8051	107	0	8300
11334	81	17	111	8114	0	8323
11335	55	21	8210	132	0	8418
11336	43	16	108	8087	0	8254
11337	50	26	85	8971	0	9132
11338	9022	16	34	191	0	9263
11339	117	8405	61	115	0	8698
11340	82	104	41	9034	0	9261
11341	8972	48	34	171	0	9225
11342	8743	19	44	118	0	8924
11343	160	25	50	8671	0	8906
11344	75	8279	65	154	0	8573
11345	41	8673	39	133	0	8886
11346	59	130	23	8985	0	9197
11347	37	65	42	9037	0	9181
11348	8015	35	38	203	0	8291
11349	113	41	35	8058	0	8247
11350	77	41	7794	153	0	8065
11351	7236	14	108	151	0	7509
11352	114	7491	81	98	0	7784
11353	7966	93	37	83	0	8179
11354	128	71	7567	89	0	7855
11355	85	7692	144	84	0	8005
11356	8509	141	61	59	0	8770
11357	8576	77	31	59	0	8743
11358	184	23	7707	33	0	7947
11359	7638	35	132	31	0	7836
11360	7954	35	52	37	0	8078
11361	186	7431	39	43	0	7699
11362	98	106	19	7953	0	8176
11363	65	56	7094	127	0	7342
11364	75	22	112	7118	0	7327
11365	55	33	7271	128	0	7487
11366	33	31	120	7201	0	7385
11367	7365	24	88	165	0	7642
11368	123	15	46	7400	0	7584
11369	69	26	7096	167	0	7358
11370	7169	16	128	83	0	7396
11371	131	13	53	7346	0	7543
11372	81	24	6699	147	0	6951
11373	5922	9	123	102	0	6156
11374	129	6	54	5781	0	5970
11375	74	27	5526	137	0	5764
11376	43	18	5438	77	0	5576
11377	30	9	158	5498	0	5695
11378	51	20	5613	133	0	5817
11379	51	5099	149	80	0	5379
11380	1	34	6	4418	0	4459
11381	4401	6	9	33	0	4449
11382	36	6	4292	11	0	4345
11383	5	11	4206	7	0	4229
11384	3806	2	45	9	0	3862
11385	35	4	4292	4	0	4335
11386	3888	1	41	8	0	3938
11387	44	6	4243	1	0	4294
11388	6	3	41	4066	0	4116
11389	11	3	4635	34	0	4683
11390	5	3	43	4324	0	4375
11391	8	1	4578	38	0	4625
11392	3	12	4504	6	0	4525
11393	3897	4	52	15	0	3968
11394	39	4147	31	7	0	4224
11395	5393	35	9	5	0	5442
11396	95	5098	21	4	0	5218
11397	37	95	9	5322	0	5463
11398	29	27	5	5474	0	5535
11399	5406	26	5	114	0	5551
11400	105	9	11	5320	0	5445
11401	43	13	5279	112	0	5447
11402	3972	4	92	36	0	4104
11403	4164	8	35	26	0	4233
11404	120	8	25	4112	0	4265
11405	47	24	4869	105	0	5045
11406	31	2	125	4877	0	5035
11407	21	4808	57	156	0	5042
11408	15	135	32	4902	0	5084
11409	17	34	17	5162	0	5230
11410	21	35	4836	182	0	5074
11411	4321	13	151	80	0	4565
11412	152	4806	46	53	0	5057
11413	4898	137	46	31	0	5112
11414	160	4887	29	35	0	5111
11415	46	162	27	4851	0	5086
11416	44	4806	28	154	0	5032
11417	24	165	4739	67	0	4995
11418	18	41	155	4625	0	4839
11419	29	36	49	4868	0	4982
11420	34	11	45	5145	0	5235
11421	5640	25	24	206	0	5895
11422	155	16	36	5631	0	5838
11423	4780	19	24	195	0	5018
11424	4862	25	22	71	0	4980
11425	4200	20	35	69	0	4324
11426	226	27	3862	62	0	4177
11427	79	18	163	3978	0	4238
11428	70	9	60	4196	0	4335
11429	44	12	55	4278	0	4389
11430	4097	11	34	234	0	4376
11431	179	16	42	4121	0	4358
11432	75	27	26	4298	0	4426
11433	4148	25	28	214	0	4415
11434	176	27	38	4160	0	4401
11435	63	30	5867	225	0	6185
11436	64	42	5941	102	0	6149
11437	42	22	314	5582	0	5960
11438	5475	24	95	347	0	5941
11439	5623	24	63	124	0	5834
11440	369	24	27	5515	0	5935
11441	149	31	5169	332	0	5681
11442	112	5289	279	121	0	5801
11443	61	298	96	5437	0	5892
11444	50	72	100	5690	0	5912
11445	53	64	52	5851	0	6020
11446	5567	23	32	467	0	6089
11447	358	23	5309	184	0	5874
11448	5817	10	299	161	0	6287
11449	376	35	76	5484	0	5971
11450	114	5689	73	336	0	6212
11451	5846	320	30	136	0	6332
11452	5965	67	42	144	0	6218
11453	392	72	5440	109	0	6013
11454	151	5492	318	91	0	6052
11455	104	5339	78	61	0	5582
11456	5054	299	64	74	0	5491
11457	296	86	29	5181	0	5592
11458	93	73	28	5451	0	5645
11459	100	44	21	5366	0	5531
11460	79	4790	46	385	0	5300
11461	67	5319	41	164	0	5591
11462	5139	312	40	132	0	5623
11463	308	117	38	5216	0	5679
11464	117	77	5080	327	0	5601
11465	102	23	267	5908	0	6300
11466	87	22	6087	416	0	6612
11467	76	41	6208	172	0	6497
11468	70	73	6036	143	0	6322
11469	68	6077	422	87	0	6654
11470	63	349	159	5686	0	6257
11471	53	6201	108	372	0	6734
11472	65	387	70	6206	0	6728
11473	70	109	49	6627	0	6855
11474	6258	82	66	504	0	6910
11475	348	45	77	6458	0	6928
11476	6813	38	63	474	0	7388
11477	7139	48	53	172	0	7412
11478	498	64	54	6631	0	7247
11479	209	6652	53	442	0	7356
11480	146	398	36	6573	0	7153
11481	106	6698	42	472	0	7318
11482	81	433	44	6993	0	7551
11483	76	141	6459	521	0	7197
11484	75	112	378	6920	0	7485
11485	88	64	112	7283	0	7547
11486	6587	58	98	574	0	7317
11487	390	6663	54	293	0	7400
11488	143	415	52	6853	0	7463
11489	118	151	59	6612	0	6940
11490	104	6401	57	510	0	7072
11491	95	396	59	6650	0	7200
11492	6195	136	67	571	0	6969
11493	6519	106	68	248	0	6941
11494	513	6309	67	200	0	7089
11495	174	342	27	5634	0	6177
11496	5422	102	28	395	0	5947
11497	324	5549	33	176	0	6082
11498	105	358	24	5289	0	5776
11499	114	5502	31	380	0	6027
11500	5621	379	31	158	0	6189
11501	369	141	5379	128	0	6017
11502	111	110	5554	129	0	5904
11503	111	955	379	4710	0	6155
11504	100	103	5488	361	0	6052
11505	74	46	335	4733	0	5188
11506	4673	53	114	405	0	5245
11507	333	71	4450	176	0	5030
11508	143	70	286	4623	0	5122
11509	111	63	112	4918	0	5204
11510	4611	52	97	414	0	5174
11511	280	4572	76	215	0	5143
11512	4617	317	35	190	0	5159
11513	4798	102	35	149	0	5084
11514	389	4522	60	120	0	5091
11515	172	280	67	4715	0	5234
11516	132	100	4386	354	0	4972
11517	82	99	266	4545	0	4992
11518	91	4572	83	369	0	5115
11519	4656	303	74	163	0	5196
11520	347	114	57	4707	0	5225
11521	147	117	4618	332	0	5214
11522	108	85	284	4889	0	5366
11523	68	81	111	5176	0	5436
11524	76	65	87	5256	0	5484
11525	68	70	62	5266	0	5466
11526	95	57	43	5265	0	5460
11527	65	79	4600	507	0	5251
11528	63	112	4544	235	0	4954
11529	53	4493	305	212	0	5063
11530	57	4900	122	160	0	5239
11531	4850	334	91	162	0	5437
11532	310	143	4664	147	0	5264
11533	4817	107	286	156	0	5366
11534	364	57	4808	129	0	5358
11535	83	32	2753	45	0	2913
11536	59	41	160	2769	0	3029
11537	2824	27	89	166	0	3106
11538	121	25	67	2875	0	3088
11539	57	27	37	2979	0	3100
11540	57	23	2681	219	0	2980
11541	45	22	128	2826	0	3021
11542	35	20	71	2957	0	3083
11543	32	26	46	2965	0	3069
11544	48	37	20	2973	0	3078
11545	44	27	21	3028	0	3120
11546	2812	29	26	231	0	3098
11547	138	28	15	2946	0	3127
11548	67	27	2385	184	0	2663
11549	51	20	116	2563	0	2750
11550	37	19	2441	179	0	2676
11551	30	16	142	2532	0	2720
11552	26	19	2436	188	0	2669
11553	23	11	141	2516	0	2691
11554	15	14	79	2610	0	2718
11555	26	18	2420	197	0	2661
11556	2295	20	120	130	0	2565
11557	116	11	2402	104	0	2633
11558	56	10	140	2517	0	2723
11559	3539	15	72	157	0	3783
11560	138	16	49	3733	0	3936
11561	75	9	27	3831	0	3942
11562	62	20	4941	190	0	5213
11563	40	4754	116	129	0	5039
11564	20	4908	83	102	0	5113
11565	10	4304	39	59	0	4412
11566	6	52	23	4063	0	4144
11567	4065	13	11	80	0	4169
11568	56	8	6	4005	0	4075
11569	16	3	22	4239	0	4280
11570	17	2	17	4256	0	4292
11571	11	4	20	4259	0	4294
11572	7	3951	18	112	0	4088
11573	19	52	6	4302	0	4379
11574	8	21	7	4281	0	4317
11575	12	4043	11	120	0	4186
11576	3698	9	1	21	0	3729
11577	8	13	0	3673	0	3694
11578	3663	4	0	18	0	3685
11579	3626	3	0	19	0	3648
11580	20	3457	6	12	0	3495
11581	18	8	1	3696	0	3723
11582	5	18	3553	12	0	3588
11583	8	16	3403	12	0	3439
11584	5	4	19	3550	0	3578
11585	3711	3	16	12	0	3742
11586	3635	0	4	14	0	3653
11587	19	4	4	3637	0	3664
11588	3720	2	1	16	0	3739
11589	15	3444	6	28	0	3493
11590	3656	9	6	20	0	3691
11591	15	3440	8	24	0	3487
11592	17	18	0	3655	0	3690
11593	13	13	1	3605	0	3632
11594	2	3471	4	36	0	3513
11595	3636	16	0	22	0	3674
11596	17	24	4664	8	0	4713
11597	23	7	8	4509	0	4547
11598	22	10	5713	16	0	5761
11599	15	11	13	5537	0	5576
11600	5879	6	10	22	0	5917
11601	9	11	10	5768	0	5798
11602	5839	1	11	23	0	5874
11603	5752	0	18	17	0	5787
11604	23	1	7	5680	0	5711
11605	30	3	5647	19	0	5699
11606	17	5214	22	24	0	5277
11607	12	9	10	5820	0	5851
11608	5813	12	6	20	0	5851
11609	22	17	5549	18	0	5606
11610	29	13	9	5435	0	5486
11611	12	11	10	5581	0	5614
11612	4	6	6	5776	0	5792
11613	5821	9	3	36	0	5869
11614	12	11	3	5663	0	5689
11615	23	6	3	5743	0	5775
11616	15	5	5860	27	0	5907
11617	1	3	21	5633	0	5658
11618	4	1	19	5809	0	5833
11619	5	0	9	5983	0	5997
11620	15	5560	10	39	0	5624
11621	11	9	3	5319	0	5342
11622	12	10	1	5238	0	5261
11623	5176	8	7	30	0	5221
11624	17	11	5048	32	0	5108
11625	12	19	4761	20	0	4812
11626	6	4687	44	19	0	4756
11627	4	20	13	5249	0	5286
11628	5278	14	9	19	0	5320
11629	16	6	11	5126	0	5159
11630	19	2	8	5117	0	5146
11631	9	6	4	5231	0	5250
11632	4	2	6	5154	0	5166
11633	10	6	2	5132	0	5150
11634	9	3	5096	44	0	5152
11635	8	2	13	5031	0	5054
11636	5231	3	16	34	0	5284
11637	11	4830	16	35	0	4892
11638	11	9	1	5202	0	5223
11639	5	17	4	5182	0	5208
11640	8	15	5062	37	0	5122
11641	3	6	11	4804	0	4824
11642	7	2	14	5091	0	5114
11643	5174	1	11	31	0	5217
11644	16	4883	23	28	0	4950
11645	12	17	12	5110	0	5151
11646	5	15	3	5071	0	5094
11647	9	11	4	5509	0	5533
11648	14	9	5576	42	0	5641
11649	10	23	5084	43	0	5160
11650	5	5033	49	37	0	5124
11651	2	5331	35	26	0	5394
11652	5	35	10	5654	0	5704
11653	2	5143	27	40	0	5212
11654	6	34	9	5608	0	5657
11655	5	23	10	5579	0	5617
11656	7	17	8	6509	0	6541
11657	7	10	8	7831	0	7856
11658	3	42	7597	112	0	7754
11659	2	10	103	7139	0	7254
11660	5	19	69	6947	0	7040
11661	2	9	40	7187	0	7238
11662	5485	11	17	280	0	5793
11663	98	5566	36	185	0	5885
11664	65	114	36	5215	0	5430
11665	37	5643	40	223	0	5943
11666	5418	144	27	175	0	5764
11667	4755	91	24	153	0	5023
11668	168	6469	26	115	0	6778
11669	90	6444	13	87	0	6634
11670	65	229	5884	71	0	6249
11671	53	6322	98	81	0	6554
11672	56	187	58	6454	0	6755
11673	6395	116	45	164	0	6720
11674	147	6346	29	115	0	6637
11675	77	192	27	6481	0	6777
11676	62	140	44	6531	0	6777
11677	41	140	33	6615	0	6829
11678	6482	87	29	262	0	6860
11679	160	109	6055	179	0	6503
11680	6052	92	105	141	0	6390
11681	185	6249	69	128	0	6631
11682	112	162	45	6563	0	6882
11683	80	142	6170	225	0	6617
11684	5690	88	135	154	0	6067
11685	190	6225	97	92	0	6604
11686	125	184	69	6280	0	6658
11687	111	6246	55	172	0	6584
11688	64	212	52	6425	0	6753
11689	71	130	43	6542	0	6786
11690	72	108	6643	249	0	7072
11691	57	107	6574	190	0	6928
11692	67	80	155	6971	0	7273
11693	52	99	6855	223	0	7229
11694	43	64	157	6889	0	7153
11695	35	52	116	6903	0	7106
11696	47	46	105	6228	0	6426
11697	5921	46	117	303	0	6387
11698	143	22	106	5273	0	5544
11699	84	58	4915	259	0	5316
11700	4979	44	145	232	0	5400
11701	139	55	90	5225	0	5509
11702	98	42	79	5316	0	5535
11703	5070	39	69	314	0	5492
11704	161	5232	75	259	0	5727
11705	110	132	101	5503	0	5846
11706	99	73	79	5663	0	5914
11707	5438	74	53	336	0	5901
11708	169	67	5134	273	0	5643
11709	129	56	130	5544	0	5859
11710	93	78	76	5583	0	5830
11711	83	48	81	5482	0	5694
11712	101	5239	54	342	0	5736
11713	76	159	80	5604	0	5919
11714	5370	82	64	332	0	5848
11715	174	5314	66	245	0	5799
11716	5176	171	42	242	0	5631
11717	180	5141	46	228	0	5595
11718	5273	226	25	200	0	5724
11719	221	150	5060	176	0	5607
11720	164	124	4999	170	0	5457
11721	5134	102	162	155	0	5553
11722	220	103	5058	144	0	5525
11723	188	104	169	5138	0	5599
11724	117	105	116	5104	0	5442
11725	111	61	115	5427	0	5714
11726	5264	87	118	296	0	5765
11727	216	79	5055	206	0	5556
11728	5156	67	204	175	0	5602
11729	225	80	121	5780	0	6206
11730	5772	70	94	316	0	6252
11731	266	82	72	5833	0	6253
11732	5800	79	74	312	0	6265
11733	297	53	93	6535	0	6978
11734	194	74	6291	328	0	6887
11735	7418	73	225	228	0	7944
11736	7542	36	150	204	0	7932
11737	444	49	102	7415	0	8010
11738	269	47	91	7291	0	7698
11739	189	7137	90	475	0	7891
11740	7156	251	108	280	0	7795
11741	371	7263	99	215	0	7948
11742	7514	284	91	190	0	8079
11743	401	129	7186	243	0	7959
11744	259	117	7126	188	0	7690
11745	185	93	6990	204	0	7472
11746	7130	79	379	154	0	7742
11747	367	6705	192	128	0	7392
11748	228	259	139	6650	0	7276
11749	6480	127	141	319	0	7067
11750	361	6505	120	199	0	7185
11751	205	292	98	7062	0	7657
11752	169	6843	81	361	0	7454
11753	129	6902	75	223	0	7329
11754	152	7433	52	174	0	7811
11755	6971	421	65	142	0	7599
11756	241	6151	42	100	0	6534
11757	98	4802	44	38	0	4982
11758	36	4723	11	15	0	4785
11759	4722	178	14	12	0	4926
11760	4822	75	9	13	0	4919
11761	202	50	4453	13	0	4718
11762	4630	31	127	14	0	4802
11763	5567	22	44	13	0	5646
11764	212	27	30	5361	0	5630
11765	5560	12	16	158	0	5746
11766	191	49	4947	62	0	5249
11767	79	5289	131	37	0	5536
11768	4524	161	49	11	0	4745
11769	163	67	29	4548	0	4807
11770	4648	43	22	150	0	4863
11771	192	41	4164	53	0	4450
11772	4501	30	122	34	0	4687
11773	196	29	46	4561	0	4832
11774	84	23	4333	169	0	4609
11775	61	4291	140	56	0	4548
11776	34	4598	60	51	0	4743
11777	40	216	31	4357	0	4644
11778	29	94	12	4273	0	4408
11779	24	4506	18	178	0	4726
11780	4593	181	12	72	0	4858
11781	4652	76	13	34	0	4775
11782	4650	48	9	26	0	4733
11783	247	4992	16	32	0	5287
11784	114	182	14	4604	0	4914
11785	79	4976	17	155	0	5227
11786	5141	195	18	54	0	5408
11787	5196	62	13	51	0	5322
11788	251	5004	23	28	0	5306
11789	5181	175	22	27	0	5405
11790	240	85	12	4541	0	4878
11791	120	41	20	4741	0	4922
11792	4624	40	32	254	0	4950
11793	4664	38	27	103	0	4832
11794	4681	42	27	62	0	4812
11795	312	38	14	4561	0	4925
11796	149	34	30	4765	0	4978
11797	106	43	4323	251	0	4723
11798	72	55	171	4625	0	4923
11799	82	58	67	4740	0	4947
11800	86	61	4467	260	0	4874
11801	73	58	4501	133	0	4765
11802	81	61	4579	72	0	4793
11803	75	52	264	4561	0	4952
11804	81	59	4230	221	0	4591
11805	66	68	221	4285	0	4640
11806	75	63	84	4490	0	4712
11807	85	78	4134	260	0	4557
11808	87	84	4231	134	0	4536
11809	81	64	221	4319	0	4685
11810	73	84	4137	220	0	4514
11811	64	109	4043	116	0	4332
11812	80	5033	237	81	0	5431
11813	5206	207	109	59	0	5581
11814	5331	116	73	50	0	5570
11815	5277	93	43	47	0	5460
11816	315	4951	43	54	0	5363
11817	166	5195	34	72	0	5467
11818	134	248	35	5207	0	5624
11819	107	108	51	5408	0	5674
11820	113	90	4930	252	0	5385
11821	114	50	189	5255	0	5608
11822	5227	55	89	277	0	5648
11823	258	50	76	4677	0	5061
11824	116	5014	67	247	0	5444
11825	5274	192	64	104	0	5634
11826	5331	93	57	118	0	5599
11827	5403	68	66	69	0	5606
11828	313	77	5906	89	0	6385
11829	157	46	163	5757	0	6123
11830	5890	27	93	192	0	6202
11831	188	41	5660	141	0	6030
11832	124	5560	173	100	0	5957
11833	67	5101	60	72	0	5300
11834	4064	134	823	70	0	5091
11835	63	3964	23	23	0	4073
11836	38	45	18	4079	0	4180
11837	41	37	4978	44	0	5100
11838	26	25	38	4968	0	5057
11839	5190	15	25	73	0	5303
11840	46	4862	42	41	0	4991
11841	5166	40	21	31	0	5258
11842	72	24	4900	21	0	5017
11843	34	22	49	4919	0	5024
11844	27	5697	39	61	0	5824
11845	28	44	20	6089	0	6181
11846	6100	21	19	65	0	6205
11847	6068	20	13	41	0	6142
11848	6036	14	16	33	0	6099
11849	6049	9	25	32	0	6115
11850	65	10	25	6013	0	6113
11851	22	16	5294	64	0	5396
11852	17	24	52	5296	0	5389
11853	19	5060	41	73	0	5193
11854	5525	36	23	51	0	5635
11855	55	30	5393	23	0	5501
11856	5261	24	52	26	0	5363
11857	58	14	38	5480	0	5590
11858	32	15	5421	78	0	5546
11859	24	15	50	5363	0	5452
11860	5489	18	39	66	0	5612
11861	5419	13	21	51	0	5504
11862	5378	10	31	29	0	5448
11863	41	6	4773	11	0	4831
11864	15	6	30	4554	0	4605
11865	10	9	4831	33	0	4883
11866	7	4559	31	24	0	4621
11867	4846	21	10	16	0	4893
11868	27	4595	17	16	0	4655
11869	5040	21	14	8	0	5083
11870	26	8	17	4953	0	5004
11871	8	4727	22	26	0	4783
11872	4972	19	7	24	0	5022
11873	23	15	4831	11	0	4880
11874	13	4	23	4805	0	4845
11875	4947	8	10	30	0	4995
11876	35	7	4809	16	0	4867
11877	20	3	25	4764	0	4812
11878	12	4600	22	29	0	4663
11879	10	22	12	4990	0	5034
11880	7	10	11	4917	0	4945
11881	4910	12	6	32	0	4960
11882	39	4691	19	17	0	4766
11883	0	1	0	4420	0	4421
11884	0	4237	9	0	0	4246
11885	0	1	0	4425	0	4426
11886	1	4186	8	2	0	4197
11887	4299	1	1	1	0	4302
11888	3	8	4206	1	0	4218
11889	3	0	1	4173	0	4177
11890	0	1	0	4245	0	4246
11891	0	1	1	4268	0	4270
11892	0	2	0	4237	0	4239
11893	3	3	4271	0	0	4277
11894	0	4044	21	3	0	4068
11895	4432	0	1	2	0	4435
11896	4408	1	1	0	0	4410
11897	1	4261	8	3	0	4273
11898	4473	0	0	1	0	4474
11899	4374	1	0	1	0	4376
11900	1	4287	9	4	0	4301
11901	0	4	0	4457	0	4461
11902	0	4278	7	2	0	4287
11903	4393	1	1	1	0	4396
11904	4	5	4337	0	0	4346
11905	3787	1	1	5	0	3794
11906	4	8	4330	0	0	4342
11907	2	1	2	4182	0	4187
11908	4367	0	0	1	0	4368
11909	2	5	4205	2	0	4214
11910	4005	0	5	3	0	4013
11911	4266	1	1	1	0	4269
11912	0	2	1	4008	0	4011
11913	1	3755	13	4	0	3773
11914	4118	0	2	1	0	4121
11915	1	0	0	4043	0	4044
11916	0	3779	12	2	0	3793
11917	4040	0	7	1	0	4048
11918	0	3	0	4031	0	4034
11919	1	3804	7	3	0	3815
11920	1	0	0	4092	0	4093
11921	4082	0	2	1	0	4085
11922	4018	0	1	3	0	4022
11923	4020	1	1	1	0	4023
11924	5	2	1	3795	0	3803
11925	0	2	0	3959	0	3961
11926	3	4	3889	0	0	3896
11927	0	7	1	3882	0	3890
11928	1	1	3126	6	0	3134
11929	4	5	2963	3	0	2975
11930	3	4	2977	7	0	2991
11931	1	2835	19	5	0	2860
11932	2	4	6	3079	0	3091
11933	0	2918	13	3	0	2934
11934	3292	8	0	0	0	3300
11935	3217	4	1	6	0	3228
11936	12	5	0	3213	0	3230
11937	16	5	2967	11	0	2999
11938	9	1	52	2975	0	3037
11939	3	9	3404	63	0	3479
11940	1	6	65	3310	0	3382
11941	0	3213	30	61	0	3304
11942	1	3425	16	32	0	3474
11943	3431	71	3	14	0	3519
11944	55	31	2644	4	0	2734
11945	30	13	56	2655	0	2754
11946	15	5	24	3295	0	3339
11947	3273	5	12	83	0	3373
11948	61	3122	13	40	0	3236
11949	3275	59	8	19	0	3361
11950	69	3176	13	13	0	3271
11951	3314	70	5	12	0	3401
11952	3291	30	7	9	0	3337
11953	86	20	6	3254	0	3366
11954	46	13	3174	63	0	3296
11955	3114	11	63	35	0	3223
11956	69	3161	32	20	0	3282
11957	3305	61	20	11	0	3397
11958	79	30	3	3253	0	3365
11959	40	18	10	3274	0	3342
11960	24	3313	10	83	0	3430
11961	12	65	8	3382	0	3467
11962	18	3341	11	71	0	3441
11963	15	74	3	3217	0	3309
11964	18	30	3	3254	0	3305
11965	3175	22	5	97	0	3299
11966	75	17	3050	54	0	3196
11967	36	3028	65	23	0	3152
11968	22	59	25	3192	0	3298
11969	3484	36	9	73	0	3602
11970	3552	16	3	45	0	3616
11971	4406	10	7	28	0	4451
11972	228	16	4097	16	0	4357
11973	4310	14	159	21	0	4504
11974	200	14	37	4368	0	4619
11975	4275	10	17	195	0	4497
11976	198	4173	20	58	0	4449
11977	64	173	15	4371	0	4623
11978	4294	45	12	193	0	4544
11979	181	5169	32	66	0	5448
11980	66	272	6	5343	0	5687
11981	32	70	4969	301	0	5372
11982	5178	30	238	70	0	5516
11983	5552	23	41	35	0	5651
11984	344	41	4971	26	0	5382
11985	91	4957	268	30	0	5346
11986	55	5387	56	25	0	5523
11987	45	315	21	5244	0	5625
11988	39	77	23	5448	0	5587
11989	26	43	27	5620	0	5716
11990	40	37	5068	362	0	5507
11991	5159	33	257	106	0	5555
11992	5558	23	53	71	0	5705
11993	5591	25	37	44	0	5697
11994	5447	25	25	39	0	5536
11995	5400	31	24	30	0	5485
11996	5395	30	25	42	0	5492
11997	369	25	21	6276	0	6691
11998	124	37	5857	331	0	6349
11999	80	33	6054	85	0	6252
12000	66	27	307	6140	0	6540
12001	53	26	74	6259	0	6412
12002	57	33	38	6022	0	6150
12003	62	6116	43	342	0	6563
12004	6090	297	26	105	0	6518
12005	337	6138	26	75	0	6576
12006	111	318	30	6289	0	6748
12007	6031	79	36	342	0	6488
12008	328	6086	41	98	0	6553
12009	115	315	24	6240	0	6694
12010	82	80	23	6536	0	6721
12011	71	43	29	6474	0	6617
12012	60	5480	25	402	0	5967
12013	50	309	24	6301	0	6684
12014	51	101	5856	408	0	6416
12015	46	67	293	6272	0	6678
12016	53	48	83	6440	0	6624
12017	52	45	47	6527	0	6671
12018	46	39	31	6823	0	6939
12019	70	58	5769	496	0	6393
12020	54	6181	297	198	0	6730
12021	71	337	82	6256	0	6746
12022	57	105	58	6674	0	6894
12023	70	63	41	6412	0	6586
12024	57	5883	60	483	0	6483
12025	51	6498	46	212	0	6807
12026	6326	392	49	166	0	6933
12027	343	128	33	6262	0	6766
12028	114	86	5971	454	0	6625
12029	68	6240	322	187	0	6817
12030	6413	370	87	146	0	7016
12031	381	138	6284	114	0	6917
12032	134	86	6387	132	0	6739
12033	85	75	6468	141	0	6769
12034	64	65	397	6291	0	6817
12035	95	70	6031	414	0	6610
12036	57	6013	375	181	0	6626
12037	32	299	114	5505	0	5950
12038	48	91	5356	359	0	5854
12039	52	59	298	5170	0	5579
12040	5109	48	104	370	0	5631
12041	319	68	4886	146	0	5419
12042	4991	56	295	131	0	5473
12043	323	4983	114	96	0	5516
12044	5121	307	67	115	0	5610
12045	344	88	60	5143	0	5635
12046	4634	59	77	375	0	5145
12047	4821	56	73	149	0	5099
12048	4662	75	77	99	0	4913
12049	375	4849	68	105	0	5397
12050	5007	275	80	108	0	5470
12051	5240	80	65	90	0	5475
12052	387	83	4669	85	0	5224
12053	152	4895	278	91	0	5416
12054	106	310	86	4869	0	5371
12055	87	111	69	5144	0	5411
12056	75	71	71	5275	0	5492
12057	88	51	4760	417	0	5316
12058	65	66	288	5685	0	6104
12059	89	46	5442	407	0	5984
12060	5520	60	311	169	0	6060
12061	5858	62	112	125	0	6157
12062	383	78	5337	137	0	5935
12063	5584	46	283	137	0	6050
12064	5801	50	118	125	0	6094
12065	5879	55	67	116	0	6117
12066	408	52	69	5610	0	6139
12067	159	58	5286	388	0	5891
12068	119	5422	283	168	0	5992
12069	115	275	97	5076	0	5563
12070	110	121	5003	329	0	5563
12071	62	67	4082	127	0	4338
12072	3470	38	198	113	0	3819
12073	166	3632	81	104	0	3983
12074	3695	167	53	113	0	4028
12075	4227	40	62	106	0	4435
12076	192	4131	81	78	0	4482
12077	4270	163	76	66	0	4575
12078	219	91	4793	79	0	5182
12079	95	34	3711	40	0	3880
12080	87	19	3737	49	0	3892
12081	54	3736	103	46	0	3939
12082	3846	62	72	44	0	4024
12083	3798	40	59	64	0	3961
12084	99	3701	75	55	0	3930
12085	68	3818	71	54	0	4011
12086	48	102	46	3819	0	4015
12087	51	76	46	3869	0	4042
12088	3840	41	41	104	0	4026
12089	90	3891	39	72	0	4092
12090	3963	80	49	37	0	4129
12091	3925	50	23	47	0	4045
12092	121	35	4417	50	0	4623
12093	107	4362	79	30	0	4578
12094	77	89	45	4576	0	4787
12095	4607	58	56	53	0	4774
12096	119	42	50	4991	0	5202
12097	3890	11	49	43	0	3993
12098	47	20	3782	33	0	3882
12099	40	3604	55	39	0	3738
12100	52	3800	38	19	0	3909
12101	40	64	19	3743	0	3866
12102	37	3771	18	33	0	3859
12103	3843	60	30	24	0	3957
12104	34	53	3719	35	0	3841
12105	3585	40	34	34	0	3693
12106	56	22	3759	28	0	3865
12107	56	27	41	3731	0	3855
12108	58	18	34	3725	0	3835
12109	50	13	33	3844	0	3940
12110	3860	15	22	65	0	3962
12111	53	22	3760	46	0	3881
12112	43	14	37	3765	0	3859
12113	39	13	29	3774	0	3855
12114	33	3638	20	80	0	3771
12115	42	3730	14	58	0	3844
12116	13	3219	17	12	0	3261
12117	11	12	11	3321	0	3355
12118	1	1	0	3083	0	3085
12119	0	3019	2	3	0	3024
12120	0	3034	4	2	0	3040
12121	3310	1	1	0	0	3312
12122	1	4	1	3296	0	3302
12123	1	3196	5	3	0	3205
12124	3345	0	0	1	0	3346
12125	0	2	0	3289	0	3291
12126	3456	0	1	0	0	3457
12127	3	2	0	3399	0	3404
12128	5	9	4548	3	0	4565
12129	0	4477	12	3	0	4492
12130	4538	4	1	0	0	4543
12131	10	6	4558	0	0	4574
12132	1	4416	11	1	0	4429
12133	0	5	1	4683	0	4689
12134	0	2	0	4630	0	4632
12135	0	1	0	4501	0	4502
12136	0	3	0	4536	0	4539
12137	1	3	4635	4	0	4643
12138	2	4429	13	7	0	4451
12139	0	2	1	4693	0	4696
12140	4588	2	1	5	0	4596
12141	4	4533	2	4	0	4543
12142	3	2	1	5132	0	5138
12143	8	7	5037	35	0	5087
12144	0	4889	50	13	0	4952
12145	9	41	6	5059	0	5115
12146	1	5121	11	26	0	5159
12147	5412	37	3	6	0	5458
12148	5298	8	3	8	0	5317
12149	47	10	4866	0	0	4923
12150	4707	5	37	6	0	4755
12151	4911	3	7	3	0	4924
12152	57	17	4934	0	0	5008
12153	16	4878	65	5	0	4964
12154	11	45	11	5180	0	5247
12155	10	6	5	5291	0	5312
12156	5234	4	5	60	0	5303
12157	58	3	5	5197	0	5263
12158	6	9	4624	60	0	4699
12159	4442	3	43	15	0	4503
12160	63	13	4447	10	0	4533
12161	14	4390	62	18	0	4484
12162	4546	53	13	4	0	4616
12163	60	10	4590	3	0	4663
12164	19	17	4275	1	0	4312
12165	9	4266	68	11	0	4354
12166	6	60	8	4633	0	4707
12167	7	15	4531	60	0	4613
12168	8	9	58	4170	0	4245
12169	3	6	15	4577	0	4601
12170	7	10	4456	68	0	4541
12171	6	4203	69	21	0	4299
12172	5	53	17	4604	0	4679
12173	4573	13	13	63	0	4662
12174	4578	7	10	18	0	4613
12175	64	7	9	4541	0	4621
12176	18	11	4448	65	0	4542
12177	18	12	4404	15	0	4449
12178	8	2	69	3907	0	3986
12179	13	9	3898	65	0	3985
12180	3636	3	65	19	0	3723
12181	58	9	24	3872	0	3963
12182	11	5	11	3941	0	3968
12183	7	3732	22	78	0	3839
12184	9	59	12	4954	0	5034
12185	12	20	4753	68	0	4853
12186	4558	8	59	27	0	4652
12187	4895	6	16	17	0	4934
12188	75	6	4750	14	0	4845
12189	14	6	62	4587	0	4669
12190	14	6	20	4810	0	4850
12191	15	11	5571	65	0	5662
12192	9	6	76	4949	0	5040
12193	9	4	17	5000	0	5030
12194	10	4871	27	82	0	4990
12195	4	74	9	5136	0	5223
12196	8	11	14	4869	0	4902
12197	4832	10	11	92	0	4945
12198	5193	9	10	37	0	5249
12199	5262	8	15	23	0	5308
12200	5279	8	16	19	0	5322
12201	5297	4	11	21	0	5333
12202	106	9	5020	21	0	5156
12203	34	11	75	5031	0	5151
12204	32	10	18	5289	0	5349
12205	25	16	4989	95	0	5125
12206	5015	5	84	41	0	5145
12207	5288	6	26	38	0	5358
12208	92	14	4956	24	0	5086
12209	5050	6	79	31	0	5166
12210	5253	7	21	28	0	5309
12211	113	14	5024	19	0	5170
12212	44	11	82	4808	0	4945
12213	43	5361	38	88	0	5530
12214	35	94	24	5676	0	5829
12215	34	22	26	5703	0	5785
12216	36	19	21	5783	0	5859
12217	29	18	5583	147	0	5777
12218	5434	12	118	65	0	5629
12219	5742	7	33	50	0	5832
12220	139	7	28	5723	0	5897
12221	62	13	5373	124	0	5572
12222	50	8	123	5344	0	5525
12223	38	18	5276	136	0	5468
12224	41	16	5112	54	0	5223
12225	30	4876	147	586	0	5639
12226	23	63	53	5748	0	5887
12227	5738	17	42	136	0	5933
12228	4366	19	37	52	0	4474
12229	4393	16	27	50	0	4486
12230	147	10	27	4206	0	4390
12231	61	4112	33	126	0	4332
12232	61	92	20	4365	0	4538
12233	50	31	4186	133	0	4400
12234	4210	32	111	53	0	4406
12235	4141	17	275	75	0	4508
12236	120	15	53	4326	0	4514
12237	59	12	39	4385	0	4495
12238	66	9	35	4450	0	4560
12239	71	12	4139	154	0	4376
12240	3748	8	115	88	0	3959
12241	137	4041	48	74	0	4300
12242	46	3617	44	61	0	3768
12243	38	69	3591	66	0	3764
12244	240	26	96	3468	0	3830
12245	36	35	3423	95	0	3589
12246	3372	28	88	57	0	3545
12247	93	20	35	3530	0	3678
12248	62	16	3411	94	0	3583
12249	67	3926	88	55	0	4136
12250	3989	87	40	46	0	4162
12251	134	32	3904	60	0	4130
12252	40	3609	97	41	0	3787
12253	37	3793	47	48	0	3925
12254	3784	90	42	42	0	3958
12255	106	36	32	3798	0	3972
12256	47	28	3705	110	0	3890
12257	41	3709	92	69	0	3911
12258	3795	83	34	55	0	3967
12259	3750	22	43	41	0	3856
12260	117	3632	35	31	0	3815
12261	68	86	3702	30	0	3886
12262	55	45	98	3785	0	3983
12263	3836	36	38	99	0	4009
12264	3886	33	43	47	0	4009
12265	112	20	3709	70	0	3911
12266	46	18	106	3678	0	3848
12267	62	15	34	3865	0	3976
12268	55	23	3719	120	0	3917
12269	52	29	3637	56	0	3774
12270	4120	28	106	38	0	4292
12271	4217	19	47	44	0	4327
12272	4247	19	64	42	0	4372
12273	4284	28	32	54	0	4398
12274	145	38	4046	25	0	4254
12275	4165	19	102	41	0	4327
12276	139	22	44	4124	0	4329
12277	60	26	4061	126	0	4273
12278	62	31	3994	38	0	4125
12279	68	4001	126	44	0	4239
12280	57	103	52	4086	0	4298
12281	43	32	4067	112	0	4254
12282	3974	39	123	49	0	4185
12283	118	33	49	3482	0	3682
12284	62	3231	55	84	0	3432
12285	3300	97	38	42	0	3477
12286	3359	31	37	41	0	3468
12287	125	30	3155	60	0	3370
12288	72	3175	111	39	0	3397
12289	56	92	41	3293	0	3482
12290	3280	33	55	105	0	3473
12291	98	19	12	2343	0	2472
12292	49	18	2245	79	0	2391
12293	2222	8	74	29	0	2333
12294	95	3215	37	23	0	3370
12295	42	3207	36	21	0	3306
12296	33	3339	22	26	0	3420
12297	3419	82	16	27	0	3544
12298	3007	23	27	13	0	3070
12299	3014	27	17	9	0	3067
12300	92	17	16	2955	0	3080
12301	40	10	2875	77	0	3002
12302	32	10	73	2942	0	3057
12303	2995	5	21	81	0	3102
12304	79	10	18	2978	0	3085
12305	3143	18	11	78	0	3250
12306	3189	13	10	28	0	3240
12307	3141	8	20	16	0	3185
12308	101	3018	18	13	0	3150
12309	3141	74	10	20	0	3245
12310	88	31	3032	20	0	3171
12311	43	21	3028	22	0	3114
12312	30	3011	93	21	0	3155
12313	10	38	11	2577	0	2636
12314	2595	15	8	39	0	2657
12315	50	7	2517	8	0	2582
12316	2462	10	37	4	0	2513
12317	48	4	15	2427	0	2494
12318	15	2843	13	35	0	2906
12319	9	42	8	2959	0	3018
12320	17	12	3082	46	0	3157
12321	2927	4	47	15	0	2993
12322	46	7	3124	8	0	3185
12323	12	7	2712	14	0	2745
12324	2635	5	42	6	0	2688
12325	41	2258	23	7	0	2329
12326	2451	32	10	2	0	2495
12327	2461	8	8	1	0	2478
12328	50	5	2367	2	0	2424
12329	3183	5	34	4	0	3226
12330	133	6	3166	5	0	3310
12331	23	15	3975	1	0	4014
12332	17	10	3925	9	0	3961
12333	14	3879	124	8	0	4025
12334	4143	111	23	9	0	4286
12335	4206	13	19	1	0	4239
12336	4247	5	7	7	0	4266
12337	4232	10	5	8	0	4255
12338	145	12	3973	2	0	4132
12339	30	2	111	4012	0	4155
12340	18	4	15	4236	0	4273
12341	4133	7	10	126	0	4276
12342	120	3961	18	16	0	4115
12343	20	113	7	4157	0	4297
12344	4149	14	10	122	0	4295
12345	126	10	4030	16	0	4182
12346	25	14	112	3952	0	4103
12347	25	8	4349	133	0	4515
12348	15	4193	142	18	0	4368
12349	3	80	24	3908	0	4015
12350	3889	8	12	88	0	3997
12351	80	13	6	3888	0	3987
12352	25	16	3796	92	0	3929
12353	14	3676	86	17	0	3793
12354	4201	83	5	4	0	4293
12355	96	13	4138	6	0	4253
12356	3998	3	93	2	0	4096
12357	81	4003	21	20	0	4125
12358	4261	85	3	11	0	4360
12359	4321	10	10	6	0	4347
12360	94	16	9	4200	0	4319
12361	20	16	4121	107	0	4264
12362	32	3965	108	11	0	4116
12363	12	86	28	4859	0	4985
12364	18	7	19	5241	0	5285
12365	15	9	25	5380	0	5429
12366	24	18	9	5316	0	5367
12367	23	6535	15	139	0	6712
12368	6790	132	7	27	0	6956
12369	142	6623	23	34	0	6822
12370	36	144	18	7184	0	7382
12371	7201	37	8	168	0	7414
12372	175	21	10	7155	0	7361
12373	53	29	6852	188	0	7122
12374	44	7149	163	64	0	7420
12375	25	185	43	7396	0	7649
12376	29	45	18	7714	0	7806
12377	7582	23	26	217	0	7848
12378	173	31	7320	85	0	7609
12379	7311	19	177	49	0	7556
12380	7583	28	53	29	0	7693
12381	7691	18	24	49	0	7782
12382	230	29	7394	38	0	7691
12383	91	32	175	7300	0	7598
12384	57	21	55	7602	0	7735
12385	38	42	7354	231	0	7665
12386	54	35	7667	86	0	7842
12387	7660	36	210	47	0	7953
12388	204	14	74	7852	0	8144
12389	7906	16	43	196	0	8161
12390	7978	21	32	95	0	8126
12391	253	10	31	7855	0	8149
12392	101	43	8291	223	0	8658
12393	7932	19	241	119	0	8311
12394	265	17	88	7605	0	7975
12395	119	37	7221	260	0	7637
12396	68	7335	250	111	0	7764
12397	7501	238	83	63	0	7885
12398	268	7488	63	70	0	7889
12399	132	277	37	6735	0	7181
12400	78	7535	44	218	0	7875
12401	7522	262	42	112	0	7938
12402	7609	90	41	83	0	7823
12403	311	7482	58	94	0	7945
12404	7650	252	61	78	0	8041
12405	7560	84	51	66	0	7761
12406	330	7307	46	95	0	7778
12407	7441	256	42	80	0	7819
12408	330	99	42	7391	0	7862
12409	157	53	40	7688	0	7938
12410	7543	40	53	332	0	7968
12411	334	41	50	7052	0	7477
12412	146	7533	60	262	0	8001
12413	7641	257	66	106	0	8070
12414	7583	107	44	89	0	7823
12415	313	7541	48	100	0	8002
12416	7737	274	49	71	0	8131
12417	7831	92	52	77	0	8052
12418	362	68	48	7345	0	7823
12419	196	71	7034	275	0	7576
12420	163	6925	231	125	0	7444
12421	7172	270	87	90	0	7619
12422	7403	98	43	95	0	7639
12423	740	77	6556	84	0	7457
12424	7222	67	228	84	0	7601
12425	371	64	6830	83	0	7348
12426	7138	60	259	94	0	7551
12427	339	67	104	7095	0	7605
12428	189	89	6920	291	0	7489
12429	120	71	6022	83	0	6296
12430	96	76	192	5711	0	6075
12431	95	68	91	5116	0	5370
12432	118	67	4884	214	0	5283
12433	129	42	160	5030	0	5361
12434	111	68	4910	194	0	5283
12435	125	61	166	5018	0	5370
12436	147	47	85	4843	0	5122
12437	124	4813	75	209	0	5221
12438	140	4876	71	120	0	5207
12439	119	5049	48	99	0	5315
12440	101	213	58	5002	0	5374
12441	131	103	60	5148	0	5442
12442	101	78	4756	271	0	5206
12443	4849	58	160	147	0	5214
12444	5079	63	94	99	0	5335
12445	282	4905	60	89	0	5336
12446	5082	182	58	79	0	5401
12447	245	101	45	4722	0	5113
12448	4799	74	71	186	0	5130
12449	4848	49	64	132	0	5093
12450	282	52	63	4747	0	5144
12451	4626	77	71	230	0	5004
12452	244	4532	71	134	0	4981
12453	171	4751	48	104	0	5074
12454	139	271	68	4034	0	4512
12455	153	4410	55	165	0	4783
12456	120	204	67	4274	0	4665
12457	134	122	68	4476	0	4800
12458	4443	64	60	244	0	4811
12459	251	4350	62	163	0	4826
12460	4385	195	76	95	0	4751
12461	4302	103	60	102	0	4567
12462	269	4335	66	113	0	4783
12463	3793	180	59	76	0	4108
12464	235	98	3207	100	0	3640
12465	134	3257	136	109	0	3636
12466	3334	159	83	123	0	3699
12467	146	53	1706	58	0	1963
12468	74	1669	104	72	0	1919
12469	62	1831	55	60	0	2008
12470	1464	83	31	34	0	1612
12471	1445	61	24	39	0	1569
12472	1433	49	15	38	0	1535
12473	128	1388	28	39	0	1583
12474	74	74	20	1444	0	1612
12475	1409	39	25	110	0	1583
12476	1454	41	50	48	0	1593
12477	110	53	20	1406	0	1589
12478	73	42	1350	90	0	1555
12479	68	44	1391	33	0	1536
12480	56	39	92	1350	0	1537
12481	61	34	38	1440	0	1573
12482	60	28	1365	87	0	1540
12483	58	30	77	1276	0	1441
12484	54	1377	41	105	0	1577
12485	1414	81	48	38	0	1581
12486	90	41	36	1074	0	1241
12487	1088	22	17	96	0	1223
12488	84	1004	30	69	0	1187
12489	60	1377	32	48	0	1517
12490	1413	77	30	60	0	1580
12491	93	35	1396	48	0	1572
12492	532	0	0	1	0	533
12493	0	531	1	0	0	532
12494	0	1	0	573	0	574
12495	577	0	0	0	0	577
12496	0	1	0	565	0	566
12497	574	0	0	0	0	574
12498	557	0	0	0	0	557
12499	0	541	0	1	0	542
12500	577	0	0	0	0	577
12501	0	537	2	0	0	539
12502	573	0	0	0	0	573
12503	0	0	0	549	0	549
12504	569	0	0	0	0	569
12505	0	0	0	564	0	564
12506	573	0	0	0	0	573
12507	559	1	0	1	0	561
12508	558	0	0	0	0	558
12509	567	0	0	0	0	567
12510	552	0	0	0	0	552
12511	0	0	0	552	0	552
12512	341	0	0	1	0	342
12513	0	308	0	0	0	308
12514	0	0	332	0	0	332
12515	0	0	0	329	0	329
12516	0	0	334	0	0	334
12517	0	0	0	330	0	330
12518	0	0	323	0	0	323
12519	325	0	0	0	0	325
12520	0	0	0	335	0	335
12521	0	0	335	0	0	335
12522	1	0	320	0	0	321
12523	0	1	0	331	0	332
12524	340	0	0	0	0	340
12525	0	603	0	2	0	605
12526	625	13	0	0	0	638
12527	625	4	0	1	0	630
12528	15	613	1	0	0	629
12529	630	15	0	0	0	645
12530	16	4	0	631	0	651
12531	10	1	0	629	0	640
12532	1	4	1	648	0	654
12533	623	0	0	19	0	642
12534	14	1078	1	10	0	1103
12535	6	40	0	1093	0	1139
12536	1	15	1	1153	0	1170
12537	1089	7	0	63	0	1159
12538	47	3	0	1117	0	1167
12539	16	4	1252	56	0	1328
12540	8	1327	49	21	0	1405
12541	1342	52	16	7	0	1417
12542	52	20	8	1177	0	1257
12543	24	1739	7	32	0	1802
12544	1829	57	1	20	0	1907
12545	65	28	1691	10	0	1794
12546	22	1747	54	7	0	1830
12547	1796	60	18	6	0	1880
12548	57	20	12	1811	0	1900
12549	20	16	2	1867	0	1905
12550	17	11	1783	79	0	1890
12551	6	2	56	1799	0	1863
12552	5	5	1804	71	0	1885
12553	8	9	1745	30	0	1792
12554	9	7	1780	17	0	1813
12555	1779	5	83	12	0	1879
12556	1822	5	34	5	0	1866
12557	1864	4	18	5	0	1891
12558	87	8	18	1711	0	1824
12559	44	1695	7	47	0	1793
12560	28	1808	11	25	0	1872
12561	1776	72	6	19	0	1873
12562	1755	41	1	16	0	1813
12563	78	1743	10	7	0	1838
12564	1818	54	10	17	0	1899
12565	72	34	1758	7	0	1871
12566	33	19	1772	9	0	1833
12567	22	7	84	1713	0	1826
12568	19	6	37	2190	0	2252
12569	12	7	2143	79	0	2241
12570	11	4	65	2138	0	2218
12571	2171	5	30	81	0	2287
12572	63	10	2111	31	0	2215
12573	2104	10	62	23	0	2199
12574	76	8	24	2127	0	2235
12575	44	14	2987	60	0	3105
12576	31	2978	68	35	0	3112
12577	3209	58	26	19	0	3312
12578	64	33	3091	14	0	3202
12579	3125	22	66	9	0	3222
12580	76	13	29	3176	0	3294
12581	3211	10	14	66	0	3301
12582	80	12	3104	30	0	3226
12583	37	9	64	3167	0	3277
12584	3199	6	37	64	0	3306
12585	3165	7	28	30	0	3230
12586	3206	7	12	28	0	3253
12587	3229	7	15	26	0	3277
12588	101	7	15	3160	0	3283
12589	48	6	9	2928	0	2991
12590	37	10	2794	87	0	2928
12591	21	10	67	2821	0	2919
12592	26	3	29	2812	0	2870
12593	15	2756	24	97	0	2892
12594	3104	57	20	45	0	3226
12595	3505	29	18	29	0	3581
12596	126	3422	13	21	0	3582
12597	63	95	23	3423	0	3604
12598	45	29	14	3608	0	3696
12599	3502	24	11	127	0	3664
12600	119	20	3427	60	0	3626
12601	48	4	101	3552	0	3705
12602	37	13	3470	125	0	3645
12603	3396	14	106	46	0	3562
12604	3546	7	34	38	0	3625
12605	3606	14	27	23	0	3670
12606	161	9	14	3467	0	3651
12607	70	6	15	3578	0	3669
12608	3561	14	9	139	0	3723
12609	125	11	3403	56	0	3595
12610	38	5	95	4386	0	4524
12611	4387	12	34	124	0	4557
12612	116	11	33	4355	0	4515
12613	53	15	4971	136	0	5175
12614	49	24	4801	46	0	4920
12615	4844	12	121	36	0	5013
12616	120	4835	53	30	0	5038
12617	5168	93	36	21	0	5318
12618	5212	31	20	19	0	5282
12619	141	22	17	6214	0	6394
12620	65	12	18	6188	0	6283
12621	52	5919	32	125	0	6128
12622	6214	92	27	59	0	6392
12623	120	5969	17	47	0	6153
12624	66	6088	18	31	0	6203
12625	37	106	11	5951	0	6105
12626	5952	34	13	99	0	6098
12627	5957	22	20	37	0	6036
12628	118	12	12	5869	0	6011
12629	60	13	13	5920	0	6006
12630	65	9	6	5971	0	6051
12631	5908	9	15	141	0	6073
12632	97	16	5807	71	0	5991
12633	49	5641	93	48	0	5831
12634	5469	51	18	23	0	5561
12635	57	13	22	5393	0	5485
12636	28	19	5324	58	0	5429
12637	38	12	5163	28	0	5241
12638	20	5082	69	28	0	5199
12639	19	5679	24	10	0	5732
12640	15	47	12	5910	0	5984
12641	12	5423	17	58	0	5510
12642	13	48	6	5887	0	5954
12643	15	9	4	5527	0	5555
12644	5511	10	7	57	0	5585
12645	48	7	6	5446	0	5507
12646	12	6	4	5527	0	5549
12647	21	3	5408	52	0	5484
12648	13	3	41	5425	0	5482
12649	5447	6	14	57	0	5524
12650	6013	4	14	20	0	6051
12651	56	5723	16	19	0	5814
12652	6027	46	4	12	0	6089
12653	73	17	5720	11	0	5821
12654	15	5660	55	22	0	5752
12655	16	54	7	6632	0	6709
12656	485	12	12	6216	0	6725
12657	32	16	12	7297	0	7357
12658	7300	6	8	90	0	7404
12659	7037	12	14	32	0	7095
12660	87	20	7109	20	0	7236
12661	36	13	7093	17	0	7159
12662	38	15	7035	34	0	7122
12663	19	6949	90	24	0	7082
12664	15	6874	42	36	0	6967
12665	7459	70	9	33	0	7571
12666	7413	25	8	20	0	7466
12667	78	14	8	7375	0	7475
12668	30	5	11	7062	0	7108
12669	25	6799	20	86	0	6930
12670	15	65	10	7142	0	7232
12671	18	19	6845	86	0	6968
12672	14	7337	87	29	0	7467
12673	13	76	18	7827	0	7934
12674	29	28	7644	72	0	7773
12675	26	22	67	6650	0	6765
12676	11	6532	20	79	0	6642
12677	6956	64	14	33	0	7067
12678	6910	19	7	40	0	6976
12679	6929	22	8	23	0	6982
12680	88	15	7	6810	0	6920
12681	31	23	3	6953	0	7010
12682	6942	8	7	91	0	7048
12683	75	6633	19	41	0	6768
12684	6959	73	12	25	0	7069
12685	97	26	7160	19	0	7302
12686	7416	17	98	19	0	7550
12687	7608	11	26	24	0	7669
12688	133	11	10	7496	0	7650
12689	7948	9	12	117	0	8086
12690	7861	14	12	46	0	7933
12691	137	14	8	7882	0	8041
12692	50	16	7639	122	0	7827
12693	7120	13	102	51	0	7286
12694	110	34	7574	19	0	7737
12695	27	7727	94	7	0	7855
12696	8	93	16	8348	0	8465
12697	8	29	5	8501	0	8543
12698	8698	9	8	174	0	8889
12699	155	25	8255	58	0	8493
12700	42	6	132	8456	0	8636
12701	27	8362	41	146	0	8576
12702	17	8578	29	48	0	8672
12703	12	188	13	8784	0	8997
12704	12	64	8406	167	0	8649
12705	8	24	136	8502	0	8670
12706	11	17	34	8720	0	8782
12707	17	68	8017	198	0	8300
12708	16	8259	135	62	0	8472
12709	8491	157	32	29	0	8709
12710	147	7682	19	18	0	7866
12711	43	167	9	7878	0	8097
12712	7585	53	12	170	0	7820
12713	142	6040	28	884	0	7094
12714	49	164	6730	24	0	6967
12715	6810	47	139	24	0	7020
12716	162	7420	57	20	0	7659
12717	7898	178	24	14	0	8114
12718	206	74	7449	23	0	7752
12719	6656	28	188	12	0	6884
12720	210	16	49	6699	0	6974
12721	79	28	6437	195	0	6739
12722	38	11	189	6558	0	6796
12723	24	6507	68	213	0	6812
12724	18	183	24	6271	0	6496
12725	22	58	14	6363	0	6457
12726	21	42	5840	262	0	6165
12727	26	20	174	6232	0	6452
12728	30	83	5133	238	0	5484
12729	27	5994	160	84	0	6265
12730	20	191	37	6184	0	6432
12731	27	77	5913	218	0	6235
12732	16	5888	193	75	0	6172
12733	17	6162	65	42	0	6286
12734	30	237	5999	28	0	6294
12735	30	86	6089	18	0	6223
12736	23	36	230	6097	0	6386
12737	6156	22	76	209	0	6463
12738	197	6035	35	81	0	6348
12739	68	205	24	5479	0	5776
12740	5497	73	13	215	0	5798
12741	219	5392	18	82	0	5711
12742	5487	208	17	48	0	5760
12743	225	5435	25	43	0	5728
12744	5549	222	14	28	0	5813
12745	5619	75	15	29	0	5738
12746	5591	33	24	28	0	5676
12747	273	6941	25	27	0	7266
12748	91	241	16	7106	0	7454
12749	57	126	6580	275	0	7038
12750	29	6416	264	114	0	6823
12751	26	264	91	6537	0	6918
12752	36	107	60	6842	0	7045
12753	34	92	6199	374	0	6699
12754	32	6308	262	176	0	6778
12755	5750	241	84	87	0	6162
12756	234	5770	48	60	0	6112
12757	91	258	30	5905	0	6284
12758	53	116	5736	250	0	6155
12759	5665	73	239	105	0	6082
12760	251	43	87	5930	0	6311
12761	102	55	5479	271	0	5907
12762	5479	34	251	123	0	5887
12763	248	5540	111	90	0	5989
12764	5724	245	51	64	0	6084
12765	5815	106	43	50	0	6014
12766	329	59	39	5680	0	6107
12767	149	69	5396	257	0	5871
12768	86	5450	245	112	0	5893
12769	66	259	5523	77	0	5925
12770	39	102	274	5543	0	5958
12771	23	83	111	5864	0	6081
12772	4993	54	72	342	0	5461
12773	253	49	4643	154	0	5099
12774	107	4960	240	98	0	5405
12775	62	252	90	5261	0	5665
12776	54	105	71	5752	0	5982
12777	5456	89	43	349	0	5937
12778	268	5495	38	171	0	5972
12779	132	285	22	5585	0	6024
12780	5184	131	32	318	0	5665
12781	278	5521	37	136	0	5972
12782	5607	282	33	75	0	5997
12783	5669	153	29	62	0	5913
12784	374	5489	52	72	0	5987
12785	4807	248	33	42	0	5130
12786	301	4871	27	46	0	5245
12787	4972	264	28	50	0	5314
12788	4932	107	40	41	0	5120
12789	333	4510	20	39	0	4902
12790	4661	251	23	39	0	4974
12791	4775	118	26	44	0	4963
12792	4883	73	19	39	0	5014
12793	362	71	4441	45	0	4919
12794	167	43	4233	50	0	4493
12795	117	38	3632	30	0	3817
12796	3367	33	229	25	0	3654
12797	193	24	3278	39	0	3534
12798	85	34	2957	38	0	3114
12799	74	32	190	2963	0	3259
12800	2981	22	115	144	0	3262
12801	164	55	2918	83	0	3220
12802	87	48	2978	89	0	3202
12803	79	34	178	2893	0	3184
12804	77	48	98	3016	0	3239
12805	74	53	72	3089	0	3288
12806	69	47	2834	212	0	3162
12807	78	36	130	3059	0	3303
12808	2886	53	72	192	0	3203
12809	164	2926	61	119	0	3270
12810	112	143	46	3237	0	3538
12811	100	90	44	3306	0	3540
12812	99	80	3320	204	0	3703
12813	73	3524	131	127	0	3855
12814	3485	142	80	84	0	3791
12815	197	3528	62	68	0	3855
12816	79	134	50	2850	0	3113
12817	102	74	2742	101	0	3019
12818	63	74	126	2822	0	3085
12819	76	35	85	2934	0	3130
12820	2824	39	83	144	0	3090
12821	103	33	81	2822	0	3039
12822	67	2630	85	158	0	2940
12823	100	2751	41	106	0	2998
12824	62	128	2732	87	0	3009
12825	2769	69	128	56	0	3022
12826	112	62	77	2839	0	3090
12827	71	57	67	2883	0	3078
12828	58	37	54	2984	0	3133
12829	2774	29	73	194	0	3070
12830	111	2758	42	173	0	3084
12831	2901	96	35	148	0	3180
12832	160	72	2705	94	0	3031
12833	100	83	2747	81	0	3011
12834	2861	51	126	87	0	3125
12835	146	50	89	2785	0	3070
12836	100	55	75	2885	0	3115
12837	88	53	47	2984	0	3172
12838	90	52	2714	185	0	3041
12839	2851	54	116	129	0	3150
12840	2895	56	68	123	0	3142
12841	2942	35	60	92	0	3129
12842	180	48	39	2880	0	3147
12843	159	34	2686	148	0	3027
12844	133	31	2695	93	0	2952
12845	89	49	2724	104	0	2966
12846	100	2801	172	72	0	3145
12847	31	40	38	1154	0	1263
12848	1170	16	45	38	0	1269
12849	52	13	1163	38	0	1266
12850	1170	11	42	49	0	1272
12851	57	9	26	1190	0	1282
12852	43	14	29	1146	0	1232
12853	35	1097	29	45	0	1206
12854	38	1110	30	38	0	1216
12855	38	1134	45	24	0	1241
12856	26	32	57	1174	0	1289
12857	1167	17	45	40	0	1269
12858	1182	13	24	57	0	1276
12859	39	8	1126	65	0	1238
12860	1153	16	30	64	0	1263
12861	37	12	1148	45	0	1242
12862	38	13	51	1165	0	1267
12863	60	13	1117	45	0	1235
12864	1166	25	37	27	0	1255
12865	48	15	24	1142	0	1229
12866	27	17	1148	57	0	1249
12867	21	16	1109	39	0	1185
12868	1075	15	67	36	0	1193
12869	1131	23	44	31	0	1229
12870	35	1124	29	37	0	1225
12871	50	27	20	1163	0	1260
12872	37	14	1118	50	0	1219
12873	34	20	1097	36	0	1187
12874	31	11	41	1391	0	1474
12875	828	0	0	20	0	848
12876	19	795	2	6	0	822
12877	6	19	0	827	0	852
12878	828	4	0	20	0	852
12879	20	2	0	817	0	839
12880	7	783	1	20	0	811
12881	2	18	0	840	0	860
12882	824	7	0	22	0	853
12883	18	1	0	819	0	838
12884	1703	1	0	22	0	1726
12885	21	1589	4	8	0	1622
12886	1691	15	1	2	0	1709
12887	22	8	1611	1	0	1642
12888	1502	2	18	1	0	1523
12889	1679	1	7	0	0	1687
12890	26	1576	3	1	0	1606
12891	9	16	1	1677	0	1703
12892	2	7	1642	19	0	1670
12893	2	4	1495	11	0	1512
12894	1507	2	27	2	0	1538
12895	1587	0	9	2	0	1598
12896	26	1581	3	0	0	1610
12897	9	1612	3	2	0	1626
12898	1681	25	0	0	0	1706
12899	21	1606	1	1	0	1629
12900	8	1630	1	1	0	1640
12901	4	21	1	1943	0	1969
12902	2	10	0	2147	0	2159
12903	2	3	2107	26	0	2138
12904	0	2	20	2061	0	2083
12905	2132	0	9	26	0	2167
12906	19	1	2077	10	0	2107
12907	11	9	2699	2	0	2721
12908	3	2	28	2652	0	2685
12909	4	0	10	2874	0	2888
12910	0	1	4	2721	0	2726
12911	2	4	2614	28	0	2648
12912	2	0	18	2222	0	2242
12913	0	1	6	2346	0	2353
12914	2379	1	2	29	0	2411
12915	18	2500	2	14	0	2534
12916	2641	19	2	4	0	2666
12917	23	8	2521	2	0	2554
12918	2363	4	19	2	0	2388
12919	22	2472	10	1	0	2505
12920	2616	22	3	2	0	2643
12921	22	2544	7	4	0	2577
12922	2642	22	0	3	0	2667
12923	20	2507	3	3	0	2533
12924	9	2494	3	4	0	2510
12925	2	31	1	2632	0	2666
12926	2647	8	2	24	0	2681
12927	2600	3	0	11	0	2614
12928	2593	7	1	5	0	2606
12929	33	7	2461	4	0	2505
12930	15	7	2809	3	0	2834
12931	5	1	26	2907	0	2939
12932	6	3107	12	19	0	3144
12933	1	3160	6	16	0	3183
12934	3	26	2	3336	0	3367
12935	3332	12	0	26	0	3370
12936	3294	4	2	12	0	3312
12937	3280	4	5	4	0	3293
12938	35	6	3730	1	0	3772
12939	14	4	21	3759	0	3798
12940	8	3	3808	21	0	3840
12941	3746	2	23	9	0	3780
12942	3837	4	8	4	0	3853
12943	32	2	3800	3	0	3837
12944	11	9	22	3728	0	3770
12945	3925	1	9	25	0	3960
12946	24	2	5	4564	0	4595
12947	10	4	5	4500	0	4519
12948	4	3	1	5166	0	5174
12949	5253	1	2	46	0	5302
12950	42	1	2	5427	0	5472
12951	5444	5	2	60	0	5511
12952	53	5089	12	21	0	5175
12953	20	52	1	5680	0	5753
12954	3	19	2	5724	0	5748
12955	5	1	3	5740	0	5749
12956	5729	2	0	96	0	5827
12957	71	1	3	5657	0	5732
12958	23	3	1	5674	0	5701
12959	5780	0	4	83	0	5867
12960	5671	2	5	20	0	5698
12961	5701	0	6	10	0	5717
12962	93	7	5342	6	0	5448
12963	32	11	4843	10	0	4896
12964	5497	3	81	7	0	5588
12965	70	3	20	5605	0	5698
12966	23	4	5	5568	0	5600
12967	5699	7	1	86	0	5793
12968	5542	4	2	25	0	5573
12969	5558	4	2	10	0	5574
12970	86	5370	11	10	0	5477
12971	5673	68	1	4	0	5746
12972	5509	17	1	3	0	5530
12973	89	5331	13	6	0	5439
12974	14	5149	10	4	0	5177
12975	3	57	1	5378	0	5439
12976	5482	10	0	50	0	5542
12977	5409	1	1	13	0	5424
12978	5343	2	4	2	0	5351
12979	60	3	2	5326	0	5391
12980	5440	0	0	54	0	5494
12981	48	6	5053	11	0	5118
12982	5090	1	44	7	0	5142
12983	55	9	5194	5	0	5263
12984	21	14	4296	2	0	4333
12985	5	1	52	4446	0	4504
12986	4570	3	11	56	0	4640
12987	48	1	2	4573	0	4624
12988	17	3	4552	58	0	4630
12989	9	7	4376	16	0	4408
12990	2	2	53	4440	0	4497
12991	4490	2	13	53	0	4558
12992	52	4303	7	21	0	4383
12993	20	45	2	4554	0	4621
12994	13	8	3	4580	0	4604
12995	8	5	4465	62	0	4540
12996	8	7	4165	17	0	4197
12997	9	3	55	4483	0	4550
12998	4524	2	14	63	0	4603
12999	62	7	4368	19	0	4456
13000	21	6	43	4398	0	4468
13001	13	3	9	4219	0	4244
13002	9	3	1	4101	0	4114
13003	4067	2	0	71	0	4140
13004	65	16	3724	19	0	3824
13005	22	3838	34	16	0	3910
13006	8	56	11	4076	0	4151
13007	7	16	3335	64	0	3422
13008	21	3104	56	27	0	3208
13009	19	3290	17	20	0	3346
13010	3354	60	5	19	0	3438
13011	67	3279	7	17	0	3370
13012	3389	54	6	27	0	3476
13013	77	16	3265	22	0	3380
13014	26	7	52	3313	0	3398
13015	3098	3	17	73	0	3191
13016	70	2943	19	40	0	3072
13017	31	57	2968	39	0	3095
13018	31	18	51	2749	0	2849
13019	37	2959	17	60	0	3073
13020	30	54	8	3073	0	3165
13021	3265	20	12	75	0	3372
13022	75	3186	24	39	0	3324
13023	3324	56	8	31	0	3419
13024	3332	17	7	32	0	3388
13025	89	17	3167	27	0	3300
13026	54	3082	63	28	0	3227
13027	35	56	23	3278	0	3392
13028	46	19	3175	69	0	3309
13029	39	20	3576	29	0	3664
13030	44	8	101	3324	0	3477
13031	3678	7	43	108	0	3836
13032	3433	15	27	42	0	3517
13033	154	15	17	3440	0	3626
13034	76	14	3285	139	0	3514
13035	53	3301	108	53	0	3515
13036	3461	114	33	27	0	3635
13037	3483	40	16	33	0	3572
13038	157	3309	22	26	0	3514
13039	3486	125	15	25	0	3651
13040	161	53	3255	14	0	3483
13041	3425	30	118	17	0	3590
13042	3421	33	43	25	0	3522
13043	173	26	3286	14	0	3499
13044	71	17	126	3331	0	3545
13045	67	13	3190	137	0	3407
13046	39	2731	133	57	0	2960
13047	38	2867	59	40	0	3004
13048	23	115	25	2106	0	2269
13049	23	47	1926	108	0	2104
13050	10	1819	73	37	0	1939
13051	7	1952	26	23	0	2008
13052	1821	104	26	22	0	1973
13053	1600	37	16	12	0	1665
13054	90	23	10	1626	0	1749
13055	41	21	7	1578	0	1647
13056	26	1604	8	77	0	1715
13057	1591	61	9	38	0	1699
13058	1617	23	6	25	0	1671
13059	75	1598	8	15	0	1696
13060	36	78	2	1640	0	1756
13061	26	38	1509	71	0	1644
13062	22	18	61	1665	0	1766
13063	1588	18	26	77	0	1709
13064	66	18	13	1647	0	1744
13065	34	13	10	1712	0	1769
13066	1648	5	6	93	0	1752
13067	75	4	5	1562	0	1646
13068	27	1590	5	88	0	1710
13069	22	71	3	1619	0	1715
13070	29	29	5	1675	0	1738
13071	22	17	5	1562	0	1606
13072	16	1599	12	85	0	1712
13073	12	69	6	1682	0	1769
13074	10	31	1555	94	0	1690
13075	15	17	56	1686	0	1774
13076	21	19	1470	96	0	1606
13077	9	1596	65	50	0	1720
13078	6	63	31	1660	0	1760
13079	15	27	18	1682	0	1742
13080	19	22	16	1711	0	1768
13081	11	23	12	1734	0	1780
13082	8	26	1478	116	0	1628
13083	7	1583	69	67	0	1726
13084	8	67	19	1637	0	1731
13085	15	36	1587	89	0	1727
13086	22	23	72	1687	0	1804
13087	1638	20	33	97	0	1788
13088	74	13	1475	52	0	1614
13089	1669	16	69	32	0	1786
13090	84	20	27	1656	0	1787
13091	43	20	1574	86	0	1723
13092	26	1611	76	54	0	1767
13093	21	68	23	1656	0	1768
13094	23	27	1572	102	0	1724
13095	22	1633	84	41	0	1780
13096	18	84	32	1663	0	1797
13097	1633	36	32	92	0	1793
13098	1703	27	22	47	0	1799
13099	1723	21	19	38	0	1801
13100	114	23	1561	33	0	1731
13101	64	2234	68	30	0	2396
13102	54	103	29	2138	0	2324
13103	42	58	25	2883	0	3008
13104	2870	32	25	196	0	3123
13105	159	2985	23	91	0	3258
13106	2973	176	15	50	0	3214
13107	2998	77	23	52	0	3150
13108	3215	58	20	32	0	3325
13109	266	45	2902	48	0	3261
13110	3082	31	162	32	0	3307
13111	230	26	70	2971	0	3297
13112	126	20	35	3176	0	3357
13113	3029	23	34	242	0	3328
13114	192	26	20	3007	0	3245
13115	105	2968	15	209	0	3297
13116	48	157	14	3122	0	3341
13117	3000	77	13	225	0	3315
13118	184	50	2827	124	0	3185
13119	97	2908	151	79	0	3235
13120	72	165	61	2998	0	3296
13121	2782	80	31	187	0	3080
13122	188	44	2686	99	0	3017
13123	95	26	175	2774	0	3070
13124	55	34	2771	208	0	3068
13125	40	24	2859	117	0	3040
13126	42	27	2870	69	0	3008
13127	35	10	2876	78	0	2999
13128	34	29	2881	55	0	2999
13129	2203	22	208	40	0	2473
13130	152	2247	89	41	0	2529
13131	1913	107	51	22	0	2093
13132	1921	60	39	18	0	2038
13133	164	1776	37	22	0	1999
13134	92	1931	23	24	0	2070
13135	1864	157	26	26	0	2073
13136	1982	68	14	40	0	2104
13137	170	32	18	1816	0	2036
13138	83	1331	10	101	0	1525
13139	1359	120	10	49	0	1538
13140	118	1349	6	35	0	1508
13141	78	115	11	1387	0	1591
13142	1364	52	19	116	0	1551
13143	1439	35	18	58	0	1550
13144	155	22	13	1385	0	1575
13145	75	27	10	1484	0	1596
13146	49	9	1324	168	0	1550
13147	41	15	99	1447	0	1602
13148	25	9	1358	141	0	1533
13149	32	11	118	1381	0	1542
13150	23	11	67	1481	0	1582
13151	1386	8	39	159	0	1592
13152	1479	6	42	79	0	1606
13153	164	16	1325	38	0	1543
13154	1434	17	108	47	0	1606
13155	149	13	56	1370	0	1588
13156	93	15	1327	122	0	1557
13157	48	18	104	1426	0	1596
13158	37	25	58	1467	0	1587
13159	45	18	1652	158	0	1873
13160	35	12	118	1745	0	1910
13161	27	8	1706	146	0	1887
13162	20	15	121	1778	0	1934
13163	1692	10	65	138	0	1905
13164	106	1716	31	85	0	1938
13165	1708	103	30	50	0	1891
13166	123	1750	27	35	0	1935
13167	1747	114	18	44	0	1923
13168	131	1760	25	27	0	1943
13169	1738	118	17	41	0	1914
13170	143	1743	25	29	0	1940
13171	86	134	12	1735	0	1967
13172	67	73	1682	116	0	1938
13173	58	38	1736	72	0	1904
13174	53	26	151	1749	0	1979
13175	1712	28	71	139	0	1950
13176	140	1691	46	71	0	1948
13177	77	113	33	1741	0	1964
13178	50	51	1683	150	0	1934
13179	44	22	1747	92	0	1905
13180	40	23	149	1596	0	1808
13181	23	1717	68	144	0	1952
13182	1746	115	38	88	0	1987
13183	128	69	1708	52	0	1957
13184	75	30	1747	49	0	1901
13185	40	1729	164	30	0	1963
13186	1703	118	73	45	0	1939
13187	1833	56	41	33	0	1963
13188	163	40	46	1730	0	1979
13189	1785	22	44	124	0	1975
13190	1766	31	41	72	0	1910
13191	172	1697	45	41	0	1955
13192	1787	118	43	32	0	1980
13193	154	55	1688	30	0	1927
13194	90	35	123	1712	0	1960
13195	68	18	69	1825	0	1980
13196	1728	38	37	153	0	1956
13197	135	1710	30	84	0	1959
13198	1724	121	36	45	0	1926
13199	147	1644	30	32	0	1853
13200	82	1802	13	39	0	1936
13201	41	112	1089	22	0	1264
13202	47	54	1188	25	0	1314
13203	329	0	0	1	0	330
13204	354	0	0	0	0	354
13205	0	0	359	0	0	359
13206	0	330	1	1	0	332
13207	0	343	1	0	0	344
13208	363	0	0	0	0	363
13209	350	0	0	0	0	350
13210	0	1	0	352	0	353
13211	361	0	0	0	0	361
13212	0	0	0	350	0	350
13213	1	0	346	0	0	347
13214	1	2	309	0	0	312
13215	340	0	0	0	0	340
13216	0	0	0	345	0	345
13217	0	341	0	0	0	341
13218	357	0	0	0	0	357
13219	346	0	0	0	0	346
13220	0	0	352	0	0	352
13221	345	0	0	0	0	345
13222	353	0	0	0	0	353
13223	0	0	0	352	0	352
13224	0	329	0	0	0	329
13225	0	332	3	0	0	335
13226	0	0	0	356	0	356
13227	0	0	1	343	0	344
13228	0	0	0	347	0	347
13229	0	0	344	0	0	344
13230	1	0	335	0	0	336
13231	0	0	0	340	0	340
13232	0	1	346	1	0	348
13233	1	0	338	0	0	339
13234	0	0	0	330	0	330
13235	0	2	594	0	0	596
13236	0	576	17	2	0	595
13237	613	18	1	2	0	634
13238	19	1	0	1021	0	1041
13239	1	991	2	19	0	1013
13240	0	18	1022	1	0	1041
13241	0	2	15	1015	0	1032
13242	0	0	1048	19	0	1067
13243	0	0	14	1028	0	1042
13244	0	1	1	1072	0	1074
13245	0	0	1053	20	0	1073
13246	1	4	20	1005	0	1030
13247	3	989	3	19	0	1014
13248	1	21	0	1065	0	1087
13249	1	5	1046	20	0	1072
13250	0	1	22	1032	0	1055
13251	1049	2	1	22	0	1074
13252	18	1011	8	5	0	1042
13253	1	21	1	1055	0	1078
13254	5	6	1023	23	0	1057
13255	0	961	23	9	0	993
13256	0	1045	2	4	0	1051
13257	1	21	1018	1	0	1041
13258	0	2	17	957	0	976
13259	0	0	7	711	0	718
13260	2	2	711	27	0	742
13261	4	686	16	7	0	713
13262	1	735	5	1	0	742
13263	734	20	0	9	0	763
13264	19	1055	8	2	0	1084
13265	1127	21	2	6	0	1156
13266	20	5	4	1108	0	1137
13267	1107	3	3	23	0	1136
13268	24	0	1072	6	0	1102
13269	1041	4	19	4	0	1068
13270	20	2	2	1107	0	1131
13271	1	1075	5	18	0	1099
13272	1128	24	1	1	0	1154
13273	22	5	0	1098	0	1125
13274	2	1043	6	21	0	1072
13275	3	1085	6	3	0	1097
13276	1109	21	0	8	0	1138
13277	1138	3	3	1	0	1145
13278	1132	2	3	0	0	1137
13279	24	6	1	1104	0	1135
13280	8	1034	1	22	0	1065
13281	0	1086	1	4	0	1091
13282	9	17	0	1114	0	1140
13283	1114	1	3	27	0	1145
13284	1102	4	1	2	0	1109
13285	1098	5	4	3	0	1110
13286	29	5	1031	1	0	1066
13287	8	5	980	5	0	998
13288	1378	7	20	3	0	1408
13289	27	3	2	1395	0	1427
13290	1	8	2	1409	0	1420
13291	2	7	8	1410	0	1427
13292	2	6	3	1425	0	1436
13293	13	1	1378	25	0	1417
13294	8	3	19	1364	0	1394
13295	10	6	1363	27	0	1406
13296	1271	4	28	11	0	1314
13297	20	1892	9	12	0	1933
13298	7	26	7	2694	0	2734
13299	3	5	2	2739	0	2749
13300	2754	2	4	32	0	2792
13301	2709	2	8	13	0	2732
13302	2711	2	5	14	0	2732
13303	2689	9	11	5	0	2714
13304	20	6	2690	15	0	2731
13305	5	6	2601	5	0	2617
13306	4	3	23	2624	0	2654
13307	2736	8	5	31	0	2780
13308	2668	7	7	13	0	2695
13309	22	4	2652	22	0	2700
13310	3	7	24	2607	0	2641
13311	2730	5	5	31	0	2771
13312	24	13	6	2700	0	2743
13313	13	10	3665	23	0	3711
13314	7	11	23	3537	0	3578
13315	3756	4	7	32	0	3799
13316	25	3447	16	13	0	3501
13317	3766	25	2	6	0	3799
13318	4534	10	3	6	0	4553
13319	4473	6	10	3	0	4492
13320	30	8	7	4455	0	4500
13321	4508	4	6	29	0	4547
13322	20	4258	10	15	0	4303
13323	12	4320	7	8	0	4347
13324	6	29	8	4511	0	4554
13325	4534	6	3	27	0	4570
13326	25	4316	10	5	0	4356
13327	4753	28	0	10	0	4791
13328	5030	9	4	4	0	5047
13329	61	4930	2	10	0	5003
13330	17	59	4	5662	0	5742
13331	12	17	2	5747	0	5778
13332	15	25	5605	65	0	5710
13333	15	19	52	5291	0	5377
13334	30	8	5590	75	0	5703
13335	4	5061	53	19	0	5137
13336	5	38	6	5480	0	5529
13337	5454	11	7	53	0	5525
13338	4968	9	13	15	0	5005
13339	44	8	3	5051	0	5106
13340	19	5	4931	46	0	5001
13341	4440	13	41	20	0	4514
13342	35	4761	25	26	0	4847
13343	18	4833	13	18	0	4882
13344	19	4920	9	11	0	4959
13345	13	55	1	5001	0	5070
13346	12	21	4895	45	0	4973
13347	11	11	43	4787	0	4852
13348	8	19	4879	52	0	4958
13349	11	12	3910	883	0	4816
13350	6	22	4813	16	0	4857
13351	4	11	49	4501	0	4565
13352	5	10	25	4814	0	4854
13353	6	5	12	4904	0	4927
13354	2	10	18	4867	0	4897
13355	4944	4	13	68	0	5029
13356	41	4689	33	24	0	4787
13357	4915	42	13	31	0	5001
13358	46	4767	20	20	0	4853
13359	11	51	7	4903	0	4972
13360	10	14	4	4932	0	4960
13361	4925	11	5	61	0	5002
13362	4833	12	4	35	0	4884
13363	5436	4	5	24	0	5469
13364	5787	17	7	11	0	5822
13365	5813	7	3	19	0	5842
13366	59	5564	10	21	0	5654
13367	5862	45	1	10	0	5918
13368	63	5571	19	19	0	5672
13369	5815	44	10	12	0	5881
13370	72	18	5784	9	0	5883
13371	34	15	40	5774	0	5863
13372	21	5744	21	39	0	5825
13373	24	46	11	5989	0	6070
13374	12	24	5854	51	0	5941
13375	17	11	41	5728	0	5797
13376	5835	9	21	52	0	5917
13377	47	5621	26	37	0	5731
13378	16	5895	15	22	0	5948
13379	27	59	6738	22	0	6846
13380	14	27	48	6765	0	6854
13381	6	6822	33	64	0	6925
13382	15	47	20	7274	0	7356
13383	5	23	7007	69	0	7104
13384	11	6399	81	47	0	6538
13385	13	60	6781	18	0	6872
13386	18	35	5932	842	0	6827
13387	14	31	50	6909	0	7004
13388	6927	12	16	61	0	7016
13389	51	9	21	6859	0	6940
13390	30	19	7260	64	0	7373
13391	23	9	59	7106	0	7197
13392	16	23	7237	51	0	7327
13393	19	29	7385	30	0	7463
13394	7404	14	63	20	0	7501
13395	7801	8	23	36	0	7868
13396	7663	16	25	20	0	7724
13397	60	18	7139	41	0	7258
13398	25	13	6625	15	0	6678
13399	17	3	66	6568	0	6654
13400	20	10	40	6713	0	6783
13401	6734	12	27	54	0	6827
13402	57	15	15	6643	0	6730
13403	21	10	6678	68	0	6777
13404	25	17	6364	36	0	6442
13405	19	6213	71	37	0	6340
13406	9	54	26	7962	0	8051
13407	30	26	7943	108	0	8107
13408	11	24	101	7725	0	7861
13409	7932	11	34	136	0	8113
13410	103	19	8822	47	0	8991
13411	24	18	140	8751	0	8933
13412	27	9	31	9015	0	9082
13413	27	20	7967	152	0	8166
13414	17	6	135	7817	0	7975
13415	29	10	7948	170	0	8157
13416	7617	14	143	52	0	7826
13417	142	10	42	7851	0	8045
13418	27	7144	49	142	0	7362
13419	7394	123	27	45	0	7589
13420	7304	19	24	49	0	7396
13421	145	7214	40	49	0	7448
13422	59	141	20	7144	0	7364
13423	43	7205	35	137	0	7420
13424	41	7305	31	51	0	7428
13425	40	174	6975	48	0	7237
13426	37	7004	131	47	0	7219
13427	31	165	6853	22	0	7071
13428	5971	25	102	20	0	6118
13429	6214	22	26	11	0	6273
13430	92	5894	29	19	0	6034
13431	23	5969	25	13	0	6030
13432	23	6080	14	10	0	6127
13433	6752	110	11	4	0	6877
13434	102	38	7	6661	0	6808
13435	21	55	6898	100	0	7074
13436	26	7063	103	24	0	7216
13437	19	110	12	7225	0	7366
13438	13	32	17	6935	0	6997
13439	10	7859	23	102	0	7994
13440	9067	160	11	27	0	9265
13441	204	53	8722	27	0	9006
13442	44	37	186	10316	0	10583
13443	31	10719	51	822	0	11623
13444	11513	295	20	60	0	11888
13445	313	87	10928	29	0	11357
13446	62	11114	304	38	0	11518
13447	41	318	53	11586	0	11998
13448	33	89	11286	311	0	11719
13449	11110	46	309	66	0	11531
13450	315	33	66	11564	0	11978
13451	77	57	11068	327	0	11529
13452	39	11238	302	119	0	11698
13453	11276	314	75	55	0	11720
13454	299	11388	50	50	0	11787
13455	11553	324	43	35	0	11955
13456	11728	81	36	34	0	11879
13457	375	67	26	11244	0	11712
13458	99	10934	41	325	0	11399
13459	68	324	10890	69	0	11351
13460	62	78	292	11349	0	11781
13461	47	58	88	11070	0	11263
13462	38	43	45	11719	0	11845
13463	45	44	30	11325	0	11444
13464	42	34	35	10801	0	10912
13465	10391	30	31	428	0	10880
13466	10393	43	29	135	0	10600
13467	10195	31	30	98	0	10354
13468	362	9736	51	92	0	10241
13469	110	309	10165	61	0	10645
13470	97	97	10165	51	0	10410
13471	78	57	10233	47	0	10415
13472	51	72	369	9824	0	10316
13473	52	51	97	10316	0	10516
13474	45	37	75	10545	0	10702
13475	52	54	9875	408	0	10389
13476	39	9651	350	180	0	10220
13477	46	330	10017	113	0	10506
13478	44	103	10710	109	0	10966
13479	63	55	385	9916	0	10419
13480	52	73	9936	362	0	10423
13481	48	49	379	9756	0	10232
13482	9708	48	131	390	0	10277
13483	9981	48	92	119	0	10240
13484	390	58	9418	125	0	9991
13485	112	57	375	9641	0	10185
13486	113	69	9284	375	0	9841
13487	89	9459	369	142	0	10059
13488	9683	349	126	90	0	10248
13489	369	120	9310	79	0	9878
13490	117	8917	342	100	0	9476
13491	76	9301	126	95	0	9598
13492	83	9432	100	91	0	9706
13493	84	447	8321	93	0	8945
13494	77	161	354	8307	0	8899
13495	67	8618	140	362	0	9187
13496	74	395	105	8697	0	9271
13497	88	144	84	9110	0	9426
13498	8640	98	98	447	0	9283
13499	378	8684	86	182	0	9330
13500	8619	379	79	125	0	9202
13501	392	8510	75	159	0	9136
13502	134	8899	90	118	0	9241
13503	154	431	8426	109	0	9120
13504	106	881	362	7988	0	9337
13505	95	166	8543	379	0	9183
13506	65	7191	310	167	0	7733
13507	77	312	7214	132	0	7735
13508	78	113	7309	136	0	7636
13509	82	7342	366	117	0	7907
13510	6238	275	118	104	0	6735
13511	252	6414	90	116	0	6872
13512	6433	271	105	119	0	6928
13513	276	116	6336	101	0	6829
13514	127	79	6344	108	0	6658
13515	80	6330	323	111	0	6844
13516	6267	264	114	108	0	6753
13517	292	6300	107	93	0	6792
13518	110	276	101	6446	0	6933
13519	6428	107	111	274	0	6920
13520	295	89	6232	116	0	6732
13521	110	79	307	7092	0	7588
13522	6907	77	130	335	0	7449
13523	286	6921	126	149	0	7482
13524	102	309	101	7103	0	7615
13525	84	113	6814	354	0	7365
13526	6988	81	321	151	0	7541
13527	298	75	129	7123	0	7625
13528	97	78	6837	356	0	7368
13529	61	79	334	6880	0	7354
13530	83	6830	154	343	0	7410
13531	92	300	6827	162	0	7381
13532	92	104	325	7084	0	7605
13533	6313	75	116	326	0	6830
13534	297	68	104	6396	0	6865
13535	5703	70	70	309	0	6152
13536	295	5701	84	123	0	6203
13537	5860	281	82	90	0	6313
13538	308	132	5639	87	0	6166
13539	95	94	5007	75	0	5271
13540	46	73	3852	47	0	4018
13541	48	3850	220	57	0	4175
13542	17	50	366	1360	0	1793
13543	11	10	18	1374	0	1413
13544	6	14	11	1375	0	1406
13545	4	7	7	1396	0	1414
13546	5	10	1296	57	0	1368
13547	1255	8	39	31	0	1333
13548	36	1304	20	26	0	1386
13549	1321	34	17	15	0	1387
13550	48	10	10	1323	0	1391
13551	21	1325	11	39	0	1396
13552	18	40	8	1363	0	1429
13553	1353	15	3	47	0	1418
13554	42	1311	9	16	0	1378
13555	1360	38	14	18	0	1430
13556	1391	13	15	5	0	1424
13557	46	17	17	1670	0	1750
13558	23	12	1652	41	0	1728
13559	1635	5	42	22	0	1704
13560	40	3	13	1720	0	1776
13561	1707	4	15	56	0	1782
13562	1709	10	12	23	0	1754
13563	1729	3	9	26	0	1767
13564	61	9	1656	15	0	1741
13565	33	6	36	1629	0	1704
13566	1703	6	13	45	0	1767
13567	47	17	1626	15	0	1705
13568	22	1593	44	20	0	1679
13569	16	44	8	1614	0	1682
13570	22	20	1658	38	0	1738
13571	15	17	1647	20	0	1699
13572	19	16	42	1592	0	1669
13573	16	4	20	1696	0	1736
13574	23	5	16	1685	0	1729
13575	14	12	12	1687	0	1725
13576	21	2	1606	70	0	1699
13577	21	1511	43	40	0	1615
13578	20	33	17	996	0	1066
13579	1004	10	18	49	0	1081
13580	1014	8	13	19	0	1054
13581	1029	7	10	22	0	1068
13582	66	3	7	1000	0	1076
13583	36	4	15	989	0	1044
13584	24	928	12	57	0	1021
13585	12	987	15	28	0	1042
13586	9	42	15	1008	0	1074
13587	1568	19	14	52	0	1653
13588	1576	17	15	24	0	1632
13589	1580	14	9	28	0	1631
13590	1586	3	8	33	0	1630
13591	1594	7	15	25	0	1641
13592	63	1471	18	21	0	1573
13593	25	36	11	1574	0	1646
13594	2081	17	9	49	0	2156
13595	2110	8	7	29	0	2154
13596	57	15	3	2053	0	2128
13597	32	3	9	2094	0	2138
13598	33	5	2015	61	0	2114
13599	18	6	35	1964	0	2023
13600	18	10	9	2070	0	2107
13601	17	8	2003	58	0	2086
13602	20	13	38	1980	0	2051
13603	14	2249	13	56	0	2332
13604	22	39	2255	28	0	2344
13605	24	2245	42	22	0	2333
13606	26	46	13	2293	0	2378
13607	26	21	8	2348	0	2403
13608	28	2209	11	47	0	2295
13609	19	2293	9	29	0	2350
13610	2376	43	6	21	0	2446
13611	2388	19	3	15	0	2425
13612	61	17	2247	22	0	2347
13613	2252	10	39	24	0	2325
13614	2376	3	14	24	0	2417
13615	2379	4	18	22	0	2423
13616	2361	4	19	19	0	2403
13617	62	7	2245	28	0	2342
13618	29	10	2091	25	0	2155
13619	2214	5	53	13	0	2285
13620	45	2194	28	21	0	2288
13621	2	0	1646	0	0	1648
13622	1644	0	0	0	0	1644
13623	1674	0	0	1	0	1675
13624	0	1	1664	0	0	1665
13625	1457	1	2	1	0	1461
13626	0	0	0	1659	0	1659
13627	0	2	1664	0	0	1666
13628	1482	0	2	0	0	1484
13629	0	1569	2	1	0	1572
13630	1691	0	0	0	0	1691
13631	1688	0	0	0	0	1688
13632	0	0	0	1643	0	1643
13633	0	0	0	1618	0	1618
13634	0	0	0	1677	0	1677
13635	1690	0	0	0	0	1690
13636	1674	0	0	0	0	1674
13637	0	1	0	1657	0	1658
13638	0	1	1	1649	0	1651
13639	2	0	1641	0	0	1643
13640	1514	1	0	0	0	1515
13641	0	1	0	1664	0	1665
13642	2	2	0	1659	0	1663
13643	1	1565	5	1	0	1572
13644	0	0	1	1675	0	1676
13645	0	1	0	1653	0	1654
13646	1641	0	1	1	0	1643
13647	1	1586	4	1	0	1592
13648	1	0	0	1664	0	1665
13649	0	0	0	1629	0	1629
13650	1	2	1	1636	0	1640
13651	3	0	1649	2	0	1654
13652	1	1	0	1575	0	1577
13653	1596	0	1	1	0	1598
13654	1	2	1610	0	0	1613
13655	0	0	0	1609	0	1609
13656	0	0	0	1637	0	1637
13657	1344	1	0	1	0	1346
13658	1276	1	1	2	0	1280
13659	0	0	1320	2	0	1322
13660	1179	0	2	2	0	1183
13661	1	1	1280	1	0	1283
13662	1196	0	1	3	0	1200
13663	1	1205	6	2	0	1214
13664	1331	0	0	0	0	1331
13665	1	1234	5	1	0	1241
13666	1325	0	0	2	0	1327
13667	1	1257	1	2	0	1261
13668	1	0	0	1306	0	1307
13669	2	1	0	1292	0	1295
13670	0	1	1	1287	0	1289
13671	2	1259	2	1	0	1264
13672	0	2	1	1318	0	1321
13673	2	1251	2	1	0	1256
13674	0	2	0	1313	0	1315
13675	1290	0	0	2	0	1292
13676	1229	1	0	1	0	1231
13677	1	1242	5	1	0	1249
13678	0	1	0	1308	0	1309
13679	1290	0	0	2	0	1292
13680	0	1251	1	2	0	1254
13681	0	1236	1	4	0	1241
13682	1302	1	0	0	0	1303
13683	1292	0	0	1	0	1293
13684	1	1259	2	0	0	1262
13685	1313	0	1	2	0	1316
13686	2	1	0	1285	0	1288
13687	1	2	900	0	0	903
13688	882	4	0	0	0	886
13689	892	0	0	3	0	895
13690	1	2	878	0	0	881
13691	835	3	0	0	0	838
13692	894	1	0	1	0	896
13693	904	0	0	1	0	905
13694	1	421	2	1	0	425
13695	443	1	0	0	0	444
13696	443	0	0	0	0	443
13697	1	0	1	614	0	616
13698	1	1	1	615	0	618
13699	2	0	0	615	0	617
13700	627	0	0	0	0	627
13701	0	1	1	618	0	620
13702	623	0	0	0	0	623
13703	326	0	0	0	0	326
13704	1	0	0	323	0	324
13705	0	1	0	323	0	324
13706	1	0	0	326	0	327
13707	328	0	0	0	0	328
13708	0	303	0	1	0	304
13709	0	0	0	325	0	325
13710	0	0	0	323	0	323
13711	327	0	0	0	0	327
13712	333	0	0	1	0	334
13713	0	0	328	0	0	328
13714	1	0	306	0	0	307
13715	577	0	1	1	0	579
13716	19	0	0	859	0	878
13717	8	0	0	1283	0	1291
13718	8	4	1205	81	0	1298
13719	3	2	59	1194	0	1258
13720	0	1209	11	79	0	1299
13721	2	1337	9	16	0	1364
13722	1264	84	6	9	0	1363
13723	74	27	1133	4	0	1238
13724	11	1279	55	3	0	1348
13725	7	79	10	1288	0	1384
13726	5	12	1254	79	0	1350
13727	0	13	77	1272	0	1362
13728	0	9	12	1351	0	1372
13729	2	4	1206	94	0	1306
13730	1	1260	76	21	0	1358
13731	4	77	10	1293	0	1384
13732	1294	13	8	82	0	1397
13733	1354	11	6	13	0	1384
13734	1353	6	1	12	0	1372
13735	90	1274	2	10	0	1376
13736	1269	74	3	1	0	1347
13737	91	14	1	1298	0	1404
13738	19	20	1225	82	0	1346
13739	1265	5	68	16	0	1354
13740	76	1260	13	17	0	1366
13741	13	75	14	1285	0	1387
13742	11	15	7	1321	0	1354
13743	8	1271	4	88	0	1371
13744	8	86	2	1304	0	1400
13745	8	17	4	1386	0	1415
13746	8	13	7	1406	0	1434
13747	1295	14	11	112	0	1432
13748	1353	14	8	38	0	1413
13749	89	16	1269	38	0	1412
13750	26	17	83	1280	0	1406
13751	25	11	21	1364	0	1421
13752	13	15	15	1402	0	1445
13753	1307	17	20	114	0	1458
13754	87	15	1211	44	0	1357
13755	1278	5	79	38	0	1400
13756	1495	12	19	24	0	1550
13757	101	9	13	1438	0	1561
13758	1452	6	17	90	0	1565
13759	100	18	1741	35	0	1894
13760	1809	12	130	32	0	1983
13761	156	1798	31	30	0	2015
13762	44	139	1819	14	0	2016
13763	34	28	1915	15	0	1992
13764	28	28	134	1866	0	2056
13765	29	20	2010	157	0	2216
13766	2061	11	143	29	0	2244
13767	145	2040	30	33	0	2248
13768	2131	149	19	21	0	2320
13769	160	26	10	2119	0	2315
13770	24	27	2033	169	0	2253
13771	28	21	2116	41	0	2206
13772	22	18	140	2117	0	2297
13773	2402	18	27	177	0	2624
13774	139	2330	32	64	0	2565
13775	32	2500	23	48	0	2603
13776	2426	150	14	45	0	2635
13777	154	2409	19	31	0	2613
13778	2467	165	17	30	0	2679
13779	172	31	18	2461	0	2682
13780	2467	21	11	172	0	2671
13781	170	16	17	2472	0	2675
13782	2461	9	24	176	0	2670
13783	175	16	23	2415	0	2629
13784	46	2366	16	178	0	2606
13785	2433	146	8	51	0	2638
13786	161	2808	31	44	0	3044
13787	40	163	2629	32	0	2864
13788	44	38	139	2444	0	2665
13789	40	2682	38	118	0	2878
13790	2750	149	26	34	0	2959
13791	2808	32	34	25	0	2899
13792	172	2709	23	25	0	2929
13793	50	157	2642	42	0	2891
13794	44	24	149	2645	0	2862
13795	28	2682	55	149	0	2914
13796	33	160	24	2763	0	2980
13797	31	35	27	2776	0	2869
13798	2639	32	27	181	0	2879
13799	158	2534	31	62	0	2785
13800	47	164	22	2655	0	2888
13801	2647	36	28	170	0	2881
13802	2745	33	32	48	0	2858
13803	2764	34	18	52	0	2868
13804	196	25	25	2637	0	2883
13805	2661	18	16	170	0	2865
13806	195	2573	26	37	0	2831
13807	2596	161	21	47	0	2825
13808	175	3079	19	54	0	3327
13809	3220	166	16	46	0	3448
13810	3334	44	20	35	0	3433
13811	188	33	23	3179	0	3423
13812	70	26	3018	174	0	3288
13813	70	46	2988	40	0	3144
13814	52	3066	138	41	0	3297
13815	2915	127	18	23	0	3083
13816	135	34	2524	14	0	2707
13817	2018	14	60	6	0	2098
13818	74	2070	9	18	0	2171
13819	21	2143	8	11	0	2183
13820	16	69	5	2090	0	2180
13821	22	2065	4	64	0	2155
13822	15	69	2190	18	0	2292
13823	13	25	66	2161	0	2265
13824	15	2205	18	72	0	2310
13825	17	83	8	2333	0	2441
13826	2314	23	12	81	0	2430
13827	88	12	10	2297	0	2407
13828	23	23	2214	86	0	2346
13829	24	2168	83	17	0	2292
13830	21	81	17	2266	0	2385
13831	15	30	12	2360	0	2417
13832	15	19	17	2399	0	2450
13833	2311	16	10	100	0	2437
13834	2332	18	6	27	0	2383
13835	89	19	2234	23	0	2365
13836	22	13	2242	26	0	2303
13837	25	2123	86	19	0	2253
13838	2902	88	12	16	0	3018
13839	88	16	11	2895	0	3010
13840	31	11	14	2980	0	3036
13841	29	13	8	2974	0	3024
13842	24	16	7	2996	0	3043
13843	23	23	2736	101	0	2883
13844	2740	15	66	27	0	2848
13845	93	21	9	3193	0	3316
13846	39	12	3099	105	0	3255
13847	3017	19	89	31	0	3156
13848	3714	17	16	16	0	3763
13849	135	11	3524	22	0	3692
13850	46	20	3546	20	0	3632
13851	19	10	104	3559	0	3692
13852	3621	7	35	105	0	3768
13853	3704	22	17	34	0	3777
13854	131	17	24	3493	0	3665
13855	36	16	26	3688	0	3766
13856	29	11	3397	128	0	3565
13857	29	14	96	3422	0	3561
13858	31	25	3404	106	0	3566
13859	2784	0	41	29	0	2854
13860	38	2803	32	14	0	2887
13861	3024	37	13	6	0	3080
13862	40	2878	16	10	0	2944
13863	3024	38	8	6	0	3076
13864	48	17	2	2920	0	2987
13865	21	12	1	2824	0	2858
13866	2807	5	3	53	0	2868
13867	2796	7	2	21	0	2826
13868	2842	5	7	9	0	2863
13869	2841	1	5	16	0	2863
13870	63	8	2667	11	0	2749
13871	2719	1	39	8	0	2767
13872	2798	4	19	8	0	2829
13873	2871	3	4	9	0	2887
13874	71	3	5	2802	0	2881
13875	2812	0	12	44	0	2868
13876	46	2682	16	27	0	2771
13877	32	35	7	2818	0	2892
13878	22	11	7	2887	0	2927
13879	14	7	2692	64	0	2777
13880	17	4	39	2709	0	2769
13881	13	2723	18	49	0	2803
13882	2812	40	8	28	0	2888
13883	45	2751	13	18	0	2827
13884	2853	41	9	11	0	2914
13885	54	20	6	2835	0	2915
13886	2398	13	8	49	0	2468
13887	58	2281	13	26	0	2378
13888	2407	43	7	10	0	2467
13889	2461	16	4	10	0	2491
13890	66	7	6	2371	0	2450
13891	32	6	9	2417	0	2464
13892	19	11	2301	61	0	2392
13893	26	6	36	2347	0	2415
13894	26	3	19	2412	0	2460
13895	13	5	2323	72	0	2413
13896	15	3	41	2377	0	2436
13897	18	6	2334	50	0	2408
13898	2319	8	43	33	0	2403
13899	52	6	16	2398	0	2472
13900	30	4	2326	53	0	2413
13901	2304	6	50	31	0	2391
13902	52	7	24	2377	0	2460
13903	35	11	2299	49	0	2394
13904	2287	2	44	36	0	2369
13905	53	5	24	2369	0	2451
13906	35	7	8	2399	0	2449
13907	2393	4	11	72	0	2480
13908	55	4	12	1859	0	1930
13909	31	4	10	1866	0	1911
13910	22	1	4	1852	0	1879
13911	17	1746	12	69	0	1844
13912	1850	37	4	32	0	1923
13913	1865	21	6	29	0	1921
13914	61	4	9	1856	0	1930
13915	1867	6	11	59	0	1943
13916	1875	8	6	39	0	1928
13917	1897	10	8	18	0	1933
13918	1806	3	13	17	0	1839
13919	1883	4	9	24	0	1920
13920	74	8	1731	23	0	1836
13921	42	13	1690	20	0	1765
13922	1624	4	31	13	0	1672
13923	47	1572	18	14	0	1651
13924	29	23	9	1657	0	1718
13925	25	13	2089	34	0	2161
13926	16	6	2054	25	0	2101
13927	22	8	57	2134	0	2221
13928	2128	15	19	49	0	2211
13929	60	6	8	2167	0	2241
13930	23	7	2058	63	0	2151
13931	2127	4	48	28	0	2207
13932	50	8	22	2168	0	2248
13933	35	6	11	2169	0	2221
13934	29	3	6	2207	0	2245
13935	22	2	12	2223	0	2259
13936	22	4	2089	75	0	2190
13937	34	2	41	2171	0	2248
13938	1616	5	23	65	0	1709
13939	60	10	1520	37	0	1627
13940	1598	1	49	27	0	1675
13941	1656	4	34	23	0	1717
13942	1646	0	23	29	0	1698
13943	1609	3	22	27	0	1661
13944	85	1512	29	26	0	1652
13945	30	1232	12	31	0	1305
13946	34	1273	19	18	0	1344
13947	1331	31	22	28	0	1412
13948	24	11	832	19	0	886
13949	859	2	21	23	0	905
13950	28	1	14	881	0	924
13951	857	1	9	48	0	915
13952	27	2	13	880	0	922
13953	870	2	5	41	0	918
13954	28	2	16	862	0	908
13955	20	3	12	883	0	918
13956	714	3	9	36	0	762
13957	33	815	16	20	0	884
13958	33	19	801	11	0	864
13959	28	803	22	13	0	866
13960	26	33	797	6	0	862
13961	22	22	27	812	0	883
13962	856	23	12	22	0	913
13963	36	16	11	840	0	903
13964	842	13	27	25	0	907
13965	50	1047	21	19	0	1137
13966	23	27	1408	33	0	1491
13967	45	1362	20	15	0	1442
13968	16	1437	11	41	0	1505
13969	1491	24	25	18	0	1558
13970	1485	9	8	30	0	1532
13971	51	1414	7	37	0	1509
13972	25	17	10	1507	0	1559
13973	20	19	8	1232	0	1279
13974	1197	12	12	56	0	1277
13975	35	19	1177	20	0	1251
13976	17	12	1156	34	0	1219
13977	32	15	32	1162	0	1241
13978	27	10	1184	28	0	1249
13979	1142	12	22	35	0	1211
13980	1186	6	19	13	0	1224
13981	53	1142	13	20	0	1228
13982	41	34	1151	8	0	1234
13983	13	45	24	1158	0	1240
13984	21	34	1179	27	0	1261
13985	20	32	33	1176	0	1261
13986	1197	21	20	27	0	1265
13987	40	1146	32	29	0	1247
13988	56	20	2254	30	0	2360
13989	26	2201	30	35	0	2292
13990	36	2843	23	28	0	2930
13991	2917	50	21	43	0	3031
13992	2945	23	15	23	0	3006
13993	64	28	2829	40	0	2961
13994	33	2803	70	43	0	2949
13995	46	47	25	2928	0	3046
13996	25	37	30	2942	0	3034
13997	32	21	39	2961	0	3053
13998	28	29	2874	74	0	3005
13999	28	15	77	2871	0	2991
14000	21	9	41	2991	0	3062
14001	2975	12	15	75	0	3077
14002	2947	14	18	52	0	3031
14003	3004	29	11	30	0	3074
14004	2952	34	16	19	0	3021
14005	2937	42	29	19	0	3027
14006	72	2853	17	18	0	2960
14007	2983	77	13	17	0	3090
14008	98	38	2871	13	0	3020
14009	65	23	58	2922	0	3068
14010	2948	34	25	60	0	3067
14011	65	2859	25	52	0	3001
14012	3010	62	11	52	0	3135
14013	3028	24	14	48	0	3114
14014	69	28	32	2989	0	3118
14015	36	15	35	2962	0	3048
14016	36	2866	28	96	0	3026
14017	30	47	33	3046	0	3156
14018	47	24	3106	75	0	3252
14019	53	18	57	3161	0	3289
14020	42	34	3097	76	0	3249
14021	3014	15	86	52	0	3167
14022	84	17	37	3188	0	3326
14023	67	24	3086	74	0	3251
14024	54	2992	74	61	0	3181
14025	16	2548	29	16	0	2609
14026	2961	47	13	15	0	3036
14027	46	23	5	2946	0	3020
14028	24	20	2895	36	0	2975
14029	17	2739	44	29	0	2829
14030	24	34	2885	12	0	2955
14031	2880	23	42	18	0	2963
14032	2936	12	20	17	0	2985
14033	2979	11	14	9	0	3013
14034	57	11	9	2941	0	3018
14035	33	3	2872	45	0	2953
14036	20	2755	47	24	0	2846
14037	12	34	22	2971	0	3039
14038	15	18	2871	40	0	2944
14039	12	19	2742	30	0	2803
14040	2	8	56	2896	0	2962
14041	2962	11	31	39	0	3043
14042	38	14	15	2925	0	2992
14043	26	7	11	2964	0	3008
14044	25	7	2885	57	0	2974
14045	11	11	42	2870	0	2934
14046	13	7	24	2943	0	2987
14047	16	9	2872	58	0	2955
14048	15	9	2826	34	0	2884
14049	15	10	48	2875	0	2948
14050	18	4	2898	49	0	2969
14051	10	9	50	2919	0	2988
14052	2914	5	28	61	0	3008
14053	41	2809	31	31	0	2912
14054	25	36	19	2952	0	3032
14055	16	19	2877	51	0	2963
14056	2525	17	53	28	0	2623
14057	44	2773	28	33	0	2878
14058	2949	36	15	31	0	3031
14059	57	24	17	2905	0	3003
14060	25	13	15	2922	0	2975
14061	3227	8	17	67	0	3319
14062	46	9	3160	50	0	3265
14063	3603	3	49	40	0	3695
14064	59	7	32	3741	0	3839
14065	3515	3	27	58	0	3603
14066	3156	4	19	39	0	3218
14067	77	6	13	3020	0	3116
14068	38	3005	20	57	0	3120
14069	3136	44	5	39	0	3224
14070	3129	25	16	22	0	3192
14071	70	22	3017	23	0	3132
14072	3098	10	43	21	0	3172
14073	73	18	26	3028	0	3145
14074	48	2993	21	52	0	3114
14075	31	44	17	2964	0	3056
14076	29	3023	12	68	0	3132
14077	3134	55	7	43	0	3239
14078	3124	28	14	19	0	3185
14079	76	20	13	3579	0	3688
14080	47	13	3507	69	0	3636
14081	49	15	3487	36	0	3587
14082	24	5	68	3639	0	3736
14083	3643	12	39	62	0	3756
14084	3627	9	20	48	0	3704
14085	82	3831	22	29	0	3964
14086	53	68	17	3996	0	4134
14087	39	37	3910	78	0	4064
14088	28	24	2808	47	0	2907
14089	32	597	99	2314	0	3042
14090	3707	3	40	52	0	3802
14091	66	5	16	4274	0	4361
14092	38	12	4067	91	0	4208
14093	4102	6	85	43	0	4236
14094	88	7	43	4235	0	4373
14095	39	2	22	4307	0	4370
14096	28	6	18	4166	0	4218
14097	24	4280	16	120	0	4440
14098	30	77	4354	53	0	4514
14099	25	46	4389	30	0	4490
14100	14	16	110	4510	0	4650
14101	19	10	4452	94	0	4575
14102	4393	5	102	47	0	4547
14103	94	10	43	4474	0	4621
14104	49	3	22	4513	0	4587
14105	24	12	15	4593	0	4644
14106	13	4425	24	131	0	4593
14107	4581	83	22	50	0	4736
14108	93	35	15	4585	0	4728
14109	4565	18	12	107	0	4702
14110	102	4419	16	77	0	4614
14111	4521	88	21	32	0	4662
14112	4480	33	21	31	0	4565
14113	4472	14	19	47	0	4552
14114	138	4137	21	49	0	4345
14115	71	4410	23	35	0	4539
14116	4417	119	16	21	0	4573
14117	108	4401	26	35	0	4570
14118	43	91	4127	18	0	4279
14119	34	4093	79	35	0	4241
14120	23	4226	40	19	0	4308
14121	4319	85	23	17	0	4444
14122	91	44	4125	39	0	4299
14123	44	33	4088	27	0	4192
14124	31	28	89	4074	0	4222
14125	4271	24	38	90	0	4423
14126	105	21	3830	42	0	3998
14127	44	11	90	3825	0	3970
14128	39	22	3836	86	0	3983
14129	25	37	3769	47	0	3878
14130	3815	13	105	34	0	3967
14131	97	17	3856	29	0	3999
14132	42	12	102	3731	0	3887
14133	37	24	36	3762	0	3859
14134	29	3668	39	111	0	3847
14135	38	3808	30	65	0	3941
14136	20	93	36	3897	0	4046
14137	29	43	4284	98	0	4454
14138	29	28	92	4328	0	4477
14139	36	27	44	4488	0	4595
14140	44	25	4860	124	0	5053
14141	20	22	95	4978	0	5115
14142	5069	15	55	120	0	5259
14143	92	31	4848	70	0	5041
14144	4970	20	80	60	0	5130
14145	98	18	67	5000	0	5183
14146	53	19	32	5306	0	5410
14147	35	5098	42	146	0	5321
14148	31	107	43	5307	0	5488
14149	44	49	41	5390	0	5524
14150	5317	32	40	160	0	5549
14151	115	18	35	5349	0	5517
14152	57	27	25	5444	0	5553
14153	5264	33	32	168	0	5497
14154	110	38	37	5316	0	5501
14155	57	19	27	5208	0	5311
14156	51	5122	47	155	0	5375
14157	5215	101	44	89	0	5449
14158	139	39	22	5289	0	5489
14159	69	28	26	5397	0	5520
14160	48	27	5108	175	0	5358
14161	52	38	95	4999	0	5184
14162	53	29	62	5134	0	5278
14163	4464	14	21	144	0	4643
14164	4421	17	16	83	0	4537
14165	122	19	19	4500	0	4660
14166	62	37	4307	117	0	4523
14167	42	4286	94	68	0	4490
14168	30	4428	52	56	0	4566
14169	40	374	30	4386	0	4830
14170	4612	71	23	97	0	4803
14171	112	35	14	4625	0	4786
14172	4655	27	12	120	0	4814
14173	113	22	21	4634	0	4790
14174	48	24	25	4108	0	4205
14175	3983	31	24	139	0	4177
14176	3893	26	15	70	0	4004
14177	141	3844	20	45	0	4050
14178	70	3984	26	44	0	4124
14179	24	98	29	3431	0	3582
14180	31	33	12	3510	0	3586
14181	27	27	3286	121	0	3461
14182	3026	15	82	55	0	3178
14183	93	3291	37	36	0	3457
14184	28	2714	18	13	0	2773
14185	2410	38	5	9	0	2462
14186	35	16	2388	5	0	2444
14187	11	11	1836	1	0	1859
14188	4	6	1818	2	0	1830
14189	2	1791	32	6	0	1831
14190	3	22	8	1209	0	1242
14191	4	9	5	1232	0	1250
14192	2	5	1	1237	0	1245
14193	1211	2	2	32	0	1247
14194	1212	5	0	15	0	1232
14195	26	1191	0	11	0	1228
14196	13	18	0	1223	0	1254
14197	12	11	1282	21	0	1326
14198	5	1275	17	15	0	1312
14199	1311	24	6	8	0	1349
14200	19	12	1315	7	0	1353
14201	1221	5	19	5	0	1250
14202	25	3	1306	7	0	1341
14203	8	3	24	1287	0	1322
14204	7	1257	17	22	0	1303
14205	1318	20	2	14	0	1354
14206	21	1285	7	10	0	1323
14207	1335	20	3	6	0	1364
14208	25	11	2	1306	0	1344
14209	13	8	2247	24	0	2292
14210	6	5	16	2216	0	2243
14211	2	6	7	2359	0	2374
14212	5	4	2268	30	0	2307
14213	2101	2	20	20	0	2143
14214	21	2406	13	13	0	2453
14215	2550	22	3	8	0	2583
14216	28	2439	7	10	0	2484
14217	10	30	4	2571	0	2615
14218	9	17	2492	29	0	2547
14219	2425	6	21	15	0	2467
14220	28	2601	13	10	0	2652
14221	14	32	3	2674	0	2723
14222	8	12	2	2978	0	3000
14223	3402	5	4	42	0	3453
14224	3944	4	7	19	0	3974
14225	77	3913	14	15	0	4019
14226	4436	69	3	7	0	4515
14227	4451	31	3	7	0	4492
14228	4526	10	4	7	0	4547
14229	145	27	4186	3	0	4361
14230	70	4145	81	11	0	4307
14231	26	4442	49	11	0	4528
14232	20	129	14	4229	0	4392
14233	15	60	9	4501	0	4585
14234	4458	25	4	131	0	4618
14235	100	4350	8	64	0	4522
14236	4495	91	7	22	0	4615
14237	119	60	3	3921	0	4103
14238	70	27	8	4027	0	4132
14239	3983	18	8	133	0	4142
14240	3994	16	7	66	0	4083
14241	155	26	3822	27	0	4030
14242	78	14	89	3907	0	4088
14243	38	23	3831	98	0	3990
14244	28	24	3714	61	0	3827
14245	20	21	3853	30	0	3924
14246	3592	12	109	21	0	3734
14247	83	12	51	3598	0	3744
14248	59	12	20	3577	0	3668
14249	32	12	11	3761	0	3816
14250	22	23	3550	127	0	3722
14251	29	4	71	3605	0	3709
14252	24	4	44	3695	0	3767
14253	3668	4	21	123	0	3816
14254	3695	6	25	64	0	3790
14255	3737	10	21	31	0	3799
14256	3727	12	24	25	0	3788
14257	136	13	23	3660	0	3832
14258	3711	15	22	85	0	3833
14259	118	12	21	3678	0	3829
14260	81	16	3439	104	0	3640
14261	3530	10	79	76	0	3695
14262	100	3514	62	55	0	3731
14263	75	83	32	3575	0	3765
14264	52	58	16	3598	0	3724
14265	52	3596	22	135	0	3805
14266	3616	89	10	88	0	3803
14267	132	3374	18	61	0	3585
14268	119	88	3329	35	0	3571
14269	78	55	3312	40	0	3485
14270	3470	23	125	46	0	3664
14271	3585	29	65	43	0	3722
14272	152	32	3421	56	0	3661
14273	3525	26	93	47	0	3691
14274	138	31	3432	50	0	3651
14275	3489	28	118	47	0	3682
14276	129	27	3435	56	0	3647
14277	105	39	4467	44	0	4655
14278	75	28	144	4225	0	4472
14279	68	25	86	4566	0	4745
14280	4625	35	47	138	0	4845
14281	4560	23	42	108	0	4733
14282	4600	21	52	87	0	4760
14283	4615	15	48	77	0	4755
14284	182	4401	65	61	0	4709
14285	142	90	48	4477	0	4757
14286	116	4434	62	105	0	4717
14287	115	90	52	4634	0	4891
14288	103	58	42	4579	0	4782
14289	99	34	44	4692	0	4869
14290	86	42	4416	193	0	4737
14291	4121	27	120	141	0	4409
14292	132	4217	98	110	0	4557
14293	125	4451	54	98	0	4728
14294	103	125	4360	70	0	4658
14295	110	73	94	4357	0	4634
14296	110	61	59	4477	0	4707
14297	4274	46	35	195	0	4550
14298	150	48	28	4282	0	4508
14299	128	45	38	4271	0	4482
14300	91	31	52	4547	0	4721
14301	76	32	69	4550	0	4727
14302	4474	19	71	194	0	4758
14303	4440	22	70	125	0	4657
14304	4537	23	67	90	0	4717
14305	206	27	63	4448	0	4744
14306	4505	30	74	134	0	4743
14307	165	27	64	4794	0	5050
14308	111	31	69	4837	0	5048
14309	84	30	3744	187	0	4045
14310	67	19	3656	140	0	3882
14311	74	29	3695	110	0	3908
14312	3723	17	158	116	0	4014
14313	169	16	90	3615	0	3890
14314	149	3471	52	148	0	3820
14315	3714	80	62	87	0	3943
14316	199	63	3476	73	0	3811
14317	3517	39	103	70	0	3729
14318	163	3296	90	79	0	3628
14319	3441	91	52	92	0	3676
14320	159	60	37	3301	0	3557
14321	3332	33	48	143	0	3556
14322	124	2872	38	108	0	3142
14323	86	2712	34	59	0	2891
14324	2075	38	11	23	0	2147
14325	43	2040	19	33	0	2135
14326	17	1515	7	7	0	1546
14327	5	1557	7	4	0	1573
14328	1630	16	7	0	0	1653
14329	1615	9	3	2	0	1629
14330	1593	15	0	3	0	1611
14331	6	16	2	1563	0	1587
14332	6	18	1	1594	0	1619
14333	18	7	1560	1	0	1586
14334	20	6	3	1535	0	1564
14335	22	7	1551	4	0	1584
14336	14	4	2	1546	0	1566
14337	7	3	0	1604	0	1614
14338	1596	1	11	10	0	1618
14339	1488	5	5	15	0	1513
14340	3	1543	12	6	0	1564
14341	6	4	4	1599	0	1613
14342	4	6	1550	16	0	1576
14343	13	4	1	1514	0	1532
14344	15	8	1	1538	0	1562
14345	11	12	3	1553	0	1579
14346	10	5	1555	16	0	1586
14347	8	5	1382	7	0	1402
14348	1427	1	6	20	0	1454
14349	2	3	4	1584	0	1593
14350	3	5	2129	24	0	2161
14351	2002	1	14	15	0	2032
14352	1	2038	19	9	0	2067
14353	2200	2	11	8	0	2221
14354	9	1	2150	20	0	2180
14355	2052	3	14	9	0	2078
14356	20	1	4	2058	0	2083
14357	9	16	2128	2	0	2155
14358	18	2022	5	8	0	2053
14359	2151	6	16	7	0	2180
14360	17	1	7	2118	0	2143
14361	6	5	5	2142	0	2158
14362	6	2107	12	11	0	2136
14363	4	12	7	2166	0	2189
14364	18	10	2099	4	0	2131
14365	12	1998	7	14	0	2031
14366	2141	3	4	20	0	2168
14367	6	12	4	2119	0	2141
14368	7	6	3	2133	0	2149
14369	8	8	2112	6	0	2134
14370	8	12	5	2084	0	2109
14371	23	8	2629	4	0	2664
14372	10	2485	10	18	0	2523
14373	3113	2	2	23	0	3140
14374	3033	4	14	12	0	3063
14375	3022	5	6	19	0	3052
14376	6	2921	17	10	0	2954
14377	5	15	4	2140	0	2164
14378	15	5	6	2126	0	2152
14379	15	10	3	2089	0	2117
14380	2170	3	1	10	0	2184
14381	2122	14	7	4	0	2147
14382	5	7	2	2153	0	2167
14383	7	6	2112	20	0	2145
14384	7	3	1	2113	0	2124
14385	14	0	3	2121	0	2138
14386	17	1	9	2127	0	2154
14387	7	3	2	2127	0	2139
14388	2153	2	16	12	0	2183
14389	4	4	7	2135	0	2150
14390	9	2	5	2119	0	2135
14391	9	2073	5	22	0	2109
14392	8	3	1	2155	0	2167
14393	16	2041	7	10	0	2074
14394	8	6	0	2155	0	2169
14395	2144	2	0	22	0	2168
14396	3	2066	3	17	0	2089
14397	2061	5	2	18	0	2086
14398	12	17	2065	7	0	2101
14399	5	3	1	2082	0	2091
14400	15	6	1903	10	0	1934
14401	3	12	4	1880	0	1899
14402	16	5	2	1910	0	1933
14403	6	1801	18	11	0	1836
14404	4	1816	6	24	0	1850
14405	5	1852	12	12	0	1881
14406	1933	3	4	26	0	1966
14407	0	1523	4	0	0	1527
14408	2	1520	2	2	0	1526
14409	1	1	0	1573	0	1575
14410	1585	0	0	0	0	1585
14411	0	1476	5	1	0	1482
14412	1571	0	0	0	0	1571
14413	1535	0	0	0	0	1535
14414	1	3	2055	1	0	2060
14415	1	2	4	1916	0	1923
14416	2	0	0	2111	0	2113
14417	0	1	0	2123	0	2124
14418	0	0	1	2071	0	2072
14419	1	0	2077	1	0	2079
14420	3	4	1826	3	0	1836
14421	1898	0	3	2	0	1903
14422	1	1934	7	0	0	1942
14423	1	1991	4	4	0	2000
14424	2112	1	0	0	0	2113
14425	1	1966	4	0	0	1971
14426	0	2	0	2073	0	2075
14427	2095	0	0	2	0	2097
14428	2	3	1987	0	0	1992
14429	0	0	1	2007	0	2008
14430	0	0	2004	2	0	2006
14431	1882	1	1	1	0	1885
14432	2	1	2022	0	0	2025
14433	2372	2	1	0	0	2375
14434	2398	0	0	1	0	2399
14435	2409	0	0	0	0	2409
14436	2400	0	2	0	0	2402
14437	2420	0	0	0	0	2420
14438	1	0	0	2377	0	2378
14439	2457	2	0	1	0	2460
14440	2	1	1	2369	0	2373
14441	1	0	0	2370	0	2371
14442	0	0	0	2418	0	2418
14443	0	1	2401	1	0	2403
14444	0	0	2	2273	0	2275
14445	0	0	0	2388	0	2388
14446	2	2	2339	1	0	2344
14447	1935	0	2	3	0	1940
14448	1	2	0	2312	0	2315
14449	0	0	2377	1	0	2378
14450	1	4	1737	0	0	1742
14451	0	0	1	1726	0	1727
14452	0	0	1829	1	0	1830
14453	0	1	1	1751	0	1753
14454	1	0	0	1750	0	1751
14455	0	1682	3	0	0	1685
14456	0	1692	5	0	0	1697
14457	1813	1	0	0	0	1814
14458	2	0	0	2195	0	2197
14459	0	0	0	2180	0	2180
14460	2	0	0	2250	0	2252
14461	2	4	2519	41	0	2566
14462	0	0	36	2439	0	2475
14463	2529	0	0	43	0	2572
14464	40	1	2487	0	0	2528
14465	0	2	31	3110	0	3143
14466	1	2	0	3088	0	3091
14467	0	1	0	3128	0	3129
14468	0	3514	8	36	0	3558
14469	3665	68	0	1	0	3734
14470	3584	11	2	1	0	3598
14471	84	3062	7	3	0	3156
14472	16	75	0	3185	0	3276
14473	15	12	3188	73	0	3288
14474	12	13	3031	9	0	3065
14475	3106	6	120	9	0	3241
14476	108	5	35	3243	0	3391
14477	3746	2	23	114	0	3885
14478	161	3592	27	31	0	3811
14479	47	3819	21	23	0	3910
14480	3681	187	14	16	0	3898
14481	143	3913	13	9	0	4078
14482	51	171	9	3895	0	4126
14483	25	58	9	3847	0	3939
14484	21	4153	13	166	0	4353
14485	5246	163	7	55	0	5471
14486	255	67	5048	39	0	5409
14487	4993	37	232	21	0	5283
14488	290	34	5118	18	0	5460
14489	4796	35	272	24	0	5127
14490	295	19	5022	28	0	5364
14491	85	4910	260	18	0	5273
14492	57	239	77	5186	0	5559
14493	5207	61	58	256	0	5582
14494	267	54	5085	63	0	5469
14495	82	38	5254	50	0	5424
14496	55	19	298	5034	0	5406
14497	54	25	5138	263	0	5480
14498	32	24	290	5063	0	5409
14499	46	20	91	5245	0	5402
14500	46	22	5036	330	0	5434
14501	41	24	277	5138	0	5480
14502	5896	20	96	313	0	6325
14503	279	5687	79	101	0	6146
14504	6222	251	71	65	0	6609
14505	293	73	61	6164	0	6591
14506	6216	48	42	297	0	6603
14507	6700	41	50	92	0	6883
14508	354	31	50	6323	0	6758
14509	139	6272	42	267	0	6720
14510	6733	255	53	85	0	7126
14511	318	80	6437	73	0	6908
14512	108	63	6594	65	0	6830
14513	6484	43	316	64	0	6907
14514	315	28	117	6018	0	6478
14515	127	37	6531	287	0	6982
14516	87	27	287	6615	0	7016
14517	6667	32	102	318	0	7119
14518	6813	30	77	109	0	7029
14519	7265	33	83	79	0	7460
14520	405	6905	68	67	0	7445
14521	160	290	49	7092	0	7591
14522	121	90	55	7405	0	7671
14523	7248	63	47	367	0	7725
14524	339	6996	52	152	0	7539
14525	7264	311	58	90	0	7723
14526	396	83	58	7198	0	7735
14527	7261	71	60	337	0	7729
14528	386	71	6888	125	0	7470
14529	158	6826	307	120	0	7411
14530	124	305	114	6466	0	7009
14531	104	6965	103	268	0	7440
14532	115	327	60	7204	0	7706
14533	6960	104	71	349	0	7484
14534	357	104	6625	124	0	7210
14535	6642	63	299	110	0	7114
14536	376	6731	105	94	0	7306
14537	169	311	81	6977	0	7538
14538	144	102	69	7329	0	7644
14539	7095	96	61	397	0	7649
14540	393	67	6674	159	0	7293
14541	170	59	306	6976	0	7511
14542	139	56	116	7191	0	7502
14543	125	61	109	7260	0	7555
14544	123	46	91	7394	0	7654
14545	7080	38	93	460	0	7671
14546	7219	65	81	201	0	7566
14547	445	65	7371	161	0	8042
14548	183	69	7321	148	0	7721
14549	7538	64	363	122	0	8087
14550	7917	43	161	119	0	8240
14551	457	50	112	7546	0	8165
14552	201	40	104	7871	0	8216
14553	7620	46	91	431	0	8188
14554	377	7303	83	237	0	8000
14555	191	298	85	7632	0	8206
14556	155	82	74	7990	0	8301
14557	143	76	7375	451	0	8045
14558	117	63	274	7150	0	7604
14559	123	55	6998	409	0	7585
14560	98	47	290	7253	0	7688
14561	6873	48	123	376	0	7420
14562	321	46	108	6930	0	7405
14563	170	41	6624	393	0	7228
14564	153	6284	285	181	0	6903
14565	120	246	104	6295	0	6765
14566	112	99	5999	382	0	6592
14567	106	6508	305	190	0	7109
14568	111	250	97	6297	0	6755
14569	92	128	6006	315	0	6541
14570	5205	84	277	198	0	5764
14571	321	5861	112	151	0	6445
14572	149	6048	108	131	0	6436
14573	73	5833	69	90	0	6065
14574	59	270	44	5743	0	6116
14575	84	118	5459	272	0	5933
14576	73	5455	230	127	0	5885
14577	45	180	53	5226	0	5504
14578	5509	66	54	212	0	5841
14579	215	48	41	6673	0	6977
14580	84	62	8006	341	0	8493
14581	61	8066	343	128	0	8598
14582	8016	364	96	95	0	8571
14583	355	8210	83	92	0	8740
14584	149	415	7627	101	0	8292
14585	55	7011	257	39	0	7362
14586	33	311	88	7084	0	7516
14587	52	158	6848	243	0	7301
14588	47	6920	273	100	0	7340
14589	52	308	103	7006	0	7469
14590	22	156	83	7120	0	7381
14591	12	7009	82	327	0	7430
14592	10	308	51	7291	0	7660
14593	14	135	6917	368	0	7434
14594	22	117	7048	144	0	7331
14595	18	93	289	7196	0	7596
14596	7100	65	129	355	0	7649
14597	7257	61	87	171	0	7576
14598	316	61	69	7047	0	7493
14599	126	6958	99	325	0	7508
14600	86	262	104	7293	0	7745
14601	7128	95	89	374	0	7686
14602	302	84	51	6488	0	6925
14603	178	71	29	6764	0	7042
14604	6314	77	19	405	0	6815
14605	284	6133	46	225	0	6688
14606	114	306	39	6330	0	6789
14607	6067	117	26	393	0	6603
14608	325	77	5584	201	0	6187
14609	5867	66	257	177	0	6367
14610	347	62	74	5974	0	6457
14611	5938	61	61	352	0	6412
14612	6057	78	50	168	0	6353
14613	5903	46	65	152	0	6166
14614	437	5678	80	91	0	6286
14615	217	262	4970	80	0	5529
14616	179	5316	262	96	0	5853
14617	5268	299	80	99	0	5746
14618	401	5349	57	61	0	5868
14619	204	289	32	4778	0	5303
14620	4749	154	40	255	0	5198
14621	270	4782	55	111	0	5218
14622	142	310	4544	97	0	5093
14623	123	160	213	4791	0	5287
14624	104	137	4530	295	0	5066
14625	92	4787	243	158	0	5280
14626	98	294	93	4708	0	5193
14627	86	155	72	4923	0	5236
14628	54	125	90	4960	0	5229
14629	57	74	101	4883	0	5115
14630	56	4705	95	389	0	5245
14631	4769	277	72	214	0	5332
14632	265	158	4588	182	0	5193
14633	130	88	218	4875	0	5311
14634	4795	75	93	377	0	5340
14635	283	100	4594	196	0	5173
14636	126	4580	269	148	0	5123
14637	119	306	137	4592	0	5154
14638	127	134	4501	282	0	5044
14639	86	4654	270	165	0	5175
14640	4529	285	117	159	0	5090
14641	290	4659	119	110	0	5178
14642	118	337	91	4558	0	5104
14643	75	188	73	4902	0	5238
14644	4598	115	82	398	0	5193
14645	264	4626	94	193	0	5177
14646	133	334	53	4747	0	5267
14647	4052	160	50	343	0	4605
14648	4141	141	50	207	0	4539
14649	336	4045	32	221	0	4634
14650	4148	281	38	170	0	4637
14651	4348	152	40	114	0	4654
14652	401	143	27	4113	0	4684
14653	246	90	3861	314	0	4511
14654	192	79	243	4149	0	4663
14655	176	73	85	4331	0	4665
14656	153	99	3825	370	0	4447
14657	135	3972	255	197	0	4559
14658	116	261	101	4106	0	4584
14659	61	120	113	4313	0	4607
14660	61	104	109	4345	0	4619
14661	72	87	56	4289	0	4504
14662	79	4009	67	444	0	4599
14663	4064	281	66	247	0	4658
14664	4203	134	30	250	0	4617
14665	4230	93	29	206	0	4558
14666	380	4022	30	195	0	4627
14667	159	247	21	3620	0	4047
14668	140	128	3245	312	0	3825
14669	154	112	192	3401	0	3859
14670	171	3484	51	280	0	3986
14671	3586	250	47	138	0	4021
14672	3674	125	37	138	0	3974
14673	3580	102	46	152	0	3880
14674	313	3383	72	140	0	3908
14675	159	3460	91	100	0	3810
14676	130	3541	59	114	0	3844
14677	134	328	3893	85	0	4440
14678	154	568	3185	49	0	3956
14679	82	605	301	1476	0	2464
14680	671	1	0	1	0	673
14681	667	0	0	2	0	669
14682	1	0	0	669	0	670
14683	0	0	0	655	0	655
14684	0	0	0	673	0	673
14685	0	1	0	672	0	673
14686	669	0	0	1	0	670
14687	653	0	1	0	0	654
14688	1	1153	5	1	0	1160
14689	1256	2	0	0	0	1258
14690	1241	1	0	0	0	1242
14691	1208	1	0	0	0	1209
14692	3	2	1215	1	0	1221
14693	1146	0	2	1	0	1149
14694	1	1143	1	1	0	1146
14695	1	1	0	1243	0	1245
14696	0	1	0	1251	0	1252
14697	0	1171	2	3	0	1176
14698	0	1	0	1264	0	1265
14699	1262	0	0	1	0	1263
14700	1	1	0	1242	0	1244
14701	1	0	1240	2	0	1243
14702	1147	0	1	0	0	1148
14703	2	1181	0	1	0	1184
14704	0	2	0	1252	0	1254
14705	1	0	0	1235	0	1236
14706	1	0	0	1229	0	1230
14707	2	2	1235	2	0	1241
14708	0	1151	5	1	0	1157
14709	0	2	0	1258	0	1260
14710	0	1	1246	2	0	1249
14711	0	0	2	1198	0	1200
14712	1	1	1253	1	0	1256
14713	0	1	1	1218	0	1220
14714	0	1160	4	2	0	1166
14715	0	2	0	1255	0	1257
14716	1258	0	0	3	0	1261
14717	1222	1	0	0	0	1223
14718	3	3	1195	1	0	1202
14719	2	2	1076	1	0	1081
14720	2	5	2269	1	0	2277
14721	0	0	45	2286	0	2331
14722	1	1	6	2368	0	2376
14723	1	0	3	2435	0	2439
14724	0	2298	5	51	0	2354
14725	3	45	0	2403	0	2451
14726	2	5	1	2414	0	2422
14727	1	3	0	2444	0	2448
14728	2408	0	0	57	0	2465
14729	2351	0	0	9	0	2360
14730	54	2	2339	3	0	2398
14731	14	6	2249	0	0	2269
14732	2233	2	51	3	0	2289
14733	2388	0	9	2	0	2399
14734	56	2	2332	2	0	2392
14735	12	10	2235	1	0	2258
14736	2299	1	48	1	0	2349
14737	2380	0	10	2	0	2392
14738	59	4	2281	2	0	2346
14739	10	0	46	2249	0	2305
14740	5	0	6	2367	0	2378
14741	0	2247	9	50	0	2306
14742	1	47	1	2389	0	2438
14743	2	4	2319	53	0	2378
14744	2	3	46	2300	0	2351
14745	2	0	6	2372	0	2380
14746	4	1	2324	55	0	2384
14747	2052	4	51	13	0	2120
14748	2325	2	8	4	0	2339
14749	53	1	5	2323	0	2382
14750	9	1	1	2368	0	2379
14751	2341	0	1	59	0	2401
14752	2297	2	2	14	0	2315
14753	2314	4	2	7	0	2327
14754	2365	1	1	5	0	2372
14755	58	2233	3	4	0	2298
14756	2318	48	4	5	0	2375
14757	45	2242	11	5	0	2303
14758	10	52	2	2307	0	2371
14759	5	8	3	2328	0	2344
14760	3	2243	5	57	0	2308
14761	3	47	4	2314	0	2368
14762	4	7	1	2324	0	2336
14763	5	2242	6	56	0	2309
14764	6	46	6	2328	0	2386
14765	9	6	1	2323	0	2339
14766	7	5	2	2310	0	2324
14767	7	5	2231	62	0	2305
14768	3	2130	52	16	0	2201
14769	5	51	6	2236	0	2298
14770	5	2215	6	47	0	2273
14771	2296	50	6	11	0	2363
14772	55	14	2201	7	0	2277
14773	11	7	2109	8	0	2135
14774	2166	1	57	7	0	2231
14775	49	5	11	2271	0	2336
14776	12	1	2220	62	0	2295
14777	9	8	1617	18	0	1652
14778	1	5	50	1660	0	1716
14779	1669	1	15	60	0	1745
14780	1639	2	5	18	0	1664
14781	53	4	8	1655	0	1720
14782	18	4	1615	56	0	1693
14783	14	1565	49	20	0	1648
14784	8	52	13	1677	0	1750
14785	12	13	1617	50	0	1692
14786	7	1587	49	22	0	1665
14787	9	46	11	1685	0	1751
14788	1187	11	9	59	0	1266
14789	62	7	7	1137	0	1213
14790	18	1135	16	55	0	1224
14791	1167	50	10	17	0	1244
14792	57	13	1128	14	0	1212
14793	14	1103	51	21	0	1189
14794	10	49	1144	10	0	1213
14795	1086	7	59	14	0	1166
14796	54	5	16	1140	0	1215
14797	18	5	9	1212	0	1244
14798	1180	3	5	66	0	1254
14799	53	6	7	1168	0	1234
14800	16	3	1129	60	0	1208
14801	1052	9	52	16	0	1129
14802	59	1140	13	16	0	1228
14803	15	48	11	1170	0	1244
14804	1155	11	11	57	0	1234
14805	57	1109	12	21	0	1199
14806	19	50	6	1170	0	1245
14807	1173	9	5	54	0	1241
14808	63	9	5	1130	0	1207
14809	17	1083	7	57	0	1164
14810	13	48	1076	21	0	1158
14811	6	17	49	1134	0	1206
14812	11	10	9	1161	0	1191
14813	1159	4	7	65	0	1235
14814	55	11	5	1155	0	1226
14815	1171	6	1	66	0	1244
14816	1190	9	4	14	0	1217
14817	63	10	1	1133	0	1207
14818	16	1132	5	55	0	1208
14819	10	55	2	1172	0	1239
14820	9	0	0	0	0	9
14821	0	10	0	0	0	10
14822	0	10	0	0	0	10
14823	11	0	0	0	0	11
14824	12	0	0	0	0	12
14825	0	576	2	0	0	578
14826	571	26	0	0	0	597
14827	595	13	0	0	0	608
14828	39	5	0	581	0	625
14829	19	6	576	28	0	629
14830	8	2	27	608	0	645
14831	4	2	582	35	0	623
14832	6	1	33	612	0	652
14833	6	1	579	38	0	624
14834	588	4	34	24	0	650
14835	36	1	19	604	0	660
14836	610	1	8	38	0	657
14837	34	2	7	575	0	618
14838	20	1021	9	39	0	1089
14839	1084	32	6	23	0	1145
14840	46	18	1017	11	0	1092
14841	1055	6	31	14	0	1106
14842	39	1040	22	13	0	1114
14843	1071	28	15	7	0	1121
14844	1066	16	7	15	0	1104
14845	54	1024	10	10	0	1098
14846	28	35	5	1072	0	1140
14847	1060	21	10	32	0	1123
14848	47	1015	3	22	0	1087
14849	26	29	7	1080	0	1142
14850	1065	22	4	38	0	1129
14851	42	13	5	1077	0	1137
14852	28	12	1	1100	0	1141
14853	23	4	5	1122	0	1154
14854	12	11	1037	54	0	1114
14855	15	10	31	1571	0	1627
14856	1537	9	16	82	0	1644
14857	85	9	1488	53	0	1635
14858	51	6	71	1556	0	1684
14859	33	7	38	1616	0	1694
14860	18	10	1514	127	0	1669
14861	1512	3	81	74	0	1670
14862	1591	8	46	45	0	1690
14863	115	2	1518	30	0	1665
14864	68	4	78	1516	0	1666
14865	44	3	41	1619	0	1707
14866	17	4	1515	125	0	1661
14867	10	5	82	1588	0	1685
14868	16	1	50	1635	0	1702
14869	17	2	1505	133	0	1657
14870	1513	5	82	71	0	1671
14871	78	4	46	1580	0	1708
14872	1579	2	33	97	0	1711
14873	1621	5	21	62	0	1709
14874	128	7	1510	39	0	1684
14875	78	4	76	1560	0	1718
14876	1538	4	46	89	0	1677
14877	84	1482	36	60	0	1662
14878	56	63	18	1561	0	1698
14879	40	37	15	1610	0	1702
14880	24	22	14	2097	0	2157
14881	21	13	1902	158	0	2094
14882	1907	3	77	91	0	2078
14883	86	2	52	2011	0	2151
14884	57	5	28	2090	0	2180
14885	44	10	1908	139	0	2101
14886	33	7	80	2041	0	2161
14887	29	4	49	2094	0	2176
14888	1947	5	42	146	0	2140
14889	87	1875	31	105	0	2098
14890	65	66	1906	72	0	2109
14891	1988	40	86	48	0	2162
14892	89	21	60	2015	0	2185
14893	60	11	1937	115	0	2123
14894	39	12	1977	84	0	2112
14895	39	2	130	2019	0	2190
14896	28	11	1980	132	0	2151
14897	25	10	1936	90	0	2061
14898	34	1816	141	67	0	2058
14899	23	66	86	1988	0	2163
14900	28	43	1933	119	0	2123
14901	31	27	97	2022	0	2177
14902	1975	20	62	126	0	2183
14903	95	9	58	2013	0	2175
14904	61	12	40	2087	0	2200
14905	1991	7	28	160	0	2186
14906	2026	14	44	98	0	2182
14907	139	11	36	1993	0	2179
14908	83	12	1852	128	0	2075
14909	54	1839	91	96	0	2080
14910	32	71	68	1997	0	2168
14911	1955	44	45	122	0	2166
14912	1980	31	31	97	0	2139
14913	136	1850	31	83	0	2100
14914	85	1950	37	56	0	2128
14915	1976	96	31	61	0	2164
14916	2029	62	24	66	0	2181
14917	138	32	1868	71	0	2109
14918	87	23	93	1856	0	2059
14919	72	1873	62	102	0	2109
14920	1962	71	35	81	0	2149
14921	100	49	36	1915	0	2100
14922	70	1857	40	110	0	2077
14923	59	94	1816	84	0	2053
14924	44	622	99	1276	0	2041
14925	15	1953	53	74	0	2095
14926	2058	51	31	53	0	2193
14927	2053	29	35	38	0	2155
14928	79	1981	21	30	0	2111
14929	2089	56	14	38	0	2197
14930	2046	31	26	23	0	2126
14931	93	1953	26	26	0	2098
14932	60	2009	18	38	0	2125
14933	37	63	28	2076	0	2204
14934	2038	48	29	64	0	2179
14935	64	40	2609	55	0	2768
14936	2592	13	53	50	0	2708
14937	82	2608	51	39	0	2780
14938	2396	57	32	34	0	2519
14939	2400	46	26	24	0	2496
14940	2412	29	19	32	0	2492
14941	112	12	17	2305	0	2446
14942	77	2223	22	61	0	2383
14943	2395	54	20	48	0	2517
14944	75	41	2255	49	0	2420
14945	56	2212	55	45	0	2368
14946	48	55	35	2373	0	2511
14947	32	40	2259	76	0	2407
14948	25	34	2226	53	0	2338
14949	39	20	72	2274	0	2405
14950	33	24	48	2371	0	2476
14951	33	22	42	2423	0	2520
14952	40	23	28	2371	0	2462
14953	32	2189	22	112	0	2355
14954	25	2342	32	79	0	2478
14955	1893	4	8	8	0	1913
14956	12	6	6	1878	0	1902
14957	5	9	9	1872	0	1895
14958	12	6	14	1883	0	1915
14959	1896	4	9	12	0	1921
14960	1861	11	7	12	0	1891
14961	4	7	7	1888	0	1906
14962	1901	6	9	10	0	1926
14963	1869	8	5	16	0	1898
14964	1861	3	10	14	0	1888
14965	14	3	3	1860	0	1880
14966	18	8	1754	12	0	1792
14967	13	12	1636	14	0	1675
14968	13	8	1688	16	0	1725
14969	18	9	1775	5	0	1807
14970	17	4	8	1783	0	1812
14971	1831	6	6	15	0	1858
14972	1770	11	5	12	0	1798
14973	15	8	1786	8	0	1817
14974	15	8	1708	9	0	1740
14975	12	1681	4	10	0	1707
14976	11	10	8	1804	0	1833
14977	1825	5	10	8	0	1848
14978	17	15	1752	6	0	1790
14979	1701	10	5	9	0	1725
14980	0	1266	5	0	0	1271
14981	0	0	0	1368	0	1368
14982	0	0	0	1352	0	1352
14983	1	1	1	1333	0	1336
14984	1373	0	1	0	0	1374
14985	0	0	1	1357	0	1358
14986	0	1	1	1356	0	1358
14987	1374	0	0	1	0	1375
14988	1	1	0	1338	0	1340
14989	1	0	1639	0	0	1640
14990	1569	0	0	0	0	1569
14991	0	1	0	1661	0	1662
14992	0	1	0	1655	0	1656
14993	0	1548	3	1	0	1552
14994	1682	0	0	1	0	1683
14995	1668	0	1	0	0	1669
14996	0	0	0	1617	0	1617
14997	0	2	1645	1	0	1648
14998	1508	0	1	1	0	1510
14999	0	0	1632	1	0	1633
15000	0	1	1	1569	0	1571
15001	1	0	0	1641	0	1642
15002	1662	0	0	0	0	1662
15003	1	0	0	1640	0	1641
15004	0	2	1643	0	0	1645
15005	1511	0	1	4	0	1516
15006	2	0	1621	1	0	1624
15007	0	2	1511	2	0	1515
15008	1508	1	2	0	0	1511
15009	1	1	0	1627	0	1629
15010	0	1528	4	2	0	1534
15011	1633	1	1	1	0	1636
15012	1569	1	0	1	0	1571
15013	1	0	1616	0	0	1617
15014	1571	0	0	1	0	1572
15015	0	1	1	1593	0	1595
15016	1	1	1623	0	0	1625
15017	0	1472	7	2	0	1481
15018	1611	0	1	0	0	1612
15019	1	1538	2	1	0	1542
15020	0	0	1	1614	0	1615
15021	0	1	0	1593	0	1594
15022	1	1	0	1600	0	1602
15023	1	0	1	1537	0	1539
15024	0	1509	4	1	0	1514
15025	0	2	898	0	0	900
15026	0	871	8	1	0	880
15027	963	0	2	0	0	965
15028	0	1	0	946	0	947
15029	958	0	0	1	0	959
15030	0	2	1	947	0	950
15031	2085	1	0	4	0	2090
15032	0	4186	6	3	0	4195
15033	4341	0	0	10	0	4351
15034	4335	0	0	0	0	4335
15035	3685	0	1	0	0	3686
15036	3696	0	1	0	0	3697
15037	0	3584	3	2	0	3589
15038	1	0	3642	0	0	3643
15039	0	0	1	3643	0	3644
15040	3686	0	1	0	0	3687
15041	3688	0	0	0	0	3688
15042	1	0	0	3983	0	3984
15043	1	1	3953	4	0	3959
15044	0	0	4	3967	0	3971
15045	0	3875	4	6	0	3885
15046	3983	4	0	1	0	3988
15047	4	3	0	3987	0	3994
15048	3	3734	6	5	0	3748
15049	1	3915	2	2	0	3920
15050	0	3950	4	3	0	3957
15051	2	9	1	4529	0	4541
15052	4533	2	0	58	0	4593
15053	57	4449	7	12	0	4525
15054	5	60	0	4558	0	4623
15055	4539	6	0	65	0	4610
15056	62	3	0	4560	0	4625
15057	4556	5	0	65	0	4626
15058	4595	3	0	13	0	4611
15059	66	4417	7	9	0	4499
15060	13	63	0	4415	0	4491
15061	9	4465	2	45	0	4521
15062	4566	63	0	7	0	4636
15063	4585	10	0	5	0	4600
15064	5237	6	1	3	0	5247
15065	68	10	0	5138	0	5216
15066	19	10	5056	65	0	5150
15067	5050	6	50	7	0	5113
15068	5229	0	6	9	0	5244
15069	73	0	2	5105	0	5180
15070	14	5023	7	60	0	5104
15071	12	63	1	5175	0	5251
15072	11	7	2	5261	0	5281
15073	5168	10	5	72	0	5255
15074	5211	7	0	16	0	5234
15075	73	11	5107	10	0	5201
15076	18	2	54	5121	0	5195
15077	5021	2	8	77	0	5108
15078	73	0	6	5160	0	5239
15079	17	8	5089	66	0	5180
15080	10	4844	71	13	0	4938
15081	10	5099	10	11	0	5130
15082	5159	70	3	8	0	5240
15083	62	12	3	5117	0	5194
15084	15	14	6	7138	0	7173
15085	7072	15	1	135	0	7223
15086	133	20	6841	56	0	7050
15087	53	4	120	6978	0	7155
15088	37	20	6695	138	0	6890
15089	22	6526	130	59	0	6737
15090	7503	121	35	33	0	7692
15091	7598	36	13	27	0	7674
15092	7629	20	14	24	0	7687
15093	189	36	7238	25	0	7488
15094	8458	24	136	18	0	8636
15095	8582	21	43	18	0	8664
15096	228	18	11	8489	0	8746
15097	8201	10	30	156	0	8397
15098	185	25	8162	53	0	8425
15099	8335	6	146	26	0	8513
15100	205	73	7822	25	0	8125
15101	85	8522	152	36	0	8795
15102	54	186	57	7567	0	7864
15103	63	9306	25	130	0	9524
15104	54	193	8865	66	0	9178
15105	47	9463	159	46	0	9715
15106	9172	172	46	26	0	9416
15107	171	9290	47	42	0	9550
15108	77	9158	50	42	0	9327
15109	70	191	9228	33	0	9522
15110	48	74	160	9388	0	9670
15111	9473	33	62	174	0	9742
15112	189	66	9129	53	0	9437
15113	88	9092	175	30	0	9385
15114	52	187	66	9293	0	9598
15115	57	71	9408	180	0	9716
15116	54	40	9323	86	0	9503
15117	62	34	207	9514	0	9817
15118	73	34	9191	179	0	9477
15119	48	50	184	8708	0	8990
15120	45	9243	91	163	0	9542
15121	47	180	70	9227	0	9524
15122	51	9322	63	174	0	9610
15123	62	164	52	9638	0	9916
15124	9425	72	47	191	0	9735
15125	208	49	38	9409	0	9704
15126	79	9245	50	187	0	9561
15127	69	183	31	9692	0	9975
15128	68	73	9249	202	0	9592
15129	61	48	152	9530	0	9791
15130	9542	28	79	206	0	9855
15131	194	46	8127	92	0	8459
15132	84	50	180	6279	0	6593
15133	6224	36	79	214	0	6553
15134	201	6146	66	96	0	6509
15135	136	185	58	6211	0	6590
15136	6354	91	40	214	0	6699
15137	217	47	68	6413	0	6745
15138	130	71	5857	212	0	6270
15139	6064	51	200	91	0	6406
15140	222	6023	111	74	0	6430
15141	101	6256	78	77	0	6512
15142	6073	212	70	82	0	6437
15143	6115	92	42	85	0	6334
15144	244	75	80	5938	0	6337
15145	6111	94	86	180	0	6471
15146	244	96	5540	95	0	5975
15147	5856	80	185	71	0	6192
15148	218	5841	105	77	0	6241
15149	6077	204	89	81	0	6451
15150	255	83	6070	121	0	6529
15151	131	45	141	5829	0	6146
15152	104	49	113	5853	0	6119
15153	96	79	97	5325	0	5597
15154	73	5831	85	173	0	6162
15155	6005	144	72	115	0	6336
15156	181	79	131	5299	0	5690
15157	135	5980	102	162	0	6379
15158	6818	117	69	139	0	7143
15159	6809	85	99	84	0	7077
15160	6895	86	69	85	0	7135
15161	6846	91	74	89	0	7100
15162	6701	63	78	108	0	6950
15163	229	96	58	6666	0	7049
15164	178	87	66	6151	0	6482
15165	6143	58	78	212	0	6491
15166	182	93	71	6146	0	6492
15167	157	110	47	6163	0	6477
15168	97	88	5449	230	0	5864
15169	5921	100	181	137	0	6339
15170	6199	85	88	144	0	6516
15171	6209	108	75	106	0	6498
15172	208	83	99	5564	0	5954
15173	115	5841	68	193	0	6217
15174	6436	183	83	96	0	6798
15175	6334	115	74	125	0	6648
15176	242	87	48	6347	0	6724
15177	6317	160	93	200	0	6770
15178	194	122	5398	162	0	5876
15179	133	6158	173	136	0	6600
15180	143	6374	116	105	0	6738
15181	313	222	5943	83	0	6561
15182	94	6222	164	125	0	6605
15183	134	4940	98	731	0	5903
15184	3601	42	27	65	0	3735
15185	68	3455	33	88	0	3644
15186	79	34	31	3571	0	3715
15187	3580	27	53	61	0	3721
15188	70	49	3375	61	0	3555
15189	3450	53	30	41	0	3574
15190	93	39	3423	37	0	3592
15191	45	29	3325	81	0	3480
15192	3321	37	41	75	0	3474
15193	78	12	3397	102	0	3589
15194	4	2860	21	3	0	2888
15195	1	13	4	3052	0	3070
15196	3090	3	2	14	0	3109
15197	15	2871	6	6	0	2898
15198	6	13	0	3077	0	3096
15199	4	7	2995	15	0	3021
15200	1	2	16	2938	0	2957
15201	3071	1	4	17	0	3093
15202	16	3	2971	5	0	2995
15203	7	1	15	2310	0	2333
15204	2360	1	5	18	0	2384
15205	2335	1	3	7	0	2346
15206	19	2	1	2305	0	2327
15207	5	3	0	2298	0	2306
15208	4	4	2284	18	0	2310
15209	5	6	2100	5	0	2116
15210	2159	0	17	4	0	2180
15211	2319	0	4	2	0	2325
15212	19	2166	11	1	0	2197
15213	2341	14	2	1	0	2358
15214	2559	5	3	2	0	2569
15215	24	1	3009	0	0	3034
15216	6	2862	25	1	0	2894
15217	3127	14	4	0	0	3145
15218	3100	6	3	0	0	3109
15219	3108	2	1	1	0	3112
15220	21	4	0	3025	0	3050
15221	8	1	0	3070	0	3079
15222	5	2918	5	17	0	2945
15223	1	15	2	3121	0	3139
15224	3128	2	0	19	0	3149
15225	16	2	2	3070	0	3090
15226	9	1	3096	16	0	3122
15227	9	6	2898	6	0	2919
15228	1	3	19	2996	0	3019
15229	3	3	3065	15	0	3086
15230	2	5	2895	7	0	2909
15231	2	8	20	2725	0	2755
15232	1	0	6	2970	0	2977
15233	3	1	2953	19	0	2976
15234	5	5	2897	11	0	2918
15235	2	2760	29	9	0	2800
15236	3033	16	9	2	0	3060
15237	16	2874	5	3	0	2898
15238	3042	15	2	2	0	3061
15239	3047	4	3	1	0	3055
15240	20	2875	8	3	0	2906
15241	3058	15	1	2	0	3076
15242	19	5	0	3000	0	3024
15243	6	6	2994	16	0	3022
15244	5	2	15	2863	0	2885
15245	2	1	5	3056	0	3064
15246	3037	2	3	20	0	3062
15247	2972	1	2	12	0	2987
15248	2988	0	0	6	0	2994
15249	2991	1	2	3	0	2997
15250	2597	0	3	2	0	2602
15251	23	2382	10	3	0	2418
15252	9	14	1	2589	0	2613
15253	6	3	2470	13	0	2492
15254	4	3	15	2438	0	2460
15255	2	1	5	2499	0	2507
15256	1	1	3	2592	0	2597
15257	1884	0	3	22	0	1909
15258	16	0	1	1862	0	1879
15259	1870	3	1	18	0	1892
15260	18	11	2577	7	0	2613
15261	7	2	17	2578	0	2604
15262	6	0	2630	20	0	2656
15263	2568	0	19	4	0	2591
15264	15	2	7	2675	0	2699
15265	9	1	2641	17	0	2668
15266	2	0	17	2577	0	2596
15267	2634	0	5	19	0	2658
15268	18	1	2638	12	0	2669
15269	2535	0	20	4	0	2559
15270	2670	2	4	1	0	2677
15271	2632	0	2	3	0	2637
15272	2635	2	2	0	0	2639
15273	25	2494	9	4	0	2532
15274	2	2148	2	1	0	2153
15275	1	2167	3	3	0	2174
15276	0	3	0	2275	0	2278
15277	1	2213	1	0	0	2215
15278	2291	2	0	0	0	2293
15279	1	2170	5	3	0	2179
15280	0	2130	6	2	0	2138
15281	0	1	0	2263	0	2264
15282	0	5	0	2233	0	2238
15283	2288	1	0	1	0	2290
15284	1	1	0	2215	0	2217
15285	0	2	2125	2	0	2129
15286	1	8	1858	6	0	1873
15287	0	4	2036	1	0	2041
15288	2	3	3	1910	0	1918
15289	0	0	2	3026	0	3028
15290	0	1	3017	28	0	3046
15291	2	3	2843	34	0	2882
15292	0	8	2930	9	0	2947
15293	2885	0	64	6	0	2955
15294	25	0	41	2725	0	2791
15295	25	1	21	2745	0	2792
15296	2749	0	15	60	0	2824
15297	31	2	12	2734	0	2779
15298	41	2570	9	43	0	2663
15299	10	2667	6	43	0	2726
15300	6	50	1	2759	0	2816
15301	2737	30	2	34	0	2803
15302	2689	13	1	44	0	2747
15303	2752	11	3	11	0	2777
15304	63	10	4	2713	0	2790
15305	46	8	2672	36	0	2762
15306	23	4	29	2715	0	2771
15307	14	4	2690	42	0	2750
15308	2511	2	41	39	0	2593
15309	31	0	32	2727	0	2790
15310	2696	1	22	37	0	2756
15311	39	4	2626	45	0	2714
15312	2407	4	43	15	0	2469
15313	49	8	2613	10	0	2680
15314	42	2273	41	14	0	2370
15315	23	2005	32	12	0	2072
15316	2000	50	15	9	0	2074
15317	41	39	8	2010	0	2098
15318	35	16	1964	35	0	2050
15319	13	1924	33	38	0	2008
15320	7	1999	34	14	0	2054
15321	16	63	10	2026	0	2115
15322	2024	41	7	46	0	2118
15323	2010	11	16	41	0	2078
15324	66	1963	14	23	0	2066
15325	2049	38	21	10	0	2118
15326	45	39	14	2029	0	2127
15327	50	17	1952	45	0	2064
15328	30	2749	46	52	0	2877
15329	19	38	40	2938	0	3035
15330	25	39	19	2952	0	3035
15331	2949	16	18	79	0	3062
15332	40	19	2802	60	0	2921
15333	2859	23	33	28	0	2943
15334	2936	10	37	31	0	3014
15335	78	9	12	2908	0	3007
15336	69	12	8	2931	0	3020
15337	3492	13	12	78	0	3595
15338	58	11	13	3482	0	3564
15339	52	6	3415	64	0	3537
15340	24	7	3351	58	0	3440
15341	25	3864	74	44	0	4007
15342	24	4440	52	29	0	4545
15343	32	71	21	4340	0	4464
15344	22	4371	41	53	0	4487
15345	4479	63	27	38	0	4607
15346	48	4478	30	28	0	4584
15347	49	68	14	4532	0	4663
15348	28	48	19	4610	0	4705
15349	28	44	4417	87	0	4576
15350	27	24	45	4368	0	4464
15351	25	26	42	4495	0	4588
15352	14	4438	35	114	0	4601
15353	22	51	24	5117	0	5214
15354	17	54	18	5298	0	5387
15355	25	46	4999	157	0	5227
15356	22	4958	93	108	0	5181
15357	22	100	56	5007	0	5185
15358	27	5111	28	114	0	5280
15359	26	123	4843	80	0	5072
15360	28	4407	100	37	0	4572
15361	4482	120	63	42	0	4707
15362	4462	84	32	30	0	4608
15363	4477	59	18	31	0	4585
15364	161	4422	23	40	0	4646
15365	4538	122	16	30	0	4706
15366	137	77	17	4519	0	4750
15367	4458	43	17	109	0	4627
15368	138	4405	13	90	0	4646
15369	4506	110	11	62	0	4689
15370	4755	70	26	47	0	4898
15371	181	4734	25	57	0	4997
15372	108	134	4743	27	0	5012
15373	52	79	115	4912	0	5158
15374	47	54	5678	129	0	5908
15375	44	38	245	5977	0	6304
15376	29	47	116	6336	0	6528
15377	39	41	5979	377	0	6436
15378	23	35	258	6111	0	6427
15379	6051	36	136	307	0	6530
15380	261	42	5866	173	0	6342
15381	136	5917	255	97	0	6405
15382	58	257	143	5893	0	6351
15383	49	131	56	6347	0	6583
15384	46	74	5794	394	0	6308
15385	49	47	252	5697	0	6045
15386	42	5962	122	301	0	6427
15387	5611	281	73	172	0	6137
15388	235	6105	60	118	0	6518
15389	4998	266	29	59	0	5352
15390	211	5002	39	59	0	5311
15391	87	5826	42	55	0	6010
15392	44	370	5598	42	0	6054
15393	36	138	265	5791	0	6230
15394	32	79	98	5723	0	5932
15395	32	57	67	5796	0	5952
15396	33	5463	55	394	0	5945
15397	35	292	69	5820	0	6216
15398	5627	128	46	381	0	6182
15399	281	69	38	5862	0	6250
15400	5725	52	71	384	0	6232
15401	326	54	5455	201	0	6036
15402	5593	52	280	118	0	6043
15403	325	67	126	5621	0	6139
15404	120	88	62	5958	0	6228
15405	5705	39	52	441	0	6237
15406	317	60	5390	216	0	5983
15407	134	5414	307	134	0	5989
15408	84	305	116	6205	0	6710
15409	6142	169	82	342	0	6735
15410	6401	81	49	189	0	6720
15411	380	98	50	6247	0	6775
15412	177	91	6025	378	0	6671
15413	6081	86	310	189	0	6666
15414	332	97	6071	127	0	6627
15415	146	60	348	6172	0	6726
15416	99	65	6106	412	0	6682
15417	77	67	327	6284	0	6755
15418	85	63	6005	443	0	6596
15419	81	5896	346	224	0	6547
15420	86	313	151	5564	0	6114
15421	121	5996	96	305	0	6518
15422	6176	339	85	190	0	6790
15423	6446	155	71	132	0	6804
15424	423	91	6069	113	0	6696
15425	194	102	308	6100	0	6704
15426	6215	70	134	378	0	6797
15427	356	79	108	6199	0	6742
15428	189	80	81	5643	0	5993
15429	117	68	5202	462	0	5849
15430	5180	79	326	243	0	5828
15431	368	80	5270	193	0	5911
15432	191	39	344	5440	0	6014
15433	145	62	5291	420	0	5918
15434	5334	35	364	248	0	5981
15435	5509	48	196	182	0	5935
15436	5668	53	149	136	0	6006
15437	457	56	156	4853	0	5522
15438	211	54	4688	440	0	5393
15439	145	48	4812	234	0	5239
15440	762	64	397	3851	0	5074
15441	100	4035	207	307	0	4649
15442	3752	343	111	165	0	4371
15443	370	141	74	3789	0	4374
15444	206	95	3627	375	0	4303
15445	156	67	329	3894	0	4446
15446	133	63	3750	389	0	4335
15447	110	56	373	3893	0	4432
15448	115	46	3737	442	0	4340
15449	120	42	3886	245	0	4293
15450	94	3640	404	208	0	4346
15451	87	283	3797	186	0	4353
15452	92	112	3985	156	0	4345
15453	83	54	356	2716	0	3209
15454	77	46	193	2840	0	3156
15455	93	2947	127	315	0	3482
15456	2998	252	116	139	0	3505
15457	324	2993	99	85	0	3501
15458	178	268	76	3049	0	3571
15459	3056	105	98	286	0	3545
15460	290	58	95	3142	0	3585
15461	3080	50	111	325	0	3566
15462	290	52	105	3127	0	3574
15463	160	65	3306	335	0	3866
15464	106	70	262	3489	0	3927
15465	118	39	138	3736	0	4031
15466	3464	25	107	406	0	4002
15467	3529	17	129	209	0	3884
15468	3718	17	114	164	0	4013
15469	356	3349	144	105	0	3954
15470	133	3114	118	100	0	3465
15471	3094	254	104	98	0	3550
15472	241	87	3085	95	0	3508
15473	121	83	3224	93	0	3521
15474	40	293	79	1828	0	2240
15475	28	14	1845	71	0	1958
15476	19	12	1804	24	0	1859
15477	1750	9	66	28	0	1853
15478	1878	7	33	25	0	1943
15479	69	1796	15	29	0	1909
15480	36	2040	9	23	0	2108
15481	27	66	10	1874	0	1977
15482	23	1990	20	48	0	2081
15483	2294	62	13	33	0	2402
15484	64	14	27	2237	0	2342
15485	14	2179	29	77	0	2299
15486	2287	55	26	30	0	2398
15487	66	10	2196	24	0	2296
15488	18	17	2196	16	0	2247
15489	2753	14	72	12	0	2851
15490	77	21	2794	11	0	2903
15491	1711	2	8	0	0	1721
15492	2	2	0	2016	0	2020
15493	1	1	2024	1	0	2027
15494	1	1873	3	3	0	1880
15495	1	1901	5	4	0	1911
15496	2045	0	1	0	0	2046
15497	0	1901	5	2	0	1908
15498	2186	1	1	0	0	2188
15499	2161	0	0	0	0	2161
15500	0	2083	5	3	0	2091
15501	1	2	0	2180	0	2183
15502	2	1	2129	0	0	2132
15503	0	2267	4	3	0	2274
15504	0	15	1	2426	0	2442
15505	0	2	1	2453	0	2456
15506	2460	2	0	19	0	2481
15507	14	1	1	2420	0	2436
15508	3	5	2652	18	0	2678
15509	2	2570	20	6	0	2598
15510	1	18	2	2787	0	2808
15511	3208	2	2	19	0	3231
15512	3223	2	0	5	0	3230
15513	48	0	1	3225	0	3274
15514	3224	1	3	41	0	3269
15515	46	6	3156	10	0	3218
15516	10	0	34	3113	0	3157
15517	11	3	3189	42	0	3245
15518	5	2	40	3321	0	3368
15519	1	0	9	3690	0	3700
15520	3	1	6	3717	0	3727
15521	1	1	4	3733	0	3739
15522	1	2	2	3780	0	3785
15523	3685	0	3	102	0	3790
15524	3701	1	2	34	0	3738
15525	98	3540	8	15	0	3661
15526	3718	75	1	6	0	3800
15527	81	20	1	3696	0	3798
15528	28	7	2	3711	0	3748
15529	8	3	5	3621	0	3637
15530	5	4	3618	113	0	3740
15531	7	5	71	3454	0	3537
15532	5	3514	29	84	0	3632
15533	3675	76	7	35	0	3793
15534	3619	20	4	16	0	3659
15535	98	10	3562	14	0	3684
15536	44	3514	70	16	0	3644
15537	22	72	19	3700	0	3813
15538	13	27	3590	92	0	3722
15539	15	13	72	3463	0	3563
15540	11	3542	31	91	0	3675
15541	3551	74	14	46	0	3685
15542	72	3568	16	30	0	3686
15543	39	80	3523	25	0	3667
15544	18	38	3403	25	0	3484
15545	11	3292	92	33	0	3428
15546	8	3540	30	30	0	3608
15547	3613	92	11	28	0	3744
15548	3668	35	5	20	0	3728
15549	106	16	10	3572	0	3704
15550	37	20	3534	87	0	3678
15551	23	11	78	3508	0	3620
15552	11	13	27	3696	0	3747
15553	3554	13	10	127	0	3704
15554	3317	14	12	57	0	3400
15555	100	5	18	4035	0	4158
15556	39	23	3920	119	0	4101
15557	18	3983	103	57	0	4161
15558	4174	114	38	25	0	4351
15559	123	4265	20	21	0	4429
15560	44	124	15	4686	0	4869
15561	24	47	10	4860	0	4941
15562	18	22	13	4875	0	4928
15563	7	18	18	4537	0	4580
15564	4345	11	16	209	0	4581
15565	143	24	7	4399	0	4573
15566	63	4212	9	163	0	4447
15567	40	143	9	4422	0	4614
15568	4134	44	19	163	0	4360
15569	130	4067	27	67	0	4291
15570	47	146	9	4243	0	4445
15571	30	70	4007	158	0	4265
15572	4028	24	126	67	0	4245
15573	150	15	44	4200	0	4409
15574	69	17	4097	163	0	4346
15575	27	22	4072	68	0	4189
15576	19	17	169	4163	0	4368
15577	4152	13	65	168	0	4398
15578	4183	17	22	65	0	4287
15579	185	4401	19	49	0	4654
15580	4475	140	8	45	0	4668
15581	4504	49	25	50	0	4628
15582	4521	28	19	41	0	4609
15583	4736	27	22	28	0	4813
15584	206	21	10	4560	0	4797
15585	74	24	17	4680	0	4795
15586	51	19	4329	215	0	4614
15587	31	4174	136	114	0	4455
15588	26	4466	52	78	0	4622
15589	38	165	4082	50	0	4335
15590	4076	69	139	55	0	4339
15591	157	32	48	4253	0	4490
15592	4298	26	24	167	0	4515
15593	4311	23	11	81	0	4426
15594	209	25	4080	43	0	4357
15595	82	24	144	4160	0	4410
15596	4213	21	57	175	0	4466
15597	174	18	25	4260	0	4477
15598	75	20	3900	196	0	4191
15599	36	21	145	3881	0	4083
15600	32	3873	72	160	0	4137
15601	45	4064	27	86	0	4222
15602	56	182	3828	36	0	4102
15603	51	3725	120	34	0	3930
15604	3762	151	49	30	0	3992
15605	3816	67	25	36	0	3944
15606	190	24	32	3731	0	3977
15607	92	20	21	3768	0	3901
15608	54	19	21	3350	0	3444
15609	3158	20	13	210	0	3401
15610	142	3128	29	93	0	3392
15611	2762	99	12	35	0	2908
15612	2788	51	12	32	0	2883
15613	146	2671	18	15	0	2850
15614	2718	109	20	17	0	2864
15615	127	2677	15	33	0	2852
15616	2761	101	7	42	0	2911
15617	124	52	2599	42	0	2817
15618	2179	334	87	42	0	2642
15619	71	2142	29	26	0	2268
15620	37	60	16	2235	0	2348
15621	29	24	11	2439	0	2503
15622	18	16	7	2616	0	2657
15623	2548	15	6	124	0	2693
15624	81	7	8	2591	0	2687
15625	40	17	2453	103	0	2613
15626	2498	26	66	46	0	2636
15627	85	20	2469	40	0	2614
15628	48	21	83	2523	0	2675
15629	29	17	2474	95	0	2615
15630	23	9	85	2464	0	2581
15631	21	2467	46	91	0	2625
15632	23	69	25	2523	0	2640
15633	22	2477	23	103	0	2625
15634	35	82	12	2565	0	2694
15635	2549	44	12	97	0	2702
15636	91	31	13	2560	0	2695
15637	2592	12	15	94	0	2713
15638	103	18	2421	57	0	2599
15639	2527	18	62	38	0	2645
15640	2595	11	31	25	0	2662
15641	2601	22	20	20	0	2663
15642	134	13	13	2523	0	2683
15643	2589	11	21	75	0	2696
15644	109	26	2415	45	0	2595
15645	2520	15	75	43	0	2653
15646	115	14	2440	33	0	2602
15647	2514	9	78	34	0	2635
15648	107	15	48	2504	0	2674
15649	76	17	3359	84	0	3536
15650	52	19	82	3330	0	3483
15651	36	8	43	3551	0	3638
15652	44	11	3386	114	0	3555
15653	3139	10	76	82	0	3307
15654	90	4175	51	48	0	4364
15655	3953	41	14	26	0	4034
15656	58	3726	23	26	0	3833
15657	3773	44	10	27	0	3854
15658	64	17	3633	12	0	3726
15659	2896	11	425	29	0	3361
15660	24	2980	12	6	0	3022
15661	17	11	10	3190	0	3228
15662	17	10	2	3166	0	3195
15663	11	5	5	3175	0	3196
15664	16	4	3163	19	0	3202
15665	8	5	12	3031	0	3056
15666	13	3	3183	19	0	3218
15667	3381	0	20	13	0	3414
15668	3494	4	8	11	0	3517
15669	55	2	12	3489	0	3558
15670	21	3	3463	59	0	3546
15671	3142	2	51	20	0	3215
15672	57	6	4458	13	0	4534
15673	11	2	66	4264	0	4343
15674	10	2	10	4505	0	4527
15675	10	3	15	4569	0	4597
15676	21	1	6	4626	0	4654
15677	4523	9	5	82	0	4619
15678	70	4631	12	28	0	4741
15679	24	83	4209	13	0	4329
15680	20	4201	71	19	0	4311
15681	4444	82	14	16	0	4556
15682	86	10	7	4450	0	4553
15683	4122	13	6	95	0	4236
15684	87	5	10	4086	0	4188
15685	20	10	7	4119	0	4156
15686	15	10	9	4206	0	4240
15687	15	13	3992	98	0	4118
15688	14	3832	74	38	0	3958
15689	20	71	3836	24	0	3951
15690	18	11	80	3864	0	3973
15691	3956	9	14	101	0	4080
15692	3909	6	15	36	0	3966
15693	3910	7	15	28	0	3960
15694	94	3758	17	25	0	3894
15695	3916	83	20	22	0	4041
15696	88	19	11	3904	0	4022
15697	25	9	14	3891	0	3939
15698	28	8	5	3948	0	3989
15699	28	3755	13	107	0	3903
15700	33	81	9	3782	0	3905
15701	25	3770	12	85	0	3892
15702	3920	86	17	30	0	4053
15703	3946	21	13	29	0	4009
15704	102	16	13	3880	0	4011
15705	28	15	3748	105	0	3896
15706	3689	12	72	39	0	3812
15707	90	13	14	3928	0	4045
15708	29	14	3808	108	0	3959
15709	3553	12	81	35	0	3681
15710	93	11	20	3895	0	4019
15711	3895	17	14	101	0	4027
15712	96	3721	26	36	0	3879
15713	33	84	11	3880	0	4008
15714	32	4557	17	95	0	4701
15715	24	80	6	4801	0	4911
15716	37	4603	17	95	0	4752
15717	22	79	12	4649	0	4762
15718	28	20	4458	100	0	4606
15719	3522	28	74	43	0	3667
15720	88	4290	29	40	0	4447
15721	12	79	4188	24	0	4303
15722	4047	13	78	20	0	4158
15723	82	10	8	4373	0	4473
15724	24	18	4234	84	0	4360
15725	26	3960	83	32	0	4101
15726	18	79	12	4382	0	4491
15727	22	21	4223	82	0	4348
15728	19	13	72	4201	0	4305
15729	14	15	8	4383	0	4420
15730	12	15	4236	99	0	4362
15731	16	15	70	4258	0	4359
15732	14	24	4438	90	0	4566
15733	18	16	72	4419	0	4525
15734	21	17	5013	91	0	5142
15735	18	11	78	4962	0	5069
15736	26	15	13	5101	0	5155
15737	22	15	12	5110	0	5159
15738	18	4902	38	87	0	5045
15739	5160	75	21	36	0	5292
15740	5071	11	26	34	0	5142
15741	85	10	23	5062	0	5180
15742	5090	14	28	104	0	5236
15743	79	16	4971	52	0	5118
15744	18	4833	78	35	0	4964
15745	5110	80	13	42	0	5245
15746	78	4873	36	38	0	5025
15747	33	88	12	5120	0	5253
15748	19	17	19	5172	0	5227
15749	4219	12	21	97	0	4349
15750	84	23	13	4173	0	4293
15751	29	14	4643	95	0	4781
15752	25	4487	79	41	0	4632
15753	4694	79	10	37	0	4820
15754	83	15	12	3896	0	4006
15755	23	3817	18	104	0	3962
15756	15	78	17	3907	0	4017
15757	20	4192	32	78	0	4322
15758	4418	84	16	34	0	4552
15759	4369	17	22	29	0	4437
15760	89	17	4267	24	0	4397
15761	33	22	4197	32	0	4284
15762	30	13	70	4283	0	4396
15763	18	4139	21	91	0	4269
15764	18	78	16	4441	0	4553
15765	4417	15	16	93	0	4541
15766	87	13	4277	44	0	4421
15767	10	6	21	3541	0	3578
15768	8	8	3609	24	0	3649
15769	10	19	3414	12	0	3455
15770	13	3492	23	12	0	3540
15771	4	20	4	3697	0	3725
15772	2718	0	0	0	0	2718
15773	1	3	2701	0	0	2705
15774	1	2571	2	1	0	2575
15775	2732	0	0	1	0	2733
15776	0	0	0	2719	0	2719
15777	2716	0	0	1	0	2717
15778	2687	0	0	4	0	2691
15779	2616	0	1	2	0	2619
15780	0	2	2666	0	0	2668
15781	2468	0	1	3	0	2472
15782	2679	1	0	1	0	2681
15783	0	2545	4	2	0	2551
15784	0	0	0	2716	0	2716
15785	0	0	0	2678	0	2678
15786	0	0	0	2711	0	2711
15787	2704	0	1	1	0	2706
15788	2550	0	1	3	0	2554
15789	2	3	2849	0	0	2854
15790	2	0	0	2856	0	2858
15791	0	2717	8	2	0	2727
15792	2957	0	0	0	0	2957
15793	2	3	2866	0	0	2871
15794	1	0	0	2828	0	2829
15795	3	2	0	2904	0	2909
15796	0	2761	6	1	0	2768
15797	0	0	0	2956	0	2956
15798	0	0	1	2876	0	2877
15799	1	0	1	2939	0	2941
15800	2935	0	1	3	0	2939
15801	1	0	1	2923	0	2925
15802	0	0	1	2930	0	2931
15803	2923	1	0	1	0	2925
15804	2	0	0	2940	0	2942
15805	0	2793	5	1	0	2799
15806	2936	0	0	1	0	2937
15807	3130	1	2	2	0	3135
15808	3141	1	0	3	0	3145
15809	4519	0	1	0	0	4520
15810	88	5213	12	5	0	5318
15811	8186	109	2	1	0	8298
15812	8488	28	2	3	0	8521
15813	417	31	1	8215	0	8664
15814	94	28	7117	410	0	7649
15815	79	7	359	7376	0	7821
15816	39	3	38	7766	0	7846
15817	34	5	45	7758	0	7842
15818	32	5	18	7834	0	7889
15819	15	6	13	8002	0	8036
15820	7402	5	17	546	0	7970
15821	412	2	5	7595	0	8014
15822	53	18	7155	524	0	7750
15823	66	6	370	7177	0	7619
15824	35	7095	58	464	0	7652
15825	25	380	51	7452	0	7908
15826	31	54	7228	482	0	7795
15827	6910	51	409	114	0	7484
15828	7479	25	61	103	0	7668
15829	458	30	7062	75	0	7625
15830	106	7033	394	55	0	7588
15831	7427	399	53	56	0	7935
15832	7548	46	64	37	0	7695
15833	7514	57	35	44	0	7650
15834	7055	32	24	34	0	7145
15835	519	19	29	6630	0	7197
15836	144	37	6404	439	0	7024
15837	128	12	391	6586	0	7117
15838	92	10	52	7036	0	7190
15839	68	30	6401	491	0	6990
15840	70	56	6651	127	0	6904
15841	6515	23	445	115	0	7098
15842	495	6380	115	92	0	7082
15843	144	401	103	6651	0	7299
15844	132	67	6475	504	0	7178
15845	6497	55	450	165	0	7167
15846	469	37	6422	188	0	7116
15847	6432	22	445	202	0	7101
15848	474	6407	104	178	0	7163
15849	112	413	83	6686	0	7294
15850	134	69	6283	556	0	7042
15851	5927	69	414	170	0	6580
15852	473	6250	133	180	0	7036
15853	95	6836	121	133	0	7185
15854	110	498	77	6507	0	7192
15855	66	146	65	7128	0	7405
15856	6582	117	85	538	0	7322
15857	515	6114	82	176	0	6887
15858	173	453	87	6340	0	7053
15859	6202	98	77	508	0	6885
15860	6638	112	95	133	0	6978
15861	6744	79	63	160	0	7046
15862	670	76	6007	119	0	6872
15863	290	58	6238	110	0	6696
15864	6644	40	441	140	0	7265
15865	603	6484	139	138	0	7364
15866	176	7010	143	175	0	7504
15867	154	496	105	6438	0	7193
15868	104	6693	113	563	0	7473
15869	6729	531	108	223	0	7591
15870	543	128	131	6851	0	7653
15871	176	150	6469	568	0	7363
15872	6764	111	488	175	0	7538
15873	7180	90	150	199	0	7619
15874	590	99	164	6955	0	7808
15875	248	67	147	7306	0	7768
15876	230	60	127	7399	0	7816
15877	211	63	117	7484	0	7875
15878	237	79	6492	684	0	7492
15879	195	6775	437	280	0	7687
15880	147	517	155	6111	0	6930
15881	162	6858	154	520	0	7694
15882	158	597	122	6158	0	7035
15883	119	6898	86	562	0	7665
15884	6871	587	104	232	0	7794
15885	7146	182	70	275	0	7673
15886	579	6888	82	257	0	7806
15887	7064	540	88	179	0	7871
15888	648	167	73	7005	0	7893
15889	6712	151	88	582	0	7533
15890	695	6619	85	165	0	7564
15891	6854	535	78	151	0	7618
15892	7254	151	104	132	0	7641
15893	724	121	124	6694	0	7663
15894	299	128	6415	531	0	7373
15895	279	6486	498	156	0	7419
15896	195	548	140	6758	0	7641
15897	6727	222	129	578	0	7656
15898	593	214	6445	205	0	7457
15899	200	156	449	6591	0	7396
15900	213	150	138	6999	0	7500
15901	6779	104	132	633	0	7648
15902	7060	94	112	272	0	7538
15903	7028	95	107	207	0	7437
15904	693	6574	92	224	0	7583
15905	6890	497	77	235	0	7699
15906	685	126	6394	237	0	7442
15907	238	132	6415	224	0	7009
15908	216	113	6525	206	0	7060
15909	141	338	425	4743	0	5647
15910	115	123	4136	403	0	4777
15911	1262	11	35	17	0	1325
15912	54	14	15	1282	0	1365
15913	29	18	1240	42	0	1329
15914	1254	8	29	37	0	1328
15915	44	9	22	1260	0	1335
15916	36	12	17	1273	0	1338
15917	2131	8	18	51	0	2208
15918	50	14	13	2087	0	2164
15919	24	17	2083	49	0	2173
15920	24	9	38	2063	0	2134
15921	21	16	2067	51	0	2155
15922	15	13	53	2058	0	2139
15923	2080	9	21	41	0	2151
15924	45	1941	20	41	0	2047
15925	21	2045	18	35	0	2119
15926	39	36	12	2094	0	2181
15927	30	18	10	2090	0	2148
15928	24	1989	17	51	0	2081
15929	38	2040	9	33	0	2120
15930	18	44	27	2099	0	2188
15931	23	17	13	2121	0	2174
15932	2081	14	18	51	0	2164
15933	39	1983	19	41	0	2082
15934	26	1963	26	24	0	2039
15935	24	2020	13	49	0	2106
15936	2068	41	20	39	0	2168
15937	50	24	2008	26	0	2108
15938	1919	21	44	26	0	2010
15939	45	15	23	2092	0	2175
15940	33	1937	19	56	0	2045
15941	29	2031	7	40	0	2107
15942	2581	54	10	40	0	2685
15943	79	35	11	2399	0	2524
15944	40	2670	11	67	0	2788
15945	2813	63	25	36	0	2937
15946	2758	29	24	31	0	2842
15947	92	22	2708	28	0	2850
15948	2690	20	59	39	0	2808
15949	2724	34	18	14	0	2790
15950	85	35	12	2650	0	2782
15951	55	2606	18	55	0	2734
15952	23	2135	16	51	0	2225
15953	29	79	14	2204	0	2326
15954	2167	32	6	75	0	2280
15955	81	32	1999	41	0	2153
15956	42	31	1975	27	0	2075
15957	529	21	1462	23	0	2035
15958	52	24	1981	34	0	2091
15959	22	1966	76	33	0	2097
15960	27	2019	30	20	0	2096
15961	27	89	1924	13	0	2053
15962	30	28	1976	27	0	2061
15963	37	1925	80	21	0	2063
15964	1	24	11	1503	0	1539
15965	4	13	1498	23	0	1538
15966	3	1	28	1412	0	1444
15967	3	4	14	1501	0	1522
15968	3	3	1	1544	0	1551
15969	5	2	2	1556	0	1565
15970	4	0	1527	34	0	1565
15971	5	2	25	1461	0	1493
15972	1533	5	10	30	0	1578
15973	27	5	1448	19	0	1499
15974	1350	3	28	2	0	1383
15975	27	2	13	1395	0	1437
15976	16	6	1350	30	0	1402
15977	1331	0	31	12	0	1374
15978	31	0	18	1398	0	1447
15979	1413	2	5	31	0	1451
15980	26	6	4	1371	0	1407
15981	14	1305	8	23	0	1350
15982	3	28	1315	18	0	1364
15983	6	16	25	1372	0	1419
15984	1406	2	14	29	0	1451
15985	1387	3	10	14	0	1414
15986	1390	4	8	2	0	1404
15987	1403	0	6	8	0	1417
15988	1382	3	4	4	0	1393
15989	32	1326	3	10	0	1371
15990	1411	30	4	4	0	1449
15991	27	13	1334	4	0	1378
15992	1345	5	26	6	0	1382
15993	29	4	15	1257	0	1305
15994	18	4	1355	16	0	1393
15995	10	5	1291	12	0	1318
15996	8	3	39	1326	0	1376
15997	1381	1	14	30	0	1426
15998	25	1319	4	20	0	1368
15999	1386	26	6	5	0	1423
16000	27	1339	7	13	0	1386
16001	18	25	4	1382	0	1429
16002	6	15	6	1399	0	1426
16003	1393	3	5	40	0	1441
16004	31	5	7	1376	0	1419
16005	16	4	1338	32	0	1390
16006	1302	3	28	18	0	1351
16007	34	5	15	1368	0	1422
16008	27	1	6	1358	0	1392
16009	8	9	1330	38	0	1385
16010	1212	7	28	20	0	1267
16011	1336	3	17	6	0	1362
16012	41	1276	8	12	0	1337
16013	15	30	1304	8	0	1357
16014	11	17	1571	10	0	1609
16015	15	3	40	1560	0	1618
16016	10	4	18	1528	0	1560
16017	12	971	8	37	0	1028
16018	10	28	983	10	0	1031
16019	9	10	29	989	0	1037
16020	9	9	984	26	0	1028
16021	5	10	26	967	0	1008
16022	6	967	21	32	0	1026
16023	8	24	11	1006	0	1049
16024	6	12	9	1020	0	1047
16025	4	1	9	1035	0	1049
16026	997	6	7	42	0	1052
16027	27	3	953	19	0	1002
16028	14	968	29	15	0	1026
16029	9	27	13	1166	0	1215
16030	1158	10	6	47	0	1221
16031	39	5	9	1169	0	1222
16032	1172	8	6	49	0	1235
16033	43	6	1088	27	0	1164
16034	1145	2	38	14	0	1199
16035	51	3	14	1177	0	1245
16036	32	4	1129	43	0	1208
16037	14	1128	41	35	0	1218
16038	21	32	15	1161	0	1229
16039	13	11	21	1198	0	1243
16040	1164	8	6	52	0	1230
16041	43	1129	11	36	0	1219
16042	1	628	17	7	0	653
16043	6	765	3	4	0	778
16044	587	13	0	14	0	614
16045	12	570	2	14	0	598
16046	13	17	2	584	0	616
16047	8	15	1	604	0	628
16048	593	18	0	13	0	624
16049	12	587	0	24	0	623
16050	30	11	3	599	0	643
16051	602	14	10	58	0	684
16052	642	6	0	27	0	675
16053	598	1	9	68	0	676
16054	76	581	18	2	0	677
16055	602	34	39	11	0	686
16056	56	2	8	605	0	671
16057	17	577	11	59	0	664
16058	31	593	42	8	0	674
16059	12	64	0	611	0	687
16060	596	30	1	60	0	687
16061	619	23	0	47	0	689
16062	66	18	0	580	0	664
16063	8	634	7	12	0	661
16064	607	69	1	14	0	691
16065	25	48	564	32	0	669
16066	67	17	574	9	0	667
16067	594	56	10	18	0	678
16068	24	4	575	72	0	675
16069	23	19	13	627	0	682
16070	660	8	1	21	0	690
16071	30	48	19	593	0	690
16072	24	18	579	56	0	677
16073	84	560	17	7	0	668
16074	62	19	13	818	0	912
16075	52	28	793	32	0	905
16076	795	59	20	18	0	892
16077	61	14	3	845	0	923
16078	24	16	810	61	0	911
16079	20	65	17	807	0	909
16080	14	830	5	51	0	900
16081	24	33	20	842	0	919
16082	78	8	4	828	0	918
16083	49	19	13	819	0	900
16084	18	788	26	62	0	894
16085	815	61	11	25	0	912
16086	59	14	27	812	0	912
16087	15	14	49	845	0	923
16088	28	8	50	838	0	924
16089	46	10	790	56	0	902
16090	16	16	67	821	0	920
16091	818	11	6	74	0	909
16092	59	782	20	40	0	901
16093	11	29	20	855	0	915
16094	19	18	40	841	0	918
16095	796	47	28	43	0	914
16096	24	1450	26	69	0	1569
16097	1497	99	41	28	0	1665
16098	1686	35	12	19	0	1752
16099	114	8	10	1657	0	1789
16100	1577	13	40	133	0	1763
16101	122	1561	1	72	0	1756
16102	1604	162	11	30	0	1807
16103	123	21	3	1647	0	1794
16104	1619	21	2	167	0	1809
16105	1707	19	12	78	0	1816
16106	137	56	1482	33	0	1708
16107	1618	19	95	38	0	1770
16108	1689	6	15	76	0	1786
16109	1636	12	18	80	0	1746
16110	135	23	1508	63	0	1729
16111	50	1531	125	37	0	1743
16112	39	103	28	1617	0	1787
16113	1591	23	10	114	0	1738
16114	121	1333	9	37	0	1500
16115	1363	100	10	59	0	1532
16116	142	28	20	1380	0	1570
16117	82	24	1265	126	0	1497
16118	1315	58	96	25	0	1494
16119	176	19	18	1339	0	1552
16120	81	21	1293	128	0	1523
16121	1352	27	93	83	0	1555
16122	144	30	1439	36	0	1649
16123	49	49	114	1449	0	1661
16124	81	21	27	1598	0	1727
16125	1538	7	16	173	0	1734
16126	1591	9	31	37	0	1668
16127	189	1458	25	38	0	1710
16128	1563	105	76	21	0	1765
16129	131	17	1283	17	0	1448
16130	42	7	1354	16	0	1419
16131	1304	13	94	16	0	1427
16132	113	1302	25	20	0	1460
16133	1341	99	13	17	0	1470
16134	114	1325	17	22	0	1478
16135	1380	107	7	7	0	1501
16136	127	27	7	1321	0	1482
16137	47	14	1292	100	0	1453
16138	37	16	94	1336	0	1483
16139	30	12	26	1437	0	1505
16140	1357	15	20	120	0	1512
16141	125	11	1301	30	0	1467
16142	1314	21	92	19	0	1446
16143	124	1192	22	29	0	1367
16144	1235	98	21	23	0	1377
16145	121	22	13	1226	0	1382
16146	55	12	1169	115	0	1351
16147	35	14	96	1238	0	1383
16148	1227	8	27	118	0	1380
16149	121	15	18	1236	0	1390
16150	46	11	22	1267	0	1346
16151	42	1171	20	114	0	1347
16152	37	101	13	1237	0	1388
16153	41	27	1167	111	0	1346
16154	36	26	93	1215	0	1370
16155	36	16	21	1317	0	1390
16156	1221	11	21	134	0	1387
16157	125	10	24	1236	0	1395
16158	30	14	1152	135	0	1331
16159	35	1181	99	50	0	1365
16160	26	106	17	1164	0	1313
16161	30	24	26	1293	0	1373
16162	1225	22	17	130	0	1394
16163	114	1183	22	47	0	1366
16164	46	98	11	2274	0	2429
16165	2231	22	11	134	0	2398
16166	2331	18	21	44	0	2414
16167	124	19	17	2281	0	2441
16168	50	16	2163	118	0	2347
16169	2140	16	95	54	0	2305
16170	133	12	19	2268	0	2432
16171	2261	27	18	126	0	2432
16172	2266	13	11	40	0	2330
16173	136	2191	20	40	0	2387
16174	2001	92	14	36	0	2143
16175	116	1934	16	34	0	2100
16176	51	90	13	2010	0	2164
16177	35	18	15	2027	0	2095
16178	34	1928	27	100	0	2089
16179	2047	105	16	36	0	2204
16180	2065	28	15	35	0	2143
16181	124	25	1921	30	0	2100
16182	49	24	1944	31	0	2048
16183	37	29	88	1922	0	2076
16184	2034	21	18	119	0	2192
16185	108	22	20	1993	0	2143
16186	46	9	16	2090	0	2161
16187	31	17	1973	126	0	2147
16188	32	12	1934	41	0	2019
16189	37	8	2010	39	0	2094
16190	1839	11	111	30	0	1991
16191	2017	11	28	35	0	2091
16192	111	1851	27	44	0	2033
16193	50	1986	19	29	0	2084
16194	44	101	18	2006	0	2169
16195	26	35	1943	120	0	2124
16196	1155	2	7	8	0	1172
16197	13	0	1255	5	0	1273
16198	1	0	1	1106	0	1108
16199	0	2	1	1132	0	1135
16200	0	0	0	1157	0	1157
16201	0	1	0	1147	0	1148
16202	1182	0	1	3	0	1186
16203	1	1	0	1164	0	1166
16204	1	2	1151	1	0	1155
16205	911	0	1	2	0	914
16206	1	1	1141	0	0	1143
16207	2	1	1075	0	0	1078
16208	0	1064	3	1	0	1068
16209	0	1	1	1143	0	1145
16210	1152	1	1	0	0	1154
16211	0	0	0	1123	0	1123
16212	1	1	1144	0	0	1146
16213	0	0	0	1093	0	1093
16214	1127	0	1	0	0	1128
16215	0	1081	1	2	0	1084
16216	1127	0	0	1	0	1128
16217	2	1069	4	0	0	1075
16218	1108	1	0	0	0	1109
16219	0	1107	1	0	0	1108
16220	2	1091	1	0	0	1094
16221	3	1	1077	0	0	1081
16222	0	928	1	0	0	929
16223	982	0	1	0	0	983
16224	0	1	0	939	0	940
16225	975	0	0	0	0	975
16226	0	948	0	2	0	950
16227	957	0	0	0	0	957
16228	1	1	941	0	0	943
16229	1	0	0	920	0	921
16230	0	936	1	0	0	937
16231	0	0	0	958	0	958
16232	0	1	0	937	0	938
16233	1133	0	2	1	0	1136
16234	8	1095	2	3	0	1108
16235	1095	6	2	1	0	1104
16236	11	5	1061	0	0	1077
16237	4	3	1015	0	0	1022
16238	3	1061	11	2	0	1077
16239	0	8	5	1110	0	1123
16240	1	4	1085	7	0	1097
16241	0	3	9	944	0	956
16242	1	1	5	1047	0	1054
16243	0	2	1042	11	0	1055
16244	1	2	968	8	0	979
16245	0	1	999	3	0	1003
16246	1	2	995	1	0	999
16247	0	991	14	4	0	1009
16248	2	7	7	1012	0	1028
16249	0	6	4	1041	0	1051
16250	0	3	1031	11	0	1045
16251	1	3	9	955	0	968
16252	0	2	1040	11	0	1053
16253	0	1	12	993	0	1006
16254	0	3	4	1012	0	1019
16255	0	1009	3	14	0	1026
16256	1	8	1	1044	0	1054
16257	0	3	2	988	0	993
16258	0	3	2	1024	0	1029
16259	0	3	997	12	0	1012
16260	0	934	11	5	0	950
16261	988	9	4	4	0	1005
16262	956	4	1	1	0	962
16263	12	7	1	973	0	993
16264	8	0	1	172	0	181
16265	2	174	2	13	0	191
16266	167	8	3	7	0	185
16267	8	178	2	3	0	191
16268	175	11	1	1	0	188
16269	11	6	169	2	0	188
16270	170	3	7	4	0	184
16271	12	172	3	2	0	189
16272	5	9	4	166	0	184
16273	4	4	2	168	0	178
16274	1	172	2	12	0	187
16275	170	8	2	7	0	187
16276	8	7	0	176	0	191
16277	3	3	1	184	0	191
16278	175	1	0	16	0	192
16279	180	1	0	8	0	189
16280	12	2	171	5	0	190
16281	180	1	9	1	0	191
16282	9	1	4	176	0	190
16283	5	1	174	9	0	189
16284	5	2	7	178	0	192
16285	0	0	172	15	0	187
16286	2	1	181	7	0	191
16287	0	3	10	179	0	192
16288	3	1	170	10	0	184
16289	0	173	9	6	0	188
16290	4	8	3	171	0	186
16291	3	4	5	181	0	193
16292	3	5	163	13	0	184
16293	0	256	11	9	0	276
16294	245	14	5	3	0	267
16295	14	3	2	258	0	277
16296	238	4	2	15	0	259
16297	19	250	1	4	0	274
16298	8	16	243	5	0	272
16299	6	5	14	260	0	285
16300	259	3	5	17	0	284
16301	14	5	245	6	0	270
16302	256	5	16	5	0	282
16303	17	244	6	7	0	274
16304	7	266	7	6	0	286
16305	255	20	5	5	0	285
16306	17	12	6	256	0	291
16307	10	3	7	262	0	282
16308	6	255	7	21	0	289
16309	6	18	10	263	0	297
16310	3	10	7	278	0	298
16311	255	8	7	24	0	294
16312	19	8	4	273	0	304
16313	13	9	249	24	0	295
16314	10	7	24	261	0	302
16315	13	7	7	285	0	312
16316	11	12	249	24	0	296
16317	8	14	16	269	0	307
16318	264	7	9	27	0	307
16319	255	9	9	25	0	298
16320	278	6	6	23	0	313
16321	27	8	9	470	0	514
16322	16	6	434	30	0	486
16323	14	442	19	18	0	493
16324	14	28	8	470	0	520
16325	9	12	442	31	0	494
16326	12	7	19	460	0	498
16327	4	4	8	491	0	507
16328	439	7	8	40	0	494
16329	16	734	11	25	0	786
16330	14	17	748	28	0	807
16331	709	10	16	13	0	748
16332	35	724	10	20	0	789
16333	8	602	11	20	0	641
16334	615	10	10	15	0	650
16335	11	6	10	625	0	652
16336	4	7	596	23	0	630
16337	7	7	14	612	0	640
16338	11	583	14	18	0	626
16339	628	9	4	19	0	660
16340	26	6	4	618	0	654
16341	615	10	5	21	0	651
16342	14	13	13	609	0	649
16343	10	1175	14	18	0	1217
16344	1235	32	5	15	0	1287
16345	1246	15	13	13	0	1287
16346	36	1204	9	22	0	1271
16347	1256	27	5	20	0	1308
16348	31	17	8	1230	0	1286
16349	21	1197	9	31	0	1258
16350	1237	32	8	19	0	1296
16351	38	1204	12	12	0	1266
16352	1256	31	6	14	0	1307
16353	35	25	2	1241	0	1303
16354	1258	17	5	32	0	1312
16355	2215	17	4	25	0	2261
16356	2207	12	9	19	0	2247
16357	47	10	10	2176	0	2243
16358	24	19	2	2175	0	2220
16359	2194	22	5	40	0	2261
16360	45	8	2130	25	0	2208
16361	18	12	23	2123	0	2176
16362	23	2109	17	36	0	2185
16363	23	38	6	2196	0	2263
16364	24	22	6	2193	0	2245
16365	30	11	2136	46	0	2223
16366	19	11	29	2272	0	2331
16367	24	2222	19	34	0	2299
16368	26	25	8	2412	0	2471
16369	18	26	2489	50	0	2583
16370	23	18	36	3136	0	3213
16371	26	8	18	3356	0	3408
16372	3527	13	9	145	0	3694
16373	3481	14	14	85	0	3594
16374	145	12	7	3504	0	3668
16375	83	3322	11	115	0	3531
16376	43	3450	18	90	0	3601
16377	54	119	3397	70	0	3640
16378	35	72	84	3515	0	3706
16379	3549	35	47	129	0	3760
16380	109	36	26	3621	0	3792
16381	74	35	3486	143	0	3738
16382	38	35	93	3543	0	3709
16383	28	33	62	3565	0	3688
16384	40	22	42	3674	0	3778
16385	43	25	3394	199	0	3661
16386	39	3370	103	129	0	3641
16387	3470	96	58	98	0	3722
16388	3342	78	41	75	0	3536
16389	136	42	32	3582	0	3792
16390	88	36	3434	127	0	3685
16391	51	3374	96	115	0	3636
16392	54	93	72	3338	0	3557
16393	36	3287	34	85	0	3442
16394	34	3424	20	78	0	3556
16395	3417	117	25	35	0	3594
16396	85	86	3399	44	0	3614
16397	59	39	3366	39	0	3503
16398	21	44	135	3268	0	3468
16399	14	31	75	3448	0	3568
16400	25	41	3365	130	0	3561
16401	17	24	96	3783	0	3920
16402	32	27	3835	111	0	4005
16403	3514	9	118	93	0	3734
16404	78	9	82	3858	0	4027
16405	59	19	3784	118	0	3980
16406	25	14	93	3662	0	3794
16407	15	3692	97	108	0	3912
16408	3836	79	41	84	0	4040
16409	87	3784	43	60	0	3974
16410	3984	92	39	31	0	4146
16411	110	66	3789	48	0	4013
16412	3821	38	93	36	0	3988
16413	108	24	60	3909	0	4101
16414	68	37	3862	105	0	4072
16415	56	23	98	3890	0	4067
16416	36	32	3831	116	0	4015
16417	3562	14	111	86	0	3773
16418	101	4175	89	68	0	4433
16419	78	78	51	4081	0	4288
16420	34	4283	38	116	0	4471
16421	4167	102	45	79	0	4393
16422	4166	69	20	68	0	4323
16423	142	4109	39	53	0	4343
16424	105	104	16	4101	0	4326
16425	66	92	25	4211	0	4394
16426	67	43	11	4231	0	4352
16427	4190	40	14	174	0	4418
16428	104	4107	32	113	0	4356
16429	73	84	23	3322	0	3502
16430	40	72	20	3400	0	3532
16431	3317	33	18	163	0	3531
16432	92	34	3179	123	0	3428
16433	68	33	3131	86	0	3318
16434	3103	27	119	71	0	3320
16435	93	27	3273	73	0	3466
16436	78	23	3220	73	0	3394
16437	46	30	131	3143	0	3350
16438	3280	24	99	101	0	3504
16439	106	26	66	3178	0	3376
16440	84	35	3223	101	0	3443
16441	3063	22	113	62	0	3260
16442	93	26	3205	71	0	3395
16443	87	3084	117	62	0	3350
16444	44	78	87	3273	0	3482
16445	3249	65	66	107	0	3487
16446	100	34	49	3298	0	3481
16447	68	33	58	3350	0	3509
16448	3375	25	43	140	0	3583
16449	97	21	58	3716	0	3892
16450	73	31	54	3730	0	3888
16451	50	32	3594	182	0	3858
16452	57	15	76	3734	0	3882
16453	3718	14	70	140	0	3942
16454	3643	18	40	126	0	3827
16455	2977	19	41	74	0	3111
16456	152	23	41	2837	0	3053
16457	94	2801	25	134	0	3054
16458	2903	77	38	87	0	3105
16459	110	2867	34	63	0	3074
16460	2968	92	23	48	0	3131
16461	129	79	23	2903	0	3134
16462	2954	51	21	90	0	3116
16463	2891	34	17	96	0	3038
16464	2820	44	32	60	0	2956
16465	172	2743	37	41	0	2993
16466	99	2638	25	60	0	2822
16467	2002	98	685	40	0	2825
16468	80	2623	61	49	0	2813
16469	67	2465	46	50	0	2628
16470	5	1709	3	2	0	1719
16471	1756	3	0	3	0	1762
16472	1	2	0	1391	0	1394
16473	0	0	0	1416	0	1416
16474	1440	0	1	1	0	1442
16475	1	2	1410	0	0	1413
16476	1	0	0	1368	0	1369
16477	1	0	0	1409	0	1410
16478	0	1	0	1415	0	1416
16479	1	0	1	1734	0	1736
16480	0	1654	7	34	0	1695
16481	1	2432	4	9	0	2446
16482	2780	78	2	5	0	2865
16483	92	24	1	2812	0	2929
16484	21	12	1	2937	0	2971
16485	14	12	2726	118	0	2870
16486	8	7	84	2834	0	2933
16487	5	4	3187	118	0	3314
16488	2	6	98	3269	0	3375
16489	1	9	3215	115	0	3340
16490	9	3046	115	41	0	3211
16491	3	86	30	3324	0	3443
16492	3270	22	17	110	0	3419
16493	3271	15	15	40	0	3341
16494	117	13	8	3278	0	3416
16495	43	13	3230	104	0	3390
16496	25	14	3134	41	0	3214
16497	3080	4	109	24	0	3217
16498	99	3123	50	19	0	3291
16499	3319	89	19	24	0	3451
16500	3353	22	18	15	0	3408
16501	133	18	2753	17	0	2921
16502	47	9	97	2751	0	2904
16503	28	7	38	2941	0	3014
16504	22	6	30	3041	0	3099
16505	18	7	13	3046	0	3084
16506	10	11	10	3034	0	3065
16507	16	11	2835	162	0	3024
16508	15	9	2816	72	0	2912
16509	14	6	127	2846	0	2993
16510	13	4	45	2932	0	2994
16511	10	4	29	3008	0	3051
16512	2870	5	26	158	0	3059
16513	110	12	17	2917	0	3056
16514	2894	9	10	148	0	3061
16515	131	10	13	3192	0	3346
16516	3169	4	19	141	0	3333
16517	3220	5	11	69	0	3305
16518	2793	3	18	53	0	2867
16519	2794	6	11	57	0	2868
16520	2795	4	16	39	0	2854
16521	159	5	11	2703	0	2878
16522	2705	5	15	135	0	2860
16523	129	2547	21	56	0	2753
16524	2703	99	19	48	0	2869
16525	140	29	21	2703	0	2893
16526	59	20	2620	136	0	2835
16527	42	11	104	2694	0	2851
16528	44	12	2614	149	0	2819
16529	38	9	116	2668	0	2831
16530	35	4	45	2791	0	2875
16531	33	19	2611	154	0	2817
16532	36	6	2622	77	0	2741
16533	38	4	125	2690	0	2857
16534	2671	11	55	149	0	2886
16535	134	8	2552	73	0	2767
16536	57	2370	127	63	0	2617
16537	39	92	2581	55	0	2767
16538	2588	33	121	58	0	2800
16539	122	20	59	2653	0	2854
16540	2697	20	41	132	0	2890
16541	2747	14	27	60	0	2848
16542	156	10	19	2695	0	2880
16543	72	7	2574	144	0	2797
16544	42	7	107	2678	0	2834
16545	45	4	45	2774	0	2868
16546	2562	6	25	179	0	2772
16547	127	2477	27	84	0	2715
16548	61	98	20	2614	0	2793
16549	55	31	2138	144	0	2368
16550	2148	20	111	66	0	2345
16551	127	2154	48	53	0	2382
16552	60	102	31	2242	0	2435
16553	54	29	21	2337	0	2441
16554	41	18	22	2390	0	2471
16555	2264	19	22	162	0	2467
16556	2338	10	21	86	0	2455
16557	154	6	21	2687	0	2868
16558	79	15	2480	184	0	2758
16559	46	2535	134	86	0	2801
16560	2629	130	49	67	0	2875
16561	2936	34	37	69	0	3076
16562	211	24	32	2857	0	3124
16563	84	19	15	3039	0	3157
16564	65	23	2662	211	0	2961
16565	48	2746	155	98	0	3047
16566	2866	156	59	70	0	3151
16567	2896	47	40	52	0	3035
16568	195	2790	36	45	0	3066
16569	2948	169	21	53	0	3191
16570	217	47	18	2910	0	3192
16571	89	43	2779	192	0	3103
16572	74	26	153	2913	0	3166
16573	65	22	2744	213	0	3044
16574	2798	11	163	92	0	3064
16575	170	2732	74	78	0	3054
16576	67	163	45	2876	0	3151
16577	68	46	2726	194	0	3034
16578	57	39	2773	85	0	2954
16579	2413	23	142	47	0	2625
16580	136	2430	59	58	0	2683
16581	1781	69	17	19	0	1886
16582	1449	14	13	13	0	1489
16583	1472	9	11	9	0	1501
16584	79	6	8	1405	0	1498
16585	30	6	1357	69	0	1462
16586	21	1327	57	20	0	1425
16587	13	63	19	981	0	1076
16588	11	14	964	67	0	1056
16589	13	11	999	13	0	1036
16590	14	12	71	985	0	1082
16591	16	12	961	68	0	1057
16592	954	10	61	18	0	1043
16593	71	4	19	964	0	1058
16594	32	5	13	1033	0	1083
16595	986	7	15	73	0	1081
16596	72	948	10	28	0	1058
16597	987	63	6	23	0	1079
16598	71	20	10	989	0	1090
16599	22	15	13	1038	0	1088
16600	21	7	19	1043	0	1090
16601	10	6	16	1055	0	1087
16602	984	3	19	94	0	1100
16603	67	11	925	38	0	1041
16604	23	876	55	30	0	984
16605	22	48	15	932	0	1017
16606	873	13	16	67	0	969
16607	951	16	18	25	0	1010
16608	71	907	11	22	0	1011
16609	905	56	10	22	0	993
16610	80	872	9	21	0	982
16611	34	948	8	29	0	1019
16612	21	63	6	936	0	1026
16613	23	23	871	72	0	989
16614	16	25	53	919	0	1013
16615	672	11	22	79	0	784
16616	70	1192	20	35	0	1317
16617	29	61	15	1240	0	1345
16618	32	20	1187	66	0	1305
16619	1227	24	52	26	0	1329
16620	1294	14	24	21	0	1353
16621	1307	13	16	28	0	1364
16622	76	20	1200	17	0	1313
16623	1240	13	51	25	0	1329
16624	72	1216	26	18	0	1332
16625	35	62	16	1184	0	1297
16626	21	1220	23	68	0	1332
16627	1249	64	19	28	0	1360
16628	1273	29	14	26	0	1342
16629	72	19	1171	26	0	1288
16630	50	1189	54	13	0	1306
16631	45	57	24	1212	0	1338
16632	45	16	13	1288	0	1362
16633	30	20	18	1281	0	1349
16634	27	16	14	1274	0	1331
16635	24	17	8	1300	0	1349
16636	21	15	1186	88	0	1310
16637	22	1210	51	42	0	1325
16638	1242	65	25	25	0	1357
16639	72	27	1195	20	0	1314
16640	30	1205	67	16	0	1318
16641	1253	71	25	18	0	1367
16642	68	24	1209	26	0	1327
16643	1471	12	51	37	0	1571
16644	1519	16	20	29	0	1584
16645	1493	13	11	34	0	1551
16646	84	1433	18	26	0	1561
16647	36	63	1435	31	0	1565
16648	31	1447	53	25	0	1556
16649	27	69	21	1359	0	1476
16650	23	1469	17	54	0	1563
16651	1513	69	15	20	0	1617
16652	1531	28	20	19	0	1598
16653	1541	21	15	15	0	1592
16654	87	18	1451	18	0	1574
16655	55	1856	59	14	0	1984
16656	47	81	421	1568	0	2117
16657	1932	11	5	53	0	2001
16658	63	1904	5	11	0	1983
16659	26	60	3	1977	0	2066
16660	23	24	1922	60	0	2029
16661	1690	11	38	17	0	1756
16662	44	8	1955	11	0	2018
16663	18	8	1956	1	0	1983
16664	1885	2	54	2	0	1943
16665	46	6	1941	1	0	1994
16666	1934	2	51	2	0	1989
16667	55	1888	28	2	0	1973
16668	1952	43	18	2	0	2015
16669	60	18	6	1912	0	1996
16670	21	14	7	1960	0	2002
16671	17	1	8	2017	0	2043
16672	1948	3	5	80	0	2036
16673	1955	1	3	35	0	1994
16674	1954	3	7	17	0	1981
16675	76	1888	4	6	0	1974
16676	31	48	3	1965	0	2047
16677	22	19	1874	51	0	1966
16678	5	15	39	1916	0	1975
16679	5	1843	24	63	0	1935
16680	9	49	13	1932	0	2003
16681	10	20	4	1994	0	2028
16682	1946	13	5	64	0	2028
16683	52	4	4	1985	0	2045
16684	19	12	1915	65	0	2011
16685	20	6	1883	41	0	1950
16686	9	6	62	1973	0	2050
16687	1916	7	34	54	0	2011
16688	51	7	17	1934	0	2009
16689	25	6	8	2012	0	2051
16690	25	1	1866	75	0	1967
16691	11	1841	56	42	0	1950
16692	11	45	25	1978	0	2059
16693	1908	23	26	54	0	2011
16694	54	1891	18	26	0	1989
16695	30	50	6	1965	0	2051
16696	1068	26	881	58	0	2033
16697	39	22	19	1991	0	2071
16698	1923	6	23	74	0	2026
16699	56	1861	33	35	0	1985
16700	36	57	1860	30	0	1983
16701	30	27	45	1915	0	2017
16702	21	20	1908	66	0	2015
16703	1904	11	60	37	0	2012
16704	1975	13	30	31	0	2049
16705	75	16	1893	17	0	2001
16706	48	7	51	1907	0	2013
16707	31	11	1895	63	0	2000
16708	15	1879	64	46	0	2004
16709	17	52	33	1972	0	2074
16710	24	25	1915	65	0	2029
16711	22	22	54	1853	0	1951
16712	21	1859	35	78	0	1993
16713	18	58	29	1954	0	2059
16714	16	31	1878	83	0	2008
16715	1842	19	56	46	0	1963
16716	60	1382	40	36	0	1518
16717	1439	59	24	30	0	1552
16718	71	31	2085	30	0	2217
16719	2130	23	60	29	0	2242
16720	72	17	2122	36	0	2247
16721	2133	17	73	21	0	2244
16722	2236	14	38	24	0	2312
16723	85	12	29	2165	0	2291
16724	64	15	16	2201	0	2296
16725	2184	22	9	95	0	2310
16726	67	2082	19	65	0	2233
16727	2199	53	22	44	0	2318
16728	78	36	21	2140	0	2275
16729	43	2497	27	75	0	2642
16730	35	55	20	2653	0	2763
16731	25	27	19	2685	0	2756
16732	17	19	25	2641	0	2702
16733	25	2541	23	101	0	2690
16734	2638	65	20	59	0	2782
16735	69	29	15	2666	0	2779
16736	43	28	2580	72	0	2723
16737	31	16	2481	57	0	2585
16738	17	23	2515	56	0	2611
16739	2561	9	88	32	0	2690
16740	2651	15	44	30	0	2740
16741	95	18	2592	26	0	2731
16742	56	18	52	2463	0	2589
16743	36	10	38	2416	0	2500
16744	19	15	2599	93	0	2726
16745	16	18	2539	59	0	2632
16746	23	13	81	2591	0	2708
16747	2587	9	49	69	0	2714
16748	2550	15	20	42	0	2627
16749	2571	13	23	42	0	2649
16750	90	2498	24	42	0	2654
16751	48	2553	30	27	0	2658
16752	33	77	21	2637	0	2768
16753	2616	43	20	69	0	2748
16754	79	38	2529	39	0	2685
16755	1887	17	24	35	0	1963
16756	42	2006	29	23	0	2100
16757	4	1571	8	7	0	1590
16758	1652	11	4	4	0	1671
16759	9	1574	7	2	0	1592
16760	4	1621	3	12	0	1640
16761	1686	12	2	5	0	1705
16762	1	2044	6	3	0	2054
16763	0	2	0	2184	0	2186
16764	1	1	0	2182	0	2184
16765	2204	1	1	2	0	2208
16766	2159	0	0	2	0	2161
16767	1	2029	6	4	0	2040
16768	3	2032	4	2	0	2041
16769	2	4	2100	0	0	2106
16770	2110	0	1	0	0	2111
16771	2191	0	0	0	0	2191
16772	2181	0	1	0	0	2182
16773	1	0	0	2153	0	2154
16774	0	1	0	2169	0	2170
16775	2210	0	0	1	0	2211
16776	1	4	0	2146	0	2151
16777	1	0	2189	1	0	2191
16778	0	1	1	2133	0	2135
16779	0	2084	2	3	0	2089
16780	0	1	0	2181	0	2182
16781	0	1	0	2168	0	2169
16782	0	0	0	2164	0	2164
16783	2185	0	1	1	0	2187
16784	2	2102	3	1	0	2108
16785	0	2	0	2179	0	2181
16786	0	2	2157	2	0	2161
16787	1	2	2028	1	0	2032
16788	0	1	2	2035	0	2038
16789	0	2	0	2162	0	2164
16790	2167	0	0	2	0	2169
16791	2	2	1	2140	0	2145
16792	0	2115	2	4	0	2121
16793	2	4	2065	1	0	2072
16794	0	1	2	2069	0	2072
16795	3	0	2144	2	0	2149
16796	0	2	2	2098	0	2102
16797	2137	0	0	2	0	2139
16798	2146	1	0	1	0	2148
16799	2	2006	5	2	0	2015
16800	0	2	0	2155	0	2157
16801	2160	0	0	3	0	2163
16802	2107	0	0	0	0	2107
16803	2106	0	0	0	0	2106
16804	2115	1	0	0	0	2116
16805	2136	0	1	0	0	2137
16806	2	2003	11	0	0	2016
16807	2157	3	0	1	0	2161
16808	3	2	2049	1	0	2055
16809	2	0	3	2027	0	2032
16810	2142	0	0	3	0	2145
16811	2081	0	0	0	0	2081
16812	2070	0	0	1	0	2071
16813	4	3	2052	0	0	2059
16814	0	0	4	1981	0	1985
16815	2156	0	0	3	0	2159
16816	3	1923	12	2	0	1940
16817	2138	4	0	0	0	2142
16818	1437	1	0	0	0	1438
16819	1411	0	0	0	0	1411
16820	4	1	1	1800	0	1806
16821	1870	0	0	22	0	1892
16822	23	2	1745	9	0	1779
16823	10	4	1743	5	0	1762
16824	1787	1	29	0	0	1817
16825	24	0	1821	1	0	1846
16826	1740	1	24	0	0	1765
16827	26	2	1789	0	0	1817
16828	9	0	26	1764	0	1799
16829	1401	0	6	22	0	1429
16830	21	1907	8	8	0	1944
16831	2000	21	0	5	0	2026
16832	24	1925	7	2	0	1958
16833	7	1941	5	2	0	1955
16834	8	28	0	1998	0	2034
16835	2	12	1	2003	0	2018
16836	3	7	2	1964	0	1976
16837	1	3	1911	31	0	1946
16838	1855	1	21	14	0	1891
16839	2189	0	9	8	0	2206
16840	2201	1	5	0	0	2207
16841	2214	1	0	3	0	2218
16842	2213	0	4	2	0	2219
16843	38	1	2093	0	0	2132
16844	15	3	1915	1	0	1934
16845	7	1	27	1933	0	1968
16846	4	3	1964	21	0	1992
16847	1779	0	26	8	0	1813
16848	20	1875	14	7	0	1916
16849	8	19	7	2144	0	2178
16850	2147	9	0	34	0	2190
16851	34	7	1	2095	0	2137
16852	22	1	2276	34	0	2333
16853	7	3	2205	17	0	2232
16854	1	1	48	2266	0	2316
16855	4	3	2245	36	0	2288
16856	2145	0	40	20	0	2205
16857	33	0	19	2285	0	2337
16858	21	3	2240	35	0	2299
16859	9	2128	40	21	0	2198
16860	3	29	17	2279	0	2328
16861	3	18	2692	34	0	2747
16862	3	5	34	2021	0	2063
16863	5	1	19	2112	0	2137
16864	2	6	2080	51	0	2139
16865	4	1	35	2071	0	2111
16866	1	0	21	2107	0	2129
16867	1	1	9	2142	0	2153
16868	2092	1	4	59	0	2156
16869	34	2005	5	31	0	2075
16870	21	2039	6	11	0	2077
16871	11	53	2829	3	0	2896
16872	2763	27	36	6	0	2832
16873	38	13	2910	4	0	2965
16874	23	6	2876	5	0	2910
16875	10	3	53	2885	0	2951
16876	2983	1	28	38	0	3050
16877	39	2805	15	27	0	2886
16878	2993	32	6	10	0	3041
16879	2961	23	2	7	0	2993
16880	54	3162	6	8	0	3230
16881	3343	41	2	8	0	3394
16882	3300	22	5	6	0	3333
16883	59	3216	6	8	0	3289
16884	24	43	7	3311	0	3385
16885	10	22	8	3345	0	3385
16886	3334	9	8	62	0	3413
16887	43	3863	10	36	0	3952
16888	4251	49	4	16	0	4320
16889	4227	25	7	6	0	4265
16890	4218	6	4	8	0	4236
16891	93	6	3	4142	0	4244
16892	34	5	5	4254	0	4298
16893	4208	1	4	87	0	4300
16894	4136	5	5	38	0	4184
16895	4217	4	8	13	0	4242
16896	88	3	4	4203	0	4298
16897	37	9	4082	66	0	4194
16898	13	4	59	4146	0	4222
16899	7	4	26	4241	0	4278
16900	10	11	4062	87	0	4170
16901	9	16	4967	35	0	5027
16902	13	8	147	5278	0	5446
16903	15	10	5130	150	0	5305
16904	5787	2	146	82	0	6017
16905	139	2	80	6399	0	6620
16906	83	7	22	6541	0	6653
16907	6409	6	10	223	0	6648
16908	147	5	19	6460	0	6631
16909	99	1	7	6489	0	6596
16910	26	7	15	6655	0	6703
16911	19	1	12	6690	0	6722
16912	20	8	6159	245	0	6432
16913	21	4	126	6449	0	6600
16914	27	22	6158	174	0	6381
16915	17	6114	150	124	0	6405
16916	25	128	73	6461	0	6687
16917	20	90	6173	167	0	6450
16918	5781	19	144	119	0	6063
16919	152	6173	102	54	0	6481
16920	6054	118	26	34	0	6232
16921	140	67	18	5744	0	5969
16922	84	5713	26	135	0	5958
16923	5986	118	10	83	0	6197
16924	133	5892	23	45	0	6093
16925	6013	125	14	44	0	6196
16926	144	76	11	5830	0	6061
16927	6019	17	14	140	0	6190
16928	134	5791	25	108	0	6058
16929	5962	136	16	48	0	6162
16930	158	70	5240	42	0	5510
16931	94	25	139	5378	0	5636
16932	5324	14	70	156	0	5564
16933	5378	17	29	105	0	5529
16934	228	16	15	5331	0	5590
16935	109	20	5172	156	0	5457
16936	47	4830	118	115	0	5110
16937	47	5251	74	51	0	5423
16938	5364	184	18	55	0	5621
16939	154	83	19	5150	0	5406
16940	104	26	21	5305	0	5456
16941	5167	19	17	232	0	5435
16942	4977	23	45	107	0	5152
16943	215	32	5001	61	0	5309
16944	102	23	140	5108	0	5373
16945	51	35	4988	171	0	5245
16946	72	4938	141	122	0	5273
16947	4910	138	90	71	0	5209
16948	179	4981	38	70	0	5268
16949	93	4925	28	60	0	5106
16950	43	168	31	5053	0	5295
16951	4964	71	19	182	0	5236
16952	139	4757	31	127	0	5054
16953	4818	130	31	83	0	5062
16954	141	4737	42	78	0	4998
16955	94	133	26	4868	0	5121
16956	4794	86	40	154	0	5074
16957	163	47	4632	109	0	4951
16958	102	29	129	4770	0	5030
16959	54	37	4625	170	0	4886
16960	74	4361	147	124	0	4706
16961	59	4342	76	76	0	4553
16962	4243	164	34	71	0	4512
16963	156	4729	37	74	0	4996
16964	4863	154	42	64	0	5123
16965	4870	98	33	63	0	5064
16966	202	71	4580	63	0	4916
16967	4636	48	128	65	0	4877
16968	160	65	4579	69	0	4873
16969	127	4582	135	71	0	4915
16970	4755	152	87	54	0	5048
16971	181	3907	44	60	0	4192
16972	132	138	39	4017	0	4326
16973	4016	75	47	175	0	4313
16974	174	47	29	4056	0	4306
16975	126	47	3888	168	0	4229
16976	74	55	132	3981	0	4242
16977	49	51	85	4150	0	4335
16978	4004	59	36	227	0	4326
16979	165	65	3816	121	0	4167
16980	3586	64	129	53	0	3832
16981	3727	50	70	70	0	3917
16982	210	52	40	3632	0	3934
16983	137	40	30	3766	0	3973
16984	3689	34	36	208	0	3967
16985	176	3497	48	104	0	3825
16986	133	119	39	3682	0	3973
16987	51	76	2863	115	0	3105
16988	45	39	2551	87	0	2722
16989	45	2592	139	36	0	2812
16990	35	120	60	2689	0	2904
16991	35	86	20	2803	0	2944
16992	2736	35	16	165	0	2952
16993	113	36	14	2779	0	2942
16994	2739	32	20	120	0	2911
16995	130	2569	23	86	0	2808
16996	81	2618	18	38	0	2755
16997	53	2748	19	42	0	2862
16998	2697	144	17	42	0	2900
16999	2666	75	22	45	0	2808
17000	175	2654	20	50	0	2899
17001	1716	3	0	1	0	1720
17002	3	1967	2	1	0	1973
17003	0	2	1	2242	0	2245
17004	0	2202	10	5	0	2217
17005	1880	2	1	0	0	1883
17006	1867	0	0	0	0	1867
17007	2	0	0	1861	0	1863
17008	2396	0	0	3	0	2399
17009	2	1	0	2382	0	2385
17010	0	2274	11	5	0	2290
17011	0	2	0	2392	0	2394
17012	0	2258	3	10	0	2271
17013	2390	2	0	0	0	2392
17014	3	0	2331	0	0	2334
17015	2234	1	3	3	0	2241
17016	3	0	0	2376	0	2379
17017	0	0	2340	2	0	2342
17018	2264	0	5	1	0	2270
17019	4	3	2350	0	0	2357
17020	0	0	1	2284	0	2285
17021	0	0	0	2353	0	2353
17022	0	1	0	2349	0	2350
17023	0	0	0	2720	0	2720
17024	0	2640	4	45	0	2689
17025	1	45	0	3670	0	3716
17026	3674	2	2	64	0	3742
17027	63	12	3496	6	0	3577
17028	4	4598	64	8	0	4674
17029	4782	103	3	3	0	4891
17030	4835	50	7	2	0	4894
17031	154	15	1	4993	0	5163
17032	71	23	4836	112	0	5042
17033	27	13	99	4944	0	5083
17034	24	8	47	5044	0	5123
17035	38	19	4700	182	0	4939
17036	18	5182	113	81	0	5394
17037	5447	129	57	40	0	5673
17038	5422	74	31	30	0	5557
17039	5531	31	21	21	0	5604
17040	230	31	12	5386	0	5659
17041	133	19	16	5563	0	5731
17042	5506	14	9	216	0	5745
17043	183	16	6	5182	0	5387
17044	106	5170	29	184	0	5489
17045	5803	133	10	102	0	6048
17046	6249	79	20	70	0	6418
17047	6458	35	12	61	0	6566
17048	6602	34	11	32	0	6679
17049	375	37	6023	25	0	6460
17050	183	32	6170	23	0	6408
17051	128	23	269	6057	0	6477
17052	116	9	107	6451	0	6683
17053	71	16	6133	304	0	6524
17054	61	21	6260	140	0	6482
17055	44	14	301	6328	0	6687
17056	6253	9	128	290	0	6680
17057	252	19	79	6246	0	6596
17058	135	20	5951	275	0	6381
17059	92	6066	249	133	0	6540
17060	6254	206	106	61	0	6627
17061	6377	78	67	89	0	6611
17062	6426	48	85	55	0	6614
17063	6079	44	64	58	0	6245
17064	378	36	5585	70	0	6069
17065	199	28	234	5836	0	6297
17066	5891	19	119	272	0	6301
17067	331	17	83	5890	0	6321
17068	177	19	74	5756	0	6026
17069	140	5651	61	338	0	6190
17070	123	222	49	5959	0	6353
17071	5773	91	68	323	0	6255
17072	286	5767	57	183	0	6293
17073	5839	264	44	128	0	6275
17074	333	5790	47	133	0	6303
17075	220	267	51	5515	0	6053
17076	148	5537	67	271	0	6023
17077	142	5891	76	164	0	6273
17078	5855	342	50	126	0	6373
17079	317	161	5630	129	0	6237
17080	176	142	5726	109	0	6153
17081	135	117	5650	122	0	6024
17082	5565	91	329	101	0	6086
17083	329	5600	173	108	0	6210
17084	234	5863	129	103	0	6329
17085	5645	349	104	102	0	6200
17086	348	5698	98	95	0	6239
17087	205	5888	78	100	0	6271
17088	164	398	47	5860	0	6469
17089	179	204	5634	313	0	6330
17090	136	184	5748	163	0	6231
17091	168	114	334	5798	0	6414
17092	5669	82	191	325	0	6267
17093	336	5656	169	187	0	6348
17094	224	267	150	5845	0	6486
17095	177	154	5616	358	0	6305
17096	179	129	5761	199	0	6268
17097	146	129	344	5850	0	6469
17098	5791	127	171	357	0	6446
17099	6019	121	133	182	0	6455
17100	435	105	5674	148	0	6362
17101	5701	60	328	166	0	6255
17102	421	77	5173	110	0	5781
17103	261	53	348	4662	0	5324
17104	213	4435	219	283	0	5150
17105	4625	270	158	171	0	5224
17106	357	157	145	4553	0	5212
17107	239	102	124	4758	0	5223
17108	180	104	136	4340	0	4760
17109	173	74	117	4447	0	4811
17110	183	86	3793	490	0	4552
17111	189	3990	304	281	0	4764
17112	179	261	186	4147	0	4773
17113	3977	160	135	391	0	4663
17114	383	110	121	4158	0	4772
17115	223	114	123	4339	0	4799
17116	175	115	3853	441	0	4584
17117	170	110	3959	256	0	4495
17118	173	3940	348	233	0	4694
17119	130	4180	189	237	0	4736
17120	134	347	159	4146	0	4786
17121	4075	191	127	391	0	4784
17122	327	171	3892	245	0	4635
17123	187	3715	275	153	0	4330
17124	137	279	157	3509	0	4082
17125	146	2821	84	256	0	3307
17126	136	263	94	2595	0	3088
17127	113	2869	65	286	0	3333
17128	66	153	42	1658	0	1919
17129	1542	94	35	193	0	1864
17130	140	1584	36	120	0	1880
17131	54	175	41	1472	0	1742
17132	1366	69	42	193	0	1670
17133	144	1391	37	95	0	1667
17134	68	1422	29	86	0	1605
17135	90	1505	31	81	0	1707
17136	27	124	15	964	0	1130
17137	21	49	16	1010	0	1096
17138	22	955	23	106	0	1106
17139	12	134	21	995	0	1162
17140	17	78	912	110	0	1117
17141	17	975	74	57	0	1123
17142	31	569	26	438	0	1064
17143	29	949	34	74	0	1086
17144	26	112	929	40	0	1107
17145	12	580	28	17	0	637
17146	78	0	0	0	0	78
17147	1	0	0	79	0	80
17148	77	0	0	1	0	78
17149	1	0	74	0	0	75
17150	0	1	1	79	0	81
17151	0	0	76	1	0	77
17152	0	0	1	80	0	81
17153	80	0	0	1	0	81
17154	1	0	0	80	0	81
17155	80	0	0	1	0	81
17156	1	73	0	0	0	74
17157	77	1	0	0	0	78
17158	1	0	75	0	0	76
17159	0	75	1	0	0	76
17160	0	1	0	79	0	80
17161	0	0	0	82	0	82
17162	0	0	79	0	0	79
17163	0	73	1	0	0	74
17164	0	0	0	79	0	79
17165	0	75	0	1	0	76
17166	0	1	0	79	0	80
17167	0	77	0	1	0	78
17168	78	1	0	0	0	79
17169	1	0	0	645	0	646
17170	1	1	646	2	0	650
17171	0	602	2	0	0	604
17172	0	627	1	0	0	628
17173	2	1	621	0	0	624
17174	0	615	2	0	0	617
17175	0	1	0	628	0	629
17176	0	554	76	1	0	631
17177	0	0	1	640	0	641
17178	0	0	0	621	0	621
17179	0	0	640	1	0	641
17180	559	1	1	1	0	562
17181	1	0	0	630	0	631
17182	1	0	641	1	0	643
17183	0	627	1	0	0	628
17184	651	1	0	0	0	652
17185	1	605	0	1	0	607
17186	0	1	0	646	0	647
17187	655	0	0	1	0	656
17188	1	0	0	636	0	637
17189	0	0	645	1	0	646
17190	0	0	1	606	0	607
17191	0	1	638	1	0	640
17192	606	0	1	0	0	607
17193	1	0	645	0	0	646
17194	618	0	1	0	0	619
17195	618	0	0	0	0	618
17196	1	0	636	0	0	637
17197	0	0	604	2	0	606
17198	0	617	1	0	0	618
17199	651	1	0	0	0	652
17200	1	0	0	634	0	635
17201	0	0	0	630	0	630
17202	666	0	0	1	0	667
17203	642	0	0	0	0	642
17204	650	0	0	0	0	650
17205	663	0	0	0	0	663
17206	1	0	0	660	0	661
17207	669	0	0	1	0	670
17208	1	0	0	648	0	649
17209	0	0	1	640	0	641
17210	0	0	0	654	0	654
17211	0	1	645	2	0	648
17212	0	614	1	0	0	615
17213	0	611	1	0	0	612
17214	0	1	0	661	0	662
17215	662	0	0	1	0	663
17216	1	0	0	641	0	642
17217	652	0	0	1	0	653
17218	1	0	656	0	0	657
17219	593	0	1	0	0	594
17220	1	0	0	644	0	645
17221	656	0	0	1	0	657
17222	898	1	2	0	0	901
17223	911	0	0	0	0	911
17224	1	0	0	916	0	917
17225	1	1	940	1	0	943
17226	0	0	2	910	0	912
17227	944	0	0	2	0	946
17228	2	0	1126	0	0	1128
17229	0	1	2	1094	0	1097
17230	1169	0	0	2	0	1171
17231	2	5	1106	0	0	1113
17232	1080	0	4	1	0	1085
17233	1159	0	0	0	0	1159
17234	2	0	0	1123	0	1125
17235	0	1	0	1144	0	1145
17236	1157	0	0	2	0	1159
17237	2	0	0	1149	0	1151
17238	1153	0	1	2	0	1156
17239	2	1062	0	1	0	1065
17240	0	1074	3	1	0	1078
17241	0	1	0	1116	0	1117
17242	0	3	1079	4	0	1086
17243	0	1048	4	2	0	1054
17244	1407	1	1	1	0	1410
17245	2	1323	3	3	0	1331
17246	0	3	1368	1	0	1372
17247	1	2	2	1283	0	1288
17248	2	2	1381	1	0	1386
17249	0	1305	5	1	0	1311
17250	1	1	0	1398	0	1400
17251	0	1303	3	2	0	1308
17252	1	2	1340	1	0	1344
17253	0	0	1	1271	0	1272
17254	3	2	1375	1	0	1381
17255	1	1	1	1308	0	1311
17256	1393	0	0	2	0	1395
17257	3	2	1348	1	0	1354
17258	1250	0	3	1	0	1254
17259	2	1	1347	0	0	1350
17260	1	0	1	1303	0	1305
17261	1	0	1335	3	0	1339
17262	0	0	1	1297	0	1298
17263	1	0	3	1322	0	1326
17264	0	2	1	1317	0	1320
17265	1	2	0	1327	0	1330
17266	0	2	1329	3	0	1334
17267	1383	2	3	0	0	1388
17268	1	0	0	1611	0	1612
17269	1092	0	2	2	0	1096
17270	1097	1	1	0	0	1099
17271	1106	0	0	0	0	1106
17272	1	1	0	1745	0	1747
17273	1	0	1	1713	0	1715
17274	0	1609	4	2	0	1615
17275	1750	1	1	0	0	1752
17276	1736	1	0	1	0	1738
17277	1707	0	1	1	0	1709
17278	2	3	1662	0	0	1667
17279	1	1	4	1659	0	1665
17280	0	1	1688	2	0	1691
17281	1637	1	4	0	0	1642
17282	1717	0	0	2	0	1719
17283	2	1	2	1692	0	1697
17284	1	0	1	1701	0	1703
17285	2	2133	5	2	0	2142
17286	2273	1	1	1	0	2276
17287	2267	0	0	3	0	2270
17288	2	2154	2	0	0	2158
17289	2287	1	0	1	0	2289
17290	1	0	0	2352	0	2353
17291	0	1	0	2341	0	2342
17292	2373	1	0	3	0	2377
17293	2	2	2285	1	0	2290
17294	2249	0	5	3	0	2257
17295	2353	1	0	2	0	2356
17296	3	2209	4	3	0	2219
17297	2381	2	0	0	0	2383
17298	3	1	2301	0	0	2305
17299	0	0	1	2316	0	2317
17300	2369	0	1	1	0	2371
17301	1	1	2	2330	0	2334
17302	2	1	2324	1	0	2328
17303	1	0	1	2266	0	2268
17304	1	3248	9	3	0	3261
17305	0	47	1	3412	0	3460
17306	0	0	0	3532	0	3532
17307	0	0	1	3477	0	3478
17308	1	0	0	3527	0	3528
17309	2	2	3494	6	0	3504
17310	0	1	3	3426	0	3430
17311	3553	0	1	10	0	3564
17312	6	3311	10	7	0	3334
17313	1	8	0	3562	0	3571
17314	6	3	3939	11	0	3959
17315	1	5	8	3874	0	3888
17316	3977	1	1	10	0	3989
17317	3836	1	0	4	0	3841
17318	3785	3	2	2	0	3792
17319	7	1	2	3876	0	3886
17320	3	0	3928	10	0	3941
17321	5	3660	17	4	0	3686
17322	3708	6	1	3	0	3718
17323	10	0	0	3632	0	3642
17324	3	0	2	3646	0	3651
17325	4	4	3603	13	0	3624
17326	1	3328	14	7	0	3350
17327	1	3534	4	0	0	3539
17328	2	11	0	3459	0	3472
17329	2	1	3355	9	0	3367
17330	3031	2	9	8	0	3050
17331	6	2	3365	2	0	3375
17332	3003	4	9	1	0	3017
17333	6	3195	15	6	0	3222
17334	4	9	3251	2	0	3266
17335	3126	2	8	2	0	3138
17336	8	3152	7	5	0	3172
17337	3671	7	3	2	0	3683
17338	14	2	3592	0	0	3608
17339	2	3418	14	8	0	3442
17340	3684	7	3	5	0	3699
17341	11	7	3522	0	0	3540
17342	3593	3	7	0	0	3603
17343	7	4	0	3636	0	3647
17344	4069	1	1	6	0	4077
17345	6	2	3	4004	0	4015
17346	4057	1	1	7	0	4066
17347	10	2	3947	1	0	3960
17348	4	2	5	3935	0	3946
17349	3	3	1	4261	0	4268
17350	4	3	4141	11	0	4159
17351	7	2	6	4083	0	4098
17352	2	3483	40	18	0	3543
17353	5	6	2	4261	0	4274
17354	0	1	3	4217	0	4221
17355	5	1	1	5743	0	5750
17356	5	6	5572	24	0	5607
17357	5365	4	26	9	0	5404
17358	24	2	4	5939	0	5969
17359	12	5	5816	28	0	5861
17360	5569	2	32	15	0	5618
17361	5867	0	6	15	0	5888
17362	5918	2	12	11	0	5943
17363	45	3	11	5797	0	5856
17364	22	4	3	7338	0	7367
17365	18	2	4	7235	0	7259
17366	13	7024	15	128	0	7180
17367	7142	92	5	59	0	7298
17368	7243	33	10	46	0	7332
17369	142	19	11	7132	0	7304
17370	62	28	6996	126	0	7212
17371	49	16	7213	66	0	7344
17372	35	6686	173	48	0	6942
17373	44	138	52	6898	0	7132
17374	7013	40	39	138	0	7230
17375	150	6800	40	74	0	7064
17376	7133	147	20	63	0	7363
17377	7116	46	33	51	0	7246
17378	7200	40	21	28	0	7289
17379	204	38	12	6916	0	7170
17380	113	17	33	7182	0	7345
17381	7584	23	15	190	0	7812
17382	211	26	18	7574	0	7829
17383	103	32	7465	221	0	7821
17384	7661	23	172	104	0	7960
17385	227	19	57	7225	0	7528
17386	99	21	38	7361	0	7519
17387	95	26	30	7497	0	7648
17388	98	33	7012	281	0	7424
17389	6832	15	182	163	0	7192
17390	233	26	7023	112	0	7394
17391	113	14	208	7096	0	7431
17392	85	23	7302	231	0	7641
17393	86	24	223	7279	0	7612
17394	60	11	108	7548	0	7727
17395	71	21	7184	315	0	7591
17396	49	31	240	6833	0	7153
17397	66	7011	108	273	0	7458
17398	7258	182	66	154	0	7660
17399	8091	65	60	111	0	8327
17400	285	48	44	8055	0	8432
17401	135	54	7783	268	0	8240
17402	114	7378	248	137	0	7877
17403	70	7944	107	127	0	8248
17404	7122	249	88	91	0	7550
17405	256	110	6840	82	0	7288
17406	6940	71	206	94	0	7311
17407	258	41	100	6995	0	7394
17408	140	24	77	7204	0	7445
17409	6844	29	72	299	0	7244
17410	260	6753	48	173	0	7234
17411	133	210	7350	121	0	7814
17412	106	91	211	7120	0	7528
17413	99	74	7397	249	0	7819
17414	66	6976	257	150	0	7449
17415	71	198	120	7310	0	7699
17416	7220	91	90	280	0	7681
17417	7299	69	75	164	0	7607
17418	311	66	6943	125	0	7445
17419	170	6968	225	124	0	7487
17420	7172	203	124	92	0	7591
17421	263	7116	91	97	0	7567
17422	149	231	80	7222	0	7682
17423	7247	130	55	245	0	7677
17424	257	87	60	7322	0	7726
17425	132	85	7034	299	0	7550
17426	100	56	229	7245	0	7630
17427	119	79	7065	282	0	7545
17428	99	71	229	7208	0	7607
17429	7217	40	116	303	0	7676
17430	289	7018	91	174	0	7572
17431	7284	227	93	126	0	7730
17432	274	116	83	7145	0	7618
17433	149	95	59	7400	0	7703
17434	119	89	6798	332	0	7338
17435	109	87	6996	197	0	7389
17436	104	6946	265	171	0	7486
17437	125	222	6719	115	0	7181
17438	6141	98	265	127	0	6631
17439	257	6568	170	114	0	7109
17440	140	6832	95	120	0	7187
17441	118	6915	101	119	0	7253
17442	100	311	70	6781	0	7262
17443	89	165	6588	284	0	7126
17444	100	6157	244	162	0	6663
17445	88	252	122	5712	0	6174
17446	81	6208	120	261	0	6670
17447	6261	260	84	163	0	6768
17448	6418	137	98	137	0	6790
17449	295	102	73	6089	0	6559
17450	173	91	84	6263	0	6611
17451	6006	84	81	315	0	6486
17452	258	5889	76	202	0	6425
17453	137	6133	75	153	0	6498
17454	116	294	56	6155	0	6621
17455	77	136	4529	236	0	4978
17456	55	4624	182	158	0	5019
17457	4398	202	99	101	0	4800
17458	198	4310	85	87	0	4680
17459	106	4539	55	70	0	4770
17460	4423	284	45	54	0	4806
17461	215	5600	42	61	0	5918
17462	125	254	5410	63	0	5852
17463	71	5631	190	74	0	5966
17464	4158	120	46	25	0	4349
17465	88	4067	36	35	0	4226
17466	4148	124	23	28	0	4323
17467	118	61	12	4023	0	4214
17468	54	52	17	4641	0	4764
17469	41	35	4456	125	0	4657
17470	30	4363	94	66	0	4553
17471	19	69	30	4243	0	4361
17472	4185	39	21	74	0	4319
17473	4171	29	8	55	0	4263
17474	88	4025	19	29	0	4161
17475	48	74	6	4208	0	4336
17476	4224	37	17	74	0	4352
17477	4174	39	12	34	0	4259
17478	96	19	4014	32	0	4161
17479	53	28	3714	22	0	3817
17480	34	26	3925	22	0	4007
17481	18	3175	43	3	0	3239
17482	3094	33	223	10	0	3360
17483	19	3311	13	8	0	3351
17484	3480	22	7	7	0	3516
17485	27	4525	10	7	0	4569
17486	12	25	4	4671	0	4712
17487	4719	14	4	20	0	4757
17488	22	9	4619	13	0	4663
17489	4333	5	21	6	0	4365
17490	4640	7	14	6	0	4667
17491	32	4536	9	5	0	4582
17492	0	4292	4	2	0	4298
17493	4483	0	0	0	0	4483
17494	2	7	4303	0	0	4312
17495	4170	0	1	2	0	4173
17496	4390	0	1	0	0	4391
17497	2	0	0	4344	0	4346
17498	4506	0	0	1	0	4507
17499	1	2	2	3739	0	3744
17500	0	2	0	3743	0	3745
17501	0	2	0	3774	0	3776
17502	0	3610	1	1	0	3612
17503	3842	0	0	1	0	3843
17504	3775	0	2	0	0	3777
17505	0	0	0	4555	0	4555
17506	0	2	0	4505	0	4507
17507	0	4390	9	2	0	4401
17508	4621	0	0	1	0	4622
17509	2	1	4454	0	0	4457
17510	0	2	0	4509	0	4511
17511	1	1	3945	1	0	3948
17512	1	0	1	3819	0	3821
17513	4	0	3982	0	0	3986
17514	0	2	0	3764	0	3766
17515	3905	1	1	0	0	3907
17516	2	5	3819	1	0	3827
17517	3522	0	0	4	0	3526
17518	2	3700	5	2	0	3709
17519	1	0	1	3940	0	3942
17520	1	1	1	3921	0	3924
17521	3972	0	1	0	0	3973
17522	0	0	1	4581	0	4582
17523	4	5	5267	0	0	5276
17524	4917	2	1	3	0	4923
17525	5201	2	2	2	0	5207
17526	5258	0	0	3	0	5261
17527	5286	3	1	0	0	5290
17528	1	4991	9	3	0	5004
17529	2	0	0	5357	0	5359
17530	5383	0	2	3	0	5388
17531	1	0	0	5234	0	5235
17532	5289	1	4	3	0	5297
17533	4	5	5159	0	0	5168
17534	3	4	5097	0	0	5104
17535	3	2	2	4712	0	4719
17536	0	4948	14	1	0	4963
17537	1	5098	11	4	0	5114
17538	5158	0	1	0	0	5159
17539	0	0	5442	7	0	5449
17540	4687	1	6	6	0	4700
17541	1	5226	11	3	0	5241
17542	5509	0	2	1	0	5512
17543	0	3	0	5375	0	5378
17544	5	5	5394	1	0	5405
17545	2	1	2	5180	0	5185
17546	2	0	0	5360	0	5362
17547	0	5221	8	6	0	5235
17548	0	5335	4	5	0	5344
17549	0	1	0	5474	0	5475
17550	2	5218	8	1	0	5229
17551	5	4	5051	0	0	5060
17552	4	18	4884	3	0	4909
17553	4332	6	16	6	0	4360
17554	5152	0	2	3	0	5157
17555	1	4841	14	4	0	4860
17556	2	2	0	5029	0	5033
17557	3	3	0	5060	0	5066
17558	3	3	5010	0	0	5016
17559	3	3	3	4661	0	4670
17560	0	4743	7	5	0	4755
17561	4	10	4135	1	0	4150
17562	2	7	4622	1	0	4632
17563	1	4484	41	5	0	4531
17564	5	19	4897	2	0	4923
17565	1	5	17	4763	0	4786
17566	2	5	4	4701	0	4712
17567	6	3	4987	19	0	5015
17568	2	2	13	4762	0	4779
17569	2	4672	11	14	0	4699
17570	1	4990	13	8	0	5012
17571	0	27	1	5124	0	5152
17572	8	14	5459	23	0	5504
17573	0	5640	82	10	0	5732
17574	0	71	17	6049	0	6137
17575	3	27	5859	68	0	5957
17576	5522	12	102	14	0	5650
17577	5929	20	22	18	0	5989
17578	5976	10	27	20	0	6033
17579	72	8	22	5829	0	5931
17580	8	5	9	6022	0	6044
17581	9	20	6238	87	0	6354
17582	4	27	77	6034	0	6142
17583	3	30	13	6345	0	6391
17584	3	33	6143	88	0	6267
17585	4693	28	80	43	0	4844
17586	67	5076	40	32	0	5215
17587	5319	86	29	23	0	5457
17588	83	5156	27	26	0	5292
17589	24	78	28	5368	0	5498
17590	46	13	5260	80	0	5399
17591	32	14	66	5186	0	5298
17592	26	28	5286	103	0	5443
17593	4563	12	92	82	0	4749
17594	66	16	5322	47	0	5451
17595	16	25	97	5113	0	5251
17596	15	18	5257	120	0	5410
17597	29	5297	114	49	0	5489
17598	43	103	33	5622	0	5801
17599	71	22	23	6044	0	6160
17600	52	36	19	6155	0	6262
17601	42	31	5877	166	0	6116
17602	27	32	5862	77	0	5998
17603	16	15	136	5869	0	6036
17604	16	10	69	7703	0	7798
17605	21	14	44	7601	0	7680
17606	7716	3	70	277	0	8066
17607	254	19	31	7828	0	8132
17608	89	49	8640	264	0	9042
17609	9356	29	279	105	0	9769
17610	310	42	95	9719	0	10166
17611	10487	42	71	349	0	10949
17612	10634	18	49	169	0	10870
17613	437	13	41	10561	0	11052
17614	10526	6	67	406	0	11005
17615	10752	2	76	174	0	11004
17616	477	28	10186	101	0	10792
17617	195	10592	348	114	0	11249
17618	123	321	158	10296	0	10898
17619	82	131	66	11286	0	11565
17620	10981	55	57	511	0	11604
17621	11154	35	44	252	0	11485
17622	10728	27	61	154	0	10970
17623	547	51	9098	121	0	9817
17624	254	9413	362	116	0	10145
17625	9624	335	140	133	0	10232
17626	431	9619	104	137	0	10291
17627	9783	378	69	145	0	10375
17628	480	143	56	9738	0	10417
17629	9727	78	67	441	0	10313
17630	9919	52	93	215	0	10279
17631	10126	55	56	156	0	10393
17632	599	61	9696	163	0	10519
17633	10194	26	352	138	0	10710
17634	572	9989	133	133	0	10827
17635	10496	347	84	132	0	11059
17636	10586	157	80	96	0	10919
17637	11333	71	90	88	0	11582
17638	619	104	80	10344	0	11147
17639	383	10296	67	386	0	11132
17640	10687	374	45	227	0	11333
17641	556	178	10030	172	0	10936
17642	341	10259	358	151	0	11109
17643	318	382	148	9286	0	10134
17644	264	10405	122	341	0	11132
17645	10626	430	102	157	0	11315
17646	10823	224	84	111	0	11242
17647	638	125	77	10516	0	11356
17648	373	160	9990	404	0	10927
17649	324	10192	352	232	0	11100
17650	335	405	218	8272	0	9230
17651	296	194	117	10046	0	10653
17652	281	128	69	10870	0	11348
17653	10760	112	80	535	0	11487
17654	11033	111	100	214	0	11458
17655	11124	102	82	143	0	11451
17656	11252	139	69	113	0	11573
17657	728	113	46	10712	0	11599
17658	439	122	10729	452	0	11742
17659	338	99	344	11283	0	12064
17660	294	77	184	11542	0	12097
17661	308	110	99	11614	0	12131
17662	301	83	96	11184	0	11664
17663	10255	98	144	634	0	11131
17664	577	109	124	10312	0	11122
17665	10376	82	85	575	0	11118
17666	10573	113	108	336	0	11130
17667	835	89	9854	221	0	10999
17668	526	71	9593	268	0	10458
17669	436	101	9795	271	0	10603
17670	445	70	487	9544	0	10546
17671	384	99	9487	497	0	10467
17672	307	105	419	9607	0	10438
17673	292	144	208	9569	0	10213
17674	9423	95	121	649	0	10288
17675	592	85	116	9236	0	10029
17676	494	8974	111	499	0	10078
17677	9240	325	120	331	0	10016
17678	598	9071	130	272	0	10071
17679	412	393	9015	220	0	10040
17680	353	9191	337	205	0	10086
17681	9107	435	217	178	0	9937
17682	590	319	121	8905	0	9935
17683	465	164	8625	460	0	9714
17684	9024	187	333	324	0	9868
17685	705	127	177	9004	0	10013
17686	490	112	8615	481	0	9698
17687	413	100	392	8966	0	9871
17688	397	77	272	9028	0	9774
17689	375	128	141	8921	0	9565
17690	354	8697	161	519	0	9731
17691	9119	351	124	310	0	9904
17692	666	192	108	8762	0	9728
17693	482	8673	112	468	0	9735
17694	378	420	78	9551	0	10427
17695	399	282	9042	450	0	10173
17696	354	9112	390	330	0	10186
17697	8933	426	243	214	0	9816
17698	9152	300	138	218	0	9808
17699	516	205	125	8495	0	9341
17700	352	219	104	8787	0	9462
17701	8757	129	105	506	0	9497
17702	8475	164	103	330	0	9072
17703	543	8442	124	297	0	9406
17704	6877	220	61	154	0	7312
17705	320	125	6311	129	0	6885
17706	204	63	5960	120	0	6347
17707	125	5879	225	126	0	6355
17708	74	4816	57	43	0	4990
17709	4243	74	24	35	0	4376
17710	61	4363	37	36	0	4497
17711	3774	21	8	16	0	3819
17712	3748	9	9	10	0	3776
17713	3724	2	6	8	0	3740
17714	27	6	5	3614	0	3652
17715	3742	6	10	28	0	3786
17716	26	8	3951	16	0	4001
17717	7	7	3548	5	0	3567
17718	3	3585	17	8	0	3613
17719	9	7	3659	2	0	3677
17720	4	7	5	3372	0	3388
17721	3	3	3757	5	0	3768
17722	9	9	3623	6	0	3647
17723	2	5	9	3599	0	3615
17724	3727	1	6	4	0	3738
17725	3569	5	3	5	0	3582
17726	10	4	3671	2	0	3687
17727	3924	3	8	4	0	3939
17728	7	7	4117	2	0	4133
17729	3962	1	6	5	0	3974
17730	4113	0	8	4	0	4125
17731	9	3	4	4073	0	4089
17732	6	0	1	3595	0	3602
17733	2	3433	8	12	0	3455
17734	1	3516	6	11	0	3534
17735	3	7	2	3607	0	3619
17736	4	6	1	3592	0	3603
17737	3160	2	1	10	0	3173
17738	6	3011	6	8	0	3031
17739	3130	3	1	7	0	3141
17740	3	2991	16	4	0	3014
17741	8	9	3073	1	0	3091
17742	2	8	6	3029	0	3045
17743	3036	2	5	7	0	3050
17744	3019	1	2	7	0	3029
17745	12	3482	7	4	0	3505
17746	8	3492	3	2	0	3505
17747	3	3530	11	5	0	3549
17748	4	16	2	3619	0	3641
17749	5	11	3870	12	0	3898
17750	2	3964	35	9	0	4010
17751	0	23	8	3958	0	3989
17752	0	6	0	3964	0	3970
17753	5	9	3910	27	0	3951
17754	3	7	3773	7	0	3790
17755	3656	3	24	3	0	3686
17756	28	4	3909	1	0	3942
17757	3823	1	22	2	0	3848
17758	3436	2	9	1	0	3448
17759	3433	1	2	4	0	3440
17760	3398	1	10	3	0	3412
17761	31	10	3303	2	0	3346
17762	6	3206	35	5	0	3252
17763	3	24	8	3417	0	3452
17764	4	10	3350	26	0	3390
17765	5	1	21	3278	0	3305
17766	3	3448	18	28	0	3497
17767	3	26	2	3817	0	3848
17768	5	9	2	3786	0	3802
17769	6	6	1	3790	0	3803
17770	3809	3	1	35	0	3848
17771	25	3	6	4309	0	4343
17772	9	3	5	3902	0	3919
17773	2	6	4	3863	0	3875
17774	3	3757	8	42	0	3810
17775	3854	30	5	11	0	3900
17776	29	3725	9	9	0	3772
17777	10	4218	11	13	0	4252
17778	10	49	6	4812	0	4877
17779	7	20	6	4863	0	4896
17780	4831	9	7	66	0	4913
17781	49	11	3	4850	0	4913
17782	4832	11	5	59	0	4907
17783	5910	5	9	33	0	5957
17784	141	9	8	5899	0	6057
17785	81	11	7	5867	0	5966
17786	28	6317	20	174	0	6539
17787	6471	172	8	93	0	6744
17788	181	8165	14	55	0	8415
17789	8465	330	16	26	0	8837
17790	361	126	7966	21	0	8474
17791	8199	67	285	27	0	8578
17792	8568	37	86	21	0	8712
17793	420	22	49	8322	0	8813
17794	164	42	8001	334	0	8541
17795	101	7995	330	124	0	8550
17796	52	355	99	8464	0	8970
17797	70	123	8067	392	0	8652
17798	48	73	359	8419	0	8899
17799	8363	52	112	426	0	8953
17800	399	67	7827	154	0	8447
17801	133	7956	345	120	0	8554
17802	89	8535	125	71	0	8820
17803	78	467	83	7208	0	7836
17804	54	8237	72	315	0	8678
17805	8421	430	41	104	0	8996
17806	8675	136	47	79	0	8937
17807	8785	103	30	73	0	8991
17808	531	102	7950	57	0	8640
17809	8382	74	345	50	0	8851
17810	448	70	108	7862	0	8488
17811	176	54	73	8189	0	8492
17812	129	45	61	8252	0	8487
17813	108	35	61	8385	0	8589
17814	94	44	7674	552	0	8364
17815	83	41	7815	238	0	8177
17816	55	65	7417	144	0	7681
17817	7107	50	473	110	0	7740
17818	402	7236	182	115	0	7935
17819	147	385	108	7376	0	8016
17820	7299	122	71	425	0	7917
17821	430	7103	63	174	0	7770
17822	167	7657	74	105	0	8003
17823	7388	475	68	68	0	7999
17824	7587	193	51	74	0	7905
17825	502	7305	50	96	0	7953
17826	220	428	42	6963	0	7653
17827	138	6855	40	417	0	7450
17828	7070	439	55	160	0	7724
17829	7188	168	58	113	0	7527
17830	7293	139	61	93	0	7586
17831	594	6760	66	78	0	7498
17832	269	392	50	7024	0	7735
17833	175	181	6627	456	0	7439
17834	126	131	349	6984	0	7590
17835	124	114	123	7378	0	7739
17836	122	98	6659	537	0	7416
17837	6797	89	400	221	0	7507
17838	454	68	148	7027	0	7697
17839	194	96	108	7033	0	7431
17840	151	6850	98	533	0	7632
17841	6993	437	54	255	0	7739
17842	469	170	54	6857	0	7550
17843	212	6899	81	471	0	7663
17844	6913	476	47	222	0	7658
17845	489	6396	52	155	0	7092
17846	6584	449	56	149	0	7238
17847	514	213	6293	123	0	7143
17848	229	179	6460	113	0	6981
17849	188	98	5988	122	0	6396
17850	132	5750	490	108	0	6480
17851	153	387	201	5241	0	5982
17852	155	5777	138	366	0	6436
17853	5929	427	110	191	0	6657
17854	438	186	5712	146	0	6482
17855	5899	134	409	118	0	6560
17856	6221	107	180	120	0	6628
17857	528	119	122	5894	0	6663
17858	6036	97	94	433	0	6660
17859	515	102	96	5956	0	6669
17860	237	112	5603	475	0	6427
17861	5836	90	405	189	0	6520
17862	467	5651	201	145	0	6464
17863	235	387	131	5889	0	6642
17864	5963	199	87	404	0	6653
17865	451	155	64	5993	0	6663
17866	235	130	5174	479	0	6018
17867	196	113	356	5361	0	6026
17868	163	5376	142	476	0	6157
17869	5542	399	109	200	0	6250
17870	488	166	97	5544	0	6295
17871	5396	141	57	445	0	6039
17872	484	71	65	5380	0	6000
17873	198	71	69	5320	0	5658
17874	155	5180	76	500	0	5911
17875	5121	357	60	242	0	5780
17876	430	5896	73	185	0	6584
17877	171	428	55	5100	0	5754
17878	137	4977	55	412	0	5581
17879	5102	395	56	189	0	5742
17880	5271	173	52	175	0	5671
17881	5275	114	46	158	0	5593
17882	491	4785	74	111	0	5461
17883	139	3321	27	49	0	3536
17884	3264	282	22	73	0	3641
17885	295	3841	30	66	0	4232
17886	68	207	14	3382	0	3671
17887	95	43	3272	201	0	3611
17888	2037	15	37	17	0	2106
17889	2172	20	1	10	0	2203
17890	2176	10	2	6	0	2194
17891	53	2067	7	13	0	2140
17892	2147	48	3	7	0	2205
17893	62	14	2111	5	0	2192
17894	0	1576	2	1	0	1579
17895	1	2	0	1670	0	1673
17896	1	2104	4	0	0	2109
17897	2145	0	0	0	0	2145
17898	0	2117	6	0	0	2123
17899	0	1	0	2201	0	2202
17900	0	2107	3	1	0	2111
17901	0	0	0	2203	0	2203
17902	0	0	0	2149	0	2149
17903	1	1	2174	0	0	2176
17904	0	3	0	2113	0	2116
17905	2195	0	0	0	0	2195
17906	2169	0	0	0	0	2169
17907	0	0	0	2156	0	2156
17908	0	1	2185	0	0	2186
17909	0	0	0	2142	0	2142
17910	2199	0	0	2	0	2201
17911	2160	0	0	0	0	2160
17912	2176	0	0	0	0	2176
17913	0	2037	7	3	0	2047
17914	2208	0	0	0	0	2208
17915	1	1	2085	0	0	2087
17916	2732	0	0	2	0	2734
17917	0	1	0	2767	0	2768
17918	0	0	0	2773	0	2773
17919	0	0	0	2833	0	2833
17920	2828	0	0	0	0	2828
17921	2786	0	0	0	0	2786
17922	0	0	0	2807	0	2807
17923	1	1	2750	2	0	2754
17924	0	0	0	2720	0	2720
17925	0	0	0	2791	0	2791
17926	1	2	2760	3	0	2766
17927	0	2562	7	0	0	2569
17928	0	0	0	2791	0	2791
17929	2813	0	0	0	0	2813
17930	0	0	0	2791	0	2791
17931	1	0	0	2764	0	2765
17932	2819	1	0	0	0	2820
17933	0	2642	3	0	0	2645
17934	0	2764	2	5	0	2771
17935	2894	1	1	0	0	2896
17936	1	3	2825	0	0	2829
17937	2882	0	1	3	0	2886
17938	1	3	3278	0	0	3282
17939	1	3103	6	0	0	3110
17940	3367	0	3	0	0	3370
17941	3320	0	1	2	0	3323
17942	3317	0	1	0	0	3318
17943	3286	1	0	3	0	3290
17944	1	4	3229	0	0	3234
17945	0	1	0	3134	0	3135
17946	3277	0	0	0	0	3277
17947	0	0	3303	0	0	3303
17948	1	5	3386	0	0	3392
17949	0	3707	14	10	0	3731
17950	4087	7	1	0	0	4095
17951	9	2	0	4043	0	4054
17952	4081	0	0	8	0	4089
17953	8	3914	5	4	0	3931
17954	1	8	0	4319	0	4328
17955	1	1	0	4331	0	4333
17956	1	1	0	4331	0	4333
17957	3	7	4178	13	0	4201
17958	0	4396	16	6	0	4418
17959	4714	45	5	3	0	4767
17960	45	13	0	4732	0	4790
17961	4727	9	2	48	0	4786
17962	4681	5	1	12	0	4699
17963	57	2	0	4675	0	4734
17964	19	8	4599	51	0	4677
17965	6	4	40	4618	0	4668
17966	3	4444	24	53	0	4524
17967	1	51	7	4768	0	4827
17968	12	14	4587	54	0	4667
17969	4516	8	43	20	0	4587
17970	50	2	11	4683	0	4746
17971	4422	4	8	47	0	4481
17972	56	8	4255	24	0	4343
17973	4011	4	49	17	0	4081
17974	63	7	4249	9	0	4328
17975	4012	11	51	8	0	4082
17976	55	3471	20	12	0	3558
17977	15	3638	18	9	0	3680
17978	16	56	0	3695	0	3767
17979	6	21	4	3644	0	3675
17980	12	14	4	3732	0	3762
17981	3717	2	10	68	0	3797
17982	53	8	0	3731	0	3792
17983	19	10	3596	61	0	3686
17984	3957	11	50	20	0	4038
17985	47	3439	22	28	0	3536
17986	3631	55	11	10	0	3707
17987	3551	16	4	18	0	3589
17988	65	21	3543	15	0	3644
17989	33	12	47	3428	0	3520
17990	23	7	18	3651	0	3699
17991	14	11	3488	82	0	3595
17992	9	3288	69	39	0	3405
17993	3937	56	13	20	0	4026
17994	3916	24	13	22	0	3975
17995	71	19	9	3853	0	3952
17996	42	12	4	3446	0	3504
17997	26	11	9	3657	0	3703
17998	3547	5	4	95	0	3651
17999	61	3466	14	42	0	3583
18000	3612	52	14	33	0	3711
18001	3584	32	8	26	0	3650
18002	80	21	3466	28	0	3595
18003	37	7	58	3453	0	3555
18004	28	3442	22	69	0	3561
18005	20	61	16	3605	0	3702
18006	29	27	8	3651	0	3715
18007	23	23	3697	81	0	3824
18008	4140	18	71	47	0	4276
18009	4761	8	31	31	0	4831
18010	5256	11	26	28	0	5321
18011	145	13	22	5214	0	5394
18012	53	22	11	5102	0	5188
18013	33	5007	22	144	0	5206
18014	22	5133	18	65	0	5238
18015	5783	128	11	57	0	5979
18016	124	5074	25	39	0	5262
18017	57	133	5505	38	0	5733
18018	58	33	104	5690	0	5885
18019	5783	26	33	131	0	5973
18020	135	25	5530	59	0	5749
18021	66	25	5495	45	0	5631
18022	5677	23	134	34	0	5868
18023	5802	34	43	35	0	5914
18024	165	18	26	5739	0	5948
18025	78	30	5893	138	0	6139
18026	47	19	127	6011	0	6204
18027	47	31	6448	163	0	6689
18028	64	40	6406	64	0	6574
18029	53	6457	148	51	0	6709
18030	6729	113	60	50	0	6952
18031	6678	43	48	44	0	6813
18032	172	6489	41	42	0	6744
18033	74	126	28	6598	0	6826
18034	69	54	31	6555	0	6709
18035	50	39	28	6712	0	6829
18036	6591	31	34	174	0	6830
18037	141	6113	54	87	0	6395
18038	6234	138	37	55	0	6464
18039	6322	53	35	43	0	6453
18040	201	39	5883	38	0	6161
18041	86	5929	137	46	0	6198
18042	62	125	53	6201	0	6441
18043	67	50	6005	155	0	6277
18044	5981	50	131	78	0	6240
18045	6292	23	58	67	0	6440
18046	6284	30	38	66	0	6418
18047	6297	28	41	49	0	6415
18048	204	28	38	6033	0	6303
18049	79	29	5278	116	0	5502
18050	57	18	107	5394	0	5576
18051	5435	29	43	131	0	5638
18052	5442	33	39	59	0	5573
18053	155	5268	35	46	0	5504
18054	5196	105	25	38	0	5364
18055	147	34	5474	35	0	5690
18056	72	39	6124	24	0	6259
18057	5671	28	501	38	0	6238
18058	108	5676	42	23	0	5849
18059	60	67	20	5805	0	5952
18060	51	5705	28	68	0	5852
18061	46	69	16	5961	0	6092
18062	39	30	17	5910	0	5996
18063	34	30	12	6365	0	6441
18064	7109	30	24	86	0	7249
18065	7592	34	16	42	0	7684
18066	7654	14	21	30	0	7719
18067	119	33	7353	28	0	7533
18068	6955	24	80	28	0	7087
18069	111	19	35	8136	0	8301
18070	54	19	29	8164	0	8266
18071	57	23	8003	99	0	8182
18072	54	18	86	8220	0	8378
18073	8718	20	34	125	0	8897
18074	151	21	8440	67	0	8679
18075	73	13	114	8669	0	8869
18076	8710	13	58	134	0	8915
18077	8633	13	50	63	0	8759
18078	167	25	8518	59	0	8769
18079	89	35	8992	32	0	9148
18080	62	28	135	9243	0	9468
18081	9835	25	50	137	0	10047
18082	9790	19	45	69	0	9923
18083	179	25	42	9247	0	9493
18084	74	8897	55	146	0	9172
18085	9348	110	28	75	0	9561
18086	160	9002	45	57	0	9264
18087	84	129	29	9348	0	9590
18088	91	57	9053	131	0	9332
18089	70	59	8974	77	0	9180
18090	73	53	9208	56	0	9390
18091	55	20	182	9150	0	9407
18092	51	31	61	9568	0	9711
18093	9245	14	49	198	0	9506
18094	169	9022	64	97	0	9352
18095	9275	128	53	67	0	9523
18096	195	54	31	8777	0	9057
18097	98	8703	41	159	0	9001
18098	79	9050	51	74	0	9254
18099	61	164	41	9144	0	9410
18100	9052	57	41	175	0	9325
18101	169	8864	51	80	0	9164
18102	8993	137	33	81	0	9244
18103	189	8931	47	54	0	9221
18104	9127	164	45	57	0	9393
18105	207	64	8719	46	0	9036
18106	115	66	8603	36	0	8820
18107	74	8497	152	58	0	8781
18108	8141	110	55	40	0	8346
18109	90	7612	48	31	0	7781
18110	53	7091	31	27	0	7202
18111	36	111	28	7402	0	7577
18112	7403	43	25	83	0	7554
18113	91	7235	29	50	0	7405
18114	7358	96	21	31	0	7506
18115	107	6750	35	26	0	6918
18116	6765	97	29	31	0	6922
18117	93	6185	18	29	0	6325
18118	48	6263	20	15	0	6346
18119	35	105	15	6127	0	6282
18120	31	6150	25	89	0	6295
18121	6321	96	24	39	0	6480
18122	96	49	5991	38	0	6174
18123	46	36	92	6156	0	6330
18124	40	38	7052	107	0	7237
18125	38	29	90	6698	0	6855
18126	41	27	40	7072	0	7180
18127	50	36	6225	112	0	6423
18128	5529	31	97	72	0	5729
18129	108	6064	56	47	0	6275
18130	6426	97	41	35	0	6599
18131	116	6513	35	41	0	6705
18132	64	107	28	6759	0	6958
18133	6842	46	31	102	0	7021
18134	6797	53	20	52	0	6922
18135	6831	42	33	45	0	6951
18136	143	47	24	6642	0	6856
18137	83	37	26	6556	0	6702
18138	61	6933	41	107	0	7142
18139	7340	93	37	69	0	7539
18140	7333	56	33	52	0	7474
18141	7280	41	33	44	0	7398
18142	7313	43	39	47	0	7442
18143	138	6972	37	46	0	7193
18144	74	103	34	7759	0	7970
18145	94	64	7451	96	0	7705
18146	7260	60	85	59	0	7464
18147	7714	47	43	45	0	7849
18148	139	68	7399	44	0	7650
18149	81	58	7319	40	0	7498
18150	59	59	105	7192	0	7415
18151	55	46	51	7628	0	7780
18152	55	49	36	7799	0	7939
18153	7708	54	28	138	0	7928
18154	117	51	44	7701	0	7913
18155	69	54	7048	121	0	7292
18156	58	42	86	6466	0	6652
18157	60	41	6418	126	0	6645
18158	58	52	102	6215	0	6427
18159	56	51	47	6542	0	6696
18160	55	50	6270	127	0	6502
18161	5633	49	94	76	0	5852
18162	116	6449	35	54	0	6654
18163	6917	131	30	44	0	7122
18164	153	79	13	6264	0	6509
18165	5653	62	15	117	0	5847
18166	161	6012	16	54	0	6243
18167	85	6235	19	49	0	6388
18168	81	196	17	7915	0	8209
18169	35	85	7002	215	0	7337
18170	43	70	7401	99	0	7613
18171	26	7800	302	66	0	8194
18172	7254	215	105	22	0	7596
18173	203	87	51	7417	0	7758
18174	7397	43	54	229	0	7723
18175	226	7189	67	105	0	7587
18176	99	7501	62	63	0	7725
18177	77	305	38	7446	0	7866
18178	7413	145	29	235	0	7822
18179	6932	77	15	124	0	7148
18180	341	67	6560	68	0	7036
18181	160	76	6016	43	0	6295
18182	6078	62	238	48	0	6426
18183	234	6151	120	46	0	6551
18184	6392	196	55	38	0	6681
18185	269	88	59	6281	0	6697
18186	147	59	6941	185	0	7332
18187	6755	44	225	82	0	7106
18188	232	6836	122	62	0	7252
18189	120	6881	71	40	0	7112
18190	96	251	35	6953	0	7335
18191	6924	140	38	211	0	7313
18192	216	74	54	6956	0	7300
18193	7051	54	47	231	0	7383
18194	252	93	6575	110	0	7030
18195	6706	80	171	74	0	7031
18196	7080	47	83	74	0	7284
18197	312	56	6630	81	0	7079
18198	6621	36	190	65	0	6912
18199	286	7065	101	47	0	7499
18200	183	186	71	7039	0	7479
18201	142	7244	57	184	0	7627
18202	7453	203	60	84	0	7800
18203	274	111	67	7156	0	7608
18204	160	7122	62	177	0	7521
18205	109	223	39	7339	0	7710
18206	73	7157	40	245	0	7515
18207	98	257	15	7473	0	7843
18208	7351	138	19	266	0	7774
18209	224	107	27	7419	0	7777
18210	127	84	7105	275	0	7591
18211	7055	79	171	167	0	7472
18212	220	77	84	7377	0	7758
18213	139	69	7127	260	0	7595
18214	111	52	6858	168	0	7189
18215	83	47	7148	130	0	7408
18216	95	32	302	6844	0	7273
18217	101	36	158	7182	0	7477
18218	75	28	118	7316	0	7537
18219	73	25	108	7419	0	7625
18220	7261	22	110	330	0	7723
18221	7318	28	98	190	0	7634
18222	7398	40	78	136	0	7652
18223	7460	37	53	149	0	7699
18224	339	48	27	6458	0	6872
18225	212	54	6108	285	0	6659
18226	6342	46	182	161	0	6731
18227	6603	49	82	117	0	6851
18228	381	47	60	6271	0	6759
18229	236	52	41	6557	0	6886
18230	6504	45	58	322	0	6929
18231	295	41	60	5086	0	5482
18232	202	5367	54	286	0	5909
18233	5695	168	62	190	0	6115
18234	5703	98	67	138	0	6006
18235	346	71	5351	131	0	5899
18236	205	54	198	5459	0	5916
18237	153	54	130	5741	0	6078
18238	5162	59	91	311	0	5623
18239	5324	53	70	170	0	5617
18240	323	40	70	5602	0	6035
18241	203	58	5549	290	0	6100
18242	158	44	5564	213	0	5979
18243	139	40	251	5746	0	6176
18244	160	49	119	5962	0	6290
18245	5759	23	82	356	0	6220
18246	313	5497	82	208	0	6100
18247	203	5542	104	134	0	5983
18248	125	5833	102	133	0	6193
18249	127	261	85	5827	0	6300
18250	5776	131	64	280	0	6251
18251	5760	92	53	168	0	6073
18252	314	5667	31	146	0	6158
18253	5851	262	39	107	0	6259
18254	308	176	24	5777	0	6285
18255	195	128	6731	275	0	7329
18256	196	88	179	6955	0	7418
18257	155	80	97	7223	0	7555
18258	138	65	69	7374	0	7646
18259	7172	58	56	367	0	7653
18260	264	47	54	7105	0	7470
18261	172	6926	61	349	0	7508
18262	6638	171	65	229	0	7103
18263	249	6496	63	201	0	7009
18264	150	6522	63	157	0	6892
18265	133	6705	57	156	0	7051
18266	88	214	5704	112	0	6118
18267	96	5889	175	110	0	6270
18268	22	59	4179	24	0	4284
18269	3576	648	51	27	0	4302
18270	4456	8	2	8	0	4474
18271	16	8	4721	8	0	4753
18272	4516	8	16	6	0	4546
18273	5239	5	6	8	0	5258
18274	17	16	5134	10	0	5177
18275	11	4952	27	12	0	5002
18276	11	19	2	5318	0	5350
18277	5371	10	6	13	0	5400
18278	15	11	0	5293	0	5319
18279	5356	8	8	19	0	5391
18280	5236	5	10	15	0	5266
18281	24	12	5181	13	0	5230
18282	5123	7	10	16	0	5156
18283	22	5009	16	6	0	5053
18284	5359	17	4	14	0	5394
18285	13	13	5	5287	0	5318
18286	10	12	5349	16	0	5387
18287	5	12	12	5273	0	5302
18288	5393	5	6	22	0	5426
18289	17	5096	14	22	0	5149
18290	10	28	5234	7	0	5279
18291	16	11	12	5009	0	5048
18292	13	17	5337	16	0	5383
18293	7	5012	32	8	0	5059
18294	5381	22	3	8	0	5414
18295	25	10	4	5336	0	5375
18296	9	15	5312	20	0	5356
18297	14	17	4979	9	0	5019
18298	5081	6	16	16	0	5119
18299	20	10	10	4808	0	4848
18300	19	6	7	4785	0	4817
18301	20	13	4831	17	0	4881
18302	20	13	4714	15	0	4762
18303	21	4552	33	7	0	4613
18304	16	16	16	5256	0	5304
18305	12	20	13	5101	0	5146
18306	18	5032	14	25	0	5089
18307	21	33	5083	16	0	5153
18308	4908	11	25	13	0	4957
18309	26	13	15	5293	0	5347
18310	28	14	5247	27	0	5316
18311	18	10	25	4965	0	5018
18312	13	4843	34	22	0	4912
18313	20	34	5267	17	0	5338
18314	5022	17	38	15	0	5092
18315	53	18	6320	10	0	6401
18316	20	17	6140	16	0	6193
18317	21	15	6047	20	0	6103
18318	21	11	6547	18	0	6597
18319	12	14	52	6498	0	6576
18320	24	13	6969	47	0	7053
18321	18	18	38	6701	0	6775
18322	12	6670	22	50	0	6754
18323	7366	41	16	21	0	7444
18324	70	20	18	7267	0	7375
18325	32	24	8655	83	0	8794
18326	16	8357	153	45	0	8571
18327	15	136	42	8986	0	9179
18328	8883	35	31	148	0	9097
18329	123	8509	36	53	0	8721
18330	44	145	22	8962	0	9173
18331	9025	43	23	157	0	9248
18332	151	27	8203	34	0	8415
18333	8280	16	131	27	0	8454
18334	153	17	8336	24	0	8530
18335	8217	10	141	14	0	8382
18336	8484	15	44	16	0	8559
18337	169	21	8158	25	0	8373
18338	52	7960	150	18	0	8180
18339	420	126	42	8050	0	8638
18340	18	34	7956	127	0	8135
18341	25	11	133	7348	0	7517
18342	18	17	39	7756	0	7830
18343	22	7	7777	161	0	7967
18344	13	24	7616	43	0	7696
18345	12	13	138	7966	0	8129
18346	8169	11	41	147	0	8368
18347	121	7517	56	56	0	7750
18348	41	7767	32	35	0	7875
18349	8206	148	21	31	0	8406
18350	8127	40	24	18	0	8209
18351	162	27	14	8005	0	8208
18352	48	20	23	8134	0	8225
18353	38	18	17	8322	0	8395
18354	8085	13	24	164	0	8286
18355	142	6556	22	61	0	6781
18356	54	6815	22	36	0	6927
18357	25	151	22	7001	0	7199
18358	28	42	20	7031	0	7121
18359	24	21	21	7082	0	7148
18360	6979	17	18	176	0	7190
18361	128	6731	21	83	0	6963
18362	7042	139	16	44	0	7241
18363	142	43	6656	47	0	6888
18364	56	6510	139	31	0	6736
18365	24	137	40	6962	0	7163
18366	6985	49	18	149	0	7201
18367	141	25	6756	58	0	6980
18368	52	32	6974	33	0	7091
18369	36	28	149	6905	0	7118
18370	38	24	51	6577	0	6690
18371	28	25	33	6332	0	6418
18372	39	25	25	6279	0	6368
18373	23	12	27	5932	0	5994
18374	32	6235	31	185	0	6483
18375	24	153	21	6667	0	6865
18376	6476	44	23	193	0	6736
18377	150	6358	41	84	0	6633
18378	6479	157	26	59	0	6721
18379	169	44	6543	70	0	6826
18380	72	52	6461	41	0	6626
18381	41	42	155	6490	0	6728
18382	51	45	9842	181	0	10119
18383	34	39	340	9915	0	10328
18384	43	40	123	10293	0	10499
18385	10080	17	66	484	0	10647
18386	9128	20	63	190	0	9401
18387	422	8876	45	111	0	9454
18388	176	9401	52	68	0	9697
18389	91	423	40	9325	0	9879
18390	9285	169	29	367	0	9850
18391	357	87	9072	167	0	9683
18392	150	65	342	9210	0	9767
18393	93	38	130	9634	0	9895
18394	74	48	8828	484	0	9434
18395	41	9027	369	221	0	9658
18396	50	336	139	9374	0	9899
18397	46	147	9018	420	0	9631
18398	53	75	356	9444	0	9928
18399	8907	57	149	430	0	9543
18400	336	8810	102	209	0	9457
18401	146	9297	87	115	0	9645
18402	79	427	44	9347	0	9897
18403	9091	169	42	402	0	9704
18404	326	8680	63	183	0	9252
18405	9709	333	48	130	0	10220
18406	410	159	9315	131	0	10015
18407	185	104	9620	116	0	10025
18408	127	75	467	9547	0	10216
18409	102	63	187	10780	0	11132
18410	10501	87	117	551	0	11256
18411	423	73	65	10493	0	11054
18412	215	87	10142	513	0	10957
18413	124	104	363	9870	0	10461
18414	96	77	162	10645	0	10980
18415	66	78	8859	595	0	9598
18416	8829	63	359	312	0	9563
18417	363	65	191	9446	0	10065
18418	8984	79	109	488	0	9660
18419	411	8421	119	257	0	9208
18420	8552	371	89	190	0	9202
18421	413	8376	72	167	0	9028
18422	194	8727	77	146	0	9144
18423	138	477	63	8327	0	9005
18424	7533	207	876	408	0	9024
18425	6914	108	61	192	0	7275
18426	364	82	55	6886	0	7387
18427	6875	68	55	348	0	7346
18428	6992	55	62	228	0	7337
18429	419	68	66	6870	0	7423
18430	6695	64	79	340	0	7178
18431	362	6575	80	224	0	7241
18432	6925	288	78	156	0	7447
18433	357	175	6644	140	0	7316
18434	7117	88	252	162	0	7619
18435	361	67	170	7079	0	7677
18436	205	36	120	7347	0	7708
18437	133	51	77	7466	0	7727
18438	116	48	79	7454	0	7697
18439	89	69	83	7286	0	7527
18440	103	6494	77	516	0	7190
18441	124	7084	86	288	0	7582
18442	7188	361	60	199	0	7808
18443	367	206	6776	154	0	7503
18444	7128	160	238	105	0	7631
18445	405	148	7020	105	0	7678
18446	249	109	281	7108	0	7747
18447	198	110	122	7553	0	7983
18448	7328	100	82	437	0	7947
18449	376	108	6971	261	0	7716
18450	279	78	243	8092	0	8692
18451	209	64	8099	361	0	8733
18452	168	8888	318	276	0	9650
18453	165	357	140	9396	0	10058
18454	9262	179	93	497	0	10031
18455	9198	111	58	281	0	9648
18456	9246	79	82	214	0	9621
18457	562	8783	100	172	0	9617
18458	276	9334	89	180	0	9879
18459	8248	469	91	205	0	9013
18460	408	9020	99	209	0	9736
18461	210	9202	92	241	0	9745
18462	177	449	8609	214	0	9449
18463	122	8856	359	218	0	9555
18464	117	9350	180	193	0	9840
18465	128	511	103	9211	0	9953
18466	134	283	8890	454	0	9761
18467	152	172	8977	229	0	9530
18468	8633	100	498	183	0	9414
18469	499	97	8738	139	0	9473
18470	8888	84	438	144	0	9554
18471	513	89	205	8364	0	9171
18472	320	8492	124	424	0	9360
18473	8949	384	86	257	0	9676
18474	9323	187	80	175	0	9765
18475	529	127	79	9040	0	9775
18476	285	99	75	9320	0	9779
18477	214	82	84	9558	0	9938
18478	9132	79	72	598	0	9881
18479	8875	73	53	294	0	9295
18480	8912	96	56	183	0	9247
18481	622	8643	41	182	0	9488
18482	5222	140	17	30	0	5409
18483	163	5077	19	33	0	5292
18484	63	5210	17	31	0	5321
18485	47	160	28	5200	0	5435
18486	46	5145	17	154	0	5362
18487	5257	171	12	61	0	5501
18488	150	56	7	5260	0	5473
18489	5228	52	11	160	0	5451
18490	155	4984	16	63	0	5218
18491	48	5158	13	51	0	5270
18492	5252	173	23	26	0	5474
18493	151	5110	21	31	0	5313
18494	69	150	26	5214	0	5459
18495	54	43	33	5362	0	5492
18496	5297	33	23	184	0	5537
18497	177	24	20	5235	0	5456
18498	79	22	5380	174	0	5655
18499	58	26	155	5462	0	5701
18500	5471	38	54	215	0	5778
18501	185	5612	43	75	0	5915
18502	5911	200	18	60	0	6189
18503	5917	71	28	41	0	6057
18504	5917	59	18	36	0	6030
18505	271	47	5001	46	0	5365
18506	118	55	4964	28	0	5165
18507	4756	47	174	20	0	4997
18508	152	4090	40	14	0	4296
18509	33	167	15	4260	0	4475
18510	18	41	19	4287	0	4365
18511	20	3995	34	172	0	4221
18512	16	4538	18	43	0	4615
18513	16	175	10	6595	0	6796
18514	10	51	15	6550	0	6626
18515	24	30	6307	193	0	6554
18516	36	32	5821	52	0	5941
18517	6102	17	169	27	0	6315
18518	6605	14	40	17	0	6676
18519	188	13	12	6408	0	6621
18520	53	33	6464	171	0	6721
18521	36	26	149	6332	0	6543
18522	6471	18	33	172	0	6694
18523	180	29	6345	55	0	6609
18524	64	21	153	6267	0	6505
18525	36	29	6332	164	0	6561
18526	33	5794	181	44	0	6052
18527	33	182	6278	29	0	6522
18528	17	65	150	6128	0	6360
18529	6479	32	48	170	0	6729
18530	173	36	17	6419	0	6645
18531	7408	27	22	170	0	7627
18532	7481	26	16	55	0	7578
18533	7168	25	14	36	0	7243
18534	205	37	6746	32	0	7020
18535	6796	30	154	16	0	6996
18536	190	22	40	6999	0	7251
18537	69	13	17	7120	0	7219
18538	33	24	6933	213	0	7203
18539	31	13	145	6775	0	6964
18540	7072	11	32	189	0	7304
18541	177	7271	43	65	0	7556
18542	7891	163	14	42	0	8110
18543	7950	43	19	39	0	8051
18544	7915	24	15	28	0	7982
18545	206	29	12	7144	0	7391
18546	68	31	7160	180	0	7439
18547	48	19	138	7108	0	7313
18548	49	16	39	7332	0	7436
18549	7319	20	23	191	0	7553
18550	6443	18	31	61	0	6553
18551	223	24	6177	39	0	6463
18552	39	4	51	5078	0	5172
18553	22	9	5260	52	0	5343
18554	5464	5	55	34	0	5558
18555	90	6290	30	16	0	6426
18556	6679	117	15	11	0	6822
18557	122	5600	22	1540	0	7284
18558	7380	118	9	55	0	7562
18559	165	7132	17	24	0	7338
18560	77	163	6	7230	0	7476
18561	40	64	6	8271	0	8381
18562	8230	27	6	205	0	8468
18563	8139	13	11	79	0	8242
18564	8243	11	9	40	0	8303
18565	8162	12	9	26	0	8209
18566	8264	9	8	26	0	8307
18567	238	4	7	7992	0	8241
18568	97	7827	27	146	0	8097
18569	57	143	6	8092	0	8298
18570	38	7969	20	169	0	8196
18571	32	172	11	8076	0	8291
18572	31	8009	24	174	0	8238
18573	29	170	10	8154	0	8363
18574	28	86	7205	181	0	7500
18575	6685	35	147	83	0	6950
18576	163	7099	63	58	0	7383
18577	7470	157	26	26	0	7679
18578	200	70	7125	31	0	7426
18579	6930	33	153	25	0	7141
18580	196	28	7608	29	0	7861
18581	83	22	217	7558	0	7880
18582	44	7591	82	222	0	7939
18583	51	224	7864	60	0	8199
18584	36	69	214	7784	0	8103
18585	7884	60	75	236	0	8255
18586	231	26	49	8035	0	8341
18587	83	22	30	8154	0	8289
18588	61	22	17	8361	0	8461
18589	40	28	7798	324	0	8190
18590	41	21	197	7780	0	8039
18591	30	7613	82	278	0	8003
18592	35	220	51	8024	0	8330
18593	26	76	35	8242	0	8379
18594	7987	52	18	316	0	8373
18595	231	23	25	8079	0	8358
18596	90	31	8541	288	0	8950
18597	69	48	8400	129	0	8646
18598	36	24	8219	73	0	8352
18599	27	7930	294	65	0	8316
18600	8409	204	105	40	0	8758
18601	208	7876	86	40	0	8210
18602	8147	234	45	36	0	8462
18603	244	93	34	7979	0	8350
18604	101	77	8196	220	0	8594
18605	67	60	7865	103	0	8095
18606	50	8407	307	67	0	8831
18607	54	268	101	8747	0	9170
18608	40	94	64	9093	0	9291
18609	40	67	43	9262	0	9412
18610	36	55	8771	394	0	9256
18611	7974	38	273	160	0	8445
18612	288	45	8469	113	0	8915
18613	100	35	301	6688	0	7124
18614	78	47	89	7177	0	7391
18615	70	51	6636	366	0	7123
18616	6448	34	275	180	0	6937
18617	290	6680	133	98	0	7201
18618	6949	292	85	95	0	7421
18619	332	111	74	6426	0	6943
18620	117	6740	55	294	0	7206
18621	90	304	48	7029	0	7471
18622	6910	112	54	365	0	7441
18623	324	73	45	7010	0	7452
18624	134	55	6638	375	0	7202
18625	6729	46	293	167	0	7235
18626	7082	42	107	138	0	7369
18627	387	61	6575	104	0	7127
18628	174	48	283	6787	0	7292
18629	6908	40	118	367	0	7433
18630	344	47	101	6860	0	7352
18631	152	50	66	6266	0	6534
18632	111	68	62	6381	0	6622
18633	94	48	58	6479	0	6679
18634	79	62	5789	472	0	6402
18635	73	47	279	6224	0	6623
18636	65	49	5828	431	0	6373
18637	5875	40	319	201	0	6435
18638	6265	38	145	168	0	6616
18639	6315	31	126	130	0	6602
18640	6323	32	86	136	0	6577
18641	440	37	88	5372	0	5937
18642	5488	35	83	361	0	5967
18643	396	44	5172	189	0	5801
18644	192	42	5225	157	0	5616
18645	5130	25	355	165	0	5675
18646	326	5064	162	161	0	5713
18647	137	5466	129	152	0	5884
18648	112	327	113	5373	0	5925
18649	96	128	5155	356	0	5735
18650	5163	92	340	184	0	5779
18651	348	81	5142	150	0	5721
18652	192	5203	325	126	0	5846
18653	148	303	5119	142	0	5712
18654	120	4666	284	116	0	5186
18655	3834	231	109	95	0	4269
18656	253	3910	109	91	0	4363
18657	95	3319	69	65	0	3548
18658	73	222	59	3258	0	3612
18659	64	91	3133	215	0	3503
18660	64	64	194	3151	0	3473
18661	59	57	89	2880	0	3085
18662	65	58	2560	258	0	2941
18663	58	41	210	2582	0	2891
18664	66	2614	104	219	0	3003
18665	59	165	92	2747	0	3063
18666	2685	66	88	238	0	3077
18667	225	53	56	2758	0	3092
18668	80	65	2575	247	0	2967
18669	93	75	193	2759	0	3120
18670	73	50	2562	256	0	2941
18671	2700	62	208	108	0	3078
18672	216	45	71	2756	0	3088
18673	2731	49	74	253	0	3107
18674	225	44	2569	133	0	2971
18675	2591	25	206	136	0	2958
18676	222	2647	101	97	0	3067
18677	113	169	2615	102	0	2999
18678	97	67	214	2722	0	3100
18679	75	70	2623	231	0	2999
18680	68	2108	149	104	0	2429
18681	63	2281	86	84	0	2514
18682	1889	118	53	79	0	2139
18683	132	1931	46	81	0	2190
18684	1932	116	48	90	0	2186
18685	131	45	66	1964	0	2206
18686	68	42	1794	151	0	2055
18687	61	2158	120	79	0	2418
18688	64	122	65	2207	0	2458
18689	74	53	54	3068	0	3249
18690	67	44	43	3187	0	3341
18691	59	47	55	3066	0	3227
18692	60	2815	48	225	0	3148
18693	54	3147	52	112	0	3365
18694	2939	183	55	74	0	3251
18695	161	3072	56	75	0	3364
18696	51	127	26	2302	0	2506
18697	37	52	2134	135	0	2358
18698	44	2257	112	56	0	2469
18699	33	140	36	2256	0	2465
18700	39	45	36	2219	0	2339
18701	28	2266	38	150	0	2482
18702	2299	145	23	69	0	2536
18703	137	61	2198	65	0	2461
18704	1800	28	100	41	0	1969
18705	98	2265	35	49	0	2447
18706	1576	51	6	14	0	1647
18707	46	1599	5	16	0	1666
18708	19	58	2	2700	0	2779
18709	7	19	3	2840	0	2869
18710	2671	15	9	147	0	2842
18711	95	23	6	2762	0	2886
18712	60	21	2552	108	0	2741
18713	21	2526	88	57	0	2692
18714	21	2700	37	29	0	2787
18715	21	133	16	2687	0	2857
18716	15	74	2612	107	0	2808
18717	12	27	93	2691	0	2823
18718	5	21	45	2819	0	2890
18719	9	24	2596	153	0	2782
18720	20	26	2518	74	0	2638
18721	5	2689	138	37	0	2869
18722	2693	98	51	29	0	2871
18723	104	66	23	2507	0	2700
18724	57	2641	21	111	0	2830
18725	2705	106	22	68	0	2901
18726	98	67	22	2732	0	2919
18727	53	35	11	2768	0	2867
18728	22	2579	18	173	0	2792
18729	16	110	18	2794	0	2938
18730	3219	62	19	133	0	3433
18731	108	38	11	3324	0	3481
18732	55	29	17	3388	0	3489
18733	21	32	3181	172	0	3406
18734	18	45	3085	97	0	3245
18735	3206	32	129	74	0	3441
18736	99	18	57	3302	0	3476
18737	55	33	29	3337	0	3454
18738	37	33	26	3435	0	3531
18739	41	29	3128	185	0	3383
18740	3220	26	123	93	0	3462
18741	114	30	59	3276	0	3479
18742	67	44	35	3396	0	3542
18743	3228	25	22	183	0	3458
18744	110	3129	31	116	0	3386
18745	70	93	3091	102	0	3356
18746	32	60	103	3116	0	3311
18747	36	3103	68	173	0	3380
18748	48	101	39	3371	0	3559
18749	3261	75	40	157	0	3533
18750	129	52	28	3362	0	3571
18751	3293	45	25	164	0	3527
18752	3342	45	31	115	0	3533
18753	158	45	37	3112	0	3352
18754	78	3038	42	166	0	3324
18755	37	3218	31	143	0	3429
18756	43	144	3136	84	0	3407
18757	29	74	127	3164	0	3394
18758	39	50	75	3299	0	3463
18759	50	40	34	3448	0	3572
18760	3274	41	27	209	0	3551
18761	143	40	21	3385	0	3589
18762	92	42	3176	171	0	3481
18763	3224	35	102	143	0	3504
18764	134	36	57	3323	0	3550
18765	86	47	42	3439	0	3614
18766	41	30	3160	257	0	3488
18767	3163	33	117	146	0	3459
18768	130	42	68	3366	0	3606
18769	91	38	3188	184	0	3501
18770	59	34	122	3322	0	3537
18771	49	13	103	2714	0	2879
18772	67	3174	60	194	0	3495
18773	3230	110	38	150	0	3528
18774	3245	62	52	132	0	3491
18775	161	3190	56	118	0	3525
18776	3283	119	66	98	0	3566
18777	3316	78	39	91	0	3524
18778	187	40	32	3766	0	4025
18779	98	46	3593	196	0	3933
18780	101	41	3584	125	0	3851
18781	81	55	3946	95	0	4177
18782	43	44	3970	110	0	4167
18783	47	51	177	3930	0	4205
18784	38	53	114	4034	0	4239
18785	48	48	50	4133	0	4279
18786	83	31	37	4193	0	4344
18787	3698	16	42	258	0	4014
18788	156	3626	53	157	0	3992
18789	2908	56	32	58	0	3054
18790	98	36	3158	59	0	3351
18791	69	27	3534	62	0	3692
18792	37	35	107	3611	0	3790
18793	3651	28	57	135	0	3871
18794	3370	16	58	88	0	3532
18795	121	3480	50	60	0	3711
18796	92	3600	30	80	0	3802
18797	39	104	23	3733	0	3899
18798	3643	43	28	139	0	3853
18799	109	3568	27	82	0	3786
18800	3711	97	25	52	0	3885
18801	3645	59	31	56	0	3791
18802	3716	28	19	62	0	3825
18803	146	28	3554	54	0	3782
18804	90	3471	94	51	0	3706
18805	3277	74	45	54	0	3450
18806	3214	37	34	57	0	3342
18807	161	3175	36	49	0	3421
18808	9	2107	4	3	0	2123
18809	2162	33	3	2	0	2200
18810	32	8	0	2124	0	2164
18811	11	5	2097	30	0	2143
18812	2035	4	29	5	0	2073
18813	34	5	4	2122	0	2165
18814	8	2030	9	39	0	2086
18815	5	36	0	2160	0	2201
18816	4	11	2097	33	0	2145
18817	4	4	30	2066	0	2104
18818	2150	2	7	34	0	2193
18819	33	0	4	2135	0	2172
18820	9	2	9	2159	0	2179
18821	2	5	2366	40	0	2413
18822	4	4	30	2320	0	2358
18823	6	2273	16	34	0	2329
18824	2391	32	3	8	0	2434
18825	2305	10	3	7	0	2325
18826	34	5	2336	8	0	2383
18827	7	1	29	2279	0	2316
18828	6	2224	8	32	0	2270
18829	7	2311	8	6	0	2332
18830	1875	33	2	7	0	1917
18831	35	9	1	1874	0	1919
18832	11	5	1835	31	0	1882
18833	6	3	1806	9	0	1824
18834	5	7	29	1861	0	1902
18835	1873	5	5	32	0	1915
18836	1889	5	1	10	0	1905
18837	36	10	1	1837	0	1884
18838	9	6	1822	33	0	1870
18839	6	1738	33	14	0	1791
18840	1860	33	8	8	0	1909
18841	35	1780	15	2	0	1832
18842	1893	31	4	4	0	1932
18843	35	8	5	1861	0	1909
18844	9	6	1845	36	0	1896
18845	5	5	30	1848	0	1888
18846	1858	6	7	34	0	1905
18847	37	7	1824	7	0	1875
18848	16	1746	33	6	0	1801
18849	5	33	7	1862	0	1907
18850	2877	7	9	35	0	2928
18851	33	4	2760	13	0	2810
18852	11	2	29	2780	0	2822
18853	11	4	7	2885	0	2907
18854	13	4	2814	38	0	2869
18855	5	5	35	2756	0	2801
18856	6	7	2838	36	0	2887
18857	2558	4	36	16	0	2614
18858	33	6	7	2829	0	2875
18859	12	14	3776	34	0	3836
18860	7	3607	65	17	0	3696
18861	3879	66	13	16	0	3974
18862	3917	6	15	12	0	3950
18863	84	5	8	4592	0	4689
18864	15	4655	10	96	0	4776
18865	4838	116	6	18	0	4978
18866	114	25	2	4840	0	4981
18867	24	29	4726	123	0	4902
18868	4612	8	112	25	0	4757
18869	124	4616	29	27	0	4796
18870	34	116	12	4845	0	5007
18871	4870	26	8	120	0	5024
18872	131	25	4735	34	0	4925
18873	32	19	4779	28	0	4858
18874	26	12	132	4518	0	4688
18875	19	11	4762	121	0	4913
18876	18	6	111	4543	0	4678
18877	14	4529	49	120	0	4712
18878	11	120	26	4439	0	4596
18879	4382	25	11	138	0	4556
18880	118	32	5167	33	0	5350
18881	31	4838	137	35	0	5041
18882	27	130	28	4986	0	5171
18883	13	46	5049	140	0	5248
18884	13	27	136	4911	0	5087
18885	9	4915	43	140	0	5107
18886	9	5073	33	42	0	5157
18887	5006	153	12	42	0	5213
18888	123	5162	25	27	0	5337
18889	33	163	5166	23	0	5385
18890	4477	35	101	10	0	4623
18891	109	40	4460	11	0	4620
18892	33	13	117	4177	0	4340
18893	25	23	4424	105	0	4577
18894	9	4246	136	29	0	4420
18895	20	104	30	4473	0	4627
18896	5	27	29	4523	0	4584
18897	7	25	11	4522	0	4565
18898	8	20	4399	144	0	4571
18899	4	7	104	5018	0	5133
18900	7	5	25	5351	0	5388
18901	5153	6	29	210	0	5398
18902	5173	11	14	82	0	5280
18903	183	17	5044	53	0	5297
18904	71	4844	148	41	0	5104
18905	45	140	5081	23	0	5289
18906	26	44	170	5115	0	5355
18907	18	51	5127	163	0	5359
18908	17	20	180	5054	0	5271
18909	23	18	62	5311	0	5414
18910	17	18	5062	209	0	5306
18911	4736	12	169	89	0	5006
18912	151	6656	84	52	0	6943
18913	50	150	42	6944	0	7186
18914	32	54	6850	175	0	7111
18915	15	54	6978	66	0	7113
18916	6981	21	198	61	0	7261
18917	158	6987	92	39	0	7276
18918	57	152	52	7408	0	7669
18919	7448	56	33	165	0	7702
18920	165	47	27	7359	0	7598
18921	59	24	25	7338	0	7446
18922	41	24	6999	226	0	7290
18923	6719	15	167	104	0	7005
18924	7242	16	61	63	0	7382
18925	201	22	46	7191	0	7460
18926	7264	18	32	204	0	7518
18927	214	15	33	7179	0	7441
18928	91	6594	37	207	0	6929
18929	63	7026	49	86	0	7224
18930	36	186	38	7263	0	7523
18931	7184	86	38	190	0	7498
18932	167	47	49	7227	0	7490
18933	7243	32	23	225	0	7523
18934	7252	35	45	89	0	7421
18935	229	18	37	7101	0	7385
18936	126	41	24	7258	0	7449
18937	59	56	6993	259	0	7367
18938	71	34	6969	141	0	7215
18939	83	36	211	7601	0	7931
18940	52	44	7530	271	0	7897
18941	7406	23	234	124	0	7787
18942	213	22	116	7659	0	8010
18943	124	37	8227	237	0	8625
18944	7969	32	242	144	0	8387
18945	9080	29	127	120	0	9356
18946	315	8652	88	96	0	9151
18947	121	225	53	9071	0	9470
18948	144	92	9958	284	0	10478
18949	10121	69	210	175	0	10575
18950	9743	32	86	201	0	10062
18951	299	65	9326	112	0	9802
18952	9551	41	240	108	0	9940
18953	376	32	96	9394	0	9898
18954	177	31	72	9785	0	10065
18955	9631	34	44	358	0	10067
18956	9642	46	51	216	0	9955
18957	299	69	71	9610	0	10049
18958	462	102	9020	295	0	9879
18959	101	8009	178	233	0	8521
18960	153	147	8342	115	0	8757
18961	138	59	8295	131	0	8623
18962	117	8118	238	147	0	8620
18963	135	111	115	7329	0	7690
18964	113	36	69	7684	0	7902
18965	84	41	7622	244	0	7991
18966	58	46	201	7563	0	7868
18967	7829	29	149	191	0	8198
18968	178	33	7517	136	0	7864
18969	8444	37	184	113	0	8778
18970	8922	29	110	85	0	9146
18971	8877	22	101	121	0	9121
18972	284	31	8612	85	0	9012
18973	193	39	8566	74	0	8872
18974	177	26	188	8537	0	8928
18975	144	70	113	8143	0	8470
18976	93	8493	100	249	0	8935
18977	8793	127	118	162	0	9200
18978	8729	46	107	80	0	8962
18979	309	8414	82	76	0	8881
18980	7904	115	130	79	0	8228
18981	221	8118	115	84	0	8538
18982	8494	170	61	101	0	8826
18983	181	56	67	8804	0	9108
18984	155	55	8577	201	0	8988
18985	146	62	8395	90	0	8693
18986	93	50	158	8674	0	8975
18987	73	38	149	8801	0	9061
18988	79	72	8483	181	0	8815
18989	83	58	218	8279	0	8638
18990	90	27	162	8588	0	8867
18991	8594	74	99	205	0	8972
18992	8599	44	90	150	0	8883
18993	8558	24	71	163	0	8816
18994	216	33	8376	114	0	8739
18995	115	7975	207	132	0	8429
18996	122	147	94	8475	0	8838
18997	128	47	8355	166	0	8696
18998	146	8004	196	103	0	8449
18999	7917	84	26	26	0	8053
19000	190	25	37	7727	0	7979
19001	94	27	87	7807	0	8015
19002	7883	27	91	92	0	8093
19003	110	24	48	7767	0	7949
19004	43	37	43	7804	0	7927
19005	7816	76	42	132	0	8066
19006	86	25	7065	42	0	7218
19007	38	6843	79	56	0	7016
19008	7242	70	25	26	0	7363
19009	87	32	7080	31	0	7230
19010	6909	25	72	32	0	7038
19011	88	6944	34	41	0	7107
19012	5618	68	25	29	0	5740
19013	5600	18	27	35	0	5680
19014	5800	17	33	32	0	5882
19015	93	16	28	5691	0	5828
19016	48	13	25	5726	0	5812
19017	46	5400	40	90	0	5576
19018	32	5508	36	48	0	5624
19019	39	5594	35	43	0	5711
19020	5741	75	21	36	0	5873
19021	103	33	5496	33	0	5665
19022	62	29	59	5652	0	5802
19023	59	19	29	5650	0	5757
19024	45	5552	36	85	0	5718
19025	41	76	25	5719	0	5861
19026	37	27	37	5660	0	5761
19027	24	5569	44	98	0	5735
19028	5613	76	30	47	0	5766
19029	88	5490	34	54	0	5666
19030	46	98	5338	49	0	5531
19031	5444	30	64	39	0	5577
19032	99	5450	43	41	0	5633
19033	5564	76	23	46	0	5709
19034	110	34	12	5567	0	5723
19035	54	41	33	5602	0	5730
19036	61	39	5508	84	0	5692
19037	53	26	5394	51	0	5524
19038	39	26	87	5627	0	5779
19039	5030	27	34	71	0	5162
19040	4943	19	24	40	0	5026
19041	75	5124	31	33	0	5263
19042	42	5137	30	42	0	5251
19043	43	4669	33	38	0	4783
19044	667	95	14	4565	0	5341
19045	4524	21	11	78	0	4634
19046	4691	11	3	30	0	4735
19047	5299	14	10	20	0	5343
19048	110	35	3830	9	0	3984
19049	29	6192	89	20	0	6330
19050	24	88	23	7690	0	7825
19051	7541	26	24	117	0	7708
19052	123	19	13	7526	0	7681
19053	39	16	7	8082	0	8144
19054	7926	11	11	151	0	8099
19055	7999	16	7	56	0	8078
19056	155	21	7702	53	0	7931
19057	61	11	112	8033	0	8217
19058	45	30	7717	135	0	7927
19059	26	17	114	8074	0	8231
19060	26	42	7607	142	0	7817
19061	45	21	121	8079	0	8266
19062	7601	22	40	152	0	7815
19063	138	7666	48	64	0	7916
19064	53	7996	35	58	0	8142
19065	75	154	19	6571	0	6819
19066	35	7702	40	118	0	7895
19067	7744	131	25	55	0	7955
19068	7681	41	28	58	0	7808
19069	143	54	6471	42	0	6710
19070	43	6449	111	40	0	6643
19071	36	86	30	6804	0	6956
19072	30	41	6562	109	0	6742
19073	6679	27	83	52	0	6841
19074	107	26	31	6808	0	6972
19075	48	39	6617	113	0	6817
19076	29	22	107	6865	0	7023
19077	6881	17	35	135	0	7068
19078	121	25	6621	51	0	6818
19079	6690	20	107	42	0	6859
19080	6803	25	42	37	0	6907
19081	124	21	34	6284	0	6463
19082	54	36	6079	116	0	6285
19083	54	35	5489	72	0	5650
19084	5684	33	123	47	0	5887
19085	5809	21	47	54	0	5931
19086	134	32	6099	62	0	6327
19087	85	26	108	6271	0	6490
19088	88	24	49	5888	0	6049
19089	59	6309	63	132	0	6563
19090	52	105	36	6515	0	6708
19091	6446	38	40	161	0	6685
19092	130	22	40	6565	0	6757
19093	77	24	6215	148	0	6464
19094	6316	18	123	86	0	6543
19095	158	15	50	6444	0	6667
19096	79	59	6047	138	0	6323
19097	68	6335	135	91	0	6629
19098	6041	110	68	94	0	6313
19099	135	6442	60	105	0	6742
19100	6499	142	40	90	0	6771
19101	189	72	6020	110	0	6391
19102	106	6016	154	121	0	6397
19103	115	6391	80	87	0	6673
19104	108	144	66	6332	0	6650
19105	101	69	83	6605	0	6858
19106	103	58	6202	224	0	6587
19107	81	46	158	6590	0	6875
19108	6467	39	116	233	0	6855
19109	188	52	6280	133	0	6653
19110	134	45	153	6535	0	6867
19111	119	68	6166	196	0	6549
19112	6176	86	180	143	0	6585
19113	173	6395	103	149	0	6820
19114	6275	152	84	169	0	6680
19115	6367	96	72	165	0	6700
19116	6506	65	98	141	0	6810
19117	270	91	5993	154	0	6508
19118	206	6156	172	127	0	6661
19119	162	167	118	6104	0	6551
19120	130	95	129	6478	0	6832
19121	7179	69	131	247	0	7626
19122	245	66	117	7229	0	7657
19123	7142	67	142	296	0	7647
19124	7181	67	131	169	0	7548
19125	7179	60	104	196	0	7539
19126	7248	65	138	155	0	7606
19127	281	85	135	7154	0	7655
19128	7209	103	86	265	0	7663
19129	265	103	6787	181	0	7336
19130	7047	98	199	168	0	7512
19131	7282	89	131	121	0	7623
19132	331	96	6610	106	0	7143
19133	7069	98	199	95	0	7461
19134	7238	84	144	107	0	7573
19135	307	69	118	7066	0	7560
19136	200	69	125	7217	0	7611
19137	7163	62	134	273	0	7632
19138	269	71	107	7167	0	7614
19139	183	57	142	6987	0	7369
19140	184	6773	129	295	0	7381
19141	187	101	89	6906	0	7283
19142	6813	44	151	206	0	7214
19143	253	47	98	6831	0	7229
19144	194	51	109	6407	0	6761
19145	187	6253	129	238	0	6807
19146	164	121	95	6220	0	6600
19147	199	64	118	5641	0	6022
19148	5666	60	106	181	0	6013
19149	184	28	43	2891	0	3146
19150	24	16	1686	45	0	1771
19151	16	1607	32	33	0	1688
19152	27	1678	17	16	0	1738
19153	1492	26	2	7	0	1527
19154	25	1451	3	8	0	1487
19155	1459	15	0	5	0	1479
19156	24	1403	7	6	0	1440
19157	2052	17	5	9	0	2083
19158	43	9	3	2027	0	2082
19159	22	3	0	2036	0	2061
19160	14	2006	7	48	0	2075
19161	11	34	2	2070	0	2117
19162	20	27	1903	40	0	1990
19163	1890	8	29	25	0	1952
19164	35	2262	16	21	0	2334
19165	2345	47	8	11	0	2411
19166	2336	21	3	12	0	2372
19167	2379	11	4	15	0	2409
19168	83	7	7	2291	0	2388
19169	33	8	5	2297	0	2343
19170	25	2551	7	62	0	2645
19171	2595	53	2	39	0	2689
19172	59	2559	11	26	0	2655
19173	2671	61	6	15	0	2753
19174	74	30	2514	16	0	2634
19175	2579	14	50	15	0	2658
19176	73	12	16	2615	0	2716
19177	41	16	2532	62	0	2651
19178	26	17	2527	28	0	2598
19179	24	8	69	2604	0	2705
19180	18	12	2578	63	0	2671
19181	21	5	57	2615	0	2698
19182	2601	14	24	70	0	2709
19183	66	5	17	2622	0	2710
19184	34	14	2476	70	0	2594
19185	31	2368	62	31	0	2492
19186	10	1927	32	28	0	1997
19187	15	67	17	1943	0	2042
19188	1921	29	7	63	0	2020
19189	61	16	10	1955	0	2042
19190	35	6	16	1981	0	2038
19191	27	9	6	2002	0	2044
19192	17	15	13	2006	0	2051
19193	20	14	1875	98	0	2007
19194	26	15	1845	46	0	1932
19195	1901	7	76	34	0	2018
19196	1955	5	35	30	0	2025
19197	87	10	17	1921	0	2035
19198	39	15	8	1977	0	2039
19199	29	14	1797	90	0	1930
19200	25	1861	55	51	0	1992
19201	1928	63	24	34	0	2049
19202	1957	26	22	26	0	2031
19203	95	17	8	1947	0	2067
19204	47	21	1848	80	0	1996
19205	31	12	57	1839	0	1939
19206	21	1834	35	75	0	1965
19207	35	58	1845	34	0	1972
19208	1870	27	58	35	0	1990
19209	73	21	28	1907	0	2029
19210	1965	13	24	82	0	2084
19211	80	6	1846	58	0	1990
19212	1897	20	69	39	0	2025
19213	83	14	29	1936	0	2062
19214	1936	22	28	74	0	2060
19215	85	14	21	1904	0	2024
19216	54	1829	25	89	0	1997
19217	40	1920	26	46	0	2032
19218	38	73	16	1940	0	2067
19219	29	41	1802	86	0	1958
19220	40	1853	76	52	0	2021
19221	12	41	22	1265	0	1340
19222	1196	19	29	55	0	1299
19223	1246	29	8	39	0	1322
19224	64	10	17	1244	0	1335
19225	39	17	10	1218	0	1284
19226	36	1168	18	62	0	1284
19227	21	1238	20	47	0	1326
19228	1201	53	14	32	0	1300
19229	53	37	5	1242	0	1337
19230	32	24	11	1275	0	1342
19231	30	13	1157	69	0	1269
19232	12	18	43	1258	0	1331
19233	17	9	23	1270	0	1319
19234	15	9	24	1282	0	1330
19235	30	18	1150	75	0	1273
19236	20	5	49	1263	0	1337
19237	1226	7	33	70	0	1336
19238	50	13	1152	42	0	1257
19239	1215	16	48	40	0	1319
19240	61	13	18	1233	0	1325
19241	35	7	27	1496	0	1565
19242	29	10	10	1557	0	1606
19243	22	12	1362	106	0	1502
19244	1396	11	68	48	0	1523
19245	73	1408	23	51	0	1555
19246	1466	61	22	30	0	1579
19247	73	1429	19	42	0	1563
19248	36	69	15	1469	0	1589
19249	1494	20	12	87	0	1613
19250	81	26	1390	45	0	1542
19251	1452	12	69	41	0	1574
19252	98	9	1386	21	0	1514
19253	25	13	76	1477	0	1591
19254	46	12	1369	76	0	1503
19255	28	1415	77	43	0	1563
19256	32	63	25	1491	0	1611
19257	830	11	5	52	0	898
19258	45	9	9	825	0	888
19259	14	1169	8	48	0	1239
19260	10	45	6	1239	0	1300
19261	1212	10	5	52	0	1279
19262	1219	8	6	21	0	1254
19263	48	1173	7	22	0	1250
19264	7	931	2	2	0	942
19265	0	32	0	939	0	971
19266	5	3	2	961	0	971
19267	936	2	3	30	0	971
19268	928	2	2	9	0	941
19269	32	894	6	2	0	934
19270	8	24	5	639	0	676
19271	6	6	2	667	0	681
19272	6	5	620	29	0	660
19273	2	606	20	10	0	638
19274	4	652	9	4	0	669
19275	6	27	1	638	0	672
19276	2	4	639	32	0	677
19277	6	1	634	6	0	647
19278	5	2	28	612	0	647
19279	2	8	4	657	0	671
19280	5	4	631	34	0	674
19281	4	5	22	623	0	654
19282	6	4	634	30	0	674
19283	626	2	19	10	0	657
19284	25	6	4	646	0	681
19285	11	4	630	29	0	674
19286	7	3	626	10	0	646
19287	7	3	27	618	0	655
19288	7	5	648	28	0	688
19289	3	8	612	8	0	631
19290	3	572	23	9	0	607
19291	644	26	4	8	0	682
19292	28	5	628	7	0	668
19293	8	5	23	601	0	637
19294	3	4	7	641	0	655
19295	5	3	3	671	0	682
19296	3	2	627	34	0	666
19297	1	7	25	616	0	649
19298	635	5	8	30	0	678
19299	24	3	2	644	0	673
19300	5	3	625	28	0	661
19301	5	2	27	619	0	653
19302	622	2	11	29	0	664
19303	647	1	6	11	0	665
19304	652	0	6	15	0	673
19305	26	0	10	631	0	667
19306	634	1	11	29	0	675
19307	640	3	5	12	0	660
19308	660	3	7	4	0	674
19309	26	593	9	7	0	635
19310	616	25	7	9	0	657
19311	30	3	7	638	0	678
19312	7	2	610	33	0	652
19313	7	590	27	12	0	636
19314	624	31	8	6	0	669
19315	30	6	2	620	0	658
19316	10	6	10	617	0	643
19317	6	583	7	33	0	629
19318	8	600	2	12	0	622
19319	623	27	7	11	0	668
19320	28	602	5	11	0	646
19321	618	24	5	14	0	661
19322	31	597	6	12	0	646
19323	603	27	7	7	0	644
19324	30	592	2	6	0	630
19325	8	616	3	14	0	641
19326	616	26	5	7	0	654
19327	33	7	555	9	0	604
19328	13	578	20	6	0	617
19329	8	27	3	608	0	646
19330	14	6	4	633	0	657
19331	12	2	4	622	0	640
19332	12	5	3	636	0	656
19333	7	10	584	34	0	635
19334	567	4	20	11	0	602
19335	27	6	5	621	0	659
19336	622	3	5	31	0	661
19337	623	7	5	8	0	643
19338	628	9	4	5	0	646
19339	624	2	5	13	0	644
19340	31	8	569	11	0	619
19341	0	1	1	321	0	323
19342	1	0	330	1	0	332
19343	0	306	1	2	0	309
19344	1	0	0	311	0	312
19345	1	0	1	330	0	332
19346	0	0	0	339	0	339
19347	0	0	1	333	0	334
19348	0	0	342	0	0	342
19349	1	0	0	322	0	323
19350	0	1	0	337	0	338
19351	342	0	1	0	0	343
19352	322	0	0	2	0	324
19353	0	0	0	337	0	337
19354	0	0	1	337	0	338
19355	0	0	0	342	0	342
19356	335	0	0	1	0	336
19357	324	0	0	0	0	324
19358	322	0	0	1	0	323
19359	8	0	2	0	0	10
19360	0	8	0	1	0	9
19361	9	0	0	0	0	9
19362	8	0	0	0	0	8
19363	0	0	0	9	0	9
19364	0	0	0	9	0	9
19365	9	0	0	0	0	9
19366	0	9	0	0	0	9
19367	0	7	0	0	0	7
19368	489	0	0	0	0	489
19369	0	0	0	468	0	468
19370	0	0	0	486	0	486
19371	0	0	0	484	0	484
19372	0	0	0	476	0	476
19373	0	0	0	471	0	471
19374	0	464	0	0	0	464
19375	0	0	0	486	0	486
19376	491	0	0	0	0	491
19377	0	0	0	484	0	484
19378	0	0	0	480	0	480
19379	492	0	0	0	0	492
19380	0	463	0	0	0	463
19381	0	0	0	487	0	487
19382	0	471	1	0	0	472
19383	0	0	0	481	0	481
19384	0	0	472	0	0	472
19385	376	2	0	0	0	378
19386	0	452	0	1	0	453
19387	478	0	0	0	0	478
19388	3	0	465	0	0	468
19389	0	0	0	450	0	450
19390	0	459	0	0	0	459
19391	0	457	1	0	0	458
19392	484	0	0	0	0	484
19393	1	1	0	472	0	474
19394	0	0	467	0	0	467
19395	0	0	0	437	0	437
19396	0	0	471	0	0	471
19397	392	0	0	0	0	392
19398	1	0	467	0	0	468
19399	0	1	0	428	0	429
19400	0	445	0	1	0	446
19401	0	0	0	481	0	481
19402	0	449	0	0	0	449
19403	484	0	0	0	0	484
19404	0	0	0	450	0	450
19405	1	0	448	0	0	449
19406	1	1	387	0	0	389
19407	369	0	0	0	0	369
19408	439	0	0	0	0	439
19409	431	0	0	0	0	431
19410	433	0	0	0	0	433
19411	0	418	0	0	0	418
19412	451	0	0	0	0	451
19413	433	0	0	0	0	433
19414	0	1	432	0	0	433
19415	0	0	0	380	0	380
19416	436	0	0	0	0	436
19417	0	0	417	0	0	417
19418	1	0	0	390	0	391
19419	0	0	425	0	0	425
19420	0	0	0	406	0	406
19421	0	396	0	0	0	396
19422	437	0	0	0	0	437
19423	0	1	399	0	0	400
19424	391	0	0	0	0	391
19425	0	0	0	417	0	417
19426	435	0	0	0	0	435
19427	0	0	0	419	0	419
19428	435	0	0	0	0	435
19429	0	0	387	0	0	387
19430	384	0	1	0	0	385
19431	0	0	0	404	0	404
19432	0	0	0	421	0	421
19433	432	0	0	0	0	432
19434	0	0	0	415	0	415
19435	0	0	433	0	0	433
19436	0	0	0	407	0	407
19437	424	0	0	1	0	425
19438	0	400	0	1	0	401
19439	0	407	0	0	0	407
19440	431	0	0	0	0	431
19441	0	934	2	0	0	936
19442	0	0	0	1321	0	1321
19443	1340	0	0	0	0	1340
19444	1302	0	0	0	0	1302
19445	1297	1	0	0	0	1298
19446	0	1	1273	0	0	1274
19447	0	0	0	1271	0	1271
19448	0	1253	0	1	0	1254
19449	0	2	0	1305	0	1307
19450	3	0	1712	0	0	1715
19451	0	1572	3	2	0	1577
19452	0	0	0	1742	0	1742
19453	1740	0	1	0	0	1741
19454	0	1669	0	2	0	1671
19455	0	2	1668	1	0	1671
19456	0	0	0	1608	0	1608
19457	2	0	1695	0	0	1697
19458	0	1	1	1573	0	1575
19459	1714	0	0	0	0	1714
19460	0	0	0	1900	0	1900
19461	2202	0	0	0	0	2202
19462	2181	0	1	0	0	2182
19463	1	2083	1	0	0	2085
19464	2212	0	1	0	0	2213
19465	1	2039	1	1	0	2042
19466	1	2	2030	0	0	2033
19467	2	3	2	1872	0	1879
19468	0	0	0	1787	0	1787
19469	0	0	1761	0	0	1761
19470	0	1606	7	1	0	1614
19471	1816	0	0	1	0	1817
19472	1807	0	0	1	0	1808
19473	0	0	0	1787	0	1787
19474	0	0	0	1764	0	1764
19475	0	0	0	1821	0	1821
19476	1814	0	1	0	0	1815
19477	1	1	2030	4	0	2036
19478	2	0	1997	0	0	1999
19479	0	1	18	2056	0	2075
19480	2	0	2075	16	0	2093
19481	1	1	2056	7	0	2065
19482	1	1	26	1977	0	2005
19483	4	1	2309	18	0	2332
19484	0	2163	27	11	0	2201
19485	0	13	15	2332	0	2360
19486	1	8	2330	17	0	2356
19487	0	2	21	2275	0	2298
19488	0	2194	16	15	0	2225
19489	0	17	7	2361	0	2385
19490	1	9	2346	19	0	2375
19491	0	1	22	2243	0	2266
19492	2259	5	18	22	0	2304
19493	14	5	2233	14	0	2266
19494	2164	3	24	11	0	2202
19495	15	2197	24	7	0	2243
19496	2333	16	5	7	0	2361
19497	17	9	8	2322	0	2356
19498	11	2210	10	18	0	2249
19499	2323	21	3	15	0	2362
19500	18	11	8	2288	0	2325
19501	10	3	2256	30	0	2299
19502	4	2145	28	15	0	2192
19503	6	16	14	2325	0	2361
19504	2317	8	13	19	0	2357
19505	2286	3	11	16	0	2316
19506	26	8	8	2277	0	2319
19507	13	8	2277	22	0	2320
19508	2098	4	18	20	0	2140
19509	24	7	2273	10	0	2314
19510	14	8	21	2227	0	2270
19511	2303	6	17	25	0	2351
19512	21	2182	12	21	0	2236
19513	2321	17	12	10	0	2360
19514	22	15	2229	18	0	2284
19515	2230	5	22	12	0	2269
19516	24	7	13	2261	0	2305
19517	17	5	10	2305	0	2337
19518	13	2	2283	29	0	2327
19519	16	2	22	2244	0	2284
19520	2753	4	14	29	0	2800
19521	25	4	6	2752	0	2787
19522	15	2610	14	23	0	2662
19523	12	15	8	2743	0	2778
19524	10	2597	15	28	0	2650
19525	18	23	2640	16	0	2697
19526	3014	13	24	14	0	3065
19527	23	7	16	3237	0	3283
19528	18	11	3186	24	0	3239
19529	9	3019	42	21	0	3091
19530	12	18	17	3269	0	3316
19531	12	12	12	3291	0	3327
19532	3267	9	16	33	0	3325
19533	19	11	11	3260	0	3301
19534	3274	9	16	31	0	3330
19535	3249	7	17	31	0	3304
19536	31	3076	21	18	0	3146
19537	3293	19	16	22	0	3350
19538	31	15	17	4076	0	4139
19539	20	15	5036	51	0	5122
19540	5073	12	47	33	0	5165
19541	43	10	29	5074	0	5156
19542	32	13	4630	59	0	4734
19543	4399	10	46	50	0	4505
19544	49	9	34	4698	0	4790
19545	39	4578	32	64	0	4713
19546	31	44	12	4622	0	4709
19547	23	4591	20	57	0	4691
19548	4709	50	14	41	0	4814
19549	50	29	4579	34	0	4692
19550	30	4067	55	23	0	4175
19551	28	48	27	4312	0	4415
19552	23	36	4258	50	0	4367
19553	25	29	4033	31	0	4118
19554	15	4020	80	37	0	4152
19555	15	47	35	4208	0	4305
19556	13	33	20	4193	0	4259
19557	14	23	21	5833	0	5891
19558	6122	18	18	206	0	6364
19559	193	27	5798	57	0	6075
19560	51	5586	170	53	0	5860
19561	36	171	42	5488	0	5737
19562	31	45	30	5843	0	5949
19563	28	28	5559	222	0	5837
19564	15	17	181	5647	0	5860
19565	16	23	5589	221	0	5849
19566	25	17	5425	67	0	5534
19567	26	17	5628	48	0	5719
19568	16	16	218	5369	0	5619
19569	23	18	60	5548	0	5649
19570	18	19	36	5819	0	5892
19571	5629	13	29	238	0	5909
19572	179	5551	33	80	0	5843
19573	6147	183	19	60	0	6409
19574	6163	50	25	44	0	6282
19575	6174	22	25	44	0	6265
19576	245	7145	50	26	0	7466
19577	7219	176	9	14	0	7418
19578	7320	34	12	22	0	7388
19579	226	24	16	7082	0	7348
19580	71	22	9	7213	0	7315
19581	43	15	13	7431	0	7502
19582	34	28	6914	242	0	7218
19583	6662	11	168	97	0	6938
19584	184	19	50	6995	0	7248
19585	6908	9	44	227	0	7188
19586	195	6716	46	73	0	7030
19587	64	175	39	6953	0	7231
19588	34	39	37	7159	0	7269
19589	6989	26	37	238	0	7290
19590	196	21	24	7036	0	7277
19591	6907	17	19	242	0	7185
19592	6953	17	8	97	0	7075
19593	243	6571	21	68	0	6903
19594	85	6934	20	43	0	7082
19595	83	208	14	6767	0	7072
19596	50	6748	26	181	0	7005
19597	49	218	10	6977	0	7254
19598	44	67	6716	222	0	7049
19599	37	64	6474	92	0	6667
19600	6430	27	189	64	0	6710
19601	6957	23	63	71	0	7114
19602	238	6675	56	64	0	7033
19603	6913	187	32	64	0	7196
19604	221	6718	45	58	0	7042
19605	83	207	32	6866	0	7188
19606	46	60	30	7002	0	7138
19607	50	44	20	6976	0	7090
19608	38	27	33	7069	0	7167
19609	6868	22	40	288	0	7218
19610	200	6693	50	126	0	7069
19611	6923	194	30	93	0	7240
19612	7005	47	33	82	0	7167
19613	273	51	6645	61	0	7030
19614	6573	49	181	55	0	6858
19615	252	6555	58	63	0	6928
19616	104	207	36	6790	0	7137
19617	75	76	33	6741	0	6925
19618	65	6588	40	252	0	6945
19619	6883	213	35	107	0	7238
19620	251	76	6112	85	0	6524
19621	6233	56	202	94	0	6585
19622	276	48	6216	83	0	6623
19623	120	45	222	6240	0	6627
19624	104	48	96	6484	0	6732
19625	77	35	56	6635	0	6803
19626	5933	43	47	354	0	6377
19627	249	42	5672	174	0	6137
19628	5784	41	208	139	0	6172
19629	6066	33	92	127	0	6318
19630	6065	25	67	115	0	6272
19631	6097	37	74	81	0	6289
19632	306	42	57	5880	0	6285
19633	146	46	5696	271	0	6159
19634	132	29	180	5823	0	6164
19635	118	45	5653	294	0	6110
19636	116	72	5527	118	0	5833
19637	105	5518	234	95	0	5952
19638	353	199	48	4564	0	5164
19639	105	62	31	3990	0	4188
19640	83	57	36	3807	0	3983
19641	89	45	26	3770	0	3930
19642	3656	36	25	246	0	3963
19643	3782	21	27	109	0	3939
19644	242	23	26	3645	0	3936
19645	97	16	3450	276	0	3839
19646	75	27	162	3646	0	3910
19647	88	25	49	3789	0	3951
19648	78	29	3462	273	0	3842
19649	75	28	173	3622	0	3898
19650	3663	39	29	250	0	3981
19651	3750	36	31	110	0	3927
19652	3767	36	28	91	0	3922
19653	261	31	16	3613	0	3921
19654	3671	36	17	237	0	3961
19655	3767	29	38	91	0	3925
19656	283	33	3508	76	0	3900
19657	35	11	1771	33	0	1850
19658	19	3	1587	13	0	1622
19659	1624	0	27	15	0	1666
19660	28	1580	27	8	0	1643
19661	1717	17	15	11	0	1760
19662	26	1638	13	15	0	1692
19663	19	23	6	1687	0	1735
19664	15	16	4	1673	0	1708
19665	14	7	8	1684	0	1713
19666	11	10	1628	36	0	1685
19667	1498	2	21	27	0	1548
19668	32	3	9	1671	0	1715
19669	19	3	1635	32	0	1689
19670	18	3	1553	20	0	1594
19671	1561	4	30	10	0	1605
19672	31	1555	20	17	0	1623
19673	1172	3	0	0	0	1175
19674	1149	0	0	0	0	1149
19675	1	1108	2	1	0	1112
19676	12	1	0	0	0	13
19677	2	3	715	0	0	720
19678	1	2	716	0	0	719
19679	1	0	758	0	0	759
19680	0	1	0	739	0	740
19681	0	0	777	0	0	777
19682	719	0	0	1	0	720
19683	766	0	0	0	0	766
19684	0	0	767	4	0	771
19685	0	1	0	750	0	751
19686	791	0	0	0	0	791
19687	0	724	4	0	0	728
19688	0	731	0	0	0	731
19689	783	0	0	0	0	783
19690	0	1	1017	0	0	1018
19691	0	0	0	1035	0	1035
19692	0	0	0	1046	0	1046
19693	0	0	0	1070	0	1070
19694	0	1581	5	3	0	1589
19695	1	60	0	1663	0	1724
19696	2459	3	0	59	0	2521
19697	115	2	1	3101	0	3219
19698	13	3044	6	156	0	3219
19699	3151	157	1	26	0	3335
19700	171	31	1	3125	0	3328
19701	30	24	0	3327	0	3381
19702	3177	23	2	205	0	3407
19703	3269	16	1	67	0	3353
19704	203	8	0	3210	0	3421
19705	3194	3	2	209	0	3408
19706	3255	11	0	56	0	3322
19707	229	3065	7	39	0	3340
19708	3156	156	1	48	0	3361
19709	199	3062	8	41	0	3310
19710	88	185	0	3176	0	3449
19711	72	45	3033	185	0	3335
19712	39	41	152	3148	0	3380
19713	46	23	27	3252	0	3348
19714	41	20	21	3343	0	3425
19715	3159	24	15	238	0	3436
19716	190	3095	16	91	0	3392
19717	3166	177	8	66	0	3417
19718	192	3097	4	59	0	3352
19719	3198	188	12	36	0	3434
19720	3308	53	8	32	0	3401
19721	3350	47	0	39	0	3436
19722	3388	31	8	30	0	3457
19723	255	29	3037	24	0	3345
19724	104	26	162	3030	0	3322
19725	88	14	28	3253	0	3383
19726	74	21	3069	207	0	3371
19727	3131	19	178	66	0	3394
19728	214	14	41	3204	0	3473
19729	71	21	3065	209	0	3366
19730	65	22	3155	70	0	3312
19731	58	12	211	3174	0	3455
19732	61	16	3114	215	0	3406
19733	50	9	197	3104	0	3360
19734	48	9	80	3331	0	3468
19735	49	15	3110	241	0	3415
19736	3026	19	181	122	0	3348
19737	202	18	70	3237	0	3527
19738	72	29	3091	241	0	3433
19739	71	15	186	3243	0	3515
19740	3208	10	71	252	0	3541
19741	225	13	3081	111	0	3430
19742	3081	10	181	113	0	3385
19743	3322	9	72	68	0	3471
19744	265	14	47	3149	0	3475
19745	120	26	26	3327	0	3499
19746	97	26	3090	232	0	3445
19747	78	37	180	3172	0	3467
19748	76	28	49	3253	0	3406
19749	51	26	62	3373	0	3512
19750	47	19	3051	307	0	3424
19751	3115	10	188	133	0	3446
19752	3301	8	56	126	0	3491
19753	3341	14	42	105	0	3502
19754	3352	19	40	84	0	3495
19755	287	21	35	3192	0	3535
19756	3246	33	21	229	0	3529
19757	3352	23	22	79	0	3476
19758	2966	31	41	67	0	3105
19759	3321	15	32	60	0	3428
19760	306	3012	36	64	0	3418
19761	3224	162	44	61	0	3491
19762	3321	32	39	60	0	3452
19763	276	3065	41	85	0	3467
19764	3221	185	41	70	0	3517
19765	290	47	32	3151	0	3520
19766	124	48	41	3318	0	3531
19767	3155	29	41	245	0	3470
19768	244	3021	46	110	0	3421
19769	115	3184	43	99	0	3441
19770	109	193	50	3191	0	3543
19771	85	77	3062	247	0	3471
19772	93	58	184	3069	0	3404
19773	80	40	60	3344	0	3524
19774	3145	40	49	287	0	3521
19775	3288	26	48	128	0	3490
19776	244	25	53	3195	0	3517
19777	91	34	2337	286	0	2748
19778	102	9	192	2996	0	3299
19779	2942	17	77	270	0	3306
19780	263	23	2831	111	0	3228
19781	101	2803	201	119	0	3224
19782	2930	169	71	90	0	3260
19783	255	43	54	2910	0	3262
19784	101	33	41	3093	0	3268
19785	86	28	47	3135	0	3296
19786	81	29	2806	289	0	3205
19787	2809	15	176	151	0	3151
19788	228	17	2786	120	0	3151
19789	101	2756	196	99	0	3152
19790	113	168	68	2884	0	3233
19791	116	35	71	2955	0	3177
19792	103	777	40	2342	0	3262
19793	102	75	2759	236	0	3172
19794	67	31	2236	100	0	2434
19795	54	29	2297	97	0	2477
19796	32	1448	97	55	0	1632
19797	1	20	2	886	0	909
19798	902	1	1	27	0	931
19799	924	1	1	10	0	936
19800	42	2	870	2	0	916
19801	15	878	27	1	0	921
19802	6	31	1054	0	0	1091
19803	1	1146	34	0	0	1181
19804	1161	36	13	1	0	1211
19805	1178	13	7	0	0	1198
19806	43	1133	4	3	0	1183
19807	1182	30	0	1	0	1213
19808	40	12	2	1146	0	1200
19809	15	6	3	1192	0	1216
19810	1176	3	2	46	0	1227
19811	1178	1	0	18	0	1197
19812	1180	1	0	7	0	1188
19813	48	1106	3	3	0	1160
19814	21	1143	1	1	0	1166
19815	1177	40	2	2	0	1221
19816	35	20	1125	3	0	1183
19817	16	5	35	1164	0	1220
19818	1174	3	11	35	0	1223
19819	40	1109	7	14	0	1170
19820	17	1160	3	8	0	1188
19821	1179	41	5	3	0	1228
19822	38	16	1129	3	0	1186
19823	1170	5	37	4	0	1216
19824	44	4	1141	6	0	1195
19825	19	5	1159	1	0	1184
19826	10	5	47	1142	0	1204
19827	9	7	1152	35	0	1203
19828	1144	3	34	16	0	1197
19829	1194	5	15	8	0	1222
19830	1207	2	6	3	0	1218
19831	1200	1	5	2	0	1208
19832	54	4	5	1161	0	1224
19833	1180	3	4	38	0	1225
19834	41	1135	7	17	0	1200
19835	21	36	2	1110	0	1169
19836	16	1139	3	34	0	1192
19837	1172	42	3	12	0	1229
19838	1179	17	2	9	0	1207
19839	50	8	4	1153	0	1215
19840	1175	6	4	39	0	1224
19841	1180	4	7	16	0	1207
19842	51	5	2	1160	0	1218
19843	23	4	3	1176	0	1206
19844	17	4	2	1206	0	1229
19845	12	10	1129	54	0	1205
19846	12	3	1136	25	0	1176
19847	11	6	1165	11	0	1193
19848	12	1	54	1143	0	1210
19849	16	5	1154	46	0	1221
19850	5	5	46	1145	0	1201
19851	12	9	2205	46	0	2272
19852	15	8	2131	20	0	2174
19853	2089	6	57	10	0	2162
19854	47	2104	26	9	0	2186
19855	2283	37	8	10	0	2338
19856	53	12	8	2226	0	2299
19857	26	13	6	2241	0	2286
19858	14	7	2187	59	0	2267
19859	13	2117	44	24	0	2198
19860	15	36	18	2268	0	2337
19861	15	26	2205	39	0	2285
19862	21	2133	45	17	0	2216
19863	14	38	17	2261	0	2330
19864	2258	23	7	45	0	2333
19865	2222	9	8	26	0	2265
19866	51	8	9	2252	0	2320
19867	2282	8	3	49	0	2342
19868	55	2147	15	18	0	2235
19869	27	39	9	2260	0	2335
19870	22	26	2212	43	0	2303
19871	16	12	40	2574	0	2642
19872	18	8	2584	66	0	2676
19873	2477	5	66	40	0	2588
19874	70	4	32	2599	0	2705
19875	35	3064	17	69	0	3185
19876	24	54	7	3566	0	3651
19877	14	36	3463	71	0	3584
19878	17	26	2911	29	0	2983
19879	23	10	2917	20	0	2970
19880	2908	8	90	11	0	3017
19881	69	2967	38	14	0	3088
19882	28	56	15	3060	0	3159
19883	3079	25	17	72	0	3193
19884	62	3602	19	40	0	3723
19885	3802	63	13	26	0	3904
19886	3798	26	15	20	0	3859
19887	3682	23	10	11	0	3726
19888	3803	11	8	28	0	3850
19889	102	17	3644	19	0	3782
19890	3286	8	55	20	0	3369
19891	52	8	3383	11	0	3454
19892	3027	9	66	9	0	3111
19893	52	7	42	3432	0	3533
19894	43	12	3388	52	0	3495
19895	28	4312	56	32	0	4428
19896	15	173	30	4344	0	4562
19897	19	4225	11	41	0	4296
19898	21	4362	10	14	0	4407
19899	3996	38	233	13	0	4280
19900	49	23	4326	13	0	4411
19901	29	4148	45	8	0	4230
19902	4192	23	13	2	0	4230
19903	34	4182	25	4	0	4245
19904	4449	27	9	2	0	4487
19905	33	13	10	4379	0	4435
19906	4454	6	12	28	0	4500
19907	29	9	8	4403	0	4449
19908	4432	6	14	34	0	4486
19909	26	14	10	4380	0	4430
19910	15	4150	15	28	0	4208
19911	16	31	3	4446	0	4496
19912	4410	25	10	32	0	4477
19913	34	4238	15	18	0	4305
19914	24	30	11	4415	0	4480
19915	4393	25	9	30	0	4457
19916	41	15	7	4358	0	4421
19917	26	10	8	4324	0	4368
19918	28	13	4287	41	0	4369
19919	16	12	4174	33	0	4235
19920	22	5	35	4201	0	4263
19921	24	7	4323	45	0	4399
19922	14	13	33	4260	0	4320
19923	18	9	19	4098	0	4144
19924	14	17	13	4385	0	4429
19925	18	21	4315	44	0	4398
19926	17	12	26	4150	0	4205
19927	23	12	13	4311	0	4359
19928	13	4123	10	50	0	4196
19929	22	32	9	4401	0	4464
19930	4361	13	15	42	0	4431
19931	37	7	13	4344	0	4401
19932	21	18	5359	43	0	5441
19933	4957	14	100	29	0	5100
19934	85	5244	54	34	0	5417
19935	47	80	32	5474	0	5633
19936	39	48	5266	104	0	5457
19937	4995	29	96	57	0	5177
19938	90	5170	52	58	0	5370
19939	5481	92	37	23	0	5633
19940	103	45	18	5402	0	5568
19941	5417	33	11	107	0	5568
19942	127	42	5177	53	0	5399
19943	54	5010	92	46	0	5202
19944	38	7361	58	31	0	7488
19945	7720	108	29	23	0	7880
19946	7666	57	15	25	0	7763
19947	135	40	7524	15	0	7714
19948	7310	29	96	14	0	7449
19949	7549	20	45	21	0	7635
19950	7631	17	34	16	0	7698
19951	151	6377	21	20	0	6569
19952	79	6507	17	31	0	6634
19953	6697	115	7	20	0	6839
19954	6666	67	12	26	0	6771
19955	123	6494	17	32	0	6666
19956	69	98	17	6698	0	6882
19957	45	66	7008	94	0	7213
19958	6919	40	91	56	0	7106
19959	6933	30	52	32	0	7047
19960	7304	18	28	20	0	7370
19961	153	6901	45	34	0	7133
19962	84	107	7057	18	0	7266
19963	7226	54	96	18	0	7394
19964	120	36	37	7354	0	7547
19965	59	28	30	7317	0	7434
19966	44	28	16	7594	0	7682
19967	37	29	7260	161	0	7487
19968	35	17	93	7307	0	7452
19969	22	32	7226	146	0	7426
19970	25	7096	129	77	0	7327
19971	6911	72	30	21	0	7034
19972	75	6812	26	12	0	6925
19973	34	6856	28	12	0	6930
19974	6995	92	7	4	0	7098
19975	78	6242	23	14	0	6357
19976	41	94	6	6110	0	6251
19977	26	5981	20	73	0	6100
19978	6131	92	2	29	0	6254
19979	82	6468	15	25	0	6590
19980	38	104	3	6645	0	6790
19981	32	49	6640	94	0	6815
19982	12	27	84	7026	0	7149
19983	13	6745	58	135	0	6951
19984	15	105	24	6599	0	6743
19985	14	38	10	6695	0	6757
19986	16	33	8	6628	0	6685
19987	16	18	5	6712	0	6751
19988	17	16	11	7126	0	7170
19989	22	11	9	7252	0	7294
19990	13	20	6720	231	0	6984
19991	6542	13	142	114	0	6811
19992	154	17	57	7045	0	7273
19993	75	24	6781	166	0	7046
19994	44	25	6621	80	0	6770
19995	21	12	198	5956	0	6187
19996	6019	18	85	169	0	6291
19997	153	24	5798	80	0	6055
19998	5828	19	157	44	0	6048
19999	178	35	6899	31	0	7143
20000	90	15	169	6849	0	7123
20001	39	29	67	7170	0	7305
20002	25	25	6886	222	0	7158
20003	6418	19	156	106	0	6699
20004	166	23	71	6843	0	7103
20005	83	29	6723	172	0	7007
20006	52	27	6594	83	0	6756
20007	40	15	205	6305	0	6565
20008	19	6501	107	141	0	6768
20009	6820	150	44	64	0	7078
20010	6832	71	32	45	0	6980
20011	231	43	6665	38	0	6977
20012	108	22	154	6518	0	6802
20013	6791	15	76	175	0	7057
20014	167	28	7173	102	0	7470
20015	7146	10	166	58	0	7380
20016	181	7611	104	38	0	7934
20017	91	151	36	8128	0	8406
20018	49	71	29	8306	0	8455
20019	8230	28	33	233	0	8524
20020	165	18	32	8222	0	8437
20021	79	12	24	8308	0	8423
20022	55	13	18	8408	0	8494
20023	8168	16	36	248	0	8468
20024	184	15	7911	114	0	8224
20025	7978	12	157	73	0	8220
20026	8132	14	76	61	0	8283
20027	8208	22	45	50	0	8325
20028	251	20	32	8079	0	8382
20029	112	36	8431	188	0	8767
20030	53	8046	228	118	0	8445
20031	31	8376	115	79	0	8601
20032	20	7171	34	47	0	7272
20033	27	174	7946	41	0	8188
20034	24	55	205	9185	0	9469
20035	9284	25	63	282	0	9654
20036	10827	14	34	149	0	11024
20037	356	6	29	11657	0	12048
20038	147	30	11243	349	0	11769
20039	73	36	11168	171	0	11448
20040	37	19	392	11573	0	12021
20041	53	28	11695	360	0	12136
20042	43	7	368	11858	0	12276
20043	29	6	180	11690	0	11905
20044	47	9637	119	407	0	10210
20045	51	290	54	10024	0	10419
20046	39	110	53	10401	0	10603
20047	10000	53	77	466	0	10596
20048	319	28	61	10140	0	10548
20049	144	26	63	10394	0	10627
20050	9901	27	65	485	0	10478
20051	324	9731	53	275	0	10383
20052	10165	304	78	142	0	10689
20053	374	138	9739	117	0	10368
20054	9959	54	332	129	0	10474
20055	10309	34	158	93	0	10594
20056	495	37	9718	93	0	10343
20057	234	37	9371	97	0	9739
20058	148	24	451	9354	0	9977
20059	9540	25	201	394	0	10160
20060	387	46	9272	208	0	9913
20061	191	13	377	9320	0	9901
20062	121	37	9180	386	0	9724
20063	97	23	381	9857	0	10358
20064	76	21	219	10653	0	10969
20065	10343	24	167	508	0	11042
20066	10479	32	93	288	0	10892
20067	10653	48	82	191	0	10974
20068	529	35	11156	169	0	11889
20069	270	35	11094	167	0	11566
20070	162	31	456	11170	0	11819
20071	108	36	223	11431	0	11798
20072	122	38	133	11839	0	12132
20073	11360	43	109	543	0	12055
20074	414	11508	106	301	0	12329
20075	11859	330	97	204	0	12490
20076	11873	137	87	163	0	12260
20077	508	11281	110	164	0	12063
20078	312	11761	114	144	0	12331
20079	11252	369	136	153	0	11910
20080	386	162	136	11210	0	11894
20081	269	10655	95	458	0	11477
20082	231	296	83	11025	0	11635
20083	154	162	10555	453	0	11324
20084	146	91	373	10771	0	11381
20085	10849	75	228	479	0	11631
20086	406	71	10608	335	0	11420
20087	223	72	10551	284	0	11130
20088	159	47	464	9611	0	10281
20089	141	9578	281	444	0	10444
20090	138	10017	204	301	0	10660
20091	120	10269	164	300	0	10853
20092	10324	387	132	264	0	11107
20093	10340	203	108	264	0	10915
20094	10221	119	115	293	0	10748
20095	437	9993	136	316	0	10882
20096	10543	278	101	251	0	11173
20097	10353	174	112	237	0	10876
20098	535	143	9823	232	0	10733
20099	372	8876	359	198	0	9805
20100	302	357	196	9346	0	10201
20101	9475	193	167	368	0	10203
20102	483	135	9066	241	0	9925
20103	295	93	401	8998	0	9787
20104	250	9017	245	431	0	9943
20105	219	286	220	9252	0	9977
20106	225	124	222	9585	0	10156
20107	9994	104	189	564	0	10851
20108	10052	105	184	365	0	10706
20109	507	83	208	9997	0	10795
20110	295	105	9881	519	0	10800
20111	260	114	9548	373	0	10295
20112	9955	108	422	293	0	10778
20113	489	127	9815	267	0	10698
20114	368	107	408	8774	0	9657
20115	339	8997	263	372	0	9971
20116	8922	313	204	239	0	9678
20117	493	8664	211	236	0	9604
20118	8978	363	192	216	0	9749
20119	518	177	181	8849	0	9725
20120	319	160	149	9169	0	9797
20121	8962	136	149	523	0	9770
20122	9022	152	127	310	0	9611
20123	577	185	94	8853	0	9709
20124	410	181	123	9023	0	9737
20125	337	162	8485	494	0	9478
20126	263	195	8370	312	0	9140
20127	8703	182	404	234	0	9523
20128	451	174	8268	253	0	9146
20129	8067	102	330	259	0	8758
20130	8360	127	188	255	0	8930
20131	480	114	7834	262	0	8690
20132	334	7654	376	233	0	8597
20133	199	7091	193	159	0	7642
20134	171	136	6176	103	0	6586
20135	168	847	196	5509	0	6720
20136	4020	256	76	78	0	4430
20137	4031	5	6	12	0	4054
20138	4905	3	5	7	0	4920
20139	6297	1	7	9	0	6314
20140	6316	2	6	15	0	6339
20141	245	5599	18	8	0	5870
20142	5823	188	12	1	0	6024
20143	211	5685	22	9	0	5927
20144	5956	204	11	5	0	6176
20145	243	63	5588	2	0	5896
20146	86	22	183	5724	0	6015
20147	53	21	44	5654	0	5772
20148	34	5587	22	228	0	5871
20149	5850	210	10	59	0	6129
20150	6052	67	9	20	0	6148
20151	264	28	13	5790	0	6095
20152	91	12	18	6045	0	6166
20153	5893	8	12	278	0	6191
20154	210	12	6	5894	0	6122
20155	72	17	5	6066	0	6160
20156	5922	14	7	262	0	6205
20157	232	12	10	5940	0	6194
20158	5916	1	9	255	0	6181
20159	6041	7	5	85	0	6138
20160	283	13	5624	46	0	5966
20161	6375	4	182	40	0	6601
20162	6554	9	49	42	0	6654
20163	6619	5	22	36	0	6682
20164	287	16	5273	27	0	5603
20165	108	9	198	5231	0	5546
20166	61	4	61	5637	0	5763
20167	52	15	5254	260	0	5581
20168	4348	3	198	82	0	4631
20169	250	3	49	4504	0	4806
20170	98	11	4326	220	0	4655
20171	50	8	4436	78	0	4572
20172	31	7	243	4459	0	4740
20173	37	11	4394	241	0	4683
20174	42	8	219	4014	0	4283
20175	43	11	69	4231	0	4354
20176	38	14	3857	277	0	4186
20177	29	14	209	3751	0	4003
20178	28	3816	78	214	0	4136
20179	24	4135	45	77	0	4281
20180	3987	244	34	47	0	4312
20181	4100	70	25	55	0	4250
20182	249	3939	22	54	0	4264
20183	4090	198	26	38	0	4352
20184	4185	65	17	39	0	4306
20185	278	34	10	4003	0	4325
20186	90	38	13	4242	0	4383
20187	4003	23	14	270	0	4310
20188	255	3908	15	88	0	4266
20189	105	4095	13	49	0	4262
20190	80	251	15	4056	0	4402
20191	69	82	3891	235	0	4277
20192	3970	26	197	95	0	4288
20193	4195	25	53	62	0	4335
20194	4125	25	24	41	0	4215
20195	290	3987	26	26	0	4329
20196	101	232	19	3891	0	4243
20197	73	68	21	4253	0	4415
20198	4051	38	29	275	0	4393
20199	271	4013	24	96	0	4404
20200	150	209	15	4039	0	4413
20201	104	77	14	4226	0	4421
20202	87	50	21	4338	0	4496
20203	4064	41	30	319	0	4454
20204	279	4002	16	147	0	4444
20205	126	249	26	3910	0	4311
20206	98	4072	26	227	0	4423
20207	3477	217	23	104	0	3821
20208	250	68	3329	85	0	3732
20209	3332	38	199	88	0	3657
20210	243	40	3007	75	0	3365
20211	115	31	183	3119	0	3448
20212	3151	52	59	243	0	3505
20213	263	40	3026	97	0	3426
20214	2622	20	719	65	0	3426
20215	3261	7	99	89	0	3456
20216	3302	10	61	75	0	3448
20217	298	14	38	3068	0	3418
20218	122	11	32	3253	0	3418
20219	94	5	27	3362	0	3488
20220	3107	10	30	294	0	3441
20221	248	3019	46	110	0	3423
20222	3206	177	41	54	0	3478
20223	3359	53	22	52	0	3486
20224	295	26	2994	60	0	3375
20225	3148	14	201	58	0	3421
20226	3316	9	61	67	0	3453
20227	286	25	38	3078	0	3427
20228	120	24	52	3223	0	3419
20229	79	23	41	3353	0	3496
20230	3115	15	36	295	0	3461
20231	3193	13	65	99	0	3370
20232	3186	12	44	69	0	3311
20233	272	2930	43	75	0	3320
20234	86	2828	55	72	0	3041
20235	37	2952	46	99	0	3134
20236	2801	243	40	92	0	3176
20237	234	81	2734	69	0	3118
20238	77	24	1875	46	0	2022
20239	473	0	0	2	0	475
20240	0	1	508	0	0	509
20241	0	0	0	493	0	493
20242	0	480	1	1	0	482
20243	523	0	0	0	0	523
20244	497	0	0	0	0	497
20245	509	0	0	0	0	509
20246	0	2	1	801	0	804
20247	0	0	817	0	0	817
20248	0	1	762	1	0	764
20249	795	0	0	0	0	795
20250	823	0	0	0	0	823
20251	781	0	0	0	0	781
20252	0	0	1	804	0	805
20253	0	0	0	817	0	817
20254	0	1	805	0	0	806
20255	751	2	0	0	0	753
20256	0	0	0	831	0	831
20257	0	0	0	816	0	816
20258	0	0	0	838	0	838
20259	0	786	4	0	0	790
20260	0	0	0	838	0	838
20261	0	0	0	343	0	343
20262	344	0	0	0	0	344
20263	1	0	325	0	0	326
20264	316	0	0	0	0	316
20265	341	0	0	0	0	341
20266	0	0	0	341	0	341
20267	0	0	0	343	0	343
20268	346	0	0	0	0	346
20269	0	0	332	0	0	332
20270	0	326	1	0	0	327
20271	0	0	0	345	0	345
20272	341	0	0	0	0	341
20273	0	0	0	342	0	342
20274	1	0	342	0	0	343
20275	0	0	325	0	0	325
20276	318	0	0	0	0	318
20277	0	1	0	346	0	347
20278	0	0	346	0	0	346
20279	331	0	0	0	0	331
20280	347	0	0	0	0	347
20281	0	0	0	345	0	345
20282	0	0	0	342	0	342
20283	0	332	0	0	0	332
20284	349	0	0	0	0	349
20285	0	0	0	345	0	345
20286	0	0	0	350	0	350
20287	0	0	344	0	0	344
20288	318	0	0	0	0	318
20289	339	0	0	0	0	339
20290	0	313	1	1	0	315
20291	0	0	333	0	0	333
20292	0	0	335	0	0	335
20293	0	0	0	332	0	332
20294	340	0	0	0	0	340
20295	0	0	0	342	0	342
20296	434	0	0	1	0	435
20297	426	0	0	1	0	427
20298	418	0	0	1	0	419
20299	0	0	0	420	0	420
20300	0	0	0	423	0	423
20301	429	0	0	0	0	429
20302	0	0	430	0	0	430
20303	404	0	0	0	0	404
20304	403	1	0	0	0	404
20305	1	0	422	0	0	423
20306	0	0	411	0	0	411
20307	0	389	1	1	0	391
20308	0	0	0	430	0	430
20309	349	2	1	2	0	354
20310	0	0	0	418	0	418
20311	0	0	424	0	0	424
20312	0	391	1	1	0	393
20313	0	700	0	0	0	700
20314	0	0	0	1096	0	1096
20315	0	0	0	1076	0	1076
20316	0	1032	0	0	0	1032
20317	0	0	1053	4	0	1057
20318	993	0	0	0	0	993
20319	1321	0	0	0	0	1321
20320	4	1028	1	240	0	1273
20321	1337	0	0	4	0	1341
20322	3	1	0	1335	0	1339
20323	1338	0	0	4	0	1342
20324	4	0	0	1313	0	1317
20325	2	1688	1	4	0	1695
20326	2	4	1738	2	0	1746
20327	1	3	4	1695	0	1703
20328	0	1	2	1734	0	1737
20329	0	0	0	1798	0	1798
20330	1788	1	0	8	0	1797
20331	5	0	0	1788	0	1793
20332	3	5	2868	3	0	2879
20333	3	11	2658	3	0	2675
20334	2862	1	9	5	0	2877
20335	8	3	2911	2	0	2924
20336	2896	0	6	3	0	2905
20337	11	1	2	3750	0	3764
20338	6	1	3	3762	0	3772
20339	5	2	3	3825	0	3835
20340	6	2	0	3836	0	3844
20341	3755	0	5	64	0	3824
20342	43	8	3745	35	0	3831
20343	18	4	35	3742	0	3799
20344	9	3735	18	58	0	3820
20345	3853	37	10	21	0	3921
20346	44	12	4	3587	0	3647
20347	3606	12	5	54	0	3677
20348	54	4	3502	25	0	3585
20349	24	6	45	3366	0	3441
20350	19	3404	22	51	0	3496
20351	3596	35	14	21	0	3666
20352	59	13	3521	17	0	3610
20353	21	12	46	3441	0	3520
20354	14	9	24	3601	0	3648
20355	3602	4	15	66	0	3687
20356	53	6	3502	36	0	3597
20357	26	4	3792	24	0	3846
20358	14	1	62	3681	0	3758
20359	11	5	3831	58	0	3905
20360	11	14	3723	28	0	3776
20361	8	3	69	3635	0	3715
20362	9	8	38	3691	0	3746
20363	13	5	26	3922	0	3966
20364	3903	0	21	75	0	3999
20365	60	4192	18	48	0	4318
20366	4251	63	13	26	0	4353
20367	81	16	9	4159	0	4265
20368	24	4127	9	85	0	4245
20369	19	67	12	4340	0	4438
20370	4264	17	12	86	0	4379
20371	69	4140	19	45	0	4273
20372	28	71	10	4335	0	4444
20373	27	32	4173	95	0	4327
20374	4050	17	68	41	0	4176
20375	76	7	24	4228	0	4335
20376	33	7	19	4278	0	4337
20377	27	13	4189	92	0	4321
20378	20	14	4002	44	0	4080
20379	4019	7	87	36	0	4149
20380	76	4064	33	29	0	4202
20381	34	62	20	4228	0	4344
20382	4265	20	19	92	0	4396
20383	84	15	4142	37	0	4278
20384	29	4090	80	33	0	4232
20385	29	72	28	4234	0	4363
20386	4200	24	28	88	0	4340
20387	4166	19	25	39	0	4249
20388	4218	7	25	36	0	4286
20389	96	4049	32	33	0	4210
20390	38	72	4016	36	0	4162
20391	31	19	68	4078	0	4196
20392	24	20	40	3872	0	3956
20393	29	16	30	4143	0	4218
20394	21	11	21	4266	0	4319
20395	4192	16	20	109	0	4337
20396	4061	14	20	51	0	4146
20397	94	15	4008	59	0	4176
20398	43	22	3873	47	0	3985
20399	3898	15	85	34	0	4032
20400	4108	14	35	27	0	4184
20401	101	13	24	3940	0	4078
20402	45	3924	24	80	0	4073
20403	4031	67	23	47	0	4168
20404	89	3903	23	37	0	4052
20405	43	4372	23	39	0	4477
20406	42	81	12	4533	0	4668
20407	29	33	24	4560	0	4646
20408	20	23	21	4516	0	4580
20409	28	15	19	4571	0	4633
20410	30	22	4337	115	0	4504
20411	4247	13	77	60	0	4397
20412	4507	15	40	44	0	4606
20413	100	13	27	4159	0	4299
20414	48	18	19	3957	0	4042
20415	3933	12	15	106	0	4066
20416	98	19	3729	52	0	3898
20417	3816	12	70	40	0	3938
20418	3935	16	31	34	0	4016
20419	86	15	3414	28	0	3543
20420	3569	12	70	17	0	3668
20421	90	7	24	3585	0	3706
20422	35	6	19	3660	0	3720
20423	28	7	7	3668	0	3710
20424	20	3	10	3696	0	3729
20425	3221	4	17	98	0	3340
20426	78	7	15	4167	0	4267
20427	32	6	15	4107	0	4160
20428	24	3885	17	105	0	4031
20429	23	4053	24	42	0	4142
20430	23	79	12	4198	0	4312
20431	4161	24	5	91	0	4281
20432	63	21	4	3042	0	3130
20433	26	12	2959	87	0	3084
20434	29	17	2819	34	0	2899
20435	2843	8	74	24	0	2949
20436	74	2917	38	23	0	3052
20437	2249	23	6	5	0	2283
20438	33	6	2198	10	0	2247
20439	4	1	22	2202	0	2229
20440	2280	0	6	32	0	2318
20441	28	2129	6	5	0	2168
20442	2168	24	1	3	0	2196
20443	23	7	2288	6	0	2324
20444	6	4	20	2220	0	2250
20445	4	0	5	2304	0	2313
20446	2501	2	2	27	0	2532
20447	2390	3	4	8	0	2405
20448	3419	1	2	8	0	3430
20449	3373	2	4	7	0	3386
20450	3424	2	2	2	0	3430
20451	30	3154	12	7	0	3203
20452	7	21	2	3426	0	3456
20453	3457	6	1	26	0	3490
20454	27	3	2	3360	0	3392
20455	3	1	4	3373	0	3381
20456	4	2	1	3425	0	3432
20457	7	2959	2	27	0	2995
20458	3143	18	5	5	0	3171
20459	26	2	4	3121	0	3153
20460	3151	0	5	26	0	3182
20461	3130	1	3	9	0	3143
20462	29	2918	5	7	0	2959
20463	3142	21	3	8	0	3174
20464	33	6	3005	8	0	3052
20465	2591	0	1	0	0	2592
20466	0	0	0	2653	0	2653
20467	0	1	2619	1	0	2621
20468	2	2415	9	1	0	2427
20469	3	0	2615	0	0	2618
20470	0	2506	3	1	0	2510
20471	2686	0	0	0	0	2686
20472	2629	1	2	0	0	2632
20473	2623	0	0	0	0	2623
20474	0	2518	11	2	0	2531
20475	2674	0	2	1	0	2677
20476	0	10	2477	0	0	2487
20477	2	3	2433	0	0	2438
20478	0	3	2	2356	0	2361
20479	0	2	1	2587	0	2590
20480	0	2486	7	2	0	2495
20481	2631	0	1	0	0	2632
20482	0	1	0	2966	0	2967
20483	0	2759	10	1	0	2770
20484	0	3	0	3007	0	3010
20485	2997	0	0	0	0	2997
20486	2921	0	0	2	0	2923
20487	2	4	2809	0	0	2815
20488	0	1	1	2798	0	2800
20489	1	2	2854	0	0	2857
20490	0	0	0	2845	0	2845
20491	1	2	3015	0	0	3018
20492	0	0	0	3003	0	3003
20493	3	4	3043	0	0	3050
20494	1	0	2	2973	0	2976
20495	6	1	3044	0	0	3051
20496	0	0	1	2919	0	2920
20497	1	0	1	3440	0	3442
20498	0	3644	10	34	0	3688
20499	1	35	0	3969	0	4005
20500	2	6	3840	39	0	3887
20501	0	1	32	3743	0	3776
20502	0	1	4	3954	0	3959
20503	3939	0	1	42	0	3982
20504	38	0	0	3870	0	3908
20505	4	1	0	3458	0	3463
20506	4	2	3277	42	0	3325
20507	3119	2	36	8	0	3165
20508	38	1	3	3440	0	3482
20509	4	1	3	3466	0	3474
20510	1	1	2	3505	0	3509
20511	3470	0	1	48	0	3519
20512	35	4	1	3575	0	3615
20513	5	1	0	3623	0	3629
20514	3613	0	0	57	0	3670
20515	42	3477	7	12	0	3538
20516	6	41	3	3600	0	3650
20517	3	8	2	3653	0	3666
20518	2	7	3515	56	0	3580
20519	2637	5	51	28	0	2721
20520	45	1	6	3564	0	3616
20521	10	2	3496	53	0	3561
20522	3404	2	40	15	0	3461
20523	49	1	6	3541	0	3597
20524	7	6	3	3522	0	3538
20525	3	4	2	3598	0	3607
20526	3	0	5	2771	0	2779
20527	6	3	2695	57	0	2761
20528	4	1	36	2641	0	2682
20529	6	2	3	3711	0	3722
20530	4	15	4920	94	0	5033
20531	5160	2	168	36	0	5366
20532	5569	2	68	31	0	5670
20533	5651	1	56	22	0	5730
20534	322	5	27	5464	0	5818
20535	5616	3	17	203	0	5839
20536	5706	1	8	94	0	5809
20537	318	3	7	5503	0	5831
20538	5610	2	9	226	0	5847
20539	5627	2	5	107	0	5741
20540	5616	1	7	87	0	5711
20541	5705	3	8	46	0	5762
20542	369	4	7	5346	0	5726
20543	199	5103	10	213	0	5525
20544	123	5214	17	98	0	5452
20545	83	5349	17	76	0	5525
20546	5120	307	7	47	0	5481
20547	5273	146	9	34	0	5462
20548	288	107	4150	35	0	4580
20549	4359	52	186	34	0	4631
20550	313	30	79	4326	0	4748
20551	159	13	55	4476	0	4703
20552	118	9	33	4600	0	4760
20553	4340	10	22	349	0	4721
20554	242	10	11	4403	0	4666
20555	136	4208	10	304	0	4658
20556	106	182	6	4472	0	4766
20557	68	96	4153	304	0	4621
20558	61	76	179	4405	0	4721
20559	4329	51	84	290	0	4754
20560	238	49	4096	142	0	4525
20561	137	17	199	4251	0	4604
20562	111	15	106	4411	0	4643
20563	85	19	70	4359	0	4533
20564	66	4176	46	344	0	4632
20565	54	195	20	4489	0	4758
20566	4310	78	17	335	0	4740
20567	4501	70	17	173	0	4761
20568	314	40	4195	126	0	4675
20569	196	39	4297	83	0	4615
20570	138	23	259	4262	0	4682
20571	93	14	145	4498	0	4750
20572	59	29	4196	316	0	4600
20573	61	28	223	3981	0	4293
20574	48	4158	115	285	0	4606
20575	4291	194	80	152	0	4717
20576	4442	87	48	130	0	4707
20577	4525	64	42	86	0	4717
20578	365	49	4172	75	0	4661
20579	202	34	197	5065	0	5498
20580	152	28	4871	259	0	5310
20581	4886	17	227	142	0	5272
20582	250	4503	126	131	0	5010
20583	127	190	96	4752	0	5165
20584	4725	89	66	252	0	5132
20585	261	70	41	4751	0	5123
20586	148	46	33	4977	0	5204
20587	122	38	4514	356	0	5030
20588	4472	27	213	209	0	4921
20589	268	4530	112	154	0	5064
20590	156	190	84	4804	0	5234
20591	4625	91	47	276	0	5039
20592	297	72	43	4658	0	5070
20593	4611	56	35	312	0	5014
20594	307	4450	30	187	0	4974
20595	4720	205	19	146	0	5090
20596	371	111	4407	94	0	4983
20597	4190	83	171	76	0	4520
20598	3955	53	107	56	0	4171
20599	3993	32	88	61	0	4174
20600	377	26	52	3724	0	4179
20601	248	31	50	3823	0	4152
20602	180	30	34	3822	0	4066
20603	125	3651	19	320	0	4115
20604	3776	180	14	213	0	4183
20605	231	98	23	3789	0	4141
20606	159	73	28	3890	0	4150
20607	149	44	29	4025	0	4247
20608	3808	49	32	330	0	4219
20609	257	29	23	3905	0	4214
20610	157	23	3532	322	0	4034
20611	117	3612	162	225	0	4116
20612	101	179	82	4402	0	4764
20613	88	105	67	4527	0	4787
20614	65	94	44	4695	0	4898
20615	62	64	4138	397	0	4661
20616	69	32	4296	255	0	4652
20617	56	30	274	4446	0	4806
20618	63	36	4305	302	0	4706
20619	65	25	253	4503	0	4846
20620	4333	10	140	359	0	4842
20621	4467	18	97	218	0	4800
20622	4631	22	58	181	0	4892
20623	366	42	4193	125	0	4726
20624	4428	41	199	95	0	4763
20625	328	24	121	4363	0	4836
20626	195	29	4133	244	0	4601
20627	153	37	4163	160	0	4513
20628	106	4045	291	153	0	4595
20629	67	3393	152	100	0	3712
20630	1685	37	180	19	0	1921
20631	32	8	13	1695	0	1748
20632	5	9	1499	33	0	1546
20633	8	1	33	1519	0	1561
20634	1532	0	5	46	0	1583
20635	33	6	2093	17	0	2149
20636	2118	0	31	15	0	2164
20637	2974	2	10	7	0	2993
20638	2988	1	12	10	0	3011
20639	108	2876	15	10	0	3009
20640	3031	67	14	6	0	3118
20641	113	25	9	2968	0	3115
20642	46	33	11	3010	0	3100
20643	44	7	11	3026	0	3088
20644	18	10	8	3121	0	3157
20645	2964	7	9	141	0	3121
20646	82	2779	10	77	0	2948
20647	34	2761	18	59	0	2872
20648	41	2930	18	26	0	3015
20649	2976	130	8	30	0	3144
20650	3060	63	10	20	0	3153
20651	3028	49	18	23	0	3118
20652	3068	14	13	20	0	3115
20653	141	16	10	2964	0	3131
20654	85	9	20	3035	0	3149
20655	2971	7	12	121	0	3111
20656	102	2882	21	74	0	3079
20657	3037	78	16	58	0	3189
20658	3046	34	7	34	0	3121
20659	124	35	12	2918	0	3089
20660	94	2871	10	86	0	3061
20661	67	88	5	3047	0	3207
20662	3016	35	12	129	0	3192
20663	103	46	2813	62	0	3024
20664	48	21	83	2797	0	2949
20665	54	2850	47	94	0	3045
20666	2911	83	43	56	0	3093
20667	3142	42	16	54	0	3254
20668	124	50	3072	31	0	3277
20669	86	2928	80	45	0	3139
20670	83	89	3065	18	0	3255
20671	48	34	117	3024	0	3223
20672	46	49	3116	95	0	3306
20673	51	19	3053	40	0	3163
20674	46	3370	112	63	0	3591
20675	3534	89	69	35	0	3727
20676	3882	38	47	31	0	3998
20677	124	3776	28	39	0	3967
20678	81	3897	24	32	0	4034
20679	79	130	3233	32	0	3474
20680	51	79	3215	44	0	3389
20681	36	60	3281	45	0	3422
20682	36	31	147	3278	0	3492
20683	43	24	3319	122	0	3508
20684	40	30	129	3233	0	3432
20685	51	24	58	3314	0	3447
20686	46	34	3234	127	0	3441
20687	56	3181	96	88	0	3421
20688	53	101	46	3341	0	3541
20689	3304	49	48	116	0	3517
20690	122	55	30	3335	0	3542
20691	83	27	3186	138	0	3434
20692	76	3121	91	78	0	3366
20693	41	3291	53	83	0	3468
20694	56	120	46	3360	0	3582
20695	3341	81	24	115	0	3561
20696	3763	75	35	53	0	3926
20697	147	50	19	3598	0	3814
20698	106	3565	22	105	0	3798
20699	90	107	22	3700	0	3919
20700	74	57	15	3759	0	3905
20701	61	65	26	3793	0	3945
20702	3682	43	32	167	0	3924
20703	120	3532	33	111	0	3796
20704	3738	97	28	94	0	3957
20705	3784	66	25	56	0	3931
20706	3775	64	25	68	0	3932
20707	3849	32	23	59	0	3963
20708	181	42	33	3650	0	3906
20709	102	52	3506	115	0	3775
20710	81	3445	104	86	0	3716
20711	3719	105	52	86	0	3962
20712	2879	38	33	32	0	2982
20713	2909	47	16	28	0	3000
20714	132	25	2775	21	0	2953
20715	2825	21	57	21	0	2924
20716	2933	18	36	23	0	3010
20717	115	20	32	2843	0	3010
20718	78	25	2744	78	0	2925
20719	67	2650	73	41	0	2831
20720	49	59	38	2882	0	3028
20721	2868	43	36	75	0	3022
20722	67	49	18	2844	0	2978
20723	49	22	20	2899	0	2990
20724	2892	22	25	102	0	3041
20725	79	17	2751	75	0	2922
20726	2819	18	63	54	0	2954
20727	3739	21	41	40	0	3841
20728	3746	18	38	29	0	3831
20729	3756	16	16	27	0	3815
20730	123	22	3587	19	0	3751
20731	83	26	65	3568	0	3742
20732	62	22	3625	64	0	3773
20733	28	16	94	3858	0	3996
20734	37	23	3866	88	0	4014
20735	3043	20	108	51	0	3222
20736	73	3168	62	57	0	3360
20737	3	2362	8	2	0	2375
20738	1	10	1	2523	0	2535
20739	7	7	0	3062	0	3076
20740	1	3032	16	25	0	3074
20741	3201	28	2	8	0	3239
20742	3783	6	4	7	0	3800
20743	3790	8	1	4	0	3803
20744	4346	4	4	2	0	4356
20745	101	7	0	4308	0	4416
20746	34	1	1	4438	0	4474
20747	4388	1	6	111	0	4506
20748	97	1	2	4415	0	4515
20749	37	11	4171	113	0	4332
20750	34	16	4160	26	0	4236
20751	3	2	103	4403	0	4511
20752	15	14	4274	104	0	4407
20753	4249	6	103	36	0	4394
20754	93	1	25	4390	0	4509
20755	4408	0	33	96	0	4537
20756	120	10	4211	34	0	4375
20757	29	3	90	4323	0	4445
20758	34	7	4186	109	0	4336
20759	15	4111	107	44	0	4277
20760	4344	85	31	32	0	4492
20761	4429	19	21	7	0	4476
20762	118	4235	19	17	0	4389
20763	4412	85	8	21	0	4526
20764	126	23	16	4299	0	4464
20765	31	26	10	4439	0	4506
20766	4355	4	12	122	0	4493
20767	101	3968	18	53	0	4140
20768	37	4089	14	38	0	4178
20769	46	108	14	4524	0	4692
20770	4483	49	7	110	0	4649
20771	4556	29	8	41	0	4634
20772	4569	8	13	38	0	4628
20773	148	21	4354	23	0	4546
20774	68	21	3796	18	0	3903
20775	46	3872	106	19	0	4043
20776	3737	102	43	15	0	3897
20777	120	29	23	4085	0	4257
20778	4145	24	15	134	0	4318
20779	4222	19	18	48	0	4307
20780	189	10	18	4104	0	4321
20781	80	23	3995	130	0	4228
20782	4055	15	120	58	0	4248
20783	144	11	40	4127	0	4322
20784	75	18	3974	144	0	4211
20785	4038	13	116	72	0	4239
20786	4219	7	49	49	0	4324
20787	180	6	28	4127	0	4341
20788	93	20	3936	147	0	4196
20789	66	7	133	3908	0	4114
20790	39	3929	58	166	0	4192
20791	54	123	3880	67	0	4124
20792	56	3943	139	47	0	4185
20793	4124	137	54	48	0	4363
20794	4197	36	52	27	0	4312
20795	4201	35	30	39	0	4305
20796	3936	20	25	50	0	4031
20797	206	11	26	3772	0	4015
20798	3863	36	17	141	0	4057
20799	190	13	23	3826	0	4052
20800	3745	19	31	175	0	3970
20801	177	3647	37	65	0	3926
20802	107	120	20	3659	0	3906
20803	84	3641	38	139	0	3902
20804	3783	146	28	60	0	4017
20805	3812	44	17	76	0	3949
20806	210	3604	24	51	0	3889
20807	99	130	28	3797	0	4054
20808	89	55	3570	176	0	3890
20809	64	52	124	3741	0	3981
20810	64	40	3594	174	0	3872
20811	70	30	141	3458	0	3699
20812	64	3607	63	137	0	3871
20813	3798	137	42	72	0	4049
20814	3846	59	26	57	0	3988
20815	209	39	27	3753	0	4028
20816	3833	19	37	165	0	4054
20817	192	18	40	3751	0	4001
20818	99	34	30	3869	0	4032
20819	76	31	23	3929	0	4059
20820	3783	33	24	216	0	4056
20821	3856	22	13	94	0	3985
20822	3863	18	16	73	0	3970
20823	205	3626	24	67	0	3922
20824	3812	120	35	47	0	4014
20825	178	3675	34	68	0	3955
20826	3814	156	25	55	0	4050
20827	210	40	44	2949	0	3243
20828	104	51	20	3114	0	3289
20829	3058	38	22	163	0	3281
20830	3069	18	29	89	0	3205
20831	194	2926	19	74	0	3213
20832	3062	125	22	46	0	3255
20833	194	51	12	2669	0	2926
20834	103	44	15	2771	0	2933
20835	2722	23	22	186	0	2953
20836	185	21	2453	104	0	2763
20837	118	2577	99	59	0	2853
20838	98	111	40	2655	0	2904
20839	49	50	1864	106	0	2069
20840	54	26	77	1986	0	2143
20841	1807	11	213	139	0	2170
20842	72	1307	15	51	0	1445
20843	43	1362	12	43	0	1460
20844	7	792	9	5	0	813
20845	6	33	1	786	0	826
20846	769	15	9	25	0	818
20847	25	6	4	771	0	806
20848	792	5	1	29	0	827
20849	806	1	4	17	0	828
20850	40	5	2	756	0	803
20851	794	4	2	32	0	832
20852	28	6	4	776	0	814
20853	18	5	740	30	0	793
20854	766	3	15	22	0	806
20855	29	3	1463	11	0	1506
20856	1491	1	31	10	0	1533
20857	35	3	1464	7	0	1509
20858	27	5	25	1464	0	1521
20859	6	6	13	1524	0	1549
20860	1498	4	4	42	0	1548
20861	32	9	4	1526	0	1571
20862	1494	1	7	31	0	1533
20863	40	1480	8	25	0	1553
20864	1498	27	6	13	0	1544
20865	40	17	9	1497	0	1563
20866	28	6	4	1516	0	1554
20867	20	8	2	1526	0	1556
20868	18	4	11	1570	0	1603
20869	19	4	1152	65	0	1240
20870	12	11	1158	32	0	1213
20871	25	8	40	1211	0	1284
20872	19	7	1574	48	0	1648
20873	18	1609	34	32	0	1693
20874	10	35	20	1672	0	1737
20875	21	19	1621	50	0	1711
20876	14	11	1635	44	0	1704
20877	9	1	21	1232	0	1263
20878	7	2	14	1204	0	1227
20879	5	1198	7	34	0	1244
20880	8	9	14	1273	0	1304
20881	8	12	1536	28	0	1584
20882	1553	5	39	25	0	1622
20883	30	4	25	1603	0	1662
20884	1587	10	12	57	0	1666
20885	1602	1	13	33	0	1649
20886	1623	8	21	18	0	1670
20887	37	9	1569	33	0	1648
20888	16	9	1576	23	0	1624
20889	1509	8	49	16	0	1582
20890	38	10	1569	30	0	1647
20891	17	4	39	1543	0	1603
20892	16	12	24	1603	0	1655
20893	28	4	1485	57	0	1574
20894	13	1553	44	36	0	1646
20895	1559	30	27	21	0	1637
20896	47	1944	17	28	0	2036
20897	30	2030	18	22	0	2100
20898	2048	41	26	18	0	2133
20899	42	15	2004	28	0	2089
20900	23	9	1996	20	0	2048
20901	16	7	60	2028	0	2111
20902	2025	12	21	49	0	2107
20903	42	1996	20	37	0	2095
20904	2052	42	26	20	0	2140
20905	51	28	1968	18	0	2065
20906	28	1992	55	19	0	2094
20907	13	45	29	2028	0	2115
20908	18	27	1995	48	0	2088
20909	22	13	43	2023	0	2101
20910	16	18	28	2008	0	2070
20911	31	11	20	2050	0	2112
20912	16	10	23	2107	0	2156
20913	2048	20	21	47	0	2136
20914	2047	19	11	31	0	2108
20915	69	12	2001	17	0	2099
20916	1979	16	55	18	0	2068
20917	50	1988	23	32	0	2093
20918	2056	32	30	31	0	2149
20919	42	28	2018	21	0	2109
20920	29	9	43	2063	0	2144
20921	34	10	2016	59	0	2119
20922	24	18	2000	43	0	2085
20923	32	18	53	1993	0	2096
20924	36	15	28	2050	0	2129
20925	34	19	1969	59	0	2081
20926	32	1958	57	48	0	2095
20927	25	2002	30	46	0	2103
20928	25	50	27	2067	0	2169
20929	1950	22	26	68	0	2066
20930	50	2166	26	47	0	2289
20931	32	48	2160	39	0	2279
20932	25	20	2137	33	0	2215
20933	28	24	2195	34	0	2281
20934	21	23	61	2179	0	2284
20935	2192	17	38	71	0	2318
20936	41	2153	36	61	0	2291
20937	30	54	2172	33	0	2289
20938	19	2147	78	35	0	2279
20939	25	40	35	2401	0	2501
20940	26	30	2359	60	0	2475
20941	21	2307	64	46	0	2438
20942	26	45	43	2371	0	2485
20943	30	34	37	2444	0	2545
20944	21	18	2362	65	0	2466
20945	28	20	61	2224	0	2333
20946	35	2319	37	63	0	2454
20947	30	59	2324	41	0	2454
20948	2331	29	76	36	0	2472
20949	47	30	51	2347	0	2475
20950	34	20	41	2304	0	2399
20951	20	2321	52	67	0	2460
20952	2406	51	38	46	0	2541
20953	50	35	2299	53	0	2437
20954	2356	30	67	35	0	2488
20955	30	10	8	1596	0	1644
20956	8	1942	18	30	0	1998
20957	16	58	6	2006	0	2086
20958	10	19	5	2058	0	2092
20959	2014	9	16	62	0	2101
20960	2006	11	12	18	0	2047
20961	61	8	8	2027	0	2104
20962	16	7	1948	68	0	2039
20963	1874	14	52	15	0	1955
20964	54	1944	17	25	0	2040
20965	14	55	16	2012	0	2097
20966	17	6	10	2068	0	2101
20967	10	8	6	2079	0	2103
20968	9	14	1955	71	0	2049
20969	10	5	50	1970	0	2035
20970	9	1941	21	66	0	2037
20971	14	55	8	1947	0	2024
20972	14	1546	8	63	0	1631
20973	11	61	8	1587	0	1667
20974	6	10	1531	67	0	1614
20975	1508	11	51	18	0	1588
20976	57	8	14	1583	0	1662
20977	10	11	1536	66	0	1623
20978	11	1500	47	24	0	1582
20979	1575	57	15	19	0	1666
20980	53	14	1537	17	0	1621
20981	1182	8	27	3	0	1220
20982	36	1	3	1219	0	1259
20983	4	1	7	1189	0	1201
20984	8	1191	6	24	0	1229
20985	1222	27	1	12	0	1262
20986	1219	3	5	6	0	1233
20987	33	1176	4	1	0	1214
20988	13	26	0	1213	0	1252
20989	5	3	4	1249	0	1261
20990	2	4	1	1249	0	1256
20991	3	3	1166	40	0	1212
20992	1140	2	27	10	0	1179
20993	26	3	2	1216	0	1247
20994	4	3	4	1245	0	1256
20995	7	2	1195	38	0	1242
20996	0	4	816	11	0	831
20997	3	0	33	809	0	845
20998	7	2	781	32	0	822
20999	783	1	29	8	0	821
21000	29	1	6	804	0	840
21001	6	1	6	823	0	836
21002	6	5	779	34	0	824
21003	3	0	31	813	0	847
21004	2	4	766	38	0	810
21005	3	777	32	7	0	819
21006	776	31	3	10	0	820
21007	810	4	8	5	0	827
21008	32	786	4	3	0	825
21009	9	28	2	806	0	845
21010	8	4	776	35	0	823
21011	2	6	27	801	0	836
21012	788	3	3	40	0	834
21013	32	782	9	9	0	832
21014	809	32	2	7	0	850
21015	37	6	2	796	0	841
21016	794	6	2	35	0	837
21017	34	781	5	11	0	831
21018	802	29	2	12	0	845
21019	37	5	764	2	0	808
21020	5	773	28	7	0	813
21021	9	26	3	802	0	840
21022	798	5	7	35	0	845
21023	829	6	3	5	0	843
21024	36	2	2	803	0	843
21025	811	2	4	33	0	850
21026	823	3	7	5	0	838
21027	827	2	1	11	0	841
21028	38	1	4	794	0	837
21029	11	3	771	30	0	815
21030	13	1	616	7	0	637
21031	5	3	602	12	0	622
21032	616	2	32	3	0	653
21033	32	3	9	602	0	646
21034	8	601	6	33	0	648
21035	11	32	2	573	0	618
21036	6	608	5	31	0	650
21037	615	34	3	7	0	659
21038	32	3	7	615	0	657
21039	5	6	0	460	0	471
21040	433	1	1	34	0	469
21041	29	2	3	433	0	467
21042	6	1	3	462	0	472
21043	434	1	2	32	0	469
21044	31	4	800	10	0	845
21045	5	2	20	833	0	860
21046	9	2	824	29	0	864
21047	839	0	25	5	0	869
21048	29	3	2	864	0	898
21049	860	0	5	31	0	896
21050	37	0	0	854	0	891
21051	5	4	828	36	0	873
21052	7	1	25	853	0	886
21053	847	0	5	35	0	887
21054	27	818	8	8	0	861
21055	5	30	849	6	0	890
21056	408	0	0	0	0	408
21057	0	418	0	0	0	418
21058	0	415	1	0	0	416
21059	0	410	0	0	0	410
21060	0	0	0	436	0	436
21061	435	0	0	0	0	435
21062	420	0	0	0	0	420
21063	0	0	425	0	0	425
21064	415	0	0	1	0	416
21065	0	410	1	0	0	411
21066	0	0	1	436	0	437
21067	435	0	0	0	0	435
21068	432	0	1	0	0	433
21069	431	0	0	0	0	431
21070	431	0	0	0	0	431
21071	432	0	0	0	0	432
21072	0	0	0	437	0	437
21073	0	1	428	0	0	429
21074	0	0	0	424	0	424
21075	0	0	0	434	0	434
21076	437	0	0	0	0	437
21077	0	412	3	0	0	415
21078	431	0	0	0	0	431
21079	423	0	0	0	0	423
21080	413	0	0	0	0	413
21081	427	0	0	0	0	427
21082	1	2	945	0	0	948
21083	935	0	1	0	0	936
21084	967	0	0	0	0	967
21085	968	0	0	0	0	968
21086	968	1	0	0	0	969
21087	0	0	0	973	0	973
21088	1	2	957	0	0	960
21089	921	0	0	0	0	921
21090	0	950	0	0	0	950
21091	0	0	0	982	0	982
21092	0	932	2	0	0	934
21093	0	0	0	983	0	983
21094	982	0	0	0	0	982
21095	956	0	0	1	0	957
21096	964	0	0	0	0	964
21097	0	0	929	0	0	929
21098	915	0	0	0	0	915
21099	0	2	914	0	0	916
21100	0	2	865	0	0	867
21101	0	0	899	0	0	899
21102	0	0	1	874	0	875
21103	0	1	0	928	0	929
21104	0	0	0	931	0	931
21105	0	0	0	929	0	929
21106	0	0	0	918	0	918
21107	0	0	0	947	0	947
21108	0	898	4	0	0	902
21109	945	0	0	0	0	945
21110	0	896	3	1	0	900
21111	1	0	0	943	0	944
21112	0	0	1	944	0	945
21113	956	0	0	0	0	956
21114	0	893	3	2	0	898
21115	948	0	0	1	0	949
21116	0	0	0	946	0	946
21117	1	0	0	930	0	931
21118	0	0	1	945	0	946
21119	0	0	935	0	0	935
21120	1	0	0	918	0	919
21121	1	0	906	0	0	907
21122	0	0	1235	0	0	1235
21123	2	1	1386	0	0	1389
21124	1	0	22	1361	0	1384
21125	0	1	3	1420	0	1424
21126	0	1	3	1445	0	1449
21127	1435	0	2	23	0	1460
21128	20	0	1	1430	0	1451
21129	1444	0	3	26	0	1473
21130	22	1391	4	5	0	1422
21131	1438	19	5	7	0	1469
21132	1740	1	5	6	0	1752
21133	23	1711	2	10	0	1746
21134	1764	22	0	7	0	1793
21135	1728	6	2	6	0	1742
21136	1738	4	3	4	0	1749
21137	1762	3	0	6	0	1771
21138	37	6	1693	4	0	1740
21139	19	1683	21	4	0	1727
21140	19	28	4	1751	0	1802
21141	1773	6	4	24	0	1807
21142	42	10	1703	3	0	1758
21143	20	1675	23	6	0	1724
21144	19	22	5	1313	0	1359
21145	15	1346	11	21	0	1393
21146	7	34	5	1334	0	1380
21147	13	8	5	1384	0	1410
21148	16	14	1360	28	0	1418
21149	19	12	1331	10	0	1372
21150	1282	16	31	12	0	1341
21151	36	11	1357	11	0	1415
21152	16	13	1342	9	0	1380
21153	20	4	27	1306	0	1357
21154	20	8	15	1268	0	1311
21155	4	1298	30	34	0	1366
21156	12	1346	16	19	0	1393
21157	12	29	1335	18	0	1394
21158	15	11	39	1337	0	1402
21159	9	8	1348	33	0	1398
21160	3	21	1301	22	0	1347
21161	7	1318	34	19	0	1378
21162	6	44	13	1335	0	1398
21163	1361	15	12	41	0	1429
21164	29	9	24	1373	0	1435
21165	1360	9	33	35	0	1437
21166	1361	6	30	15	0	1412
21167	1369	9	20	16	0	1414
21168	37	13	1460	16	0	1526
21169	1431	11	38	18	0	1498
21170	41	11	13	1487	0	1552
21171	1477	10	7	48	0	1542
21172	1491	18	11	14	0	1534
21173	43	1443	13	19	0	1518
21174	1495	30	18	13	0	1556
21175	42	7	1433	20	0	1502
21176	1432	9	39	15	0	1495
21177	1444	12	21	16	0	1493
21178	53	1432	16	11	0	1512
21179	1482	26	11	17	0	1536
21180	61	16	8	1400	0	1485
21181	32	10	18	1405	0	1465
21182	37	963	11	34	0	1045
21183	38	28	10	964	0	1040
21184	39	14	15	1005	0	1073
21185	31	22	971	35	0	1059
21186	33	16	978	22	0	1049
21187	974	16	31	31	0	1052
21188	1016	16	17	22	0	1071
21189	59	13	14	989	0	1075
21190	30	23	959	42	0	1054
21191	29	963	39	28	0	1059
21192	30	27	33	983	0	1073
21193	34	18	953	43	0	1048
21194	995	10	44	26	0	1075
21195	50	23	22	1192	0	1287
21196	31	1189	25	52	0	1297
21197	22	39	24	1217	0	1302
21198	19	23	12	1249	0	1303
21199	17	22	21	1266	0	1326
21200	1227	18	25	52	0	1322
21201	43	12	25	1258	0	1338
21202	1233	11	31	52	0	1327
21203	1267	16	29	19	0	1331
21204	55	18	1180	29	0	1282
21205	31	1193	36	38	0	1298
21206	30	34	20	1002	0	1086
21207	24	1211	22	47	0	1304
21208	1226	42	16	36	0	1320
21209	50	21	14	1234	0	1319
21210	30	16	1204	52	0	1302
21211	34	19	1207	25	0	1285
21212	23	17	1210	37	0	1287
21213	1178	28	43	26	0	1275
21214	38	1211	20	40	0	1309
21215	1199	33	19	30	0	1281
21216	54	1206	15	41	0	1316
21217	37	29	21	1170	0	1257
21218	35	19	17	1166	0	1237
21219	40	1193	28	41	0	1302
21220	41	44	1189	19	0	1293
21221	35	1198	45	24	0	1302
21222	791	23	14	14	0	842
21223	21	16	8	701	0	746
21224	30	15	681	21	0	747
21225	23	15	687	22	0	747
21226	17	12	22	707	0	758
21227	17	11	714	12	0	754
21228	21	10	676	17	0	724
21229	672	12	23	15	0	722
21230	22	698	14	14	0	748
21231	724	23	12	12	0	771
21232	3	2	352	3	0	360
21233	5	328	4	4	0	341
21234	2	341	3	6	0	352
21235	5	2	4	350	0	361
21236	5	3	3	587	0	598
21237	4	2	1	615	0	622
21238	4	6	589	10	0	609
21239	2	1	12	597	0	612
21240	4	4	3	611	0	622
21241	601	4	1	9	0	615
21242	10	579	3	4	0	596
21243	3	10	6	607	0	626
21244	594	2	5	11	0	612
21245	606	2	2	9	0	619
21246	11	2	3	609	0	625
21247	2	3	595	14	0	614
21248	0	2	9	613	0	624
21249	2	4	601	11	0	618
21250	1072	1	14	6	0	1093
21251	1081	2	4	5	0	1092
21252	22	4	0	1102	0	1128
21253	4	8	1045	17	0	1074
21254	4	1036	18	8	0	1066
21255	5	21	1014	6	0	1046
21256	10	8	15	885	0	918
21257	2	1077	7	16	0	1102
21258	1740	11	9	5	0	1765
21259	17	2	7	1655	0	1681
21260	6	1692	7	13	0	1718
21261	1751	14	2	4	0	1771
21262	15	2	4	1735	0	1756
21263	3	1661	6	21	0	1691
21264	9	13	4	1759	0	1785
21265	6	8	1706	20	0	1740
21266	1678	4	17	5	0	1704
21267	1739	5	3	10	0	1757
21268	15	8	1546	4	0	1573
21269	3	1520	18	6	0	1547
21270	1621	13	1	5	0	1640
21271	17	2	4	1630	0	1653
21272	6	2	0	1635	0	1643
21273	3	4	4	1628	0	1639
21274	5	4	1	1624	0	1634
21275	8	2	6	1655	0	1671
21276	1641	3	1	24	0	1669
21277	1639	3	5	6	0	1653
21278	21	2	3	1643	0	1669
21279	4	6	7	1656	0	1673
21280	8	5	1588	23	0	1624
21281	11	9	1575	6	0	1601
21282	1598	2	16	9	0	1625
21283	21	4	3	1664	0	1692
21284	4	8	1610	25	0	1647
21285	9	5	19	1637	0	1670
21286	1621	4	8	24	0	1657
21287	1644	10	7	9	0	1670
21288	22	5	5	1600	0	1632
21289	5	5	6	1658	0	1674
21290	1644	7	7	22	0	1680
21291	22	7	3	1610	0	1642
21292	11	1560	13	23	0	1607
21293	11	19	1	1645	0	1676
21294	12	11	5	1642	0	1670
21295	6	4	1351	27	0	1388
21296	10	8	1336	15	0	1369
21297	13	1362	17	13	0	1405
21298	1406	15	7	16	0	1444
21299	1348	1	7	18	0	1374
21300	1393	5	9	12	0	1419
21301	26	1325	12	12	0	1375
21302	16	1380	14	14	0	1424
21303	1373	18	4	22	0	1417
21304	27	1346	14	16	0	1403
21305	16	16	1341	22	0	1395
21306	19	1316	27	20	0	1382
21307	14	25	1345	25	0	1409
21308	1369	8	29	18	0	1424
21309	1399	16	5	22	0	1442
21310	36	1352	19	18	0	1425
21311	1412	20	11	28	0	1471
21312	1957	18	18	13	0	2006
21313	2014	12	7	18	0	2051
21314	82	9	11	1974	0	2076
21315	2022	13	13	65	0	2113
21316	74	18	1881	35	0	2008
21317	1984	8	49	27	0	2068
21318	75	14	22	1985	0	2096
21319	38	16	1915	68	0	2037
21320	31	21	1911	38	0	2001
21321	24	9	65	1957	0	2055
21322	25	10	28	2004	0	2067
21323	1983	8	25	79	0	2095
21324	60	16	15	2004	0	2095
21325	41	17	1866	81	0	2005
21326	27	16	49	1939	0	2031
21327	25	1912	32	80	0	2049
21328	1964	52	20	46	0	2082
21329	63	27	15	1972	0	2077
21330	35	26	1857	73	0	1991
21331	39	1932	54	36	0	2061
21332	1971	46	33	30	0	2080
21333	68	27	24	1954	0	2073
21334	42	29	1853	65	0	1989
21335	40	1914	56	31	0	2041
21336	1736	38	25	29	0	1828
21337	1725	21	23	21	0	1790
21338	1735	21	13	36	0	1805
21339	80	7	21	1674	0	1782
21340	43	6	13	1766	0	1828
21341	1722	8	5	68	0	1803
21342	59	1659	8	53	0	1779
21343	1736	40	14	32	0	1822
21344	64	18	13	1728	0	1823
21345	1758	14	4	58	0	1834
21346	72	6	13	1678	0	1769
21347	43	15	19	1732	0	1809
21348	35	11	17	1767	0	1830
21349	31	14	14	1795	0	1854
21350	17	1	1165	63	0	1246
21351	16	7	1155	37	0	1215
21352	1132	2	47	24	0	1205
21353	40	0	1206	11	0	1257
21354	24	3	1179	11	0	1217
21355	1122	4	47	13	0	1186
21356	1201	1	33	13	0	1248
21357	55	1	22	1959	0	2037
21358	1407	2	12	39	0	1460
21359	50	1307	7	24	0	1388
21360	1398	32	5	21	0	1456
21361	1399	19	8	14	0	1440
21362	1415	10	8	10	0	1443
21363	65	10	4	1354	0	1433
21364	38	1277	6	40	0	1361
21365	29	1356	8	23	0	1416
21366	1387	41	8	14	0	1450
21367	1395	25	12	15	0	1447
21368	54	16	9	1370	0	1449
21369	39	7	5	1370	0	1421
21370	21	1335	13	51	0	1420
21371	1389	30	9	28	0	1456
21372	44	25	1319	24	0	1412
21373	35	13	32	1326	0	1406
21374	31	3	16	1382	0	1432
21375	20	8	1334	58	0	1420
21376	12	7	34	1302	0	1355
21377	12	1256	19	56	0	1343
21378	15	35	15	1396	0	1461
21379	18	20	9	1380	0	1427
21380	16	1301	6	62	0	1385
21381	11	1360	9	42	0	1422
21382	11	47	14	1398	0	1470
21383	1386	25	3	54	0	1468
21384	41	12	9	1393	0	1455
21385	21	8	11	1565	0	1605
21386	24	1456	12	65	0	1557
21387	13	30	15	1578	0	1636
21388	17	13	17	1562	0	1609
21389	24	12	9	1575	0	1620
21390	1562	6	8	66	0	1642
21391	42	2	10	1567	0	1621
21392	31	7	7	1570	0	1615
21393	27	19	1	1581	0	1628
21394	27	6	1448	68	0	1549
21395	1421	5	25	43	0	1494
21396	45	1441	21	30	0	1537
21397	1555	35	10	20	0	1620
21398	57	18	4	1538	0	1617
21399	35	11	1471	47	0	1564
21400	1441	7	37	28	0	1513
21401	42	9	1903	26	0	1980
21402	28	9	40	1931	0	2008
21403	2055	9	23	38	0	2125
21404	2046	8	14	27	0	2095
21405	2056	6	7	28	0	2097
21406	68	3	9	2011	0	2091
21407	42	6	2	2544	0	2594
21408	23	8	7	2544	0	2582
21409	14	2358	10	72	0	2454
21410	11	2412	8	45	0	2476
21411	16	2473	10	31	0	2530
21412	0	2572	6	0	0	2578
21413	0	1	0	2725	0	2726
21414	1	0	1	2711	0	2713
21415	2770	0	0	0	0	2770
21416	2657	0	1	0	0	2658
21417	2694	0	1	0	0	2695
21418	0	0	0	2677	0	2677
21419	0	0	0	2728	0	2728
21420	2779	0	0	0	0	2779
21421	2606	0	2	0	0	2608
21422	0	3	2594	0	0	2597
21423	3	8	2327	2	0	2340
21424	1	3	2435	1	0	2440
21425	2	3	2589	1	0	2595
21426	0	0	1	2548	0	2549
21427	2707	0	0	0	0	2707
21428	0	2451	6	1	0	2458
21429	0	1	0	2666	0	2667
21430	1	0	2621	0	0	2622
21431	0	2428	7	3	0	2438
21432	0	0	0	2664	0	2664
21433	3	1	3484	0	0	3488
21434	1	2	0	3326	0	3329
21435	0	0	0	3519	0	3519
21436	3625	0	0	1	0	3626
21437	0	1	1	3599	0	3601
21438	1	4	4321	0	0	4326
21439	0	2	0	4244	0	4246
21440	0	4551	7	3	0	4561
21441	0	0	2	5781	0	5783
21442	0	3	0	5664	0	5667
21443	0	1	0	5714	0	5715
21444	5798	0	0	1	0	5799
21445	5832	0	0	4	0	5836
21446	5811	0	1	0	0	5812
21447	5741	0	4	2	0	5747
21448	4	6	5635	0	0	5645
21449	5477	0	1	0	0	5478
21450	5762	0	1	1	0	5764
21451	5	3	5622	0	0	5630
21452	2	6	5498	4	0	5510
21453	0	0	0	5635	0	5635
21454	0	5451	19	2	0	5472
21455	5881	0	0	0	0	5881
21456	5812	1	0	0	0	5813
21457	5180	0	0	0	0	5180
21458	0	1	1	5094	0	5096
21459	0	5263	9	0	0	5272
21460	6114	1	0	0	0	6115
21461	6009	1	0	3	0	6013
21462	1	2	0	5979	0	5982
21463	3	5	5892	0	0	5900
21464	5818	0	2	1	0	5821
21465	0	0	0	6050	0	6050
21466	6135	1	0	1	0	6137
21467	0	1	0	6599	0	6600
21468	4	4	6435	0	0	6443
21469	7035	0	2	0	0	7037
21470	0	0	0	7247	0	7247
21471	0	2	0	7119	0	7121
21472	0	0	0	7249	0	7249
21473	0	2	0	7228	0	7230
21474	7333	0	0	2	0	7335
21475	0	2	0	7236	0	7238
21476	1	8197	21	7	0	8226
21477	1	1	0	8813	0	8815
21478	0	8258	24	5	0	8287
21479	1	1	0	8791	0	8793
21480	1	1	1	8714	0	8717
21481	0	8291	16	2	0	8309
21482	0	0	0	8797	0	8797
21483	0	1	0	8657	0	8658
21484	8730	0	2	5	0	8737
21485	4	9	8511	1	0	8525
21486	2	1	1	8615	0	8619
21487	8762	0	0	1	0	8763
21488	8457	5	2	3	0	8467
21489	8516	2	3	3	0	8524
21490	9	11	8390	0	0	8410
21491	5	15	8031	4	0	8055
21492	3	4	2	8095	0	8104
21493	8604	0	1	4	0	8609
21494	5	6	8334	3	0	8348
21495	8010	2	1	2	0	8015
21496	2	7957	23	6	0	7988
21497	3	2	2	8574	0	8581
21498	0	3	0	8527	0	8530
21499	8833	0	3	2	0	8838
21500	12	1	1	8684	0	8698
21501	9246	1	1	17	0	9265
21502	9158	1	2	2	0	9163
21503	15	3	1	9071	0	9090
21504	2	4	4	9062	0	9072
21505	9200	1	2	14	0	9217
21506	21	7	9010	4	0	9042
21507	8219	3	13	6	0	8241
21508	21	2	8585	1	0	8609
21509	8308	0	16	4	0	8328
21510	8675	1	8	1	0	8685
21511	8600	1	2	6	0	8609
21512	7850	0	3	6	0	7859
21513	19	7396	11	7	0	7433
21514	7875	12	4	1	0	7892
21515	7850	3	2	4	0	7859
21516	17	7508	14	4	0	7543
21517	7885	11	2	5	0	7903
21518	23	9	7586	3	0	7621
21519	7381	1	15	4	0	7401
21520	23	8	7570	4	0	7605
21521	4	5	14	7386	0	7409
21522	6	5	6	7825	0	7842
21523	6	5	7773	16	0	7800
21524	8	3	15	7416	0	7442
21525	10	27	21	6532	0	6590
21526	7873	0	1	21	0	7895
21527	16	4	2	7757	0	7779
21528	8	3	2	7674	0	7687
21529	2	2	1	7839	0	7844
21530	4	7392	20	20	0	7436
21531	9	13	5	7903	0	7930
21532	7796	1	4	17	0	7818
21533	24	4	7449	6	0	7483
21534	9	1	29	7508	0	7547
21535	8	7	7470	31	0	7516
21536	6888	9	31	9	0	6937
21537	29	4	8	8071	0	8112
21538	12	21	9121	71	0	9225
21539	9	7	168	9149	0	9333
21540	10	4	91	8863	0	8968
21541	12	7770	92	248	0	8122
21542	9	169	37	8252	0	8467
21543	20	79	22	9726	0	9847
21544	13	83	9784	370	0	10250
21545	14	30	232	9838	0	10114
21546	6	11	104	10296	0	10417
21547	9867	7	87	393	0	10354
21548	9764	13	56	212	0	10045
21549	313	9610	58	170	0	10151
21550	10049	226	42	123	0	10440
21551	10017	102	52	129	0	10300
21552	386	10389	81	136	0	10992
21553	219	278	40	10698	0	11235
21554	10700	122	25	372	0	11219
21555	10604	106	21	193	0	10924
21556	10586	88	34	153	0	10861
21557	503	10150	46	119	0	10818
21558	341	283	10588	88	0	11300
21559	10465	161	296	78	0	11000
21560	10421	148	107	123	0	10799
21561	488	10423	117	114	0	11142
21562	10826	345	50	82	0	11303
21563	11074	161	36	73	0	11344
21564	601	159	40	10606	0	11406
21565	352	119	10806	368	0	11645
21566	273	79	354	11024	0	11730
21567	238	58	153	10796	0	11245
21568	214	76	111	11064	0	11465
21569	188	112	9579	581	0	10460
21570	207	62	333	10048	0	10650
21571	199	53	140	10444	0	10836
21572	152	46	141	10498	0	10837
21573	122	56	121	10520	0	10819
21574	123	45	66	10563	0	10797
21575	119	10201	78	735	0	11133
21576	111	350	70	9465	0	9996
21577	96	143	92	9848	0	10179
21578	101	122	8829	716	0	9768
21579	99	72	343	10149	0	10663
21580	88	63	162	10385	0	10698
21581	89	74	142	10468	0	10773
21582	104	72	106	10674	0	10956
21583	11087	86	88	914	0	12175
21584	474	88	87	11632	0	12281
21585	251	58	64	11988	0	12361
21586	233	118	10207	925	0	11483
21587	162	10333	425	646	0	11566
21588	126	11187	222	552	0	12087
21589	10770	561	187	472	0	11990
21590	515	11144	143	428	0	12230
21591	292	568	92	11503	0	12455
21592	11237	286	101	831	0	12455
21593	539	251	11144	583	0	12517
21594	298	179	493	11541	0	12511
21595	282	11420	247	731	0	12680
21596	211	545	199	11406	0	12361
21597	212	11688	127	800	0	12827
21598	186	651	84	12074	0	12995
21599	11735	345	71	877	0	13028
21600	635	280	11106	533	0	12554
21601	344	209	513	10556	0	11622
21602	281	10812	248	781	0	12122
21603	11041	553	209	571	0	12374
21604	616	343	10246	489	0	11694
21605	345	276	493	10871	0	11985
21606	385	231	10220	787	0	11623
21607	302	164	623	10974	0	12063
21608	241	160	10243	892	0	11536
21609	198	182	632	10697	0	11709
21610	204	191	336	11320	0	12051
21611	11343	153	304	932	0	12732
21612	11668	145	225	646	0	12684
21613	695	164	209	11503	0	12571
21614	428	11071	215	841	0	12555
21615	360	520	209	11560	0	12649
21616	227	264	191	12190	0	12872
21617	11134	229	153	1114	0	12630
21618	591	11143	163	758	0	12655
21619	11399	500	126	660	0	12685
21620	11406	306	113	552	0	12377
21621	726	10627	141	554	0	12048
21622	444	11311	111	537	0	12403
21623	11395	656	135	570	0	12756
21624	685	411	10399	597	0	12092
21625	11727	324	505	490	0	13046
21626	12010	240	283	442	0	12975
21627	897	11505	258	417	0	13077
21628	579	596	179	10460	0	11814
21629	440	11654	169	715	0	12978
21630	11706	735	182	517	0	13140
21631	12011	385	219	522	0	13137
21632	885	351	192	11758	0	13186
21633	592	245	165	11612	0	12614
21634	10758	244	143	952	0	12097
21635	686	10643	154	706	0	12189
21636	453	10694	140	603	0	11890
21637	456	10380	130	431	0	11397
21638	314	7925	65	358	0	8662
21639	287	8285	77	369	0	9018
21640	261	790	86	8080	0	9217
21641	244	379	7403	613	0	8639
21642	273	8131	323	404	0	9131
21643	6755	379	127	254	0	7515
21644	327	275	126	6217	0	6945
21645	6665	258	95	390	0	7408
21646	428	6692	96	273	0	7489
21647	6725	331	131	240	0	7427
21648	421	6655	168	214	0	7458
21649	252	370	142	6834	0	7598
21650	6750	238	131	409	0	7528
21651	6916	198	144	291	0	7549
21652	469	180	131	6833	0	7613
21653	306	185	112	6841	0	7444
21654	266	6600	90	517	0	7473
21655	215	371	94	6935	0	7615
21656	232	217	85	7081	0	7615
21657	254	739	92	6475	0	7560
21658	207	5562	77	521	0	6367
21659	5502	274	69	398	0	6243
21660	367	5663	67	315	0	6412
21661	5242	313	64	220	0	5839
21662	289	5225	81	217	0	5812
21663	225	299	4846	251	0	5621
21664	229	182	188	5314	0	5913
21665	215	212	4575	293	0	5295
21666	225	197	4725	194	0	5341
21667	232	165	231	4903	0	5531
21668	270	162	4608	281	0	5321
21669	273	182	224	4821	0	5500
21670	250	190	132	4946	0	5518
21671	232	151	125	5106	0	5614
21672	4875	183	111	415	0	5584
21673	335	123	91	5031	0	5580
21674	298	140	52	5151	0	5641
21675	4319	128	45	381	0	4873
21676	288	4167	29	328	0	4812
21677	245	4357	25	290	0	4917
21678	279	4669	17	203	0	5168
21679	167	905	10	3293	0	4375
21680	124	178	3584	284	0	4170
21681	3703	106	126	187	0	4122
21682	272	3938	57	127	0	4394
21683	2475	116	30	29	0	2650
21684	2559	75	16	21	0	2671
21685	2573	65	12	40	0	2690
21686	111	69	3060	49	0	3289
21687	50	50	102	3131	0	3333
21688	60	42	38	3282	0	3422
21689	63	26	51	3299	0	3439
21690	62	22	42	3220	0	3346
21691	52	3091	35	153	0	3331
21692	3247	108	35	91	0	3481
21693	70	17	2367	58	0	2512
21694	2360	5	60	57	0	2482
21695	88	12	10	2448	0	2558
21696	34	2315	14	105	0	2468
21697	26	2474	7	50	0	2557
21698	23	96	7	2428	0	2554
21699	34	2372	10	75	0	2491
21700	2437	104	11	16	0	2568
21701	79	53	2302	31	0	2465
21702	22	33	65	2404	0	2524
21703	23	25	25	2478	0	2551
21704	34	33	21	2491	0	2579
21705	41	37	8	2476	0	2562
21706	2470	29	4	95	0	2598
21707	122	2375	19	23	0	2539
21708	2493	66	19	25	0	2603
21709	98	22	21	2423	0	2564
21710	25	19	17	2452	0	2513
21711	15	1717	9	132	0	1873
21712	1752	80	9	74	0	1915
21713	1795	32	11	54	0	1892
21714	91	1728	14	40	0	1873
21715	50	94	31	1672	0	1847
21716	50	1722	29	87	0	1888
21717	1761	72	28	48	0	1909
21718	92	39	1181	35	0	1347
21719	34	43	1182	48	0	1307
21720	1079	56	62	39	0	1236
21721	81	1172	11	36	0	1300
21722	42	82	15	1206	0	1345
21723	35	35	23	1258	0	1351
21724	41	30	1188	93	0	1352
21725	21	13	80	1195	0	1309
21726	15	18	24	1287	0	1344
21727	27	1152	13	140	0	1332
21728	22	85	10	1237	0	1354
21729	39	38	11	1275	0	1363
21730	1224	35	14	90	0	1363
21731	102	1136	16	53	0	1307
21732	40	1169	11	63	0	1283
21733	40	77	17	1225	0	1359
21734	36	46	4	1253	0	1339
21735	50	41	13	1226	0	1330
21736	53	1149	20	93	0	1315
21737	40	88	4	1220	0	1352
21738	31	53	15	1242	0	1341
21739	30	38	9	1251	0	1328
21740	23	30	12	1249	0	1314
21741	38	1089	12	99	0	1238
21742	33	1171	12	40	0	1256
21743	1175	84	10	36	0	1305
21744	1220	18	12	42	0	1292
21745	66	15	7	1165	0	1253
21746	19	16	1478	76	0	1589
21747	11	11	53	1502	0	1577
21748	11	17	6	1592	0	1626
21749	1545	19	2	72	0	1638
21750	71	1675	9	20	0	1775
21751	18	64	8	1762	0	1852
21752	19	8	3	1823	0	1853
21753	10	16	1705	82	0	1813
21754	11	17	1726	28	0	1782
21755	13	10	57	1742	0	1822
21756	10	14	13	1783	0	1820
21757	14	1665	15	76	0	1770
21758	14	1768	4	28	0	1814
21759	1737	72	4	28	0	1841
21760	60	14	11	1761	0	1846
21761	6	12	1693	84	0	1795
21762	6	1640	55	36	0	1737
21763	3	69	3	1765	0	1840
21764	1694	25	2	74	0	1795
21765	64	19	7	1737	0	1827
21766	1760	9	6	80	0	1855
21767	65	1670	13	35	0	1783
21768	1719	69	11	22	0	1821
21769	59	21	6	1755	0	1841
21770	19	15	1978	81	0	2093
21771	15	12	69	1962	0	2058
21772	19	1941	10	94	0	2064
21773	15	84	8	2023	0	2130
21774	9	1973	7	99	0	2088
21775	11	85	6	2081	0	2183
21776	14	22	2000	107	0	2143
21777	0	9	1488	4	0	1501
21778	0	6	1522	4	0	1532
21779	1520	0	26	2	0	1548
21780	18	1517	11	2	0	1548
21781	2	1587	6	0	0	1595
21782	1617	22	1	2	0	1642
21783	1601	6	0	0	0	1607
21784	23	4	0	1543	0	1570
21785	6	2	1586	21	0	1615
21786	6	6	1400	2	0	1414
21787	1	3	22	1366	0	1392
21788	1463	0	6	22	0	1491
21789	19	1392	11	5	0	1427
21790	3	20	1	1462	0	1486
21791	1477	2	0	23	0	1502
21792	1450	4	0	4	0	1458
21793	23	2	1437	4	0	1466
21794	1310	1	23	2	0	1336
21795	25	0	1437	0	0	1462
21796	4	2	1406	0	0	1412
21797	5	2	22	1416	0	1445
21798	1	1	4	1449	0	1455
21799	0	2	6	1470	0	1478
21800	1	2	1419	27	0	1449
21801	1350	4	24	11	0	1389
21802	21	5	4	1468	0	1498
21803	1433	4	5	28	0	1470
21804	1398	5	4	9	0	1416
21805	23	1361	5	12	0	1401
21806	7	1403	8	3	0	1421
21807	6	1430	8	1	0	1445
21808	4	30	8	1668	0	1710
21809	6	11	1635	35	0	1687
21810	4	13	31	1636	0	1684
21811	4	2134	7	40	0	2185
21812	8	2205	5	9	0	2227
21813	8	85	4	2231	0	2328
21814	2185	37	6	71	0	2299
21815	61	2140	13	36	0	2250
21816	32	2204	9	26	0	2271
21817	2214	91	4	18	0	2327
21818	78	41	3	2231	0	2353
21819	41	29	3	2249	0	2322
21820	20	23	2	2328	0	2373
21821	2228	18	3	108	0	2357
21822	2267	13	3	62	0	2345
21823	100	10	6	2271	0	2387
21824	59	16	2132	88	0	2295
21825	2172	16	63	43	0	2294
21826	84	8	35	2244	0	2371
21827	45	12	2147	89	0	2293
21828	22	8	2163	61	0	2254
21829	22	6	95	2240	0	2363
21830	21	9	2193	94	0	2317
21831	22	8	81	2710	0	2821
21832	23	8	47	2707	0	2785
21833	14	9	24	2843	0	2890
21834	2672	8	23	164	0	2867
21835	94	7	15	2771	0	2887
21836	46	7	13	2815	0	2881
21837	30	8	21	2843	0	2902
21838	24	6	14	2864	0	2908
21839	19	23	2475	176	0	2693
21840	12	2550	85	109	0	2756
21841	10	83	38	2748	0	2879
21842	10	41	28	2700	0	2779
21843	13	2497	34	138	0	2682
21844	18	2702	19	85	0	2824
21845	2657	120	14	66	0	2857
21846	90	2315	15	55	0	2475
21847	49	117	8	2372	0	2546
21848	36	73	2202	119	0	2430
21849	2310	36	76	68	0	2490
21850	105	40	2079	57	0	2281
21851	2150	24	94	51	0	2319
21852	2231	13	55	44	0	2343
21853	157	30	2080	33	0	2300
21854	91	22	108	2041	0	2262
21855	67	2086	64	108	0	2325
21856	46	104	35	2186	0	2371
21857	2151	54	31	142	0	2378
21858	2192	29	24	89	0	2334
21859	135	2102	24	76	0	2337
21860	2203	96	24	60	0	2383
21861	151	45	15	2183	0	2394
21862	2202	28	19	132	0	2381
21863	2247	23	21	89	0	2380
21864	167	24	11	2186	0	2388
21865	2198	16	13	149	0	2376
21866	2232	16	20	93	0	2361
21867	169	17	2053	81	0	2320
21868	2186	20	101	55	0	2362
21869	148	25	2097	49	0	2319
21870	87	24	1765	46	0	1922
21871	47	1735	121	46	0	1949
21872	45	75	74	1811	0	2005
21873	47	49	1754	93	0	1943
21874	30	39	1779	68	0	1916
21875	1822	31	108	45	0	2006
21876	87	28	62	1814	0	1991
21877	60	16	51	1897	0	2024
21878	52	24	44	1905	0	2025
21879	37	26	32	1928	0	2023
21880	39	31	28	1952	0	2050
21881	42	32	1729	173	0	1976
21882	32	33	1749	120	0	1934
21883	39	21	116	1872	0	2048
21884	1802	34	63	126	0	2025
21885	97	1764	53	86	0	2000
21886	80	75	35	1354	0	1544
21887	1295	51	21	135	0	1502
21888	106	1721	18	111	0	1956
21889	82	81	27	1830	0	2020
21890	71	50	20	1888	0	2029
21891	58	24	36	1928	0	2046
21892	1844	15	41	158	0	2058
21893	104	22	1711	121	0	1958
21894	1836	19	92	86	0	2033
21895	120	16	56	1845	0	2037
21896	77	16	45	1829	0	1967
21897	66	1730	57	142	0	1995
21898	49	83	1689	99	0	1920
21899	1775	44	80	99	0	1998
21900	1856	30	50	95	0	2031
21901	133	34	1712	86	0	1965
21902	1803	16	85	69	0	1973
21903	130	1730	67	53	0	1980
21904	100	1761	43	56	0	1960
21905	56	1842	34	75	0	2007
21906	1816	119	32	73	0	2040
21907	114	87	1718	48	0	1967
21908	58	60	76	1548	0	1742
21909	65	1481	67	78	0	1691
21910	53	1602	39	74	0	1768
21911	9	1001	12	21	0	1043
21912	9	37	11	963	0	1020
21913	991	21	4	44	0	1060
21914	29	979	7	26	0	1041
21915	22	32	5	1005	0	1064
21916	21	16	6	1017	0	1060
21917	1000	14	6	40	0	1060
21918	35	9	3	1005	0	1052
21919	17	8	4	1034	0	1063
21920	16	11	964	53	0	1044
21921	20	6	27	995	0	1048
21922	19	7	15	1600	0	1641
21923	1588	7	12	42	0	1649
21924	1597	4	10	27	0	1638
21925	36	3	9	1591	0	1639
21926	1589	9	5	36	0	1639
21927	1552	11	8	17	0	1588
21928	44	1460	11	16	0	1531
21929	40	29	1501	11	0	1581
21930	24	1504	37	12	0	1577
21931	0	1	0	1077	0	1078
21932	1088	0	0	0	0	1088
21933	0	986	8	1	0	995
21934	0	1	0	1080	0	1081
21935	1091	0	0	0	0	1091
21936	1057	0	0	1	0	1058
21937	0	0	0	1063	0	1063
21938	0	2	1042	4	0	1048
21939	0	0	0	1055	0	1055
21940	0	0	0	1067	0	1067
21941	0	3	1062	0	0	1065
21942	1	0	0	1011	0	1012
21943	0	1	0	1061	0	1062
21944	1080	0	0	0	0	1080
21945	0	1	0	1066	0	1067
21946	0	0	0	1072	0	1072
21947	1075	0	1	1	0	1077
21948	1474	0	0	0	0	1474
21949	1520	0	0	2	0	1522
21950	46	2	1452	0	0	1500
21951	1	1	45	1444	0	1491
21952	0	1408	3	38	0	1449
21953	4	38	0	1509	0	1551
21954	1	2	1460	45	0	1508
21955	0	0	40	1408	0	1448
21956	0	0	1446	46	0	1492
21957	1420	0	40	2	0	1462
21958	1521	0	0	0	0	1521
21959	44	0	0	1478	0	1522
21960	2	0	1	1508	0	1511
21961	0	0	0	1510	0	1510
21962	0	1372	5	44	0	1421
21963	1487	43	0	2	0	1532
21964	1506	1	0	2	0	1509
21965	43	1	0	1485	0	1529
21966	2	0	0	1501	0	1503
21967	1	3	0	1530	0	1534
21968	2	1	0	1533	0	1536
21969	2	0	1439	45	0	1486
21970	4	3	35	1464	0	1506
21971	1486	2	3	49	0	1540
21972	1512	2	0	4	0	1518
21973	49	1	1	1478	0	1529
21974	2	4	1451	49	0	1506
21975	1407	0	43	6	0	1456
21976	46	0	2	1451	0	1499
21977	4	1371	4	38	0	1417
21978	4	1410	8	4	0	1426
21979	1448	44	1	3	0	1496
21980	48	2	0	1447	0	1497
21981	2	1	1	1497	0	1501
21982	2	2	0	1510	0	1514
21983	6	2	0	1984	0	1992
21984	4	1	2	2033	0	2040
21985	2	1	1894	89	0	1986
21986	1	7	1882	15	0	1905
21987	3	7	1919	7	0	1936
21988	3	0	80	1469	0	1552
21989	3	4	1447	78	0	1532
21990	6	0	72	1459	0	1537
21991	9	1	10	1496	0	1516
21992	5	2	5	1566	0	1578
21993	1479	2	10	99	0	1590
21994	77	2	16	1461	0	1556
21995	14	1	15	1557	0	1587
21996	1461	3	14	97	0	1575
21997	76	1401	15	25	0	1517
21998	14	1499	14	16	0	1543
21999	1467	83	4	18	0	1572
22000	74	1448	4	21	0	1547
22001	1478	73	3	22	0	1576
22002	1529	13	3	21	0	1566
22003	1546	1	1	26	0	1574
22004	1524	4	2	18	0	1548
22005	1549	7	5	9	0	1570
22006	89	1431	5	8	0	1533
22007	1498	76	5	10	0	1589
22008	1530	23	4	12	0	1569
22009	95	1423	11	11	0	1540
22010	1491	76	2	14	0	1583
22011	1560	14	13	8	0	1595
22012	1558	4	9	13	0	1584
22013	1564	2	4	11	0	1581
22014	106	16	1370	11	0	1503
22015	34	6	74	1393	0	1507
22016	22	4	16	1514	0	1556
22017	16	13	1423	104	0	1556
22018	25	10	1412	25	0	1472
22019	1439	8	86	10	0	1543
22020	100	8	16	1434	0	1558
22021	44	7	1416	85	0	1552
22022	21	8	982	26	0	1037
22023	949	7	91	20	0	1067
22024	1023	7	17	27	0	1074
22025	1041	4	15	20	0	1080
22026	101	4	940	20	0	1065
22027	33	1	82	974	0	1090
22028	20	5	928	97	0	1050
22029	970	4	91	30	0	1095
22030	90	3	940	18	0	1051
22031	28	6	87	958	0	1079
22032	28	6	14	963	0	1011
22033	33	967	7	87	0	1094
22034	999	81	10	23	0	1113
22035	93	17	946	21	0	1077
22036	1006	4	83	17	0	1110
22037	102	3	948	21	0	1074
22038	31	4	96	975	0	1106
22039	19	8	27	1051	0	1105
22040	10	12	13	1082	0	1117
22041	983	10	10	110	0	1113
22042	93	9	8	1002	0	1112
22043	31	8	16	1040	0	1095
22044	31	957	12	97	0	1097
22045	25	70	10	1008	0	1113
22046	994	13	17	95	0	1119
22047	97	7	952	35	0	1091
22048	20	2	33	568	0	623
22049	18	3	512	43	0	576
22050	13	523	35	27	0	598
22051	9	29	522	19	0	579
22052	547	21	36	14	0	618
22053	581	10	14	15	0	620
22054	57	3	5	555	0	620
22055	565	3	12	36	0	616
22056	582	3	11	25	0	621
22057	55	1	12	559	0	627
22058	22	8	10	587	0	627
22059	11	10	506	46	0	573
22060	18	537	42	15	0	612
22061	560	28	14	5	0	607
22062	46	550	6	12	0	614
22063	30	32	3	557	0	622
22064	24	9	5	588	0	626
22065	17	2	1	609	0	629
22066	14	1	3	608	0	626
22067	8	2	520	56	0	586
22068	548	9	36	24	0	617
22069	587	9	15	12	0	623
22070	51	12	9	554	0	626
22071	570	6	11	40	0	627
22072	44	3	4	577	0	628
22073	15	4	519	58	0	596
22074	8	1	37	558	0	604
22075	7	532	22	44	0	605
22076	17	26	12	543	0	598
22077	26	549	5	40	0	620
22078	18	34	4	526	0	582
22079	21	551	3	43	0	618
22080	557	31	4	26	0	618
22081	41	13	523	15	0	592
22082	19	549	42	19	0	629
22083	0	34	0	0	0	34
22084	0	1	0	36	0	37
22085	1	0	0	33	0	34
22086	0	0	1	36	0	37
22087	0	0	0	37	0	37
22088	0	35	0	2	0	37
22089	0	2	0	35	0	37
22090	1	1	0	37	0	39
22091	37	0	1	1	0	39
22092	2	0	1	35	0	38
22093	1	0	35	1	0	37
22094	0	0	34	1	0	35
22095	31	0	1	2	0	34
22096	1	33	0	2	0	36
22097	1	35	0	1	0	37
22098	2	1	0	613	0	616
22099	0	1	0	591	0	592
22100	0	2	604	2	0	608
22101	575	1	1	1	0	578
22102	604	0	0	2	0	606
22103	3	1	611	0	0	615
22104	0	1	592	1	0	594
22105	581	0	2	1	0	584
22106	616	1	1	0	0	618
22107	613	0	1	1	0	615
22108	625	0	2	1	0	628
22109	3	576	2	1	0	582
22110	625	1	0	1	0	627
22111	2	1	590	1	0	594
22112	2	1	587	0	0	590
22113	2	2	580	1	0	585
22114	0	0	1	603	0	604
22115	629	0	1	2	0	632
22116	623	1	1	0	0	625
22117	2	2	0	613	0	617
22118	1	1	0	599	0	601
22119	0	1	0	627	0	628
22120	0	1088	2	3	0	1093
22121	2090	2	0	3	0	2095
22122	2071	0	0	2	0	2073
22123	2066	1	1	2	0	2070
22124	2067	0	1	1	0	2069
22125	2079	0	0	0	0	2079
22126	2	0	0	2064	0	2066
22127	1	1952	1	3	0	1957
22128	1	1	1	2074	0	2077
22129	0	0	0	2053	0	2053
22130	2078	0	1	2	0	2081
22131	1	2	1968	1	0	1972
22132	2	2	1828	1	0	1833
22133	1	5	1828	0	0	1834
22134	1901	0	2	0	0	1903
22135	2031	0	0	1	0	2032
22136	0	0	0	2003	0	2003
22137	1	1	0	2474	0	2476
22138	0	1	0	2567	0	2568
22139	0	7	2522	54	0	2583
22140	1	0	37	2409	0	2447
22141	1	1	2533	44	0	2579
22142	1	0	42	2469	0	2512
22143	0	1	17	2513	0	2531
22144	0	0	4	2599	0	2603
22145	2561	1	2	58	0	2622
22146	2535	0	2	23	0	2560
22147	59	7	2465	6	0	2537
22148	2459	0	38	5	0	2502
22149	2567	0	19	3	0	2589
22150	56	1	5	2537	0	2599
22151	2581	0	3	41	0	2625
22152	46	0	1	2558	0	2605
22153	19	0	3	2583	0	2605
22154	8	2	2464	62	0	2536
22155	2299	0	41	26	0	2366
22156	41	0	17	2532	0	2590
22157	19	1	2490	42	0	2552
22158	7	5	2426	22	0	2460
22159	4	0	52	2440	0	2496
22160	6	1	20	2482	0	2509
22161	2522	0	6	58	0	2586
22162	43	2	3	2494	0	2542
22163	24	3	3	2509	0	2539
22164	7	1	2	2554	0	2564
22165	4	1	2	2558	0	2565
22166	2523	0	11	74	0	2608
22167	2463	2	8	46	0	2519
22168	2508	1	10	23	0	2542
22169	2549	0	17	16	0	2582
22170	63	0	5	2507	0	2575
22171	2536	1	11	58	0	2606
22172	56	2	3	2516	0	2577
22173	2543	0	3	55	0	2601
22174	53	2	10	2473	0	2538
22175	38	0	5	2487	0	2530
22176	28	2396	8	60	0	2492
22177	11	37	6	2545	0	2599
22178	2465	15	2	50	0	2532
22179	2336	7	2	37	0	2382
22180	65	4	2419	28	0	2516
22181	35	2320	50	15	0	2420
22182	2485	39	20	17	0	2561
22183	53	2402	13	20	0	2488
22184	2461	41	20	10	0	2532
22185	56	2397	16	11	0	2480
22186	25	49	2317	24	0	2415
22187	11	2273	52	24	0	2360
22188	14	2330	23	17	0	2384
22189	9	49	6	2737	0	2801
22190	2738	21	1	73	0	2833
22191	51	7	9	2683	0	2750
22192	28	6	5	2733	0	2772
22193	2740	3	4	81	0	2828
22194	2682	0	10	39	0	2731
22195	75	6	2	2665	0	2748
22196	47	4	3	2666	0	2720
22197	26	7	2	2754	0	2789
22198	2176	4	0	70	0	2250
22199	62	7	2083	39	0	2191
22200	35	2	45	2143	0	2225
22201	33	5	2119	56	0	2213
22202	11	1969	51	48	0	2079
22203	19	48	2125	23	0	2215
22204	14	22	45	2091	0	2172
22205	19	11	2125	67	0	2222
22206	1973	11	44	30	0	2058
22207	54	4	29	2131	0	2218
22208	37	2035	14	47	0	2133
22209	24	45	10	2145	0	2224
22210	13	2073	19	49	0	2154
22211	15	2103	11	30	0	2159
22212	17	2101	8	18	0	2144
22213	10	68	11	2104	0	2193
22214	15	2048	9	47	0	2119
22215	2077	58	9	29	0	2173
22216	46	31	1936	28	0	2041
22217	31	24	1845	26	0	1926
22218	18	20	1926	21	0	1985
22219	17	3	60	1923	0	2003
22220	28	5	23	1532	0	1588
22221	27	1	12	878	0	918
22222	15	8	5	900	0	928
22223	18	2	4	1230	0	1254
22224	15	1130	5	84	0	1234
22225	16	50	1109	48	0	1223
22226	13	22	1123	26	0	1184
22227	7	1100	59	34	0	1200
22228	13	43	29	1169	0	1254
22229	8	30	17	1193	0	1248
22230	9	12	15	1234	0	1270
22231	1185	7	14	70	0	1276
22232	51	11	1145	35	0	1242
22233	1176	7	55	15	0	1253
22234	1197	6	23	26	0	1252
22235	64	1074	16	15	0	1169
22236	34	1191	8	20	0	1253
22237	650	0	0	1	0	651
22238	0	0	1	648	0	649
22239	1	0	0	1087	0	1088
22240	1	1	1042	27	0	1071
22241	2	3	1510	11	0	1526
22242	0	1	35	1484	0	1520
22243	1568	1	11	33	0	1613
22244	31	5	2393	12	0	2441
22245	3043	2	84	7	0	3136
22246	81	0	18	3087	0	3186
22247	22	2	12	3126	0	3162
22248	11	0	8	3206	0	3225
22249	11	5	2971	113	0	3100
22250	4	2808	80	37	0	2929
22251	7	3270	29	20	0	3326
22252	3403	105	14	20	0	3542
22253	3933	22	10	13	0	3978
22254	116	14	13	3881	0	4024
22255	3923	4	8	113	0	4048
22256	124	15	3712	34	0	3885
22257	32	16	3759	25	0	3832
22258	22	8	118	3764	0	3912
22259	3913	4	32	116	0	4065
22260	113	8	21	4245	0	4387
22261	30	10	11	4390	0	4441
22262	4303	5	14	147	0	4469
22263	4317	6	11	40	0	4374
22264	140	4452	9	42	0	4643
22265	4609	147	4	24	0	4784
22266	174	25	13	4466	0	4678
22267	39	4446	20	158	0	4663
22268	4546	148	15	42	0	4751
22269	167	4406	25	32	0	4630
22270	37	153	21	4591	0	4802
22271	4588	31	19	173	0	4811
22272	178	26	4379	46	0	4629
22273	56	33	4462	32	0	4583
22274	39	14	148	4399	0	4600
22275	36	15	42	4589	0	4682
22276	30	13	23	4502	0	4568
22277	27	4406	24	191	0	4648
22278	4585	158	35	57	0	4835
22279	4637	40	24	47	0	4748
22280	4617	27	14	54	0	4712
22281	187	4425	15	44	0	4671
22282	65	154	14	4561	0	4794
22283	50	37	28	4697	0	4812
22284	42	34	20	4717	0	4813
22285	4506	30	19	197	0	4752
22286	177	4395	28	71	0	4671
22287	68	158	18	4581	0	4825
22288	46	36	10	4737	0	4829
22289	59	31	4008	210	0	4308
22290	37	4126	141	73	0	4377
22291	38	162	40	4264	0	4504
22292	48	39	17	4407	0	4511
22293	59	27	8	4433	0	4527
22294	4272	27	12	236	0	4547
22295	173	4170	15	89	0	4447
22296	4333	167	9	60	0	4569
22297	198	46	14	4295	0	4553
22298	4327	45	7	198	0	4577
22299	207	35	4067	62	0	4371
22300	4212	27	147	74	0	4460
22301	4407	34	32	63	0	4536
22302	224	26	4503	46	0	4799
22303	64	43	150	4602	0	4859
22304	52	27	30	4809	0	4918
22305	4716	27	29	216	0	4988
22306	181	17	43	4728	0	4969
22307	67	28	31	4792	0	4918
22308	65	21	22	4897	0	5005
22309	54	30	4495	246	0	4825
22310	4240	19	145	118	0	4522
22311	189	4516	39	69	0	4813
22312	71	162	32	4583	0	4848
22313	74	4402	32	213	0	4721
22314	57	4637	21	101	0	4816
22315	54	186	22	4720	0	4982
22316	38	63	4563	228	0	4892
22317	45	59	4561	101	0	4766
22318	50	35	151	4751	0	4987
22319	53	35	4591	210	0	4889
22320	4500	46	165	79	0	4790
22321	172	36	41	4725	0	4974
22322	58	20	39	4841	0	4958
22323	50	4223	54	222	0	4549
22324	51	175	28	4441	0	4695
22325	38	49	23	4517	0	4627
22326	43	4208	30	239	0	4520
22327	47	156	31	4422	0	4656
22328	57	39	22	4474	0	4592
22329	52	4199	35	214	0	4500
22330	4371	172	28	87	0	4658
22331	200	50	4164	99	0	4513
22332	75	53	4193	77	0	4398
22333	63	33	187	4253	0	4536
22334	61	23	42	4474	0	4600
22335	55	45	4157	226	0	4483
22336	45	38	4167	109	0	4359
22337	3871	24	171	106	0	4172
22338	171	4683	76	95	0	5025
22339	5112	160	20	60	0	5352
22340	178	43	4922	64	0	5207
22341	43	4535	161	64	0	4803
22342	19	160	45	4754	0	4978
22343	21	40	4662	204	0	4927
22344	7	23	3708	25	0	3763
22345	11	3	102	3484	0	3600
22346	12	14	3438	141	0	3605
22347	11	3452	111	47	0	3621
22348	10	117	41	3580	0	3748
22349	18	40	3441	134	0	3633
22350	11	3450	127	40	0	3628
22351	3250	98	30	28	0	3406
22352	105	42	3058	14	0	3219
22353	31	2760	101	14	0	2906
22354	19	102	33	2784	0	2938
22355	9	33	18	2973	0	3033
22356	2871	20	9	137	0	3037
22357	110	6	13	2892	0	3021
22358	24	7	16	2985	0	3032
22359	2861	10	9	147	0	3027
22360	95	4	9	2496	0	2604
22361	31	10	2416	104	0	2561
22362	13	9	92	2496	0	2610
22363	7	10	2466	112	0	2595
22364	7	9	2127	35	0	2178
22365	8	4	2147	15	0	2174
22366	2	5	91	2104	0	2202
22367	5	8	30	2236	0	2279
22368	2203	3	16	92	0	2314
22369	65	4	12	2130	0	2211
22370	27	2820	14	75	0	2936
22371	13	60	7	3056	0	3136
22372	8	23	9	3043	0	3083
22373	6	2944	21	77	0	3048
22374	2985	63	11	45	0	3104
22375	2938	26	12	26	0	3002
22376	82	2852	11	14	0	2959
22377	34	2965	11	18	0	3028
22378	18	80	8	3030	0	3136
22379	3040	32	9	71	0	3152
22380	65	20	2916	40	0	3041
22381	29	17	2829	25	0	2900
22382	2832	11	85	15	0	2943
22383	71	2902	35	17	0	3025
22384	32	65	14	2989	0	3100
22385	17	33	10	3504	0	3564
22386	11	19	7	3479	0	3516
22387	11	15	5	3495	0	3526
22388	10	3265	13	102	0	3390
22389	9	59	10	3545	0	3623
22390	4891	26	9	89	0	5015
22391	71	18	6	4850	0	4945
22392	35	9	7	4924	0	4975
22393	5248	10	7	103	0	5368
22394	5207	7	11	53	0	5278
22395	5286	5	9	33	0	5333
22396	5312	8	5	28	0	5353
22397	106	8	10	5219	0	5343
22398	5305	6	11	80	0	5402
22399	85	7	11	5263	0	5366
22400	5271	17	7	94	0	5389
22401	5273	9	12	52	0	5346
22402	101	8	8	4837	0	4954
22403	52	13	4621	83	0	4769
22404	4567	7	67	41	0	4682
22405	4860	13	29	27	0	4929
22406	4861	15	13	25	0	4914
22407	5229	14	14	21	0	5278
22408	126	10	10	5148	0	5294
22409	69	19	5051	90	0	5229
22410	42	15	4757	50	0	4864
22411	4734	18	111	34	0	4897
22412	5158	14	52	25	0	5249
22413	121	4866	32	28	0	5047
22414	64	5039	20	32	0	5155
22415	5258	98	13	27	0	5396
22416	92	48	16	5078	0	5234
22417	56	24	14	5144	0	5238
22418	5165	14	18	124	0	5321
22419	94	4892	20	66	0	5072
22420	5170	77	19	40	0	5306
22421	111	47	4833	39	0	5030
22422	4850	20	77	35	0	4982
22423	111	11	41	5031	0	5194
22424	64	14	4938	103	0	5119
22425	36	4772	89	73	0	4970
22426	33	73	45	5105	0	5256
22427	31	42	5602	104	0	5779
22428	27	22	109	5562	0	5720
22429	5694	12	51	122	0	5879
22430	119	15	5472	75	0	5681
22431	5328	11	112	48	0	5499
22432	129	5363	74	38	0	5604
22433	67	94	40	5639	0	5840
22434	57	60	6795	119	0	7031
22435	31	32	112	6676	0	6851
22436	35	25	6831	141	0	7032
22437	33	6512	143	83	0	6771
22438	6258	77	46	35	0	6416
22439	84	5477	27	22	0	5610
22440	46	100	14	5588	0	5748
22441	26	412	16	5293	0	5747
22442	21	35	5424	119	0	5599
22443	4321	32	94	83	0	4530
22444	79	5274	62	39	0	5454
22445	22	4984	17	10	0	5033
22446	14	5134	9	15	0	5172
22447	8	72	3	5147	0	5230
22448	7	5056	19	46	0	5128
22449	11	49	11	5166	0	5237
22450	9	5256	8	48	0	5321
22451	9	58	2	5351	0	5420
22452	5	5223	17	51	0	5296
22453	5344	53	7	25	0	5429
22454	40	44	5158	18	0	5260
22455	4935	26	40	16	0	5017
22456	5173	16	25	14	0	5228
22457	5337	14	11	15	0	5377
22458	65	5107	15	12	0	5199
22459	5403	42	4	9	0	5458
22460	5333	33	9	6	0	5381
22461	5282	14	7	10	0	5313
22462	83	16	5132	4	0	5235
22463	54	5	41	5049	0	5149
22464	33	13	5544	39	0	5629
22465	20	13	56	5476	0	5565
22466	5585	12	28	60	0	5685
22467	62	5299	27	42	0	5430
22468	52	63	6012	21	0	6148
22469	35	36	109	6034	0	6214
22470	16	17	37	6502	0	6572
22471	18	11	6413	200	0	6642
22472	5972	12	171	62	0	6217
22473	6577	13	44	37	0	6671
22474	6681	16	34	12	0	6743
22475	229	14	16	6411	0	6670
22476	68	6110	20	183	0	6381
22477	49	6474	24	54	0	6601
22478	32	185	17	6508	0	6742
22479	34	54	20	6468	0	6576
22480	42	6304	25	205	0	6576
22481	6487	175	12	69	0	6743
22482	188	6318	24	52	0	6582
22483	58	201	18	6475	0	6752
22484	51	71	6236	195	0	6553
22485	19	41	177	5967	0	6204
22486	6097	27	49	226	0	6399
22487	191	48	5789	56	0	6084
22488	5912	26	172	51	0	6161
22489	6231	34	45	38	0	6348
22490	5137	22	38	39	0	5236
22491	5154	20	26	37	0	5237
22492	5203	13	43	36	0	5295
22493	262	22	4426	32	0	4742
22494	96	27	4471	18	0	4612
22495	5803	30	186	22	0	6041
22496	6211	23	64	19	0	6317
22497	314	29	36	6242	0	6621
22498	132	6288	28	257	0	6705
22499	79	260	19	6506	0	6864
22500	6704	86	26	304	0	7120
22501	317	64	18	6401	0	6800
22502	116	6586	20	307	0	7029
22503	6794	289	20	120	0	7223
22504	6856	113	29	78	0	7076
22505	6795	64	17	65	0	6941
22506	408	6569	29	54	0	7060
22507	159	267	15	6256	0	6697
22508	115	88	8	6389	0	6600
22509	93	6173	21	310	0	6597
22510	83	271	10	6408	0	6772
22511	6325	88	9	323	0	6745
22512	6381	72	11	117	0	6581
22513	347	6104	28	89	0	6568
22514	146	272	23	6251	0	6692
22515	100	93	16	6516	0	6725
22516	57	73	24	6638	0	6792
22517	6348	44	22	415	0	6829
22518	326	50	6018	169	0	6563
22519	6173	42	253	128	0	6596
22520	368	46	6700	88	0	7202
22521	155	29	274	6555	0	7013
22522	144	6584	104	305	0	7137
22523	105	7033	80	132	0	7350
22524	6902	350	38	99	0	7389
22525	6873	145	36	96	0	7150
22526	379	6782	44	79	0	7284
22527	110	6390	29	89	0	6618
22528	6616	340	16	49	0	7021
22529	6701	124	22	51	0	6898
22530	361	7060	28	45	0	7494
22531	7369	331	14	43	0	7757
22532	400	128	6946	48	0	7522
22533	7200	79	280	83	0	7642
22534	6304	60	72	65	0	6501
22535	419	57	61	5998	0	6535
22536	188	5727	49	331	0	6295
22537	177	303	35	6087	0	6602
22538	6018	74	33	368	0	6493
22539	396	76	23	6243	0	6738
22540	158	54	24	6616	0	6852
22541	107	58	5966	457	0	6588
22542	106	46	288	6280	0	6720
22543	113	32	86	6599	0	6830
22544	6306	45	72	440	0	6863
22545	393	58	6409	175	0	7035
22546	6597	53	330	138	0	7118
22547	403	49	83	6651	0	7186
22548	146	59	58	6918	0	7181
22549	128	56	31	6791	0	7006
22550	130	6116	43	436	0	6725
22551	124	6505	49	152	0	6830
22552	119	388	28	6645	0	7180
22553	6613	116	26	395	0	7150
22554	6865	100	23	133	0	7121
22555	450	82	18	6660	0	7210
22556	6651	77	28	403	0	7159
22557	427	61	27	6644	0	7159
22558	170	62	26	6948	0	7206
22559	6489	45	27	444	0	7005
22560	415	6467	28	191	0	7101
22561	6345	337	17	140	0	6839
22562	6538	105	11	133	0	6787
22563	6416	61	25	135	0	6637
22564	452	6118	23	127	0	6720
22565	195	322	21	6312	0	6850
22566	140	97	36	6626	0	6899
22567	147	82	5975	445	0	6649
22568	88	52	240	5666	0	6046
22569	84	69	5127	360	0	5640
22570	69	4410	196	135	0	4810
22571	55	4326	92	101	0	4574
22572	84	4436	48	79	0	4647
22573	59	240	40	4516	0	4855
22574	51	104	23	4683	0	4861
22575	34	80	22	4702	0	4838
22576	29	75	14	4764	0	4882
22577	56	59	4304	315	0	4734
22578	42	61	5092	163	0	5358
22579	65	39	251	5238	0	5593
22580	66	27	5605	319	0	6017
22581	5674	17	259	158	0	6108
22582	5994	26	95	109	0	6224
22583	296	39	5577	116	0	6028
22584	130	25	259	5730	0	6144
22585	110	26	98	5988	0	6222
22586	88	36	75	6049	0	6248
22587	132	22	53	5992	0	6199
22588	95	28	52	6109	0	6284
22589	5326	39	61	378	0	5804
22590	5758	44	36	212	0	6050
22591	284	5608	21	211	0	6124
22592	136	258	5445	150	0	5989
22593	95	5525	255	141	0	6016
22594	95	5877	88	121	0	6181
22595	4567	199	31	65	0	4862
22596	198	4271	27	74	0	4570
22597	49	4028	17	47	0	4141
22598	3957	180	31	50	0	4218
22599	186	64	3795	36	0	4081
22600	3591	41	122	37	0	3791
22601	153	40	27	3630	0	3850
22602	63	31	34	3694	0	3822
22603	36	32	21	3796	0	3885
22604	51	25	3491	177	0	3744
22605	36	3495	134	81	0	3746
22606	3629	115	39	64	0	3847
22607	143	21	28	3613	0	3805
22608	35	3506	27	182	0	3750
22609	27	128	25	3723	0	3903
22610	43	40	3563	167	0	3813
22611	28	57	130	3556	0	3771
22612	37	46	32	3737	0	3852
22613	27	34	21	3802	0	3884
22614	3661	32	21	175	0	3889
22615	143	29	25	3692	0	3889
22616	41	27	3714	190	0	3972
22617	41	3651	136	104	0	3932
22618	35	128	34	3893	0	4090
22619	35	30	28	4023	0	4116
22620	53	44	3108	186	0	3391
22621	38	40	3079	86	0	3243
22622	3064	26	158	79	0	3327
22623	3254	36	53	63	0	3406
22624	173	3126	53	72	0	3424
22625	3236	148	30	82	0	3496
22626	172	40	3095	78	0	3385
22627	54	32	3110	84	0	3280
22628	2892	27	159	76	0	3154
22629	2429	25	672	75	0	3201
22630	108	41	2184	54	0	2387
22631	2240	15	90	50	0	2395
22632	121	19	2226	42	0	2408
22633	2265	11	110	24	0	2410
22634	2336	38	41	25	0	2440
22635	130	26	33	2127	0	2316
22636	50	2192	49	89	0	2380
22637	2173	97	42	33	0	2345
22638	106	34	2194	38	0	2372
22639	63	2274	70	20	0	2427
22640	2453	73	28	25	0	2579
22641	2433	29	14	39	0	2515
22642	90	2330	31	32	0	2483
22643	58	71	27	2424	0	2580
22644	47	29	2343	75	0	2494
22645	36	33	70	2035	0	2174
22646	43	34	2018	86	0	2181
22647	45	27	69	2016	0	2157
22648	35	33	36	2123	0	2227
22649	26	25	1984	101	0	2136
22650	29	1954	90	57	0	2130
22651	29	60	38	2075	0	2202
22652	28	25	1735	101	0	1889
22653	1806	20	69	67	0	1962
22654	74	18	33	1934	0	2059
22655	30	16	38	1986	0	2070
22656	1930	36	28	98	0	2092
22657	87	18	28	2223	0	2356
22658	49	21	28	2229	0	2327
22659	48	2159	34	96	0	2337
22660	39	65	34	2281	0	2419
22661	33	32	2116	110	0	2291
22662	47	13	73	2171	0	2304
22663	39	2084	34	104	0	2261
22664	32	2216	35	75	0	2358
22665	27	95	30	2254	0	2406
22666	2245	28	27	99	0	2399
22667	86	33	40	2238	0	2397
22668	2240	35	27	92	0	2394
22669	90	39	33	2241	0	2403
22670	2238	36	31	84	0	2389
22671	2280	25	36	54	0	2395
22672	132	16	18	2200	0	2366
22673	61	512	29	1692	0	2294
22674	72	2074	27	70	0	2243
22675	55	2141	34	62	0	2292
22676	69	63	2010	53	0	2195
22677	62	2116	66	54	0	2298
22678	1462	18	4	20	0	1504
22679	25	6	6	1454	0	1491
22680	12	959	10	26	0	1007
22681	970	26	11	9	0	1016
22682	21	10	14	967	0	1012
22683	16	14	15	976	0	1021
22684	23	11	11	1894	0	1939
22685	10	13	12	1839	0	1874
22686	16	1837	18	33	0	1904
22687	18	1894	21	28	0	1961
22688	1974	24	18	22	0	2038
22689	37	1870	10	27	0	1944
22690	19	25	13	2000	0	2057
22691	13	15	15	2014	0	2057
22692	26	17	9	1980	0	2032
22693	15	19	12	2014	0	2060
22694	2006	18	13	37	0	2074
22695	1998	16	5	19	0	2038
22696	41	9	1911	30	0	1991
22697	18	16	23	1923	0	1980
22698	27	12	1939	44	0	2022
22699	23	9	24	1950	0	2006
22700	28	8	10	2007	0	2053
22701	2021	8	6	41	0	2076
22702	28	12	14	1984	0	2038
22703	12	17	1937	50	0	2016
22704	16	20	1719	31	0	1786
22705	1870	13	30	32	0	1945
22706	18	24	1935	38	0	2015
22707	21	17	24	1947	0	2009
22708	19	17	1928	49	0	2013
22709	20	19	24	1932	0	1995
22710	19	1909	18	47	0	1993
22711	22	25	14	1946	0	2007
22712	16	1870	16	49	0	1951
22713	16	1936	10	45	0	2007
22714	12	24	15	2007	0	2058
22715	1974	6	6	67	0	2053
22716	16	1659	7	12	0	1694
22717	12	13	1	1746	0	1772
22718	1760	5	4	17	0	1786
22719	1729	6	1	11	0	1747
22720	2118	6	6	13	0	2143
22721	11	3	4	2100	0	2118
22722	5	5	4	2117	0	2131
22723	2125	5	2	18	0	2150
22724	2101	8	4	9	0	2122
22725	2102	5	9	7	0	2123
22726	16	5	6	2083	0	2110
22727	11	7	2017	17	0	2052
22728	1959	7	14	12	0	1992
22729	19	3	3	2075	0	2100
22730	10	2013	7	19	0	2049
22731	4	10	5	2099	0	2118
22732	6	2009	7	23	0	2045
22733	5	12	6	2111	0	2134
22734	10	14	2020	18	0	2062
22735	4	1927	13	17	0	1961
22736	5	21	2	2079	0	2107
22737	7	8	4	2059	0	2078
22738	6	9	4	2078	0	2097
22739	1716	11	2	22	0	1751
22740	12	1632	2	19	0	1665
22741	7	13	3	1734	0	1757
22742	1724	3	1	23	0	1751
22743	1665	4	2	13	0	1684
22744	19	8	3	1680	0	1710
22745	12	8	1643	19	0	1682
22746	10	5	13	1638	0	1666
22747	14	1598	6	22	0	1640
22748	12	10	4	1710	0	1736
22749	1688	3	6	19	0	1716
22750	15	2	5	1686	0	1708
22751	5	5	1657	28	0	1695
22752	8	1556	17	15	0	1596
22753	1685	14	7	8	0	1714
22754	18	5	1614	12	0	1649
22755	1579	4	18	14	0	1615
22756	13	7	11	1664	0	1695
22757	3	1	0	1336	0	1340
22758	1	1280	4	8	0	1293
22759	1350	4	1	1	0	1356
22760	5	0	0	1331	0	1336
22761	1	1	2	1938	0	1942
22762	2	4	1	2869	0	2876
22763	6	1	2901	4	0	2912
22764	1	1	4	2761	0	2767
22765	2949	0	0	9	0	2958
22766	2909	1	1	5	0	2916
22767	4	1	3	2890	0	2898
22768	1	1	1	2878	0	2881
22769	2940	0	0	8	0	2948
22770	8	3	2765	0	0	2776
22771	2730	2	4	4	0	2740
22772	6	6	2702	6	0	2720
22773	4	2	2695	1	0	2702
22774	2	4	9	2616	0	2631
22775	3	2	2784	5	0	2794
22776	2703	0	7	3	0	2713
22777	5	1	3	2836	0	2845
22778	3	1	2829	7	0	2840
22779	1955	0	7	4	0	1966
22780	2070	0	0	3	0	2073
22781	8	3	2681	4	0	2696
22782	1	0	6	2585	0	2592
22783	4	2558	6	5	0	2573
22784	2663	4	1	2	0	2670
22785	7	1	2917	4	0	2929
22786	2590	0	1	4	0	2595
22787	0	2677	8	2	0	2687
22788	2868	0	2	0	0	2870
22789	2843	0	0	0	0	2843
22790	2811	0	1	2	0	2814
22791	1	0	0	2792	0	2793
22792	0	2722	5	1	0	2728
22793	3	7	2711	1	0	2722
22794	0	2690	3	0	0	2693
22795	0	2	0	2744	0	2746
22796	0	2675	8	0	0	2683
22797	0	2714	6	1	0	2721
22798	2768	0	5	0	0	2773
22799	2	3	2669	2	0	2676
22800	2	0	2683	0	0	2685
22801	4	4	2685	3	0	2696
22802	0	2533	6	1	0	2540
22803	2780	0	0	0	0	2780
22804	2768	0	0	0	0	2768
22805	2729	0	0	0	0	2729
22806	0	2636	3	1	0	2640
22807	0	1	0	3377	0	3378
22808	3	6	3287	0	0	3296
22809	2	8	3012	0	0	3022
22810	3246	1	1	1	0	3249
22811	3356	0	2	0	0	3358
22812	3317	1	0	0	0	3318
22813	3	3	3291	0	0	3297
22814	3234	1	1	0	0	3236
22815	1	0	0	3306	0	3307
22816	0	1	0	3316	0	3317
22817	3	2	3278	0	0	3283
22818	0	3087	13	2	0	3102
22819	0	0	0	3374	0	3374
22820	2	3	2970	0	0	2975
22821	2911	1	2	3	0	2917
22822	14	1	2	3229	0	3246
22823	5	0	0	3251	0	3256
22824	3228	0	1	19	0	3248
22825	20	0	0	3246	0	3266
22826	3265	0	0	22	0	3287
22827	3250	0	0	14	0	3264
22828	27	0	0	3239	0	3266
22829	9	1	0	3233	0	3243
22830	3267	1	0	22	0	3290
22831	23	2	0	3243	0	3268
22832	3280	0	0	27	0	3307
22833	3221	0	0	19	0	3240
22834	3214	1	1	12	0	3228
22835	29	2	0	3178	0	3209
22836	18	4	2	3224	0	3248
22837	3276	0	0	23	0	3299
22838	27	3040	8	14	0	3089
22839	9	3036	4	18	0	3067
22840	3257	15	0	13	0	3285
22841	32	13	3024	9	0	3078
22842	3165	7	10	7	0	3189
22843	27	7	4	3179	0	3217
22844	21	5	3097	21	0	3144
22845	2524	6	589	11	0	3130
22846	34	5	7	3162	0	3208
22847	22	7	5	3144	0	3178
22848	12	4	7	3204	0	3227
22849	20	6	3	3187	0	3216
22850	3238	2	3	34	0	3277
22851	25	3019	14	33	0	3091
22852	3155	14	8	18	0	3195
22853	37	8	3096	19	0	3160
22854	18	12	2993	24	0	3047
22855	11	2952	25	21	0	3009
22856	25	16	7	3172	0	3220
22857	13	9	3133	32	0	3187
22858	19	2721	40	19	0	2799
22859	23	27	3028	10	0	3088
22860	16	12	19	2979	0	3026
22861	7	6	16	2515	0	2544
22862	1733	11	8	31	0	1783
22863	47	9	13	1697	0	1766
22864	1702	18	6	59	0	1785
22865	40	14	1747	35	0	1836
22866	41	2041	27	24	0	2133
22867	23	17	16	2182	0	2238
22868	52	7	9	2543	0	2611
22869	25	4	2501	49	0	2579
22870	11	9	2385	45	0	2450
22871	2415	4	18	36	0	2473
22872	2546	4	8	40	0	2598
22873	35	4	13	2525	0	2577
22874	40	6	13	2525	0	2584
22875	47	2416	9	31	0	2503
22876	37	22	8	3430	0	3497
22877	3934	17	9	71	0	4031
22878	3877	5	12	41	0	3935
22879	62	3860	29	17	0	3968
22880	3957	63	14	16	0	4050
22881	4283	39	7	12	0	4341
22882	83	14	19	4548	0	4664
22883	40	4429	40	55	0	4564
22884	46	57	6	4638	0	4747
22885	21	19	24	4500	0	4564
22886	33	25	4196	85	0	4339
22887	4285	5	44	58	0	4392
22888	80	5	16	4461	0	4562
22889	49	11	13	4802	0	4875
22890	39	4874	18	142	0	5073
22891	43	96	15	5109	0	5263
22892	5732	48	6	133	0	5919
22893	6229	37	11	73	0	6350
22894	214	24	5995	52	0	6285
22895	58	17	6077	37	0	6189
22896	41	27	192	5626	0	5886
22897	50	31	44	6272	0	6397
22898	46	14	6060	239	0	6359
22899	38	34	6121	80	0	6273
22900	43	36	194	6094	0	6367
22901	41	28	5962	220	0	6251
22902	39	20	6058	105	0	6222
22903	58	14	220	6002	0	6294
22904	6069	13	80	219	0	6381
22905	6403	16	72	101	0	6592
22906	239	23	75	6099	0	6436
22907	83	26	79	5943	0	6131
22908	5726	24	68	256	0	6074
22909	206	17	63	5880	0	6166
22910	5713	9	65	267	0	6054
22911	5794	7	83	118	0	6002
22912	241	14	75	5731	0	6061
22913	127	7	42	5959	0	6135
22914	5680	4	38	305	0	6027
22915	217	5504	48	173	0	5942
22916	97	5745	47	133	0	6022
22917	99	210	32	5845	0	6186
22918	95	58	5562	285	0	6000
22919	123	37	188	5848	0	6196
22920	5526	43	259	278	0	6106
22921	214	30	42	5617	0	5903
22922	5664	34	33	247	0	5978
22923	219	49	5364	133	0	5765
22924	5515	42	177	115	0	5849
22925	218	33	62	5476	0	5789
22926	93	25	49	5764	0	5931
22927	98	33	5892	273	0	6296
22928	86	24	182	6031	0	6323
22929	68	32	79	6116	0	6295
22930	76	24	64	6360	0	6524
22931	6632	24	60	303	0	7019
22932	225	38	6741	168	0	7172
22933	117	26	6767	145	0	7055
22934	6770	17	222	142	0	7151
22935	6934	12	105	151	0	7202
22936	263	28	6654	136	0	7081
22937	150	21	196	6430	0	6797
22938	128	6607	127	259	0	7121
22939	109	167	114	6954	0	7344
22940	6826	40	110	287	0	7263
22941	6999	27	113	185	0	7324
22942	275	28	118	6835	0	7256
22943	147	7285	131	285	0	7848
22944	136	179	118	7124	0	7557
22945	104	7351	154	289	0	7898
22946	7621	188	115	187	0	8111
22947	7526	58	100	204	0	7888
22948	7515	40	85	185	0	7825
22949	333	7017	121	141	0	7612
22950	182	7353	104	195	0	7834
22951	156	223	88	7565	0	8032
22952	152	86	83	7705	0	8026
22953	153	52	71	7709	0	7985
22954	165	52	66	7848	0	8131
22955	193	56	7273	352	0	7874
22956	7332	68	199	215	0	7814
22957	297	65	7412	233	0	8007
22958	7745	64	228	194	0	8231
22959	316	76	7658	211	0	8261
22960	7778	67	236	198	0	8279
22961	340	68	7560	186	0	8154
22962	7623	49	267	188	0	8127
22963	305	47	145	7924	0	8421
22964	7881	37	122	345	0	8385
22965	336	45	122	7774	0	8277
22966	190	57	135	7531	0	7913
22967	190	48	124	7288	0	7650
22968	173	6745	141	373	0	7432
22969	7012	176	122	247	0	7557
22970	7077	55	101	242	0	7475
22971	335	6817	92	218	0	7462
22972	199	196	86	7176	0	7657
22973	189	80	6678	369	0	7316
22974	6910	60	220	238	0	7428
22975	7201	48	92	212	0	7553
22976	6218	51	81	191	0	6541
22977	289	44	93	5441	0	5867
22978	191	5393	91	263	0	5938
22979	168	179	86	5666	0	6099
22980	5640	62	70	287	0	6059
22981	268	45	65	4475	0	4853
22982	130	4057	56	193	0	4436
22983	4186	166	69	114	0	4535
22984	232	65	4250	99	0	4646
22985	131	54	4441	99	0	4725
22986	114	4261	165	117	0	4657
22987	89	4297	66	105	0	4557
22988	109	192	4280	91	0	4672
22989	84	82	3412	64	0	3642
22990	89	436	365	2490	0	3380
22991	3636	58	61	61	0	3816
22992	48	14	3112	9	0	3183
22993	7	2549	29	2	0	2587
22994	2818	16	11	3	0	2848
22995	13	2695	12	6	0	2726
22996	2805	14	6	5	0	2830
22997	15	2885	9	6	0	2915
22998	7	2933	8	12	0	2960
22999	9	31	4	2971	0	3015
23000	9	10	3	2995	0	3017
23001	10	10	2943	24	0	2987
23002	11	5	21	2891	0	2928
23003	2987	7	6	26	0	3026
23004	3003	5	6	8	0	3022
23005	28	9	3	2944	0	2984
23006	11	5	2913	28	0	2957
23007	6	10	2789	14	0	2819
23008	6	2	24	2906	0	2938
23009	11	2	2934	33	0	2980
23010	7	5	24	2876	0	2912
23011	10	2	7	2855	0	2874
23012	9	5	3501	32	0	3547
23013	3287	4	75	12	0	3378
23014	3605	3	31	9	0	3648
23015	95	9	3405	12	0	3521
23016	32	11	3914	19	0	3976
23017	16	3	115	3805	0	3939
23018	12	2	37	4085	0	4136
23019	11	2	15	4138	0	4166
23020	13	6	15	4155	0	4189
23021	4087	2	9	128	0	4226
23022	4109	1	13	48	0	4171
23023	117	3	12	4533	0	4665
23024	45	8	9	4698	0	4760
23025	21	18	5340	154	0	5533
23026	21	2	142	5513	0	5678
23027	17	4	57	5325	0	5403
23028	5257	8	16	236	0	5517
23029	168	5149	21	98	0	5436
23030	64	149	18	5365	0	5596
23031	29	53	13	5152	0	5247
23032	18	26	9	4840	0	4893
23033	23	4261	25	241	0	4550
23034	11	4668	15	103	0	4797
23035	14	206	7	4724	0	4951
23036	21	70	4	4840	0	4935
23037	11	33	11	4933	0	4988
23038	4617	16	8	266	0	4907
23039	161	4573	26	110	0	4870
23040	4744	171	7	62	0	4984
23041	4860	66	5	54	0	4985
23042	228	31	6	4662	0	4927
23043	84	4019	9	196	0	4308
23044	4116	179	4	88	0	4387
23045	191	70	3	4153	0	4417
23046	4135	36	5	201	0	4377
23047	198	22	6	4192	0	4418
23048	79	37	3835	210	0	4161
23049	46	21	3962	104	0	4133
23050	27	17	202	4099	0	4345
23051	29	20	80	4176	0	4305
23052	29	16	36	4126	0	4207
23053	27	3827	28	259	0	4141
23054	26	4137	23	108	0	4294
23055	4062	197	14	66	0	4339
23056	4095	86	13	47	0	4241
23057	220	3969	14	55	0	4258
23058	86	3832	11	31	0	3960
23059	38	3952	5	39	0	4034
23060	3726	219	8	33	0	3986
23061	160	3789	18	26	0	3993
23062	63	179	14	3846	0	4102
23063	3819	61	17	176	0	4073
23064	3913	38	10	81	0	4042
23065	216	22	10	3844	0	4092
23066	90	29	3654	186	0	3959
23067	58	26	3750	85	0	3919
23068	39	25	190	3835	0	4089
23069	41	24	3767	189	0	4021
23070	28	15	172	3808	0	4023
23071	27	25	79	3938	0	4069
23072	18	25	3717	246	0	4006
23073	25	26	3734	112	0	3897
23074	25	16	209	3786	0	4036
23075	27	23	83	4000	0	4133
23076	3757	18	42	253	0	4070
23077	179	3620	35	130	0	3964
23078	89	3874	34	71	0	4068
23079	3709	214	28	59	0	4010
23080	3882	86	25	61	0	4054
23081	222	3681	30	66	0	3999
23082	88	3880	22	63	0	4053
23083	3842	221	18	65	0	4146
23084	186	95	25	3661	0	3967
23085	3468	37	17	226	0	3748
23086	200	3372	24	117	0	3713
23087	3512	161	24	87	0	3784
23088	205	82	3276	74	0	3637
23089	3445	36	161	83	0	3725
23090	211	36	3295	74	0	3616
23091	97	35	167	3213	0	3512
23092	3205	39	81	210	0	3535
23093	192	51	3667	123	0	4033
23094	92	31	167	3880	0	4170
23095	3902	32	73	223	0	4230
23096	183	54	3707	133	0	4077
23097	108	36	146	3687	0	3977
23098	3613	46	66	219	0	3944
23099	196	3537	32	132	0	3897
23100	96	175	19	3677	0	3967
23101	80	77	12	3749	0	3918
23102	58	63	20	3761	0	3902
23103	68	3498	19	238	0	3823
23104	48	171	18	3761	0	3998
23105	63	73	23	3816	0	3975
23106	50	56	20	3855	0	3981
23107	51	35	29	3871	0	3986
23108	62	36	3406	268	0	3772
23109	3494	29	139	158	0	3820
23110	3686	27	73	80	0	3866
23111	220	3539	57	83	0	3899
23112	76	106	15	2993	0	3190
23113	51	54	27	3026	0	3158
23114	41	2903	14	166	0	3124
23115	34	87	15	2529	0	2665
23116	2411	43	23	121	0	2598
23117	84	2438	18	72	0	2612
23118	2469	90	19	56	0	2634
23119	100	37	17	2497	0	2651
23120	43	700	1659	112	0	2514
23121	42	2422	79	63	0	2606
23122	2420	97	36	45	0	2598
23123	87	1878	22	14	0	2001
23124	44	1970	10	23	0	2047
23125	906	4	0	5	0	915
23126	7	6	872	2	0	887
23127	2	885	6	5	0	898
23128	1220	1	0	1	0	1222
23129	1221	0	0	0	0	1221
23130	1	1156	3	2	0	1162
23131	0	1	0	1226	0	1227
23132	0	0	1200	1	0	1201
23133	0	0	1	1179	0	1180
23134	0	0	0	1163	0	1163
23135	0	0	0	1215	0	1215
23136	0	0	1217	1	0	1218
23137	1	0	1	1150	0	1152
23138	1	1	1205	1	0	1208
23139	0	1	1171	0	0	1172
23140	1014	1	1	1	0	1017
23141	1	1117	3	1	0	1122
23142	0	1151	0	1	0	1152
23143	0	2	0	1210	0	1212
23144	1707	0	0	1	0	1708
23145	1695	0	0	0	0	1695
23146	1685	0	0	0	0	1685
23147	1680	0	0	0	0	1680
23148	1634	1	0	0	0	1635
23149	1	4	1817	0	0	1822
23150	0	0	7	1844	0	1851
23151	0	1770	9	11	0	1790
23152	0	10	2	1914	0	1926
23153	1911	1	0	10	0	1922
23154	10	1807	2	4	0	1823
23155	2	10	0	1915	0	1927
23156	1915	3	1	10	0	1929
23157	1899	2	0	5	0	1906
23158	12	1	1	1880	0	1894
23159	5	0	0	1872	0	1877
23160	2	0	0	1919	0	1921
23161	2	4	1865	19	0	1890
23162	0	4	1819	10	0	1833
23163	1	0	12	1842	0	1855
23164	1	0	5	1904	0	1910
23165	1899	0	2	15	0	1916
23166	1878	0	0	6	0	1884
23167	1883	0	0	5	0	1888
23168	1865	0	4	3	0	1872
23169	1899	1	2	1	0	1903
23170	15	2312	7	2	0	2336
23171	2490	11	0	5	0	2506
23172	2461	4	1	2	0	2468
23173	2456	4	0	2	0	2462
23174	18	2	0	2418	0	2438
23175	8	3	2410	12	0	2433
23176	6	0	11	2388	0	2405
23177	4	3	2410	12	0	2429
23178	3	0	10	2350	0	2363
23179	1	2286	9	20	0	2316
23180	2458	9	4	5	0	2476
23181	3595	3	4	7	0	3609
23182	14	5	4	3577	0	3600
23183	6	1	3	3604	0	3614
23184	5	0	4	3641	0	3650
23185	4	3472	6	19	0	3501
23186	3657	12	0	4	0	3673
23187	3601	3	2	5	0	3611
23188	20	3412	3	1	0	3436
23189	8	13	0	3621	0	3642
23190	6	7	0	3635	0	3648
23191	6	3451	6	15	0	3478
23192	3675	11	1	4	0	3691
23193	2974	4	1	4	0	2983
23194	19	2	2	2967	0	2990
23195	5	4	2940	18	0	2967
23196	7	8	3889	6	0	3910
23197	4	10	22	4039	0	4075
23198	1	6	10	4070	0	4087
23199	2	6	3	4225	0	4236
23200	4221	3	5	26	0	4255
23201	4144	2	4	15	0	4165
23202	25	4588	11	13	0	4637
23203	4742	18	14	13	0	4787
23204	28	18	4581	13	0	4640
23205	14	19	4403	11	0	4447
23206	12	4521	33	14	0	4580
23207	4729	22	11	10	0	4772
23208	27	4567	12	12	0	4618
23209	4792	26	5	14	0	4837
23210	31	20	4622	9	0	4682
23211	18	10	4539	12	0	4579
23212	15	8	34	4391	0	4448
23213	17	13	4573	27	0	4630
23214	16	9	25	4595	0	4645
23215	16	9	19	4335	0	4379
23216	14	4510	27	29	0	4580
23217	19	25	9	4746	0	4799
23218	15	13	14	4724	0	4766
23219	4697	9	13	40	0	4759
23220	33	4506	17	24	0	4580
23221	25	26	11	4730	0	4792
23222	20	16	4573	33	0	4642
23223	3971	19	29	28	0	4047
23224	30	16	4506	16	0	4568
23225	15	5	33	4512	0	4565
23226	17	4450	15	40	0	4522
23227	17	27	14	4705	0	4763
23228	4182	14	10	38	0	4244
23229	4146	9	9	37	0	4201
23230	36	3998	21	20	0	4075
23231	4204	22	12	15	0	4253
23232	4119	13	9	28	0	4169
23233	4165	13	7	22	0	4207
23234	4181	16	3	21	0	4221
23235	4076	13	4	26	0	4119
23236	45	18	3990	14	0	4067
23237	35	16	20	3952	0	4023
23238	27	8	11	4102	0	4148
23239	20	12	14	4128	0	4174
23240	24	4062	10	41	0	4137
23241	21	32	8	4160	0	4221
23242	27	21	3946	35	0	4029
23243	22	3845	36	20	0	3923
23244	16	3571	20	29	0	3636
23245	19	35	18	3707	0	3779
23246	26	19	9	3684	0	3738
23247	23	22	11	3638	0	3694
23248	28	3478	21	54	0	3581
23249	17	3337	14	29	0	3397
23250	3430	19	14	22	0	3485
23251	3338	24	14	16	0	3392
23252	28	3334	14	26	0	3402
23253	3483	20	11	29	0	3543
23254	3409	21	15	22	0	3467
23255	19	19	13	4183	0	4234
23256	18	14	15	4111	0	4158
23257	16	24	9	4189	0	4238
23258	25	22	4033	30	0	4110
23259	23	33	3787	29	0	3872
23260	17	3923	30	26	0	3996
23261	4190	27	20	21	0	4258
23262	29	22	4051	24	0	4126
23263	3837	26	22	29	0	3914
23264	41	15	4002	23	0	4081
23265	3936	18	27	24	0	4005
23266	32	4299	32	21	0	4384
23267	4571	18	22	19	0	4630
23268	34	21	20	4467	0	4542
23269	33	17	19	4493	0	4562
23270	30	18	3780	46	0	3874
23271	25	3811	24	30	0	3890
23272	27	21	18	4029	0	4095
23273	28	20	3919	32	0	3999
23274	3432	22	28	34	0	3516
23275	34	3838	23	27	0	3922
23276	3988	23	20	30	0	4061
23277	33	3898	19	27	0	3977
23278	31	27	16	4001	0	4075
23279	4017	17	17	30	0	4081
23280	26	3859	20	36	0	3941
23281	25	27	17	2964	0	3033
23282	34	26	2860	37	0	2957
23283	2708	28	16	33	0	2785
23284	38	17	16	2924	0	2995
23285	31	31	2865	30	0	2957
23286	34	2834	15	41	0	2924
23287	26	22	18	2930	0	2996
23288	35	21	2882	34	0	2972
23289	31	22	11	2822	0	2886
23290	26	2770	25	39	0	2860
23291	35	2880	24	25	0	2964
23292	25	35	2808	39	0	2907
23293	23	28	22	2832	0	2905
23294	26	29	3236	40	0	3331
23295	3143	25	17	45	0	3230
23296	20	8	14	2130	0	2172
23297	22	2050	20	19	0	2111
23298	17	2114	9	20	0	2160
23299	2136	15	19	17	0	2187
23300	12	2113	13	22	0	2160
23301	2135	15	6	31	0	2187
23302	4	0	1530	0	0	1534
23303	1388	1	2	0	0	1391
23304	1	1465	5	0	0	1471
23305	1563	2	0	0	0	1565
23306	1	1499	0	0	0	1500
23307	0	2	0	1544	0	1546
23308	0	0	0	1540	0	1540
23309	2	0	1514	1	0	1517
23310	1408	0	1	2	0	1411
23311	3	1	1506	0	0	1510
23312	1480	2	1	0	0	1483
23313	1	0	0	1525	0	1526
23314	1	0	0	1517	0	1518
23315	0	1491	1	1	0	1493
23316	0	2	0	1898	0	1900
23317	0	2	0	1933	0	1935
23318	1	4	2490	31	0	2526
23319	2407	0	58	14	0	2479
23320	66	2519	18	4	0	2607
23321	2562	68	5	2	0	2637
23322	71	17	2	2553	0	2643
23323	16	3	3	2653	0	2675
23324	2578	3	3	87	0	2671
23325	74	2519	4	26	0	2623
23326	2574	66	0	10	0	2650
23327	74	2501	7	6	0	2588
23328	24	2579	6	7	0	2616
23329	2598	84	1	6	0	2689
23330	75	22	0	2590	0	2687
23331	21	13	2497	80	0	2611
23332	9	8	62	2560	0	2639
23333	9	5	17	2616	0	2647
23334	7	2528	11	84	0	2630
23335	11	69	5	2607	0	2692
23336	7	22	4	2639	0	2672
23337	5	12	5	2636	0	2658
23338	10	6	2	4114	0	4132
23339	8	11	3863	123	0	4005
23340	9	8	3891	35	0	3943
23341	6	8	97	4348	0	4459
23342	5	10	4306	126	0	4447
23343	14	17	4324	33	0	4388
23344	10	12	128	4298	0	4448
23345	18	15	4193	121	0	4347
23346	26	11	123	3842	0	4002
23347	8	4170	45	115	0	4338
23348	4242	101	22	52	0	4417
23349	114	38	4958	37	0	5147
23350	33	19	112	4932	0	5096
23351	28	24	4936	124	0	5112
23352	17	26	121	5530	0	5694
23353	18	19	34	5784	0	5855
23354	5634	20	32	194	0	5880
23355	147	17	31	5059	0	5254
23356	4848	13	55	194	0	5110
23357	4942	2	66	104	0	5114
23358	168	4867	65	94	0	5194
23359	4871	148	67	76	0	5162
23360	160	4727	70	65	0	5022
23361	57	5060	56	84	0	5257
23362	5000	178	59	91	0	5328
23363	167	61	4914	75	0	5217
23364	66	50	4942	82	0	5140
23365	5185	42	204	69	0	5500
23366	4933	39	112	46	0	5130
23367	199	4837	71	73	0	5180
23368	4988	170	73	57	0	5288
23369	4975	64	70	76	0	5185
23370	5065	30	68	90	0	5253
23371	242	30	52	5022	0	5346
23372	4795	37	49	224	0	5105
23373	214	5476	43	117	0	5850
23374	143	168	40	5644	0	5995
23375	114	76	50	5702	0	5942
23376	86	5507	63	254	0	5910
23377	100	183	45	5762	0	6090
23378	5621	113	59	219	0	6012
23379	5710	71	45	127	0	5953
23380	263	5262	78	90	0	5693
23381	132	5582	78	77	0	5869
23382	5793	205	64	87	0	6149
23383	278	87	5533	72	0	5970
23384	153	83	5500	102	0	5838
23385	122	92	226	5473	0	5913
23386	146	67	130	5782	0	6125
23387	151	89	5477	272	0	5989
23388	115	5410	229	164	0	5918
23389	155	177	129	5600	0	6061
23390	119	111	5494	267	0	5991
23391	125	73	215	5498	0	5911
23392	115	81	119	5418	0	5733
23393	119	5577	67	278	0	6041
23394	125	228	75	5154	0	5582
23395	124	122	100	5323	0	5669
23396	137	81	88	5529	0	5835
23397	5358	80	86	301	0	5825
23398	228	102	96	5105	0	5531
23399	165	5112	99	279	0	5655
23400	5401	219	98	170	0	5888
23401	262	114	5131	180	0	5687
23402	167	103	5162	146	0	5578
23403	5281	74	250	175	0	5780
23404	263	94	145	5103	0	5605
23405	173	100	5204	264	0	5741
23406	137	85	208	5368	0	5798
23407	116	141	126	5585	0	5968
23408	5418	109	97	311	0	5935
23409	5357	73	120	209	0	5759
23410	272	5290	118	188	0	5868
23411	174	217	112	5440	0	5943
23412	163	122	5578	342	0	6205
23413	148	6157	188	231	0	6724
23414	6255	237	112	148	0	6752
23415	298	6182	84	188	0	6752
23416	6050	195	67	146	0	6458
23417	307	119	5770	132	0	6328
23418	5116	90	126	136	0	5468
23419	5281	90	104	100	0	5575
23420	215	125	5026	115	0	5481
23421	147	83	135	4925	0	5290
23422	138	4955	122	159	0	5374
23423	141	4994	95	152	0	5382
23424	111	5165	104	145	0	5525
23425	160	157	59	5236	0	5612
23426	159	110	5001	181	0	5451
23427	102	157	116	5075	0	5450
23428	155	83	72	5246	0	5556
23429	146	94	4960	184	0	5384
23430	122	4957	170	141	0	5390
23431	121	156	99	5231	0	5607
23432	5224	99	80	213	0	5616
23433	170	114	88	5142	0	5514
23434	111	110	100	5142	0	5463
23435	133	5086	70	229	0	5518
23436	5170	163	90	149	0	5572
23437	173	96	104	5729	0	6102
23438	60	39	4014	116	0	4229
23439	56	3935	74	97	0	4162
23440	4094	69	56	64	0	4283
23441	83	46	3701	36	0	3866
23442	3633	31	48	64	0	3776
23443	67	25	56	3733	0	3881
23444	37	4180	36	69	0	4322
23445	4427	64	21	56	0	4568
23446	4648	45	28	51	0	4772
23447	92	5234	42	38	0	5406
23448	39	60	25	5445	0	5569
23449	28	52	29	4839	0	4948
23450	4775	23	32	84	0	4914
23451	77	4640	40	61	0	4818
23452	13	16	11	4144	0	4184
23453	15	3987	13	18	0	4033
23454	18	4029	16	14	0	4077
23455	14	15	13	4171	0	4213
23456	4154	14	8	13	0	4189
23457	15	3997	11	24	0	4047
23458	10	31	4	4118	0	4163
23459	15	15	3	4116	0	4149
23460	20	6	3994	20	0	4040
23461	22	20	3827	13	0	3882
23462	11	3772	23	27	0	3833
23463	13	20	3930	25	0	3988
23464	16	11	16	3978	0	4021
23465	1	1	4000	1	0	4003
23466	0	2	1	3916	0	3919
23467	0	0	1	4631	0	4632
23468	0	1	1	4639	0	4641
23469	4697	0	0	1	0	4698
23470	1	1	1	4661	0	4664
23471	1	2	0	4675	0	4678
23472	2	4449	5	3	0	4459
23473	0	2	0	4066	0	4068
23474	4535	2	0	2	0	4539
23475	0	4275	13	7	0	4295
23476	4467	2	2	0	0	4471
23477	6	5	4303	2	0	4316
23478	3	5	4178	1	0	4187
23479	0	3	2	4191	0	4196
23480	2	0	1	4456	0	4459
23481	0	4291	13	4	0	4308
23482	2	12	1	4420	0	4435
23483	4719	0	0	5	0	4724
23484	4597	0	0	0	0	4597
23485	15	0	0	4915	0	4930
23486	7	3	5795	15	0	5820
23487	4	5	11	5695	0	5715
23488	3	3	3	6062	0	6071
23489	4	0	2	6127	0	6133
23490	2	2	2	6126	0	6132
23491	3	1	1	6098	0	6103
23492	7	5823	12	33	0	5875
23493	6126	30	5	14	0	6175
23494	6406	3	6	9	0	6424
23495	6472	1	4	14	0	6491
23496	419	5456	15	13	0	5903
23497	6493	29	1	10	0	6533
23498	58	6219	14	15	0	6306
23499	13	64	6325	12	0	6414
23500	5	17	59	6172	0	6253
23501	13	13	6321	64	0	6411
23502	9	6049	69	19	0	6146
23503	6395	58	10	9	0	6472
23504	69	23	6269	11	0	6372
23505	19	21	6539	4	0	6583
23506	7	6305	71	9	0	6392
23507	17	59	15	7192	0	7283
23508	20	29	8469	66	0	8584
23509	11	8	66	8116	0	8201
23510	10	11	15	9417	0	9453
23511	7	6	9	9718	0	9740
23512	10413	12	10	127	0	10562
23513	11266	9	16	38	0	11329
23514	251	5	19	11024	0	11299
23515	11445	11	22	265	0	11743
23516	288	28	11141	92	0	11549
23517	115	19	11067	66	0	11267
23518	90	17	11069	38	0	11214
23519	76	38	11016	52	0	11182
23520	63	10697	333	64	0	11157
23521	75	236	128	11198	0	11637
23522	83	79	11480	251	0	11893
23523	10845	43	317	99	0	11304
23524	11781	31	122	83	0	12017
23525	346	11303	149	79	0	11877
23526	11752	252	123	51	0	12178
23527	331	83	149	11624	0	12187
23528	151	67	12118	275	0	12611
23529	101	56	352	11802	0	12311
23530	81	12449	187	268	0	12985
23531	12908	292	124	124	0	13448
23532	12952	112	100	105	0	13269
23533	364	12659	103	94	0	13220
23534	13167	289	56	83	0	13595
23535	13097	122	55	65	0	13339
23536	412	12608	51	90	0	13161
23537	253	291	44	12408	0	12996
23538	170	12154	76	311	0	12711
23539	12704	320	72	144	0	13240
23540	367	151	57	12488	0	13063
23541	13061	115	80	307	0	13563
23542	386	106	54	12956	0	13502
23543	217	131	12537	326	0	13211
23544	12134	96	273	132	0	12635
23545	412	110	12062	99	0	12683
23546	214	86	278	11926	0	12504
23547	161	99	11799	334	0	12393
23548	165	82	295	11839	0	12381
23549	153	78	11709	370	0	12310
23550	11516	64	319	188	0	12087
23551	363	11500	137	173	0	12173
23552	12406	271	120	153	0	12950
23553	364	87	147	12330	0	12928
23554	12221	58	144	356	0	12779
23555	368	11325	504	181	0	12378
23556	184	11659	179	127	0	12149
23557	169	12286	113	131	0	12699
23558	12391	368	131	113	0	13003
23559	362	162	92	12252	0	12868
23560	207	131	71	12570	0	12979
23561	189	147	11776	366	0	12478
23562	166	151	11885	181	0	12383
23563	175	108	289	12445	0	13017
23564	169	121	12337	348	0	12975
23565	129	12188	322	207	0	12846
23566	12660	351	143	155	0	13309
23567	354	163	11992	137	0	12646
23568	159	144	12027	125	0	12455
23569	163	107	364	11836	0	12470
23570	12297	79	199	388	0	12963
23571	370	60	185	12280	0	12895
23572	12271	57	185	410	0	12923
23573	370	55	180	12372	0	12977
23574	178	76	12002	408	0	12664
23575	191	11495	410	195	0	12291
23576	156	320	11857	160	0	12493
23577	157	11663	427	131	0	12378
23578	124	338	208	12125	0	12795
23579	12146	139	170	373	0	12828
23580	390	131	11855	204	0	12580
23581	215	98	330	11877	0	12520
23582	174	111	156	12375	0	12816
23583	12497	87	129	435	0	13148
23584	383	96	110	12213	0	12802
23585	168	11974	156	423	0	12721
23586	11295	340	145	210	0	11990
23587	352	182	10958	175	0	11667
23588	10723	131	295	174	0	11323
23589	388	10666	172	159	0	11385
23590	231	334	107	10537	0	11209
23591	203	11003	100	336	0	11642
23592	11276	330	91	174	0	11871
23593	413	159	10840	178	0	11590
23594	10461	126	239	150	0	10976
23595	387	10603	108	146	0	11244
23596	193	334	102	11016	0	11645
23597	11113	153	86	310	0	11662
23598	11225	123	109	158	0	11615
23599	414	109	95	10905	0	11523
23600	210	117	93	11094	0	11514
23601	186	10725	101	374	0	11386
23602	157	315	90	11509	0	12071
23603	170	12685	473	395	0	13723
23604	154	13795	129	212	0	14290
23605	142	440	98	13343	0	14023
23606	128	13659	128	447	0	14362
23607	152	478	13276	245	0	14151
23608	169	258	13242	187	0	13856
23609	137	13681	454	233	0	14505
23610	115	443	13628	141	0	14327
23611	104	204	13592	156	0	14056
23612	53	146	12030	74	0	12303
23613	11	11200	342	49	0	11602
23614	10668	455	126	11	0	11260
23615	177	10496	103	11	0	10787
23616	70	259	11304	13	0	11646
23617	55	72	221	11392	0	11740
23618	11551	69	77	211	0	11908
23619	214	56	11454	59	0	11783
23620	68	19	235	11519	0	11841
23621	69	45	12028	213	0	12355
23622	24	21	273	11750	0	12068
23623	11851	32	89	262	0	12234
23624	233	56	11381	81	0	11751
23625	64	11817	262	74	0	12217
23626	70	225	89	11925	0	12309
23627	12115	78	87	224	0	12504
23628	244	94	10921	83	0	11342
23629	84	48	249	10581	0	10962
23630	74	10737	107	222	0	11140
23631	11361	229	102	78	0	11770
23632	12062	80	48	84	0	12274
23633	305	70	47	11914	0	12336
23634	135	11859	56	252	0	12302
23635	92	12336	49	101	0	12578
23636	12277	317	33	92	0	12719
23637	280	140	30	11886	0	12336
23638	88	12081	56	260	0	12485
23639	12141	267	48	100	0	12556
23640	278	101	39	12320	0	12738
23641	112	91	29	12215	0	12447
23642	98	120	10342	345	0	10905
23643	59	11421	237	171	0	11888
23644	57	12002	102	113	0	12274
23645	51	325	68	11983	0	12427
23646	11904	162	40	284	0	12390
23647	264	11360	48	130	0	11802
23648	11421	304	44	97	0	11866
23649	335	11219	51	63	0	11668
23650	120	326	45	11395	0	11886
23651	11456	131	36	285	0	11908
23652	296	117	39	11144	0	11596
23653	114	84	10737	349	0	11284
23654	103	74	259	10584	0	11020
23655	62	10465	116	319	0	10962
23656	10438	303	93	116	0	10950
23657	283	10359	71	127	0	10840
23658	111	341	58	10223	0	10733
23659	109	128	57	10714	0	11008
23660	79	134	10058	361	0	10632
23661	74	114	10158	169	0	10515
23662	51	70	323	10456	0	10900
23663	57	84	9747	317	0	10205
23664	47	9925	336	150	0	10458
23665	10942	289	119	126	0	11476
23666	294	142	11284	79	0	11799
23667	11440	115	291	79	0	11925
23668	11904	85	117	79	0	12185
23669	11817	80	121	69	0	12087
23670	11900	78	94	71	0	12143
23671	401	62	81	11594	0	12138
23672	200	63	87	11458	0	11808
23673	140	11244	101	346	0	11831
23674	11355	278	73	183	0	11889
23675	321	165	10939	123	0	11548
23676	148	117	282	11136	0	11683
23677	134	98	115	11401	0	11748
23678	96	87	10802	369	0	11354
23679	93	10912	300	203	0	11508
23680	93	291	133	11064	0	11581
23681	83	140	129	11526	0	11878
23682	11246	113	67	402	0	11828
23683	305	10604	74	563	0	11546
23684	141	284	54	11224	0	11703
23685	125	10953	79	328	0	11485
23686	102	324	54	11440	0	11920
23687	11284	144	57	375	0	11860
23688	11380	98	58	189	0	11725
23689	366	98	49	11405	0	11918
23690	11358	82	52	369	0	11861
23691	11091	83	49	172	0	11395
23692	366	10770	57	169	0	11362
23693	228	289	43	10695	0	11255
23694	167	10921	47	319	0	11454
23695	104	361	39	11025	0	11529
23696	10868	140	47	362	0	11417
23697	308	129	37	10843	0	11317
23698	151	95	43	11084	0	11373
23699	151	89	10263	410	0	10913
23700	115	10107	241	225	0	10688
23701	116	10813	97	190	0	11216
23702	10150	283	57	138	0	10628
23703	177	86	26	7300	0	7589
23704	7009	78	24	183	0	7294
23705	184	6355	21	83	0	6643
23706	76	5807	18	77	0	5978
23707	72	6050	19	67	0	6208
23708	4673	101	6	42	0	4822
23709	76	4258	15	32	0	4381
23710	4285	52	6	18	0	4361
23711	4187	19	3	24	0	4233
23712	4212	18	7	13	0	4250
23713	69	14	4	4112	0	4199
23714	26	18	2	4164	0	4210
23715	14	9	7	4246	0	4276
23716	16	15	4	4212	0	4247
23717	4253	15	5	66	0	4339
23718	50	4027	20	28	0	4125
23719	22	49	4	4242	0	4317
23720	4249	21	8	63	0	4341
23721	55	9	5	3684	0	3753
23722	28	14	5	3711	0	3758
23723	3731	14	3	71	0	3819
23724	46	9	3209	33	0	3297
23725	8	5	27	2984	0	3024
23726	8	3	3004	33	0	3048
23727	7	2	28	3016	0	3053
23728	4	2	10	3096	0	3112
23729	3056	1	5	40	0	3102
23730	29	2914	6	18	0	2967
23731	0	2380	3	3	0	2386
23732	2558	0	0	0	0	2558
23733	1	2403	4	2	0	2410
23734	2537	1	1	0	0	2539
23735	1	3	2435	0	0	2439
23736	2413	0	1	0	0	2414
23737	2530	1	1	1	0	2533
23738	2534	0	0	0	0	2534
23739	1	2	0	2437	0	2440
23740	1	1	0	2470	0	2472
23741	1	2363	8	3	0	2375
23742	1	1	0	2536	0	2538
23743	2542	0	0	1	0	2543
23744	1	2340	4	3	0	2348
23745	0	2448	2	5	0	2455
23746	2545	1	0	0	0	2546
23747	2	3	2462	0	0	2467
23748	1	2	2	2939	0	2944
23749	3	4	2995	9	0	3011
23750	1	2	10	2934	0	2947
23751	3	2874	10	11	0	2898
23752	1	10	3	3090	0	3104
23753	2981	3	2	15	0	3001
23754	10	3	2	2996	0	3011
23755	5	4	2934	13	0	2956
23756	2631	2	12	13	0	2658
23757	11	2963	15	9	0	2998
23758	6	3135	12	4	0	3157
23759	3253	15	1	2	0	3271
23760	3180	8	3	1	0	3192
23761	19	7	3140	0	0	3166
23762	3004	4	10	2	0	3020
23763	14	3082	13	1	0	3110
23764	3277	11	2	0	0	3290
23765	13	3	2	2369	0	2387
23766	4	1658	11	13	0	1686
23767	1782	12	1	4	0	1799
23768	13	13	1684	3	0	1713
23769	6	5	9	1714	0	1734
23770	1765	1	3	14	0	1783
23771	12	3	1716	7	0	1738
23772	1728	0	11	7	0	1746
23773	14	1	8	1724	0	1747
23774	6	2	4	1753	0	1765
23775	6	4	1702	14	0	1726
23776	3	2	10	1735	0	1750
23777	1730	0	4	16	0	1750
23778	12	1686	8	10	0	1716
23779	1732	9	3	7	0	1751
23780	1737	5	3	3	0	1748
23781	16	5	2	1731	0	1754
23782	10	6	2253	14	0	2283
23783	7	8	10	2250	0	2275
23784	2327	1	5	17	0	2350
23785	16	2187	14	9	0	2226
23786	2294	10	2	11	0	2317
23787	17	7	4	2303	0	2331
23788	12	4	2	2296	0	2314
23789	8	2	3	2340	0	2353
23790	3	8	2268	19	0	2298
23791	7	5	9	2262	0	2283
23792	7	5	2953	18	0	2983
23793	4	4	2929	14	0	2951
23794	10	1	16	3603	0	3630
23795	11	6	3583	35	0	3635
23796	4868	5	38	17	0	4928
23797	82	2	17	5008	0	5109
23798	46	4	12	4891	0	4953
23799	18	4886	16	112	0	5032
23800	5031	73	10	53	0	5167
23801	5038	33	3	26	0	5100
23802	121	4927	9	17	0	5074
23803	61	82	4	5048	0	5195
23804	38	48	4932	89	0	5107
23805	4821	15	82	50	0	4968
23806	5071	11	41	24	0	5147
23807	130	11	22	5027	0	5190
23808	63	13	5121	98	0	5295
23809	34	4991	90	55	0	5170
23810	4968	82	39	30	0	5119
23811	105	52	4715	17	0	4889
23812	57	4790	94	20	0	4961
23813	4956	76	41	12	0	5085
23814	4963	47	20	22	0	5052
23815	131	22	11	4848	0	5012
23816	64	4735	25	83	0	4907
23817	50	86	13	4967	0	5116
23818	36	44	9	5024	0	5113
23819	27	27	8	5013	0	5075
23820	20	15	10	5094	0	5139
23821	19	11	4783	163	0	4976
23822	26	16	85	4867	0	4994
23823	26	17	38	5635	0	5716
23824	28	17	4986	144	0	5175
23825	23	4952	110	75	0	5160
23826	5165	92	47	46	0	5350
23827	5234	49	31	35	0	5349
23828	133	28	22	5231	0	5414
23829	5245	25	19	98	0	5387
23830	126	23	8	5724	0	5881
23831	78	15	5557	141	0	5791
23832	49	31	5362	81	0	5523
23833	27	5469	156	55	0	5707
23834	5688	96	55	39	0	5878
23835	127	64	5955	48	0	6194
23836	70	41	137	5782	0	6030
23837	49	27	72	6900	0	7048
23838	42	26	40	7098	0	7206
23839	42	15	18	7165	0	7240
23840	30	23	30	7192	0	7275
23841	34	33	6632	333	0	7032
23842	30	19	185	6968	0	7202
23843	6874	23	82	252	0	7231
23844	204	6767	53	138	0	7162
23845	6791	172	32	82	0	7077
23846	221	6803	36	58	0	7118
23847	6937	201	28	59	0	7225
23848	6430	85	30	34	0	6579
23849	262	44	18	6257	0	6581
23850	141	34	16	6452	0	6643
23851	6319	17	19	282	0	6637
23852	6148	17	31	147	0	6343
23853	6297	24	27	89	0	6437
23854	272	5942	39	57	0	6310
23855	133	6171	35	55	0	6394
23856	73	224	5882	53	0	6232
23857	45	105	163	5935	0	6248
23858	55	58	5718	212	0	6043
23859	31	5776	191	152	0	6150
23860	36	168	88	5968	0	6260
23861	38	91	44	6064	0	6237
23862	38	53	34	6227	0	6352
23863	5999	38	19	303	0	6359
23864	6072	25	20	161	0	6278
23865	273	5842	37	88	0	6240
23866	146	159	18	6034	0	6357
23867	88	101	5763	222	0	6174
23868	62	60	5815	130	0	6067
23869	5898	46	238	76	0	6258
23870	6134	29	123	61	0	6347
23871	277	30	57	5954	0	6318
23872	6117	35	30	216	0	6398
23873	241	39	5729	140	0	6149
23874	126	5706	189	95	0	6116
23875	74	177	92	5987	0	6330
23876	69	112	6640	211	0	7032
23877	52	56	202	6715	0	7025
23878	43	38	97	6993	0	7171
23879	56	48	6580	296	0	6980
23880	6392	33	185	190	0	6800
23881	6830	25	87	134	0	7076
23882	264	6278	55	111	0	6708
23883	6591	187	46	97	0	6921
23884	6732	102	41	86	0	6961
23885	322	55	6242	91	0	6710
23886	6321	45	208	79	0	6653
23887	274	6710	108	80	0	7172
23888	6996	210	56	72	0	7334
23889	7042	115	46	67	0	7270
23890	7157	67	34	78	0	7336
23891	7048	39	36	72	0	7195
23892	6367	37	33	79	0	6516
23893	378	6065	33	85	0	6561
23894	5542	179	41	76	0	5838
23895	265	5503	38	65	0	5871
23896	82	4048	19	34	0	4183
23897	50	4726	34	30	0	4840
23898	4720	199	21	38	0	4978
23899	4864	79	23	42	0	5008
23900	228	56	4472	30	0	4786
23901	5196	26	149	49	0	5420
23902	5401	23	63	45	0	5532
23903	296	42	4984	48	0	5370
23904	131	16	213	5019	0	5379
23905	86	22	71	5217	0	5396
23906	61	31	31	5613	0	5736
23907	64	33	16	5643	0	5756
23908	59	40	15	5438	0	5552
23909	70	37	4922	314	0	5343
23910	55	5014	224	129	0	5422
23911	5084	211	81	65	0	5441
23912	253	5123	50	53	0	5479
23913	5307	226	32	41	0	5606
23914	5386	99	17	54	0	5556
23915	338	54	4914	46	0	5352
23916	147	42	219	4794	0	5202
23917	84	5057	84	210	0	5435
23918	5216	220	52	108	0	5596
23919	5233	99	51	75	0	5458
23920	5307	45	39	72	0	5463
23921	329	5054	43	55	0	5481
23922	5298	224	39	56	0	5617
23923	4824	95	29	63	0	5011
23924	4877	53	30	51	0	5011
23925	354	40	38	4565	0	4997
23926	172	38	19	4740	0	4969
23927	104	40	31	4901	0	5076
23928	4559	47	25	319	0	4950
23929	290	4546	31	129	0	4996
23930	4176	207	27	60	0	4470
23931	4338	87	29	38	0	4492
23932	4333	51	12	43	0	4439
23933	4307	36	20	33	0	4396
23934	359	4001	20	30	0	4410
23935	3593	180	13	26	0	3812
23936	239	3489	13	35	0	3776
23937	66	3136	11	18	0	3231
23938	3162	140	0	17	0	3319
23939	151	2927	7	20	0	3105
23940	80	3098	5	19	0	3202
23941	3177	151	3	20	0	3351
23942	3254	42	7	20	0	3323
23943	171	28	6	3089	0	3294
23944	80	28	0	3217	0	3325
23945	3152	24	4	147	0	3327
23946	3215	18	8	43	0	3284
23947	3256	21	3	27	0	3307
23948	186	31	3328	18	0	3563
23949	3529	25	109	15	0	3678
23950	164	23	27	3523	0	3737
23951	80	26	6	3631	0	3743
23952	53	20	9	3672	0	3754
23953	49	23	4	3708	0	3784
23954	48	29	3401	164	0	3642
23955	49	24	3514	53	0	3640
23956	39	30	126	3534	0	3729
23957	54	19	3471	143	0	3687
23958	48	25	3461	63	0	3597
23959	51	18	140	3391	0	3600
23960	51	16	42	3621	0	3730
23961	56	16	26	3683	0	3781
23962	58	12	23	3671	0	3764
23963	3588	11	19	188	0	3806
23964	3659	14	27	75	0	3775
23965	188	6	20	3575	0	3789
23966	82	16	20	3674	0	3792
23967	50	10	28	3726	0	3814
23968	37	14	30	3715	0	3796
23969	47	11	24	3658	0	3740
23970	40	3412	36	209	0	3697
23971	3524	135	25	109	0	3793
23972	139	3437	32	99	0	3707
23973	3589	134	27	81	0	3831
23974	3660	49	26	67	0	3802
23975	3672	30	20	70	0	3792
23976	186	28	24	2732	0	2970
23977	2766	40	17	169	0	2992
23978	194	19	21	2753	0	2987
23979	92	31	17	2846	0	2986
23980	2822	27	17	186	0	3052
23981	175	2624	12	89	0	2900
23982	94	2633	14	55	0	2796
23983	2640	127	6	56	0	2829
23984	173	48	2433	49	0	2703
23985	2705	29	90	54	0	2878
23986	156	38	24	2792	0	3010
23987	115	2233	10	127	0	2485
23988	76	2475	12	67	0	2630
23989	2498	133	8	41	0	2680
23990	157	53	6	2376	0	2592
23991	100	2333	15	125	0	2573
23992	2483	113	5	72	0	2673
23993	2583	50	2	49	0	2684
23994	2802	39	7	52	0	2900
23995	2786	29	6	41	0	2862
23996	194	2456	12	37	0	2699
23997	78	2111	8	23	0	2220
23998	2194	97	5	23	0	2319
23999	2236	40	1	23	0	2300
24000	130	29	2381	24	0	2564
24001	11	1829	18	3	0	1861
24002	1939	16	8	3	0	1966
24003	2640	15	6	2	0	2663
24004	86	13	2577	3	0	2679
24005	2878	10	65	4	0	2957
24006	89	5	2732	1	0	2827
24007	19	11	2757	1	0	2788
24008	9	2	94	2536	0	2641
24009	2	2557	31	81	0	2671
24010	2736	86	7	14	0	2843
24011	83	17	1	2729	0	2830
24012	25	5	4	2809	0	2843
24013	14	1	3	2886	0	2904
24014	2760	0	9	108	0	2877
24015	89	1	11	2773	0	2874
24016	22	1	6	2867	0	2896
24017	6	11	2702	106	0	2825
24018	2613	6	81	27	0	2727
24019	2804	4	17	16	0	2841
24020	109	9	2653	13	0	2784
24021	2702	2	74	15	0	2793
24022	99	1	17	2670	0	2787
24023	23	2657	12	93	0	2785
24024	16	85	6	2790	0	2897
24025	2804	17	11	100	0	2932
24026	97	2747	15	30	0	2889
24027	32	91	11	2834	0	2968
24028	18	21	15	2917	0	2971
24029	26	7	7	2941	0	2981
24030	10	5	9	2828	0	2852
24031	10	2745	10	119	0	2884
24032	2834	90	2	49	0	2975
24033	2875	27	8	24	0	2934
24034	122	2765	12	23	0	2922
24035	3092	92	8	24	0	3216
24036	3471	24	10	27	0	3532
24037	3203	7	8	30	0	3248
24038	158	9	2991	24	0	3182
24039	43	11	120	3055	0	3229
24040	28	12	2905	140	0	3085
24041	2989	6	112	37	0	3144
24042	138	3011	29	27	0	3205
24043	2998	130	20	17	0	3165
24044	141	3025	14	24	0	3204
24045	52	134	9	2963	0	3158
24046	34	27	26	3669	0	3756
24047	35	23	3488	155	0	3701
24048	27	3048	127	51	0	3253
24049	3203	131	33	34	0	3401
24050	142	47	3117	25	0	3331
24051	3131	24	125	27	0	3307
24052	151	29	31	3180	0	3391
24053	53	25	3072	146	0	3296
24054	31	3059	121	57	0	3268
24055	24	138	46	3200	0	3408
24056	29	43	3082	154	0	3308
24057	42	33	3122	49	0	3246
24058	28	3085	142	45	0	3300
24059	42	131	47	3138	0	3358
24060	43	37	31	3174	0	3285
24061	37	3076	32	158	0	3303
24062	3181	140	29	67	0	3417
24063	147	42	35	3114	0	3338
24064	55	3095	41	147	0	3338
24065	3187	144	29	56	0	3416
24066	3202	45	40	40	0	3327
24067	3265	31	30	37	0	3363
24068	187	3097	24	49	0	3357
24069	3207	148	27	53	0	3435
24070	3302	45	19	59	0	3425
24071	182	39	20	3184	0	3425
24072	3208	34	18	162	0	3422
24073	176	34	17	3213	0	3440
24074	75	39	3035	180	0	3329
24075	66	35	3107	68	0	3276
24076	44	24	154	3170	0	3392
24077	52	31	3111	168	0	3362
24078	3050	31	141	63	0	3285
24079	174	25	44	3170	0	3413
24080	87	26	30	3204	0	3347
24081	56	28	2951	188	0	3223
24082	51	2844	138	79	0	3112
24083	48	3089	50	64	0	3251
24084	47	157	41	3024	0	3269
24085	29	53	34	2991	0	3107
24086	46	29	2766	189	0	3030
24087	34	35	2874	77	0	3020
24088	39	34	158	2874	0	3105
24089	50	38	2777	170	0	3035
24090	3066	41	136	68	0	3311
24091	181	37	40	3130	0	3388
24092	3132	43	32	181	0	3388
24093	174	32	30	3121	0	3357
24094	61	28	29	3060	0	3178
24095	62	25	2754	198	0	3039
24096	56	2806	151	77	0	3090
24097	50	148	59	2898	0	3155
24098	60	41	2768	177	0	3046
24099	43	2820	159	73	0	3095
24100	47	131	33	2591	0	2802
24101	2578	32	37	171	0	2818
24102	151	35	2542	78	0	2806
24103	1779	13	75	37	0	1904
24104	81	19	1780	31	0	1911
24105	1327	9	64	14	0	1414
24106	55	1381	23	18	0	1477
24107	16	2072	21	20	0	2129
24108	17	59	22	2047	0	2145
24109	15	2029	12	53	0	2109
24110	2091	51	14	24	0	2180
24111	56	16	14	2075	0	2161
24112	18	16	20	2121	0	2175
24113	20	18	7	2157	0	2202
24114	8	15	2043	75	0	2141
24115	13	15	44	2035	0	2107
24116	18	15	2033	66	0	2132
24117	6	1991	58	28	0	2083
24118	2068	55	14	26	0	2163
24119	46	2022	16	26	0	2110
24120	2098	52	16	16	0	2182
24121	2131	13	7	24	0	2175
24122	2127	17	7	20	0	2171
24123	2132	12	7	20	0	2171
24124	73	9	2030	17	0	2129
24125	23	11	48	1928	0	2010
24126	19	9	13	1985	0	2026
24127	20	12	16	2041	0	2089
24128	1928	9	10	60	0	2007
24129	1900	13	17	19	0	1949
24130	50	2357	12	22	0	2441
24131	29	43	2355	23	0	2450
24132	25	15	2991	12	0	3043
24133	22	2874	60	16	0	2972
24134	19	3000	20	22	0	3061
24135	13	40	339	2556	0	2948
24136	0	8	4	2443	0	2455
24137	2562	2	1	13	0	2578
24138	11	2424	5	8	0	2448
24139	3	9	1	2558	0	2571
24140	5	6	2474	10	0	2495
24141	1	3	11	2452	0	2467
24142	1	2	3	2487	0	2493
24143	1	4	2	2540	0	2547
24144	0	2	1	2553	0	2556
24145	2	1	2517	15	0	2535
24146	0	1934	13	5	0	1952
24147	2	2010	4	7	0	2023
24148	2062	12	3	4	0	2081
24149	8	2000	4	7	0	2019
24150	2	2035	4	4	0	2045
24151	6	12	5	2026	0	2049
24152	2	6	0	2034	0	2042
24153	0	2	1	2031	0	2034
24154	6	3	2042	13	0	2064
24155	1	1961	12	11	0	1985
24156	1	12	1	2076	0	2090
24157	1	2000	4	12	0	2017
24158	2085	12	1	5	0	2103
24159	10	2023	3	5	0	2041
24160	2084	11	4	2	0	2101
24161	11	8	2036	2	0	2057
24162	1998	3	11	5	0	2017
24163	12	5	1	2023	0	2041
24164	6	0	2032	11	0	2049
24165	2018	3	10	2	0	2033
24166	2068	0	3	2	0	2073
24167	2066	2	4	1	0	2073
24168	16	1	3	2022	0	2042
24169	7	4	2013	11	0	2035
24170	1948	2	11	4	0	1965
24171	12	2	3	2051	0	2068
24172	6	0	1	2028	0	2035
24173	5	1	2024	13	0	2043
24174	3	1921	11	8	0	1943
24175	2	10	4	2031	0	2047
24176	3	1987	10	10	0	2010
24177	2056	11	2	5	0	2074
24178	2042	5	2	4	0	2053
24179	10	3	3	2024	0	2040
24180	2069	2	1	10	0	2082
24181	12	1975	6	4	0	1997
24182	2055	11	0	3	0	2069
24183	13	2006	3	2	0	2024
24184	7	14	1	2029	0	2051
24185	4	3	0	2045	0	2052
24186	4	2010	1	13	0	2028
24187	2	13	0	2061	0	2076
24188	4	4	1993	13	0	2014
24189	0	1906	16	8	0	1930
24190	1788	0	0	3	0	1791
24191	0	1708	3	3	0	1714
24192	1	1	0	1794	0	1796
24193	1	1	1728	1	0	1731
24194	1	0	1	1696	0	1698
24195	1	1	0	1723	0	1725
24196	1760	0	0	1	0	1761
24197	1	1	1737	1	0	1740
24198	2	1581	7	1	0	1591
24199	3	2	1711	0	0	1716
24200	0	3	2088	1	0	2092
24201	4	3	2136	1	0	2144
24202	2	0	39	2040	0	2081
24203	2171	0	14	27	0	2212
24204	26	2050	14	14	0	2104
24205	2171	27	2	3	0	2203
24206	2129	12	3	0	0	2144
24207	39	4	1	1479	0	1523
24208	13	1463	3	28	0	1507
24209	2156	21	2	11	0	2190
24210	25	2113	9	4	0	2151
24211	9	27	3	2121	0	2160
24212	6	13	1	2163	0	2183
24213	1	2077	5	38	0	2121
24214	2	29	0	2187	0	2218
24215	4	14	2094	30	0	2142
24216	4	7	2051	14	0	2076
24217	1	2	41	2073	0	2117
24218	2	2	13	2136	0	2153
24219	3	5	2098	39	0	2145
24220	3	6	2083	16	0	2108
24221	1898	3	38	4	0	1943
24222	27	2000	20	6	0	2053
24223	11	2077	6	5	0	2099
24224	4	39	4	2085	0	2132
24225	2	13	6	2099	0	2120
24226	1	5	3	2128	0	2137
24227	4	2	2064	44	0	2114
24228	2	8	1997	19	0	2026
24229	2	2	34	2039	0	2077
24230	3	1	1650	28	0	1682
24231	3	1566	36	19	0	1624
24232	1084	28	14	2	0	1128
24233	27	14	1068	2	0	1111
24234	15	6	1070	5	0	1096
24235	5	0	40	1045	0	1090
24236	1	7	1070	30	0	1108
24237	4	1607	33	16	0	1660
24238	3	43	14	1653	0	1713
24239	2	18	1573	40	0	1633
24240	1	1633	41	19	0	1694
24241	1663	41	16	9	0	1729
24242	43	21	5	1657	0	1726
24243	17	10	4	1725	0	1756
24244	1677	1	6	62	0	1746
24245	42	1631	6	25	0	1704
24246	1707	47	2	8	0	1764
24247	1716	18	3	4	0	1741
24248	1720	9	3	8	0	1740
24249	62	2	3	1682	0	1749
24250	1644	5	6	47	0	1702
24251	52	1577	8	21	0	1658
24252	23	1974	7	16	0	2020
24253	2002	87	3	4	0	2096
24254	82	33	3	2030	0	2148
24255	40	10	1	2100	0	2151
24256	18	9	2	2143	0	2172
24257	15	13	1908	117	0	2053
24258	11	1940	75	46	0	2072
24259	8	73	25	2052	0	2158
24260	2017	28	11	91	0	2147
24261	81	15	2	2067	0	2165
24262	32	13	1908	94	0	2047
24263	15	1974	78	40	0	2107
24264	2039	79	33	20	0	2171
24265	2071	36	19	19	0	2145
24266	2080	15	8	15	0	2118
24267	118	13	5	2045	0	2181
24268	45	17	1952	93	0	2107
24269	26	18	1893	43	0	1980
24270	25	1933	100	23	0	2081
24271	19	87	34	2004	0	2144
24272	19	42	15	2121	0	2197
24273	2028	21	11	130	0	2190
24274	101	14	11	2083	0	2209
24275	2066	16	9	121	0	2212
24276	104	16	1954	60	0	2134
24277	60	11	1989	35	0	2095
24278	35	16	103	1972	0	2126
24279	24	11	43	2051	0	2129
24280	23	13	20	2146	0	2202
24281	2045	13	13	133	0	2204
24282	2090	11	15	67	0	2183
24283	120	11	20	2598	0	2749
24284	52	17	2488	139	0	2696
24285	29	19	2527	83	0	2658
24286	30	14	158	2567	0	2769
24287	2887	11	76	131	0	3105
24288	118	12	35	2860	0	3025
24289	57	13	22	3045	0	3137
24290	37	12	2845	175	0	3069
24291	25	18	2872	95	0	3010
24292	2787	7	163	64	0	3021
24293	139	9	2884	36	0	3068
24294	79	12	134	2818	0	3043
24295	49	8	68	2993	0	3118
24296	2906	8	43	176	0	3133
24297	131	2823	47	93	0	3094
24298	2922	112	33	50	0	3117
24299	145	2897	31	49	0	3122
24300	2531	100	9	47	0	2687
24301	119	45	2381	55	0	2600
24302	2346	23	99	33	0	2501
24303	2510	21	55	25	0	2611
24304	149	7	36	2461	0	2653
24305	78	16	2386	103	0	2583
24306	45	8	107	2445	0	2605
24307	21	8	60	2473	0	2562
24308	35	2387	27	152	0	2601
24309	36	83	20	1844	0	1983
24310	25	1828	18	129	0	2000
24311	40	93	29	2272	0	2434
24312	2218	50	21	144	0	2433
24313	126	21	28	2296	0	2471
24314	68	24	2160	136	0	2388
24315	2258	17	107	77	0	2459
24316	125	23	2206	66	0	2420
24317	2236	14	119	43	0	2412
24318	2868	14	63	33	0	2978
24319	180	2730	36	51	0	2997
24320	93	2905	29	30	0	3057
24321	2796	175	34	36	0	3041
24322	2913	73	38	29	0	3053
24323	2979	33	30	37	0	3079
24324	2992	20	20	45	0	3077
24325	2951	30	9	49	0	3039
24326	223	21	21	2797	0	3062
24327	113	22	19	2946	0	3100
24328	75	28	2642	201	0	2946
24329	2808	18	143	85	0	3054
24330	176	18	59	2796	0	3049
24331	92	15	46	2937	0	3090
24332	63	35	2601	214	0	2913
24333	63	2636	146	103	0	2948
24334	52	2850	84	65	0	3051
24335	2777	154	47	54	0	3032
24336	2927	72	34	40	0	3073
24337	184	2115	35	29	0	2363
24338	91	2235	20	31	0	2377
24339	2216	144	19	33	0	2412
24340	2306	61	24	37	0	2428
24341	192	33	18	2220	0	2463
24342	104	21	20	2289	0	2434
24343	66	17	14	2378	0	2475
24344	2218	20	15	195	0	2448
24345	2332	24	20	90	0	2466
24346	191	26	17	2251	0	2485
24347	2308	19	11	147	0	2485
24348	183	24	2078	83	0	2368
24349	94	18	114	2243	0	2469
24350	66	27	2097	137	0	2327
24351	55	2162	131	79	0	2427
24352	44	81	38	1865	0	2028
24353	1850	35	32	98	0	2015
24354	110	19	19	1872	0	2020
24355	52	11	13	1953	0	2029
24356	39	19	1767	141	0	1966
24357	30	33	1785	71	0	1919
24358	34	1829	96	51	0	2010
24359	1869	90	42	33	0	2034
24360	1932	42	22	39	0	2035
24361	1972	22	17	37	0	2048
24362	1967	14	27	20	0	2028
24363	142	21	24	1843	0	2030
24364	84	17	13	1810	0	1924
24365	64	1814	25	105	0	2008
24366	1870	82	21	64	0	2037
24367	1935	41	9	41	0	2026
24368	144	38	1761	42	0	1985
24369	1841	13	82	39	0	1975
24370	128	1828	45	25	0	2026
24371	74	104	24	1780	0	1982
24372	68	1832	9	87	0	1996
24373	1870	89	13	49	0	2021
24374	133	1835	19	29	0	2016
24375	71	101	15	1855	0	2042
24376	53	53	14	1948	0	2068
24377	47	30	15	1934	0	2026
24378	54	1810	20	148	0	2032
24379	46	85	6	1904	0	2041
24380	32	52	16	1916	0	2016
24381	41	1763	24	141	0	1969
24382	47	1920	16	76	0	2059
24383	1273	63	7	22	0	1365
24384	66	1273	3	26	0	1368
24385	1306	54	11	23	0	1394
24386	70	31	1203	19	0	1323
24387	31	957	50	16	0	1054
24388	970	60	10	18	0	1058
24389	1008	32	6	24	0	1070
24390	82	19	904	21	0	1026
24391	34	11	50	967	0	1062
24392	28	18	929	67	0	1042
24393	23	953	57	32	0	1065
24394	935	47	19	24	0	1025
24395	55	962	16	20	0	1053
24396	31	61	7	921	0	1020
24397	27	26	9	1456	0	1518
24398	29	16	1418	67	0	1530
24399	34	17	1373	23	0	1447
24400	1380	19	55	21	0	1475
24401	1475	18	12	31	0	1536
24402	1461	14	9	20	0	1504
24403	1492	15	12	14	0	1533
24404	80	1409	11	18	0	1518
24405	29	48	18	1433	0	1528
24406	25	19	13	1449	0	1506
24407	24	1407	11	57	0	1499
24408	1481	60	2	25	0	1568
24409	1479	25	8	22	0	1534
24410	77	18	1418	21	0	1534
24411	1049	12	42	13	0	1116
24412	48	18	15	1082	0	1163
24413	23	8	1075	47	0	1153
24414	24	3	38	1016	0	1081
24415	17	11	1058	43	0	1129
24416	22	10	1042	26	0	1100
24417	14	566	46	495	0	1121
24418	0	476	0	2	0	478
24419	490	0	0	1	0	491
24420	470	0	1	1	0	472
24421	0	481	1	0	0	482
24422	0	487	0	2	0	489
24423	516	0	0	1	0	517
24424	487	1	0	0	0	488
24425	478	1	0	0	0	479
24426	478	0	0	0	0	478
24427	0	1	0	493	0	494
24428	1	0	505	0	0	506
24429	0	481	1	0	0	482
24430	495	1	0	0	0	496
24431	0	484	0	0	0	484
24432	485	0	0	0	0	485
24433	446	0	1	0	0	447
24434	1	1	474	1	0	477
24435	0	461	1	0	0	462
24436	0	3	0	469	0	472
24437	0	0	0	464	0	464
24438	0	1	0	442	0	443
24439	484	0	0	0	0	484
24440	402	0	0	1	0	403
24441	437	0	1	0	0	438
24442	0	455	1	0	0	456
24443	460	0	0	0	0	460
24444	0	451	0	0	0	451
24445	0	0	445	0	0	445
24446	1	454	0	0	0	455
24447	0	0	1	462	0	463
24448	0	0	0	440	0	440
24449	1	0	460	6	0	467
24450	0	0	1	415	0	416
24451	0	0	0	455	0	455
24452	456	0	1	0	0	457
24453	410	0	1	0	0	411
24454	436	0	0	1	0	437
24455	0	452	1	1	0	454
24456	458	0	0	0	0	458
24457	449	0	0	0	0	449
24458	0	447	1	0	0	448
24459	0	1	0	440	0	441
24460	1	1	0	409	0	411
24461	457	0	0	0	0	457
24462	2	0	441	0	0	443
24463	1	426	1	0	0	428
24464	0	0	0	446	0	446
24465	0	434	2	0	0	436
24466	0	449	0	0	0	449
24467	459	0	0	0	0	459
24468	424	1	1	0	0	426
24469	1	0	0	425	0	426
24470	1	0	0	423	0	424
24471	0	0	1	433	0	434
24472	0	1	0	412	0	413
24473	0	0	416	1	0	417
24474	2	1	394	1	0	398
24475	0	0	0	408	0	408
24476	1	0	419	0	0	420
24477	1	388	0	0	0	389
24478	429	0	0	0	0	429
24479	417	1	0	0	0	418
24480	1	0	0	393	0	394
24481	0	1	1	383	0	385
24482	0	0	1	410	0	411
24483	0	408	0	0	0	408
24484	416	0	0	1	0	417
24485	368	0	1	1	0	370
24486	0	0	412	0	0	412
24487	0	0	1	356	0	357
24488	0	6	1002	1	0	1009
24489	1	1	0	988	0	990
24490	1	0	0	1031	0	1032
24491	1	0	0	1031	0	1032
24492	0	1	0	1042	0	1043
24493	1056	0	0	1	0	1057
24494	963	0	2	1	0	966
24495	1456	1	0	0	0	1457
24496	0	0	0	1465	0	1465
24497	0	0	1095	1	0	1096
24498	1047	0	1	0	0	1048
24499	0	0	1	1112	0	1113
24500	1104	1	0	1	0	1106
24501	0	0	0	1098	0	1098
24502	0	1020	0	1	0	1021
24503	0	1070	1	1	0	1072
24504	1	0	0	1119	0	1120
24505	1	0	0	1104	0	1105
24506	0	0	0	1109	0	1109
24507	0	1048	2	1	0	1051
24508	1117	0	0	0	0	1117
24509	0	1064	0	1	0	1065
24510	1	1	1794	1	0	1797
24511	0	1	1	1789	0	1791
24512	0	1783	1	4	0	1788
24513	0	1	0	1884	0	1885
24514	0	0	0	1835	0	1835
24515	0	0	1851	0	0	1851
24516	1670	0	0	1	0	1671
24517	1	1739	5	0	0	1745
24518	1881	0	0	1	0	1882
24519	1872	0	0	0	0	1872
24520	1864	0	0	0	0	1864
24521	2	0	1833	0	0	1835
24522	0	0	1	1797	0	1798
24523	0	0	0	1870	0	1870
24524	1	0	1834	0	0	1835
24525	1530	4	2	0	0	1536
24526	0	1	1838	0	0	1839
24527	0	0	1828	0	0	1828
24528	0	1700	6	1	0	1707
24529	0	0	0	1856	0	1856
24530	3	1	1821	0	0	1825
24531	1723	0	3	0	0	1726
24532	1814	0	0	0	0	1814
24533	0	0	1822	0	0	1822
24534	0	0	0	1780	0	1780
24535	2	1	1847	0	0	1850
24536	0	1693	1	3	0	1697
24537	1867	0	0	0	0	1867
24538	1843	0	0	1	0	1844
24539	1823	0	0	0	0	1823
24540	0	0	0	1810	0	1810
24541	0	0	0	1837	0	1837
24542	0	1	1815	0	0	1816
24543	1693	0	0	0	0	1693
24544	0	0	0	1839	0	1839
24545	1819	0	1	0	0	1820
24546	2	1	1835	0	0	1838
24547	0	1	1800	0	0	1801
24548	0	2	1	1662	0	1665
24549	0	0	0	1824	0	1824
24550	0	0	1799	0	0	1799
24551	1669	1	1	1	0	1672
24552	0	0	1	1829	0	1830
24553	0	1723	3	1	0	1727
24554	1841	0	0	0	0	1841
24555	0	1748	3	4	0	1755
24556	1803	0	0	0	0	1803
24557	1	0	1828	0	0	1829
24558	0	2	1745	1	0	1748
24559	0	1730	2	1	0	1733
24560	1807	0	1	0	0	1808
24561	1	2	1777	0	0	1780
24562	1685	1	1	1	0	1688
24563	0	1709	4	2	0	1715
24564	0	0	0	1838	0	1838
24565	0	0	0	1820	0	1820
24566	0	1687	3	1	0	1691
24567	1834	0	0	0	0	1834
24568	1803	0	0	0	0	1803
24569	1798	0	0	2	0	1800
24570	1	2	1769	0	0	1772
24571	0	0	0	1752	0	1752
24572	0	0	1	1782	0	1783
24573	0	0	0	1818	0	1818
24574	0	1	1804	0	0	1805
24575	0	1636	3	2	0	1641
24576	1752	0	0	0	0	1752
24577	2	1	1762	1	0	1766
24578	1704	0	0	1	0	1705
24579	0	1654	6	2	0	1662
24580	1818	0	0	0	0	1818
24581	0	2	0	1778	0	1780
24582	1815	0	1	1	0	1817
24583	0	1	0	1785	0	1786
24584	0	1	1793	0	0	1794
24585	0	0	0	1782	0	1782
24586	1	0	1778	1	0	1780
24587	1636	0	0	1	0	1637
24588	0	1097	4	0	0	1101
24589	0	0	0	1189	0	1189
24590	0	1125	3	1	0	1129
24591	1170	0	0	0	0	1170
24592	1165	0	0	1	0	1166
24593	0	1120	1	0	0	1121
24594	1180	0	0	1	0	1181
24595	771	1	0	1	0	773
24596	0	0	0	747	0	747
24597	0	0	0	743	0	743
24598	782	0	0	0	0	782
24599	770	0	0	0	0	770
24600	1	1	0	761	0	763
24601	0	0	0	759	0	759
24602	1275	0	0	1	0	1276
24603	11	2	1250	0	0	1263
24604	1200	1	9	2	0	1212
24605	15	4	1211	0	0	1230
24606	1	1208	12	0	0	1221
24607	2	9	1	1225	0	1237
24608	7	3	1222	9	0	1241
24609	1	1204	17	2	0	1224
24610	563	10	2	1	0	576
24611	10	2	530	0	0	542
24612	567	4	8	1	0	580
24613	551	1	3	4	0	559
24614	562	2	4	0	0	568
24615	13	9	2	417	0	441
24616	6	555	2	8	0	571
24617	547	11	3	1	0	562
24618	16	3	533	1	0	553
24619	534	2	11	2	0	549
24620	17	6	483	1	0	507
24621	2	560	11	3	0	576
24622	5	14	1	528	0	548
24623	5	1	4	501	0	511
24624	3	545	3	8	0	559
24625	5	10	2	553	0	570
24626	1	6	515	11	0	533
24627	3	542	7	5	0	557
24628	0	11	2	559	0	572
24629	531	3	1	14	0	549
24630	558	5	2	3	0	568
24631	15	2	0	1133	0	1150
24632	2	1743	7	20	0	1772
24633	4	24	2	1787	0	1817
24634	0	4	4	1838	0	1846
24635	12	19	1963	24	0	2018
24636	4	2232	50	8	0	2294
24637	3	55	15	2302	0	2375
24638	5	33	2139	54	0	2231
24639	5	2225	56	25	0	2311
24640	2	63	22	2285	0	2372
24641	2260	20	6	63	0	2349
24642	58	2256	13	28	0	2355
24643	28	60	6	2296	0	2390
24644	2317	27	11	66	0	2421
24645	2342	20	4	34	0	2400
24646	2358	19	6	30	0	2413
24647	2548	14	11	28	0	2601
24648	83	18	14	2520	0	2635
24649	38	23	2422	79	0	2562
24650	25	17	69	2321	0	2432
24651	23	2391	34	76	0	2524
24652	2521	71	22	37	0	2651
24653	78	39	2456	27	0	2600
24654	2468	24	69	38	0	2599
24655	87	30	2450	25	0	2592
24656	51	22	67	2454	0	2594
24657	34	33	2425	74	0	2566
24658	47	17	66	2490	0	2620
24659	41	27	2416	81	0	2565
24660	50	14	65	2497	0	2626
24661	2440	23	48	81	0	2592
24662	87	2396	16	66	0	2565
24663	52	69	28	2437	0	2586
24664	47	34	18	2553	0	2652
24665	40	21	2414	101	0	2576
24666	40	25	2400	60	0	2525
24667	2378	15	104	36	0	2533
24668	79	2428	46	40	0	2593
24669	2491	67	41	38	0	2637
24670	2546	37	48	38	0	2669
24671	111	20	34	2304	0	2469
24672	49	2574	47	82	0	2752
24673	2668	75	34	57	0	2834
24674	2685	44	41	41	0	2811
24675	3588	24	23	58	0	3693
24676	3566	31	36	38	0	3671
24677	3588	21	25	53	0	3687
24678	110	27	3423	40	0	3600
24679	3464	20	82	47	0	3613
24680	111	34	3443	29	0	3617
24681	69	30	74	3383	0	3556
24682	53	24	46	3547	0	3670
24683	65	26	3386	104	0	3581
24684	3366	17	96	39	0	3518
24685	109	25	39	3480	0	3653
24686	77	23	31	3518	0	3649
24687	68	26	24	3561	0	3679
24688	66	12	33	3984	0	4095
24689	64	20	20	4124	0	4228
24690	60	21	3907	147	0	4135
24691	56	31	103	3914	0	4104
24692	64	13	3946	140	0	4163
24693	60	21	3809	80	0	3970
24694	3850	17	141	54	0	4062
24695	4030	9	68	76	0	4183
24696	4243	6	58	44	0	4351
24697	159	28	4078	54	0	4319
24698	80	22	4015	62	0	4179
24699	54	27	4002	73	0	4156
24700	63	3968	172	67	0	4270
24701	38	103	76	4196	0	4413
24702	3634	32	44	131	0	3841
24703	104	26	40	4065	0	4235
24704	49	4024	36	139	0	4248
24705	4121	86	36	98	0	4341
24706	133	47	29	4088	0	4297
24707	67	3982	38	128	0	4215
24708	61	98	26	4170	0	4355
24709	60	42	36	4242	0	4380
24710	4130	21	40	164	0	4355
24711	136	18	47	4185	0	4386
24712	79	31	3967	141	0	4218
24713	64	22	124	4006	0	4216
24714	63	3901	79	121	0	4164
24715	58	4094	43	84	0	4279
24716	46	131	48	4055	0	4280
24717	40	70	29	4011	0	4150
24718	35	3945	40	162	0	4182
24719	49	4047	34	96	0	4226
24720	32	4899	42	78	0	5051
24721	41	152	20	4664	0	4877
24722	35	4833	44	127	0	5039
24723	4853	125	20	99	0	5097
24724	116	89	4700	73	0	4978
24725	65	41	106	4671	0	4883
24726	42	4741	61	153	0	4997
24727	4842	113	33	98	0	5086
24728	118	81	4633	74	0	4906
24729	69	4686	123	71	0	4949
24730	4810	126	61	82	0	5079
24731	101	4031	32	32	0	4196
24732	47	3646	32	33	0	3758
24733	31	132	10	3587	0	3760
24734	27	3606	18	103	0	3754
24735	3131	75	3	28	0	3237
24736	50	33	7	3097	0	3187
24737	25	32	3063	59	0	3179
24738	19	31	3001	35	0	3086
24739	8	21	60	3048	0	3137
24740	13	23	3095	65	0	3196
24741	9	22	52	3093	0	3176
24742	3117	28	22	71	0	3238
24743	54	32	3042	34	0	3162
24744	31	16	52	3036	0	3135
24745	19	3027	34	59	0	3139
24746	13	71	19	3112	0	3215
24747	13	33	12	2936	0	2994
24748	13	2843	19	79	0	2954
24749	11	70	13	2959	0	3053
24750	21	33	14	2989	0	3057
24751	11	33	2871	80	0	2995
24752	11	2821	56	59	0	2947
24753	2932	67	31	33	0	3063
24754	57	38	22	2934	0	3051
24755	35	30	2881	66	0	3012
24756	27	29	51	2862	0	2969
24757	20	31	2832	80	0	2963
24758	2668	28	70	49	0	2815
24759	55	2819	38	45	0	2957
24760	23	64	31	2911	0	3029
24761	25	41	26	2984	0	3076
24762	2940	28	17	89	0	3074
24763	55	30	25	2941	0	3051
24764	38	20	2849	92	0	2999
24765	26	30	55	2799	0	2910
24766	23	2722	32	86	0	2863
24767	13	2827	29	67	0	2936
24768	20	2910	23	38	0	2991
24769	21	89	16	2895	0	3021
24770	14	59	2734	79	0	2886
24771	12	2735	57	67	0	2871
24772	2585	75	29	44	0	2733
24773	57	1949	16	718	0	2740
24774	2681	75	22	41	0	2819
24775	2009	49	19	37	0	2114
24776	77	40	1863	38	0	2018
24777	1920	37	56	45	0	2058
24778	1976	30	37	31	0	2074
24779	2300	36	22	36	0	2394
24780	2355	28	19	35	0	2437
24781	85	36	2211	33	0	2365
24782	2227	28	61	27	0	2343
24783	2273	30	32	35	0	2370
24784	79	2251	34	33	0	2397
24785	49	69	17	2288	0	2423
24786	37	51	18	2301	0	2407
24787	23	2260	26	93	0	2402
24788	1775	39	10	34	0	1858
24789	41	1756	10	21	0	1828
24790	1785	42	17	16	0	1860
24791	1748	32	14	17	0	1811
24792	44	1777	8	25	0	1854
24793	27	40	11	1801	0	1879
24794	26	32	1717	30	0	1805
24795	18	1744	25	38	0	1825
24796	16	13	27	1567	0	1623
24797	19	1549	21	16	0	1605
24798	20	1607	6	21	0	1654
24799	23	27	8	1591	0	1649
24800	23	31	1550	21	0	1625
24801	28	1501	18	28	0	1575
24802	20	1572	23	28	0	1643
24803	1093	3	0	0	0	1096
24804	1	1	0	1068	0	1070
24805	0	1	0	1037	0	1038
24806	0	1	0	1085	0	1086
24807	0	1	1071	3	0	1075
24808	0	0	1	1043	0	1044
24809	0	1008	3	1	0	1012
24810	1088	0	0	2	0	1090
24811	1	1	0	1059	0	1061
24812	2	0	1063	1	0	1066
24813	979	1	2	1	0	983
24814	1	0	1	1055	0	1057
24815	1	0	1061	1	0	1063
24816	0	1	999	1	0	1001
24817	951	1	2	0	0	954
24818	1032	0	2	0	0	1034
24819	1009	0	0	1	0	1010
24820	348	0	0	0	0	348
24821	2	0	358	0	0	360
24822	1	333	3	0	0	337
24823	363	1	1	0	0	365
24824	1	335	0	0	0	336
24825	361	1	0	0	0	362
24826	1	344	1	0	0	346
24827	1	1	0	361	0	363
24828	0	1	0	356	0	357
24829	0	0	0	356	0	356
24830	0	339	0	2	0	341
24831	0	345	0	1	0	346
24832	0	1	0	361	0	362
24833	0	340	0	1	0	341
24834	0	2	326	1	0	329
24835	0	1	1	331	0	333
24836	0	0	337	1	0	338
24837	337	0	1	1	0	339
24838	335	0	1	0	0	336
24839	2	0	337	0	0	339
24840	1	1	327	1	0	330
24841	0	0	2	331	0	333
24842	0	0	336	2	0	338
24843	0	0	1	335	0	336
24844	1	278	5	1	0	285
24845	0	1	0	344	0	345
24846	0	0	0	331	0	331
24847	0	0	0	333	0	333
24848	0	0	333	2	0	335
24849	0	0	2	323	0	325
24850	0	0	1	334	0	335
24851	0	0	0	344	0	344
24852	0	314	1	2	0	317
24853	1353	1	0	3	0	1357
24854	1343	1	0	1	0	1345
24855	1342	0	0	1	0	1343
24856	4	0	0	1322	0	1326
24857	1	0	1317	1	0	1319
24858	0	2	1293	1	0	1296
24859	0	1268	3	2	0	1273
24860	1347	1	1	0	0	1349
24861	1	1303	2	0	0	1306
24862	1346	1	0	0	0	1347
24863	2	1302	2	0	0	1306
24864	1345	1	0	0	0	1346
24865	1	1712	1	1	0	1715
24866	1	1	0	1761	0	1763
24867	0	1	1744	1	0	1746
24868	2	1	1703	1	0	1707
24869	0	1	2	1736	0	1739
24870	0	0	1	1746	0	1747
24871	1	0	0	1770	0	1771
24872	3	1	1760	2	0	1766
24873	2	0	1	1751	0	1754
24874	1740	0	1	2	0	1743
24875	1754	0	1	0	0	1755
24876	3	1720	2	3	0	1728
24877	1773	2	0	1	0	1776
24878	3	1725	3	0	0	1731
24879	1450	2	0	0	0	1452
24880	1452	0	1	0	0	1453
24881	1445	2	0	1	0	1448
24882	4	1	1680	0	0	1685
24883	1	5	1652	0	0	1658
24884	1689	0	1	1	0	1691
24885	1727	2	1	0	0	1730
24886	1	0	2	1715	0	1718
24887	0	0	0	1714	0	1714
24888	0	0	0	1718	0	1718
24889	0	0	1	1718	0	1719
24890	0	1	1	1990	0	1992
24891	1987	0	0	15	0	2002
24892	13	1	0	2001	0	2015
24893	7	4	2632	13	0	2656
24894	2849	3	90	9	0	2951
24895	2975	1	11	5	0	2992
24896	110	2852	9	4	0	2975
24897	16	2994	9	3	0	3022
24898	2904	103	5	0	0	3012
24899	106	2919	11	1	0	3037
24900	3586	110	7	4	0	3707
24901	3951	19	5	0	0	3975
24902	4048	17	2	8	0	4075
24903	256	17	0	3685	0	3958
24904	102	3768	5	185	0	4060
24905	3871	179	8	64	0	4122
24906	201	48	23	3861	0	4133
24907	91	30	22	4069	0	4212
24908	3886	18	10	242	0	4156
24909	244	3819	7	158	0	4228
24910	158	225	1	4439	0	4823
24911	4331	88	17	275	0	4711
24912	237	4345	86	68	0	4736
24913	4578	214	9	40	0	4841
24914	386	86	4015	22	0	4509
24915	4357	134	150	97	0	4738
24916	373	4416	43	40	0	4872
24917	4528	237	24	121	0	4910
24918	4553	171	85	335	0	5144
24919	747	4319	16	109	0	5191
24920	4680	199	5	376	0	5260
24921	357	4364	317	128	0	5166
24922	4758	326	52	119	0	5255
24923	693	183	6	4366	0	5248
24924	255	449	3	4555	0	5262
24925	192	418	4	4719	0	5333
24926	483	121	4263	352	0	5219
24927	302	351	191	4448	0	5292
24928	405	174	4325	394	0	5298
24929	548	134	202	4369	0	5253
24930	629	4306	71	302	0	5308
24931	191	290	103	4858	0	5442
24932	254	417	4730	355	0	5756
24933	607	153	4930	75	0	5765
24934	269	249	230	5126	0	5874
24935	4814	269	79	643	0	5805
24936	5470	86	44	166	0	5766
24937	451	5178	33	128	0	5790
24938	290	363	23	5157	0	5833
24939	577	95	4780	330	0	5782
24940	328	420	225	4865	0	5838
24941	481	167	4703	390	0	5741
24942	4812	119	529	259	0	5719
24943	681	99	125	4972	0	5877
24944	170	447	4738	439	0	5794
24945	451	99	305	4955	0	5810
24946	484	112	139	5146	0	5881
24947	218	405	4798	341	0	5762
24948	379	120	228	5096	0	5823
24949	4951	419	78	418	0	5866
24950	5319	183	66	284	0	5852
24951	424	97	209	5138	0	5868
24952	4925	53	203	715	0	5896
24953	362	40	3812	567	0	4781
24954	245	117	4053	245	0	4660
24955	3929	155	332	386	0	4802
24956	4091	117	407	224	0	4839
24957	326	109	231	4132	0	4798
24958	191	351	230	4076	0	4848
24959	118	166	3703	801	0	4788
24960	234	68	620	3277	0	4199
24961	255	3663	475	339	0	4732
24962	3741	273	137	635	0	4786
24963	4146	61	136	356	0	4699
24964	646	3713	194	263	0	4816
24965	3512	506	90	349	0	4457
24966	3509	119	280	386	0	4294
24967	376	3340	425	267	0	4408
24968	3488	287	131	485	0	4391
24969	395	3379	432	208	0	4414
24970	3832	235	163	266	0	4496
24971	402	84	3403	493	0	4382
24972	121	52	737	3515	0	4425
24973	170	40	231	4003	0	4444
24974	331	53	84	4024	0	4492
24975	3632	139	348	375	0	4494
24976	292	86	99	4014	0	4491
24977	497	59	3355	401	0	4312
24978	3774	52	398	216	0	4440
24979	346	49	220	3712	0	4327
24980	566	3299	102	302	0	4269
24981	287	3491	328	194	0	4300
24982	179	282	395	2680	0	3536
24983	366	181	105	3350	0	4002
24984	470	81	134	3468	0	4153
24985	199	53	3002	728	0	3982
24986	70	3125	243	428	0	3866
24987	3201	228	384	214	0	4027
24988	3223	108	112	429	0	3872
24989	379	3323	61	239	0	4002
24990	125	2861	34	91	0	3111
24991	75	211	45	2872	0	3203
24992	81	81	2746	239	0	3147
24993	2052	37	106	80	0	2275
24994	1875	26	59	56	0	2016
24995	129	26	30	1840	0	2025
24996	82	15	21	1908	0	2026
24997	1861	9	22	150	0	2042
24998	109	16	1709	106	0	1940
24999	1770	12	109	57	0	1948
25000	120	1788	61	21	0	1990
25001	9	9	3	863	0	884
25002	7	869	4	15	0	895
25003	908	5	8	8	0	929
25004	7	6	4	886	0	903
25005	5	3	6	882	0	896
25006	9	862	8	9	0	888
25007	896	6	2	18	0	922
25008	890	4	2	6	0	902
25009	15	6	846	9	0	876
25010	6	5	418	13	0	442
25011	438	4	11	4	0	457
25012	12	4	419	7	0	442
25013	12	5	417	8	0	442
25014	431	9	6	6	0	452
25015	8	5	411	13	0	437
25016	10	3	8	426	0	447
25017	6	2	2	434	0	444
25018	435	0	4	15	0	454
25019	14	1	419	10	0	444
25020	436	6	8	9	0	459
25021	14	3	5	432	0	454
25022	440	4	4	9	0	457
25023	441	9	7	4	0	461
25024	433	7	2	8	0	450
25025	6	10	3	438	0	457
25026	439	6	2	9	0	456
25027	14	2	3	435	0	454
25028	10	5	1	437	0	453
25029	7	2	4	441	0	454
25030	12	2	2	443	0	459
25031	442	9	6	5	0	462
25032	40	0	0	0	0	40
25033	0	0	438	0	0	438
25034	452	0	25	0	0	477
25035	485	0	5	0	0	490
25036	30	0	1	438	0	469
25037	6	442	2	26	0	476
25038	451	26	1	4	0	482
25039	29	5	3	451	0	488
25040	454	1	1	25	0	481
25041	32	451	3	7	0	493
25042	461	27	0	4	0	492
25043	33	7	0	438	0	478
25044	9	441	0	30	0	480
25045	451	28	0	8	0	487
25046	32	435	2	2	0	471
25047	9	467	0	5	0	481
25048	459	33	3	2	0	497
25049	29	10	426	3	0	468
25050	459	4	28	1	0	492
25051	33	4	8	455	0	500
25052	13	8	442	27	0	490
25053	13	4	34	457	0	508
25054	12	8	22	482	0	524
25055	27	6	437	36	0	506
25056	467	3	29	16	0	515
25057	37	7	10	469	0	523
25058	16	15	4	488	0	523
25059	23	6	3	492	0	524
25060	464	4	4	54	0	526
25061	46	7	435	18	0	506
25062	21	20	463	7	0	511
25063	21	10	33	466	0	530
25064	11	14	431	44	0	500
25065	454	17	27	16	0	514
25066	47	452	9	5	0	513
25067	437	46	10	4	0	497
25068	39	22	11	409	0	481
25069	26	423	15	28	0	492
25070	14	26	25	421	0	486
25071	20	598	10	41	0	669
25072	7	30	9	636	0	682
25073	11	7	600	45	0	663
25074	6	8	607	34	0	655
25075	10	602	36	27	0	675
25076	614	29	20	21	0	684
25077	46	12	5	602	0	665
25078	11	5	6	645	0	667
25079	1018	5	9	56	0	1088
25080	1023	2	10	31	0	1066
25081	48	6	19	1017	0	1090
25082	19	6	1000	32	0	1057
25083	9	974	50	15	0	1048
25084	17	31	18	1015	0	1081
25085	29	8	17	988	0	1042
25086	31	985	8	35	0	1059
25087	1044	44	3	18	0	1109
25088	50	19	986	15	0	1070
25089	12	17	30	1024	0	1083
25090	9	20	12	1045	0	1086
25091	7	17	998	62	0	1084
25092	9	27	33	988	0	1057
25093	1036	13	19	47	0	1115
25094	1028	11	22	20	0	1081
25095	1031	13	18	18	0	1080
25096	47	1000	8	16	0	1071
25097	1048	34	5	19	0	1106
25098	46	11	6	1039	0	1102
25099	31	5	14	1027	0	1077
25100	43	973	9	42	0	1067
25101	1208	34	10	22	0	1274
25102	1213	14	11	31	0	1269
25103	1211	17	17	24	0	1269
25104	1228	20	4	27	0	1279
25105	1237	10	6	34	0	1287
25106	77	17	1138	26	0	1258
25107	1194	23	42	19	0	1278
25108	1248	10	25	16	0	1299
25109	1235	3	25	29	0	1292
25110	80	4	15	1186	0	1285
25111	49	3	18	1227	0	1297
25112	38	8	1124	62	0	1232
25113	1005	6	51	40	0	1102
25114	71	1117	22	24	0	1234
25115	55	1128	18	23	0	1224
25116	47	59	1105	20	0	1231
25117	30	1134	43	16	0	1223
25118	27	1181	20	26	0	1254
25119	14	64	12	1107	0	1197
25120	11	1146	12	60	0	1229
25121	1170	74	9	20	0	1273
25122	1195	31	7	15	0	1248
25123	80	21	12	1154	0	1267
25124	54	13	1126	49	0	1242
25125	1122	13	53	20	0	1208
25126	83	13	1138	11	0	1245
25127	49	9	1151	18	0	1227
25128	45	4	63	1061	0	1173
25129	39	2	27	1154	0	1222
25130	40	4	1133	62	0	1239
25131	25	1066	50	46	0	1187
25132	17	1134	38	39	0	1228
25133	965	18	7	9	0	999
25134	962	11	5	4	0	982
25135	21	12	938	1	0	972
25136	930	7	14	0	0	951
25137	1990	2	8	3	0	2003
25138	28	2	7	1936	0	1973
25139	19	2	6	1955	0	1982
25140	13	2	1	1975	0	1991
25141	1994	1	2	26	0	2023
25142	1945	1	1	18	0	1965
25143	1966	0	0	13	0	1979
25144	32	1	1	1967	0	2001
25145	25	1	1914	15	0	1955
25146	1860	0	13	10	0	1883
25147	1985	1	10	7	0	2003
25148	28	1	6	1944	0	1979
25149	19	1888	8	22	0	1937
25150	15	13	3	1985	0	2016
25151	11	1918	1	18	0	1948
25152	8	16	3	1980	0	2007
25153	6	1908	2	21	0	1937
25154	1936	18	2	15	0	1971
25155	19	13	1	1934	0	1967
25156	18	1909	7	17	0	1951
25157	12	19	1878	10	0	1919
25158	1759	14	10	8	0	1791
25159	19	7	11	1952	0	1989
25160	13	1927	10	17	0	1967
25161	10	23	7	1974	0	2014
25162	12	1902	3	18	0	1935
25163	10	2190	5	19	0	2224
25164	2263	25	2	12	0	2302
25165	2225	14	4	10	0	2253
25166	27	12	2216	5	0	2260
25167	2161	8	17	1	0	2187
25168	2244	8	12	3	0	2267
25169	30	2153	12	6	0	2201
25170	18	11	13	2243	0	2285
25171	14	13	4	2061	0	2092
25172	13	15	1996	22	0	2046
25173	12	11	1768	18	0	1809
25174	1941	5	21	17	0	1984
25175	2041	4	17	14	0	2076
25176	2041	1	13	4	0	2059
25177	34	1	2003	4	0	2042
25178	24	4	16	1956	0	2000
25179	1727	4	13	15	0	1759
25180	23	2	10	1709	0	1744
25181	15	2	1677	20	0	1714
25182	1516	4	18	20	0	1558
25183	19	13	2394	16	0	2442
25184	17	2303	20	12	0	2352
25185	2504	16	12	6	0	2538
25186	25	9	2440	3	0	2477
25187	19	6	20	2418	0	2463
25188	2533	6	13	14	0	2566
25189	24	3	11	2486	0	2524
25190	2527	2	7	23	0	2559
25191	21	4	4	2502	0	2531
25192	2520	2	4	27	0	2553
25193	2490	4	0	24	0	2518
25194	2482	2	3	17	0	2504
25195	2483	4	2	12	0	2501
25196	37	6	1	2398	0	2442
25197	28	7	2377	12	0	2424
25198	24	5	2304	11	0	2344
25199	14	2245	27	11	0	2297
25200	10	2352	22	9	0	2393
25201	2312	0	1	0	0	2313
25202	0	1	0	2245	0	2246
25203	1	2	2249	0	0	2252
25204	0	3	2133	0	0	2136
25205	0	2	0	2245	0	2247
25206	2365	1	0	0	0	2366
25207	0	2165	4	2	0	2171
25208	2355	1	0	1	0	2357
25209	2	1	1	2278	0	2282
25210	0	0	1	2281	0	2282
25211	0	0	1	2250	0	2251
25212	1	0	2257	3	0	2261
25213	0	2	2136	1	0	2139
25214	3	1974	12	1	0	1990
25215	0	1	1	2285	0	2287
25216	2296	0	0	1	0	2297
25217	0	5	2144	2	0	2151
25218	0	2	2114	1	0	2117
25219	0	1	2	2123	0	2126
25220	1	1	2	2237	0	2241
25221	0	0	0	2270	0	2270
25222	1	2	0	2467	0	2470
25223	2523	0	1	7	0	2531
25224	6	1	2	2461	0	2470
25225	2491	1	1	7	0	2500
25226	5	0	2467	1	0	2473
25227	2	2333	8	5	0	2348
25228	0	4	1	2454	0	2459
25229	3	2	2407	6	0	2418
25230	1	2	2292	3	0	2298
25231	3	2234	14	3	0	2254
25232	2	4	2	2454	0	2462
25233	2	2	1	2257	0	2262
25234	2	1	2217	9	0	2229
25235	2025	1	9	3	0	2038
25236	5	1	5	2219	0	2230
25237	1	2	2	1320	0	1325
25238	1	3	1305	8	0	1317
25239	1	1205	7	3	0	1216
25240	0	1278	5	2	0	1285
25241	1333	7	1	2	0	1343
25242	6	1	1	1330	0	1338
25243	1658	0	2	10	0	1670
25244	39	4	1584	3	0	1630
25245	11	1	36	1634	0	1682
25246	1649	2	9	40	0	1700
25247	1675	3	6	14	0	1698
25248	51	2	4	1644	0	1701
25249	20	3	1637	44	0	1704
25250	11	4	1623	15	0	1653
25251	5	2	52	1609	0	1668
25252	8	6	1599	44	0	1657
25253	1508	1	45	15	0	1569
25254	41	1506	22	12	0	1581
25255	1649	33	11	8	0	1701
25256	1655	13	10	2	0	1680
25257	51	5	6	1588	0	1650
25258	16	3	6	1660	0	1685
25259	2593	1	7	53	0	2654
25260	44	6	4	2498	0	2552
25261	20	9	2517	48	0	2594
25262	13	2388	42	20	0	2463
25263	9	40	11	2308	0	2368
25264	5	13	2	2316	0	2336
25265	10	8	3	2328	0	2349
25266	10	7	2210	64	0	2291
25267	7	2125	44	31	0	2207
25268	9	39	16	2321	0	2385
25269	6	15	2287	50	0	2358
25270	5	8	41	2266	0	2320
25271	2274	4	15	57	0	2350
25272	47	3	10	2304	0	2364
25273	19	9	2273	53	0	2354
25274	2730	5	40	25	0	2800
25275	60	2735	33	18	0	2846
25276	13	2819	19	17	0	2868
25277	2895	65	6	15	0	2981
25278	70	23	2857	10	0	2960
25279	25	11	58	2788	0	2882
25280	18	5	16	2884	0	2923
25281	16	9	2766	76	0	2867
25282	8	2683	65	35	0	2791
25283	12	55	19	2099	0	2185
25284	12	18	2163	66	0	2259
25285	9	14	62	2189	0	2274
25286	2187	12	20	76	0	2295
25287	65	11	2121	28	0	2225
25288	19	10	63	2178	0	2270
25289	10	6	18	2258	0	2292
25290	10	6	2102	86	0	2204
25291	7	10	71	2001	0	2089
25292	7	2065	27	82	0	2181
25293	13	70	24	1788	0	1895
25294	9	2121	18	59	0	2207
25295	2196	54	11	43	0	2304
25296	2151	21	28	20	0	2220
25297	79	9	2145	31	0	2264
25298	34	14	2083	29	0	2160
25299	31	12	2062	14	0	2119
25300	24	2023	82	27	0	2156
25301	9	66	32	2167	0	2274
25302	21	20	2093	62	0	2196
25303	17	15	72	2134	0	2238
25304	9	12	33	2171	0	2225
25305	22	8	2034	84	0	2148
25306	23	19	75	2081	0	2198
25307	13	17	26	2076	0	2132
25308	21	2020	33	81	0	2155
25309	16	58	19	2133	0	2226
25310	7	23	13	2204	0	2247
25311	25	11	2092	103	0	2231
25312	14	12	76	2118	0	2220
25313	10	8	2124	107	0	2249
25314	12	26	2053	37	0	2128
25315	2064	15	74	47	0	2200
25316	65	11	33	1958	0	2067
25317	33	2028	25	88	0	2174
25318	19	2152	27	43	0	2241
25319	10	92	23	2127	0	2252
25320	19	34	2039	84	0	2176
25321	21	2034	85	50	0	2190
25322	6	63	35	1894	0	1998
25323	24	33	1761	75	0	1893
25324	19	1762	78	34	0	1893
25325	1915	60	35	41	0	2051
25326	1945	21	27	37	0	2030
25327	1928	26	18	28	0	2000
25328	75	25	10	1901	0	2011
25329	36	26	24	2540	0	2626
25330	17	19	27	2623	0	2686
25331	10	23	2410	127	0	2570
25332	2441	18	81	71	0	2611
25333	93	17	35	2480	0	2625
25334	38	38	2383	102	0	2561
25335	2484	28	84	60	0	2656
25336	2575	21	48	51	0	2695
25337	106	57	1988	39	0	2190
25338	2447	18	78	54	0	2597
25339	103	2418	53	41	0	2615
25340	37	75	2482	59	0	2653
25341	2421	34	106	56	0	2617
25342	99	2480	59	49	0	2687
25343	16	48	20	2098	0	2182
25344	21	2156	20	66	0	2263
25345	14	52	29	2236	0	2331
25346	19	21	2141	72	0	2253
25347	2047	10	60	42	0	2159
25348	49	21	2108	37	0	2215
25349	20	2018	63	51	0	2152
25350	15	2164	38	34	0	2251
25351	2187	63	37	25	0	2312
25352	51	27	2158	39	0	2275
25353	24	24	57	2152	0	2257
25354	20	22	2120	64	0	2226
25355	24	2122	61	38	0	2245
25356	30	54	38	1863	0	1985
25357	21	2113	42	44	0	2220
25358	2160	53	35	34	0	2282
25359	1407	21	30	35	0	1493
25360	1413	26	36	27	0	1502
25361	53	39	1377	24	0	1493
25362	22	13	1379	41	0	1455
25363	1387	19	63	27	0	1496
25364	57	18	1323	40	0	1438
25365	27	11	60	1146	0	1244
25366	15	1347	38	62	0	1462
25367	1911	50	31	42	0	2034
25368	1919	17	28	38	0	2002
25369	1956	24	16	29	0	2025
25370	58	12	18	1933	0	2021
25371	15	15	32	1986	0	2048
25372	1902	16	32	73	0	2023
25373	58	1889	30	48	0	2025
25374	1246	20	3	5	0	1274
25375	29	3	2	1240	0	1274
25376	6	3	5	1261	0	1275
25377	1233	0	5	28	0	1266
25378	29	1220	5	5	0	1259
25379	1232	24	2	5	0	1263
25380	29	1213	4	3	0	1249
25381	1251	21	2	7	0	1281
25382	27	5	0	1251	0	1283
25383	1250	2	3	19	0	1274
25384	2025	7	0	6	0	2038
25385	1997	3	0	7	0	2007
25386	85	2181	7	3	0	2276
25387	34	83	2161	3	0	2281
25388	2261	14	71	8	0	2354
25389	2298	16	13	1	0	2328
25390	101	2220	15	4	0	2340
25391	43	76	4	2285	0	2408
25392	30	26	6	2409	0	2471
25393	2304	18	9	94	0	2425
25394	88	13	2	2343	0	2446
25395	31	13	2240	101	0	2385
25396	28	19	2264	27	0	2338
25397	2270	3	92	36	0	2401
25398	86	5	32	2310	0	2433
25399	37	3	18	2373	0	2431
25400	28	3	8	2432	0	2471
25401	17	6	2260	116	0	2399
25402	18	5	90	2301	0	2414
25403	30	3	25	2368	0	2426
25404	17	6	24	2432	0	2479
25405	2338	5	8	125	0	2476
25406	100	15	4	2371	0	2490
25407	28	12	2272	116	0	2428
25408	2305	11	93	47	0	2456
25409	108	14	2243	37	0	2402
25410	2268	14	99	32	0	2413
25411	2242	17	33	26	0	2318
25412	112	16	22	2321	0	2471
25413	58	2264	26	102	0	2450
25414	47	87	14	2318	0	2466
25415	28	19	28	2338	0	2413
25416	29	2271	29	119	0	2448
25417	2256	93	27	47	0	2423
25418	96	2211	19	54	0	2380
25419	2289	112	17	30	0	2448
25420	2327	22	9	57	0	2415
25421	105	24	16	2251	0	2396
25422	43	24	14	2368	0	2449
25423	43	15	2202	130	0	2390
25424	28	24	2191	63	0	2306
25425	2243	11	99	46	0	2399
25426	2315	15	38	38	0	2406
25427	127	2209	33	43	0	2412
25428	62	84	22	2296	0	2464
25429	34	19	1570	84	0	1707
25430	30	15	73	1626	0	1744
25431	1597	8	35	91	0	1731
25432	1629	7	28	36	0	1700
25433	99	1548	15	35	0	1697
25434	40	70	12	1613	0	1735
25435	32	30	13	1638	0	1713
25436	28	23	7	1694	0	1752
25437	27	18	1523	114	0	1682
25438	1488	22	61	61	0	1632
25439	1628	16	16	46	0	1706
25440	104	18	1515	30	0	1667
25441	57	1520	68	33	0	1678
25442	1611	71	23	38	0	1743
25443	1654	17	32	36	0	1739
25444	101	22	1549	31	0	1703
25445	59	7	1862	27	0	1955
25446	49	9	85	1846	0	1989
25447	44	22	1848	78	0	1992
25448	1852	10	91	34	0	1987
25449	1925	23	30	26	0	2004
25450	1944	8	32	37	0	2021
25451	107	17	21	1750	0	1895
25452	56	1804	25	95	0	1980
25453	1894	73	23	37	0	2027
25454	1945	23	15	42	0	2025
25455	104	30	1826	35	0	1995
25456	58	19	1775	37	0	1889
25457	1767	9	86	37	0	1899
25458	101	15	29	1872	0	2017
25459	52	11	1846	96	0	2005
25460	47	1793	88	35	0	1963
25461	38	71	37	1881	0	2027
25462	1847	22	35	85	0	1989
25463	90	1840	29	35	0	1994
25464	46	73	29	1833	0	1981
25465	43	1775	35	82	0	1935
25466	29	1878	29	41	0	1977
25467	29	85	22	1409	0	1545
25468	31	33	25	1432	0	1521
25469	32	1879	24	94	0	2029
25470	1933	91	20	45	0	2089
25471	119	34	1835	39	0	2027
25472	1893	30	79	30	0	2032
25473	125	18	30	1889	0	2062
25474	56	27	19	1955	0	2057
25475	50	10	24	1981	0	2065
25476	37	13	28	1989	0	2067
25477	33	19	1853	123	0	2028
25478	50	13	89	1891	0	2043
25479	32	13	43	1859	0	1947
25480	32	1853	29	120	0	2034
25481	29	97	1774	58	0	1958
25482	25	1850	86	60	0	2021
25483	27	113	1848	47	0	2035
25484	8	1066	29	15	0	1118
25485	261	26	13	806	0	1106
25486	800	6	0	19	0	825
25487	15	798	1	9	0	823
25488	5	18	1	817	0	841
25489	0	8	779	19	0	806
25490	3	798	16	7	0	824
25491	796	17	6	2	0	821
25492	804	6	2	3	0	815
25493	20	795	2	4	0	821
25494	6	19	764	1	0	790
25495	775	8	16	1	0	800
25496	18	2	7	812	0	839
25497	812	3	2	18	0	835
25498	17	786	3	9	0	815
25499	7	813	2	5	0	827
25500	0	21	781	7	0	809
25501	783	7	16	4	0	810
25502	18	4	5	811	0	838
25503	819	2	4	17	0	842
25504	18	810	1	7	0	836
25505	818	17	2	5	0	842
25506	828	8	3	4	0	843
25507	26	9	1667	3	0	1705
25508	5	1675	21	4	0	1705
25509	1	1744	7	3	0	1755
25510	3	23	0	1743	0	1769
25511	2	1728	3	17	0	1750
25512	1745	19	1	5	0	1770
25513	17	1734	4	3	0	1758
25514	8	18	2	1770	0	1798
25515	3	1725	3	15	0	1746
25516	6	1735	3	6	0	1750
25517	6	1751	4	1	0	1762
25518	6	18	2	1772	0	1798
25519	3	12	2	1779	0	1796
25520	3	4	4	1767	0	1778
25521	5	1705	4	22	0	1736
25522	6	20	1719	11	0	1756
25523	5	8	1713	4	0	1730
25524	1677	11	21	3	0	1712
25525	25	9	6	1718	0	1758
25526	11	7	1750	20	0	1788
25527	14	3	1721	10	0	1748
25528	6	1946	25	14	0	1991
25529	6	17	6	2010	0	2039
25530	5	12	1	2239	0	2257
25531	2222	7	6	36	0	2271
25532	25	3	7	2195	0	2230
25533	7	6	9	2223	0	2245
25534	3	6	2192	34	0	2235
25535	3	11	19	2147	0	2180
25536	4	9	13	2191	0	2217
25537	3	16	2192	27	0	2238
25538	5	7	2195	14	0	2221
25539	2	2131	34	6	0	2173
25540	2	26	2165	16	0	2209
25541	10	17	16	2125	0	2168
25542	5	18	9	1982	0	2014
25543	7	12	2174	29	0	2222
25544	4	2082	27	17	0	2130
25545	1906	23	12	10	0	1951
25546	21	1867	4	11	0	1903
25547	13	21	6	1910	0	1950
25548	11	16	5	1926	0	1958
25549	6	1884	15	24	0	1929
25550	10	20	6	1934	0	1970
25551	10	9	9	1939	0	1967
25552	10	10	1892	29	0	1941
25553	6	1831	23	11	0	1871
25554	6	29	11	1931	0	1977
25555	6	18	1889	22	0	1935
25556	12	4	23	1879	0	1918
25557	12	6	9	1891	0	1918
25558	12	5	4	1932	0	1953
25559	9	11	3	1911	0	1934
25560	8	9	4	1889	0	1910
25561	11	1866	4	24	0	1905
25562	1859	18	13	14	0	1904
25563	24	15	1857	5	0	1901
25564	1593	15	23	14	0	1645
25565	21	9	1855	11	0	1896
25566	8	1777	19	10	0	1814
25567	11	23	1800	9	0	1843
25568	8	1801	23	12	0	1844
25569	0	2	1	1308	0	1311
25570	0	2	0	1343	0	1345
25571	1	1306	6	0	0	1313
25572	0	1331	1	1	0	1333
25573	1368	1	0	1	0	1370
25574	1337	0	1	1	0	1339
25575	1337	2	1	0	0	1340
25576	1344	0	0	0	0	1344
25577	0	0	0	1351	0	1351
25578	0	1302	6	1	0	1309
25579	1362	1	1	0	0	1364
25580	0	0	0	1779	0	1779
25581	1747	0	1	1	0	1749
25582	1706	1	0	3	0	1710
25583	0	1707	1	0	0	1708
25584	0	1748	0	2	0	1750
25585	0	1739	1	0	0	1740
25586	0	2	0	1773	0	1775
25587	0	1720	4	1	0	1725
25588	1766	0	0	0	0	1766
25589	1698	0	1	0	0	1699
25590	1719	2	1	1	0	1723
25591	1730	0	0	2	0	1732
25592	1730	0	0	1	0	1731
25593	0	1	1702	0	0	1703
25594	1709	0	0	1	0	1710
25595	1	6	2044	0	0	2051
25596	2008	0	7	2	0	2017
25597	9	1	0	2049	0	2059
25598	0	3	2051	9	0	2063
25599	2	4	1989	0	0	1995
25600	0	1988	16	3	0	2007
25601	2065	9	2	1	0	2077
25602	2027	0	2	6	0	2035
25603	8	2194	10	1	0	2213
25604	2	15	3	4223	0	4243
25605	4999	3	1	82	0	5085
25606	115	28	5670	16	0	5829
25607	36	5172	128	17	0	5353
25608	5156	136	35	20	0	5347
25609	147	5223	44	26	0	5440
25610	71	162	29	5076	0	5338
25611	40	5235	44	127	0	5446
25612	39	199	10	5125	0	5373
25613	48	5063	22	151	0	5284
25614	13	5338	14	64	0	5429
25615	5205	194	4	77	0	5480
25616	5353	106	10	40	0	5509
25617	175	81	5181	59	0	5496
25618	97	84	5168	20	0	5369
25619	81	74	5258	13	0	5426
25620	82	45	205	5165	0	5497
25621	71	57	5627	138	0	5893
25622	30	40	236	5552	0	5858
25623	23	32	107	5647	0	5809
25624	14	5493	106	201	0	5814
25625	5601	166	51	129	0	5947
25626	151	6480	62	82	0	6775
25627	55	195	25	7754	0	8029
25628	68	79	25	7532	0	7704
25629	65	91	29	7644	0	7829
25630	73	49	7635	242	0	7999
25631	36	60	180	7672	0	7948
25632	32	43	87	7874	0	8036
25633	30	35	71	8015	0	8151
25634	29	54	7613	292	0	7988
25635	22	8196	193	164	0	8575
25636	8480	167	63	163	0	8873
25637	8280	89	58	130	0	8557
25638	183	8281	47	117	0	8628
25639	94	204	59	8503	0	8860
25640	86	118	23	8706	0	8933
25641	106	77	8241	232	0	8656
25642	68	8106	171	147	0	8492
25643	52	182	77	8617	0	8928
25644	25	76	8479	251	0	8831
25645	13	68	202	8398	0	8681
25646	19	60	109	8545	0	8733
25647	32	74	8403	291	0	8800
25648	30	60	194	8377	0	8661
25649	40	59	98	8496	0	8693
25650	57	59	8389	295	0	8800
25651	45	65	184	8424	0	8718
25652	39	53	106	8391	0	8589
25653	22	42	74	8820	0	8958
25654	25	42	8366	336	0	8769
25655	19	40	212	8558	0	8829
25656	8365	36	99	334	0	8834
25657	8443	33	97	200	0	8773
25658	184	8642	83	204	0	9113
25659	9087	159	78	151	0	9475
25660	232	73	9491	130	0	9926
25661	128	75	180	9611	0	9994
25662	114	60	86	9611	0	9871
25663	74	70	77	9972	0	10193
25664	9727	36	63	313	0	10139
25665	152	9466	102	219	0	9939
25666	64	158	48	9818	0	10088
25667	56	9500	68	303	0	9927
25668	9732	206	55	177	0	10170
25669	215	9547	64	134	0	9960
25670	9712	246	33	113	0	10104
25671	214	9428	41	136	0	9819
25672	117	9588	62	101	0	9868
25673	115	227	61	9702	0	10105
25674	71	142	52	9828	0	10093
25675	88	98	41	9761	0	9988
25676	37	105	42	9891	0	10075
25677	58	109	9374	334	0	9875
25678	45	9246	181	244	0	9716
25679	38	197	75	9617	0	9927
25680	43	9000	84	288	0	9415
25681	70	234	8929	173	0	9406
25682	65	121	201	8898	0	9285
25683	63	133	64	9418	0	9678
25684	56	109	9046	288	0	9499
25685	33	8864	222	170	0	9289
25686	40	187	111	9303	0	9641
25687	41	82	9121	333	0	9577
25688	22	8775	230	230	0	9257
25689	24	186	106	9270	0	9586
25690	29	141	9020	288	0	9478
25691	38	126	8865	165	0	9194
25692	40	8574	230	145	0	8989
25693	38	9528	131	126	0	9823
25694	43	261	106	10693	0	11103
25695	36	137	103	10590	0	10866
25696	37	117	10120	369	0	10643
25697	9158	114	268	198	0	9738
25698	9763	108	110	180	0	10161
25699	289	80	9807	215	0	10391
25700	126	9482	284	168	0	10060
25701	117	9835	159	126	0	10237
25702	125	9892	118	125	0	10260
25703	107	9457	146	92	0	9802
25704	26	998	45	6828	0	7897
25705	12	68	11	7369	0	7460
25706	8	50	12	7428	0	7498
25707	9	54	6	7448	0	7517
25708	9	7033	22	212	0	7276
25709	12	132	8	7407	0	7559
25710	9	7059	23	203	0	7294
25711	8	160	6	7465	0	7639
25712	7215	76	9	209	0	7509
25713	137	49	13	7334	0	7533
25714	53	7069	22	210	0	7354
25715	47	154	24	7419	0	7644
25716	62	49	13	7524	0	7648
25717	47	45	13	7576	0	7681
25718	7174	56	18	262	0	7510
25719	139	90	4	7430	0	7663
25720	53	81	6869	280	0	7283
25721	31	6641	135	189	0	6996
25722	51	166	51	7886	0	8154
25723	68	54	35	8007	0	8164
25724	47	53	38	8082	0	8220
25725	7645	75	22	374	0	8116
25726	196	107	6441	225	0	6969
25727	77	74	165	5957	0	6273
25728	55	5842	67	321	0	6285
25729	63	223	28	6144	0	6458
25730	5303	104	32	336	0	5775
25731	189	5461	36	217	0	5903
25732	80	227	16	5653	0	5976
25733	40	129	12	5766	0	5947
25734	44	5362	17	413	0	5836
25735	50	232	14	5098	0	5394
25736	46	102	16	5248	0	5412
25737	56	121	4406	384	0	4967
25738	28	4744	183	256	0	5211
25739	4896	237	84	186	0	5403
25740	209	115	4730	211	0	5265
25741	4888	84	204	179	0	5355
25742	240	79	4731	191	0	5241
25743	130	60	215	5031	0	5436
25744	4945	51	112	342	0	5450
25745	260	72	79	5042	0	5453
25746	4978	50	63	366	0	5457
25747	5093	84	63	221	0	5461
25748	5035	82	30	204	0	5351
25749	346	4788	34	169	0	5337
25750	180	222	27	5005	0	5434
25751	138	126	40	5168	0	5472
25752	117	74	40	5277	0	5508
25753	92	87	4642	432	0	5253
25754	72	80	223	5112	0	5487
25755	4930	72	103	397	0	5502
25756	5093	68	74	278	0	5513
25757	330	89	4759	187	0	5365
25758	4556	73	229	166	0	5024
25759	4692	67	115	163	0	5037
25760	388	64	86	3831	0	4369
25761	3865	56	73	354	0	4348
25762	3996	45	60	258	0	4359
25763	382	54	65	3892	0	4393
25764	3893	48	56	382	0	4379
25765	4012	75	59	218	0	4364
25766	429	50	52	3856	0	4387
25767	281	68	3232	317	0	3898
25768	3850	74	213	217	0	4354
25769	349	65	3674	199	0	4287
25770	223	43	3597	232	0	4095
25771	173	3584	299	213	0	4269
25772	196	194	153	3785	0	4328
25773	184	79	113	3965	0	4341
25774	185	70	93	4064	0	4412
25775	219	79	3526	405	0	4229
25776	205	78	3523	267	0	4073
25777	167	3686	278	246	0	4377
25778	177	207	130	3713	0	4227
25779	161	92	110	3945	0	4308
25780	158	62	117	4067	0	4404
25781	190	65	3535	408	0	4198
25782	164	3644	237	298	0	4343
25783	170	198	136	3813	0	4317
25784	189	100	3614	361	0	4264
25785	193	63	3677	244	0	4177
25786	3802	68	341	167	0	4378
25787	3893	59	188	175	0	4315
25788	4039	48	153	170	0	4410
25789	401	56	122	3609	0	4188
25790	250	58	3441	334	0	4083
25791	195	3570	234	275	0	4274
25792	194	3837	157	196	0	4384
25793	159	253	3112	161	0	3685
25794	93	76	137	2057	0	2363
25795	91	45	114	2004	0	2254
25796	101	1896	96	196	0	2289
25797	79	2099	87	148	0	2413
25798	2085	155	71	103	0	2414
25799	2193	78	61	87	0	2419
25800	2196	60	54	142	0	2452
25801	2219	30	71	96	0	2416
25802	2086	61	51	87	0	2285
25803	228	2035	71	110	0	2444
25804	68	778	54	43	0	943
25805	49	1302	47	50	0	1448
25806	1350	87	32	61	0	1530
25807	93	44	25	1374	0	1536
25808	76	25	28	1404	0	1533
25809	1355	6	28	134	0	1523
25810	96	1270	37	72	0	1475
25811	61	76	37	1354	0	1528
25812	33	63	42	1397	0	1535
25813	30	38	47	1431	0	1546
25814	1356	12	35	140	0	1543
25815	82	14	38	1415	0	1549
25816	79	19	1266	92	0	1456
25817	1321	41	68	57	0	1487
25818	90	23	56	1372	0	1541
25819	84	25	1283	84	0	1476
25820	64	1249	70	71	0	1454
25821	56	1341	72	50	0	1519
25822	552	0	0	0	0	552
25823	539	0	0	0	0	539
25824	0	833	2	1	0	836
25825	0	5	0	899	0	904
25826	866	0	2	5	0	873
25827	4	0	0	883	0	887
25828	0	0	0	889	0	889
25829	0	0	0	879	0	879
25830	0	0	0	863	0	863
25831	0	848	0	5	0	853
25832	0	5	0	898	0	903
25833	0	5	0	879	0	884
25834	1	1	0	896	0	898
25835	3	2	856	6	0	867
25836	0	826	7	6	0	839
25837	1	5	0	888	0	894
25838	3	0	849	12	0	864
25839	2	5	792	9	0	808
25840	1	823	7	7	0	838
25841	873	7	0	9	0	889
25842	5	2	0	884	0	891
25843	859	4	1	15	0	879
25844	5	852	5	8	0	870
25845	1	10	1	891	0	903
25846	841	1	1	15	0	858
25847	842	2	7	10	0	861
25848	5	4	3	864	0	876
25849	1	7	3	889	0	900
25850	5	5	860	12	0	882
25851	2	2	7	855	0	866
25852	5	2	3	894	0	904
25853	853	8	1	13	0	875
25854	8	834	1	13	0	856
25855	7	9	838	6	0	860
25856	834	6	5	10	0	855
25857	8	835	4	12	0	859
25858	5	6	2	880	0	893
25859	856	3	5	13	0	877
25860	11	5	3	876	0	895
25861	3	3	4	880	0	890
25862	7	7	846	14	0	874
25863	4	12	9	875	0	900
25864	860	6	7	20	0	893
25865	18	2	4	875	0	899
25866	856	8	2	16	0	882
25867	11	825	4	15	0	855
25868	9	931	3	17	0	960
25869	6	5	4	971	0	986
25870	6	6	2	988	0	1002
25871	960	6	5	18	0	989
25872	8	918	4	16	0	946
25873	963	5	3	15	0	986
25874	963	2	10	15	0	990
25875	12	5	7	968	0	992
25876	968	13	3	17	0	1001
25877	13	6	942	10	0	971
25878	9	5	11	966	0	991
25879	10	9	944	17	0	980
25880	10	11	6	969	0	996
25881	961	10	3	20	0	994
25882	953	4	3	16	0	976
25883	21	922	2	16	0	961
25884	10	11	1	965	0	987
25885	16	5	1	940	0	962
25886	11	908	7	13	0	939
25887	8	9	3	977	0	997
25888	8	2	5	932	0	947
25889	7	925	3	23	0	958
25890	950	10	8	14	0	982
25891	954	7	7	12	0	980
25892	14	12	2	942	0	970
25893	11	10	5	953	0	979
25894	8	9	923	20	0	960
25895	15	7	8	895	0	925
25896	11	916	7	19	0	953
25897	934	10	2	27	0	973
25898	17	9	4	951	0	981
25899	11	7	2	973	0	993
25900	1023	5	2	23	0	1053
25901	15	990	8	20	0	1033
25902	13	10	3	1038	0	1064
25903	11	7	7	1003	0	1028
25904	9	985	6	28	0	1028
25905	554	12	6	15	0	587
25906	14	11	520	14	0	559
25907	9	10	516	22	0	557
25908	7	10	11	553	0	581
25909	12	12	516	21	0	561
25910	542	12	6	13	0	573
25911	17	6	5	559	0	587
25912	13	8	518	25	0	564
25913	11	14	509	13	0	547
25914	15	533	10	11	0	569
25915	515	11	5	13	0	544
25916	16	529	9	20	0	574
25917	545	8	9	18	0	580
25918	493	4	13	19	0	529
25919	16	533	9	13	0	571
25920	547	11	7	17	0	582
25921	547	7	8	15	0	577
25922	20	10	501	11	0	542
25923	10	15	10	551	0	586
25924	1	382	3	1	0	387
25925	3	403	0	0	0	406
25926	2	2	0	421	0	425
25927	416	0	2	2	0	420
25928	2	0	0	411	0	413
25929	1	2	0	416	0	419
25930	1	1	0	417	0	419
25931	0	403	1	3	0	407
25932	2	1	1	422	0	426
25933	0	2	800	3	0	805
25934	818	0	24	3	0	845
25935	869	0	11	2	0	882
25936	36	834	2	1	0	873
25937	861	26	3	2	0	892
25938	29	11	7	864	0	911
25939	19	4	816	28	0	867
25940	828	1	25	11	0	865
25941	29	831	12	3	0	875
25942	17	26	1	850	0	894
25943	847	10	2	34	0	893
25944	25	816	9	14	0	864
25945	20	847	5	4	0	876
25946	870	40	0	2	0	912
25947	32	16	822	6	0	876
25948	849	4	26	3	0	882
25949	31	9	11	836	0	887
25950	12	8	2	891	0	913
25951	11	3	829	39	0	882
25952	8	2	1115	14	0	1139
25953	10	2	40	1111	0	1163
25954	7	3	1115	38	0	1163
25955	8	2	1094	21	0	1125
25956	4	7	47	1095	0	1153
25957	6	3	23	1146	0	1178
25958	1143	1	6	49	0	1199
25959	31	5	12	1146	0	1194
25960	1148	5	11	33	0	1197
25961	39	1109	5	23	0	1176
25962	14	34	6	1143	0	1197
25963	22	15	1082	32	0	1151
25964	1102	9	27	22	0	1160
25965	1165	8	14	11	0	1198
25966	1181	11	8	3	0	1203
25967	1170	7	5	14	0	1196
25968	1072	5	15	7	0	1099
25969	59	8	4	1044	0	1115
25970	31	8	1008	35	0	1082
25971	15	4	1011	20	0	1050
25972	21	4	1030	8	0	1063
25973	1006	4	45	11	0	1066
25974	1053	3	22	13	0	1091
25975	47	1	19	989	0	1056
25976	18	1010	18	29	0	1075
25977	9	29	15	1055	0	1108
25978	14	12	1005	36	0	1067
25979	105	6	920	22	0	1053
25980	991	2	41	19	0	1053
25981	36	14	1016	9	0	1075
25982	21	3	33	1039	0	1096
25983	1049	2	24	39	0	1114
25984	1030	4	17	16	0	1067
25985	991	3	7	13	0	1014
25986	996	3	12	9	0	1020
25987	50	4	912	9	0	975
25988	940	1	32	11	0	984
25989	53	907	15	9	0	984
25990	30	29	10	945	0	1014
25991	25	18	920	35	0	998
25992	19	5	42	936	0	1002
25993	23	3	918	42	0	986
25994	17	9	40	950	0	1016
25995	11	5	20	978	0	1014
25996	13	16	925	44	0	998
25997	17	3	35	958	0	1013
25998	955	2	27	42	0	1026
25999	45	9	12	961	0	1027
26000	26	12	7	970	0	1015
26001	952	6	12	53	0	1023
26002	39	903	17	30	0	989
26003	957	27	12	11	0	1007
26004	40	932	7	16	0	995
26005	957	34	12	14	0	1017
26006	52	15	1051	13	0	1131
26007	32	11	39	1053	0	1135
26008	21	7	15	1110	0	1153
26009	1091	13	5	50	0	1159
26010	42	1046	19	22	0	1129
26011	23	25	22	1072	0	1142
26012	15	15	10	1099	0	1139
26013	16	1046	11	57	0	1130
26014	1067	25	14	32	0	1138
26015	33	1424	12	21	0	1490
26016	17	35	13	1497	0	1562
26017	15	13	10	1493	0	1531
26018	9	1447	8	51	0	1515
26019	1495	26	12	29	0	1562
26020	39	21	1438	19	0	1517
26021	1433	6	28	24	0	1491
26022	44	1415	21	16	0	1496
26023	30	25	9	1505	0	1569
26024	1304	19	4	43	0	1370
26025	46	10	12	1286	0	1354
26026	21	7	11	1325	0	1364
26027	1657	7	10	49	0	1723
26028	43	1546	8	33	0	1630
26029	38	1600	9	16	0	1663
26030	1657	38	7	18	0	1720
26031	42	23	1596	20	0	1681
26032	32	1575	36	21	0	1664
26033	1	1	0	1185	0	1187
26034	2	0	1356	0	0	1358
26035	1	1	19	1325	0	1346
26036	1371	0	3	18	0	1392
26037	17	1310	5	7	0	1339
26038	4	18	1	1361	0	1384
26039	2	1328	0	19	0	1349
26040	1367	20	1	3	0	1391
26041	1597	3	1	2	0	1603
26042	42	1573	2	1	0	1618
26043	12	40	0	1564	0	1616
26044	5	1559	2	34	0	1600
26045	1609	44	2	6	0	1661
26046	1630	10	3	8	0	1651
26047	47	5	1	1583	0	1636
26048	17	3	0	1635	0	1655
26049	8	7	1505	52	0	1572
26050	1459	4	37	15	0	1515
26051	44	8	1564	7	0	1623
26052	13	3	40	1321	0	1377
26053	1352	4	11	41	0	1408
26054	42	1287	2	13	0	1344
26055	1334	42	1	9	0	1386
26056	48	10	1298	5	0	1361
26057	1266	8	33	4	0	1311
26058	49	1296	11	7	0	1363
26059	1333	41	7	5	0	1386
26060	41	1296	8	9	0	1354
26061	16	46	4	1329	0	1395
26062	13	16	2082	43	0	2154
26063	5	10	2057	15	0	2087
26064	6	6	48	2084	0	2144
26065	12	6	2119	44	0	2181
26066	11	6	45	2100	0	2162
26067	8	8	12	2087	0	2115
26068	8	4	2137	56	0	2205
26069	1626	12	47	19	0	1704
26070	2147	6	13	12	0	2178
26071	52	2081	10	12	0	2155
26072	2160	45	6	8	0	2219
26073	47	12	6	2140	0	2205
26074	18	8	2668	43	0	2737
26075	9	8	42	2517	0	2576
26076	5	2	15	2744	0	2766
26077	2713	7	11	57	0	2788
26078	48	2595	5	20	0	2668
26079	16	2663	6	12	0	2697
26080	15	53	5	2705	0	2778
26081	12	16	6	2826	0	2860
26082	9	2792	9	53	0	2863
26083	8	42	8	2886	0	2944
26084	7	10	8	2873	0	2898
26085	5	2773	7	61	0	2846
26086	2964	45	5	23	0	3037
26087	56	14	5	2962	0	3037
26088	14	2900	7	57	0	2978
26089	14	53	6	3009	0	3082
26090	2980	15	5	59	0	3059
26091	52	2902	8	20	0	2982
26092	2986	54	3	23	0	3066
26093	3013	18	5	13	0	3049
26094	69	13	2	2932	0	3016
26095	3005	8	3	64	0	3080
26096	2983	8	3	21	0	3015
26097	2998	9	2	17	0	3026
26098	3030	6	3	9	0	3048
26099	70	9	4	2914	0	2997
26100	20	6	6	2975	0	3007
26101	16	5	2900	74	0	2995
26102	20	10	48	2787	0	2865
26103	11	9	11	2935	0	2966
26104	21	15	2865	72	0	2973
26105	2608	11	52	23	0	2694
26106	70	5	8	2835	0	2918
26107	30	9	2777	61	0	2877
26108	2284	6	50	30	0	2370
26109	67	8	2691	21	0	2787
26110	22	2693	57	14	0	2786
26111	16	2828	15	20	0	2879
26112	9	65	11	2896	0	2981
26113	13	22	2829	65	0	2929
26114	2891	14	57	25	0	2987
26115	2700	10	16	22	0	2748
26116	99	6	2671	9	0	2785
26117	2554	6	63	11	0	2634
26118	2801	7	22	12	0	2842
26119	90	2647	21	9	0	2767
26120	2771	69	8	11	0	2859
26121	83	23	7	2733	0	2846
26122	30	18	2677	72	0	2797
26123	22	9	63	2626	0	2720
26124	12	2588	29	80	0	2709
26125	12	2729	22	26	0	2789
26126	2749	83	11	16	0	2859
26127	2410	27	5	19	0	2461
26128	2332	18	13	6	0	2369
26129	105	5	8	2322	0	2440
26130	41	8	4	2370	0	2423
26131	20	2337	11	86	0	2454
26132	2368	65	5	41	0	2479
26133	73	2340	8	28	0	2449
26134	2218	55	5	7	0	2285
26135	65	2316	6	3	0	2390
26136	2199	52	155	9	0	2415
26137	3120	21	6	6	0	3153
26138	78	11	3	3033	0	3125
26139	30	3009	9	52	0	3100
26140	28	52	2856	25	0	2961
26141	2394	7	27	12	0	2440
26142	30	2720	19	8	0	2777
26143	19	23	2793	5	0	2840
26144	8	17	2777	7	0	2809
26145	7	18	34	2485	0	2544
26146	8	6	15	2589	0	2618
26147	10	2707	9	29	0	2755
26148	2847	28	5	14	0	2894
26149	31	12	2	2756	0	2801
26150	15	2674	10	30	0	2729
26151	13	2723	4	14	0	2754
26152	15	40	2587	12	0	2654
26153	7	21	2568	10	0	2606
26154	2554	11	27	3	0	2595
26155	34	8	2725	8	0	2775
26156	19	11	29	2555	0	2614
26157	21	4	11	2674	0	2710
26158	7	10	2712	38	0	2767
26159	14	10	26	2510	0	2560
26160	17	7	15	2586	0	2625
26161	2578	5	3	38	0	2624
26162	2055	13	3	14	0	2085
26163	36	4	12	2056	0	2108
26164	23	1981	12	27	0	2043
26165	9	2047	6	21	0	2083
26166	2088	34	9	13	0	2144
26167	31	21	2025	4	0	2081
26168	21	9	25	2033	0	2088
26169	2081	6	12	36	0	2135
26170	2059	14	10	15	0	2098
26171	40	11	3	2017	0	2071
26172	17	6	2027	36	0	2086
26173	10	14	1883	11	0	1918
26174	1514	10	32	7	0	1563
26175	1617	5	21	6	0	1649
26176	37	2044	13	9	0	2103
26177	24	2088	11	10	0	2133
26178	2194	34	16	2	0	2246
26179	2203	13	8	13	0	2237
26180	43	8	4	2155	0	2210
26181	31	5	11	2051	0	2098
26182	20	7	8	2088	0	2123
26183	2065	6	5	51	0	2127
26184	41	13	4	2037	0	2095
26185	31	14	2740	34	0	2819
26186	2585	6	16	22	0	2629
26187	24	7	12	2659	0	2702
26188	19	6	2632	27	0	2684
26189	2531	8	18	19	0	2576
26190	2569	11	17	8	0	2605
26191	24	2549	7	18	0	2598
26192	24	2584	8	4	0	2620
26193	22	27	2556	3	0	2608
26194	2711	20	14	11	0	2756
26195	44	2830	18	10	0	2902
26196	28	44	2800	9	0	2881
26197	2603	24	35	10	0	2672
26198	48	2825	16	5	0	2894
26199	25	40	2879	3	0	2947
26200	2721	30	33	8	0	2792
26201	46	2838	19	9	0	2912
26202	29	39	9	2930	0	3007
26203	2964	18	5	39	0	3026
26204	40	2858	7	33	0	2938
26205	17	36	10	2958	0	3021
26206	2931	18	5	41	0	2995
26207	43	13	2858	37	0	2951
26208	22	2798	42	18	0	2880
26209	25	38	3618	5	0	3686
26210	8	16	43	3421	0	3488
26211	6	16	3515	37	0	3574
26212	12	3311	43	22	0	3388
26213	13	3427	26	17	0	3483
26214	5	23	10	3243	0	3281
26215	2	13	2	3088	0	3105
26216	1	9	0	3215	0	3225
26217	1	4	3213	27	0	3245
26218	1	3	21	3183	0	3208
26219	3234	2	5	27	0	3268
26220	3063	2	5	9	0	3079
26221	27	2	3181	5	0	3215
26222	11	2999	29	3	0	3042
26223	3228	19	6	3	0	3256
26224	20	3069	13	6	0	3108
26225	3228	23	2	0	0	3253
26226	3204	10	2	1	0	3217
26227	27	7	3124	1	0	3159
26228	13	3458	28	7	0	3506
26229	7	20	6	3774	0	3807
26230	8	10	3710	20	0	3748
26231	3419	7	22	5	0	3453
26232	20	9	8	3684	0	3721
26233	9	4	3710	23	0	3746
26234	3440	5	23	7	0	3475
26235	24	11	3565	5	0	3605
26236	8	1	26	3423	0	3458
26237	2920	3	7	20	0	2950
26238	23	2756	10	12	0	2801
26239	10	21	2852	10	0	2893
26240	2750	8	23	5	0	2786
26241	2867	10	6	5	0	2888
26242	26	2774	13	4	0	2817
26243	18	19	6	2891	0	2934
26244	9	17	3	2902	0	2931
26245	2933	9	10	27	0	2979
26246	24	6	3	2861	0	2894
26247	7	5	2876	30	0	2918
26248	7	4	23	2817	0	2851
26249	2902	3	10	31	0	2946
26250	21	2756	12	19	0	2808
26251	7	24	9	2857	0	2897
26252	10	2746	10	28	0	2794
26253	2895	28	8	8	0	2939
26254	25	13	5	3298	0	3341
26255	13	9	8	3326	0	3356
26256	13	3210	10	73	0	3306
26257	13	55	3215	30	0	3313
26258	4	24	56	3156	0	3240
26259	12	17	15	3331	0	3375
26260	9	15	13	3335	0	3372
26261	8	3146	20	78	0	3252
26262	14	65	3181	40	0	3300
26263	11	28	3200	26	0	3265
26264	3009	19	78	17	0	3123
26265	3288	14	25	11	0	3338
26266	78	9	3217	12	0	3316
26267	3094	5	69	14	0	3182
26268	82	16	3202	9	0	3309
26269	3039	8	78	12	0	3137
26270	77	3703	40	12	0	3832
26271	3933	66	25	11	0	4035
26272	86	22	3871	19	0	3998
26273	31	23	3850	15	0	3919
26274	24	22	84	3696	0	3826
26275	3912	10	37	72	0	4031
26276	76	3911	40	25	0	4052
26277	42	128	4495	23	0	4688
26278	35	30	167	4478	0	4710
26279	19	31	51	4794	0	4895
26280	4708	13	31	204	0	4956
26281	4721	8	24	68	0	4821
26282	207	13	18	4708	0	4946
26283	5428	10	13	197	0	5648
26284	224	28	5054	59	0	5365
26285	65	18	182	4573	0	4838
26286	44	15	48	4840	0	4947
26287	4674	14	31	234	0	4953
26288	4752	18	22	92	0	4884
26289	241	10	22	4705	0	4978
26290	4668	15	35	215	0	4933
26291	232	21	4346	93	0	4692
26292	79	5038	176	72	0	5365
26293	72	212	5018	38	0	5340
26294	41	37	181	5062	0	5321
26295	4929	21	47	219	0	5216
26296	207	4959	35	66	0	5267
26297	77	171	30	4914	0	5192
26298	46	45	25	4986	0	5102
26299	44	4838	28	223	0	5133
26300	37	183	32	5068	0	5320
26301	48	51	26	5212	0	5337
26302	35	39	35	5250	0	5359
26303	43	22	28	5242	0	5335
26304	53	14	28	5208	0	5303
26305	55	4834	23	260	0	5172
26306	45	175	29	5118	0	5367
26307	48	47	25	5280	0	5400
26308	45	51	4627	275	0	4998
26309	30	4226	174	120	0	4550
26310	30	184	53	4391	0	4658
26311	37	64	34	4457	0	4592
26312	53	48	33	4422	0	4556
26313	44	4141	43	308	0	4536
26314	47	199	4088	149	0	4483
26315	47	60	188	4476	0	4771
26316	50	71	4069	299	0	4489
26317	46	47	4262	155	0	4510
26318	44	38	226	4470	0	4778
26319	4919	45	65	310	0	5339
26320	220	31	53	4956	0	5260
26321	83	35	51	4970	0	5139
26322	54	4827	41	302	0	5224
26323	51	190	47	5024	0	5312
26324	53	68	42	5190	0	5353
26325	57	71	5106	310	0	5544
26326	38	5258	195	174	0	5665
26327	35	191	77	5593	0	5896
26328	4996	80	52	288	0	5416
26329	210	75	4791	162	0	5238
26330	63	57	209	5078	0	5407
26331	53	48	87	5285	0	5473
26332	5011	61	67	345	0	5484
26333	203	4979	65	179	0	5426
26334	4966	219	61	178	0	5424
26335	214	4950	50	177	0	5391
26336	83	215	48	5174	0	5520
26337	5003	93	36	342	0	5474
26338	216	93	5544	192	0	6045
26339	82	5658	192	177	0	6109
26340	56	5979	85	200	0	6320
26341	5846	258	69	166	0	6339
26342	199	113	59	5818	0	6189
26343	92	5472	56	336	0	5956
26344	75	5944	56	211	0	6286
26345	70	261	55	6020	0	6406
26346	61	116	52	6218	0	6447
26347	5828	83	66	368	0	6345
26348	220	5717	60	222	0	6219
26349	86	224	66	6060	0	6436
26350	78	107	5662	335	0	6182
26351	69	5817	209	206	0	6301
26352	82	245	5587	176	0	6090
26353	74	5692	237	173	0	6176
26354	53	199	83	5477	0	5812
26355	39	100	65	5398	0	5602
26356	64	5136	57	295	0	5552
26357	72	209	5192	161	0	5634
26358	5268	98	173	137	0	5676
26359	174	99	68	5413	0	5754
26360	73	82	53	5653	0	5861
26361	61	90	5198	302	0	5651
26362	42	92	166	5500	0	5800
26363	39	89	5225	299	0	5652
26364	57	734	166	4790	0	5747
26365	53	109	5180	276	0	5618
26366	50	5176	176	194	0	5596
26367	60	195	5231	154	0	5640
26368	34	111	171	5498	0	5814
26369	5358	93	76	286	0	5813
26370	163	4621	55	139	0	4978
26371	74	175	48	4799	0	5096
26372	53	98	4476	230	0	4857
26373	38	4529	163	135	0	4865
26374	39	189	65	4762	0	5055
26375	60	91	4554	228	0	4933
26376	32	3870	110	92	0	4104
26377	3351	60	28	40	0	3479
26378	3337	39	20	54	0	3450
26379	46	36	17	3420	0	3519
26380	3398	28	33	68	0	3527
26381	44	45	24	3571	0	3684
26382	19	42	28	3627	0	3716
26383	16	17	2809	39	0	2881
26384	16	15	18	2818	0	2867
26385	8	22	8	2915	0	2953
26386	2899	20	15	28	0	2962
26387	2788	19	5	34	0	2846
26388	22	2737	14	29	0	2802
26389	17	33	2741	12	0	2803
26390	8	24	26	3431	0	3489
26391	725	28	2720	35	0	3508
26392	2494	0	2	3	0	2499
26393	1	3	2679	0	0	2683
26394	0	1	0	2680	0	2681
26395	1	2558	3	1	0	2563
26396	1	1	0	2722	0	2724
26397	1	2	0	2675	0	2678
26398	1	0	2702	0	0	2703
26399	1	1	0	2658	0	2660
26400	2705	0	0	0	0	2705
26401	2599	0	0	1	0	2600
26402	2590	0	1	2	0	2593
26403	2674	1	1	2	0	2678
26404	0	2537	5	2	0	2544
26405	1	2551	5	1	0	2558
26406	1	3	1	2632	0	2637
26407	0	0	1	2669	0	2670
26408	0	2531	14	1	0	2546
26409	0	0	0	2692	0	2692
26410	0	0	1	2677	0	2678
26411	1	1	0	2670	0	2672
26412	2	0	0	2655	0	2657
26413	0	2	1	2685	0	2688
26414	2677	0	0	2	0	2679
26415	0	2529	8	6	0	2543
26416	1	3	2541	1	0	2546
26417	2	0	1	2579	0	2582
26418	0	0	0	2645	0	2645
26419	0	0	0	2126	0	2126
26420	2112	0	0	5	0	2117
26421	1	2437	3	2	0	2443
26422	1	57	0	2513	0	2571
26423	2	2630	7	53	0	2692
26424	0	66	0	2715	0	2781
26425	0	2155	4	69	0	2228
26426	6	79	3027	10	0	3122
26427	1	10	137	3157	0	3305
26428	2	11	3727	155	0	3895
26429	2	2	154	3769	0	3927
26430	2	4	26	4533	0	4565
26431	4388	1	22	234	0	4645
26432	4504	2	11	55	0	4572
26433	4599	0	12	34	0	4645
26434	4562	0	7	24	0	4593
26435	4548	0	9	11	0	4568
26436	264	3	1	4263	0	4531
26437	69	4217	8	204	0	4498
26438	46	202	3	3619	0	3870
26439	24	39	3393	233	0	3689
26440	3463	20	179	44	0	3706
26441	3749	11	28	32	0	3820
26442	247	12	20	3567	0	3846
26443	62	7	7	3670	0	3746
26444	38	3414	14	237	0	3703
26445	22	188	10	3628	0	3848
26446	20	40	9	3703	0	3772
26447	15	3440	8	260	0	3723
26448	9	205	10	3662	0	3886
26449	3548	33	8	258	0	3847
26450	216	37	3386	56	0	3695
26451	3514	13	191	51	0	3769
26452	238	20	3396	40	0	3694
26453	50	19	197	3529	0	3795
26454	43	11	36	3563	0	3653
26455	26	3368	36	235	0	3665
26456	33	3691	25	59	0	3808
26457	28	244	17	3572	0	3861
26458	38	60	3329	235	0	3662
26459	3431	29	190	61	0	3711
26460	228	23	31	3504	0	3786
26461	49	3491	39	232	0	3811
26462	45	224	14	3568	0	3851
26463	27	36	18	3743	0	3824
26464	23	3487	17	265	0	3792
26465	29	217	10	3636	0	3892
26466	27	52	3324	273	0	3676
26467	27	57	3408	67	0	3559
26468	32	20	199	3305	0	3556
26469	21	3414	48	241	0	3724
26470	18	221	27	3555	0	3821
26471	3517	46	13	271	0	3847
26472	3706	47	24	67	0	3844
26473	3624	20	20	65	0	3729
26474	253	3400	20	44	0	3717
26475	69	222	3341	47	0	3679
26476	3487	58	189	47	0	3781
26477	3725	42	44	46	0	3857
26478	263	3437	35	52	0	3787
26479	82	233	20	3551	0	3886
26480	3585	67	27	249	0	3928
26481	3585	44	33	82	0	3744
26482	3639	26	23	62	0	3750
26483	297	25	30	3407	0	3759
26484	3451	27	23	265	0	3766
26485	275	21	30	3443	0	3769
26486	104	15	32	3663	0	3814
26487	3452	22	28	299	0	3801
26488	275	24	24	3492	0	3815
26489	3441	33	24	308	0	3806
26490	285	25	21	2901	0	3232
26491	112	40	25	3111	0	3288
26492	2896	35	26	334	0	3291
26493	304	26	3606	138	0	4074
26494	133	35	214	3740	0	4122
26495	116	23	51	4009	0	4199
26496	95	34	40	3977	0	4146
26497	76	37	25	4120	0	4258
26498	91	33	33	4030	0	4187
26499	78	3731	32	336	0	4177
26500	93	218	33	3965	0	4309
26501	93	67	3676	329	0	4165
26502	75	55	213	3900	0	4243
26503	78	47	38	4076	0	4239
26504	74	48	39	4153	0	4314
26505	78	43	3736	368	0	4225
26506	60	42	3751	168	0	4021
26507	3681	47	233	130	0	4091
26508	3988	30	76	138	0	4232
26509	293	5847	69	115	0	6324
26510	112	251	52	6222	0	6637
26511	82	66	42	6428	0	6618
26512	69	52	52	6508	0	6681
26513	6272	40	41	379	0	6732
26514	6394	48	33	161	0	6636
26515	281	55	40	6250	0	6626
26516	94	57	31	6399	0	6581
26517	81	43	32	6479	0	6635
26518	51	44	41	6502	0	6638
26519	6214	40	37	374	0	6665
26520	255	45	6020	177	0	6497
26521	57	5251	161	122	0	5591
26522	51	5722	43	118	0	5934
26523	5583	179	31	110	0	5903
26524	174	67	21	5576	0	5838
26525	61	50	5448	223	0	5782
26526	22	35	4215	56	0	4328
26527	16	4639	71	61	0	4787
26528	3737	38	10	533	0	4318
26529	12	11	4148	41	0	4212
26530	3302	1	6	0	0	3309
26531	0	0	0	3655	0	3655
26532	1	0	1	3705	0	3707
26533	0	3565	1	2	0	3568
26534	0	3630	1	1	0	3632
26535	3732	0	0	1	0	3733
26536	3651	0	1	2	0	3654
26537	0	3547	4	3	0	3554
26538	3	1	3555	0	0	3559
26539	1	5	3468	4	0	3478
26540	0	2	2	3438	0	3442
26541	3756	0	0	0	0	3756
26542	0	3446	6	0	0	3452
26543	0	1	1	3703	0	3705
26544	3746	0	0	0	0	3746
26545	0	1	0	3638	0	3639
26546	0	0	0	3654	0	3654
26547	3674	0	0	0	0	3674
26548	0	3439	6	3	0	3448
26549	0	3558	2	2	0	3562
26550	4	4	3443	0	0	3451
26551	0	1	0	3469	0	3470
26552	0	2	0	3389	0	3391
26553	1	1	3527	0	0	3529
26554	2589	2	14	6	0	2611
26555	3034	0	2	1	0	3037
26556	2	1	3404	0	0	3407
26557	2563	4	9	6	0	2582
26558	2	3	3341	1	0	3347
26559	0	3080	6	1	0	3087
26560	1	0	0	3405	0	3406
26561	0	2	0	3380	0	3382
26562	3405	0	0	0	0	3405
26563	3320	0	0	2	0	3322
26564	3304	0	1	0	0	3305
26565	3307	0	0	3	0	3310
26566	3253	0	2	3	0	3258
26567	0	4	3201	0	0	3205
26568	0	2964	9	3	0	2976
26569	0	0	1	3341	0	3342
26570	0	3136	10	1	0	3147
26571	0	3188	4	1	0	3193
26572	0	2	0	3293	0	3295
26573	0	1	1	3308	0	3310
26574	0	0	3227	1	0	3228
26575	2843	3	1	1	0	2848
26576	3264	1	0	0	0	3265
26577	0	3056	6	1	0	3063
26578	3336	1	0	0	0	3337
26579	3285	0	2	2	0	3289
26580	0	2	0	3227	0	3229
26581	0	5	3998	4	0	4007
26582	1	8	3925	1	0	3935
26583	3934	1	0	1	0	3936
26584	4070	0	2	0	0	4072
26585	0	3784	3	0	0	3787
26586	0	3883	6	7	0	3896
26587	1	1	0	4085	0	4087
26588	4092	0	0	1	0	4093
26589	0	5	3908	1	0	3914
26590	1	2	2	3899	0	3904
26591	4877	0	0	0	0	4877
26592	4787	0	0	1	0	4788
26593	1	1	0	4271	0	4273
26594	4391	1	6	1	0	4399
26595	3	7	4089	0	0	4099
26596	3	6	4125	0	0	4134
26597	2	2	2	3923	0	3929
26598	0	3	0	4291	0	4294
26599	1	0	0	4289	0	4290
26600	0	4066	2	2	0	4070
26601	0	4160	5	5	0	4170
26602	0	2	0	4338	0	4340
26603	4328	0	0	2	0	4330
26604	0	1	0	4247	0	4248
26605	0	3	1	4249	0	4253
26606	0	3978	11	4	0	3993
26607	0	4098	7	3	0	4108
26608	0	4	0	4287	0	4291
26609	0	0	2	2226	0	2228
26610	2616	0	0	0	0	2616
26611	16	2444	6	0	0	2466
26612	2605	14	1	1	0	2621
26613	15	3	0	2581	0	2599
26614	3	2	2504	16	0	2525
26615	0	7	2382	3	0	2392
26616	2452	1	14	1	0	2468
26617	15	0	1	2554	0	2570
26618	4	1	0	2544	0	2549
26619	0	2	0	2596	0	2598
26620	1	5	2534	18	0	2558
26621	1	1	14	2502	0	2518
26622	2	2761	11	15	0	2789
26623	2	29	1	2952	0	2984
26624	1	15	0	2910	0	2926
26625	0	2831	6	47	0	2884
26626	3	32	0	2970	0	3005
26627	2616	17	0	38	0	2671
26628	30	2495	2	21	0	2548
26629	2637	30	1	7	0	2675
26630	2632	15	2	3	0	2652
26631	43	3	3	2562	0	2611
26632	19	3	0	2578	0	2600
26633	6	2	0	2658	0	2666
26634	5	5	2458	51	0	2519
26635	2	2399	31	27	0	2459
26636	4	2547	15	14	0	2580
26637	2	45	3	2609	0	2659
26638	2596	18	2	33	0	2649
26639	36	6	1	2556	0	2599
26640	20	15	2503	36	0	2574
26641	8	2378	31	24	0	2441
26642	7	2503	18	12	0	2540
26643	2583	41	8	8	0	2640
26644	2599	21	8	3	0	2631
26645	49	3209	9	8	0	3275
26646	3393	34	3	7	0	3437
26647	41	23	3132	12	0	3208
26648	19	12	3042	10	0	3083
26649	3249	6	44	7	0	3306
26650	3337	7	19	9	0	3372
26651	48	9	5	3274	0	3336
26652	3356	5	2	44	0	3407
26653	40	13	3100	24	0	3177
26654	23	13	3108	12	0	3156
26655	11	8	45	3590	0	3654
26656	9	5	20	3966	0	4000
26657	11	5	5	4009	0	4030
26658	10	6	4	4514	0	4534
26659	11	1	2	6514	0	6528
26660	12	10	6087	327	0	6436
26661	3	6	248	6342	0	6599
26662	6310	3	78	335	0	6726
26663	279	9	25	6479	0	6792
26664	6405	8	27	353	0	6793
26665	302	7	14	6485	0	6808
26666	6427	10	13	368	0	6818
26667	6992	3	23	181	0	7199
26668	400	9	19	6726	0	7154
26669	151	9	31	7093	0	7284
26670	6802	7	25	462	0	7296
26671	6982	11	16	184	0	7193
26672	443	23	6694	135	0	7295
26673	188	7	275	6969	0	7439
26674	139	5	80	7787	0	8011
26675	7430	4	38	468	0	7940
26676	7618	8	37	200	0	7863
26677	455	7	24	7421	0	7907
26678	197	8	15	7717	0	7937
26679	138	3	28	7818	0	7987
26680	114	3	20	7700	0	7837
26681	82	6182	41	515	0	6820
26682	77	6635	36	231	0	6979
26683	83	350	24	6701	0	7158
26684	74	6508	26	425	0	7033
26685	65	321	15	6858	0	7259
26686	62	140	6297	444	0	6943
26687	48	60	6162	267	0	6537
26688	49	6376	341	158	0	6924
26689	38	332	103	6719	0	7192
26690	42	140	6347	430	0	6959
26691	45	88	307	5992	0	6432
26692	39	78	102	6375	0	6594
26693	5620	61	55	535	0	6271
26694	332	54	78	5856	0	6320
26695	130	65	5430	466	0	6091
26696	73	61	6254	272	0	6660
26697	83	6062	393	168	0	6706
26698	82	6539	139	184	0	6944
26699	6466	375	92	175	0	7108
26700	383	145	7079	152	0	7759
26701	177	62	325	7235	0	7799
26702	7273	44	138	454	0	7909
26703	7427	43	77	240	0	7787
26704	451	6968	84	181	0	7684
26705	219	323	74	7223	0	7839
26706	140	142	83	7579	0	7944
26707	119	73	72	7657	0	7921
26708	7573	72	60	543	0	8248
26709	406	67	7178	266	0	7917
26710	195	6852	297	180	0	7524
26711	133	322	105	7261	0	7821
26712	126	135	63	7559	0	7883
26713	76	84	7249	533	0	7942
26714	65	68	283	7564	0	7980
26715	79	66	110	7872	0	8127
26716	67	78	63	7997	0	8205
26717	65	76	61	8061	0	8263
26718	58	65	7298	578	0	7999
26719	28	76	300	7691	0	8095
26720	40	65	7319	509	0	7933
26721	44	7218	330	317	0	7909
26722	36	315	164	7215	0	7730
26723	35	124	74	7647	0	7880
26724	49	52	6899	564	0	7564
26725	37	6908	331	337	0	7613
26726	62	290	136	7261	0	7749
26727	95	104	6941	470	0	7610
26728	66	6840	332	275	0	7513
26729	59	322	146	7319	0	7846
26730	80	139	7188	453	0	7860
26731	76	85	342	7352	0	7855
26732	71	105	142	8014	0	8332
26733	73	80	101	8331	0	8585
26734	7893	77	106	507	0	8583
26735	328	7662	101	265	0	8356
26736	8003	304	91	213	0	8611
26737	355	146	8046	175	0	8722
26738	8957	95	300	211	0	9563
26739	9294	73	124	228	0	9719
26740	425	58	84	9167	0	9734
26741	9249	50	65	483	0	9847
26742	9313	62	68	292	0	9735
26743	9429	60	65	202	0	9756
26744	438	98	60	9076	0	9672
26745	194	80	54	8678	0	9006
26746	146	74	7976	485	0	8681
26747	126	81	7840	258	0	8305
26748	7999	67	341	196	0	8603
26749	373	52	149	8049	0	8623
26750	179	8051	109	401	0	8740
26751	8224	286	98	251	0	8859
26752	328	7981	95	204	0	8608
26753	155	8236	90	212	0	8693
26754	96	380	7870	188	0	8534
26755	95	128	8357	141	0	8721
26756	64	75	337	8332	0	8808
26757	63	81	8620	378	0	9142
26758	67	49	7863	171	0	8150
26759	5827	2	11	11	0	5851
26760	6858	7	4	9	0	6878
26761	13	4	5	6951	0	6973
26762	8	2	4	6925	0	6939
26763	17	7	6971	11	0	7006
26764	9	6566	40	19	0	6634
26765	8	8	7	7011	0	7034
26766	7363	2	2	17	0	7384
26767	18	3	4	7022	0	7047
26768	9	6849	12	29	0	6899
26769	12	13	6863	16	0	6904
26770	5	6596	35	14	0	6650
26771	7115	8	10	8	0	7141
26772	7354	7	9	6	0	7376
26773	25	2	3	7318	0	7348
26774	5	10	7042	14	0	7071
26775	5	7	6694	6	0	6712
26776	2	6710	39	6	0	6757
26777	10	10	1	6895	0	6916
26778	1	1	1	7100	0	7103
26779	4	4	6988	15	0	7011
26780	3	1	16	6754	0	6774
26781	0	6748	14	13	0	6775
26782	1	13	0	7385	0	7399
26783	1	1	1	7387	0	7390
26784	6	6	7303	14	0	7329
26785	2	2	15	7113	0	7132
26786	7644	0	5	20	0	7669
26787	19	8	7595	3	0	7625
26788	5	9	7447	0	0	7461
26789	3	7291	49	4	0	7347
26790	0	40	3	7962	0	8005
26791	1	2	2	8232	0	8237
26792	4	12	8032	45	0	8093
26793	7559	4	43	15	0	7621
26794	48	2	3	8213	0	8266
26795	11	9	8715	50	0	8785
26796	9	2	49	7723	0	7783
26797	9	6	7980	55	0	8050
26798	8	11	7786	11	0	7816
26799	4	7354	74	19	0	7451
26800	4	47	15	7136	0	7202
26801	2	7703	40	44	0	7789
26802	7812	74	9	12	0	7907
26803	70	32	7702	24	0	7828
26804	8	7539	95	20	0	7662
26805	20	72	21	7965	0	8078
26806	7861	12	24	86	0	7983
26807	67	7553	24	44	0	7688
26808	9	73	11	7607	0	7700
26809	23	13	15	7577	0	7628
26810	8	7734	22	87	0	7851
26811	7843	119	14	34	0	8010
26812	103	20	10	9587	0	9720
26813	11	27	17	10501	0	10556
26814	36	43	9822	301	0	10202
26815	15	9843	256	135	0	10249
26816	19	261	84	10072	0	10436
26817	17	87	49	10665	0	10818
26818	5	10508	50	363	0	10926
26819	10	601	19	10480	0	11110
26820	13	108	16	11319	0	11456
26821	17	60	16	11323	0	11416
26822	5	10817	35	444	0	11301
26823	11064	311	9	177	0	11561
26824	330	100	10682	114	0	11226
26825	10576	73	321	67	0	11037
26826	367	10801	109	62	0	11339
26827	112	314	70	11219	0	11715
26828	80	134	10805	351	0	11370
26829	45	77	328	10923	0	11373
26830	26	58	98	11015	0	11197
26831	22	47	67	11340	0	11476
26832	28	57	9997	503	0	10585
26833	28	9854	341	246	0	10469
26834	30	349	9925	161	0	10465
26835	19	9955	380	164	0	10518
26836	32	387	10075	115	0	10609
26837	15	149	394	10057	0	10615
26838	9078	112	142	418	0	9750
26839	314	9730	118	204	0	10366
26840	104	379	9943	178	0	10604
26841	86	10012	344	165	0	10607
26842	52	392	10540	142	0	11126
26843	39	181	401	10462	0	11083
26844	47	122	153	10308	0	10630
26845	51	10124	147	431	0	10753
26846	51	10848	88	214	0	11201
26847	11159	432	68	164	0	11823
26848	385	206	77	11206	0	11874
26849	124	172	10941	450	0	11687
26850	101	110	402	11201	0	11814
26851	72	82	11242	548	0	11944
26852	52	99	11239	273	0	11663
26853	47	64	486	10983	0	11580
26854	23	11014	221	477	0	11735
26855	10441	409	173	197	0	11220
26856	359	190	124	11527	0	12200
26857	118	162	118	11994	0	12392
26858	94	11945	115	517	0	12671
26859	12151	430	103	236	0	12920
26860	11767	197	96	183	0	12243
26861	460	160	101	11267	0	11988
26862	196	11865	114	451	0	12626
26863	126	12443	112	214	0	12895
26864	12743	479	115	189	0	13526
26865	396	231	12353	164	0	13144
26866	11994	192	411	165	0	12762
26867	12485	152	176	150	0	12963
26868	12561	143	111	141	0	12956
26869	534	11971	119	146	0	12770
26870	236	424	104	12391	0	13155
26871	12342	182	105	502	0	13131
26872	11771	142	79	216	0	12208
26873	440	11317	117	178	0	12052
26874	11706	398	101	166	0	12371
26875	469	164	90	11622	0	12345
26876	187	161	90	11789	0	12227
26877	142	11625	86	535	0	12388
26878	107	422	56	12075	0	12660
26879	114	192	63	12217	0	12586
26880	120	11600	78	568	0	12366
26881	125	433	63	11715	0	12336
26882	134	11436	77	529	0	12176
26883	11627	464	78	264	0	12433
26884	11401	218	86	209	0	11914
26885	485	11404	77	173	0	12139
26886	253	452	10666	160	0	11531
26887	195	211	364	11122	0	11892
26888	165	200	10872	476	0	11713
26889	147	10401	399	251	0	11198
26890	116	10943	167	214	0	11440
26891	10657	436	108	163	0	11364
26892	417	10659	104	137	0	11317
26893	236	452	84	10365	0	11137
26894	173	10463	99	378	0	11113
26895	162	10318	67	197	0	10744
26896	10467	496	76	161	0	11200
26897	396	255	69	10502	0	11222
26898	189	189	10043	453	0	10874
26899	172	160	10044	242	0	10618
26900	110	10208	403	226	0	10947
26901	9696	371	145	174	0	10386
26902	330	9693	141	122	0	10286
26903	132	445	73	9833	0	10483
26904	9804	230	87	357	0	10478
26905	390	170	46	9861	0	10467
26906	195	124	71	9975	0	10365
26907	133	9588	66	469	0	10256
26908	143	381	63	9963	0	10550
26909	104	231	9427	422	0	10184
26910	10267	144	301	206	0	10918
26911	387	10822	151	161	0	11521
26912	126	9849	65	113	0	10153
26913	9211	241	26	32	0	9510
26914	256	108	8776	37	0	9177
26915	9151	67	213	24	0	9455
26916	262	10661	83	35	0	11041
26917	62	11313	69	33	0	11477
26918	52	461	11009	21	0	11543
26919	25	11780	372	23	0	12200
26920	23	366	89	11116	0	11594
26921	21	129	49	11419	0	11618
26922	15	11265	39	401	0	11720
26923	25	336	14	11638	0	12013
26924	11617	124	13	383	0	12137
26925	365	98	11072	125	0	11660
26926	11323	51	328	67	0	11769
26927	12049	50	115	32	0	12246
26928	12170	35	53	39	0	12297
26929	548	60	11761	31	0	12400
26930	192	54	367	11879	0	12492
26931	108	64	11758	405	0	12335
26932	11702	42	420	144	0	12308
26933	11907	40	149	79	0	12175
26934	488	11702	95	57	0	12342
26935	204	388	45	11708	0	12345
26936	100	12063	55	378	0	12596
26937	85	416	11914	146	0	12561
26938	53	161	378	12293	0	12885
26939	11872	82	145	435	0	12534
26940	11827	50	81	162	0	12120
26941	566	58	41	10909	0	11574
26942	234	10482	67	358	0	11141
26943	147	371	10636	147	0	11301
26944	86	177	10929	90	0	11282
26945	10453	91	513	66	0	11123
26946	455	77	10784	56	0	11372
26947	181	10222	441	62	0	10906
26948	118	364	149	10546	0	11177
26949	81	171	10525	381	0	11158
26950	74	87	403	10443	0	11007
26951	59	79	10065	438	0	10641
26952	9542	58	439	178	0	10217
26953	415	54	171	9970	0	10610
26954	182	9688	123	390	0	10383
26955	109	10293	80	192	0	10674
26956	82	487	65	9176	0	9810
26957	72	199	76	8819	0	9166
26958	83	8448	91	507	0	9129
26959	92	375	8360	210	0	9037
26960	85	165	389	8674	0	9313
26961	85	108	8540	420	0	9153
26962	74	102	7837	191	0	8204
26963	7617	79	517	130	0	8343
26964	415	7577	206	99	0	8297
26965	7798	395	126	91	0	8410
26966	468	186	83	7399	0	8136
26967	184	7575	95	434	0	8288
26968	120	439	89	7615	0	8263
26969	82	204	106	7855	0	8247
26970	100	7580	104	532	0	8316
26971	112	427	7431	239	0	8209
26972	106	202	408	7753	0	8469
26973	7656	147	188	466	0	8457
26974	434	134	112	7854	0	8534
26975	187	108	106	8145	0	8546
26976	139	102	7320	587	0	8148
26977	113	7205	439	278	0	8035
26978	101	432	196	7433	0	8162
26979	125	240	7223	479	0	8067
26980	108	186	7436	237	0	7967
26981	7197	135	571	185	0	8088
26982	468	7348	256	177	0	8249
26983	7397	437	180	152	0	8166
26984	522	7344	125	150	0	8141
26985	238	7710	108	178	0	8234
26986	7481	583	109	148	0	8321
26987	464	270	128	7226	0	8088
26988	238	7250	152	476	0	8116
26989	183	439	143	8186	0	8951
26990	8097	197	115	534	0	8943
26991	549	163	7738	244	0	8694
26992	256	152	7917	205	0	8530
26993	7743	123	555	168	0	8589
26994	453	7759	292	174	0	8678
26995	262	439	7694	120	0	8515
26996	193	7583	463	139	0	8378
26997	177	469	214	7604	0	8464
26998	143	252	7514	462	0	8371
26999	110	170	461	7785	0	8526
27000	121	137	7501	555	0	8314
27001	7440	124	521	252	0	8337
27002	451	7584	252	190	0	8477
27003	7816	474	159	140	0	8589
27004	503	249	139	7077	0	7968
27005	210	7554	146	442	0	8352
27006	7675	472	146	235	0	8528
27007	8002	209	161	184	0	8556
27008	579	136	7509	180	0	8404
27009	289	147	7697	136	0	8269
27010	5720	106	424	90	0	6340
27011	346	5779	216	105	0	6446
27012	127	5189	136	113	0	5565
27013	80	307	110	4566	0	5063
27014	77	145	4404	276	0	4902
27015	92	4495	273	132	0	4992
27016	48	3246	78	65	0	3437
27017	285	74	28	2632	0	3019
27018	2404	18	7	81	0	2510
27019	2441	16	7	33	0	2497
27020	2468	9	8	18	0	2503
27021	111	11	2306	16	0	2444
27022	2386	8	73	18	0	2485
27023	2419	10	33	10	0	2472
27024	2468	6	16	13	0	2503
27025	117	6	22	2311	0	2456
27026	52	2326	21	77	0	2476
27027	2439	50	9	23	0	2521
27028	82	2440	9	7	0	2538
27029	24	45	0	2156	0	2225
27030	9	21	2078	57	0	2165
27031	8	9	41	2097	0	2155
27032	7	5	17	2174	0	2203
27033	7	10	2051	68	0	2136
27034	4	2051	50	31	0	2136
27035	3	53	22	2128	0	2206
27036	1736	17	6	60	0	1819
27037	56	1734	7	25	0	1822
27038	1769	55	5	7	0	1836
27039	60	26	2	1716	0	1804
27040	30	2121	1	58	0	2210
27041	2141	55	2	15	0	2213
27042	57	2087	8	9	0	2161
27043	33	59	2073	12	0	2177
27044	2069	25	49	13	0	2156
27045	2155	13	18	6	0	2192
27046	74	2074	7	14	0	2169
27047	24	64	1969	16	0	2073
27048	18	2102	59	7	0	2186
27049	26	62	19	1942	0	2049
27050	17	28	6	2607	0	2658
27051	12	16	9	2652	0	2689
27052	11	2591	10	108	0	2720
27053	12	80	6	2654	0	2752
27054	10	31	5	2743	0	2789
27055	2625	19	3	124	0	2771
27056	80	15	4	2664	0	2763
27057	35	15	10	2736	0	2796
27058	2611	11	4	127	0	2753
27059	89	2559	5	53	0	2706
27060	2698	79	8	26	0	2811
27061	2701	35	6	32	0	2774
27062	2718	13	5	23	0	2759
27063	122	16	5	2614	0	2757
27064	55	17	6	2729	0	2807
27065	44	13	2965	118	0	3140
27066	42	19	2950	44	0	3055
27067	37	18	3010	24	0	3089
27068	2977	12	106	37	0	3132
27069	104	18	2971	28	0	3121
27070	52	2991	102	26	0	3171
27071	43	87	40	3008	0	3178
27072	39	40	25	2918	0	3022
27073	31	3051	22	107	0	3211
27074	39	94	2974	48	0	3155
27075	40	3005	81	36	0	3162
27076	3081	92	28	41	0	3242
27077	92	52	3025	37	0	3206
27078	43	2974	91	39	0	3147
27079	30	96	3041	35	0	3202
27080	22	48	93	3086	0	3249
27081	30	27	3050	101	0	3208
27082	21	35	93	3025	0	3174
27083	3087	22	40	118	0	3267
27084	103	15	3006	63	0	3187
27085	55	3351	94	44	0	3544
27086	3478	84	44	49	0	3655
27087	110	50	3395	48	0	3603
27088	63	35	3442	27	0	3567
27089	54	29	118	2895	0	3096
27090	45	36	2908	113	0	3102
27091	2854	30	115	47	0	3046
27092	115	2827	58	38	0	3038
27093	46	116	31	2801	0	2994
27094	38	2875	39	104	0	3056
27095	2966	102	44	53	0	3165
27096	108	68	2845	38	0	3059
27097	48	48	2873	45	0	3014
27098	39	37	114	2885	0	3075
27099	33	46	48	2967	0	3094
27100	35	34	41	2985	0	3095
27101	31	24	37	3028	0	3120
27102	37	21	2824	157	0	3039
27103	28	2857	95	87	0	3067
27104	16	97	46	2962	0	3121
27105	37	55	2852	125	0	3069
27106	42	2847	105	68	0	3062
27107	2927	107	53	56	0	3143
27108	108	48	32	2962	0	3150
27109	2949	37	36	118	0	3140
27110	100	2900	38	73	0	3111
27111	2956	99	30	54	0	3139
27112	119	51	2859	53	0	3082
27113	74	35	97	2719	0	2925
27114	41	2854	65	100	0	3060
27115	46	114	2820	57	0	3037
27116	47	2899	110	49	0	3105
27117	18	52	24	1941	0	2035
27118	2153	22	19	48	0	2242
27119	57	2109	13	28	0	2207
27120	2157	46	17	29	0	2249
27121	62	17	2613	19	0	2711
27122	27	18	2549	21	0	2615
27123	2639	10	66	20	0	2735
27124	52	11	31	2656	0	2750
27125	24	14	25	2698	0	2761
27126	20	13	2664	59	0	2756
27127	9	6	2148	20	0	2183
27128	10	2097	51	13	0	2171
27129	2281	28	20	15	0	2344
27130	2262	12	17	9	0	2300
27131	38	2156	10	12	0	2216
27132	15	33	8	2291	0	2347
27133	2292	21	8	32	0	2353
27134	29	15	8	2268	0	2320
27135	2311	10	8	33	0	2362
27136	2298	8	12	13	0	2331
27137	2289	7	15	6	0	2317
27138	38	9	4	2260	0	2311
27139	25	1	3	2300	0	2329
27140	1903	7	10	43	0	1963
27141	1861	8	9	23	0	1901
27142	1894	5	10	18	0	1927
27143	41	1809	13	13	0	1876
27144	1906	28	6	6	0	1946
27145	31	1464	10	366	0	1871
27146	1894	35	7	7	0	1943
27147	36	17	1804	6	0	1863
27148	1726	8	32	8	0	1774
27149	42	1785	13	13	0	1853
27150	0	1309	6	0	0	1315
27151	1387	0	0	0	0	1387
27152	0	0	0	1326	0	1326
27153	0	1	1	1329	0	1331
27154	1	1287	5	0	0	1293
27155	0	1303	2	2	0	1307
27156	1358	0	1	0	0	1359
27157	1	5	1613	0	0	1619
27158	1	3	0	1588	0	1592
27159	2061	0	2	0	0	2063
27160	36	5	1928	1	0	1970
27161	1	1902	32	0	0	1935
27162	2058	30	0	1	0	2089
27163	33	4	1982	0	0	2019
27164	2	1	31	2648	0	2682
27165	4	5	3723	29	0	3761
27166	3566	2	40	2	0	3610
27167	39	3487	23	5	0	3554
27168	3937	39	6	0	0	3982
27169	3948	4	3	2	0	3957
27170	49	7	8	3788	0	3852
27171	4447	3	1	42	0	4493
27172	50	7	2	4330	0	4389
27173	19	1	1	4422	0	4443
27174	19	9	4224	55	0	4307
27175	6	4050	46	20	0	4122
27176	11	36	4	4413	0	4464
27177	2	3	7	4417	0	4429
27178	2	7	2	4357	0	4368
27179	3	7	4223	55	0	4288
27180	0	3979	44	19	0	4042
27181	2	41	4	4410	0	4457
27182	0	5	8	4460	0	4473
27183	5	11	4320	57	0	4393
27184	0	5	45	4092	0	4142
27185	4073	8	7	53	0	4141
27186	41	4234	10	22	0	4307
27187	4481	41	4	18	0	4544
27188	52	7	4398	6	0	4463
27189	6	6	39	4382	0	4433
27190	4514	3	5	44	0	4566
27191	4377	9	8	5	0	4399
27192	60	4	4655	9	0	4728
27193	17	4	48	4321	0	4390
27194	13	7	4556	55	0	4631
27195	4114	2	55	9	0	4180
27196	56	4486	11	10	0	4563
27197	4530	43	19	6	0	4598
27198	4624	6	6	11	0	4647
27199	51	4468	23	5	0	4547
27200	4685	50	5	5	0	4745
27201	64	19	4586	5	0	4674
27202	4647	11	48	4	0	4710
27203	66	6	8	4715	0	4795
27204	17	20	4687	50	0	4774
27205	25	7	40	4584	0	4656
27206	10	7	19	4740	0	4776
27207	20	2	11	4812	0	4845
27208	11	4490	10	68	0	4579
27209	4759	43	11	24	0	4837
27210	53	8	4	4811	0	4876
27211	12	4509	12	66	0	4599
27212	16	45	5	4806	0	4872
27213	8	4523	11	57	0	4599
27214	24	62	4540	18	0	4644
27215	13	12	44	4969	0	5038
27216	5	26	11	5176	0	5218
27217	17	11	5143	68	0	5239
27218	4261	13	64	31	0	4369
27219	47	5028	29	27	0	5131
27220	16	47	20	5283	0	5366
27221	14	14	14	4770	0	4812
27222	13	10	15	4727	0	4765
27223	18	4512	11	72	0	4613
27224	4660	56	14	28	0	4758
27225	58	18	4624	31	0	4731
27226	25	21	4522	21	0	4589
27227	21	10	50	4469	0	4550
27228	15	12	21	4777	0	4825
27229	4767	9	21	59	0	4856
27230	56	4471	25	33	0	4585
27231	17	48	21	4788	0	4874
27232	4783	10	8	73	0	4874
27233	54	15	15	4661	0	4745
27234	4766	7	14	69	0	4856
27235	67	24	4482	22	0	4595
27236	35	4489	51	32	0	4607
27237	4945	50	13	15	0	5023
27238	66	17	4769	25	0	4877
27239	4605	9	50	24	0	4688
27240	70	16	4636	22	0	4744
27241	4659	16	56	9	0	4740
27242	73	11	17	4781	0	4882
27243	4901	6	28	55	0	4990
27244	66	9	12	4785	0	4872
27245	25	11	17	4863	0	4916
27246	4893	5	9	70	0	4977
27247	59	4848	15	39	0	4961
27248	34	52	7	5197	0	5290
27249	5194	11	10	80	0	5295
27250	5234	17	15	32	0	5298
27251	79	10	7	4965	0	5061
27252	22	22	8	5192	0	5244
27253	5431	12	9	79	0	5531
27254	75	21	9	5924	0	6029
27255	33	5	15	6030	0	6083
27256	5954	8	11	81	0	6054
27257	73	11	9	5899	0	5992
27258	34	17	5786	83	0	5920
27259	4893	5	30	32	0	4960
27260	38	6	5334	25	0	5403
27261	23	13	5025	28	0	5089
27262	4657	6	311	23	0	4997
27263	24	5034	56	9	0	5123
27264	24	28	18	4765	0	4835
27265	1	5	1	3681	0	3688
27266	5	5	1	4652	0	4663
27267	2	5	0	4847	0	4854
27268	4704	2	5	58	0	4769
27269	4772	2	1	18	0	4793
27270	4768	1	3	9	0	4781
27271	58	11	4218	9	0	4296
27272	21	0	38	4269	0	4328
27273	12	3	10	4423	0	4448
27274	5	4	9	4275	0	4293
27275	9	4190	17	73	0	4289
27276	7	4430	9	17	0	4463
27277	4421	66	5	17	0	4509
27278	63	14	5	4449	0	4531
27279	18	6	7	5088	0	5119
27280	14	4	3	5276	0	5297
27281	17	8	4933	148	0	5106
27282	18	12	4785	45	0	4860
27283	4897	5	122	30	0	5054
27284	5157	6	29	27	0	5219
27285	137	3	19	5052	0	5211
27286	29	4789	24	125	0	4967
27287	27	124	9	4779	0	4939
27288	24	26	3	5001	0	5054
27289	18	16	4682	171	0	4887
27290	4551	18	113	49	0	4731
27291	130	15	35	4884	0	5064
27292	37	10	23	4776	0	4846
27293	4589	5	20	172	0	4786
27294	153	4236	19	361	0	4769
27295	4652	125	11	59	0	4847
27296	146	32	12	4549	0	4739
27297	51	4498	22	169	0	4740
27298	4640	139	16	62	0	4857
27299	158	31	15	4671	0	4875
27300	4620	12	17	177	0	4826
27301	4468	22	12	78	0	4580
27302	4410	16	14	58	0	4498
27303	173	4278	23	56	0	4530
27304	71	4470	20	50	0	4611
27305	58	147	19	4372	0	4596
27306	52	4350	19	167	0	4588
27307	4486	150	14	74	0	4724
27308	158	51	11	4517	0	4737
27309	4474	30	12	193	0	4709
27310	4589	30	22	69	0	4710
27311	198	24	23	4443	0	4688
27312	82	34	17	4607	0	4740
27313	4483	29	13	191	0	4716
27314	4520	29	23	85	0	4657
27315	4106	41	16	68	0	4231
27316	4279	30	17	68	0	4394
27317	4294	28	16	72	0	4410
27318	233	32	16	4156	0	4437
27319	107	30	14	4664	0	4815
27320	73	23	14	4791	0	4901
27321	4545	27	17	288	0	4877
27322	241	25	15	4464	0	4745
27323	108	4460	15	247	0	4830
27324	91	185	12	4641	0	4929
27325	4583	51	16	250	0	4900
27326	4727	40	14	120	0	4901
27327	288	38	4267	82	0	4675
27328	128	22	160	4214	0	4524
27329	109	4369	47	222	0	4747
27330	4470	177	22	121	0	4790
27331	244	4493	20	98	0	4855
27332	110	204	12	4757	0	5083
27333	4744	89	20	239	0	5092
27334	4814	49	20	132	0	5015
27335	292	4630	21	85	0	5028
27336	141	188	18	5136	0	5483
27337	103	80	4923	272	0	5378
27338	5052	59	167	118	0	5396
27339	252	65	4912	93	0	5322
27340	5126	50	182	93	0	5451
27341	5273	43	67	85	0	5468
27342	323	31	21	5124	0	5499
27343	5213	37	29	248	0	5527
27344	5314	42	17	125	0	5498
27345	5351	38	19	90	0	5498
27346	322	35	18	5156	0	5531
27347	4867	21	19	237	0	5144
27348	272	30	21	4823	0	5146
27349	143	28	19	4848	0	5038
27350	113	4668	14	278	0	5073
27351	101	178	16	4583	0	4878
27352	103	4651	17	212	0	4983
27353	4548	188	11	120	0	4867
27354	4094	67	10	78	0	4249
27355	278	42	13	3953	0	4286
27356	140	45	18	4125	0	4328
27357	3722	24	8	270	0	4024
27358	245	45	3475	121	0	3886
27359	3885	26	155	93	0	4159
27360	236	34	47	3902	0	4219
27361	112	32	3219	206	0	3569
27362	3373	34	150	85	0	3642
27363	3595	26	41	63	0	3725
27364	249	31	3261	70	0	3611
27365	3200	24	145	54	0	3423
27366	200	15	2569	46	0	2830
27367	95	2758	144	34	0	3031
27368	2911	134	51	35	0	3131
27369	2979	38	30	31	0	3078
27370	193	2710	35	44	0	2982
27371	94	2903	16	47	0	3060
27372	3007	152	175	43	0	3377
27373	3108	45	17	22	0	3192
27374	192	26	14	2955	0	3187
27375	98	34	2800	133	0	3065
27376	74	26	2763	66	0	2929
27377	2972	21	136	45	0	3174
27378	163	25	2895	46	0	3129
27379	2360	6	66	11	0	2443
27380	87	7	25	2339	0	2458
27381	42	13	8	2400	0	2463
27382	31	13	2592	92	0	2728
27383	2678	10	52	40	0	2780
27384	76	12	28	2750	0	2866
27385	41	3	15	2643	0	2702
27386	2605	4	9	86	0	2704
27387	2579	5	8	45	0	2637
27388	2585	1	8	25	0	2619
27389	91	2710	17	22	0	2840
27390	48	57	2727	12	0	2844
27391	2790	21	52	14	0	2877
27392	2911	10	28	15	0	2964
27393	88	2750	18	11	0	2867
27394	2912	51	9	11	0	2983
27395	83	26	4	2855	0	2968
27396	46	14	2778	58	0	2896
27397	2829	6	52	35	0	2922
27398	2899	7	27	15	0	2948
27399	2908	9	7	10	0	2934
27400	2938	10	7	11	0	2966
27401	95	5	7	2857	0	2964
27402	52	8	7	2898	0	2965
27403	2890	5	4	81	0	2980
27404	75	10	7	2886	0	2978
27405	50	7	2	2879	0	2938
27406	22	2744	13	90	0	2869
27407	16	50	11	2894	0	2971
27408	19	23	8	2906	0	2956
27409	24	6	6	2923	0	2959
27410	18	8	6	2913	0	2945
27411	24	2736	6	91	0	2857
27412	16	45	3	2905	0	2969
27413	12	24	7	2914	0	2957
27414	21	12	2796	87	0	2916
27415	20	13	2731	45	0	2809
27416	6	2482	47	20	0	2555
27417	2900	27	20	11	0	2958
27418	50	2856	14	13	0	2933
27419	5	20	1	3055	0	3081
27420	5	8	2953	78	0	3044
27421	3347	4	66	21	0	3438
27422	75	1	19	3532	0	3627
27423	3466	1	13	84	0	3564
27424	3500	0	8	33	0	3541
27425	99	3811	13	19	0	3942
27426	3891	77	4	13	0	3985
27427	93	3845	7	12	0	3957
27428	38	90	3	4245	0	4376
27429	26	4249	9	102	0	4386
27430	23	125	4066	33	0	4247
27431	11	4259	89	22	0	4381
27432	10	116	30	4132	0	4288
27433	4017	39	11	105	0	4172
27434	87	4064	16	45	0	4212
27435	39	110	7	4594	0	4750
27436	17	44	2	4500	0	4563
27437	21	30	4230	151	0	4432
27438	12	18	112	4395	0	4537
27439	11	18	4277	161	0	4467
27440	4200	10	137	63	0	4410
27441	135	23	4200	35	0	4393
27442	47	4207	129	40	0	4423
27443	36	129	46	4282	0	4493
27444	39	33	28	4374	0	4474
27445	26	38	15	4511	0	4590
27446	4404	24	16	186	0	4630
27447	137	32	13	4247	0	4429
27448	44	4322	21	177	0	4564
27449	4290	151	23	70	0	4534
27450	131	4317	45	53	0	4546
27451	50	165	22	4402	0	4639
27452	4381	63	15	175	0	4634
27453	156	4149	29	67	0	4401
27454	51	4352	9	75	0	4487
27455	4365	168	15	77	0	4625
27456	4491	59	26	76	0	4652
27457	158	60	4326	53	0	4597
27458	4413	37	143	80	0	4673
27459	184	34	4190	44	0	4452
27460	97	36	160	4220	0	4513
27461	57	38	3949	169	0	4213
27462	53	52	152	4018	0	4275
27463	43	31	3925	210	0	4209
27464	36	40	151	3935	0	4162
27465	46	33	62	4134	0	4275
27466	4012	31	40	227	0	4310
27467	153	36	3725	118	0	4032
27468	3735	62	146	74	0	4017
27469	183	46	3731	67	0	4027
27470	86	64	4272	59	0	4481
27471	75	34	178	4251	0	4538
27472	4096	49	68	196	0	4409
27473	159	3989	67	101	0	4316
27474	4047	165	37	106	0	4355
27475	4454	61	56	73	0	4644
27476	240	4318	53	71	0	4682
27477	4459	162	91	56	0	4768
27478	241	85	4248	47	0	4621
27479	100	52	199	4401	0	4752
27480	4360	50	87	218	0	4715
27481	173	4263	92	127	0	4655
27482	96	155	52	3940	0	4243
27483	61	61	70	4118	0	4310
27484	82	59	37	4122	0	4300
27485	91	35	46	4222	0	4394
27486	4064	54	52	245	0	4415
27487	4114	40	77	131	0	4362
27488	4164	46	51	98	0	4359
27489	3895	45	84	96	0	4120
27490	252	55	3697	112	0	4116
27491	3729	42	182	99	0	4052
27492	3840	68	71	72	0	4051
27493	236	3647	83	70	0	4036
27494	192	3826	47	68	0	4133
27495	135	214	68	3733	0	4150
27496	120	108	51	3914	0	4193
27497	106	73	3645	228	0	4052
27498	85	3689	201	142	0	4117
27499	90	176	93	3611	0	3970
27500	110	3698	80	216	0	4104
27501	87	197	51	3760	0	4095
27502	97	86	48	3722	0	3953
27503	90	3745	55	262	0	4152
27504	87	187	39	3877	0	4190
27505	90	74	3692	264	0	4120
27506	116	62	3691	120	0	3989
27507	3677	57	210	104	0	4048
27508	3829	51	105	84	0	4069
27509	251	3697	89	84	0	4121
27510	3863	175	71	83	0	4192
27511	276	259	53	3583	0	4171
27512	3714	99	40	189	0	4042
27513	243	3652	52	112	0	4059
27514	119	207	3612	103	0	4041
27515	3707	83	168	132	0	4090
27516	227	72	3680	101	0	4080
27517	112	78	3364	74	0	3628
27518	94	80	3369	96	0	3639
27519	63	2790	97	90	0	3040
27520	2675	108	281	71	0	3135
27521	2463	44	30	79	0	2616
27522	126	41	30	2395	0	2592
27523	71	40	36	2400	0	2547
27524	65	2347	39	121	0	2572
27525	2551	74	56	66	0	2747
27526	124	2448	56	43	0	2671
27527	117	2515	38	40	0	2710
27528	2140	59	27	24	0	2250
27529	80	41	23	2109	0	2253
27530	61	38	16	2117	0	2232
27531	48	33	15	2131	0	2227
27532	43	2083	30	76	0	2232
27533	2133	50	36	49	0	2268
27534	77	35	23	2118	0	2253
27535	14	1589	5	41	0	1649
27536	5	1387	10	4	0	1406
27537	7	17	3	1379	0	1406
27538	6	1353	9	20	0	1388
27539	7	20	0	1383	0	1410
27540	1380	3	2	17	0	1402
27541	22	9	1308	4	0	1343
27542	4	1325	19	15	0	1363
27543	6	14	2	1391	0	1413
27544	3	8	1321	25	0	1357
27545	1340	5	11	8	0	1364
27546	19	8	0	1388	0	1415
27547	1384	7	1	18	0	1410
27548	1374	3	0	7	0	1384
27549	18	1348	7	8	0	1381
27550	1403	16	2	5	0	1426
27551	1387	3	0	8	0	1398
27552	1386	6	0	5	0	1397
27553	19	7	4	1356	0	1386
27554	3	6	1	1376	0	1386
27555	2	6	2	1389	0	1399
27556	4	6	1337	23	0	1370
27557	5	1310	17	3	0	1335
27558	1372	20	3	6	0	1401
27559	20	1328	7	10	0	1365
27560	10	17	2	1375	0	1404
27561	4	7	1335	23	0	1369
27562	1224	4	14	6	0	1248
27563	18	1330	4	7	0	1359
27564	7	16	4	1351	0	1378
27565	8	3	2	1372	0	1385
27566	5	3	1312	19	0	1339
27567	12	1281	16	7	0	1316
27568	6	16	5	1355	0	1382
27569	3	7	3	1356	0	1369
27570	11	1	4	933	0	949
27571	917	4	3	17	0	941
27572	23	5	875	6	0	909
27573	6	889	15	6	0	916
27574	928	19	5	8	0	960
27575	1	560	0	1	0	562
27576	0	1	0	577	0	578
27577	0	563	2	1	0	566
27578	576	1	0	0	0	577
27579	571	0	0	0	0	571
27580	1	0	0	569	0	570
27581	0	1	0	992	0	993
27582	0	0	0	1017	0	1017
27583	1	4	935	13	0	953
27584	0	967	12	7	0	986
27585	0	10	4	1748	0	1762
27586	3	4	2	1781	0	1790
27587	0	4	0	1807	0	1811
27588	0	1	0	1816	0	1817
27589	2	4	1673	67	0	1746
27590	0	1724	39	29	0	1792
27591	0	38	17	1738	0	1793
27592	2	14	9	1821	0	1846
27593	0	18	1686	65	0	1769
27594	1	1	39	1690	0	1731
27595	2	1658	23	56	0	1739
27596	0	1753	22	24	0	1799
27597	0	51	2	1795	0	1848
27598	0	30	1681	54	0	1765
27599	1622	11	40	38	0	1711
27600	40	1687	26	29	0	1782
27601	16	49	1704	11	0	1780
27602	11	26	1666	16	0	1719
27603	0	1697	60	17	0	1774
27604	1	47	1716	13	0	1777
27605	2	23	52	1763	0	1840
27606	1752	16	20	55	0	1843
27607	1758	12	16	27	0	1813
27608	1730	7	12	26	0	1775
27609	1765	6	11	14	0	1796
27610	73	1724	10	9	0	1816
27611	1716	51	9	11	0	1787
27612	50	1734	17	15	0	1816
27613	21	62	1839	17	0	1939
27614	18	22	41	1829	0	1910
27615	7	1945	27	54	0	2033
27616	10	45	21	1997	0	2073
27617	1909	31	10	60	0	2010
27618	55	21	7	1872	0	1955
27619	27	1917	8	63	0	2015
27620	1991	43	11	29	0	2074
27621	54	29	1901	20	0	2004
27622	36	26	45	1934	0	2041
27623	19	20	22	1973	0	2034
27624	1913	15	24	75	0	2027
27625	46	1442	11	47	0	1546
27626	30	56	1370	29	0	1485
27627	21	29	51	1475	0	1576
27628	17	24	1422	55	0	1518
27629	9	1378	62	48	0	1497
27630	9	1489	30	32	0	1560
27631	1490	65	23	21	0	1599
27632	52	36	1422	26	0	1536
27633	1485	20	60	33	0	1598
27634	63	19	28	1406	0	1516
27635	34	1468	30	63	0	1595
27636	1483	55	17	48	0	1603
27637	52	35	1411	34	0	1532
27638	32	35	56	1467	0	1590
27639	28	20	37	1481	0	1566
27640	16	21	30	1438	0	1505
27641	17	1481	22	79	0	1599
27642	1411	63	14	57	0	1545
27643	61	1999	25	32	0	2117
27644	43	2110	14	20	0	2187
27645	29	71	16	2117	0	2233
27646	2098	48	19	72	0	2237
27647	2109	25	22	45	0	2201
27648	2095	29	26	30	0	2180
27649	77	2038	24	36	0	2175
27650	38	63	17	2112	0	2230
27651	40	38	2026	81	0	2185
27652	26	33	58	2081	0	2198
27653	31	18	35	2031	0	2115
27654	30	2054	21	82	0	2187
27655	2101	69	13	60	0	2243
27656	65	43	17	2077	0	2202
27657	48	2065	18	75	0	2206
27658	2122	62	20	46	0	2250
27659	71	35	2013	37	0	2156
27660	2013	54	58	25	0	2150
27661	73	2071	32	46	0	2222
27662	2102	69	30	33	0	2234
27663	2135	42	25	28	0	2230
27664	76	43	2024	43	0	2186
27665	2086	30	56	30	0	2202
27666	85	31	2077	28	0	2221
27667	47	29	2088	39	0	2203
27668	2066	27	77	24	0	2194
27669	2133	22	44	24	0	2223
27670	89	36	2064	20	0	2209
27671	59	23	65	2034	0	2181
27672	39	27	40	1992	0	2098
27673	33	2059	32	80	0	2204
27674	2102	55	26	41	0	2224
27675	2907	40	21	37	0	3005
27676	106	42	2755	17	0	2920
27677	2783	22	58	21	0	2884
27678	2847	21	39	21	0	2928
27679	101	2738	32	17	0	2888
27680	63	70	20	2841	0	2994
27681	36	33	13	2369	0	2451
27682	24	24	10	2438	0	2496
27683	2384	11	20	71	0	2486
27684	63	2367	11	45	0	2486
27685	1	2	0	1623	0	1626
27686	0	1538	0	2	0	1540
27687	2	3	0	1615	0	1620
27688	1	1558	2	1	0	1562
27689	1	1551	2	2	0	1556
27690	1617	3	0	1	0	1621
27691	1605	2	0	2	0	1609
27692	3	1	1	1593	0	1598
27693	2	0	0	1589	0	1591
27694	0	1	0	1618	0	1619
27695	0	2	0	1608	0	1610
27696	1	0	0	1590	0	1591
27697	1	1544	1	4	0	1550
27698	1	2	0	1620	0	1623
27699	2	1	0	1617	0	1620
27700	1560	1	1	4	0	1566
27701	2	0	0	1593	0	1595
27702	1	1	1	1608	0	1611
27703	1	0	1586	3	0	1590
27704	2	0	1	1545	0	1548
27705	1	1	2	1602	0	1606
27706	3	0	1584	2	0	1589
27707	0	1463	5	2	0	1470
27708	2	4	2072	5	0	2083
27709	4	3	2043	2	0	2052
27710	1	1849	18	3	0	1871
27711	1914	0	1	0	0	1915
27712	1902	0	0	0	0	1902
27713	0	1	0	1848	0	1849
27714	1857	0	0	1	0	1858
27715	0	1	2322	0	0	2323
27716	2	1	2	2244	0	2249
27717	3	1	2716	0	0	2720
27718	1	2	0	2697	0	2700
27719	1	1	1	2718	0	2721
27720	1	1	0	2754	0	2756
27721	2781	0	0	0	0	2781
27722	0	2	0	2751	0	2753
27723	2751	0	0	1	0	2752
27724	2748	0	0	1	0	2749
27725	0	2651	8	1	0	2660
27726	2778	0	0	0	0	2778
27727	0	2674	3	2	0	2679
27728	0	1	2	2730	0	2733
27729	1	0	0	2685	0	2686
27730	0	0	0	2731	0	2731
27731	0	1	2696	0	0	2697
27732	0	2524	4	4	0	2532
27733	0	0	0	2767	0	2767
27734	0	0	1	2752	0	2753
27735	0	2657	4	3	0	2664
27736	2762	1	0	0	0	2763
27737	0	2664	3	7	0	2674
27738	2692	0	0	1	0	2693
27739	0	2674	5	1	0	2680
27740	1	2	0	2726	0	2729
27741	0	2673	5	0	0	2678
27742	2729	0	2	1	0	2732
27743	2748	0	0	0	0	2748
27744	2729	1	0	0	0	2730
27745	2703	3	0	2	0	2708
27746	3	3	2683	0	0	2689
27747	2649	0	0	2	0	2651
27748	2729	0	0	0	0	2729
27749	2701	1	0	0	0	2702
27750	1	2	2664	0	0	2667
27751	2618	0	0	0	0	2618
27752	0	2617	5	1	0	2623
27753	2748	0	1	0	0	2749
27754	3	3	3413	0	0	3419
27755	3398	0	1	2	0	3401
27756	3483	1	1	0	0	3485
27757	0	3	1	3451	0	3455
27758	1	3	3430	0	0	3434
27759	3392	1	0	1	0	3394
27760	0	1	0	3456	0	3457
27761	0	0	1	3375	0	3376
27762	3	3	3418	2	0	3426
27763	3024	1	4	1	0	3030
27764	3453	0	1	2	0	3456
27765	1	3621	8	3	0	3633
27766	0	0	1	3865	0	3866
27767	3	0	1	3837	0	3841
27768	1	2	2	3842	0	3847
27769	0	3667	10	0	0	3677
27770	3880	0	0	2	0	3882
27771	1	1	0	3840	0	3842
27772	0	1	0	3850	0	3851
27773	3886	0	0	1	0	3887
27774	3781	0	1	5	0	3787
27775	0	1	0	3136	0	3137
27776	1	0	0	3139	0	3140
27777	1	1	3107	0	0	3109
27778	2816	1	3	3	0	2823
27779	0	2919	11	4	0	2934
27780	1	0	1	3172	0	3174
27781	1	1	0	3166	0	3168
27782	0	2999	11	0	0	3010
27783	0	0	0	3182	0	3182
27784	3664	1	2	1	0	3668
27785	34	1	0	4977	0	5012
27786	16	0	1	5643	0	5660
27787	13	0	0	5790	0	5803
27788	8	16	5406	212	0	5642
27789	1	1	102	5617	0	5721
27790	13	20	5295	209	0	5537
27791	4	5271	159	120	0	5554
27792	12	108	78	5650	0	5848
27793	4	54	57	5716	0	5831
27794	5	48	53	5730	0	5836
27795	3	32	26	5764	0	5825
27796	5	19	29	5863	0	5916
27797	5488	19	25	301	0	5833
27798	117	32	5259	206	0	5614
27799	54	5193	122	151	0	5520
27800	53	5550	67	116	0	5786
27801	36	158	50	5626	0	5870
27802	21	96	39	5710	0	5866
27803	24	82	25	5717	0	5848
27804	11	5791	39	325	0	6166
27805	17	137	20	6219	0	6393
27806	22	97	5825	324	0	6268
27807	7	5840	192	175	0	6214
27808	8	161	73	5813	0	6055
27809	5538	84	108	233	0	5963
27810	116	129	61	5712	0	6018
27811	56	75	18	5796	0	5945
27812	56	5257	40	333	0	5686
27813	38	5498	33	245	0	5814
27814	27	169	16	5798	0	6010
27815	24	117	26	5440	0	5607
27816	78	117	4905	296	0	5396
27817	35	56	182	4860	0	5133
27818	15	105	90	4979	0	5189
27819	10	120	60	4978	0	5168
27820	11	54	58	5119	0	5242
27821	4738	40	48	436	0	5262
27822	4751	41	45	326	0	5163
27823	173	90	36	4960	0	5259
27824	115	52	23	5081	0	5271
27825	4828	21	81	367	0	5297
27826	179	74	30	5041	0	5324
27827	115	52	4525	461	0	5153
27828	161	4540	146	306	0	5153
27829	97	137	82	5507	0	5823
27830	56	86	114	5662	0	5918
27831	5278	158	72	393	0	5901
27832	173	162	75	5504	0	5914
27833	97	99	46	5720	0	5962
27834	5340	51	22	532	0	5945
27835	180	52	88	5572	0	5892
27836	110	5115	55	495	0	5775
27837	113	165	25	5922	0	6225
27838	86	94	38	6245	0	6463
27839	98	99	42	6197	0	6436
27840	125	85	49	6231	0	6490
27841	142	102	5607	450	0	6301
27842	66	114	5584	398	0	6162
27843	36	68	202	5513	0	5819
27844	85	85	112	5503	0	5785
27845	38	5142	95	501	0	5776
27846	34	193	142	5391	0	5760
27847	20	5262	107	416	0	5805
27848	5149	252	88	351	0	5840
27849	157	5230	57	346	0	5790
27850	165	228	48	5461	0	5902
27851	133	142	41	5595	0	5911
27852	76	125	4897	511	0	5609
27853	4955	104	150	334	0	5543
27854	4566	98	80	332	0	5076
27855	242	4506	68	277	0	5093
27856	164	195	71	4516	0	4946
27857	138	125	4631	388	0	5282
27858	84	4775	227	313	0	5399
27859	4843	215	104	337	0	5499
27860	4969	135	132	243	0	5479
27861	276	121	4746	200	0	5343
27862	4913	78	189	265	0	5445
27863	337	63	84	4891	0	5375
27864	218	4736	78	315	0	5347
27865	4573	192	60	244	0	5069
27866	292	176	51	4588	0	5107
27867	4672	117	63	305	0	5157
27868	4699	119	39	252	0	5109
27869	308	80	65	4677	0	5130
27870	198	98	4176	412	0	4884
27871	4465	50	202	285	0	5002
27872	4650	59	113	234	0	5056
27873	4623	44	91	200	0	4958
27874	354	4418	64	203	0	5039
27875	232	192	47	4524	0	4995
27876	203	120	95	4687	0	5105
27877	131	145	4182	381	0	4839
27878	170	120	159	4765	0	5214
27879	180	4624	81	393	0	5278
27880	4650	208	107	292	0	5257
27881	259	4654	93	269	0	5275
27882	155	238	5083	218	0	5694
27883	119	5273	240	181	0	5813
27884	164	4948	133	134	0	5379
27885	591	101	27	2957	0	3676
27886	2891	19	1	60	0	2971
27887	2868	19	3	24	0	2914
27888	2852	14	2	23	0	2891
27889	49	3175	14	25	0	3263
27890	24	44	3169	15	0	3252
27891	3202	16	43	21	0	3282
27892	3318	12	16	23	0	3369
27893	60	3189	12	10	0	3271
27894	3710	50	11	8	0	3779
27895	52	23	11	3663	0	3749
27896	28	27	3731	48	0	3834
27897	3783	22	39	23	0	3867
27898	3849	12	16	24	0	3901
27899	4038	9	8	17	0	4072
27900	72	6	9	3960	0	4047
27901	35	5	10	3956	0	4006
27902	25	12	4	4573	0	4614
27903	15	4657	14	119	0	4805
27904	21	126	3	4641	0	4791
27905	17	42	5	4819	0	4883
27906	18	45	4551	177	0	4791
27907	28	21	131	4674	0	4854
27908	18	17	40	4850	0	4925
27909	17	26	39	4805	0	4887
27910	19	8	31	4819	0	4877
27911	19	4511	32	255	0	4817
27912	26	136	27	4797	0	4986
27913	19	48	10	4913	0	4990
27914	4690	46	13	261	0	5010
27915	153	34	4508	149	0	4844
27916	55	37	4500	116	0	4708
27917	4466	29	168	90	0	4753
27918	4753	15	84	83	0	4935
27919	210	24	70	4244	0	4548
27920	113	4521	46	151	0	4831
27921	4764	154	42	56	0	5016
27922	185	56	35	4611	0	4887
27923	84	4747	34	174	0	5039
27924	4899	171	17	62	0	5149
27925	174	4813	21	80	0	5088
27926	4925	202	23	54	0	5204
27927	4974	75	8	41	0	5098
27928	234	4739	19	47	0	5039
27929	91	147	8	4343	0	4589
27930	83	66	4156	136	0	4441
27931	51	64	110	4258	0	4483
27932	4325	30	34	170	0	4559
27933	150	40	4132	69	0	4391
27934	61	4005	128	173	0	4367
27935	46	135	44	4311	0	4536
27936	46	57	4151	152	0	4406
27937	29	3852	140	87	0	4108
27938	3821	143	54	61	0	4079
27939	131	51	61	3829	0	4072
27940	58	63	38	3904	0	4063
27941	50	34	27	3890	0	4001
27942	35	3698	39	199	0	3971
27943	3798	143	26	109	0	4076
27944	151	3684	20	86	0	3941
27945	59	4350	17	78	0	4504
27946	4501	165	13	67	0	4746
27947	4835	87	10	52	0	4984
27948	186	82	4612	31	0	4911
27949	4675	49	119	32	0	4875
27950	4881	55	39	29	0	5004
27951	192	46	37	4716	0	4991
27952	127	41	5050	136	0	5354
27953	106	26	120	5004	0	5256
27954	5180	19	54	164	0	5417
27955	179	37	5779	76	0	6071
27956	94	25	139	6418	0	6676
27957	84	21	54	7230	0	7389
27958	58	15	66	8052	0	8191
27959	7808	17	37	358	0	8220
27960	290	7580	45	140	0	8055
27961	7824	254	39	105	0	8222
27962	314	68	7858	91	0	8331
27963	93	50	265	7863	0	8271
27964	75	7932	80	317	0	8404
27965	8183	293	60	99	0	8635
27966	310	95	33	8228	0	8666
27967	115	78	7856	340	0	8389
27968	73	48	264	8161	0	8546
27969	8079	34	67	379	0	8559
27970	295	7956	66	141	0	8458
27971	125	312	34	7787	0	8258
27972	80	7934	43	316	0	8373
27973	8077	325	40	137	0	8579
27974	8277	95	28	135	0	8535
27975	369	8003	50	76	0	8498
27976	8232	335	26	74	0	8667
27977	383	93	30	7925	0	8431
27978	123	7726	40	308	0	8197
27979	7899	304	17	103	0	8323
27980	7976	104	19	86	0	8185
27981	390	7504	37	71	0	8002
27982	170	7217	24	59	0	7470
27983	7235	329	26	61	0	7651
27984	332	134	25	7180	0	7671
27985	7270	90	29	303	0	7692
27986	385	73	12	7221	0	7691
27987	171	81	6856	344	0	7452
27988	118	70	228	7102	0	7518
27989	6834	54	65	353	0	7306
27990	346	53	6511	146	0	7056
27991	144	43	264	6630	0	7081
27992	103	48	68	6976	0	7195
27993	93	46	6537	365	0	7041
27994	6010	38	273	175	0	6496
27995	341	33	86	6624	0	7084
27996	128	42	6220	352	0	6742
27997	5822	44	290	139	0	6295
27998	286	6544	99	141	0	7070
27999	122	6688	96	101	0	7007
28000	107	6808	65	100	0	7080
28001	94	377	6477	92	0	7040
28002	41	343	194	5701	0	6279
28003	34	56	6360	216	0	6666
28004	36	186	172	6111	0	6505
28005	35	6118	55	209	0	6417
28006	26	6194	37	57	0	6314
28007	20	192	17	6280	0	6509
28008	6237	45	18	192	0	6492
28009	163	42	19	6182	0	6406
28010	52	22	16	6294	0	6384
28011	47	6064	19	212	0	6342
28012	6135	180	11	78	0	6404
28013	180	6069	22	48	0	6319
28014	59	198	22	6204	0	6483
28015	47	51	18	6324	0	6440
28016	30	6061	29	221	0	6341
28017	37	179	16	6322	0	6554
28018	6272	55	9	258	0	6594
28019	211	54	21	6266	0	6552
28020	89	51	14	6352	0	6506
28021	73	6027	26	223	0	6349
28022	82	199	32	6304	0	6617
28023	6087	55	28	252	0	6422
28024	6133	78	16	84	0	6311
28025	6150	61	17	75	0	6303
28026	271	37	20	6031	0	6359
28027	84	59	5734	236	0	6113
28028	80	60	5657	96	0	5893
28029	82	39	169	5937	0	6227
28030	6077	67	42	225	0	6411
28031	215	55	32	6025	0	6327
28032	6081	58	17	246	0	6402
28033	242	59	28	5997	0	6326
28034	121	53	15	6748	0	6937
28035	6694	53	19	241	0	7007
28036	227	65	6326	93	0	6711
28037	6424	36	155	90	0	6705
28038	242	46	6430	88	0	6806
28039	103	52	190	6515	0	6860
28040	6596	27	48	212	0	6883
28041	244	52	6384	80	0	6760
28042	81	75	6333	53	0	6542
28043	6105	51	203	59	0	6418
28044	239	33	6325	77	0	6674
28045	83	5624	199	87	0	5993
28046	94	175	57	5952	0	6278
28047	6597	45	60	260	0	6962
28048	216	45	6391	100	0	6752
28049	6448	29	185	97	0	6759
28050	6675	29	75	79	0	6858
28051	6673	26	64	81	0	6844
28052	6331	30	44	97	0	6502
28053	235	28	54	6025	0	6342
28054	93	5954	68	216	0	6331
28055	5437	181	43	99	0	5760
28056	192	40	4683	87	0	5002
28057	37	3428	72	25	0	3562
28058	3191	27	9	7	0	3234
28059	27	3027	15	7	0	3076
28060	20	3302	7	9	0	3338
28061	15	35	326	3690	0	4066
28062	3	0	1	3665	0	3669
28063	1	2	1	3686	0	3690
28064	4133	1	3	5	0	4142
28065	4024	1	7	1	0	4033
28066	33	3	2	4261	0	4299
28067	12	0	1	5087	0	5100
28068	1	8	5079	83	0	5171
28069	4896	1	76	20	0	4993
28070	5273	2	18	7	0	5300
28071	102	2	8	5210	0	5322
28072	21	1	3	5332	0	5357
28073	11	14	5129	105	0	5259
28074	10	1	76	5128	0	5215
28075	10	4	5079	96	0	5189
28076	7	4805	99	34	0	4945
28077	11	92	5111	19	0	5233
28078	5	16	91	4960	0	5072
28079	7	9	5147	97	0	5260
28080	12	14	4907	22	0	4955
28081	4945	4	106	15	0	5070
28082	90	1	25	5387	0	5503
28083	23	7	5328	106	0	5464
28084	4951	4	106	26	0	5087
28085	109	7	5242	21	0	5379
28086	31	12	5171	17	0	5231
28087	15	5067	116	23	0	5221
28088	11	89	31	5306	0	5437
28089	9	23	5238	119	0	5389
28090	13	16	5079	26	0	5134
28091	18	9	110	5088	0	5225
28092	19	6	40	5078	0	5143
28093	6	5120	30	137	0	5293
28094	12	100	22	5389	0	5523
28095	5159	19	20	122	0	5320
28096	5063	9	24	34	0	5130
28097	5091	11	15	32	0	5149
28098	124	9	17	4571	0	4721
28099	43	4483	27	117	0	4670
28100	4517	96	25	31	0	4669
28101	101	4476	30	34	0	4641
28102	30	4415	33	31	0	4509
28103	19	4069	21	34	0	4143
28104	4364	116	28	26	0	4534
28105	103	28	24	4320	0	4475
28106	35	23	28	4327	0	4413
28107	24	4284	25	131	0	4464
28108	4346	105	27	48	0	4526
28109	109	36	4216	45	0	4406
28110	45	21	106	4359	0	4531
28111	4401	7	42	122	0	4572
28112	121	4256	37	48	0	4462
28113	4585	106	25	47	0	4763
28114	122	34	22	4404	0	4582
28115	46	4339	32	128	0	4545
28116	30	119	4297	45	0	4491
28117	4379	38	107	37	0	4561
28118	113	29	35	4551	0	4728
28119	4579	16	23	133	0	4751
28120	121	17	32	4523	0	4693
28121	39	4340	19	159	0	4557
28122	38	106	4554	72	0	4770
28123	39	46	4607	58	0	4750
28124	44	25	130	5987	0	6186
28125	6100	15	43	167	0	6325
28126	6111	23	36	74	0	6244
28127	154	16	30	6023	0	6223
28128	73	29	30	6103	0	6235
28129	6117	18	33	174	0	6342
28130	152	24	40	6078	0	6294
28131	6060	20	38	166	0	6284
28132	141	5815	42	86	0	6084
28133	6180	111	39	83	0	6413
28134	162	55	5570	62	0	5849
28135	67	26	144	5740	0	5977
28136	62	30	67	5806	0	5965
28137	46	26	70	5807	0	5949
28138	57	5455	78	182	0	5772
28139	46	5510	70	112	0	5738
28140	41	148	61	5838	0	6088
28141	34	49	5611	185	0	5879
28142	42	53	156	5631	0	5882
28143	40	27	86	5804	0	5957
28144	51	30	75	5894	0	6050
28145	5675	25	81	186	0	5967
28146	153	5426	67	98	0	5744
28147	72	4887	70	78	0	5107
28148	54	181	70	5511	0	5816
28149	59	58	68	5589	0	5774
28150	58	43	61	5584	0	5746
28151	42	38	63	5713	0	5856
28152	5487	38	59	196	0	5780
28153	131	5360	59	110	0	5660
28154	5578	145	51	85	0	5859
28155	5618	64	35	84	0	5801
28156	179	53	35	5511	0	5778
28157	75	38	31	5659	0	5803
28158	5575	28	30	197	0	5830
28159	5615	35	25	108	0	5783
28160	200	45	11	5450	0	5706
28161	67	29	6	4796	0	4898
28162	63	24	4971	165	0	5223
28163	49	4791	150	79	0	5069
28164	45	4685	32	41	0	4803
28165	4701	157	23	32	0	4913
28166	157	43	4451	31	0	4682
28167	22	17	3573	6	0	3618
28168	3186	4	82	4	0	3276
28169	3469	3	28	3	0	3503
28170	84	3524	18	6	0	3632
28171	25	3640	9	6	0	3680
28172	15	74	2	3818	0	3909
28173	3807	24	7	74	0	3912
28174	3824	10	6	23	0	3863
28175	4293	1	5	19	0	4318
28176	89	7	4	4195	0	4295
28177	29	8	2	4320	0	4359
28178	16	9	4044	90	0	4159
28179	7	9	3834	33	0	3883
28180	7	12	4102	17	0	4138
28181	9	4	83	4019	0	4115
28182	3935	2	20	70	0	4027
28183	67	6	3872	23	0	3968
28184	24	7	55	3836	0	3922
28185	11	3701	23	66	0	3801
28186	6	61	9	3980	0	4056
28187	7	12	7	3965	0	3991
28188	8	7	4211	83	0	4309
28189	4	1	73	4128	0	4206
28190	4203	2	35	91	0	4331
28191	79	12	4986	30	0	5107
28192	28	20	72	4961	0	5081
28193	18	16	5053	83	0	5170
28194	17	4639	102	38	0	4796
28195	10	78	4943	16	0	5047
28196	13	28	85	4793	0	4919
28197	25	10	30	5100	0	5165
28198	21	19	5197	104	0	5341
28199	9	16	80	5084	0	5189
28200	9	9	33	5232	0	5283
28201	13	4896	35	113	0	5057
28202	22	84	5053	38	0	5197
28203	21	36	76	4980	0	5113
28204	20	12	28	4932	0	4992
28205	10	4690	20	113	0	4833
28206	6	72	15	5054	0	5147
28207	5015	21	22	92	0	5150
28208	82	12	19	6353	0	6466
28209	25	8	6262	102	0	6397
28210	6146	8	81	51	0	6286
28211	6323	6	43	25	0	6397
28212	106	8	6316	22	0	6452
28213	5805	15	78	25	0	5923
28214	94	5880	51	13	0	6038
28215	31	78	21	6301	0	6431
28216	16	26	19	8219	0	8280
28217	14	22	24	8134	0	8194
28218	18	8	14	8258	0	8298
28219	28	10	19	8318	0	8375
28220	8176	9	18	265	0	8468
28221	165	19	7952	123	0	8259
28222	7665	18	179	68	0	7930
28223	200	26	7844	60	0	8130
28224	89	24	193	6926	0	7232
28225	6987	20	80	233	0	7320
28226	194	21	45	6883	0	7143
28227	98	6648	79	206	0	7031
28228	6987	159	56	121	0	7323
28229	230	65	47	7458	0	7800
28230	100	52	7261	199	0	7612
28231	6817	35	181	124	0	7157
28232	217	7443	82	89	0	7831
28233	106	189	7418	72	0	7785
28234	83	96	181	7395	0	7755
28235	77	37	88	7380	0	7582
28236	59	7294	52	257	0	7662
28237	56	172	7331	134	0	7693
28238	52	71	189	7408	0	7720
28239	47	59	7520	214	0	7840
28240	43	28	238	7471	0	7780
28241	40	25	113	7714	0	7892
28242	49	26	7471	287	0	7833
28243	39	42	203	7474	0	7758
28244	33	37	123	7013	0	7206
28245	27	24	66	7874	0	7991
28246	24	21	71	7947	0	8063
28247	7632	10	50	390	0	8082
28248	198	31	6860	221	0	7310
28249	8338	25	218	132	0	8713
28250	226	14	107	8628	0	8975
28251	114	8	100	8711	0	8933
28252	67	18	69	8723	0	8877
28253	58	8192	60	356	0	8666
28254	8568	171	57	186	0	8982
28255	203	95	57	8577	0	8932
28256	131	8224	60	272	0	8687
28257	66	182	49	8782	0	9079
28258	8572	89	64	299	0	9024
28259	8362	52	59	195	0	8668
28260	8437	55	60	131	0	8683
28261	285	8112	73	121	0	8591
28262	90	142	7644	94	0	7970
28263	7537	85	133	73	0	7828
28264	8024	37	76	100	0	8237
28265	210	7927	49	78	0	8264
28266	8326	141	40	72	0	8579
28267	8259	72	37	77	0	8445
28268	8382	48	29	70	0	8529
28269	231	7950	61	60	0	8302
28270	141	140	42	8706	0	9029
28271	8760	71	29	181	0	9041
28272	9459	56	22	119	0	9656
28273	9442	38	20	93	0	9593
28274	9549	33	16	90	0	9688
28275	306	202	22	8723	0	9253
28276	165	46	8617	217	0	9045
28277	120	34	163	8635	0	8952
28278	87	8549	94	230	0	8960
28279	96	164	37	9012	0	9309
28280	99	76	8640	247	0	9062
28281	8658	46	165	146	0	9015
28282	227	38	79	8900	0	9244
28283	8909	37	68	236	0	9250
28284	8684	38	38	147	0	8907
28285	278	43	39	9253	0	9613
28286	140	50	9176	250	0	9616
28287	120	49	8503	132	0	8804
28288	7905	24	209	90	0	8228
28289	232	8477	105	64	0	8878
28290	147	9413	70	74	0	9704
28291	106	8624	47	82	0	8859
28292	91	8848	48	76	0	9063
28293	8888	251	47	50	0	9236
28294	8937	98	44	48	0	9127
28295	8900	69	30	42	0	9041
28296	8921	71	31	44	0	9067
28297	268	65	29	8601	0	8963
28298	142	8405	29	191	0	8767
28299	8618	203	24	84	0	8929
28300	264	106	8989	64	0	9423
28301	156	8935	166	64	0	9321
28302	139	179	9156	59	0	9533
28303	10003	68	178	61	0	10310
28304	10390	42	73	71	0	10576
28305	10313	60	48	60	0	10481
28306	287	46	46	10135	0	10514
28307	141	44	10868	206	0	11259
28308	103	9624	185	93	0	10005
28309	9724	168	92	66	0	10050
28310	214	9463	59	59	0	9795
28311	148	9500	43	42	0	9733
28312	124	11043	34	52	0	11253
28313	108	11667	54	61	0	11890
28314	95	257	11522	39	0	11913
28315	98	11883	178	50	0	12209
28316	10184	79	17	18	0	10298
28317	88	31	12	10117	0	10248
28318	45	24	10	11288	0	11367
28319	11289	25	11	92	0	11417
28320	87	10835	30	42	0	10994
28321	48	89	11659	32	0	11828
28322	31	44	64	11661	0	11800
28323	29	22	31	12834	0	12916
28324	37	22	14	12909	0	12982
28325	41	19	12778	99	0	12937
28326	39	34	12608	41	0	12722
28327	32	12	88	13638	0	13770
28328	41	21	13899	88	0	14049
28329	39	30	12854	44	0	12967
28330	10844	35	130	48	0	11057
28331	79	12785	56	33	0	12953
28332	16	12746	40	19	0	12821
28333	21	12890	36	22	0	12969
28334	34	86	18	12884	0	13022
28335	30	12736	22	63	0	12851
28336	13099	69	25	24	0	13217
28337	80	40	12658	20	0	12798
28338	12603	24	62	24	0	12713
28339	74	22	21	12983	0	13100
28340	34	17	19	13625	0	13695
28341	31	13442	32	90	0	13595
28342	13857	93	24	41	0	14015
28343	13675	43	22	29	0	13769
28344	121	14094	34	36	0	14285
28345	67	127	7	14242	0	14443
28346	48	63	14028	129	0	14268
28347	47	41	14726	57	0	14871
28348	17	14701	257	39	0	15014
28349	14591	198	73	22	0	14884
28350	244	84	14483	13	0	14824
28351	78	52	223	14441	0	14794
28352	14641	48	72	222	0	14983
28353	14895	44	38	68	0	15045
28354	326	19179	66	56	0	19627
28355	112	20063	44	36	0	20255
28356	21042	577	27	16	0	21662
28357	534	276	20434	23	0	21267
28358	20674	132	484	25	0	21315
28359	21130	62	171	31	0	21394
28360	665	47	95	20732	0	21539
28361	286	64	20528	494	0	21372
28362	170	56	20603	174	0	21003
28363	20080	49	656	114	0	20899
28364	557	85	20611	48	0	21301
28365	19570	55	577	42	0	20244
28366	20356	42	238	22	0	20658
28367	668	19539	174	48	0	20429
28368	349	485	19372	40	0	20246
28369	188	19717	522	47	0	20474
28370	19820	573	230	42	0	20665
28371	563	268	19610	20	0	20461
28372	250	131	490	18642	0	19513
28373	182	83	19164	437	0	19866
28374	174	64	19039	167	0	19444
28375	182	48	19069	98	0	19397
28376	121	79	18954	67	0	19221
28377	94	17853	783	79	0	18809
28378	139	498	18384	24	0	19045
28379	148	17932	664	41	0	18785
28380	148	575	18373	31	0	19127
28381	18797	232	605	39	0	19673
28382	613	145	279	17305	0	18342
28383	256	18612	283	373	0	19524
28384	19272	490	195	156	0	20113
28385	18881	227	212	108	0	19428
28386	18840	162	200	72	0	19274
28387	18931	103	224	44	0	19302
28388	746	18354	215	53	0	19368
28389	19179	466	185	58	0	19888
28390	18625	226	218	44	0	19113
28391	710	18022	210	62	0	19004
28392	352	614	17337	40	0	18343
28393	250	299	573	17464	0	18586
28394	197	17986	365	449	0	18997
28395	192	552	16893	194	0	17831
28396	203	268	16942	130	0	17543
28397	168	16299	834	84	0	17385
28398	191	16908	418	90	0	17607
28399	192	17213	320	56	0	17781
28400	197	16866	232	60	0	17355
28401	16294	781	236	42	0	17353
28402	16437	419	191	54	0	17101
28403	813	331	15509	51	0	16704
28404	442	253	15753	48	0	16496
28405	333	205	746	15057	0	16341
28406	275	206	435	15556	0	16472
28407	300	196	293	15326	0	16115
28408	14874	188	257	703	0	16022
28409	720	14608	216	351	0	15895
28410	462	15273	227	201	0	16163
28411	353	15810	248	133	0	16544
28412	14117	929	256	84	0	15386
28413	13951	476	300	62	0	14789
28414	914	350	257	13145	0	14666
28415	13502	273	271	544	0	14590
28416	13782	312	221	280	0	14595
28417	962	278	258	13264	0	14762
28418	13322	298	321	621	0	14562
28419	877	12986	369	295	0	14527
28420	549	691	380	13208	0	14828
28421	457	461	12088	617	0	13623
28422	422	12234	801	326	0	13783
28423	419	779	11553	270	0	13021
28424	384	467	872	10571	0	12294
28425	413	11728	558	528	0	13227
28426	433	736	455	11430	0	13054
28427	399	438	425	11223	0	12485
28428	411	351	10668	768	0	12198
28429	350	285	11643	464	0	12742
28430	374	261	948	11503	0	13086
28431	389	266	628	10470	0	11753
28432	390	11514	469	727	0	13100
28433	11007	789	359	395	0	12550
28434	836	12115	352	260	0	13563
28435	490	12707	331	209	0	13737
28436	418	992	11638	222	0	13270
28437	333	13118	865	206	0	14522
28438	350	910	555	11785	0	13600
28439	309	13103	440	719	0	14571
28440	262	892	369	11682	0	13205
28441	290	12277	390	737	0	13694
28442	11934	932	325	360	0	13551
28443	790	12783	337	338	0	14248
28444	381	974	308	11069	0	12732
28445	363	12155	322	640	0	13480
28446	10936	971	1423	317	0	13647
28447	11477	467	202	243	0	12389
28448	904	11574	185	148	0	12811
28449	11238	760	146	166	0	12310
28450	836	706	123	10752	0	12417
28451	499	448	10678	570	0	12195
28452	400	1072	10175	295	0	11942
28453	253	11005	685	245	0	12188
28454	6104	268	103	38	0	6513
28455	6318	103	82	32	0	6535
28456	269	74	5292	20	0	5655
28457	93	51	5359	28	0	5531
28458	5203	35	228	30	0	5496
28459	5554	39	94	19	0	5706
28460	272	48	5174	30	0	5524
28461	5203	37	215	27	0	5482
28462	269	5197	64	22	0	5552
28463	88	6281	62	29	0	6460
28464	79	282	32	6049	0	6442
28465	59	117	18	6374	0	6568
28466	6247	84	22	264	0	6617
28467	6261	51	22	100	0	6434
28468	6238	42	30	74	0	6384
28469	311	26	24	6154	0	6515
28470	126	33	39	6185	0	6383
28471	86	5816	40	265	0	6207
28472	66	6073	36	105	0	6280
28473	64	6316	29	68	0	6477
28474	57	306	39	5763	0	6165
28475	44	6034	34	218	0	6330
28476	48	288	5839	64	0	6239
28477	5800	112	215	65	0	6192
28478	266	94	6050	48	0	6458
28479	99	79	6141	29	0	6348
28480	5749	64	266	39	0	6118
28481	233	5710	116	55	0	6114
28482	5887	266	71	44	0	6268
28483	5999	103	45	51	0	6198
28484	310	113	5990	45	0	6458
28485	158	73	6058	44	0	6333
28486	127	6078	267	45	0	6517
28487	106	255	6536	55	0	6952
28488	80	565	260	5991	0	6896
28489	67	102	93	5723	0	5985
28490	65	5955	97	234	0	6351
28491	61	6346	65	95	0	6567
28492	6232	306	44	55	0	6637
28493	6295	139	42	39	0	6515
28494	283	113	49	7239	0	7684
28495	131	76	52	7525	0	7784
28496	7313	63	54	261	0	7691
28497	7329	69	43	118	0	7559
28498	300	7170	48	101	0	7619
28499	7383	241	49	53	0	7726
28500	294	7040	56	61	0	7451
28501	112	7338	59	54	0	7563
28502	7367	314	35	50	0	7766
28503	7490	163	39	42	0	7734
28504	336	124	38	7304	0	7802
28505	7448	99	36	257	0	7840
28506	338	95	7016	91	0	7540
28507	163	7125	230	92	0	7610
28508	7300	258	94	86	0	7738
28509	313	139	7379	62	0	7893
28510	142	119	208	6797	0	7266
28511	135	6915	93	198	0	7341
28512	117	7838	104	80	0	8139
28513	8024	295	66	62	0	8447
28514	303	156	7666	60	0	8185
28515	7533	108	222	58	0	7921
28516	339	59	112	8395	0	8905
28517	156	68	8282	221	0	8727
28518	7924	72	238	87	0	8321
28519	280	7913	118	90	0	8401
28520	139	8404	101	67	0	8711
28521	8497	277	67	56	0	8897
28522	8588	167	63	58	0	8876
28523	8193	123	65	49	0	8430
28524	350	76	63	7814	0	8303
28525	193	67	71	8052	0	8383
28526	178	61	7717	270	0	8226
28527	138	83	7609	135	0	7965
28528	105	7512	278	110	0	8005
28529	79	218	83	7209	0	7589
28530	7098	110	63	203	0	7474
28531	194	6981	48	90	0	7313
28532	116	1069	26	6345	0	7556
28533	7145	141	34	136	0	7456
28534	217	6346	60	78	0	6701
28535	107	7044	57	72	0	7280
28536	108	242	6724	55	0	7129
28537	6033	73	101	22	0	6229
28538	6379	54	49	30	0	6512
28539	139	47	6155	29	0	6370
28540	5906	42	98	26	0	6072
28541	159	54	6197	18	0	6428
28542	81	5511	621	22	0	6235
28543	52	46	32	5805	0	5935
28544	5794	26	35	49	0	5904
28545	58	5557	33	28	0	5676
28546	39	5706	28	30	0	5803
28547	5086	0	0	1	0	5087
28548	2	6	5131	0	0	5139
28549	5022	1	0	0	0	5023
28550	0	5091	10	4	0	5105
28551	2	15	4668	0	0	4685
28552	4895	0	0	1	0	4896
28553	5118	0	0	1	0	5119
28554	4	4	1	4858	0	4867
28555	2	2	0	5013	0	5017
28556	0	4730	14	3	0	4747
28557	3	5	4799	0	0	4807
28558	0	4	0	5262	0	5266
28559	2	2	5549	5	0	5558
28560	6	7	6148	1	0	6162
28561	1	2	31	6168	0	6202
28562	5	5	6267	34	0	6311
28563	7	9	5808	12	0	5836
28564	1	3	47	5631	0	5682
28565	4	8	5863	36	0	5911
28566	5337	1	38	12	0	5388
28567	33	5245	39	16	0	5333
28568	8	41	5634	1	0	5684
28569	10	17	5687	2	0	5716
28570	1	3	43	5543	0	5590
28571	5939	0	9	39	0	5987
28572	5906	2	7	8	0	5923
28573	5915	0	2	5	0	5922
28574	5936	2	2	1	0	5941
28575	43	1	3	5807	0	5854
28576	13	5	5670	35	0	5723
28577	5709	2	36	12	0	5759
28578	5858	3	7	11	0	5879
28579	5918	0	7	5	0	5930
28580	51	7	5654	1	0	5713
28581	5235	6	40	3	0	5284
28582	40	1	5	6235	0	6281
28583	8	6080	20	48	0	6156
28584	9	51	2	5891	0	5953
28585	5	5802	17	53	0	5877
28586	5981	55	0	13	0	6049
28587	55	14	5460	8	0	5537
28588	13	6	52	5398	0	5469
28589	6	5240	29	60	0	5335
28590	1	5479	24	11	0	5515
28591	5649	60	8	8	0	5725
28592	5684	16	4	9	0	5713
28593	70	15	5426	1	0	5512
28594	4615	3	59	1	0	4678
28595	56	6	11	4657	0	4730
28596	17	9	4893	55	0	4974
28597	12	16	4800	9	0	4837
28598	10	1	57	5857	0	5925
28599	6730	2	9	82	0	6823
28600	84	4	5	6573	0	6666
28601	26	2	9	6739	0	6776
28602	18	4	2	6726	0	6750
28603	11	6477	18	103	0	6609
28604	10	76	9	6777	0	6872
28605	6545	19	10	90	0	6664
28606	85	6514	18	29	0	6646
28607	23	82	9	6744	0	6858
28608	6615	21	8	90	0	6734
28609	83	6136	14	33	0	6266
28610	23	6273	18	22	0	6336
28611	21	97	7	6343	0	6468
28612	5784	22	7	89	0	5902
28613	87	19	5704	30	0	5840
28614	33	24	5563	13	0	5633
28615	6616	12	98	14	0	6740
28616	6294	7	28	17	0	6346
28617	136	6124	25	20	0	6305
28618	40	117	13	6242	0	6412
28619	35	34	6203	115	0	6387
28620	20	33	6604	40	0	6697
28621	28	26	6590	26	0	6670
28622	30	6384	169	26	0	6609
28623	25	6679	60	29	0	6793
28624	6807	147	31	25	0	7010
28625	144	60	6683	30	0	6917
28626	6653	38	144	26	0	6861
28627	6849	24	47	31	0	6951
28628	170	41	7451	26	0	7688
28629	69	7440	162	28	0	7699
28630	47	145	50	7636	0	7878
28631	40	70	7623	134	0	7867
28632	37	50	7332	49	0	7468
28633	7232	17	151	35	0	7435
28634	155	7509	75	22	0	7761
28635	63	142	46	6932	0	7183
28636	56	52	30	6968	0	7106
28637	30	6918	56	153	0	7157
28638	33	7041	58	59	0	7191
28639	44	7081	41	49	0	7215
28640	48	186	36	7157	0	7427
28641	7158	66	41	144	0	7409
28642	156	38	37	7205	0	7436
28643	66	43	7048	173	0	7330
28644	58	54	6971	65	0	7148
28645	26	50	162	7157	0	7395
28646	37	70	6978	155	0	7240
28647	35	6896	177	70	0	7178
28648	33	151	72	8075	0	8331
28649	8029	52	55	218	0	8354
28650	8014	46	51	65	0	8176
28651	222	8586	52	57	0	8917
28652	8716	210	35	53	0	9014
28653	8823	68	49	49	0	8989
28654	8906	67	32	48	0	9053
28655	270	61	8164	49	0	8544
28656	8397	42	191	33	0	8663
28657	243	8375	68	48	0	8734
28658	419	213	7687	48	0	8367
28659	86	82	8090	46	0	8304
28660	59	7363	210	33	0	7665
28661	7583	190	95	27	0	7895
28662	576	88	57	6840	0	7561
28663	97	7007	31	176	0	7311
28664	7233	182	37	86	0	7538
28665	193	85	33	7235	0	7546
28666	7475	64	47	199	0	7785
28667	208	45	51	7597	0	7901
28668	95	49	7374	216	0	7734
28669	78	59	7456	93	0	7686
28670	71	58	7424	58	0	7611
28671	58	47	228	7183	0	7516
28672	61	46	87	7624	0	7818
28673	84	48	7241	226	0	7599
28674	50	7263	207	110	0	7630
28675	7498	194	86	64	0	7842
28676	7482	73	77	54	0	7686
28677	245	7264	82	51	0	7642
28678	121	187	77	7940	0	8325
28679	104	91	7869	251	0	8315
28680	7841	68	271	107	0	8287
28681	294	60	7976	79	0	8409
28682	107	51	7412	55	0	7625
28683	77	62	7459	41	0	7639
28684	7308	52	331	50	0	7741
28685	264	58	7233	42	0	7597
28686	108	7089	310	39	0	7546
28687	98	7523	127	32	0	7780
28688	87	312	105	7230	0	7734
28689	117	110	73	7552	0	7852
28690	74	77	7206	312	0	7669
28691	7109	51	314	99	0	7573
28692	7537	56	141	65	0	7799
28693	324	66	111	7408	0	7909
28694	7692	51	98	266	0	8107
28695	296	7593	94	141	0	8124
28696	7417	285	88	76	0	7866
28697	303	7196	108	64	0	7671
28698	109	6467	55	58	0	6689
28699	5180	283	51	52	0	5566
28700	5874	100	54	53	0	6081
28701	5983	70	51	51	0	6155
28702	6058	66	55	46	0	6225
28703	355	52	6217	49	0	6673
28704	6547	62	262	42	0	6913
28705	314	60	114	6164	0	6652
28706	137	6429	110	211	0	6887
28707	6528	247	78	83	0	6936
28708	296	6530	79	62	0	6967
28709	6613	277	70	37	0	6997
28710	294	124	65	6473	0	6956
28711	139	72	64	6789	0	7064
28712	122	69	6238	308	0	6737
28713	100	63	6288	125	0	6576
28714	112	6468	285	96	0	6961
28715	5347	214	93	66	0	5720
28716	251	5899	66	65	0	6281
28717	147	5928	53	62	0	6190
28718	109	6077	79	68	0	6333
28719	132	312	5646	44	0	6134
28720	86	5479	200	42	0	5807
28721	5456	235	76	40	0	5807
28722	5617	101	53	37	0	5808
28723	279	83	48	5258	0	5668
28724	143	5345	62	179	0	5729
28725	94	5572	68	78	0	5812
28726	82	255	69	5445	0	5851
28727	108	100	5960	195	0	6363
28728	91	5359	197	81	0	5728
28729	109	244	69	5397	0	5819
28730	5303	114	42	212	0	5671
28731	5408	97	48	83	0	5636
28732	278	5431	44	69	0	5822
28733	5476	247	43	82	0	5848
28734	5573	115	75	58	0	5821
28735	281	85	71	5465	0	5902
28736	135	92	5226	220	0	5673
28737	116	5286	215	89	0	5706
28738	93	234	92	5383	0	5802
28739	104	130	5216	213	0	5663
28740	86	5411	237	90	0	5824
28741	5323	263	85	67	0	5738
28742	5530	154	71	54	0	5809
28743	312	118	53	5153	0	5636
28744	159	5297	59	214	0	5729
28745	118	270	5686	84	0	6158
28746	143	114	200	5828	0	6285
28747	104	101	5783	236	0	6224
28748	97	5293	209	108	0	5707
28749	85	211	92	4759	0	5147
28750	4661	115	61	190	0	5027
28751	168	3997	53	103	0	4321
28752	4089	188	49	64	0	4390
28753	3972	114	42	55	0	4183
28754	201	4346	38	69	0	4654
28755	122	183	42	4337	0	4684
28756	118	94	38	4361	0	4611
28757	93	4182	47	180	0	4502
28758	99	4410	55	96	0	4660
28759	88	170	33	3955	0	4246
28760	67	4127	47	137	0	4378
28761	4191	190	38	59	0	4478
28762	4247	101	36	54	0	4438
28763	187	101	4056	63	0	4407
28764	99	80	4060	56	0	4295
28765	3942	96	132	49	0	4219
28766	4499	84	48	39	0	4670
28767	151	4987	62	61	0	5261
28768	5169	175	41	57	0	5442
28769	5212	98	50	34	0	5394
28770	196	5054	37	48	0	5335
28771	5165	178	36	58	0	5437
28772	187	101	34	5756	0	6078
28773	93	100	35	5838	0	6066
28774	97	81	5627	192	0	5997
28775	69	5509	150	89	0	5817
28776	62	5823	78	67	0	6030
28777	6426	211	40	69	0	6746
28778	5830	48	19	27	0	5924
28779	5862	42	21	15	0	5940
28780	5891	36	16	30	0	5973
28781	142	39	5657	27	0	5865
28782	74	28	5663	20	0	5785
28783	42	5696	99	21	0	5858
28784	31	111	42	5762	0	5946
28785	41	59	23	5676	0	5799
28786	37	5779	33	93	0	5942
28787	38	101	18	5913	0	6070
28788	5847	49	21	99	0	6016
28789	111	5660	32	46	0	5849
28790	81	96	5553	30	0	5760
28791	59	5657	92	21	0	5829
28792	5863	102	39	32	0	6036
28793	122	60	5690	27	0	5899
28794	5327	56	76	17	0	5476
28795	5546	36	34	40	0	5656
28796	115	27	5429	36	0	5607
28797	62	44	5464	23	0	5593
28798	36	32	5426	27	0	5521
28799	5046	35	97	21	0	5199
28800	98	45	5391	10	0	5544
28801	51	5244	111	24	0	5430
28802	5530	77	43	25	0	5675
28803	72	29	4577	2	0	4680
28804	4406	11	77	4	0	4498
28805	75	19	4583	3	0	4680
28806	54	12	4588	1	0	4655
28807	35	4245	101	15	0	4396
28808	14	65	4525	3	0	4607
28809	32	35	4494	2	0	4563
28810	22	3810	131	23	0	3986
28811	4444	58	45	14	0	4561
28812	66	36	4436	5	0	4543
28813	42	31	71	3973	0	4117
28814	18	4239	57	48	0	4362
28815	4439	67	18	25	0	4549
28816	3974	38	24	8	0	4044
28817	94	26	3992	6	0	4118
28818	54	3707	75	10	0	3846
28819	33	3994	52	12	0	4091
28820	28	76	41	3907	0	4052
28821	18	3874	20	49	0	3961
28822	21	93	19	3768	0	3901
28823	19	42	22	4011	0	4094
28824	21	3926	21	87	0	4055
28825	24	76	13	3985	0	4098
28826	46	3880	10	67	0	4003
28827	40	73	3055	33	0	3201
28828	22	38	85	3132	0	3277
28829	20	37	44	3188	0	3289
28830	24	3157	33	74	0	3288
28831	19	3310	27	43	0	3399
28832	25	90	20	3206	0	3341
28833	20	3232	19	76	0	3347
28834	4050	76	20	47	0	4193
28835	69	55	31	4006	0	4161
28836	40	3955	28	75	0	4098
28837	4130	76	19	39	0	4264
28838	72	3986	44	17	0	4119
28839	53	96	3886	19	0	4054
28840	36	43	73	3873	0	4025
28841	4049	37	45	62	0	4193
28842	103	26	3985	30	0	4144
28843	43	27	86	3838	0	3994
28844	28	3858	64	68	0	4018
28845	32	88	3431	33	0	3584
28846	37	3451	99	23	0	3610
28847	3522	77	67	17	0	3683
28848	3575	56	28	10	0	3669
28849	106	3508	29	14	0	3657
28850	3625	69	54	11	0	3759
28851	88	48	3449	23	0	3608
28852	51	36	81	3378	0	3546
28853	44	28	56	3368	0	3496
28854	26	3150	41	85	0	3302
28855	3264	72	41	40	0	3417
28856	3305	54	36	16	0	3411
28857	91	47	3149	15	0	3302
28858	3186	29	73	15	0	3303
28859	3276	28	47	9	0	3360
28860	3300	28	37	27	0	3392
28861	104	33	23	3110	0	3270
28862	59	34	26	3165	0	3284
28863	48	3111	24	84	0	3267
28864	3232	72	23	47	0	3374
28865	3194	49	30	20	0	3293
28866	97	2768	26	26	0	2917
28867	35	39	6	2692	0	2772
28868	22	3249	21	37	0	3329
28869	25	3876	19	23	0	3943
28870	3933	51	11	25	0	4020
28871	56	31	3860	11	0	3958
28872	28	21	3241	19	0	3309
28873	14	3238	52	20	0	3324
28874	3318	49	24	10	0	3401
28875	60	32	3292	11	0	3395
28876	37	3058	48	19	0	3162
28877	2674	10	1	1	0	2686
28878	11	2	2609	0	0	2622
28879	4	1	9	2552	0	2566
28880	2691	0	2	9	0	2702
28881	12	3	3663	1	0	3679
28882	2	4	4473	1	0	4480
28883	3	5	5003	0	0	5011
28884	3	3	4910	0	0	4916
28885	4857	0	10	0	0	4867
28886	5201	1	1	2	0	5205
28887	8	4956	13	0	0	4977
28888	2	11	1	5171	0	5185
28889	1	1	0	5668	0	5670
28890	1	5485	6	27	0	5519
28891	1	24	1	5691	0	5717
28892	0	5422	6	28	0	5456
28893	0	5548	9	15	0	5572
28894	1	34	2	5681	0	5718
28895	6	15	5573	32	0	5626
28896	1	5332	33	17	0	5383
28897	0	31	9	5703	0	5743
28898	5724	13	5	30	0	5772
28899	25	10	5618	12	0	5665
28900	5598	5	27	9	0	5639
28901	5677	4	12	8	0	5701
28902	38	11	5	6120	0	6174
28903	20	7	6141	48	0	6216
28904	19	14	6514	15	0	6562
28905	8	7278	98	15	0	7399
28906	5	84	36	7502	0	7627
28907	7	34	7578	85	0	7704
28908	10	27	7339	32	0	7408
28909	1	7084	128	27	0	7240
28910	7624	82	51	10	0	7767
28911	7593	33	31	8	0	7665
28912	106	21	19	7979	0	8125
28913	54	24	8569	100	0	8747
28914	35	17	8369	45	0	8466
28915	19	9177	165	42	0	9403
28916	22	95	9633	13	0	9763
28917	13	45	9605	9	0	9672
28918	5	40	163	8872	0	9080
28919	10	21	9772	103	0	9906
28920	9194	11	146	42	0	9393
28921	101	10	63	9753	0	9927
28922	55	16	9694	114	0	9879
28923	28	9220	139	56	0	9443
28924	17	98	51	9774	0	9940
28925	11	54	9598	117	0	9780
28926	4	9123	142	56	0	9325
28927	6	119	56	9559	0	9740
28928	7	9486	49	110	0	9652
28929	9	125	24	9804	0	9962
28930	8	56	16	9709	0	9789
28931	13	44	9499	159	0	9715
28932	5	9242	119	79	0	9445
28933	15	113	46	9683	0	9857
28934	4	46	40	8997	0	9087
28935	8	38	29	9186	0	9261
28936	8	27	8836	175	0	9046
28937	3	8464	131	105	0	8703
28938	12	110	55	9070	0	9247
28939	11	60	8813	139	0	9023
28940	7	8516	131	76	0	8730
28941	5	122	57	9021	0	9205
28942	11	59	8853	127	0	9050
28943	7	8492	149	70	0	8718
28944	6	129	57	8890	0	9082
28945	10	55	40	9039	0	9144
28946	11	50	10507	155	0	10723
28947	9731	21	114	94	0	9960
28948	102	10214	79	60	0	10455
28949	10896	110	54	35	0	11095
28950	133	69	10463	32	0	10697
28951	10426	34	125	25	0	10610
28952	134	29	67	10519	0	10749
28953	59	23	47	10910	0	11039
28954	40	28	10597	161	0	10826
28955	9836	27	121	85	0	10069
28956	10653	16	64	59	0	10792
28957	141	10243	61	42	0	10487
28958	79	10569	37	38	0	10723
28959	10789	141	33	31	0	10994
28960	134	86	10446	24	0	10690
28961	61	11216	156	28	0	11461
28962	40	122	56	11833	0	12051
28963	25	66	46	12046	0	12183
28964	23	50	11699	158	0	11930
28965	11468	32	131	95	0	11726
28966	153	34	12232	60	0	12479
28967	11086	20	183	44	0	11333
28968	179	33	11796	32	0	12040
28969	76	10804	215	40	0	11135
28970	12620	139	83	29	0	12871
28971	12611	62	66	32	0	12771
28972	12495	47	47	24	0	12613
28973	12662	32	42	20	0	12756
28974	231	34	28	12417	0	12710
28975	115	40	12192	157	0	12504
28976	68	27	147	12162	0	12404
28977	44	11786	104	171	0	12105
28978	32	141	54	12597	0	12824
28979	31	68	12224	185	0	12508
28980	22	56	12902	86	0	13066
28981	14	33	197	12045	0	12289
28982	11583	20	107	168	0	11878
28983	11084	21	60	85	0	11250
28984	11057	17	52	62	0	11188
28985	234	26	10875	41	0	11176
28986	115	39	10437	33	0	10624
28987	66	10107	221	48	0	10442
28988	43	10540	124	33	0	10740
28989	10469	163	47	18	0	10697
28990	10510	70	25	23	0	10628
28991	163	10075	36	32	0	10306
28992	10606	133	20	30	0	10789
28993	10611	56	23	26	0	10716
28994	171	10125	28	29	0	10353
28995	11502	138	21	21	0	11682
28996	11406	55	22	25	0	11508
28997	172	10925	32	24	0	11153
28998	11426	125	30	28	0	11609
28999	11144	53	30	25	0	11252
29000	193	53	11397	19	0	11662
29001	104	32	11256	23	0	11415
29002	66	10287	160	19	0	10532
29003	41	10794	98	14	0	10947
29004	10676	80	26	4	0	10786
29005	9882	34	12	10	0	9938
29006	9814	22	8	7	0	9851
29007	93	10425	34	17	0	10569
29008	50	61	11	11281	0	11403
29009	34	40	12190	61	0	12325
29010	16	477	65	11570	0	12128
29011	18	11764	57	51	0	11890
29012	12222	42	8	11	0	12283
29013	54	10762	35	13	0	10864
29014	29	40	3	12194	0	12266
29015	12307	16	3	43	0	12369
29016	12207	7	6	22	0	12242
29017	111	20	12468	6	0	12605
29018	12725	5	71	7	0	12808
29019	12925	11	29	6	0	12971
29020	13045	8	14	11	0	13078
29021	112	13	15	12808	0	12948
29022	58	12280	34	71	0	12443
29023	37	62	10	13602	0	13711
29024	43	77	13360	90	0	13570
29025	29	14560	125	49	0	14763
29026	37	131	41	15244	0	15453
29027	41	78	14727	131	0	14977
29028	36	14458	152	75	0	14721
29029	36	150	55	14774	0	15015
29030	42	79	14898	130	0	15149
29031	12470	44	177	96	0	12787
29032	153	33	15123	37	0	15346
29033	87	57	14547	19	0	14710
29034	39	14069	242	41	0	14391
29035	30	162	92	14797	0	15081
29036	48	93	28	14559	0	14728
29037	44	13920	77	176	0	14217
29038	47	146	28	15157	0	15378
29039	15130	73	27	153	0	15383
29040	14849	26	38	92	0	15005
29041	227	43	14378	31	0	14679
29042	14134	35	154	34	0	14357
29043	14718	42	80	37	0	14877
29044	204	67	14358	47	0	14676
29045	85	13745	176	41	0	14047
29046	51	12860	85	56	0	13052
29047	67	225	50	12089	0	12431
29048	71	12691	41	106	0	12909
29049	64	188	12241	61	0	12554
29050	88	98	12532	17	0	12735
29051	65	12371	261	29	0	12726
29052	13463	161	116	20	0	13760
29053	13504	110	41	25	0	13680
29054	13568	72	28	36	0	13704
29055	13489	57	33	35	0	13614
29056	13379	50	33	40	0	13502
29057	229	12800	52	40	0	13121
29058	117	189	12793	30	0	13129
29059	77	95	152	13104	0	13428
29060	13264	44	77	156	0	13541
29061	200	12020	67	80	0	12367
29062	144	155	30	12460	0	12789
29063	92	103	12143	152	0	12490
29064	70	11274	208	89	0	11641
29065	33	11415	73	21	0	11542
29066	11626	165	37	24	0	11852
29067	112	11323	47	40	0	11522
29068	65	146	21	10878	0	11110
29069	10898	74	29	120	0	11121
29070	10195	34	26	76	0	10331
29071	10291	37	32	20	0	10380
29072	185	39	9637	20	0	9881
29073	104	9395	149	18	0	9666
29074	10254	129	49	9	0	10441
29075	138	87	25	10752	0	11002
29076	10909	39	18	159	0	11125
29077	182	10438	30	72	0	10722
29078	10994	155	23	25	0	11197
29079	11009	73	11	31	0	11124
29080	218	33	35	9996	0	10282
29081	91	52	10561	159	0	10863
29082	63	31	153	10864	0	11111
29083	10836	39	82	187	0	11144
29084	10891	41	35	88	0	11055
29085	266	10513	51	42	0	10872
29086	10960	176	30	29	0	11195
29087	244	11327	50	37	0	11658
29088	11863	181	21	54	0	12119
29089	11838	94	47	46	0	12025
29090	274	73	11129	63	0	11539
29091	126	11043	205	67	0	11441
29092	79	189	90	11596	0	11954
29093	63	122	39	11809	0	12033
29094	80	63	46	11451	0	11640
29095	54	10536	53	238	0	10881
29096	76	224	10367	106	0	10773
29097	72	130	10378	58	0	10638
29098	72	18861	282	74	0	19289
29099	19593	525	105	62	0	20285
29100	572	203	19718	57	0	20550
29101	19765	130	584	51	0	20530
29102	647	19441	278	74	0	20440
29103	259	586	19833	61	0	20739
29104	162	226	565	19887	0	20840
29105	83	182	19774	601	0	20640
29106	104	113	19851	217	0	20285
29107	125	109	705	16569	0	17508
29108	114	17634	374	438	0	18560
29109	128	18100	178	162	0	18568
29110	18140	685	99	106	0	19030
29111	649	324	17139	44	0	18156
29112	17822	165	566	69	0	18622
29113	18067	98	273	53	0	18491
29114	714	16997	174	64	0	17949
29115	16348	549	59	26	0	16982
29116	16308	197	75	25	0	16605
29117	15414	141	55	32	0	15642
29118	781	14637	82	17	0	15517
29119	318	14296	97	27	0	14738
29120	188	15605	58	22	0	15873
29121	15747	706	48	16	0	16517
29122	16305	271	52	19	0	16647
29123	758	169	14679	21	0	15627
29124	320	110	14337	15	0	14782
29125	13653	57	585	23	0	14318
29126	13962	42	257	30	0	14291
29127	14077	41	140	28	0	14286
29128	696	40	87	13541	0	14364
29129	285	48	79	13822	0	14234
29130	163	67	55	14067	0	14352
29131	91	68	45	14344	0	14548
29132	103	88	13015	669	0	13875
29133	94	68	13702	273	0	14137
29134	125	41	13861	154	0	14181
29135	122	57	13739	54	0	13972
29136	13563	54	688	47	0	14352
29137	556	13698	268	39	0	14561
29138	252	14424	147	43	0	14866
29139	14384	595	69	37	0	15085
29140	557	289	13954	50	0	14850
29141	240	196	14157	59	0	14652
29142	14145	108	606	48	0	14907
29143	14563	95	282	45	0	14985
29144	666	14185	193	48	0	15092
29145	329	471	151	14344	0	15295
29146	14483	171	145	476	0	15275
29147	14851	156	119	173	0	15299
29148	758	83	95	13688	0	14624
29149	375	14407	85	454	0	15321
29150	14528	502	73	207	0	15310
29151	579	236	14315	186	0	15316
29152	14702	148	490	114	0	15454
29153	627	14628	245	122	0	15622
29154	15143	501	202	80	0	15926
29155	15377	198	146	64	0	15785
29156	706	209	14687	60	0	15662
29157	389	132	14666	72	0	15259
29158	14826	97	662	68	0	15653
29159	15110	117	309	41	0	15577
29160	725	15340	193	51	0	16309
29161	369	573	136	15494	0	16572
29162	256	262	15122	493	0	16133
29163	15409	199	560	179	0	16347
29164	663	174	271	15495	0	16603
29165	442	120	201	15959	0	16722
29166	15601	126	199	621	0	16547
29167	682	15443	148	279	0	16552
29168	16799	626	115	181	0	17721
29169	17020	221	198	103	0	17542
29170	16960	171	162	205	0	17498
29171	876	16237	160	144	0	17417
29172	16750	567	191	113	0	17621
29173	712	235	136	16558	0	17641
29174	357	249	828	16214	0	17648
29175	326	201	15669	594	0	16790
29176	305	133	15685	278	0	16401
29177	207	15673	706	187	0	16773
29178	293	17192	324	96	0	17905
29179	361	652	16527	70	0	17610
29180	251	17071	561	67	0	17950
29181	16564	602	240	44	0	17450
29182	16733	234	182	49	0	17198
29183	16900	199	105	73	0	17277
29184	826	192	93	16160	0	17271
29185	432	165	93	16624	0	17314
29186	282	204	15522	662	0	16670
29187	227	15113	495	375	0	16210
29188	15164	526	208	191	0	16089
29189	589	15391	223	100	0	16303
29190	15688	620	156	82	0	16546
29191	15908	217	120	55	0	16300
29192	848	171	91	15402	0	16512
29193	522	88	99	15742	0	16451
29194	311	69	63	16182	0	16625
29195	207	100	14621	868	0	15796
29196	169	14869	492	490	0	16020
29197	133	15728	260	354	0	16475
29198	6	5503	19	20	0	5548
29199	4	5532	10	19	0	5565
29200	0	5370	10	7	0	5387
29201	5178	70	4	4	0	5256
29202	38	41	5093	3	0	5175
29203	20	5112	54	8	0	5194
29204	22	57	4904	1	0	4984
29205	10	5044	53	5	0	5112
29206	18	57	15	4825	0	4915
29207	9	22	14	5098	0	5143
29208	6	5480	6	56	0	5548
29209	5588	40	5	30	0	5663
29210	44	35	5250	14	0	5343
29211	28	5310	44	10	0	5392
29212	19	55	5365	5	0	5444
29213	8	22	47	5434	0	5511
29214	12	19	17	5368	0	5416
29215	9	5370	19	62	0	5460
29216	10	40	3	6089	0	6142
29217	7	23	2	6003	0	6035
29218	5	5748	20	63	0	5836
29219	5	58	5444	32	0	5539
29220	5	42	5411	16	0	5474
29221	5278	25	51	11	0	5365
29222	5634	11	23	12	0	5680
29223	57	19	14	5335	0	5425
29224	37	16	5304	41	0	5398
29225	15	15	43	5215	0	5288
29226	5	5154	30	50	0	5239
29227	13	58	5993	18	0	6082
29228	2	5700	69	17	0	5788
29229	10	58	5922	8	0	5998
29230	7	5807	68	11	0	5893
29231	6120	61	20	15	0	6216
29232	43	27	19	6005	0	6094
29233	21	19	15	5961	0	6016
29234	21	24	6010	62	0	6117
29235	12	23	5778	34	0	5847
29236	10	5637	79	24	0	5750
29237	5709	51	31	17	0	5808
29238	48	32	21	5621	0	5722
29239	27	39	5821	46	0	5933
29240	20	23	5516	32	0	5591
29241	5131	23	57	33	0	5244
29242	5547	11	36	19	0	5613
29243	64	23	5915	11	0	6013
29244	41	14	47	5664	0	5766
29245	35	5873	47	55	0	6010
29246	6213	53	17	34	0	6317
29247	50	6002	32	31	0	6115
29248	6151	60	17	22	0	6250
29249	65	5759	20	15	0	5859
29250	29	5810	17	16	0	5872
29251	29	72	12	5586	0	5699
29252	15	45	11	5524	0	5595
29253	10	5967	28	75	0	6080
29254	19	66	5872	40	0	5997
29255	15	39	5799	27	0	5880
29256	16	33	5941	20	0	6010
29257	5668	26	72	18	0	5784
29258	6028	18	39	16	0	6101
29259	63	5811	31	20	0	5925
29260	42	71	5419	14	0	5546
29261	18	44	51	5443	0	5556
29262	16	37	5522	49	0	5624
29263	14	22	5453	27	0	5516
29264	10	23	68	6186	0	6287
29265	20	24	40	6562	0	6646
29266	16	31	6718	139	0	6904
29267	6867	18	100	93	0	7078
29268	107	6647	80	49	0	6883
29269	85	6829	61	33	0	7008
29270	47	196	28	6817	0	7088
29271	6827	124	24	129	0	7104
29272	130	6800	26	86	0	7042
29273	7302	152	18	53	0	7525
29274	178	7300	26	41	0	7545
29275	7038	181	18	25	0	7262
29276	182	111	6725	29	0	7047
29277	108	65	6852	19	0	7044
29278	50	33	167	6057	0	6307
29279	40	39	5942	115	0	6136
29280	25	5792	156	81	0	6054
29281	23	6034	108	37	0	6202
29282	6127	180	57	20	0	6384
29283	120	104	42	5879	0	6145
29284	78	6000	34	127	0	6239
29285	6205	146	33	66	0	6450
29286	6184	103	22	31	0	6340
29287	6299	68	19	20	0	6406
29288	245	33	27	6118	0	6423
29289	123	29	29	6275	0	6456
29290	74	37	6215	209	0	6535
29291	61	34	6192	114	0	6401
29292	6285	27	185	52	0	6549
29293	149	43	98	6305	0	6595
29294	111	29	6191	163	0	6494
29295	6199	19	148	110	0	6476
29296	146	7139	127	60	0	7472
29297	7487	136	66	32	0	7721
29298	7520	75	38	35	0	7668
29299	7545	47	29	42	0	7663
29300	252	41	7215	39	0	7547
29301	7212	33	133	38	0	7416
29302	201	38	91	7171	0	7501
29303	148	6756	84	119	0	7107
29304	111	7253	54	84	0	7502
29305	7471	192	39	50	0	7752
29306	7459	93	52	40	0	7644
29307	7568	52	35	38	0	7693
29308	263	48	14	7007	0	7332
29309	159	57	28	7118	0	7362
29310	118	38	24	6991	0	7171
29311	103	6803	39	214	0	7159
29312	7095	137	41	117	0	7390
29313	7127	93	38	76	0	7334
29314	7198	57	13	78	0	7346
29315	265	64	6726	64	0	7119
29316	6569	60	116	38	0	6783
29317	242	60	75	6360	0	6737
29318	191	6412	52	121	0	6776
29319	6716	146	36	80	0	6978
29320	6632	89	38	65	0	6824
29321	242	54	6611	65	0	6972
29322	171	48	128	6582	0	6929
29323	101	7402	96	157	0	7756
29324	7840	173	56	84	0	8153
29325	231	99	28	7771	0	8129
29326	165	58	38	8600	0	8861
29327	104	45	50	8014	0	8213
29328	84	37	32	9761	0	9914
29329	89	68	9005	454	0	9616
29330	76	9098	285	199	0	9658
29331	91	331	94	9443	0	9959
29332	93	134	9245	362	0	9834
29333	9383	67	311	166	0	9927
29334	9834	53	134	119	0	10140
29335	426	54	79	9634	0	10193
29336	9751	62	55	352	0	10220
29337	9930	45	50	162	0	10187
29338	460	70	9105	127	0	9762
29339	209	9118	277	100	0	9704
29340	9426	304	123	89	0	9942
29341	381	122	85	9514	0	10102
29342	9507	82	76	348	0	10013
29343	419	54	56	9149	0	9678
29344	176	52	73	9492	0	9793
29345	160	67	8433	441	0	9101
29346	8052	47	290	219	0	8608
29347	353	8602	107	185	0	9247
29348	219	339	8476	107	0	9141
29349	172	8778	306	101	0	9357
29350	8929	362	149	90	0	9530
29351	376	161	99	8533	0	9169
29352	8528	83	56	381	0	9048
29353	419	7844	67	167	0	8497
29354	8529	326	58	121	0	9034
29355	8702	120	33	103	0	8958
29356	8757	73	51	110	0	8991
29357	8677	53	61	88	0	8879
29358	543	8203	59	70	0	8875
29359	8530	343	59	72	0	9004
29360	462	161	43	8357	0	9023
29361	261	88	48	8450	0	8847
29362	195	7794	56	444	0	8489
29363	181	8157	55	193	0	8586
29364	131	7708	40	131	0	8010
29365	7186	335	45	72	0	7638
29366	344	6748	43	56	0	7191
29367	139	6199	33	43	0	6414
29368	6278	282	20	46	0	6626
29369	6365	70	29	45	0	6509
29370	312	6103	17	42	0	6474
29371	6375	264	25	48	0	6712
29372	309	88	5988	74	0	6459
29373	5691	53	171	37	0	5952
29374	251	61	5427	48	0	5787
29375	110	5417	176	41	0	5744
29376	82	5697	41	44	0	5864
29377	312	230	24	5454	0	6020
29378	5540	72	21	198	0	5831
29379	5977	54	17	55	0	6103
29380	5971	51	19	51	0	6092
29381	5985	40	21	54	0	6100
29382	5992	63	33	54	0	6142
29383	267	76	5523	35	0	5901
29384	103	81	5386	38	0	5608
29385	5707	68	177	48	0	6000
29386	262	6081	58	39	0	6440
29387	6481	221	38	44	0	6784
29388	6595	59	23	49	0	6726
29389	7375	51	27	51	0	7504
29390	7149	42	28	66	0	7285
29391	7131	67	39	63	0	7300
29392	308	55	6587	69	0	7019
29393	6820	57	217	81	0	7175
29394	7057	79	67	86	0	7289
29395	295	90	6550	101	0	7036
29396	5765	100	209	101	0	6175
29397	6046	100	84	91	0	6321
29398	341	68	5934	98	0	6441
29399	202	73	5786	76	0	6137
29400	225	5813	215	60	0	6313
29401	244	221	66	6021	0	6552
29402	239	75	5931	219	0	6464
29403	6329	73	213	76	0	6691
29404	372	80	84	7048	0	7584
29405	195	83	7786	234	0	8298
29406	7726	97	229	82	0	8134
29407	8040	84	70	89	0	8283
29408	8046	81	56	103	0	8286
29409	377	7704	58	101	0	8240
29410	208	225	72	7988	0	8493
29411	175	7951	76	236	0	8438
29412	8300	241	91	90	0	8722
29413	8235	116	103	63	0	8517
29414	362	123	7958	48	0	8491
29415	188	7796	223	61	0	8268
29416	185	8151	94	62	0	8492
29417	176	298	60	8072	0	8606
29418	217	118	44	8295	0	8674
29419	8177	127	48	227	0	8579
29420	398	7926	48	69	0	8441
29421	250	7988	32	51	0	8321
29422	254	287	7671	47	0	8259
29423	221	7047	192	41	0	7501
29424	7398	267	45	46	0	7756
29425	374	120	7013	74	0	7581
29426	5432	73	149	48	0	5702
29427	268	77	6248	52	0	6645
29428	3260	20	30	18	0	3328
29429	8	4383	10	6	0	4407
29430	4517	2	3	2	0	4524
29431	12	11	4474	1	0	4498
29432	4353	3	6	1	0	4363
29433	4335	1	1	2	0	4339
29434	2	5	4674	0	0	4681
29435	4573	1	2	1	0	4577
29436	4731	1	4	1	0	4737
29437	4771	1	2	0	0	4774
29438	10	4601	13	9	0	4633
29439	4955	4	2	1	0	4962
29440	12	11	4784	0	0	4807
29441	7	4867	15	5	0	4894
29442	5134	13	6	2	0	5155
29443	5011	4	5	0	0	5020
29444	5064	4	2	0	0	5070
29445	22	4920	8	5	0	4955
29446	9	14	2	5762	0	5787
29447	7	16	6171	30	0	6224
29448	6	4	73	6193	0	6276
29449	10	8	6089	76	0	6183
29450	5683	3	74	32	0	5792
29451	68	5962	46	11	0	6087
29452	32	74	11	6098	0	6215
29453	13	6093	20	65	0	6191
29454	14	76	1	5867	0	5958
29455	8	29	6	5844	0	5887
29456	6	5754	10	107	0	5877
29457	6	75	3	5824	0	5908
29458	7	34	6	7094	0	7141
29459	7	7007	12	173	0	7199
29460	9	8181	19	57	0	8266
29461	9	217	7	8199	0	8432
29462	17	69	7732	197	0	8015
29463	12	7983	184	56	0	8235
29464	3	204	32	8108	0	8347
29465	27	66	7761	197	0	8051
29466	7	7888	180	68	0	8143
29467	8176	202	45	36	0	8459
29468	194	67	7963	23	0	8247
29469	7830	42	193	18	0	8083
29470	197	18	46	8044	0	8305
29471	51	24	26	8244	0	8345
29472	21	26	11	8387	0	8445
29473	19	26	7957	257	0	8259
29474	14	33	7823	80	0	7950
29475	7438	29	233	52	0	7752
29476	199	22	66	8135	0	8422
29477	51	47	7885	222	0	8205
29478	7792	22	192	78	0	8084
29479	201	29	57	7742	0	8029
29480	50	26	37	7934	0	8047
29481	40	30	29	7799	0	7898
29482	32	7671	41	266	0	8010
29483	32	213	32	7501	0	7778
29484	29	7514	26	227	0	7796
29485	22	7884	32	103	0	8041
29486	7299	246	30	63	0	7638
29487	7054	85	37	54	0	7230
29488	7397	36	33	57	0	7523
29489	260	6607	43	53	0	6963
29490	6707	231	33	43	0	7014
29491	6817	74	34	44	0	6969
29492	263	45	37	6613	0	6958
29493	94	46	44	6864	0	7048
29494	63	53	6292	302	0	6710
29495	50	6515	212	124	0	6901
29496	6625	223	66	81	0	6995
29497	6583	85	46	75	0	6789
29498	248	6521	46	76	0	6891
29499	6581	260	40	65	0	6946
29500	6598	85	37	79	0	6799
29501	278	64	44	6250	0	6636
29502	114	6239	42	244	0	6639
29503	75	6610	39	116	0	6840
29504	5857	270	37	89	0	6253
29505	250	103	37	5179	0	5569
29506	95	103	4851	268	0	5317
29507	5046	64	208	136	0	5454
29508	263	73	5225	86	0	5647
29509	95	5416	225	90	0	5826
29510	5260	240	78	87	0	5665
29511	250	113	5063	98	0	5524
29512	104	87	227	5272	0	5690
29513	90	93	4940	275	0	5398
29514	86	5216	255	126	0	5683
29515	91	271	87	5262	0	5711
29516	70	131	5137	305	0	5643
29517	5031	99	252	134	0	5516
29518	252	6919	92	127	0	7390
29519	102	264	77	6649	0	7092
29520	81	6970	89	287	0	7427
29521	7074	281	76	128	0	7559
29522	7072	130	60	133	0	7395
29523	298	7153	75	138	0	7664
29524	135	281	65	7024	0	7505
29525	93	7186	73	281	0	7633
29526	7307	278	86	124	0	7795
29527	7338	123	104	118	0	7683
29528	325	102	6895	130	0	7452
29529	119	7020	233	130	0	7502
29530	115	7364	104	118	0	7701
29531	99	305	83	7345	0	7832
29532	7320	120	93	293	0	7826
29533	7458	96	74	128	0	7756
29534	6905	65	72	82	0	7124
29535	305	6688	64	90	0	7147
29536	144	245	51	6668	0	7108
29537	117	6775	56	276	0	7224
29538	6898	250	62	122	0	7332
29539	285	91	54	6743	0	7173
29540	141	80	6500	283	0	7004
29541	96	6409	212	118	0	6835
29542	6527	254	77	95	0	6953
29543	286	119	6354	70	0	6829
29544	6298	87	212	76	0	6673
29545	291	6366	53	92	0	6802
29546	120	5973	42	68	0	6203
29547	5272	172	25	34	0	5503
29548	196	5457	21	29	0	5703
29549	5524	166	22	36	0	5748
29550	187	5425	19	40	0	5671
29551	5558	179	20	47	0	5804
29552	5674	55	27	38	0	5794
29553	198	58	6037	42	0	6335
29554	85	58	6088	27	0	6258
29555	73	6013	139	27	0	6252
29556	6305	175	31	25	0	6536
29557	204	68	6103	29	0	6404
29558	4806	31	43	20	0	4900
29559	376	19	495	4086	0	4976
29560	2	4	4421	2	0	4429
29561	0	7	4172	0	0	4179
29562	3	2	4333	0	0	4338
29563	0	4269	8	1	0	4278
29564	0	4	1	4496	0	4501
29565	4516	0	0	1	0	4517
29566	1	0	0	4479	0	4480
29567	4526	0	0	2	0	4528
29568	2	1	2	4490	0	4495
29569	4485	0	1	3	0	4489
29570	4455	1	0	4	0	4460
29571	5217	2	2	0	0	5221
29572	45	5062	8	2	0	5117
29573	21	51	5130	0	0	5202
29574	9	16	44	5223	0	5292
29575	8	51	44	4204	0	4307
29576	2	5	9	5320	0	5336
29577	7	4	3	5223	0	5237
29578	1	5118	6	81	0	5206
29579	6	50	5028	33	0	5117
29580	0	5977	57	29	0	6063
29581	1	59	14	6189	0	6263
29582	1	24	9	7658	0	7692
29583	5	13	4	7662	0	7684
29584	1	13	3	8689	0	8706
29585	1	8195	29	81	0	8306
29586	0	8388	8	43	0	8439
29587	3	71	8288	34	0	8396
29588	1	24	50	8391	0	8466
29589	0	15	17	8527	0	8559
29590	0	9	10	8702	0	8721
29591	8661	8	9	77	0	8755
29592	52	8183	13	47	0	8295
29593	21	64	8304	22	0	8411
29594	8386	17	52	23	0	8478
29595	54	12	16	8633	0	8715
29596	8719	5	10	67	0	8801
29597	69	9	6	8643	0	8727
29598	8704	15	6	65	0	8790
29599	65	5	12	8632	0	8714
29600	8653	3	5	76	0	8737
29601	69	17	8512	40	0	8638
29602	34	1	53	8551	0	8639
29603	22	8188	35	59	0	8304
29604	14	57	13	9143	0	9227
29605	9126	21	16	118	0	9281
29606	112	9338	20	54	0	9524
29607	40	129	7	10612	0	10788
29608	36	9966	20	207	0	10229
29609	15	212	2	10398	0	10627
29610	8	79	3	10511	0	10601
29611	23	57	10055	283	0	10418
29612	12	35	179	10113	0	10339
29613	5	25	10551	273	0	10854
29614	8	10084	231	126	0	10449
29615	10615	192	74	87	0	10968
29616	196	73	10454	55	0	10778
29617	10032	53	205	33	0	10323
29618	9072	34	81	30	0	9217
29619	273	18	54	8827	0	9172
29620	128	25	9553	200	0	9906
29621	9323	15	250	92	0	9680
29622	10040	5	121	75	0	10241
29623	365	13	74	9349	0	9801
29624	197	13	32	9567	0	9809
29625	107	9838	43	369	0	10357
29626	59	253	29	10280	0	10621
29627	40	10061	30	340	0	10471
29628	41	333	9859	163	0	10396
29629	25	132	228	10299	0	10684
29630	10170	95	108	321	0	10694
29631	10310	51	73	176	0	10610
29632	346	9968	45	128	0	10487
29633	190	269	39	10869	0	11367
29634	10923	126	31	314	0	11394
29635	324	10606	49	166	0	11145
29636	10966	326	19	130	0	11441
29637	400	145	22	10827	0	11394
29638	10990	110	21	354	0	11475
29639	412	95	10492	182	0	11181
29640	195	10659	301	132	0	11287
29641	11025	335	126	93	0	11579
29642	336	11154	113	92	0	11695
29643	11662	390	57	85	0	12194
29644	11854	180	38	61	0	12133
29645	510	151	12816	67	0	13544
29646	280	94	307	12667	0	13348
29647	13378	71	138	359	0	13946
29648	430	62	12563	194	0	13249
29649	12871	52	346	146	0	13415
29650	467	51	157	12943	0	13618
29651	223	51	12752	397	0	13423
29652	175	58	355	12753	0	13341
29653	12283	57	170	450	0	12960
29654	406	79	11841	217	0	12543
29655	228	68	340	12081	0	12717
29656	203	50	162	12508	0	12923
29657	12284	48	144	504	0	12980
29658	12289	53	88	290	0	12720
29659	512	11733	91	199	0	12535
29660	304	352	65	11565	0	12286
29661	230	157	53	11803	0	12243
29662	166	124	54	12059	0	12403
29663	11625	67	84	565	0	12341
29664	11699	63	82	340	0	12184
29665	548	85	47	11640	0	12320
29666	342	11173	118	458	0	12091
29667	227	390	108	11557	0	12282
29668	219	11398	137	496	0	12250
29669	11680	488	82	257	0	12507
29670	527	11615	137	211	0	12490
29671	11509	447	198	153	0	12307
29672	596	348	83	11156	0	12183
29673	11619	165	130	386	0	12300
29674	547	277	10550	275	0	11649
29675	479	10718	359	300	0	11856
29676	11600	312	217	157	0	12286
29677	11598	174	339	194	0	12305
29678	605	166	215	11015	0	12001
29679	487	11097	207	481	0	12272
29680	353	378	282	10755	0	11768
29681	443	249	134	10867	0	11693
29682	398	192	105	9880	0	10575
29683	9572	95	298	647	0	10612
29684	9540	118	165	628	0	10451
29685	768	71	108	9346	0	10293
29686	531	8911	246	525	0	10213
29687	9583	342	162	471	0	10558
29688	589	261	8895	471	0	10216
29689	522	155	301	9533	0	10511
29690	422	128	9063	660	0	10273
29691	312	259	361	9621	0	10553
29692	370	98	9039	762	0	10269
29693	288	147	417	9639	0	10491
29694	9334	138	218	864	0	10554
29695	9600	210	132	489	0	10431
29696	837	8992	89	377	0	10295
29697	10526	466	50	385	0	11427
29698	694	471	44	10176	0	11385
29699	396	285	74	10678	0	11433
29700	10423	312	57	714	0	11506
29701	704	132	9738	529	0	11103
29702	514	287	9723	335	0	10859
29703	600	140	9843	261	0	10844
29704	9005	200	378	385	0	9968
29705	646	177	9883	280	0	10986
29706	605	196	9033	284	0	10118
29707	8212	307	259	308	0	9086
29708	491	8991	182	234	0	9898
29709	447	279	111	9479	0	10316
29710	264	182	84	9786	0	10316
29711	295	259	9098	474	0	10126
29712	9327	66	184	475	0	10052
29713	9126	112	199	367	0	9804
29714	9043	181	151	388	0	9763
29715	604	174	8811	162	0	9751
29716	8869	70	241	248	0	9428
29717	388	71	8795	378	0	9632
29718	220	8600	291	342	0	9453
29719	380	8797	261	259	0	9697
29720	8049	114	276	324	0	8763
29721	192	7826	139	428	0	8585
29722	270	8080	234	219	0	8803
29723	8476	135	67	309	0	8987
29724	305	8138	231	168	0	8842
29725	7670	244	52	296	0	8262
29726	444	142	98	7550	0	8234
29727	342	67	142	7662	0	8213
29728	133	181	163	7721	0	8198
29729	300	43	184	7647	0	8174
29730	108	7314	271	366	0	8059
29731	7523	94	233	247	0	8097
29732	319	9344	198	168	0	10029
29733	199	8775	276	119	0	9369
29734	214	223	8966	64	0	9467
29735	8277	166	348	58	0	8849
29736	417	132	10168	80	0	10797
29737	181	110	10345	168	0	10804
29738	113	10586	513	229	0	11441
29739	28	12834	98	12	0	12972
29740	12205	388	50	12	0	12655
29741	314	12243	103	36	0	12696
29742	109	349	11900	9	0	12367
29743	59	11655	398	6	0	12118
29744	43	319	12722	2	0	13086
29745	35	155	11202	4	0	11396
29746	10817	82	480	6	0	11385
29747	340	60	11076	8	0	11484
29748	134	38	436	11022	0	11630
29749	10764	31	188	323	0	11306
29750	349	10271	168	142	0	10930
29751	163	277	10808	63	0	11311
29752	10940	112	362	36	0	11450
29753	362	71	154	10173	0	10760
29754	157	9944	162	296	0	10559
29755	90	270	10871	111	0	11342
29756	10838	110	379	51	0	11378
29757	377	64	11004	32	0	11477
29758	145	38	390	11040	0	11613
29759	88	42	10897	344	0	11371
29760	55	20	402	11246	0	11723
29761	10828	8	174	394	0	11404
29762	335	10709	123	177	0	11344
29763	11286	303	60	99	0	11748
29764	413	136	10932	52	0	11533
29765	158	75	351	12101	0	12685
29766	110	50	11771	404	0	12335
29767	12000	45	452	131	0	12628
29768	12240	24	165	79	0	12508
29769	514	11946	137	45	0	12642
29770	12355	375	59	41	0	12830
29771	12095	134	45	22	0	12296
29772	587	81	34	11652	0	12354
29773	266	83	11048	387	0	11784
29774	130	10868	412	124	0	11534
29775	82	361	129	11763	0	12335
29776	11806	124	86	410	0	12426
29777	428	85	11638	167	0	12318
29778	167	57	11798	88	0	12110
29779	105	72	11461	39	0	11677
29780	11372	39	585	48	0	12044
29781	462	47	11369	20	0	11898
29782	11376	35	519	18	0	11948
29783	493	68	10288	27	0	10876
29784	204	10414	461	26	0	11105
29785	132	403	183	10624	0	11342
29786	78	173	10460	392	0	11103
29787	82	10167	489	142	0	10880
29788	67	10829	214	82	0	11192
29789	42	541	153	10748	0	11484
29790	10730	234	97	436	0	11497
29791	429	139	118	10883	0	11569
29792	10692	107	73	488	0	11360
29793	502	111	77	10890	0	11580
29794	210	104	10530	506	0	11350
29795	161	84	10741	204	0	11190
29796	10518	66	600	158	0	11342
29797	10325	68	289	111	0	10793
29798	635	83	9810	58	0	10586
29799	9999	103	526	62	0	10690
29800	589	129	9703	45	0	10466
29801	311	9556	579	52	0	10498
29802	242	9950	277	61	0	10530
29803	165	10212	242	71	0	10690
29804	131	623	193	9906	0	10853
29805	9293	317	154	444	0	10208
29806	9628	229	157	188	0	10202
29807	665	175	115	9412	0	10367
29808	348	141	8236	469	0	9194
29809	187	119	545	8582	0	9433
29810	195	96	8309	527	0	9127
29811	163	96	620	8583	0	9462
29812	8410	52	336	574	0	9372
29813	8877	59	262	232	0	9430
29814	8949	67	184	197	0	9397
29815	9006	80	185	143	0	9414
29816	738	73	148	8381	0	9340
29817	401	56	138	8874	0	9469
29818	8559	114	149	583	0	9405
29819	8881	91	113	300	0	9385
29820	702	80	116	8508	0	9406
29821	338	73	105	8883	0	9399
29822	271	62	103	8648	0	9084
29823	243	72	108	8773	0	9196
29824	8308	51	105	750	0	9214
29825	544	53	8021	366	0	8984
29826	273	45	517	8330	0	9165
29827	8328	37	235	582	0	9182
29828	608	62	7869	303	0	8842
29829	349	53	517	8281	0	9200
29830	268	85	7996	526	0	8875
29831	217	8057	583	268	0	9125
29832	151	300	187	5907	0	6545
29833	5849	144	170	366	0	6529
29834	353	115	120	5760	0	6348
29835	215	5651	118	397	0	6381
29836	176	4485	65	141	0	4867
29837	128	4052	62	124	0	4366
29838	107	3952	65	96	0	4220
29839	1236	76	31	35	0	1378
29840	75	12	25	1265	0	1377
29841	17	14	1187	90	0	1308
29842	21	10	83	1230	0	1344
29843	38	10	1141	87	0	1276
29844	1237	6	64	23	0	1330
29845	122	3	14	1185	0	1324
29846	60	6	17	1250	0	1333
29847	34	10	12	1270	0	1326
29848	22	16	15	1287	0	1340
29849	1214	19	2	100	0	1335
29850	1278	8	13	36	0	1335
29851	87	8	9	1234	0	1338
29852	1207	9	8	114	0	1338
29853	77	7	1138	63	0	1285
29854	21	1149	65	62	0	1297
29855	43	60	19	1177	0	1299
29856	24	7	33	1185	0	1249
29857	28	1160	18	97	0	1303
29858	32	62	17	1204	0	1315
29859	22	6	38	1271	0	1337
29860	1200	6	22	110	0	1338
29861	84	11	1159	32	0	1286
29862	25	26	1187	29	0	1267
29863	1201	11	73	44	0	1329
29864	106	9	1200	28	0	1343
29865	4	0	1	0	0	5
29866	3	0	0	0	0	3
29867	0	1	0	2	0	3
29868	0	0	1	1	0	2
29869	1	0	0	1	0	2
29870	0	1	0	1	0	2
29871	1	0	0	0	0	1
29872	6	0	0	0	0	6
29873	6	1	0	1	0	8
29874	41	0	0	0	0	41
29875	40	0	1	0	0	41
29876	40	0	0	0	0	40
29877	40	0	0	0	0	40
29878	39	0	0	1	0	40
29879	40	0	0	0	0	40
29880	40	0	0	0	0	40
29881	40	0	0	0	0	40
29882	40	0	0	0	0	40
29883	40	0	0	0	0	40
29884	40	0	0	0	0	40
29885	40	0	0	0	0	40
29886	40	0	0	0	0	40
29887	40	0	0	0	0	40
29888	40	0	0	0	0	40
29889	40	0	0	0	0	40
29890	40	0	0	0	0	40
29891	40	0	0	0	0	40
29892	40	0	0	0	0	40
29893	40	0	0	0	0	40
29894	40	0	0	0	0	40
29895	40	0	0	0	0	40
29896	40	0	0	0	0	40
29897	40	0	0	0	0	40
29898	40	0	0	0	0	40
29899	40	0	0	0	0	40
29900	40	0	0	0	0	40
29901	39	0	0	0	0	39
29902	38	0	0	0	0	38
29903	36	0	0	0	0	36
