Pos	A	C	G	T	Other	Total
1	0	0	0	0	0	0
2	0	0	0	0	0	0
3	0	0	0	2	0	2
4	2	0	0	0	0	2
5	3	0	0	0	0	3
6	3	0	0	0	0	3
7	0	0	6	0	0	6
8	0	0	5	0	0	5
9	0	0	0	8	0	8
10	0	0	0	6	0	6
11	0	0	0	8	0	8
12	14	0	0	1	0	15
13	0	0	0	28	0	28
14	41	0	0	1	0	42
15	0	69	0	0	0	69
16	0	106	0	0	0	106
17	1	0	0	304	0	305
18	1	0	0	344	0	345
19	0	456	0	3	0	459
20	0	499	0	0	0	499
21	0	573	0	2	0	575
22	619	0	0	2	0	621
23	0	0	629	0	0	629
24	2	0	619	0	0	621
25	0	0	0	687	0	687
26	731	0	0	2	0	733
27	740	0	0	2	0	742
28	1	748	0	1	0	750
29	859	1	0	9	0	869
30	927	0	0	6	0	933
31	946	0	0	3	0	949
32	1	942	0	0	0	943
33	0	961	0	0	0	961
34	995	1	0	2	0	998
35	1002	0	0	1	0	1003
36	1	1010	0	0	0	1011
37	0	1074	0	9	0	1083
38	1084	1	0	3	0	1088
39	1091	0	0	1	0	1092
40	2	1092	0	2	0	1096
41	0	2	0	1140	0	1142
42	1	0	0	1148	0	1149
43	0	0	0	1148	0	1148
44	1	1145	0	3	0	1149
45	0	2	1128	1	0	1131
46	1113	0	1	1	0	1115
47	2	0	0	1163	0	1165
48	1	1162	0	2	0	1165
49	1	2	0	1172	0	1175
50	0	1175	0	1	0	1176
51	1	1	0	1192	0	1194
52	0	0	0	1195	0	1195
53	0	1	1202	1	0	1204
54	1	0	1	1200	0	1202
55	1219	0	0	3	0	1222
56	1	0	1208	1	0	1210
57	1201	1	1	3	0	1206
58	1	0	1	1232	0	1234
59	1	1220	0	1	0	1222
60	0	2	0	1236	0	1238
61	0	1	1243	1	0	1245
62	0	0	1	1233	0	1234
63	0	1	0	1249	0	1250
64	0	1253	0	5	0	1258
65	0	1	0	1269	0	1270
66	2	1254	1	2	0	1259
67	0	1	0	1275	0	1276
68	1269	0	0	2	0	1271
69	1264	0	1	3	0	1268
70	1272	0	0	2	0	1274
71	10	1262	0	3	0	1275
72	3	3	1270	1	0	1277
73	1273	0	3	0	0	1276
74	1319	0	1	3	0	1323
75	3	1350	0	2	0	1355
76	2	3	0	1011	0	1016
77	0	0	0	1036	0	1036
78	2	0	0	899	0	901
79	909	1	0	11	0	921
80	922	0	0	3	0	925
81	914	1	0	1	0	916
82	913	0	0	3	0	916
83	11	0	0	909	0	920
84	2	904	0	9	0	915
85	3	8	0	930	0	941
86	1	2	953	9	0	965
87	2	0	11	990	0	1003
88	3	0	1011	14	0	1028
89	3	0	14	1026	0	1043
90	0	2	1055	14	0	1071
91	0	1	1075	3	0	1079
92	0	1094	15	1	0	1110
93	0	15	1	1151	0	1167
94	1	2	1172	15	0	1190
95	5	1	15	1157	0	1178
96	1	1187	1	13	0	1202
97	1192	15	2	2	0	1211
98	13	1223	1	4	0	1241
99	2	16	0	1215	0	1233
100	1	1237	1	16	0	1255
101	0	15	1220	3	0	1238
102	0	4	1208	2	0	1214
103	1	1220	17	2	0	1240
104	0	14	2	1232	0	1248
105	0	1	1240	17	0	1258
106	0	1234	18	5	0	1257
107	1248	15	2	3	0	1268
108	19	2	1	1244	0	1266
109	1	3	1260	16	0	1280
110	2	1257	15	3	0	1277
111	0	16	2	1270	0	1288
112	1	3	1	1284	0	1289
113	1249	2	0	19	0	1270
114	15	2	1253	4	0	1274
115	1	1	15	1248	0	1265
116	1	3	1233	15	0	1252
117	0	1133	18	6	0	1157
118	1103	16	3	5	0	1127
119	15	1078	2	1	0	1096
120	1	17	1	1041	0	1060
121	1	1020	1	13	0	1035
122	1009	14	1	2	0	1026
123	16	1020	0	2	0	1038
124	2	16	1001	1	0	1020
125	2	994	17	0	0	1013
126	987	17	1	2	0	1007
127	15	4	993	3	0	1015
128	3	2	13	994	0	1012
129	973	1	3	18	0	995
130	16	0	5	942	0	963
131	947	2	2	18	0	969
132	967	2	1	4	0	974
133	21	3	1	953	0	978
134	3	3	1	970	0	977
135	948	1	0	24	0	973
136	954	2	0	9	0	965
137	23	1	1	924	0	949
138	930	3	0	17	0	950
139	950	2	1	6	0	959
140	21	927	1	4	0	953
141	6	17	1	941	0	965
142	940	3	3	20	0	966
143	962	2	1	8	0	973
144	22	0	2	951	0	975
145	7	1	1	973	0	982
146	953	2	2	20	0	977
147	22	956	1	8	0	987
148	7	17	2	956	0	982
149	8	3	959	18	0	988
150	4	4	18	938	0	964
151	2	956	1	24	0	983
152	5	15	965	6	0	991
153	3	3	19	957	0	982
154	3	4	3	959	0	969
155	5	1	953	20	0	979
156	922	4	18	9	0	953
157	20	977	3	5	0	1005
158	980	19	4	3	0	1006
159	21	5	973	3	0	1002
160	2	5	996	6	0	1009
161	958	4	21	5	0	988
162	17	993	3	4	0	1017
163	983	20	3	4	0	1010
164	21	987	2	3	0	1013
165	2	22	992	1	0	1017
166	981	1	20	7	0	1009
167	19	6	1006	2	0	1033
168	1	3	22	1005	0	1031
169	1007	2	4	21	0	1034
170	1015	5	1	6	0	1027
171	20	1004	1	5	0	1030
172	7	25	5	975	0	1012
173	2	992	5	18	0	1017
174	8	16	969	2	0	995
175	2	11	16	895	0	924
176	4	883	1	12	0	900
177	2	11	3	846	0	862
178	804	2	5	14	0	825
179	13	2	1	809	0	825
180	1	816	3	10	0	830
181	3	8	2	824	0	837
182	3	3	0	831	0	837
183	3	824	4	9	0	840
184	3	11	0	823	0	837
185	3	2	816	12	0	833
186	2	797	8	4	0	811
187	742	5	1	2	0	750
188	4	1	737	2	0	744
189	1	4	719	3	0	727
190	1	708	4	2	0	715
191	8	13	1	654	0	676
192	2	0	652	2	0	656
193	0	570	3	3	0	576
194	1	4	2	580	0	587
195	1	1	0	599	0	601
196	582	1	1	4	0	588
197	2	585	1	2	0	590
198	0	3	559	1	0	563
199	0	1	565	3	0	569
200	2	1	4	556	0	563
201	3	1	1	639	0	644
202	1	2	2	649	0	654
203	0	781	2	10	0	793
204	0	17	797	2	0	816
205	2	2	15	841	0	860
206	0	876	4	17	0	897
207	0	912	2	6	0	920
208	0	21	945	3	0	969
209	4	4	19	936	0	963
210	2	2	1016	17	0	1037
211	4	5	20	1010	0	1039
212	3	1	6	1049	0	1059
213	0	0	1028	25	0	1053
214	1	1027	21	12	0	1061
215	1018	21	7	7	0	1053
216	19	7	1047	3	0	1076
217	5	1044	26	1	0	1076
218	3	1077	8	3	0	1091
219	1	28	1043	3	0	1075
220	1024	10	23	4	0	1061
221	21	6	7	1002	0	1036
222	5	1044	6	19	0	1074
223	1041	24	3	6	0	1074
224	25	7	4	1003	0	1039
225	6	1026	2	23	0	1057
226	1039	24	1	9	0	1073
227	24	10	1019	3	0	1056
228	6	1024	26	2	0	1058
229	1000	23	8	5	0	1036
230	18	1003	6	5	0	1032
231	986	28	3	2	0	1019
232	26	12	3	967	0	1008
233	7	968	5	23	0	1003
234	5	22	5	974	0	1006
235	956	9	3	27	0	995
236	21	5	951	12	0	989
237	8	5	959	7	0	979
238	8	9	26	923	0	966
239	5	7	9	937	0	958
240	9	6	8	914	0	937
241	4	897	7	28	0	936
242	0	26	889	11	0	926
243	3	10	22	863	0	898
244	7	855	9	17	0	888
245	5	890	8	9	0	912
246	3	26	880	7	0	916
247	6	12	871	3	0	892
248	2	8	893	6	0	909
249	6	7	28	867	0	908
250	6	9	877	19	0	911
251	3	3	30	859	0	895
252	6	5	872	23	0	906
253	842	6	24	13	0	885
254	23	888	7	5	0	923
255	10	937	8	5	0	960
256	8	27	965	4	0	1004
257	939	10	27	7	0	983
258	969	8	6	7	0	990
259	972	6	7	5	0	990
260	31	7	925	4	0	967
261	13	2	944	3	0	962
262	9	3	34	921	0	967
263	932	5	10	32	0	979
264	933	7	8	14	0	962
265	30	6	906	8	0	950
266	908	6	31	9	0	954
267	33	4	14	887	0	938
268	10	10	894	28	0	942
269	5	12	911	10	0	938
270	868	4	43	12	0	927
271	26	6	900	9	0	941
272	889	5	32	10	0	936
273	30	5	888	7	0	930
274	10	858	38	8	0	914
275	8	893	18	8	0	927
276	7	29	16	880	0	932
277	17	13	10	901	0	941
278	8	9	893	31	0	941
279	5	11	33	870	0	919
280	11	859	20	23	0	913
281	12	883	9	15	0	919
282	11	900	19	3	0	933
283	16	39	9	866	0	930
284	10	17	877	24	0	928
285	8	9	889	11	0	917
286	11	6	36	847	0	900
287	11	9	14	863	0	897
288	14	8	5	841	0	868
289	14	851	9	29	0	903
290	850	29	7	15	0	901
291	864	12	5	13	0	894
292	34	851	14	9	0	908
293	16	27	859	8	0	910
294	861	12	30	6	0	909
295	32	11	863	4	0	910
296	869	10	31	4	0	914
297	879	3	15	18	0	915
298	879	8	10	8	0	905
299	870	10	12	8	0	900
300	31	858	5	16	0	910
301	765	17	6	15	0	803
302	22	769	11	11	0	813
303	611	14	4	3	0	632
304	13	599	4	2	0	618
305	11	13	523	3	0	550
306	4	48	12	440	0	504
307	3	487	8	11	0	509
308	6	440	7	1	0	454
309	391	13	20	16	0	440
310	363	6	1	2	0	372
311	7	366	1	4	0	378
312	7	5	0	360	0	372
313	3	407	3	9	0	422
314	415	7	3	1	0	426
315	11	2	408	1	0	422
316	3	3	5	389	0	400
317	5	2	3	392	0	402
318	5	4	1	393	0	403
319	3	1	393	4	0	401
320	3	380	5	4	0	392
321	5	393	1	3	0	402
322	2	8	0	400	0	410
323	5	1	401	6	0	413
324	2	6	6	400	0	414
325	5	4	0	403	0	412
326	1	3	1	398	0	403
327	3	4	2	392	0	401
328	388	3	1	8	0	400
329	5	390	4	4	0	403
330	389	5	2	7	0	403
331	5	3	391	3	0	402
332	3	3	398	4	0	408
333	3	1	7	390	0	401
334	4	3	2	389	0	398
335	0	396	1	6	0	403
336	1	4	396	7	0	408
337	0	401	8	2	0	411
338	3	6	400	4	0	413
339	394	3	6	2	0	405
340	4	401	1	6	0	412
341	1	6	409	6	0	422
342	3	2	7	406	0	418
343	3	3	405	5	0	416
344	4	397	5	3	0	409
345	4	8	3	384	0	399
346	1	395	2	8	0	406
347	4	5	397	1	0	407
348	2	5	4	384	0	395
349	382	1	2	9	0	394
350	5	377	2	2	0	386
351	1	6	379	4	0	390
352	4	7	3	357	0	371
353	1	3	356	4	0	364
354	3	1	323	0	0	327
355	0	295	4	1	0	300
356	1	2	0	248	0	251
357	0	0	1	249	0	250
358	0	0	1	245	0	246
359	0	2	248	2	0	252
360	0	0	258	1	0	259
361	247	0	2	1	0	250
362	2	0	256	1	0	259
363	248	0	3	0	0	251
364	2	250	1	0	0	253
365	1	2	0	250	0	253
366	0	255	1	2	0	258
367	1	257	0	0	0	258
368	0	3	258	0	0	261
369	0	1	2	255	0	258
370	0	1	257	2	0	260
371	0	1	238	0	0	239
372	235	0	3	0	0	238
373	2	0	249	1	0	252
374	0	0	245	0	0	245
375	230	1	4	0	0	235
376	3	0	240	0	0	243
377	0	0	246	0	0	246
378	0	0	3	236	0	239
379	1	241	0	2	0	244
380	1	2	1	245	0	249
381	0	0	1	243	0	244
382	245	0	0	3	0	248
383	2	1	0	241	0	244
384	0	245	0	3	0	248
385	239	2	0	1	0	242
386	3	0	239	0	0	242
387	236	0	2	3	0	241
388	2	1	250	0	0	253
389	1	0	258	0	0	259
390	0	271	4	0	0	275
391	287	3	0	0	0	290
392	3	292	1	0	0	296
393	1	3	291	0	0	295
394	0	2	2	272	0	276
395	1	282	1	3	0	287
396	282	4	0	1	0	287
397	283	1	1	0	0	285
398	4	281	0	1	0	286
399	288	3	0	0	0	291
400	4	1	0	275	0	280
401	2	273	0	5	0	280
402	0	2	0	283	0	285
403	0	1	0	302	0	303
404	299	0	0	4	0	303
405	298	0	0	1	0	299
406	302	0	0	1	0	303
407	4	2	297	0	0	303
408	296	0	2	0	0	298
409	2	1	1	297	0	301
410	2	0	301	2	0	305
411	1	0	299	1	0	301
412	1	290	3	0	0	294
413	248	2	3	0	0	253
414	1	253	1	0	0	255
415	2	1	0	255	0	258
416	0	1	0	256	0	257
417	0	0	254	2	0	256
418	0	0	2	247	0	249
419	0	1	259	1	0	261
420	1	0	253	1	0	255
421	0	262	2	0	0	264
422	0	1	1	253	0	255
423	0	1	0	249	0	250
424	250	0	1	2	0	253
425	1	0	258	2	0	261
426	1	0	2	258	0	261
427	258	0	2	1	0	261
428	1	1	254	1	0	257
429	253	0	1	2	0	256
430	257	0	1	1	0	259
431	3	0	263	0	0	266
432	1	0	2	254	0	257
433	0	0	1	259	0	260
434	1	0	265	2	0	268
435	261	0	2	1	0	264
436	270	0	1	0	0	271
437	267	0	0	0	0	267
438	274	0	1	0	0	275
439	267	0	1	2	0	270
440	2	1	237	3	0	243
441	1	0	278	0	0	279
442	1	275	2	0	0	278
443	1	1	291	0	0	293
444	1	2	1	284	0	288
445	2	0	1	255	0	258
446	1	0	0	289	0	290
447	0	0	2	291	0	293
448	0	0	286	7	0	293
449	0	289	1	1	0	291
450	0	294	2	1	0	297
451	0	3	0	286	0	289
452	0	298	0	2	0	300
453	297	2	0	3	0	302
454	296	1	0	1	0	298
455	3	309	2	0	0	314
456	1	3	0	312	0	316
457	1	2	0	323	0	326
458	1	0	325	4	0	330
459	308	1	2	1	0	312
460	316	0	1	1	0	318
461	5	319	2	2	0	328
462	331	3	0	0	0	334
463	3	1	342	3	0	349
464	2	329	5	1	0	337
465	2	342	5	0	0	349
466	2	348	0	2	0	352
467	2	5	1	342	0	350
468	334	3	1	3	0	341
469	6	1	0	346	0	353
470	4	0	340	4	0	348
471	1	2	6	350	0	359
472	2	2	368	5	0	377
473	0	1	6	359	0	366
474	2	0	6	358	0	366
475	1	367	2	9	0	379
476	377	4	2	4	0	387
477	4	3	3	370	0	380
478	4	373	2	7	0	386
479	374	3	3	4	0	384
480	330	7	1	5	0	343
481	379	0	1	3	0	383
482	6	382	3	3	0	394
483	5	2	391	2	0	400
484	4	6	3	396	0	409
485	1	5	6	384	0	396
486	2	397	1	10	0	410
487	2	3	397	5	0	407
488	2	3	393	1	0	399
489	377	2	6	2	0	387
490	5	2	4	374	0	385
491	4	1	382	4	0	391
492	4	394	3	3	0	404
493	4	3	3	389	0	399
494	2	412	2	2	0	418
495	3	3	405	1	0	412
496	385	2	3	1	0	391
497	404	0	4	3	0	411
498	6	410	3	2	0	421
499	3	4	1	410	0	418
500	1	1	414	4	0	420
501	2	411	2	6	0	421
502	410	2	4	1	0	417
503	4	390	0	1	0	395
504	3	395	1	0	0	399
505	5	5	0	389	0	399
506	1	392	0	2	0	395
507	388	2	0	4	0	394
508	3	3	0	385	0	391
509	3	0	376	2	0	381
510	1	0	356	2	0	359
511	1	0	3	359	0	363
512	0	354	2	1	0	357
513	357	2	1	2	0	362
514	1	2	0	350	0	353
515	2	0	345	1	0	348
516	0	1	1	340	0	342
517	1	0	2	346	0	349
518	348	0	0	4	0	352
519	2	0	0	345	0	347
520	2	0	341	2	0	345
521	0	0	343	4	0	347
522	0	0	4	356	0	360
523	0	0	2	354	0	356
524	0	0	372	4	0	376
525	338	0	2	3	0	343
526	2	0	364	0	0	366
527	2	371	2	0	0	375
528	1	2	2	375	0	380
529	0	2	372	2	0	376
530	0	0	370	2	0	372
531	0	0	4	366	0	370
532	364	0	2	4	0	370
533	2	0	393	4	0	399
534	2	392	2	0	0	396
535	397	2	2	0	0	401
536	2	2	400	0	0	404
537	390	0	2	1	0	393
538	400	0	3	0	0	403
539	4	420	0	0	0	424
540	3	1	1	417	0	422
541	0	428	0	2	0	430
542	0	2	439	2	0	443
543	428	2	2	0	0	432
544	436	0	2	0	0	438
545	4	0	429	0	0	433
546	3	0	443	0	0	446
547	0	461	4	0	0	465
548	467	2	3	1	0	473
549	3	3	0	473	0	479
550	3	0	0	463	0	466
551	0	470	0	4	0	474
552	464	2	0	2	0	468
553	2	3	481	0	0	486
554	4	0	2	527	0	533
555	549	0	3	3	0	555
556	3	560	0	3	0	566
557	3	2	630	0	0	635
558	0	2	636	0	0	638
559	0	1	7	631	0	639
560	0	647	3	5	0	655
561	0	5	651	3	0	659
562	0	2	6	650	0	658
563	664	0	2	6	0	672
564	5	9	673	2	0	689
565	2	0	6	687	0	695
566	0	0	687	6	0	693
567	2	2	704	2	0	710
568	1	5	8	697	0	711
569	2	0	707	8	0	717
570	664	0	6	2	0	672
571	5	1	717	0	0	723
572	686	0	6	4	0	696
573	5	705	5	0	0	715
574	723	4	1	3	0	731
575	5	747	1	1	0	754
576	6	6	1	748	0	761
577	1	3	1	767	0	772
578	3	0	757	7	0	767
579	0	2	761	1	0	764
580	1	0	7	774	0	782
581	0	1	778	8	0	787
582	2	0	9	755	0	766
583	0	755	5	6	0	766
584	0	768	2	3	0	773
585	2	6	3	765	0	776
586	1	3	1	768	0	773
587	1	3	754	6	0	764
588	3	3	5	746	0	757
589	2	744	1	6	0	753
590	1	738	1	3	0	743
591	0	741	1	2	0	744
592	1	5	1	709	0	716
593	0	702	2	8	0	712
594	699	7	2	3	0	711
595	5	3	2	707	0	717
596	3	0	704	8	0	715
597	3	2	7	695	0	707
598	2	1	704	6	0	713
599	0	2	703	4	0	709
600	1	1	711	1	0	714
601	0	705	7	4	0	716
602	0	6	723	3	0	732
603	719	1	8	3	0	731
604	720	1	4	3	0	728
605	741	4	1	1	0	747
606	6	2	2	735	0	745
607	736	2	2	7	0	747
608	6	715	0	3	0	724
609	3	764	0	0	0	767
610	741	7	1	5	0	754
611	6	2	758	3	0	769
612	3	1	8	757	0	769
613	1	1	765	6	0	773
614	4	0	768	4	0	776
615	0	777	14	0	0	791
616	1	7	4	764	0	776
617	0	5	3	786	0	794
618	781	1	4	7	0	793
619	8	790	0	6	0	804
620	3	800	1	4	0	808
621	1	7	797	4	0	809
622	5	805	6	2	0	818
623	800	8	2	2	0	812
624	792	7	3	1	0	803
625	8	4	807	1	0	820
626	2	2	800	4	0	808
627	3	5	11	784	0	803
628	5	1	9	789	0	804
629	1	791	5	13	0	810
630	3	8	7	783	0	801
631	3	2	5	789	0	799
632	1	780	3	14	0	798
633	4	9	5	776	0	794
634	3	2	5	766	0	776
635	0	758	4	12	0	774
636	2	8	758	2	0	770
637	3	3	9	771	0	786
638	772	2	5	11	0	790
639	750	3	5	1	0	759
640	10	3	745	2	0	760
641	735	2	8	4	0	749
642	735	6	3	1	0	745
643	12	722	1	4	0	739
644	2	9	711	6	0	728
645	2	3	726	4	0	735
646	4	5	9	775	0	793
647	775	3	6	10	0	794
648	820	3	9	3	0	835
649	11	1	4	870	0	886
650	920	3	1	16	0	940
651	946	4	5	6	0	961
652	924	3	5	6	0	938
653	14	6	904	5	0	929
654	11	2	887	4	0	904
655	857	2	11	4	0	874
656	13	2	863	4	0	882
657	3	790	7	0	0	800
658	4	9	4	778	0	795
659	0	2	793	9	0	804
660	1	0	794	2	0	797
661	2	8	8	773	0	791
662	0	1	778	8	0	787
663	2	1	772	2	0	777
664	1	740	8	2	0	751
665	2	779	2	1	0	784
666	776	6	2	0	0	784
667	9	5	1	755	0	770
668	766	1	1	7	0	775
669	6	0	757	4	0	767
670	4	1	5	754	0	764
671	1	0	3	764	0	768
672	761	2	1	9	0	773
673	5	760	0	5	0	770
674	2	5	712	1	0	720
675	5	6	714	0	0	725
676	1	758	7	1	0	767
677	1	7	748	0	0	756
678	0	738	8	1	0	747
679	1	724	5	0	0	730
680	2	9	708	6	0	725
681	702	2	5	1	0	710
682	6	1	3	732	0	742
683	3	750	0	6	0	759
684	1	6	1	743	0	751
685	743	3	0	8	0	754
686	734	1	0	4	0	739
687	727	0	1	1	0	729
688	7	2	729	0	0	738
689	3	1	7	721	0	732
690	0	731	5	4	0	740
691	762	7	0	3	0	772
692	7	2	1	771	0	781
693	3	1	2	760	0	766
694	1	1	0	781	0	783
695	2	1	777	8	0	788
696	754	2	6	2	0	764
697	7	788	4	2	0	801
698	3	8	1	797	0	809
699	1	3	1	785	0	790
700	780	0	0	10	0	790
701	10	0	753	2	0	765
702	4	0	785	3	0	792
703	2	779	12	1	0	794
704	3	8	796	2	0	809
705	767	2	9	1	0	779
706	12	789	3	4	0	808
707	2	11	805	2	0	820
708	776	2	13	1	0	792
709	12	0	812	1	0	825
710	2	815	11	2	0	830
711	4	9	3	800	0	816
712	4	4	1	815	0	824
713	3	3	800	12	0	818
714	0	0	778	4	0	782
715	3	774	16	1	0	794
716	764	12	4	3	0	783
717	12	788	2	1	0	803
718	3	16	0	785	0	804
719	2	3	776	12	0	793
720	738	0	16	2	0	756
721	14	2	4	759	0	779
722	2	757	5	12	0	776
723	1	799	3	4	0	807
724	0	15	3	796	0	814
725	2	5	1	805	0	813
726	790	3	2	14	0	809
727	12	0	3	798	0	813
728	2	2	794	15	0	813
729	789	2	14	4	0	809
730	801	2	5	4	0	812
731	16	3	799	3	0	821
732	810	2	11	4	0	827
733	18	1	4	828	0	851
734	4	1	1	849	0	855
735	2	1	1	847	0	851
736	2	2	4	827	0	835
737	0	835	1	19	0	855
738	855	15	4	6	0	880
739	900	4	0	2	0	906
740	19	3	916	2	0	940
741	941	0	20	1	0	962
742	990	1	3	2	0	996
743	1012	2	2	3	0	1019
744	1048	3	2	1	0	1054
745	25	1009	0	4	0	1038
746	6	20	1	974	0	1001
747	6	3	983	22	0	1014
748	2	3	934	4	0	943
749	830	5	26	6	0	867
750	831	0	11	5	0	847
751	16	799	3	0	0	818
752	810	14	1	1	0	826
753	17	815	0	0	0	832
754	3	18	0	812	0	833
755	830	3	0	17	0	850
756	842	3	0	5	0	850
757	838	1	0	6	0	845
758	20	819	0	2	0	841
759	821	15	0	0	0	836
760	21	2	0	809	0	832
761	826	3	0	16	0	845
762	18	1	811	2	0	832
763	3	808	14	3	0	828
764	806	15	2	1	0	824
765	16	2	802	0	0	820
766	2	5	15	803	0	825
767	3	1	816	15	0	835
768	1	1	811	4	0	817
769	3	0	17	802	0	822
770	1	0	825	16	0	842
771	2	0	19	817	0	838
772	2	0	4	820	0	826
773	827	1	3	20	0	851
774	15	825	1	7	0	848
775	4	846	1	9	0	860
776	3	850	2	1	0	856
777	1	22	837	1	0	861
778	4	8	17	821	0	850
779	1	4	848	16	0	869
780	819	2	17	5	0	843
781	855	1	4	4	0	864
782	17	847	4	2	0	870
783	9	15	1	839	0	864
784	7	854	0	14	0	875
785	851	17	0	4	0	872
786	19	6	0	850	0	875
787	5	5	861	18	0	889
788	5	853	15	6	0	879
789	2	18	866	5	0	891
790	5	5	17	852	0	879
791	1	5	851	17	0	874
792	809	3	18	4	0	834
793	19	0	859	4	0	882
794	5	842	21	2	0	870
795	7	17	5	853	0	882
796	5	3	5	870	0	883
797	855	4	3	22	0	884
798	859	2	3	7	0	871
799	20	835	2	9	0	866
800	8	15	845	6	0	874
801	4	7	837	1	0	849
802	819	5	19	2	0	845
803	19	4	836	2	0	861
804	8	2	824	1	0	835
805	6	4	815	1	0	826
806	4	3	826	1	0	834
807	1	821	18	3	0	843
808	830	12	9	3	0	854
809	15	4	6	802	0	827
810	811	4	3	14	0	832
811	21	806	1	5	0	833
812	809	15	1	3	0	828
813	19	834	2	2	0	857
814	9	16	1	830	0	856
815	5	868	3	14	0	890
816	4	18	857	5	0	884
817	3	881	14	7	0	905
818	3	14	12	959	0	988
819	957	8	4	17	0	986
820	17	3	5	965	0	990
821	7	3	964	22	0	996
822	8	2	17	948	0	975
823	4	951	6	21	0	982
824	2	14	957	9	0	982
825	957	8	14	9	0	988
826	19	6	8	973	0	1006
827	968	5	6	19	0	998
828	991	3	6	7	0	1007
829	19	968	5	10	0	1002
830	959	14	4	8	0	985
831	991	6	9	3	0	1009
832	18	986	7	4	0	1015
833	16	11	5	987	0	1019
834	12	6	4	989	0	1011
835	5	979	3	18	0	1005
836	3	16	3	992	0	1014
837	5	8	973	17	0	1003
838	5	12	11	955	0	983
839	8	4	943	19	0	974
840	1	2	863	11	0	877
841	5	843	14	9	0	871
842	1	840	11	5	0	857
843	3	850	8	5	0	866
844	6	13	6	802	0	827
845	1	6	808	8	0	823
846	788	3	9	6	0	806
847	9	4	7	799	0	819
848	4	4	798	9	0	815
849	3	2	796	5	0	806
850	5	809	10	1	0	825
851	0	9	4	799	0	812
852	789	5	5	9	0	808
853	7	778	1	5	0	791
854	4	777	2	5	0	788
855	5	778	2	2	0	787
856	3	11	3	788	0	805
857	1	836	2	9	0	848
858	1	10	3	890	0	904
859	3	5	1	920	0	929
860	4	6	926	14	0	950
861	860	2	10	8	0	880
862	10	2	947	3	0	962
863	5	3	14	947	0	969
864	2	3	958	10	0	973
865	1	951	13	7	0	972
866	952	10	6	6	0	974
867	9	3	3	943	0	958
868	4	3	5	958	0	970
869	957	3	3	15	0	978
870	935	2	3	5	0	945
871	960	1	6	3	0	970
872	13	4	948	2	0	967
873	911	2	8	3	0	924
874	14	918	3	3	0	938
875	6	930	1	3	0	940
876	5	10	0	914	0	929
877	6	4	0	888	0	898
878	6	908	0	10	0	924
879	2	11	3	909	0	925
880	899	4	2	13	0	918
881	8	6	891	10	0	915
882	4	899	9	3	0	915
883	882	10	2	5	0	899
884	7	874	4	7	0	892
885	6	11	877	5	0	899
886	3	4	10	880	0	897
887	2	3	862	8	0	875
888	1	845	11	7	0	864
889	4	10	5	846	0	865
890	2	5	842	7	0	856
891	3	5	836	6	0	850
892	4	6	12	839	0	861
893	844	3	5	9	0	861
894	851	1	4	8	0	864
895	853	2	5	5	0	865
896	14	3	864	3	0	884
897	6	860	8	2	0	876
898	3	9	7	854	0	873
899	3	5	4	853	0	865
900	1	861	3	11	0	876
901	855	11	1	8	0	875
902	11	5	0	861	0	877
903	4	3	857	8	0	872
904	4	859	8	6	0	877
905	848	11	3	9	0	871
906	9	868	4	7	0	888
907	4	12	6	862	0	884
908	5	6	1	868	0	880
909	0	4	4	872	0	880
910	3	7	859	11	0	880
911	2	3	13	841	0	859
912	2	849	4	12	0	867
913	2	840	4	7	0	853
914	2	8	832	7	0	849
915	795	5	7	5	0	812
916	814	2	0	5	0	821
917	7	794	5	3	0	809
918	715	5	1	3	0	724
919	722	1	0	1	0	724
920	6	727	1	1	0	735
921	2	6	1	731	0	740
922	2	1	767	5	0	775
923	0	4	739	2	0	745
924	764	2	7	2	0	775
925	7	785	0	4	0	796
926	1	9	1	785	0	796
927	3	2	2	795	0	802
928	5	1	0	797	0	803
929	782	2	2	10	0	796
930	6	3	3	779	0	791
931	4	1	3	768	0	776
932	1	2	755	8	0	766
933	719	2	7	0	0	728
934	7	742	1	2	0	752
935	742	8	0	6	0	756
936	3	733	5	4	0	745
937	2	5	6	740	0	753
938	743	1	4	6	0	754
939	745	3	2	1	0	751
940	6	4	732	2	0	744
941	759	1	6	8	0	774
942	10	3	776	6	0	795
943	3	4	743	5	0	755
944	6	2	746	6	0	760
945	2	3	813	6	0	824
946	1	3	11	842	0	857
947	4	1	853	12	0	870
948	5	2	10	844	0	861
949	851	7	4	9	0	871
950	16	2	1	840	0	859
951	831	5	1	16	0	853
952	13	841	3	6	0	863
953	8	16	1	829	0	854
954	5	1	828	12	0	846
955	3	843	16	2	0	864
956	5	16	6	813	0	840
957	1	1	800	15	0	817
958	3	758	19	1	0	781
959	1	769	7	1	0	778
960	3	14	745	3	0	765
961	1	10	17	721	0	749
962	0	1	714	16	0	731
963	676	0	15	4	0	695
964	700	1	2	3	0	706
965	16	687	0	5	0	708
966	691	14	2	2	0	709
967	15	5	0	688	0	708
968	2	2	679	16	0	699
969	653	2	16	3	0	674
970	16	3	679	4	0	702
971	1	689	15	5	0	710
972	705	16	6	2	0	729
973	19	6	1	708	0	734
974	1	5	712	13	0	731
975	693	2	17	3	0	715
976	707	1	4	5	0	717
977	709	0	4	3	0	716
978	26	0	2	685	0	713
979	8	2	1	705	0	716
980	4	4	695	14	0	717
981	6	691	13	4	0	714
982	1	13	4	693	0	711
983	4	1	5	712	0	722
984	4	1	703	15	0	723
985	3	3	704	2	0	712
986	3	3	15	703	0	724
987	693	3	4	19	0	719
988	17	694	3	7	0	721
989	701	15	6	2	0	724
990	19	692	3	4	0	718
991	12	14	693	3	0	722
992	5	4	705	6	0	720
993	678	0	17	8	0	703
994	756	3	5	8	0	772
995	18	741	4	7	0	770
996	3	19	724	7	0	753
997	4	4	17	731	0	756
998	6	4	4	736	0	750
999	1	727	6	22	0	756
1000	3	17	11	733	0	764
1001	2	3	730	23	0	758
1002	726	2	17	7	0	752
1003	741	7	2	1	0	751
1004	727	5	3	2	0	737
1005	729	7	8	0	0	744
1006	22	2	708	2	0	734
1007	702	0	22	4	0	728
1008	25	1	705	0	0	731
1009	10	698	19	1	0	728
1010	4	21	8	713	0	746
1011	710	8	6	19	0	743
1012	23	0	4	741	0	768
1013	3	5	737	28	0	773
1014	721	3	25	6	0	755
1015	756	2	3	6	0	767
1016	28	1	5	736	0	770
1017	9	1	4	759	0	773
1018	12	1	733	22	0	768
1019	8	733	20	6	0	767
1020	715	19	5	1	0	740
1021	23	2	689	1	0	715
1022	658	0	19	1	0	678
1023	21	664	1	1	0	687
1024	658	20	3	2	0	683
1025	21	638	3	4	0	666
1026	3	652	5	4	0	664
1027	4	24	0	633	0	661
1028	3	4	1	650	0	658
1029	4	2	1	649	0	656
1030	3	3	1	650	0	657
1031	1	4	625	23	0	653
1032	622	1	22	4	0	649
1033	654	1	1	2	0	658
1034	651	1	3	5	0	660
1035	25	4	2	629	0	660
1036	6	3	4	644	0	657
1037	628	1	4	25	0	658
1038	644	1	2	4	0	651
1039	642	7	2	2	0	653
1040	25	1	2	607	0	635
1041	6	5	3	602	0	616
1042	5	3	570	19	0	597
1043	5	2	572	4	0	583
1044	3	560	17	6	0	586
1045	471	17	8	11	0	507
1046	478	4	5	5	0	492
1047	477	0	2	4	0	483
1048	15	2	481	4	0	502
1049	469	4	14	3	0	490
1050	486	1	2	6	0	495
1051	496	0	0	5	0	501
1052	18	0	1	476	0	495
1053	4	2	5	481	0	492
1054	7	0	2	477	0	486
1055	8	0	429	12	0	449
1056	415	1	7	4	0	427
1057	11	427	0	6	0	444
1058	387	7	2	5	0	401
1059	10	372	1	7	0	390
1060	6	368	2	1	0	377
1061	6	8	6	370	0	390
1062	7	1	3	372	0	383
1063	4	360	0	10	0	374
1064	364	8	1	4	0	377
1065	367	2	3	3	0	375
1066	11	2	1	355	0	369
1067	4	1	352	12	0	369
1068	3	0	350	3	0	356
1069	5	0	357	3	0	365
1070	2	3	341	5	0	351
1071	307	1	24	2	0	334
1072	302	2	0	3	0	307
1073	10	2	1	295	0	308
1074	4	0	288	9	0	301
1075	2	1	6	308	0	317
1076	1	307	0	10	0	318
1077	4	342	0	2	0	348
1078	337	8	2	0	0	347
1079	345	1	0	2	0	348
1080	344	1	1	4	0	350
1081	9	1	1	335	0	346
1082	1	2	3	343	0	349
1083	2	0	3	339	0	344
1084	3	1	0	341	0	345
1085	4	0	331	8	0	343
1086	2	1	9	330	0	342
1087	348	0	3	8	0	359
1088	9	0	3	348	0	360
1089	2	0	2	359	0	363
1090	3	7	2	350	0	362
1091	3	356	1	9	0	369
1092	2	351	2	2	0	357
1093	2	358	2	1	0	363
1094	1	6	0	293	0	300
1095	2	3	0	295	0	300
1096	294	1	0	9	0	304
1097	300	0	1	3	0	304
1098	307	0	1	1	0	309
1099	9	0	1	295	0	305
1100	3	1	0	297	0	301
1101	1	301	0	8	0	310
1102	0	312	0	4	0	316
1103	304	7	0	2	0	313
1104	5	3	1	307	0	316
1105	308	1	0	7	0	316
1106	322	1	0	3	0	326
1107	7	0	0	317	0	324
1108	2	332	1	6	0	341
1109	333	4	0	2	0	339
1110	337	2	0	1	0	340
1111	8	0	339	1	0	348
1112	310	0	3	1	0	314
1113	4	310	2	1	0	317
1114	3	4	0	326	0	333
1115	378	3	0	6	0	387
1116	6	1	0	383	0	390
1117	2	0	0	390	0	392
1118	1	387	0	6	0	394
1119	390	6	0	2	0	398
1120	396	2	0	1	0	399
1121	9	384	1	0	0	394
1122	2	419	0	0	0	421
1123	418	7	2	0	0	427
1124	419	2	0	1	0	422
1125	7	0	408	0	0	415
1126	2	0	391	0	0	393
1127	0	0	440	0	0	440
1128	0	0	7	441	0	448
1129	0	0	2	458	0	460
1130	0	0	443	6	0	449
1131	440	0	5	3	0	448
1132	462	0	2	0	0	464
1133	465	0	0	0	0	465
1134	462	0	0	0	0	462
1135	7	0	517	0	0	524
1136	530	0	5	0	0	535
1137	551	0	2	1	0	554
1138	565	0	0	0	0	565
1139	560	0	0	1	0	561
1140	560	0	0	0	0	560
1141	6	0	573	0	0	579
1142	2	567	5	0	0	574
1143	1	5	2	574	0	582
1144	1	2	0	589	0	592
1145	1	0	582	7	0	590
1146	553	0	4	3	0	560
1147	5	0	2	576	0	583
1148	2	1	584	5	0	592
1149	0	0	575	2	0	577
1150	0	606	7	0	0	613
1151	1	5	2	636	0	644
1152	1	2	0	641	0	644
1153	2	0	0	649	0	651
1154	648	0	0	8	0	656
1155	5	0	0	645	0	650
1156	2	0	641	5	0	648
1157	0	1	603	2	0	606
1158	0	0	687	0	0	687
1159	2	0	7	711	0	720
1160	729	0	2	6	0	737
1161	5	0	719	2	0	726
1162	722	0	5	0	0	727
1163	820	2	2	5	0	829
1164	8	0	0	839	0	847
1165	4	1	0	846	0	851
1166	0	868	0	7	0	875
1167	0	7	868	2	0	877
1168	876	2	7	2	0	887
1169	8	0	2	919	0	929
1170	2	919	1	6	0	928
1171	1	6	0	936	0	943
1172	0	2	939	6	0	947
1173	1	0	6	929	0	936
1174	0	924	2	10	0	936
1175	0	6	0	924	0	930
1176	938	0	0	6	0	944
1177	7	0	0	917	0	924
1178	2	904	0	6	0	912
1179	0	922	1	2	0	925
1180	925	7	0	2	0	934
1181	6	3	934	0	0	943
1182	4	0	7	924	0	935
1183	0	0	2	968	0	970
1184	0	0	984	10	0	994
1185	0	992	9	2	0	1003
1186	2	10	986	0	0	998
1187	0	1	7	979	0	987
1188	0	1006	2	7	0	1015
1189	1031	7	0	4	0	1042
1190	8	1031	0	2	0	1041
1191	0	1047	0	2	0	1049
1192	1069	8	0	2	0	1079
1193	1114	0	0	5	0	1119
1194	1147	0	0	4	0	1151
1195	8	0	0	1153	0	1161
1196	0	0	1149	6	0	1155
1197	1180	0	6	5	0	1191
1198	1242	0	0	3	0	1245
1199	12	0	0	1277	0	1289
1200	1	0	1283	11	0	1295
1201	0	1267	11	1	0	1279
1202	1292	11	1	3	0	1307
1203	1360	0	0	8	0	1368
1204	10	1370	1	0	0	1381
1205	1	1408	1	0	0	1410
1206	1416	12	0	3	0	1431
1207	1426	1	0	3	0	1430
1208	1403	0	2	2	0	1407
1209	11	0	0	1395	0	1406
1210	1	2	1431	11	0	1445
1211	1	2	11	1405	0	1419
1212	2	1	1430	11	0	1444
1213	0	1406	11	2	0	1419
1214	0	1428	1	1	0	1430
1215	1	10	0	1375	0	1386
1216	0	0	1	1395	0	1396
1217	4	0	0	1371	0	1375
1218	0	1375	0	11	0	1386
1219	1385	10	0	3	0	1398
1220	1369	1	0	5	0	1375
1221	10	1399	2	0	0	1411
1222	2	9	0	1385	0	1396
1223	0	1396	0	9	0	1405
1224	0	8	0	1397	0	1405
1225	1	1392	0	10	0	1403
1226	1418	7	0	4	0	1429
1227	10	2	0	1386	0	1398
1228	1	1	1395	9	0	1406
1229	1369	0	8	4	0	1381
1230	1387	0	2	3	0	1392
1231	10	0	1382	1	0	1393
1232	3	0	8	1387	0	1398
1233	0	0	1401	10	0	1411
1234	0	2	9	1405	0	1416
1235	2	0	1362	9	0	1373
1236	1304	0	10	5	0	1319
1237	10	1	1	1331	0	1343
1238	2	1337	0	8	0	1347
1239	1372	10	1	4	0	1387
1240	10	3	0	1385	0	1398
1241	2	0	1	1371	0	1374
1242	1	1	1362	11	0	1375
1243	4	1	9	1426	0	1440
1244	1	1	1475	11	0	1488
1245	0	4	1515	4	0	1523
1246	2	1	18	1577	0	1598
1247	2	0	1692	15	0	1709
1248	1738	0	17	9	0	1764
1249	1972	1	5	4	0	1982
1250	2083	1	0	7	0	2091
1251	27	2163	3	0	0	2193
1252	12	24	1	2209	0	2246
1253	10	9	1	2165	0	2185
1254	4	2220	2	32	0	2258
1255	2222	31	2	10	0	2265
1256	33	8	0	2213	0	2254
1257	9	4	2248	32	0	2293
1258	5	11	2167	8	0	2191
1259	7	2169	30	7	0	2213
1260	2177	29	8	10	0	2224
1261	30	8	2176	1	0	2215
1262	2089	4	27	9	0	2129
1263	28	2044	6	6	0	2084
1264	14	24	2059	5	0	2102
1265	4	8	2054	1	0	2067
1266	11	7	2088	3	0	2109
1267	8	2046	31	4	0	2089
1268	7	23	2033	10	0	2073
1269	2021	9	38	4	0	2072
1270	38	4	15	1983	0	2040
1271	18	11	6	2057	0	2092
1272	10	5	10	2058	0	2083
1273	15	6	5	2069	0	2095
1274	5	5	2056	46	0	2112
1275	8	5	25	2064	0	2102
1276	8	4	12	2066	0	2090
1277	2018	4	8	45	0	2075
1278	2063	3	9	17	0	2092
1279	2011	5	8	20	0	2044
1280	37	6	2012	13	0	2068
1281	19	2043	24	6	0	2092
1282	12	2092	11	7	0	2122
1283	2005	30	7	11	0	2053
1284	28	2038	9	10	0	2085
1285	18	36	5	2024	0	2083
1286	10	17	10	2051	0	2088
1287	11	7	2014	37	0	2069
1288	3	1991	35	24	0	2053
1289	6	30	1991	10	0	2037
1290	1950	13	31	13	0	2007
1291	1991	6	16	9	0	2022
1292	33	6	9	1960	0	2008
1293	15	6	7	1938	0	1966
1294	15	4	5	1918	0	1942
1295	16	5	7	1909	0	1937
1296	5	3	1902	47	0	1957
1297	14	4	28	1858	0	1904
1298	7	3	1855	41	0	1906
1299	14	3	1797	20	0	1834
1300	7	1799	37	11	0	1854
1301	1808	23	14	18	0	1863
1302	26	1843	12	11	0	1892
1303	14	29	9	1775	0	1827
1304	4	21	1818	33	0	1876
1305	1786	6	32	19	0	1843
1306	30	12	1793	12	0	1847
1307	1791	4	34	16	0	1845
1308	1818	6	19	8	0	1851
1309	45	4	9	1855	0	1913
1310	16	3	15	1832	0	1866
1311	18	5	12	1833	0	1868
1312	20	11	1774	38	0	1843
1313	1772	4	31	26	0	1833
1314	33	1764	16	19	0	1832
1315	19	31	12	1787	0	1849
1316	1770	15	16	44	0	1845
1317	1799	9	9	26	0	1843
1318	1799	15	9	14	0	1837
1319	54	4	1753	20	0	1831
1320	1795	11	34	17	0	1857
1321	1797	12	19	19	0	1847
1322	46	11	1650	22	0	1729
1323	29	8	1783	16	0	1836
1324	26	13	45	1776	0	1860
1325	25	4	1804	40	0	1873
1326	11	1724	49	24	0	1808
1327	17	1788	32	12	0	1849
1328	1752	34	23	15	0	1824
1329	42	1780	25	9	0	1856
1330	25	41	18	1777	0	1861
1331	1737	23	15	39	0	1814
1332	43	1792	18	17	0	1870
1333	18	39	14	1779	0	1850
1334	9	19	22	1803	0	1853
1335	16	10	1776	44	0	1846
1336	16	16	39	1780	0	1851
1337	14	8	1767	49	0	1838
1338	19	6	1744	27	0	1796
1339	25	5	43	1722	0	1795
1340	20	2	18	1747	0	1787
1341	1695	2	21	60	0	1778
1342	38	1803	14	38	0	1893
1343	24	34	15	1755	0	1828
1344	17	37	12	1733	0	1799
1345	1644	15	9	48	0	1716
1346	35	1586	6	39	0	1666
1347	19	1470	5	19	0	1513
1348	18	1380	5	12	0	1415
1349	11	1194	11	4	0	1220
1350	960	31	40	4	0	1035
1351	929	11	9	3	0	952
1352	896	7	0	0	0	903
1353	896	1	1	3	0	901
1354	24	0	1	880	0	905
1355	12	1	874	14	0	901
1356	7	856	11	8	0	882
1357	2	13	5	852	0	872
1358	0	7	853	12	0	872
1359	4	7	14	834	0	859
1360	3	1	5	841	0	850
1361	2	0	839	19	0	860
1362	4	2	12	846	0	864
1363	2	4	7	804	0	817
1364	840	0	7	23	0	870
1365	818	2	1	13	0	834
1366	817	1	2	7	0	827
1367	823	2	0	3	0	828
1368	27	2	2	796	0	827
1369	11	3	1	808	0	823
1370	7	2	0	809	0	818
1371	794	1	2	28	0	825
1372	17	3	1	809	0	830
1373	9	1	1	808	0	819
1374	8	2	771	24	0	805
1375	5	0	16	774	0	795
1376	6	762	6	21	0	795
1377	5	788	5	8	0	806
1378	746	22	2	11	0	781
1379	16	10	754	5	0	785
1380	8	724	14	3	0	749
1381	716	17	6	1	0	740
1382	16	5	6	713	0	740
1383	7	7	713	19	0	746
1384	15	1	16	709	0	741
1385	5	724	7	25	0	761
1386	720	16	11	6	0	753
1387	17	732	2	9	0	760
1388	732	22	2	6	0	762
1389	745	6	4	4	0	759
1390	22	11	0	734	0	767
1391	17	2	1	723	0	743
1392	12	715	2	26	0	755
1393	715	15	1	21	0	752
1394	17	3	714	13	0	747
1395	697	9	12	3	0	721
1396	698	2	4	7	0	711
1397	18	3	677	4	0	702
1398	15	5	14	629	0	663
1399	643	1	5	17	0	666
1400	12	1	638	10	0	661
1401	8	2	603	10	0	623
1402	577	3	14	4	0	598
1403	13	570	12	7	0	602
1404	7	525	9	2	0	543
1405	10	14	5	518	0	547
1406	5	11	518	9	0	543
1407	500	7	9	13	0	529
1408	9	5	512	8	0	534
1409	4	466	13	3	0	486
1410	467	12	2	0	0	481
1411	11	3	6	464	0	484
1412	460	7	1	14	0	482
1413	16	2	461	3	0	482
1414	3	4	8	459	0	474
1415	7	464	3	9	0	483
1416	4	9	6	451	0	470
1417	2	12	3	457	0	474
1418	7	6	459	11	0	483
1419	5	451	8	9	0	473
1420	8	447	3	8	0	466
1421	4	10	431	4	0	449
1422	413	5	10	4	0	432
1423	417	6	4	3	0	430
1424	9	4	8	402	0	423
1425	398	0	2	12	0	412
1426	14	378	4	2	0	398
1427	6	393	1	9	0	409
1428	403	8	1	6	0	418
1429	12	6	3	397	0	418
1430	402	6	1	11	0	420
1431	409	2	4	5	0	420
1432	16	1	0	388	0	405
1433	12	1	382	8	0	403
1434	379	2	8	4	0	393
1435	385	0	3	6	0	394
1436	10	0	7	372	0	389
1437	9	378	1	11	0	399
1438	8	10	0	378	0	396
1439	3	3	380	14	0	400
1440	1	6	387	7	0	401
1441	2	384	10	9	0	405
1442	7	7	5	252	0	271
1443	0	0	4	249	0	253
1444	0	0	244	4	0	248
1445	238	1	4	1	0	244
1446	248	0	1	2	0	251
1447	257	0	1	1	0	259
1448	257	0	1	0	0	258
1449	7	251	0	0	0	258
1450	3	265	0	0	0	268
1451	267	5	0	0	0	272
1452	6	1	0	267	0	274
1453	2	2	0	273	0	277
1454	1	273	0	6	0	280
1455	1	5	0	270	0	276
1456	0	1	0	268	0	269
1457	0	261	0	7	0	268
1458	0	6	259	2	0	267
1459	0	1	5	263	0	269
1460	264	1	1	6	0	272
1461	260	1	1	1	0	263
1462	7	0	255	1	0	263
1463	2	0	247	2	0	251
1464	3	1	244	0	0	248
1465	2	0	5	247	0	254
1466	0	0	242	4	0	246
1467	0	0	254	1	0	255
1468	3	3	4	244	0	254
1469	1	250	2	3	0	256
1470	0	2	255	2	0	259
1471	0	255	3	1	0	259
1472	244	3	0	2	0	249
1473	2	249	2	0	0	253
1474	1	3	1	241	0	246
1475	244	3	0	2	0	249
1476	4	0	0	250	0	254
1477	2	1	0	254	0	257
1478	2	0	256	4	0	262
1479	2	246	2	2	0	252
1480	1	262	0	2	0	265
1481	2	3	0	247	0	252
1482	1	1	0	247	0	249
1483	0	1	0	239	0	240
1484	0	2	230	3	0	235
1485	1	1	219	2	0	223
1486	211	0	1	3	0	215
1487	2	1	217	1	0	221
1488	1	1	215	0	0	217
1489	0	215	3	2	0	220
1490	1	2	1	219	0	223
1491	1	2	227	2	0	232
1492	1	0	4	225	0	230
1493	0	0	227	3	0	230
1494	1	0	3	229	0	233
1495	1	0	250	3	0	254
1496	0	0	4	249	0	253
1497	0	0	3	252	0	255
1498	0	265	1	3	0	269
1499	0	3	0	273	0	276
1500	0	276	2	2	0	280
1501	0	3	1	276	0	280
1502	0	1	0	279	0	280
1503	276	2	0	3	0	281
1504	2	0	1	275	0	278
1505	2	1	275	2	0	280
1506	1	0	2	268	0	271
1507	0	1	0	271	0	272
1508	0	0	268	4	0	272
1509	1	1	256	1	0	259
1510	0	1	3	261	0	265
1511	0	0	0	267	0	267
1512	0	0	265	4	0	269
1513	0	260	3	2	0	265
1514	1	272	1	0	0	274
1515	265	3	1	2	0	271
1516	3	3	0	273	0	279
1517	275	1	1	3	0	280
1518	263	0	2	2	0	267
1519	3	265	0	3	0	271
1520	270	3	0	2	0	275
1521	272	1	3	0	0	276
1522	2	0	262	2	0	266
1523	2	3	2	267	0	274
1524	1	0	268	4	0	273
1525	0	0	4	274	0	278
1526	0	0	268	4	0	272
1527	0	262	5	2	0	269
1528	0	260	0	3	0	263
1529	0	3	1	253	0	257
1530	242	2	1	3	0	248
1531	2	0	0	249	0	251
1532	1	1	0	246	0	248
1533	1	0	245	2	0	248
1534	0	1	242	2	0	245
1535	2	1	244	1	0	248
1536	0	1	4	247	0	252
1537	0	0	1	244	0	245
1538	1	248	1	4	0	254
1539	0	258	0	2	0	260
1540	251	4	0	3	0	258
1541	2	256	1	1	0	260
1542	0	3	240	0	0	243
1543	0	1	3	243	0	247
1544	0	1	246	3	0	250
1545	1	251	2	1	0	255
1546	0	4	0	251	0	255
1547	243	0	1	2	0	246
1548	2	0	247	0	0	249
1549	1	232	1	0	0	234
1550	2	1	229	0	0	232
1551	0	228	1	0	0	229
1552	0	1	4	221	0	226
1553	224	0	0	2	0	226
1554	224	0	0	1	0	225
1555	1	223	0	0	0	224
1556	227	1	0	0	0	228
1557	1	0	0	230	0	231
1558	229	0	0	1	0	230
1559	1	0	234	0	0	235
1560	0	0	241	0	0	241
1561	0	0	1	242	0	243
1562	0	0	0	249	0	249
1563	0	0	248	1	0	249
1564	0	0	1	242	0	243
1565	248	0	0	1	0	249
1566	248	0	0	0	0	248
1567	2	237	0	0	0	239
1568	0	238	0	0	0	238
1569	235	1	1	0	0	237
1570	1	0	0	230	0	231
1571	225	1	1	1	0	228
1572	1	232	0	0	0	233
1573	232	2	0	1	0	235
1574	2	0	235	0	0	237
1575	0	0	239	1	0	240
1576	0	1	1	236	0	238
1577	0	1	231	1	0	233
1578	0	0	1	229	0	230
1579	1	0	0	225	0	226
1580	1	0	229	1	0	231
1581	1	1	1	232	0	235
1582	1	1	1	261	0	264
1583	1	1	269	2	0	273
1584	0	0	268	2	0	270
1585	264	0	2	0	0	266
1586	3	0	274	0	0	277
1587	294	1	3	1	0	299
1588	316	0	0	1	0	317
1589	3	1	310	3	0	317
1590	1	0	312	0	0	313
1591	0	0	4	307	0	311
1592	1	0	1	309	0	311
1593	1	305	1	3	0	310
1594	0	310	1	4	0	315
1595	0	4	296	0	0	300
1596	300	1	3	2	0	306
1597	305	1	0	1	0	307
1598	6	1	285	0	0	292
1599	1	1	288	0	0	290
1600	3	1	3	273	0	280
1601	1	288	2	1	0	292
1602	1	3	2	295	0	301
1603	1	0	0	305	0	306
1604	299	2	1	3	0	305
1605	305	0	0	2	0	307
1606	4	0	1	302	0	307
1607	1	0	300	3	0	304
1608	293	0	2	2	0	297
1609	2	305	1	2	0	310
1610	303	3	2	2	0	310
1611	304	0	0	1	0	305
1612	3	302	1	0	0	306
1613	1	306	1	1	0	309
1614	2	3	0	303	0	308
1615	1	1	1	300	0	303
1616	0	297	2	2	0	301
1617	3	3	1	298	0	305
1618	0	0	1	306	0	307
1619	1	0	295	4	0	300
1620	297	1	3	3	0	304
1621	301	1	1	1	0	304
1622	303	0	4	1	0	308
1623	5	0	0	302	0	307
1624	295	0	0	3	0	298
1625	4	295	2	0	0	301
1626	1	8	1	286	0	296
1627	1	282	2	3	0	288
1628	2	306	0	3	0	311
1629	307	3	1	3	0	314
1630	305	0	2	1	0	308
1631	303	0	1	2	0	306
1632	301	0	0	4	0	305
1633	300	1	0	1	0	302
1634	4	0	301	1	0	306
1635	292	0	2	2	0	296
1636	4	1	298	0	0	303
1637	290	0	3	0	0	293
1638	305	0	1	1	0	307
1639	294	1	3	0	0	298
1640	3	0	293	2	0	298
1641	1	0	4	292	0	297
1642	1	303	1	4	0	309
1643	313	3	1	1	0	318
1644	310	1	2	3	0	316
1645	3	312	1	2	0	318
1646	320	2	0	1	0	323
1647	3	0	2	308	0	313
1648	0	316	3	2	0	321
1649	321	2	1	1	0	325
1650	326	0	1	2	0	329
1651	3	3	0	323	0	329
1652	323	1	0	2	0	326
1653	3	0	2	321	0	326
1654	2	0	1	321	0	324
1655	3	0	320	3	0	326
1656	0	0	3	314	0	317
1657	0	1	2	318	0	321
1658	1	1	321	3	0	326
1659	0	2	308	1	0	311
1660	2	0	1	307	0	310
1661	1	0	310	3	0	314
1662	294	1	4	2	0	301
1663	2	322	1	1	0	326
1664	1	2	1	323	0	327
1665	1	1	1	331	0	334
1666	2	1	0	328	0	331
1667	331	0	0	5	0	336
1668	334	0	0	2	0	336
1669	339	0	2	1	0	342
1670	4	336	0	1	0	341
1671	1	3	1	343	0	348
1672	3	0	0	341	0	344
1673	337	2	0	4	0	343
1674	329	1	0	2	0	332
1675	2	0	0	330	0	332
1676	1	0	324	5	0	330
1677	328	0	3	0	0	331
1678	337	0	0	3	0	340
1679	3	0	334	0	0	337
1680	315	0	3	0	0	318
1681	3	0	343	1	0	347
1682	324	2	2	1	0	329
1683	2	4	0	334	0	340
1684	0	348	1	1	0	350
1685	1	1	378	0	0	380
1686	0	371	2	1	0	374
1687	0	341	0	0	0	341
1688	353	4	6	4	0	367
1689	2	1	0	357	0	360
1690	0	0	0	350	0	350
1691	374	0	0	2	0	376
1692	1	1	0	376	0	378
1693	1	0	0	378	0	379
1694	0	0	0	378	0	378
1695	0	0	0	384	0	384
1696	2	0	375	1	0	378
1697	0	0	365	1	0	366
1698	0	378	1	2	0	381
1699	382	1	0	1	0	384
1700	3	0	0	384	0	387
1701	1	383	1	1	0	386
1702	0	2	1	404	0	407
1703	1	0	0	409	0	410
1704	1	0	0	397	0	398
1705	0	1	0	411	0	412
1706	1	1	0	415	0	417
1707	1	412	0	2	0	415
1708	0	1	0	417	0	418
1709	1	0	410	2	0	413
1710	0	410	1	2	0	413
1711	0	1	0	418	0	419
1712	0	1	1	414	0	416
1713	0	405	0	3	0	408
1714	0	418	0	0	0	418
1715	420	2	1	1	0	424
1716	1	414	1	1	0	417
1717	418	1	0	4	0	423
1718	421	0	1	0	0	422
1719	2	1	451	0	0	454
1720	3	1	1	439	0	444
1721	0	1	460	2	0	463
1722	0	475	0	1	0	476
1723	3	2	1	450	0	456
1724	1	0	1	485	0	487
1725	3	0	0	496	0	499
1726	1	0	1	495	0	497
1727	0	2	513	1	0	516
1728	0	0	1	507	0	508
1729	1	0	517	3	0	521
1730	1	0	525	1	0	527
1731	525	0	1	2	0	528
1732	548	0	1	1	0	550
1733	548	0	0	2	0	550
1734	2	541	2	0	0	545
1735	1	1	1	548	0	551
1736	1	0	574	1	0	576
1737	2	0	1	567	0	570
1738	1	0	591	1	0	593
1739	596	1	1	0	0	598
1740	596	0	1	1	0	598
1741	592	0	1	1	0	594
1742	1	0	581	1	0	583
1743	1	0	578	0	0	579
1744	4	0	1	600	0	605
1745	3	0	0	590	0	593
1746	3	0	0	610	0	613
1747	0	0	612	1	0	613
1748	0	0	574	0	0	574
1749	608	0	1	3	0	612
1750	1	0	0	649	0	650
1751	0	0	0	652	0	652
1752	674	0	1	1	0	676
1753	1	0	1	675	0	677
1754	711	0	0	6	0	717
1755	747	0	0	3	0	750
1756	752	0	0	5	0	757
1757	2	0	769	0	0	771
1758	0	751	1	5	0	757
1759	789	1	0	2	0	792
1760	2	0	0	786	0	788
1761	1	0	0	777	0	778
1762	0	794	0	1	0	795
1763	796	2	0	2	0	800
1764	810	0	0	3	0	813
1765	814	0	0	2	0	816
1766	0	822	0	1	0	823
1767	879	2	0	2	0	883
1768	886	0	0	0	0	886
1769	888	0	0	0	0	888
1770	3	0	0	880	0	883
1771	1	1	0	889	0	891
1772	1	0	928	1	0	930
1773	2	0	1	904	0	907
1774	2	0	0	918	0	920
1775	0	0	919	2	0	921
1776	903	0	1	2	0	906
1777	928	0	0	3	0	931
1778	1	0	0	925	0	926
1779	0	923	0	3	0	926
1780	0	929	0	0	0	929
1781	2	1	1	919	0	923
1782	1	5	905	1	0	912
1783	4	2	1	887	0	894
1784	2	0	919	1	0	922
1785	1	0	938	0	0	939
1786	0	0	0	985	0	985
1787	995	0	0	1	0	996
1788	961	1	0	0	0	962
1789	1	0	0	989	0	990
1790	0	0	0	999	0	999
1791	1	0	0	1005	0	1006
1792	0	0	0	1000	0	1000
1793	1018	0	0	3	0	1021
1794	1012	0	1	0	0	1013
1795	1002	0	0	2	0	1004
1796	0	0	1005	0	0	1005
1797	1	0	0	1011	0	1012
1798	0	0	0	1029	0	1029
1799	1030	0	0	1	0	1031
1800	0	1024	2	0	0	1026
1801	1036	0	0	1	0	1037
1802	1034	0	0	0	0	1034
1803	1030	0	1	1	0	1032
1804	1031	0	0	0	0	1031
1805	4	0	1055	0	0	1059
1806	1	3	1004	0	0	1008
1807	1102	0	3	4	0	1109
1808	1117	0	0	0	0	1117
1809	1118	0	0	2	0	1120
1810	1129	0	0	2	0	1131
1811	1	0	1192	0	0	1193
1812	2	1230	6	2	0	1240
1813	1	7	3	1335	0	1346
1814	1427	3	0	12	0	1442
1815	1445	0	0	7	0	1452
1816	1534	0	0	4	0	1538
1817	1565	0	0	1	0	1566
1818	1589	0	1	0	0	1590
1819	1533	0	0	3	0	1536
1820	20	2	1456	0	0	1478
1821	5	0	1509	2	0	1516
1822	2	2	18	1488	0	1510
1823	1	0	1532	13	0	1546
1824	3	1493	13	6	0	1515
1825	4	1516	5	0	0	1525
1826	4	19	0	1566	0	1589
1827	2	5	1588	13	0	1608
1828	4	0	1532	5	0	1541
1829	1570	1	17	2	0	1590
1830	1696	0	7	1	0	1704
1831	28	1	2	1714	0	1745
1832	1732	1	0	29	0	1762
1833	25	0	4	1742	0	1771
1834	5	1	3	1752	0	1761
1835	0	2	1770	28	0	1800
1836	3	5	1709	8	0	1725
1837	4	2	31	1719	0	1756
1838	0	6	1714	28	0	1748
1839	1648	1	24	13	0	1686
1840	1751	0	6	5	0	1762
1841	36	1743	1	4	0	1784
1842	1758	26	3	2	0	1789
1843	35	5	1720	2	0	1762
1844	1722	0	26	7	0	1755
1845	1774	0	10	4	0	1788
1846	1786	0	7	6	0	1799
1847	37	0	6	1733	0	1776
1848	8	1735	7	26	0	1776
1849	1748	27	6	14	0	1795
1850	1762	7	4	4	0	1777
1851	42	6	2	1761	0	1811
1852	1758	0	4	31	0	1793
1853	30	1803	9	11	0	1853
1854	14	30	5	1792	0	1841
1855	10	10	1776	28	0	1824
1856	1673	1	32	11	0	1717
1857	36	1	1750	8	0	1795
1858	20	3	33	1756	0	1812
1859	10	1727	6	32	0	1775
1860	7	1900	4	14	0	1925
1861	6	34	5	1943	0	1988
1862	12	1914	13	36	0	1975
1863	8	41	5	2455	0	2509
1864	9	10	12	2566	0	2597
1865	14	7	5	2604	0	2630
1866	2519	9	1	78	0	2607
1867	64	8	6	2488	0	2566
1868	25	4	2461	70	0	2560
1869	16	2461	59	21	0	2557
1870	2478	58	14	17	0	2567
1871	76	16	5	2453	0	2550
1872	36	10	7	2475	0	2528
1873	27	7	4	2508	0	2546
1874	14	10	2429	86	0	2539
1875	15	2425	61	33	0	2534
1876	2461	62	20	22	0	2565
1877	67	18	11	2390	0	2486
1878	24	2448	15	70	0	2557
1879	2448	68	8	32	0	2556
1880	69	22	2420	23	0	2534
1881	2426	14	65	20	0	2525
1882	77	17	2439	11	0	2544
1883	35	7	2453	18	0	2513
1884	15	2386	74	27	0	2502
1885	20	66	25	2319	0	2430
1886	22	23	2318	67	0	2430
1887	18	2240	69	31	0	2358
1888	14	69	27	2263	0	2373
1889	16	2259	17	65	0	2357
1890	8	68	2249	38	0	2363
1891	16	28	62	2235	0	2341
1892	16	16	2255	76	0	2363
1893	19	14	69	2234	0	2336
1894	11	12	31	2294	0	2348
1895	12	17	2226	93	0	2348
1896	25	15	71	2231	0	2342
1897	2182	11	27	89	0	2309
1898	61	2181	17	52	0	2311
1899	33	60	2193	29	0	2315
1900	2176	22	73	32	0	2303
1901	74	18	23	2143	0	2258
1902	34	2178	17	69	0	2298
1903	2197	65	16	46	0	2324
1904	2255	28	16	33	0	2332
1905	86	20	16	2150	0	2272
1906	35	16	20	2170	0	2241
1907	31	10	13	2192	0	2246
1908	19	11	13	2182	0	2225
1909	17	2093	17	88	0	2215
1910	26	103	11	2036	0	2176
1911	13	1997	15	82	0	2107
1912	16	2013	14	41	0	2084
1913	15	1930	12	30	0	1987
1914	10	69	1800	34	0	1913
1915	12	1823	57	26	0	1918
1916	1697	69	32	34	0	1832
1917	57	1687	18	30	0	1792
1918	24	65	19	1618	0	1726
1919	17	1697	13	64	0	1791
1920	17	56	13	1694	0	1780
1921	13	31	18	1727	0	1789
1922	16	21	1671	75	0	1783
1923	1626	18	53	35	0	1732
1924	1672	18	15	44	0	1749
1925	1634	22	14	39	0	1709
1926	64	1587	20	29	0	1700
1927	24	53	20	1561	0	1658
1928	30	24	1514	74	0	1642
1929	24	1504	59	32	0	1619
1930	17	60	18	1347	0	1442
1931	25	1409	14	46	0	1494
1932	1393	47	15	29	0	1484
1933	1414	29	18	21	0	1482
1934	1438	22	12	21	0	1493
1935	1420	14	19	20	0	1473
1936	53	24	11	1390	0	1478
1937	26	18	10	1391	0	1445
1938	21	1376	16	56	0	1469
1939	22	48	15	1388	0	1473
1940	19	25	1360	55	0	1459
1941	13	16	41	1365	0	1435
1942	10	20	1344	56	0	1430
1943	8	1325	42	41	0	1416
1944	11	43	1336	30	0	1420
1945	6	22	46	1331	0	1405
1946	15	17	1350	51	0	1433
1947	14	21	49	1338	0	1422
1948	8	15	26	1356	0	1405
1949	16	14	13	1357	0	1400
1950	18	18	16	1348	0	1400
1951	1280	12	16	62	0	1370
1952	45	1292	11	34	0	1382
1953	1229	34	8	34	0	1305
1954	35	20	1188	35	0	1278
1955	1195	14	36	24	0	1269
1956	1228	13	10	26	0	1277
1957	55	8	1188	22	0	1273
1958	30	11	1160	21	0	1222
1959	26	1131	36	23	0	1216
1960	12	1036	15	17	0	1080
1961	29	38	929	14	0	1010
1962	11	814	28	21	0	874
1963	31	31	26	373	0	461
1964	324	2	5	6	0	337
1965	3	3	1	324	0	331
1966	326	0	1	6	0	333
1967	333	3	0	1	0	337
1968	3	334	0	5	0	342
1969	336	3	1	1	0	341
1970	335	2	1	4	0	342
1971	4	1	1	333	0	339
1972	339	1	0	3	0	343
1973	3	352	0	1	0	356
1974	2	2	0	353	0	357
1975	347	0	1	4	0	352
1976	2	2	359	2	0	365
1977	361	0	4	1	0	366
1978	4	1	0	364	0	369
1979	0	1	373	4	0	378
1980	2	0	365	0	0	367
1981	362	6	7	1	0	376
1982	378	0	0	1	0	379
1983	4	0	0	378	0	382
1984	2	0	1	381	0	384
1985	0	0	1	378	0	379
1986	1	384	0	3	0	388
1987	393	2	0	0	0	395
1988	3	388	0	1	0	392
1989	388	4	0	2	0	394
1990	2	0	384	1	0	387
1991	0	1	3	388	0	392
1992	399	0	0	3	0	402
1993	3	1	0	397	0	401
1994	1	0	0	395	0	396
1995	0	374	0	3	0	377
1996	380	3	0	1	0	384
1997	4	403	0	0	0	407
1998	0	3	0	411	0	414
1999	0	0	405	5	0	410
2000	372	1	4	0	0	377
2001	5	0	396	0	0	401
2002	375	1	4	2	0	382
2003	5	400	0	1	0	406
2004	0	5	1	386	0	392
2005	1	387	0	5	0	393
2006	396	5	1	1	0	403
2007	6	0	0	400	0	406
2008	0	1	0	404	0	405
2009	0	0	384	6	0	390
2010	380	1	5	0	0	386
2011	6	0	0	394	0	400
2012	0	0	378	5	0	383
2013	0	369	4	1	0	374
2014	0	4	0	382	0	386
2015	386	0	1	3	0	390
2016	5	0	0	384	0	389
2017	0	0	391	4	0	395
2018	416	1	4	0	0	421
2019	7	1	0	425	0	433
2020	1	0	483	8	0	492
2021	0	0	9	500	0	509
2022	2	0	1	496	0	499
2023	1	499	0	11	0	511
2024	502	10	0	3	0	515
2025	11	499	2	6	0	518
2026	511	11	0	2	0	524
2027	12	0	0	509	0	521
2028	1	509	1	10	0	521
2029	2	12	0	506	0	520
2030	0	1	494	12	0	507
2031	484	0	11	0	0	495
2032	12	0	0	480	0	492
2033	0	1	1	483	0	485
2034	1	0	0	485	0	486
2035	0	0	462	12	0	474
2036	1	0	455	0	0	456
2037	0	453	10	2	0	465
2038	1	11	1	450	0	463
2039	450	1	0	13	0	464
2040	12	444	1	0	0	457
2041	0	12	1	463	0	476
2042	475	1	0	12	0	488
2043	484	0	0	1	0	485
2044	13	474	0	0	0	487
2045	501	13	0	2	0	516
2046	536	0	1	2	0	539
2047	18	1	0	552	0	571
2048	3	547	0	16	0	566
2049	3	16	0	556	0	575
2050	557	0	0	16	0	573
2051	17	1	560	0	0	578
2052	1	1	16	550	0	568
2053	2	2	0	567	0	571
2054	1	0	546	18	0	565
2055	3	0	14	545	0	562
2056	546	1	1	17	0	565
2057	526	0	2	5	0	533
2058	17	0	1	544	0	562
2059	1	0	543	16	0	560
2060	2	2	539	2	0	545
2061	4	523	15	2	0	544
2062	3	544	1	1	0	549
2063	2	14	3	527	0	546
2064	527	1	2	15	0	545
2065	13	521	0	3	0	537
2066	514	16	1	2	0	533
2067	14	1	1	513	0	529
2068	2	1	0	521	0	524
2069	503	1	0	15	0	519
2070	15	504	1	2	0	522
2071	499	14	1	10	0	524
2072	16	1	488	2	0	507
2073	2	3	481	2	0	488
2074	4	2	14	470	0	490
2075	1	1	468	15	0	485
2076	2	0	464	0	0	466
2077	0	1	15	449	0	465
2078	1	0	451	13	0	465
2079	0	0	15	436	0	451
2080	0	0	3	447	0	450
2081	1	1	448	15	0	465
2082	1	1	13	437	0	452
2083	1	1	1	436	0	439
2084	1	423	2	16	0	442
2085	426	14	2	2	0	444
2086	14	1	425	2	0	442
2087	1	1	13	421	0	436
2088	1	2	1	435	0	439
2089	1	1	424	15	0	441
2090	411	0	15	2	0	428
2091	14	422	2	5	0	443
2092	0	12	2	423	0	437
2093	1	0	2	430	0	433
2094	1	413	2	14	0	430
2095	2	14	426	3	0	445
2096	0	435	13	2	0	450
2097	413	15	1	3	0	432
2098	12	1	412	1	0	426
2099	3	2	13	410	0	428
2100	1	2	410	13	0	426
2101	1	1	417	1	0	420
2102	3	409	12	1	0	425
2103	1	10	2	395	0	408
2104	393	1	1	13	0	408
2105	398	1	2	2	0	403
2106	12	398	1	1	0	412
2107	1	12	0	398	0	411
2108	401	2	0	13	0	416
2109	415	1	0	3	0	419
2110	12	401	2	1	0	416
2111	405	10	2	3	0	420
2112	12	0	1	403	0	416
2113	2	405	2	11	0	420
2114	4	12	1	412	0	429
2115	2	1	0	420	0	423
2116	5	2	0	412	0	419
2117	2	2	397	13	0	414
2118	0	3	363	5	0	371
2119	0	363	9	4	0	376
2120	303	2	1	1	0	307
2121	4	284	2	1	0	291
2122	1	6	2	280	0	289
2123	3	1	296	4	0	304
2124	1	3	6	294	0	304
2125	1	2	0	296	0	299
2126	0	1	1	298	0	300
2127	292	0	1	8	0	301
2128	5	0	1	290	0	296
2129	0	1	312	7	0	320
2130	297	0	5	3	0	305
2131	312	1	1	2	0	316
2132	316	0	2	1	0	319
2133	314	1	1	3	0	319
2134	315	0	2	0	0	317
2135	7	311	2	0	0	320
2136	3	3	0	305	0	311
2137	3	306	1	6	0	316
2138	311	5	0	2	0	318
2139	302	1	0	3	0	306
2140	302	1	1	2	0	306
2141	5	287	1	1	0	294
2142	2	277	1	1	0	281
2143	2	285	0	0	0	287
2144	4	4	278	0	0	286
2145	2	23	8	222	0	255
2146	1	201	3	1	0	206
2147	0	191	0	1	0	192
2148	1	0	0	192	0	193
2149	1	0	0	192	0	193
2150	0	1	197	0	0	198
2151	197	0	0	2	0	199
2152	0	0	0	206	0	206
2153	0	0	1	201	0	202
2154	1	0	199	0	0	200
2155	0	0	197	2	0	199
2156	0	204	1	1	0	206
2157	0	0	1	204	0	205
2158	0	1	0	203	0	204
2159	0	1	204	1	0	206
2160	192	0	0	1	0	193
2161	209	0	0	1	0	210
2162	1	1	215	0	0	217
2163	216	0	0	1	0	217
2164	2	0	221	1	0	224
2165	221	0	2	1	0	224
2166	231	0	1	0	0	232
2167	1	1	239	0	0	241
2168	1	0	0	240	0	241
2169	1	1	0	243	0	245
2170	0	0	2	256	0	258
2171	257	0	0	2	0	259
2172	257	0	0	2	0	259
2173	0	0	268	1	0	269
2174	2	0	268	0	0	270
2175	276	1	1	0	0	278
2176	282	0	1	0	0	283
2177	1	1	272	0	0	274
2178	1	0	277	1	0	279
2179	1	0	0	287	0	288
2180	0	0	292	2	0	294
2181	0	0	1	279	0	280
2182	287	0	0	2	0	289
2183	2	0	311	0	0	313
2184	308	0	2	2	0	312
2185	2	0	353	0	0	355
2186	4	0	3	353	0	360
2187	3	0	0	366	0	369
2188	1	0	2	366	0	369
2189	0	365	1	4	0	370
2190	3	3	0	362	0	368
2191	1	2	1	375	0	379
2192	370	1	0	8	0	379
2193	3	0	367	3	0	373
2194	360	0	4	2	0	366
2195	6	0	363	0	0	369
2196	339	0	5	0	0	344
2197	4	353	3	1	0	361
2198	2	4	348	1	0	355
2199	1	2	348	2	0	353
2200	0	2	5	338	0	345
2201	0	0	2	352	0	354
2202	0	0	349	9	0	358
2203	1	1	343	4	0	349
2204	3	0	376	2	0	381
2205	390	0	7	1	0	398
2206	390	0	3	1	0	394
2207	390	0	4	0	0	394
2208	9	1	0	375	0	385
2209	3	2	2	378	0	385
2210	2	0	411	5	0	418
2211	0	1	4	401	0	406
2212	1	0	3	396	0	400
2213	403	0	3	7	0	413
2214	405	0	3	7	0	415
2215	414	0	3	3	0	420
2216	8	0	3	406	0	417
2217	5	0	1	408	0	414
2218	5	0	2	406	0	413
2219	410	0	1	7	0	418
2220	4	0	0	411	0	415
2221	3	410	1	5	0	419
2222	1	3	3	411	0	418
2223	0	402	1	7	0	410
2224	400	3	1	5	0	409
2225	397	2	1	3	0	403
2226	7	398	1	2	0	408
2227	7	407	0	2	0	416
2228	2	4	1	407	0	414
2229	3	3	388	4	0	398
2230	1	2	4	390	0	397
2231	2	0	402	7	0	411
2232	0	406	3	7	0	416
2233	2	5	2	409	0	418
2234	0	3	2	417	0	422
2235	2	4	436	4	0	446
2236	3	0	3	437	0	443
2237	4	2	444	4	0	454
2238	446	4	5	4	0	459
2239	452	2	3	4	0	461
2240	452	2	4	2	0	460
2241	7	1	2	447	0	457
2242	4	1	2	457	0	464
2243	3	1	480	5	0	489
2244	2	4	8	474	0	488
2245	2	479	3	8	0	492
2246	1	4	480	4	0	489
2247	2	1	470	2	0	475
2248	1	0	7	452	0	460
2249	2	0	479	5	0	486
2250	4	0	472	5	0	481
2251	472	0	8	1	0	481
2252	6	543	3	3	0	555
2253	560	3	2	4	0	569
2254	566	2	1	4	0	573
2255	573	0	4	3	0	580
2256	8	0	0	573	0	581
2257	5	2	1	576	0	584
2258	2	0	588	8	0	598
2259	1	1	5	576	0	583
2260	2	584	2	6	0	594
2261	583	3	3	5	0	594
2262	4	581	2	3	0	590
2263	5	592	1	2	0	600
2264	3	6	1	591	0	601
2265	5	2	593	5	0	605
2266	4	2	3	599	0	608
2267	3	0	606	6	0	615
2268	2	605	3	5	0	615
2269	596	3	0	5	0	604
2270	604	3	3	2	0	612
2271	624	0	0	6	0	630
2272	5	5	665	0	0	675
2273	5	0	649	2	0	656
2274	671	4	6	1	0	682
2275	688	3	2	2	0	695
2276	693	2	1	3	0	699
2277	5	1	2	692	0	700
2278	2	0	1	695	0	698
2279	691	0	3	7	0	701
2280	684	2	1	5	0	692
2281	8	1	723	1	0	733
2282	6	1	700	2	0	709
2283	697	3	2	2	0	704
2284	3	0	723	1	0	727
2285	683	1	2	2	0	688
2286	2	0	701	0	0	703
2287	5	0	0	673	0	678
2288	3	0	729	0	0	732
2289	1	0	0	738	0	739
2290	0	0	0	755	0	755
2291	0	776	0	1	0	777
2292	789	0	0	2	0	791
2293	0	0	806	0	0	806
2294	779	0	0	3	0	782
2295	0	823	0	0	0	823
2296	879	0	0	0	0	879
2297	3	0	0	875	0	878
2298	1	0	0	875	0	876
2299	0	904	0	5	0	909
2300	0	4	0	947	0	951
2301	1	1	0	953	0	955
2302	0	0	0	968	0	968
2303	959	0	0	9	0	968
2304	926	0	0	2	0	928
2305	7	0	919	0	0	926
2306	1	928	4	1	0	934
2307	1	5	1	946	0	953
2308	1	1	0	983	0	985
2309	0	0	983	8	0	991
2310	2	0	7	951	0	960
2311	963	0	3	7	0	973
2312	979	0	0	2	0	981
2313	987	0	0	2	0	989
2314	9	0	0	1003	0	1012
2315	1054	0	0	10	0	1064
2316	1061	0	0	4	0	1065
2317	1071	0	0	3	0	1074
2318	9	0	0	1069	0	1078
2319	3	0	0	1080	0	1083
2320	1	0	0	1087	0	1088
2321	0	0	0	1063	0	1063
2322	1	0	0	1068	0	1069
2323	0	1	1054	10	0	1065
2324	1	0	1054	2	0	1057
2325	0	1054	8	1	0	1063
2326	0	7	2	1071	0	1080
2327	0	1	1	1082	0	1084
2328	0	1	0	1084	0	1085
2329	2	0	1069	10	0	1081
2330	4	0	5	1050	0	1059
2331	0	0	1054	10	0	1064
2332	3	0	9	1048	0	1060
2333	1	0	1108	9	0	1118
2334	1	1100	8	1	0	1110
2335	0	7	0	1096	0	1103
2336	0	1	1088	9	0	1098
2337	1017	1	7	6	0	1031
2338	8	1100	2	3	0	1113
2339	2	8	1	1116	0	1127
2340	1	1120	1	8	0	1130
2341	0	7	0	1108	0	1115
2342	1124	1	0	12	0	1137
2343	9	1	0	1098	0	1108
2344	3	1100	0	10	0	1113
2345	1103	9	0	3	0	1115
2346	9	3	1	1146	0	1159
2347	3	2	0	1163	0	1168
2348	1166	0	1	16	0	1183
2349	12	0	0	1286	0	1298
2350	3	0	0	1598	0	1601
2351	2	1	1655	25	0	1683
2352	0	2	1615	12	0	1629
2353	6	0	33	1621	0	1660
2354	1	0	1646	23	0	1670
2355	5	1	1621	12	0	1639
2356	1567	0	31	9	0	1607
2357	24	1	1659	0	0	1684
2358	10	1644	29	4	0	1687
2359	10	21	11	1657	0	1699
2360	1686	10	6	32	0	1734
2361	1716	6	1	16	0	1739
2362	1703	0	3	6	0	1712
2363	37	1687	3	6	0	1733
2364	20	21	1	1691	0	1733
2365	17	16	2	1700	0	1735
2366	1647	7	3	42	0	1699
2367	1684	1	1	23	0	1709
2368	1690	1	2	9	0	1702
2369	39	1	1689	5	0	1734
2370	20	1682	27	6	0	1735
2371	8	1839	17	8	0	1872
2372	7	40	10	1780	0	1837
2373	7	17	3	1832	0	1859
2374	5	6	1825	39	0	1875
2375	1803	4	37	23	0	1867
2376	1845	2	15	8	0	1870
2377	46	8	12	1820	0	1886
2378	20	6	3	1845	0	1874
2379	15	1	2	1863	0	1881
2380	1821	0	6	55	0	1882
2381	42	0	1769	23	0	1834
2382	24	2	1787	10	0	1823
2383	13	1	46	1755	0	1815
2384	5	3	1756	41	0	1805
2385	1728	5	39	24	0	1796
2386	1746	2	17	14	0	1779
2387	1769	2	10	10	0	1791
2388	51	1670	11	11	0	1743
2389	1695	31	9	8	0	1743
2390	49	15	5	1663	0	1732
2391	27	7	2	1658	0	1694
2392	18	2	2	1688	0	1710
2393	7	2	1614	64	0	1687
2394	13	8	37	1606	0	1664
2395	12	1591	20	45	0	1668
2396	1548	26	13	26	0	1613
2397	30	1578	9	24	0	1641
2398	11	32	1568	19	0	1630
2399	14	1543	40	11	0	1608
2400	1477	34	24	11	0	1546
2401	36	1494	14	4	0	1548
2402	25	38	8	1398	0	1469
2403	17	1473	8	31	0	1529
2404	1473	34	8	21	0	1536
2405	1484	21	5	15	0	1525
2406	1435	10	6	14	0	1465
2407	51	8	1443	13	0	1515
2408	22	6	1426	17	0	1471
2409	18	9	1417	11	0	1455
2410	1404	8	40	14	0	1466
2411	45	8	20	1399	0	1472
2412	27	4	17	1414	0	1462
2413	15	13	1385	42	0	1455
2414	14	9	35	1379	0	1437
2415	1308	9	21	41	0	1379
2416	34	1315	13	27	0	1389
2417	1323	34	9	21	0	1387
2418	42	18	1314	14	0	1388
2419	1330	10	32	11	0	1383
2420	1346	8	17	12	0	1383
2421	1361	7	11	9	0	1388
2422	44	13	1315	12	0	1384
2423	29	5	36	1318	0	1388
2424	21	4	1321	35	0	1381
2425	28	3	36	1318	0	1385
2426	22	5	1319	37	0	1383
2427	16	4	40	1315	0	1375
2428	7	8	27	1340	0	1382
2429	1307	5	12	50	0	1374
2430	1328	6	5	31	0	1370
2431	1349	6	7	20	0	1382
2432	51	4	16	1297	0	1368
2433	26	1195	16	36	0	1273
2434	22	1257	11	24	0	1314
2435	1264	40	5	15	0	1324
2436	39	20	1234	16	0	1309
2437	1250	9	28	15	0	1302
2438	37	9	1237	12	0	1295
2439	1265	10	33	13	0	1321
2440	1214	6	23	15	0	1258
2441	45	7	1246	12	0	1310
2442	1255	6	36	17	0	1314
2443	1263	3	21	13	0	1300
2444	1267	4	15	10	0	1296
2445	63	1227	6	8	0	1304
2446	29	47	13	1174	0	1263
2447	23	15	1198	30	0	1266
2448	24	14	1197	19	0	1254
2449	19	1052	39	9	0	1119
2450	9	734	7	8	0	758
2451	25	15	15	621	0	676
2452	605	4	7	17	0	633
2453	16	621	4	9	0	650
2454	10	11	5	619	0	645
2455	9	635	2	13	0	659
2456	626	15	5	5	0	651
2457	15	4	6	605	0	630
2458	8	5	600	13	0	626
2459	8	580	9	6	0	603
2460	9	577	3	4	0	593
2461	6	15	3	554	0	578
2462	7	576	3	15	0	601
2463	0	13	7	570	0	590
2464	584	4	4	17	0	609
2465	583	6	1	4	0	594
2466	595	5	3	6	0	609
2467	599	3	3	8	0	613
2468	21	2	600	4	0	627
2469	11	574	10	3	0	598
2470	8	569	2	2	0	581
2471	0	457	1	3	0	461
2472	2	446	0	2	0	450
2473	428	7	12	4	0	451
2474	417	2	0	3	0	422
2475	438	0	1	1	0	440
2476	442	0	0	3	0	445
2477	5	0	443	1	0	449
2478	459	0	3	1	0	463
2479	471	0	2	0	0	473
2480	471	0	0	0	0	471
2481	5	0	0	464	0	469
2482	3	0	0	463	0	466
2483	469	0	1	5	0	475
2484	4	1	0	463	0	468
2485	3	459	0	2	0	464
2486	0	4	0	468	0	472
2487	1	3	0	466	0	470
2488	2	481	0	4	0	487
2489	2	3	0	476	0	481
2490	1	2	0	481	0	484
2491	477	0	0	7	0	484
2492	4	0	464	2	0	470
2493	461	0	3	1	0	465
2494	4	0	469	0	0	473
2495	3	0	449	1	0	453
2496	0	1	464	2	0	467
2497	450	1	5	0	0	456
2498	4	0	488	1	0	493
2499	493	0	3	2	0	498
2500	503	1	2	0	0	506
2501	504	0	1	1	0	506
2502	6	499	0	0	0	505
2503	507	4	1	1	0	513
2504	2	516	1	1	0	520
2505	2	3	0	529	0	534
2506	2	2	0	531	0	535
2507	0	526	1	5	0	532
2508	2	526	0	2	0	530
2509	1	552	1	0	0	554
2510	545	5	1	2	0	553
2511	3	553	1	0	0	557
2512	559	3	0	1	0	563
2513	4	2	566	0	0	572
2514	558	0	2	2	0	562
2515	573	0	2	2	0	577
2516	5	1	568	0	0	574
2517	2	1	3	566	0	572
2518	0	2	568	3	0	573
2519	1	1	3	565	0	570
2520	0	1	0	574	0	575
2521	570	0	0	5	0	575
2522	566	1	1	3	0	571
2523	6	560	0	3	0	569
2524	576	4	0	0	0	580
2525	4	3	580	0	0	587
2526	577	1	3	1	0	582
2527	4	0	615	0	0	619
2528	2	0	622	1	0	625
2529	637	0	5	1	0	643
2530	650	0	2	1	0	653
2531	6	0	655	0	0	661
2532	2	1	3	651	0	657
2533	0	0	2	666	0	668
2534	0	0	659	6	0	665
2535	1	0	3	650	0	654
2536	1	640	2	3	0	646
2537	1	3	1	688	0	693
2538	2	3	0	685	0	690
2539	2	0	660	5	0	667
2540	625	0	5	3	0	633
2541	661	0	2	2	0	665
2542	651	0	1	2	0	654
2543	653	0	1	0	0	654
2544	6	645	0	1	0	652
2545	2	4	0	632	0	638
2546	1	2	626	4	0	633
2547	0	0	623	3	0	626
2548	3	0	3	626	0	632
2549	1	2	644	1	0	648
2550	637	0	1	4	0	642
2551	2	0	2	652	0	656
2552	4	0	0	654	0	658
2553	0	1	0	647	0	648
2554	644	0	0	4	0	648
2555	3	641	0	2	0	646
2556	644	2	0	2	0	648
2557	641	2	0	2	0	645
2558	4	622	2	0	0	628
2559	3	637	0	0	0	640
2560	655	3	0	2	0	660
2561	3	2	1	655	0	661
2562	2	0	1	644	0	647
2563	666	0	0	6	0	672
2564	3	2	662	2	0	669
2565	673	0	3	3	0	679
2566	684	0	2	1	0	687
2567	5	692	0	1	0	698
2568	742	4	2	2	0	750
2569	752	1	0	2	0	755
2570	7	839	0	1	0	847
2571	2	850	0	1	0	853
2572	3	12	3	827	0	845
2573	836	1	1	10	0	848
2574	10	877	0	1	0	888
2575	3	11	0	881	0	895
2576	901	2	0	13	0	916
2577	12	0	889	1	0	902
2578	4	0	11	896	0	911
2579	0	1	886	11	0	898
2580	879	1	11	4	0	895
2581	903	1	2	1	0	907
2582	16	0	883	1	0	900
2583	3	884	13	0	0	900
2584	2	11	2	902	0	917
2585	2	1	906	13	0	922
2586	1	0	14	905	0	920
2587	3	0	2	922	0	927
2588	2	4	895	16	0	917
2589	873	1	15	4	0	893
2590	904	2	2	2	0	910
2591	16	0	905	2	0	923
2592	4	913	13	0	0	930
2593	0	16	3	889	0	908
2594	1	899	1	16	0	917
2595	0	922	2	4	0	928
2596	921	16	2	3	0	942
2597	18	3	2	922	0	945
2598	7	0	3	913	0	923
2599	2	1	906	18	0	927
2600	2	1	906	6	0	915
2601	2	2	18	893	0	915
2602	4	2	4	910	0	920
2603	1	2	891	20	0	914
2604	1	2	908	4	0	915
2605	1	1	18	877	0	897
2606	880	0	5	20	0	905
2607	14	877	2	4	0	897
2608	880	16	1	2	0	899
2609	16	878	2	3	0	899
2610	7	897	1	2	0	907
2611	882	17	1	3	0	903
2612	17	4	887	4	0	912
2613	7	3	15	877	0	902
2614	1	2	6	891	0	900
2615	3	1	1	939	0	944
2616	1	5	934	22	0	962
2617	4	2	17	942	0	965
2618	958	2	3	18	0	981
2619	18	1	3	981	0	1003
2620	6	2	2	1002	0	1012
2621	983	3	3	26	0	1015
2622	997	1	2	9	0	1009
2623	24	965	4	5	0	998
2624	4	19	981	4	0	1008
2625	2	5	971	3	0	981
2626	3	1	965	7	0	976
2627	8	916	24	1	0	949
2628	4	20	6	899	0	929
2629	2	7	3	918	0	930
2630	905	4	4	22	0	935
2631	26	1	3	885	0	915
2632	7	2	880	21	0	910
2633	2	4	23	878	0	907
2634	3	2	4	902	0	911
2635	1	0	880	30	0	911
2636	4	863	21	7	0	895
2637	4	20	6	817	0	847
2638	2	856	3	22	0	883
2639	3	19	850	8	0	880
2640	849	3	21	7	0	880
2641	869	0	10	4	0	883
2642	868	3	6	2	0	879
2643	27	2	1	842	0	872
2644	5	853	2	24	0	884
2645	840	23	7	5	0	875
2646	868	7	4	2	0	881
2647	849	2	3	4	0	858
2648	26	3	826	6	0	861
2649	801	3	20	5	0	829
2650	21	808	7	5	0	841
2651	794	22	2	4	0	822
2652	22	810	0	9	0	841
2653	807	21	7	5	0	840
2654	22	4	804	3	0	833
2655	802	2	22	5	0	831
2656	813	2	3	5	0	823
2657	743	5	4	9	0	761
2658	817	3	3	5	0	828
2659	25	3	784	5	0	817
2660	13	2	21	765	0	801
2661	769	5	8	22	0	804
2662	26	762	2	9	0	799
2663	12	19	9	738	0	778
2664	4	6	722	22	0	754
2665	7	8	20	713	0	748
2666	7	1	713	23	0	744
2667	4	694	21	7	0	726
2668	6	626	4	5	0	641
2669	5	619	6	5	0	635
2670	2	21	8	500	0	531
2671	1	4	2	499	0	506
2672	4	1	478	15	0	498
2673	2	457	12	6	0	477
2674	403	11	4	3	0	421
2675	11	395	0	2	0	408
2676	3	384	0	3	0	390
2677	3	12	3	360	0	378
2678	358	1	0	11	0	370
2679	365	1	0	5	0	371
2680	11	1	3	357	0	372
2681	354	4	1	8	0	367
2682	9	2	0	354	0	365
2683	2	4	348	9	0	363
2684	346	2	9	1	0	358
2685	10	0	1	349	0	360
2686	4	0	335	9	0	348
2687	4	0	329	1	0	334
2688	1	1	7	334	0	343
2689	342	2	2	7	0	353
2690	351	1	0	2	0	354
2691	10	341	1	1	0	353
2692	351	6	1	3	0	361
2693	357	0	3	1	0	361
2694	352	0	0	2	0	354
2695	8	358	1	2	0	369
2696	367	6	0	4	0	377
2697	373	3	0	1	0	377
2698	10	0	0	362	0	372
2699	354	1	1	8	0	364
2700	10	345	0	2	0	357
2701	1	360	1	0	0	362
2702	2	7	0	357	0	366
2703	2	1	0	364	0	367
2704	2	365	1	7	0	375
2705	362	6	0	1	0	369
2706	7	357	0	2	0	366
2707	353	7	1	0	0	361
2708	7	357	0	2	0	366
2709	1	7	1	337	0	346
2710	0	347	0	8	0	355
2711	350	6	2	1	0	359
2712	342	1	0	0	0	343
2713	332	0	0	1	0	333
2714	6	1	319	0	0	326
2715	1	0	288	0	0	289
2716	0	257	4	0	0	261
2717	0	5	246	1	0	252
2718	0	1	245	1	0	247
2719	1	0	1	204	0	206
2720	1	0	210	1	0	212
2721	1	222	2	0	0	225
2722	226	2	1	1	0	230
2723	1	219	1	0	0	221
2724	0	227	0	0	0	227
2725	238	2	1	1	0	242
2726	249	0	1	0	0	250
2727	2	257	0	1	0	260
2728	258	2	0	0	0	260
2729	259	1	0	0	0	260
2730	257	0	0	0	0	257
2731	4	1	244	0	0	249
2732	0	1	242	0	0	243
2733	1	0	2	258	0	261
2734	1	0	0	258	0	259
2735	260	1	0	2	0	263
2736	3	252	0	0	0	255
2737	1	2	0	263	0	266
2738	1	0	0	267	0	268
2739	0	0	1	271	0	272
2740	0	0	0	278	0	278
2741	0	0	276	4	0	280
2742	0	1	270	2	0	273
2743	1	0	4	278	0	283
2744	1	0	285	3	0	289
2745	286	0	3	2	0	291
2746	3	0	1	292	0	296
2747	1	0	289	4	0	294
2748	276	0	3	3	0	282
2749	2	286	1	0	0	289
2750	285	2	1	1	0	289
2751	2	301	0	1	0	304
2752	1	2	1	295	0	299
2753	1	1	300	1	0	303
2754	1	0	2	287	0	290
2755	0	0	293	2	0	295
2756	285	0	2	1	0	288
2757	2	1	1	311	0	315
2758	314	0	0	2	0	316
2759	2	0	310	1	0	313
2760	328	0	2	1	0	331
2761	350	0	2	0	0	352
2762	3	0	355	1	0	359
2763	1	0	2	364	0	367
2764	1	0	374	2	0	377
2765	0	370	3	2	0	375
2766	371	2	3	0	0	376
2767	373	1	0	0	0	374
2768	2	0	371	0	0	373
2769	1	0	371	0	0	372
2770	0	0	2	375	0	377
2771	0	0	1	377	0	378
2772	390	0	0	2	0	392
2773	1	394	0	1	0	396
2774	407	1	0	0	0	408
2775	407	1	0	0	0	408
2776	1	0	400	0	0	401
2777	395	0	1	0	0	396
2778	2	0	413	0	0	415
2779	1	0	1	423	0	425
2780	0	1	454	2	0	457
2781	1	0	1	451	0	453
2782	0	1	453	1	0	455
2783	443	0	1	2	0	446
2784	449	0	1	1	0	451
2785	3	0	0	450	0	453
2786	465	0	0	2	0	467
2787	1	0	1	493	0	495
2788	1	505	1	1	0	508
2789	507	1	0	1	0	509
2790	1	504	1	0	0	506
2791	3	1	0	513	0	517
2792	0	1	0	493	0	494
2793	2	0	1	488	0	491
2794	3	2	0	482	0	487
2795	0	2	471	2	0	475
2796	440	0	1	1	0	442
2797	463	1	1	1	0	466
2798	2	462	0	1	0	465
2799	1	1	1	464	0	467
2800	0	1	0	464	0	465
2801	0	0	469	2	0	471
2802	462	0	1	1	0	464
2803	1	0	1	474	0	476
2804	2	0	460	6	0	468
2805	480	0	2	1	0	483
2806	494	0	1	0	0	495
2807	489	0	0	0	0	489
2808	2	0	488	0	0	490
2809	1	0	475	1	0	477
2810	487	0	2	0	0	489
2811	1	1	0	500	0	502
2812	2	0	0	506	0	508
2813	1	0	510	1	0	512
2814	512	0	2	1	0	515
2815	1	0	1	525	0	527
2816	546	0	0	4	0	550
2817	550	0	0	6	0	556
2818	554	0	0	0	0	554
2819	3	2	578	0	0	583
2820	2	0	2	587	0	591
2821	580	0	1	4	0	585
2822	1	589	1	1	0	592
2823	2	2	0	607	0	611
2824	0	1	1	607	0	609
2825	601	0	0	4	0	605
2826	588	0	1	2	0	591
2827	3	0	0	588	0	591
2828	2	0	601	2	0	605
2829	596	0	2	1	0	599
2830	5	0	618	0	0	623
2831	629	0	2	1	0	632
2832	639	0	1	0	0	640
2833	3	1	636	0	0	640
2834	3	0	3	643	0	649
2835	0	0	664	2	0	666
2836	0	689	2	4	0	695
2837	0	6	0	698	0	704
2838	0	710	0	3	0	713
2839	1	7	0	735	0	743
2840	0	1	748	6	0	755
2841	0	740	6	1	0	747
2842	0	771	2	0	0	773
2843	3	17	0	782	0	802
2844	786	2	1	10	0	799
2845	9	2	0	885	0	896
2846	929	0	0	15	0	944
2847	13	932	2	2	0	949
2848	1048	16	0	3	0	1067
2849	19	5	1076	0	0	1100
2850	5	0	17	1075	0	1097
2851	4	1	5	1071	0	1081
2852	2	0	1064	24	0	1090
2853	1038	0	20	5	0	1063
2854	1073	2	3	1	0	1079
2855	24	1058	1	1	0	1084
2856	4	20	4	1044	0	1072
2857	2	1039	2	19	0	1062
2858	1	20	1050	6	0	1077
2859	1	3	1057	1	0	1062
2860	4	9	22	1025	0	1060
2861	1029	2	4	20	0	1055
2862	20	1014	3	5	0	1042
2863	1004	18	1	4	0	1027
2864	19	8	995	2	0	1024
2865	1014	1	23	3	0	1041
2866	1039	2	7	2	0	1050
2867	28	1	1021	4	0	1054
2868	9	1	22	1021	0	1053
2869	1029	5	3	23	0	1060
2870	1052	1	1	4	0	1058
2871	1050	3	5	0	0	1058
2872	28	0	1	1013	0	1042
2873	8	0	1000	20	0	1028
2874	994	0	24	7	0	1025
2875	28	0	1010	4	0	1042
2876	10	2	20	1005	0	1037
2877	6	1	6	1018	0	1031
2878	7	1000	4	23	0	1034
2879	4	22	985	6	0	1017
2880	4	940	23	3	0	970
2881	5	980	8	3	0	996
2882	4	23	5	970	0	1002
2883	5	3	957	22	0	987
2884	2	5	22	964	0	993
2885	4	5	968	23	0	1000
2886	4	2	23	954	0	983
2887	4	5	6	949	0	964
2888	2	4	909	27	0	942
2889	0	3	21	907	0	931
2890	4	2	925	24	0	955
2891	2	3	929	9	0	943
2892	2	911	26	5	0	944
2893	922	18	5	9	0	954
2894	22	5	920	6	0	953
2895	916	1	25	2	0	944
2896	24	2	6	925	0	957
2897	6	3	919	21	0	949
2898	3	922	24	7	0	956
2899	4	24	5	923	0	956
2900	5	4	926	26	0	961
2901	5	3	26	892	0	926
2902	5	908	5	20	0	938
2903	912	19	2	9	0	942
2904	24	5	7	906	0	942
2905	897	4	3	25	0	929
2906	915	3	3	10	0	931
2907	918	2	7	2	0	929
2908	913	2	2	9	0	926
2909	901	4	2	3	0	910
2910	28	879	3	3	0	913
2911	4	19	2	886	0	911
2912	10	4	2	891	0	907
2913	7	0	4	890	0	901
2914	8	1	851	28	0	888
2915	6	841	21	9	0	877
2916	857	22	6	5	0	890
2917	869	7	4	4	0	884
2918	22	842	2	10	0	876
2919	5	839	3	8	0	855
2920	814	25	5	6	0	850
2921	23	8	807	4	0	842
2922	9	6	23	790	0	828
2923	780	5	10	22	0	817
2924	26	6	1	766	0	799
2925	8	771	4	22	0	805
2926	6	22	5	778	0	811
2927	11	5	776	25	0	817
2928	757	2	26	10	0	795
2929	793	2	6	8	0	809
2930	30	2	3	750	0	785
2931	10	2	2	773	0	787
2932	740	5	4	24	0	773
2933	24	728	2	11	0	765
2934	10	24	2	711	0	747
2935	8	3	3	727	0	741
2936	674	2	2	25	0	703
2937	22	675	3	11	0	711
2938	675	17	2	6	0	700
2939	18	655	2	4	0	679
2940	2	664	0	6	0	672
2941	631	13	3	4	0	651
2942	18	634	3	2	0	657
2943	9	23	7	607	0	646
2944	1	4	616	18	0	639
2945	2	4	506	3	0	515
2946	3	1	470	3	0	477
2947	1	466	15	1	0	483
2948	346	3	13	3	0	365
2949	5	0	3	329	0	337
2950	0	3	2	334	0	339
2951	3	1	330	5	0	339
2952	334	1	6	4	0	345
2953	6	0	2	347	0	355
2954	2	1	2	350	0	355
2955	3	1	1	340	0	345
2956	332	1	2	6	0	341
2957	6	0	325	5	0	336
2958	321	0	4	4	0	329
2959	7	0	1	321	0	329
2960	1	2	322	5	0	330
2961	321	0	3	3	0	327
2962	6	0	327	3	0	336
2963	2	3	5	323	0	333
2964	5	1	331	6	0	343
2965	2	0	313	0	0	315
2966	308	1	3	3	0	315
2967	5	0	307	1	0	313
2968	0	3	5	302	0	310
2969	307	0	1	4	0	312
2970	4	0	4	305	0	313
2971	1	1	308	7	0	317
2972	2	1	322	0	0	325
2973	2	319	4	3	0	328
2974	4	3	3	316	0	326
2975	301	0	4	7	0	312
2976	3	293	2	2	0	300
2977	301	4	2	3	0	310
2978	5	2	0	300	0	307
2979	298	2	1	6	0	307
2980	6	297	2	1	0	306
2981	2	5	0	297	0	304
2982	301	0	0	7	0	308
2983	5	301	1	2	0	309
2984	3	5	0	295	0	303
2985	3	0	0	303	0	306
2986	299	2	0	6	0	307
2987	7	1	0	303	0	311
2988	0	3	1	304	0	308
2989	4	0	0	307	0	311
2990	2	1	286	6	0	295
2991	278	1	2	3	0	284
2992	3	1	0	340	0	344
2993	0	1	358	8	0	367
2994	360	0	6	2	0	368
2995	9	1	362	3	0	375
2996	2	0	8	355	0	365
2997	2	364	3	9	0	378
2998	1	7	6	364	0	378
2999	2	1	363	9	0	375
3000	0	3	378	2	0	383
3001	2	1	7	373	0	383
3002	1	2	372	8	0	383
3003	366	0	11	1	0	378
3004	7	0	374	7	0	388
3005	1	1	10	366	0	378
3006	2	1	1	370	0	374
3007	2	0	2	367	0	371
3008	359	0	2	9	0	370
3009	363	1	1	4	0	369
3010	372	0	1	5	0	378
3011	10	0	0	367	0	377
3012	4	1	1	382	0	388
3013	4	0	376	9	0	389
3014	2	1	381	4	0	388
3015	2	383	6	5	0	396
3016	5	7	1	346	0	359
3017	5	0	1	336	0	342
3018	1	339	2	7	0	349
3019	343	7	0	3	0	353
3020	7	338	0	3	0	348
3021	340	6	1	3	0	350
3022	7	1	1	341	0	350
3023	341	1	0	8	0	350
3024	8	0	1	345	0	354
3025	2	0	338	8	0	348
3026	2	1	7	339	0	349
3027	334	0	2	9	0	345
3028	8	1	1	332	0	342
3029	1	1	2	336	0	340
3030	1	0	323	10	0	334
3031	2	0	8	323	0	333
3032	0	0	2	328	0	330
3033	1	321	2	9	0	333
3034	0	6	3	326	0	335
3035	3	0	0	331	0	334
3036	2	1	1	329	0	333
3037	0	299	0	9	0	308
3038	0	7	2	287	0	296
3039	282	0	1	11	0	294
3040	8	278	0	2	0	288
3041	1	268	0	2	0	271
3042	2	264	0	2	0	268
3043	1	17	0	240	0	258
3044	1	248	1	6	0	256
3045	2	256	3	0	0	261
3046	237	6	2	1	0	246
3047	7	1	229	2	0	239
3048	225	1	6	2	0	234
3049	6	2	0	225	0	233
3050	1	1	227	7	0	236
3051	226	0	8	1	0	235
3052	7	0	219	1	0	227
3053	1	0	216	3	0	220
3054	216	0	8	3	0	227
3055	8	0	3	222	0	233
3056	2	1	219	8	0	230
3057	212	0	10	2	0	224
3058	220	1	0	5	0	226
3059	9	1	214	2	0	226
3060	215	0	7	4	0	226
3061	223	0	3	1	0	227
3062	8	0	204	4	0	216
3063	204	0	8	6	0	218
3064	210	0	2	4	0	216
3065	10	1	205	0	0	216
3066	1	1	232	2	0	236
3067	2	1	8	230	0	241
3068	1	0	234	15	0	250
3069	231	0	9	8	0	248
3070	12	1	3	231	0	247
3071	7	2	1	234	0	244
3072	3	2	219	11	0	235
3073	1	1	9	220	0	231
3074	1	0	225	14	0	240
3075	225	2	10	4	0	241
3076	238	0	5	2	0	245
3077	12	3	226	1	0	242
3078	232	1	9	2	0	244
3079	236	1	3	4	0	244
3080	12	3	227	2	0	244
3081	239	0	8	4	0	251
3082	240	3	5	2	0	250
3083	14	1	231	2	0	248
3084	236	1	10	3	0	250
3085	11	0	236	2	0	249
3086	4	0	8	234	0	246
3087	0	0	5	241	0	246
3088	0	0	3	246	0	249
3089	4	1	229	13	0	247
3090	221	0	10	4	0	235
3091	10	2	226	3	0	241
3092	3	164	6	1	0	174
3093	0	151	2	1	0	154
3094	145	7	2	0	0	154
3095	6	2	0	142	0	150
3096	3	142	0	5	0	150
3097	141	5	1	1	0	148
3098	143	2	0	0	0	145
3099	8	145	0	0	0	153
3100	2	5	1	135	0	143
3101	1	128	0	5	0	134
3102	132	4	0	2	0	138
3103	139	2	1	0	0	142
3104	7	0	1	129	0	137
3105	132	0	0	6	0	138
3106	5	0	1	133	0	139
3107	3	0	130	5	0	138
3108	127	0	5	3	0	135
3109	5	0	136	1	0	142
3110	2	0	6	126	0	134
3111	126	0	2	6	0	134
3112	5	0	1	116	0	122
3113	3	0	109	5	0	117
3114	1	0	109	2	0	112
3115	0	2	7	106	0	115
3116	106	0	2	4	0	112
3117	4	108	0	2	0	114
3118	2	4	0	109	0	115
3119	0	2	110	4	0	116
3120	109	0	4	1	0	114
3121	119	0	2	0	0	121
3122	6	0	111	0	0	117
3123	115	0	4	0	0	119
3124	4	0	2	115	0	121
3125	2	0	117	4	0	123
3126	114	0	4	3	0	121
3127	4	0	2	115	0	121
3128	3	0	0	116	0	119
3129	116	0	0	6	0	122
3130	4	118	0	2	0	124
3131	2	119	0	0	0	121
3132	118	6	0	0	0	124
3133	120	1	0	0	0	121
3134	6	0	121	0	0	127
3135	2	0	119	0	0	121
3136	0	0	5	116	0	121
3137	118	0	3	2	0	123
3138	122	0	0	2	0	124
3139	121	0	0	1	0	122
3140	5	115	0	1	0	121
3141	2	124	1	0	0	127
3142	0	5	0	122	0	127
3143	0	2	1	127	0	130
3144	1	0	0	135	0	136
3145	1	0	136	4	0	141
3146	0	0	129	2	0	131
3147	138	0	5	0	0	143
3148	142	0	2	1	0	145
3149	5	0	1	149	0	155
3150	3	0	0	150	0	153
3151	1	0	3	152	0	156
3152	0	0	148	5	0	153
3153	0	0	153	2	0	155
3154	0	0	6	150	0	156
3155	0	0	158	4	0	162
3156	0	151	3	2	0	156
3157	0	158	2	1	0	161
3158	157	5	1	0	0	163
3159	4	160	0	0	0	164
3160	2	3	1	155	0	161
3161	0	2	0	158	0	160
3162	0	164	0	5	0	169
3163	1	4	0	170	0	175
3164	0	2	166	5	0	173
3165	0	164	4	3	0	171
3166	1	1	2	144	0	148
3167	0	0	137	1	0	138
3168	0	135	2	0	0	137
3169	0	1	0	134	0	135
3170	1	132	0	1	0	134
3171	0	1	0	135	0	136
3172	0	0	1	133	0	134
3173	0	131	1	1	0	133
3174	126	1	0	1	0	128
3175	124	0	0	0	0	124
3176	1	127	0	0	0	128
3177	0	127	0	1	0	128
3178	0	1	1	123	0	125
3179	1	0	123	1	0	125
3180	126	0	0	0	0	126
3181	118	0	1	1	0	120
3182	2	0	119	0	0	121
3183	119	0	1	1	0	121
3184	124	0	0	0	0	124
3185	2	0	119	0	0	121
3186	120	0	1	1	0	122
3187	1	0	124	1	0	126
3188	1	126	1	0	0	128
3189	126	2	0	1	0	129
3190	128	1	0	1	0	130
3191	2	0	126	0	0	128
3192	129	0	1	0	0	130
3193	129	0	1	0	0	130
3194	1	0	130	0	0	131
3195	130	0	1	2	0	133
3196	132	0	0	0	0	132
3197	1	0	127	0	0	128
3198	129	0	1	1	0	131
3199	1	1	0	123	0	125
3200	0	1	0	124	0	125
3201	0	0	123	3	0	126
3202	0	0	121	1	0	122
3203	0	1	1	121	0	123
3204	0	0	0	122	0	122
3205	125	1	1	1	0	128
3206	1	0	123	1	0	125
3207	129	0	1	1	0	131
3208	1	1	0	133	0	135
3209	1	0	130	1	0	132
3210	142	0	1	0	0	143
3211	1	1	0	145	0	147
3212	0	1	147	1	0	149
3213	147	0	1	1	0	149
3214	1	0	1	150	0	152
3215	156	0	0	1	0	157
3216	2	0	170	0	0	172
3217	0	0	2	158	0	160
3218	1	173	1	1	0	176
3219	182	1	0	1	0	184
3220	180	2	1	0	0	183
3221	4	182	0	0	0	186
3222	186	2	1	1	0	190
3223	188	3	0	1	0	192
3224	192	0	0	0	0	192
3225	5	186	0	0	0	191
3226	2	2	1	196	0	201
3227	1	2	201	2	0	206
3228	1	0	2	199	0	202
3229	0	0	3	196	0	199
3230	1	0	199	3	0	203
3231	1	0	201	1	0	203
3232	0	0	6	198	0	204
3233	1	208	2	2	0	213
3234	209	2	0	3	0	214
3235	212	2	0	0	0	214
3236	4	222	1	0	0	227
3237	224	2	1	1	0	228
3238	220	2	0	2	0	224
3239	5	0	217	1	0	223
3240	222	1	2	0	0	225
3241	2	222	3	0	0	227
3242	2	2	213	6	0	223
3243	0	2	206	1	0	209
3244	0	210	4	0	0	214
3245	208	2	2	0	0	212
3246	2	2	221	1	0	226
3247	2	0	3	221	0	226
3248	1	0	224	2	0	227
3249	209	0	2	4	0	215
3250	3	0	270	0	0	273
3251	3	0	265	0	0	268
3252	268	0	4	1	0	273
3253	2	275	2	0	0	279
3254	287	2	1	0	0	290
3255	289	2	0	1	0	292
3256	4	1	0	288	0	293
3257	3	324	0	2	0	329
3258	339	2	0	4	0	345
3259	3	2	345	0	0	350
3260	332	1	2	1	0	336
3261	2	343	3	1	0	349
3262	342	1	1	0	0	344
3263	342	2	1	1	0	346
3264	3	349	0	1	0	353
3265	2	2	0	361	0	365
3266	367	2	0	1	0	370
3267	2	367	0	2	0	371
3268	2	2	0	375	0	379
3269	379	2	0	2	0	383
3270	2	0	0	403	0	405
3271	4	0	0	398	0	402
3272	0	403	0	4	0	407
3273	406	2	0	4	0	412
3274	414	2	1	0	0	417
3275	418	0	0	3	0	421
3276	4	429	0	1	0	434
3277	440	2	1	0	0	443
3278	438	2	1	2	0	443
3279	3	0	0	436	0	439
3280	2	1	0	437	0	440
3281	1	0	445	4	0	450
3282	2	0	2	445	0	449
3283	1	1	2	436	0	440
3284	1	0	441	4	0	446
3285	420	0	3	3	0	426
3286	2	0	451	0	0	453
3287	3	0	448	0	0	451
3288	0	1	4	452	0	457
3289	1	0	3	459	0	463
3290	0	462	1	4	0	467
3291	469	3	0	4	0	476
3292	470	2	0	0	0	472
3293	4	476	1	0	0	481
3294	2	506	0	1	0	509
3295	0	6	1	507	0	514
3296	1	527	0	4	0	532
3297	535	5	1	2	0	543
3298	541	4	1	0	0	546
3299	9	0	0	533	0	542
3300	3	2	0	539	0	544
3301	541	0	0	8	0	549
3302	8	1	527	3	0	539
3303	529	0	5	2	0	536
3304	7	3	527	1	0	538
3305	536	0	6	3	0	545
3306	8	0	4	535	0	547
3307	6	0	541	6	0	553
3308	0	2	540	3	0	545
3309	539	0	7	1	0	547
3310	540	0	3	1	0	544
3311	9	545	1	4	0	559
3312	2	6	1	567	0	576
3313	2	1	2	582	0	587
3314	573	1	0	15	0	589
3315	8	565	0	5	0	578
3316	563	9	2	2	0	576
3317	8	555	0	1	0	564
3318	2	561	2	1	0	566
3319	552	9	1	1	0	563
3320	9	1	543	1	0	554
3321	1	1	7	542	0	551
3322	0	4	0	555	0	559
3323	4	0	550	6	0	560
3324	3	0	8	550	0	561
3325	0	0	0	515	0	515
3326	0	543	0	7	0	550
3327	546	7	0	4	0	557
3328	7	5	544	2	0	558
3329	539	0	7	0	0	546
3330	8	546	1	0	0	555
3331	3	6	2	542	0	553
3332	569	0	1	12	0	582
3333	11	0	2	565	0	578
3334	1	1	3	571	0	576
3335	2	0	563	9	0	574
3336	547	0	8	1	0	556
3337	566	2	0	4	0	572
3338	9	0	566	4	0	579
3339	0	1	10	563	0	574
3340	4	0	568	8	0	580
3341	569	2	9	0	0	580
3342	582	0	1	3	0	586
3343	8	4	0	570	0	582
3344	573	1	4	11	0	589
3345	10	0	603	5	0	618
3346	3	0	10	606	0	619
3347	4	2	0	601	0	607
3348	5	0	1	613	0	619
3349	1	1	3	608	0	613
3350	548	1	0	12	0	561
3351	9	1	549	2	0	561
3352	2	1	9	550	0	562
3353	3	0	549	10	0	562
3354	2	0	552	4	0	558
3355	3	0	9	539	0	551
3356	2	0	1	552	0	555
3357	506	1	1	13	0	521
3358	8	2	2	502	0	514
3359	4	1	1	528	0	534
3360	0	1	2	531	0	534
3361	529	0	1	9	0	539
3362	531	1	3	3	0	538
3363	538	0	0	6	0	544
3364	523	0	4	3	0	530
3365	7	563	3	5	0	578
3366	1	8	2	573	0	584
3367	3	1	2	572	0	578
3368	592	1	0	9	0	602
3369	12	635	0	6	0	653
3370	3	10	1	666	0	680
3371	2	3	720	14	0	739
3372	801	2	10	4	0	817
3373	16	831	3	5	0	855
3374	861	15	2	1	0	879
3375	893	7	1	1	0	902
3376	26	6	0	866	0	898
3377	11	0	862	19	0	892
3378	8	1	15	886	0	910
3379	902	0	7	20	0	929
3380	18	2	4	904	0	928
3381	904	0	0	23	0	927
3382	21	884	2	8	0	915
3383	917	16	2	4	0	939
3384	23	10	1	908	0	942
3385	12	3	1	969	0	985
3386	967	3	0	25	0	995
3387	969	1	1	13	0	984
3388	968	2	1	7	0	978
3389	970	0	0	6	0	976
3390	971	1	1	3	0	976
3391	32	0	1	931	0	964
3392	15	2	909	16	0	942
3393	6	913	15	10	0	944
3394	894	14	7	6	0	921
3395	19	7	873	3	0	902
3396	867	5	13	2	0	887
3397	19	855	8	4	0	886
3398	876	13	5	3	0	897
3399	18	6	0	872	0	896
3400	14	3	1	883	0	901
3401	7	0	859	22	0	888
3402	6	0	13	879	0	898
3403	4	2	891	15	0	912
3404	7	3	888	8	0	906
3405	886	1	20	9	0	916
3406	920	1	11	7	0	939
3407	26	2	883	2	0	913
3408	882	4	14	5	0	905
3409	908	0	11	4	0	923
3410	25	1	879	5	0	910
3411	19	861	14	5	0	899
3412	6	15	11	893	0	925
3413	920	7	5	18	0	950
3414	935	6	2	9	0	952
3415	940	0	2	8	0	950
3416	943	1	3	3	0	950
3417	936	2	1	6	0	945
3418	28	1	924	2	0	955
3419	18	0	933	2	0	953
3420	14	1	16	950	0	981
3421	951	3	9	16	0	979
3422	965	3	6	10	0	984
3423	972	1	0	13	0	986
3424	948	0	6	7	0	961
3425	24	932	4	2	0	962
3426	17	982	1	13	0	1013
3427	988	14	5	3	0	1010
3428	998	12	1	4	0	1015
3429	26	994	2	3	0	1025
3430	1012	13	3	5	0	1033
3431	20	10	997	3	0	1030
3432	12	8	12	987	0	1019
3433	9	1	998	15	0	1023
3434	6	1	994	12	0	1013
3435	8	0	19	1017	0	1044
3436	9	1	13	1024	0	1047
3437	12	1	1029	20	0	1062
3438	10	1	13	1021	0	1045
3439	5	1	10	1038	0	1054
3440	1031	2	7	19	0	1059
3441	1039	5	1	14	0	1059
3442	26	1	8	1033	0	1068
3443	19	4	1021	15	0	1059
3444	14	1019	11	11	0	1055
3445	1014	12	10	6	0	1042
3446	19	10	1037	3	0	1069
3447	13	1021	12	6	0	1052
3448	12	1064	10	5	0	1091
3449	1076	18	10	5	0	1109
3450	1078	13	3	8	0	1102
3451	26	3	4	1063	0	1096
3452	17	1	1118	16	0	1152
3453	12	0	12	1126	0	1150
3454	11	2	12	1134	0	1159
3455	10	0	9	1154	0	1173
3456	1138	1	2	28	0	1169
3457	18	1110	2	15	0	1145
3458	12	1184	4	7	0	1207
3459	14	22	1	1159	0	1196
3460	5	11	3	1195	0	1214
3461	1176	10	4	24	0	1214
3462	1164	2	2	22	0	1190
3463	1178	1	5	8	0	1192
3464	32	1152	5	4	0	1193
3465	1123	12	5	3	0	1143
3466	19	7	10	1110	0	1146
3467	8	6	1098	17	0	1129
3468	10	2	1045	14	0	1071
3469	1010	0	16	9	0	1035
3470	11	0	989	5	0	1005
3471	8	2	915	4	0	929
3472	808	1	8	1	0	818
3473	5	0	808	1	0	814
3474	2	0	794	2	0	798
3475	5	4	1	774	0	784
3476	1	1	818	0	0	820
3477	4	0	3	787	0	794
3478	3	0	0	801	0	804
3479	0	0	832	1	0	833
3480	0	834	3	4	0	841
3481	855	0	0	11	0	866
3482	1	1	870	2	0	874
3483	1	4	852	2	0	859
3484	801	0	0	0	0	801
3485	1	1	834	0	0	836
3486	0	819	4	0	0	823
3487	7	760	1	3	0	771
3488	1	0	4	842	0	847
3489	2	3	0	833	0	838
3490	857	3	0	1	0	861
3491	858	0	0	4	0	862
3492	857	1	0	5	0	863
3493	5	0	0	864	0	869
3494	873	0	0	7	0	880
3495	866	1	2	1	0	870
3496	0	0	867	4	0	871
3497	9	0	837	0	0	846
3498	4	882	2	1	0	889
3499	0	0	5	885	0	890
3500	887	0	6	1	0	894
3501	0	895	2	0	0	897
3502	0	0	2	909	0	911
3503	911	0	0	5	0	916
3504	879	4	2	5	0	890
3505	0	902	0	6	0	908
3506	908	0	0	4	0	912
3507	916	0	2	1	0	919
3508	0	6	0	918	0	924
3509	5	0	924	0	0	929
3510	4	903	2	0	0	909
3511	0	904	2	4	0	910
3512	882	5	4	1	0	892
3513	0	3	1	875	0	879
3514	0	5	891	0	0	896
3515	4	884	0	0	0	888
3516	893	0	0	6	0	899
3517	897	0	4	2	0	903
3518	1	8	895	0	0	904
3519	8	0	0	876	0	884
3520	6	0	0	917	0	923
3521	0	0	1017	2	0	1019
3522	1057	0	2	6	0	1065
3523	1278	0	2	5	0	1285
3524	19	0	4	1466	0	1489
3525	5	1508	2	24	0	1539
3526	5	24	0	1565	0	1594
3527	0	3	1575	33	0	1611
3528	1557	5	25	7	0	1594
3529	32	1	4	1605	0	1642
3530	4	2	1612	30	0	1648
3531	1575	1	23	9	0	1608
3532	30	1	5	1613	0	1649
3533	9	6	6	1618	0	1639
3534	1583	0	3	36	0	1622
3535	29	1584	6	9	0	1628
3536	1586	27	0	12	0	1625
3537	37	4	2	1573	0	1616
3538	1566	6	4	41	0	1617
3539	39	8	1556	7	0	1610
3540	7	1549	29	15	0	1600
3541	9	29	9	1583	0	1630
3542	1590	5	5	33	0	1633
3543	33	1584	3	12	0	1632
3544	16	30	7	1599	0	1652
3545	1613	8	1	37	0	1659
3546	1579	5	5	18	0	1607
3547	41	2	7	1546	0	1596
3548	17	7	1532	36	0	1592
3549	8	6	1536	16	0	1566
3550	1538	2	33	13	0	1586
3551	36	1515	8	14	0	1573
3552	13	1497	6	14	0	1530
3553	1464	31	12	9	0	1516
3554	35	1483	3	7	0	1528
3555	13	31	4	1493	0	1541
3556	14	10	6	1521	0	1551
3557	1503	12	4	40	0	1559
3558	1467	3	4	17	0	1491
3559	1477	11	1	10	0	1499
3560	41	10	1405	8	0	1464
3561	20	2	31	1428	0	1481
3562	14	9	1426	32	0	1481
3563	12	3	1395	18	0	1428
3564	15	2	1426	15	0	1458
3565	18	11	40	1394	0	1463
3566	13	10	1403	40	0	1466
3567	19	2	1425	11	0	1457
3568	6	9	42	1395	0	1452
3569	1403	2	16	44	0	1465
3570	35	3	1425	14	0	1477
3571	20	8	37	1404	0	1469
3572	17	4	11	1455	0	1487
3573	16	7	1441	40	0	1504
3574	9	6	41	1419	0	1475
3575	10	4	1443	46	0	1503
3576	17	3	39	1407	0	1466
3577	13	5	13	1434	0	1465
3578	11	0	16	1433	0	1460
3579	7	1	13	1426	0	1447
3580	1368	4	15	47	0	1434
3581	1379	1	17	22	0	1419
3582	41	5	1347	18	0	1411
3583	16	1343	46	8	0	1413
3584	9	27	1363	17	0	1416
3585	8	9	1367	20	0	1404
3586	1337	4	44	19	0	1404
3587	33	1376	21	14	0	1444
3588	1366	34	11	12	0	1423
3589	45	1372	20	8	0	1445
3590	1376	38	14	15	0	1443
3591	1404	11	9	18	0	1442
3592	43	9	12	1376	0	1440
3593	18	1367	12	46	0	1443
3594	21	37	9	1391	0	1458
3595	15	9	9	1427	0	1460
3596	9	8	1369	53	0	1439
3597	7	1387	43	18	0	1455
3598	12	35	16	1405	0	1468
3599	1406	7	15	47	0	1475
3600	1461	7	8	17	0	1493
3601	1436	11	13	19	0	1479
3602	50	1400	8	16	0	1474
3603	1446	40	9	15	0	1510
3604	51	1519	16	7	0	1593
3605	22	49	5	1557	0	1633
3606	16	12	1541	50	0	1619
3607	15	13	43	1539	0	1610
3608	12	1538	12	55	0	1617
3609	16	44	9	1558	0	1627
3610	9	18	14	1579	0	1620
3611	14	1553	5	55	0	1627
3612	1556	49	6	26	0	1637
3613	50	14	5	1561	0	1630
3614	15	10	1509	57	0	1591
3615	10	8	49	1537	0	1604
3616	13	16	10	1577	0	1616
3617	17	4	1526	62	0	1609
3618	8	13	44	1492	0	1557
3619	10	1499	13	52	0	1574
3620	16	45	1503	15	0	1579
3621	25	11	1417	19	0	1472
3622	10	1348	51	6	0	1415
3623	5	1156	14	15	0	1190
3624	3	946	10	5	0	964
3625	854	25	18	4	0	901
3626	821	8	5	3	0	837
3627	812	1	1	3	0	817
3628	21	3	0	803	0	827
3629	3	2	779	20	0	804
3630	3	0	19	769	0	791
3631	2	1	2	787	0	792
3632	765	1	3	21	0	790
3633	773	0	2	7	0	782
3634	19	767	2	5	0	793
3635	760	18	1	5	0	784
3636	794	2	1	3	0	800
3637	801	2	1	3	0	807
3638	20	1	777	1	0	799
3639	7	1	778	3	0	789
3640	4	1	20	766	0	791
3641	0	1	775	18	0	794
3642	743	2	18	6	0	769
3643	767	2	4	3	0	776
3644	21	1	733	1	0	756
3645	728	0	19	0	0	747
3646	19	725	3	1	0	748
3647	734	18	3	0	0	755
3648	17	5	1	720	0	743
3649	6	1	1	712	0	720
3650	3	721	1	21	0	746
3651	720	16	0	6	0	742
3652	727	6	0	2	0	735
3653	23	712	2	1	0	738
3654	5	17	1	699	0	722
3655	4	4	0	711	0	719
3656	4	699	1	18	0	722
3657	2	17	1	701	0	721
3658	0	4	1	720	0	725
3659	697	1	2	22	0	722
3660	716	1	0	7	0	724
3661	22	3	691	2	0	718
3662	693	0	20	3	0	716
3663	20	1	697	2	0	720
3664	7	1	19	689	0	716
3665	7	1	686	17	0	711
3666	4	677	17	4	0	702
3667	2	21	5	677	0	705
3668	6	4	3	686	0	699
3669	667	2	1	24	0	694
3670	21	3	0	652	0	676
3671	5	0	640	18	0	663
3672	635	0	13	8	0	656
3673	647	3	3	3	0	656
3674	648	2	2	4	0	656
3675	641	0	1	3	0	645
3676	24	2	0	639	0	665
3677	8	1	1	663	0	673
3678	4	1	1	692	0	698
3679	2	1	1	694	0	698
3680	670	1	1	25	0	697
3681	681	1	2	8	0	692
3682	25	0	0	633	0	658
3683	4	639	3	20	0	666
3684	641	17	1	7	0	666
3685	20	3	636	2	0	661
3686	5	633	16	2	0	656
3687	601	16	5	3	0	625
3688	15	605	1	4	0	625
3689	3	17	609	0	0	629
3690	607	4	17	4	0	632
3691	618	1	4	3	0	626
3692	21	5	585	1	0	612
3693	6	1	16	592	0	615
3694	4	4	3	596	0	607
3695	4	584	1	19	0	608
3696	3	16	2	588	0	609
3697	564	2	1	24	0	591
3698	18	558	3	5	0	584
3699	5	15	1	525	0	546
3700	2	2	1	541	0	546
3701	5	1	509	21	0	536
3702	3	512	16	4	0	535
3703	452	20	5	6	0	483
3704	14	379	2	1	0	396
3705	5	349	0	0	0	354
3706	342	9	2	5	0	358
3707	11	1	3	325	0	340
3708	3	1	2	333	0	339
3709	324	1	1	14	0	340
3710	11	0	1	326	0	338
3711	4	0	1	336	0	341
3712	342	2	1	12	0	357
3713	14	0	1	327	0	342
3714	5	333	0	9	0	347
3715	324	10	0	6	0	340
3716	12	3	317	1	0	333
3717	3	298	8	3	0	312
3718	0	9	2	298	0	309
3719	3	3	290	9	0	305
3720	2	0	293	4	0	299
3721	4	21	7	255	0	287
3722	256	0	3	6	0	265
3723	6	0	2	261	0	269
3724	4	2	0	263	0	269
3725	2	0	0	269	0	271
3726	1	1	2	264	0	268
3727	1	0	1	267	0	269
3728	0	1	248	11	0	260
3729	1	1	250	4	0	256
3730	2	0	7	248	0	257
3731	1	1	251	7	0	260
3732	1	251	6	3	0	261
3733	1	5	2	255	0	263
3734	0	3	245	7	0	255
3735	237	0	6	4	0	247
3736	4	234	4	3	0	245
3737	1	219	1	3	0	224
3738	2	229	2	0	0	233
3739	1	8	1	224	0	234
3740	223	2	3	6	0	234
3741	5	2	2	219	0	228
3742	222	1	0	4	0	227
3743	5	212	1	3	0	221
3744	215	5	1	2	0	223
3745	6	3	0	211	0	220
3746	2	3	0	217	0	222
3747	2	206	0	6	0	214
3748	0	5	0	210	0	215
3749	2	2	0	214	0	218
3750	1	2	0	211	0	214
3751	204	0	0	10	0	214
3752	199	0	1	3	0	203
3753	5	2	197	3	0	207
3754	200	1	4	1	0	206
3755	5	1	206	3	0	215
3756	1	1	5	203	0	210
3757	3	1	1	202	0	207
3758	2	0	1	208	0	211
3759	1	0	201	8	0	210
3760	1	1	5	206	0	213
3761	2	0	208	7	0	217
3762	1	0	7	212	0	220
3763	210	0	3	6	0	219
3764	5	0	207	4	0	216
3765	206	1	5	2	0	214
3766	7	0	2	208	0	217
3767	206	0	1	7	0	214
3768	5	205	1	3	0	214
3769	1	4	0	215	0	220
3770	1	1	212	6	0	220
3771	0	1	8	209	0	218
3772	1	2	2	209	0	214
3773	2	208	1	6	0	217
3774	1	3	209	3	0	216
3775	1	203	4	2	0	210
3776	181	3	1	3	0	188
3777	3	175	3	0	0	181
3778	145	3	3	1	0	152
3779	154	0	0	2	0	156
3780	150	2	1	0	0	153
3781	3	0	1	150	0	154
3782	2	1	148	2	0	153
3783	3	1	1	146	0	151
3784	0	149	2	4	0	155
3785	1	2	1	151	0	155
3786	148	1	0	2	0	151
3787	2	146	0	1	0	149
3788	3	1	0	142	0	146
3789	3	1	1	138	0	143
3790	139	1	0	2	0	142
3791	0	1	138	4	0	143
3792	1	137	2	2	0	142
3793	1	0	1	128	0	130
3794	0	2	131	0	0	133
3795	0	1	0	133	0	134
3796	1	130	1	1	0	133
3797	0	1	1	138	0	140
3798	0	0	0	136	0	136
3799	0	1	0	135	0	136
3800	1	0	134	2	0	137
3801	133	0	1	2	0	136
3802	0	1	1	149	0	151
3803	166	0	1	1	0	168
3804	177	0	1	1	0	179
3805	177	0	0	2	0	179
3806	175	1	0	0	0	176
3807	178	0	0	1	0	179
3808	4	0	0	172	0	176
3809	2	170	0	2	0	174
3810	1	1	1	168	0	171
3811	1	166	0	2	0	169
3812	0	4	0	153	0	157
3813	152	0	0	2	0	154
3814	2	1	0	149	0	152
3815	1	0	150	2	0	153
3816	145	0	1	0	0	146
3817	2	149	0	1	0	152
3818	148	1	0	1	0	150
3819	145	1	0	0	0	146
3820	145	0	0	1	0	146
3821	1	151	0	0	0	152
3822	1	1	0	152	0	154
3823	1	0	0	151	0	152
3824	0	0	145	2	0	147
3825	0	0	2	143	0	145
3826	1	0	0	141	0	142
3827	1	1	0	141	0	143
3828	1	142	0	1	0	144
3829	145	1	0	0	0	146
3830	145	0	0	0	0	145
3831	1	1	143	0	0	145
3832	0	141	1	1	0	143
3833	0	1	0	143	0	144
3834	0	0	1	142	0	143
3835	0	0	0	145	0	145
3836	0	0	0	149	0	149
3837	1	0	0	150	0	151
3838	0	1	146	1	0	148
3839	1	0	146	0	0	147
3840	150	0	1	0	0	151
3841	151	0	1	0	0	152
3842	147	1	0	0	0	148
3843	1	0	0	151	0	152
3844	0	0	152	2	0	154
3845	151	0	1	1	0	153
3846	152	0	0	1	0	153
3847	1	0	152	1	0	154
3848	153	0	2	0	0	155
3849	1	0	163	0	0	164
3850	1	0	1	165	0	167
3851	1	0	160	1	0	162
3852	161	0	1	0	0	162
3853	161	0	0	1	0	162
3854	162	0	1	0	0	163
3855	157	0	0	1	0	158
3856	2	0	167	0	0	169
3857	0	167	3	0	0	170
3858	171	1	0	0	0	172
3859	172	0	2	0	0	174
3860	1	1	170	1	0	173
3861	1	0	2	165	0	168
3862	3	0	0	168	0	171
3863	2	0	166	1	0	169
3864	168	0	1	1	0	170
3865	171	0	0	1	0	172
3866	1	171	2	0	0	174
3867	179	4	0	0	0	183
3868	178	0	0	0	0	178
3869	176	1	0	0	0	177
3870	175	0	1	1	0	177
3871	5	0	164	1	0	170
3872	170	0	1	2	0	173
3873	3	2	2	170	0	177
3874	2	174	1	2	0	179
3875	2	3	169	0	0	174
3876	1	171	2	1	0	175
3877	1	4	0	164	0	169
3878	2	0	167	2	0	171
3879	158	2	2	1	0	163
3880	2	0	162	1	0	165
3881	163	0	3	1	0	167
3882	3	0	1	165	0	169
3883	0	0	1	165	0	166
3884	1	165	0	2	0	168
3885	0	171	0	1	0	172
3886	0	3	0	177	0	180
3887	182	1	0	2	0	185
3888	181	1	0	0	0	182
3889	180	0	1	1	0	182
3890	4	1	182	0	0	187
3891	180	0	2	1	0	183
3892	3	0	183	1	0	187
3893	1	0	187	1	0	189
3894	179	0	5	1	0	185
3895	180	0	0	2	0	182
3896	2	0	182	0	0	184
3897	1	1	2	179	0	183
3898	2	0	0	182	0	184
3899	185	0	0	2	0	187
3900	183	0	0	3	0	186
3901	2	0	189	2	0	193
3902	1	180	3	0	0	184
3903	1	166	0	0	0	167
3904	155	1	0	0	0	156
3905	1	1	0	157	0	159
3906	0	1	0	161	0	162
3907	1	0	0	168	0	169
3908	170	0	0	2	0	172
3909	1	0	0	171	0	172
3910	169	0	0	2	0	171
3911	176	0	0	1	0	177
3912	1	186	0	1	0	188
3913	2	1	0	216	0	219
3914	1	0	217	1	0	219
3915	216	1	1	0	0	218
3916	220	0	0	1	0	221
3917	219	0	0	0	0	219
3918	2	0	229	0	0	231
3919	1	0	1	227	0	229
3920	231	0	0	1	0	232
3921	220	0	1	0	0	221
3922	221	1	0	1	0	223
3923	2	219	0	0	0	221
3924	1	228	0	0	0	229
3925	1	1	0	230	0	232
3926	1	1	0	227	0	229
3927	0	228	0	2	0	230
3928	230	1	0	1	0	232
3929	1	0	236	1	0	238
3930	0	0	1	238	0	239
3931	0	0	0	238	0	238
3932	0	0	235	1	0	236
3933	227	0	0	2	0	229
3934	237	0	0	1	0	238
3935	1	236	0	0	0	237
3936	231	1	0	0	0	232
3937	3	1	248	0	0	252
3938	254	1	1	1	0	257
3939	2	0	256	0	0	258
3940	262	0	1	0	0	263
3941	269	0	0	1	0	270
3942	270	0	1	0	0	271
3943	267	0	0	1	0	268
3944	2	268	0	0	0	270
3945	275	1	0	0	0	276
3946	286	0	0	1	0	287
3947	2	1	291	0	0	294
3948	292	0	1	0	0	293
3949	2	0	0	302	0	304
3950	0	0	301	1	0	302
3951	305	0	1	1	0	307
3952	1	0	0	309	0	310
3953	313	0	1	1	0	315
3954	347	0	0	3	0	350
3955	1	0	373	1	0	375
3956	370	0	1	1	0	372
3957	380	0	0	0	0	380
3958	378	0	0	1	0	379
3959	387	0	0	1	0	388
3960	1	0	0	381	0	382
3961	0	387	0	1	0	388
3962	380	1	1	2	0	384
3963	396	0	0	1	0	397
3964	396	0	0	0	0	396
3965	2	0	396	0	0	398
3966	0	400	1	0	0	401
3967	0	2	0	404	0	406
3968	0	0	0	404	0	404
3969	2	1	423	1	0	427
3970	1	0	3	425	0	429
3971	0	0	431	3	0	434
3972	0	1	3	429	0	433
3973	0	0	0	437	0	437
3974	0	0	444	4	0	448
3975	435	0	4	0	0	439
3976	460	0	0	1	0	461
3977	3	0	469	0	0	472
3978	460	0	3	2	0	465
3979	485	0	0	1	0	486
3980	3	1	480	0	0	484
3981	2	0	3	489	0	494
3982	3	0	0	493	0	496
3983	493	0	1	3	0	497
3984	4	501	0	0	0	505
3985	484	3	0	0	0	487
3986	498	0	1	0	0	499
3987	3	511	0	1	0	515
3988	513	3	0	1	0	517
3989	516	0	0	1	0	517
3990	3	507	1	0	0	511
3991	1	3	0	521	0	525
3992	1	540	0	4	0	545
3993	1	4	0	541	0	546
3994	2	1	539	3	0	545
3995	1	0	532	0	0	533
3996	534	1	3	2	0	540
3997	547	0	0	1	0	548
3998	4	2	544	0	0	550
3999	544	0	3	1	0	548
4000	551	0	0	2	0	553
4001	548	1	1	0	0	550
4002	4	563	0	0	0	567
4003	2	4	0	572	0	578
4004	573	0	0	4	0	577
4005	570	0	2	0	0	572
4006	4	2	565	0	0	571
4007	3	0	2	564	0	569
4008	1	1	0	566	0	568
4009	0	557	2	7	0	566
4010	2	588	0	1	0	591
4011	1	7	1	582	0	591
4012	1	594	1	5	0	601
4013	572	7	0	2	0	581
4014	6	607	1	2	0	616
4015	623	8	0	0	0	631
4016	10	2	630	1	0	643
4017	671	1	11	1	0	684
4018	707	1	1	1	0	710
4019	706	1	0	1	0	708
4020	707	2	1	0	0	710
4021	14	694	1	2	0	711
4022	5	9	2	713	0	729
4023	4	2	0	703	0	709
4024	3	2	706	11	0	722
4025	3	1	10	698	0	712
4026	4	2	2	718	0	726
4027	712	1	1	12	0	726
4028	11	712	1	5	0	729
4029	5	13	1	714	0	733
4030	3	3	1	730	0	737
4031	3	0	1	740	0	744
4032	735	3	0	14	0	752
4033	10	1	0	741	0	752
4034	742	1	2	12	0	757
4035	12	1	2	747	0	762
4036	5	0	0	758	0	763
4037	5	0	721	11	0	737
4038	694	4	10	6	0	714
4039	11	716	2	2	0	731
4040	744	8	1	4	0	757
4041	11	3	0	738	0	752
4042	1	2	2	745	0	750
4043	751	0	1	13	0	765
4044	749	1	0	7	0	757
4045	16	1	1	804	0	822
4046	5	1	796	11	0	813
4047	4	1	792	7	0	804
4048	2	828	12	6	0	848
4049	844	10	10	3	0	867
4050	853	2	4	1	0	860
4051	14	3	1	853	0	871
4052	6	853	2	12	0	873
4053	6	11	1	852	0	870
4054	5	4	0	829	0	838
4055	4	790	1	16	0	811
4056	798	11	0	9	0	818
4057	11	5	1	819	0	836
4058	4	811	2	12	0	829
4059	3	851	0	7	0	861
4060	844	14	2	5	0	865
4061	14	4	833	1	0	852
4062	840	4	12	5	0	861
4063	14	4	3	841	0	862
4064	5	1	4	844	0	854
4065	4	841	2	11	0	858
4066	3	11	1	840	0	855
4067	3	1	835	15	0	854
4068	2	811	10	5	0	828
4069	2	807	5	5	0	819
4070	811	12	3	2	0	828
4071	9	813	2	3	0	827
4072	2	12	3	827	0	844
4073	4	832	1	8	0	845
4074	2	11	0	831	0	844
4075	6	3	0	836	0	845
4076	1	5	812	14	0	832
4077	2	2	8	813	0	825
4078	2	2	4	815	0	823
4079	791	2	4	14	0	811
4080	10	1	807	7	0	825
4081	6	4	9	826	0	845
4082	5	4	822	13	0	844
4083	829	3	11	8	0	851
4084	10	852	3	9	0	874
4085	903	11	5	8	0	927
4086	15	6	2	940	0	963
4087	7	6	3	933	0	949
4088	5	4	919	17	0	945
4089	881	3	12	10	0	906
4090	10	928	3	13	0	954
4091	931	14	4	7	0	956
4092	16	2	2	921	0	941
4093	6	932	4	13	0	955
4094	939	12	2	8	0	961
4095	13	957	2	6	0	978
4096	6	14	1	972	0	993
4097	5	7	2	977	0	991
4098	5	6	2	971	0	984
4099	3	962	0	19	0	984
4100	2	11	2	976	0	991
4101	4	4	1	980	0	989
4102	948	6	2	18	0	974
4103	967	4	1	11	0	983
4104	963	4	1	7	0	975
4105	18	2	966	6	0	992
4106	970	4	15	4	0	993
4107	993	2	4	7	0	1006
4108	965	9	4	5	0	983
4109	19	1	930	8	0	958
4110	951	5	9	6	0	971
4111	15	2	5	961	0	983
4112	6	9	941	13	0	969
4113	5	935	9	11	0	960
4114	5	22	2	907	0	936
4115	3	895	5	10	0	913
4116	5	911	1	5	0	922
4117	851	9	4	8	0	872
4118	10	3	3	851	0	867
4119	849	8	4	7	0	868
4120	15	1	1	846	0	863
4121	845	3	2	14	0	864
4122	12	3	2	843	0	860
4123	841	5	1	14	0	861
4124	12	1	824	8	0	845
4125	6	7	8	830	0	851
4126	7	7	863	8	0	885
4127	9	2	805	7	0	823
4128	5	5	854	7	0	871
4129	4	4	6	861	0	875
4130	3	6	860	6	0	875
4131	861	3	8	10	0	882
4132	7	6	2	876	0	891
4133	7	4	932	11	0	954
4134	9	4	7	938	0	958
4135	6	2	1	964	0	973
4136	7	2	1026	11	0	1046
4137	8	2	6	1022	0	1038
4138	8	3	3	1030	0	1044
4139	6	1024	7	8	0	1045
4140	1022	6	6	12	0	1046
4141	1038	4	4	9	0	1055
4142	9	5	1003	8	0	1025
4143	1012	2	9	6	0	1029
4144	13	2	987	6	0	1008
4145	3	3	928	6	0	940
4146	9	3	934	7	0	953
4147	1	18	14	906	0	939
4148	3	1	933	9	0	946
4149	3	1	6	904	0	914
4150	4	0	2	929	0	935
4151	4	0	5	911	0	920
4152	4	2	0	923	0	929
4153	912	1	3	11	0	927
4154	908	0	2	2	0	912
4155	6	919	3	2	0	930
4156	8	5	1	936	0	950
4157	3	2	949	6	0	960
4158	6	962	9	1	0	978
4159	3	8	5	991	0	1007
4160	4	0	1002	13	0	1019
4161	3	1	12	984	0	1000
4162	1	3	995	11	0	1010
4163	3	1	977	1	0	982
4164	2	2	8	1009	0	1021
4165	3	1	2	1015	0	1021
4166	1023	1	2	11	0	1037
4167	12	1	1	1024	0	1038
4168	1011	1	1	15	0	1028
4169	10	1013	2	3	0	1028
4170	2	1039	1	2	0	1044
4171	3	8	1	1066	0	1078
4172	1058	1	2	12	0	1073
4173	9	1051	4	6	0	1070
4174	1	8	2	1097	0	1108
4175	1108	0	3	12	0	1123
4176	1127	0	2	3	0	1132
4177	1111	0	2	4	0	1117
4178	1097	1	3	6	0	1107
4179	1120	0	3	6	0	1129
4180	9	0	1069	2	0	1080
4181	0	3	1051	3	0	1057
4182	1	1064	9	3	0	1077
4183	3	13	2	1056	0	1074
4184	1	0	1099	9	0	1109
4185	1	1	1053	1	0	1056
4186	0	3	9	1060	0	1072
4187	0	2	1117	10	0	1129
4188	0	0	1139	2	0	1141
4189	1	1411	6	0	0	1418
4190	1428	16	2	4	0	1450
4191	18	1552	2	1	0	1573
4192	6	22	0	1618	0	1646
4193	1625	2	0	21	0	1648
4194	21	1654	0	2	0	1677
4195	8	20	1	1634	0	1663
4196	2	1	1655	23	0	1681
4197	1668	0	21	1	0	1690
4198	1689	1	2	3	0	1695
4199	1706	0	1	3	0	1710
4200	27	0	1	1690	0	1718
4201	3	1	1686	27	0	1717
4202	1	1691	26	3	0	1721
4203	5	25	1	1702	0	1733
4204	1692	2	2	24	0	1720
4205	25	1	1666	1	0	1693
4206	1	1642	23	3	0	1669
4207	1	19	1667	2	0	1689
4208	1636	2	19	2	0	1659
4209	1700	1	2	4	0	1707
4210	1689	2	0	6	0	1697
4211	30	1	1641	1	0	1673
4212	4	1624	27	4	0	1659
4213	8	24	2	1647	0	1681
4214	4	1	1	1666	0	1672
4215	1	0	4	1663	0	1668
4216	3	2	1630	24	0	1659
4217	1594	1	25	7	0	1627
4218	29	0	1639	3	0	1671
4219	1646	1	28	4	0	1679
4220	1697	2	4	3	0	1706
4221	1697	0	1	2	0	1700
4222	1683	2	2	3	0	1690
4223	32	0	1652	1	0	1685
4224	8	4	24	1655	0	1691
4225	3	5	1652	29	0	1689
4226	6	1613	22	2	0	1643
4227	2	1664	5	4	0	1675
4228	1646	28	1	7	0	1682
4229	1618	6	5	1	0	1630
4230	28	1643	3	4	0	1678
4231	1653	28	1	8	0	1690
4232	34	2	1513	5	0	1554
4233	1563	4	20	7	0	1594
4234	29	1589	5	4	0	1627
4235	1606	29	2	3	0	1640
4236	1559	2	4	4	0	1569
4237	37	3	4	1522	0	1566
4238	5	3	4	1543	0	1555
4239	1516	0	3	33	0	1552
4240	35	3	7	1516	0	1561
4241	1523	9	2	28	0	1562
4242	32	4	4	1526	0	1566
4243	1520	1	4	31	0	1556
4244	1515	4	5	6	0	1530
4245	38	1469	5	3	0	1515
4246	9	1524	8	6	0	1547
4247	1489	27	6	9	0	1531
4248	33	1474	9	7	0	1523
4249	9	31	9	1477	0	1526
4250	13	5	3	1484	0	1505
4251	1451	5	8	35	0	1499
4252	33	1447	1	7	0	1488
4253	11	1441	4	9	0	1465
4254	10	1455	8	6	0	1479
4255	16	26	1428	7	0	1477
4256	12	5	1439	8	0	1464
4257	14	6	1432	5	0	1457
4258	14	34	30	1274	0	1352
4259	14	1344	7	24	0	1389
4260	1348	26	3	5	0	1382
4261	33	7	1334	8	0	1382
4262	8	8	1324	8	0	1348
4263	6	6	1348	7	0	1367
4264	12	6	25	1335	0	1378
4265	8	7	9	1357	0	1381
4266	13	7	5	1364	0	1389
4267	1350	6	5	24	0	1385
4268	1350	5	8	3	0	1366
4269	1361	6	5	5	0	1377
4270	36	2	8	1308	0	1354
4271	13	2	1266	28	0	1309
4272	13	7	1301	7	0	1328
4273	10	7	27	1299	0	1343
4274	14	5	7	1292	0	1318
4275	1260	4	6	35	0	1305
4276	29	1239	7	11	0	1286
4277	1242	23	4	11	0	1280
4278	34	1243	4	8	0	1289
4279	15	26	6	1234	0	1281
4280	15	4	1232	29	0	1280
4281	16	9	23	1232	0	1280
4282	1251	5	3	28	0	1287
4283	36	6	1232	7	0	1281
4284	1182	7	23	9	0	1221
4285	27	6	1174	7	0	1214
4286	13	5	1131	4	0	1153
4287	1073	6	23	12	0	1114
4288	26	4	1067	8	0	1105
4289	9	1	776	4	0	790
4290	11	765	18	3	0	797
4291	640	17	20	3	0	680
4292	598	1	3	3	0	605
4293	592	1	2	4	0	599
4294	6	1	557	2	0	566
4295	539	1	6	2	0	548
4296	8	543	0	1	0	552
4297	533	4	1	1	0	539
4298	6	1	537	0	0	544
4299	5	5	2	512	0	524
4300	1	0	524	2	0	527
4301	3	522	3	0	0	528
4302	3	2	0	515	0	520
4303	0	1	1	524	0	526
4304	543	0	1	2	0	546
4305	543	2	0	1	0	546
4306	547	0	0	1	0	548
4307	543	0	0	1	0	544
4308	540	0	0	2	0	542
4309	1	1	539	0	0	541
4310	1	1	0	539	0	541
4311	0	2	549	1	0	552
4312	1	0	2	542	0	545
4313	550	0	1	1	0	552
4314	553	0	1	1	0	555
4315	567	0	1	1	0	569
4316	585	2	0	1	0	588
4317	2	0	614	0	0	616
4318	0	0	2	616	0	618
4319	2	0	606	1	0	609
4320	1	616	1	2	0	620
4321	1	622	1	1	0	625
4322	4	2	0	643	0	649
4323	3	0	0	675	0	678
4324	4	0	1	701	0	706
4325	2	0	0	728	0	730
4326	727	0	1	2	0	730
4327	2	725	0	4	0	731
4328	713	2	1	2	0	718
4329	7	0	1	709	0	717
4330	2	2	0	701	0	705
4331	3	717	0	4	0	724
4332	3	2	1	724	0	730
4333	715	0	0	6	0	721
4334	2	687	1	0	0	690
4335	0	690	0	2	0	692
4336	688	2	0	0	0	690
4337	3	0	0	684	0	687
4338	0	685	1	3	0	689
4339	3	2	0	701	0	706
4340	703	0	0	5	0	708
4341	4	2	0	694	0	700
4342	1	1	0	702	0	704
4343	705	0	0	2	0	707
4344	2	0	0	701	0	703
4345	0	687	0	7	0	694
4346	4	3	0	684	0	691
4347	0	678	0	7	0	685
4348	3	4	0	692	0	699
4349	689	1	0	4	0	694
4350	683	2	0	2	0	687
4351	2	0	0	698	0	700
4352	3	0	678	2	0	683
4353	678	1	1	0	0	680
4354	1	0	682	4	0	687
4355	678	1	4	2	0	685
4356	677	0	0	4	0	681
4357	1	0	676	2	0	679
4358	4	663	1	0	0	668
4359	680	1	1	3	0	685
4360	681	1	3	2	0	687
4361	1	5	699	1	0	706
4362	695	2	1	1	0	699
4363	685	0	0	4	0	689
4364	691	0	3	2	0	696
4365	5	1	0	688	0	694
4366	5	0	0	688	0	693
4367	3	685	1	4	0	693
4368	1	3	0	701	0	705
4369	0	2	0	702	0	704
4370	1	3	694	4	0	702
4371	3	1	654	4	0	662
4372	640	3	4	6	0	653
4373	669	1	3	4	0	677
4374	4	666	3	3	0	676
4375	7	2	0	667	0	676
4376	2	3	698	4	0	707
4377	2	2	2	711	0	717
4378	4	1	0	728	0	733
4379	1	3	3	743	0	750
4380	1	739	1	7	0	748
4381	2	4	0	756	0	762
4382	2	2	0	759	0	763
4383	2	6	736	3	0	747
4384	2	2	727	7	0	738
4385	719	1	3	5	0	728
4386	732	0	5	5	0	742
4387	5	2	3	770	0	780
4388	6	0	1	747	0	754
4389	5	0	0	769	0	774
4390	2	3	724	9	0	738
4391	0	713	6	7	0	726
4392	2	6	721	4	0	733
4393	720	1	6	4	0	731
4394	7	6	725	0	0	738
4395	725	0	9	4	0	738
4396	725	1	1	5	0	732
4397	735	0	5	3	0	743
4398	14	0	0	725	0	739
4399	7	0	720	5	0	732
4400	7	723	5	5	0	740
4401	3	8	3	716	0	730
4402	3	1	6	739	0	749
4403	1	8	763	6	0	778
4404	4	742	8	6	0	760
4405	776	8	3	7	0	794
4406	9	779	7	3	0	798
4407	844	12	0	2	0	858
4408	18	3	2	854	0	877
4409	8	5	872	11	0	896
4410	7	874	13	6	0	900
4411	879	10	4	10	0	903
4412	12	5	886	2	0	905
4413	891	6	10	6	0	913
4414	893	4	6	3	0	906
4415	13	0	892	6	0	911
4416	875	1	12	6	0	894
4417	852	1	6	4	0	863
4418	842	0	8	3	0	853
4419	19	822	4	4	0	849
4420	794	9	5	3	0	811
4421	16	788	4	1	0	809
4422	4	14	773	1	0	792
4423	8	762	8	0	0	778
4424	710	11	4	2	0	727
4425	723	4	3	1	0	731
4426	726	4	0	2	0	732
4427	17	0	0	707	0	724
4428	7	2	0	721	0	730
4429	710	0	1	12	0	723
4430	715	1	0	7	0	723
4431	15	0	1	699	0	715
4432	7	1	691	9	0	708
4433	4	663	8	4	0	679
4434	0	686	5	4	0	695
4435	5	10	3	679	0	697
4436	1	5	677	10	0	693
4437	2	3	10	661	0	676
4438	0	670	3	12	0	685
4439	4	8	2	671	0	685
4440	0	4	662	11	0	677
4441	1	3	7	664	0	675
4442	1	2	680	11	0	694
4443	1	2	12	678	0	693
4444	1	0	695	11	0	707
4445	3	1	688	3	0	695
4446	687	0	13	3	0	703
4447	698	1	5	1	0	705
4448	702	0	3	1	0	706
4449	15	687	1	0	0	703
4450	7	8	2	699	0	716
4451	675	4	3	8	0	690
4452	696	3	2	4	0	705
4453	700	0	0	6	0	706
4454	14	0	688	2	0	704
4455	7	670	10	3	0	690
4456	4	701	4	3	0	712
4457	691	10	4	2	0	707
4458	12	8	1	684	0	705
4459	685	2	0	10	0	697
4460	11	0	674	6	0	691
4461	6	2	12	662	0	682
4462	6	3	4	666	0	679
4463	6	1	3	651	0	661
4464	5	653	3	13	0	674
4465	653	8	0	8	0	669
4466	656	5	1	4	0	666
4467	10	641	5	1	0	657
4468	8	10	1	638	0	657
4469	646	4	0	9	0	659
4470	10	5	1	639	0	655
4471	643	3	1	9	0	656
4472	13	641	2	3	0	659
4473	630	10	3	4	0	647
4474	12	4	625	0	0	641
4475	8	630	6	1	0	645
4476	9	7	603	2	0	621
4477	6	10	15	580	0	611
4478	566	6	9	8	0	589
4479	569	4	1	6	0	580
4480	561	0	1	6	0	568
4481	13	2	2	550	0	567
4482	560	1	0	9	0	570
4483	11	2	3	555	0	571
4484	553	1	3	12	0	569
4485	563	3	2	3	0	571
4486	12	3	574	4	0	593
4487	7	0	540	0	0	547
4488	5	1	532	3	0	541
4489	3	3	9	511	0	526
4490	516	1	6	10	0	533
4491	7	0	2	537	0	546
4492	6	1	0	542	0	549
4493	580	0	2	9	0	591
4494	578	1	2	5	0	586
4495	573	0	3	6	0	582
4496	578	1	1	2	0	582
4497	11	1	0	571	0	583
4498	570	0	1	6	0	577
4499	7	566	1	4	0	578
4500	553	5	0	1	0	559
4501	555	3	5	2	0	565
4502	6	0	522	0	0	528
4503	487	0	3	2	0	492
4504	4	0	486	1	0	491
4505	2	0	444	3	0	449
4506	2	0	447	2	0	451
4507	4	12	7	349	0	372
4508	1	0	362	1	0	364
4509	2	1	0	332	0	335
4510	2	0	349	0	0	351
4511	0	3	374	0	0	377
4512	0	1	0	377	0	378
4513	1	0	0	381	0	382
4514	1	0	401	0	0	402
4515	383	0	0	1	0	384
4516	1	0	0	400	0	401
4517	0	0	1	403	0	404
4518	405	1	0	1	0	407
4519	1	1	0	416	0	418
4520	1	0	415	1	0	417
4521	0	0	390	1	0	391
4522	0	0	2	402	0	404
4523	0	0	424	1	0	425
4524	0	437	1	1	0	439
4525	0	1	0	436	0	437
4526	437	1	0	1	0	439
4527	1	0	430	1	0	432
4528	432	0	1	2	0	435
4529	1	0	1	447	0	449
4530	1	0	0	449	0	450
4531	0	0	0	451	0	451
4532	0	0	0	452	0	452
4533	455	0	0	3	0	458
4534	1	487	0	1	0	489
4535	0	3	0	495	0	498
4536	0	1	0	496	0	497
4537	0	0	0	498	0	498
4538	1	0	1	491	0	493
4539	493	0	0	3	0	496
4540	3	494	0	1	0	498
4541	490	3	0	0	0	493
4542	3	470	1	0	0	474
4543	1	478	0	0	0	479
4544	460	4	0	3	0	467
4545	4	1	475	1	0	481
4546	1	0	3	481	0	485
4547	487	0	1	6	0	494
4548	508	0	0	3	0	511
4549	484	1	1	4	0	490
4550	522	0	0	1	0	523
4551	3	554	0	0	0	557
4552	573	5	0	2	0	580
4553	594	1	0	1	0	596
4554	5	632	1	3	0	641
4555	1	6	0	653	0	660
4556	1	3	643	6	0	653
4557	3	0	6	650	0	659
4558	648	0	4	7	0	659
4559	8	0	655	3	0	666
4560	2	647	7	0	0	656
4561	1	8	657	0	0	666
4562	1	5	6	644	0	656
4563	0	653	3	7	0	663
4564	663	7	0	2	0	672
4565	6	667	2	0	0	675
4566	1	7	0	662	0	670
4567	2	3	0	684	0	689
4568	670	0	2	10	0	682
4569	7	2	1	663	0	673
4570	3	672	1	6	0	682
4571	677	7	1	7	0	692
4572	683	5	0	4	0	692
4573	11	681	0	1	0	693
4574	683	9	0	4	0	696
4575	7	686	0	4	0	697
4576	680	7	0	6	0	693
4577	9	691	0	2	0	702
4578	4	7	0	685	0	696
4579	1	6	0	699	0	706
4580	702	3	0	8	0	713
4581	721	0	0	5	0	726
4582	10	706	1	0	0	717
4583	4	8	704	3	0	719
4584	711	5	7	1	0	724
4585	11	1	4	714	0	730
4586	4	700	0	7	0	711
4587	3	7	0	704	0	714
4588	710	4	0	9	0	723
4589	716	1	0	5	0	722
4590	720	0	0	0	0	720
4591	11	4	0	696	0	711
4592	4	1	692	8	0	705
4593	652	0	8	2	0	662
4594	648	2	3	3	0	656
4595	670	2	0	6	0	678
4596	7	653	3	2	0	665
4597	5	8	0	670	0	683
4598	5	670	1	9	0	685
4599	3	8	2	683	0	696
4600	1	6	0	690	0	697
4601	1	0	737	12	0	750
4602	4	1	9	776	0	790
4603	3	2	3	801	0	809
4604	814	0	0	15	0	829
4605	11	828	0	4	0	843
4606	824	13	0	5	0	842
4607	860	5	0	5	0	870
4608	19	2	0	844	0	865
4609	5	0	851	17	0	873
4610	2	839	14	4	0	859
4611	4	812	5	3	0	824
4612	796	15	1	2	0	814
4613	16	791	0	1	0	808
4614	5	15	1	762	0	783
4615	3	6	2	774	0	785
4616	5	2	753	18	0	778
4617	3	5	752	6	0	766
4618	2	741	17	5	0	765
4619	0	14	5	750	0	769
4620	742	5	2	16	0	765
4621	19	1	0	752	0	772
4622	3	5	757	15	0	780
4623	4	4	14	743	0	765
4624	720	1	3	19	0	743
4625	729	0	1	8	0	738
4626	18	718	2	2	0	740
4627	719	13	1	4	0	737
4628	16	724	1	3	0	744
4629	724	16	0	3	0	743
4630	19	2	0	714	0	735
4631	5	1	709	16	0	731
4632	2	2	712	3	0	719
4633	5	722	14	2	0	743
4634	7	11	3	690	0	711
4635	7	3	1	706	0	717
4636	702	5	0	15	0	722
4637	712	1	1	5	0	719
4638	722	3	1	2	0	728
4639	16	1	0	720	0	737
4640	3	1	1	731	0	736
4641	1	1	3	739	0	744
4642	1	1	724	16	0	742
4643	4	1	719	5	0	729
4644	723	0	14	4	0	741
4645	706	3	1	2	0	712
4646	19	1	708	2	0	730
4647	701	0	12	2	0	715
4648	680	0	5	2	0	687
4649	13	1	656	3	0	673
4650	4	652	14	3	0	673
4651	9	16	4	630	0	659
4652	2	3	626	10	0	641
4653	3	629	11	3	0	646
4654	4	13	0	568	0	585
4655	2	583	3	9	0	597
4656	0	11	589	1	0	601
4657	1	2	580	2	0	585
4658	4	1	12	591	0	608
4659	589	1	2	10	0	602
4660	11	1	2	596	0	610
4661	585	2	1	13	0	601
4662	10	1	2	587	0	600
4663	4	1	582	11	0	598
4664	571	3	10	6	0	590
4665	11	2	578	2	0	593
4666	591	1	10	5	0	607
4667	13	1	2	574	0	590
4668	4	576	2	13	0	595
4669	1	13	1	590	0	605
4670	4	592	3	11	0	610
4671	3	12	2	566	0	583
4672	3	596	0	10	0	609
4673	591	11	2	6	0	610
4674	604	2	2	4	0	612
4675	597	2	1	2	0	602
4676	15	0	577	0	0	592
4677	5	2	10	579	0	596
4678	5	1	574	12	0	592
4679	3	562	12	4	0	581
4680	4	569	3	3	0	579
4681	558	12	5	2	0	577
4682	12	4	556	2	0	574
4683	3	554	12	4	0	573
4684	5	12	2	570	0	589
4685	569	1	4	16	0	590
4686	12	581	2	2	0	597
4687	590	12	1	3	0	606
4688	15	1	581	3	0	600
4689	4	3	13	599	0	619
4690	3	3	0	613	0	619
4691	3	1	3	643	0	650
4692	2	640	0	18	0	660
4693	6	12	1	635	0	654
4694	1	2	653	18	0	674
4695	2	2	16	648	0	668
4696	3	1	4	649	0	657
4697	2	2	3	641	0	648
4698	6	629	0	16	0	651
4699	3	9	2	625	0	639
4700	4	2	4	617	0	627
4701	2	560	1	15	0	578
4702	513	8	2	4	0	527
4703	9	498	1	3	0	511
4704	2	483	1	3	0	489
4705	4	16	1	469	0	490
4706	1	1	462	12	0	476
4707	436	2	6	2	0	446
4708	6	0	2	442	0	450
4709	2	0	447	8	0	457
4710	1	448	6	6	0	461
4711	1	8	2	455	0	466
4712	0	2	458	10	0	470
4713	3	1	8	464	0	476
4714	1	1	2	475	0	479
4715	464	2	2	8	0	476
4716	11	459	0	2	0	472
4717	457	7	2	2	0	468
4718	11	1	461	1	0	474
4719	1	464	7	3	0	475
4720	1	6	465	1	0	473
4721	7	3	8	468	0	486
4722	469	1	3	8	0	481
4723	7	2	1	467	0	477
4724	468	1	0	11	0	480
4725	481	1	2	2	0	486
4726	9	0	0	484	0	493
4727	3	2	513	7	0	525
4728	3	0	536	3	0	542
4729	2	2	7	545	0	556
4730	3	1	3	552	0	559
4731	552	1	4	7	0	564
4732	8	2	0	543	0	553
4733	3	535	1	7	0	546
4734	2	4	1	544	0	551
4735	2	2	1	552	0	557
4736	545	2	0	9	0	556
4737	8	554	0	4	0	566
4738	4	9	1	555	0	569
4739	2	1	1	554	0	558
4740	0	543	4	8	0	555
4741	1	7	0	547	0	555
4742	4	1	0	550	0	555
4743	1	544	0	9	0	554
4744	2	9	1	551	0	563
4745	0	1	1	555	0	557
4746	0	549	2	9	0	560
4747	0	7	0	552	0	559
4748	546	3	0	10	0	559
4749	549	2	0	4	0	555
4750	548	2	1	3	0	554
4751	533	2	1	3	0	539
4752	8	523	0	5	0	536
4753	502	6	0	0	0	508
4754	5	486	0	1	0	492
4755	0	485	3	0	0	488
4756	4	6	0	477	0	487
4757	0	1	486	5	0	492
4758	465	1	5	2	0	473
4759	479	1	0	1	0	481
4760	6	0	488	1	0	495
4761	504	0	5	0	0	509
4762	517	0	1	0	0	518
4763	7	496	0	0	0	503
4764	566	5	0	1	0	572
4765	6	1	0	554	0	561
4766	2	1	0	557	0	560
4767	1	1	0	557	0	559
4768	0	1	0	554	0	555
4769	541	0	0	9	0	550
4770	5	0	1	544	0	550
4771	3	0	1	548	0	552
4772	2	0	532	6	0	540
4773	514	0	6	2	0	522
4774	537	0	1	3	0	541
4775	541	0	1	0	0	542
4776	6	528	0	0	0	534
4777	3	531	0	0	0	534
4778	535	5	0	2	0	542
4779	5	2	0	533	0	540
4780	4	534	0	6	0	544
4781	1	4	0	531	0	536
4782	1	540	0	5	0	546
4783	531	5	0	7	0	543
4784	4	548	1	5	0	558
4785	1	6	1	541	0	549
4786	3	2	0	558	0	563
4787	1	1	577	7	0	586
4788	1	612	5	4	0	622
4789	5	6	1	620	0	632
4790	0	5	647	7	0	659
4791	1	1	625	3	0	630
4792	3	1	6	633	0	643
4793	0	0	5	632	0	637
4794	1	605	5	7	0	618
4795	0	630	1	6	0	637
4796	0	7	0	636	0	643
4797	629	5	0	6	0	640
4798	7	3	0	655	0	665
4799	671	0	0	11	0	682
4800	682	1	0	4	0	687
4801	689	1	2	4	0	696
4802	13	0	686	1	0	700
4803	695	1	6	1	0	703
4804	8	1	3	686	0	698
4805	3	0	3	692	0	698
4806	2	0	692	10	0	704
4807	1	1	672	6	0	680
4808	5	1	8	668	0	682
4809	0	653	7	7	0	667
4810	1	668	2	2	0	673
4811	0	8	1	668	0	677
4812	668	6	0	7	0	681
4813	6	4	0	673	0	683
4814	3	0	0	680	0	683
4815	5	672	1	10	0	688
4816	2	5	0	690	0	697
4817	2	2	688	9	0	701
4818	1	4	668	4	0	677
4819	675	2	8	4	0	689
4820	6	679	7	3	0	695
4821	664	5	4	4	0	677
4822	668	3	2	1	0	674
4823	10	2	1	653	0	666
4824	6	655	0	5	0	666
4825	3	7	0	672	0	682
4826	658	4	0	7	0	669
4827	6	640	0	5	0	651
4828	618	6	0	5	0	629
4829	7	620	0	2	0	629
4830	623	7	0	1	0	631
4831	612	5	0	1	0	618
4832	9	613	0	1	0	623
4833	5	6	1	611	0	623
4834	615	2	1	5	0	623
4835	6	1	593	3	0	603
4836	3	2	592	2	0	599
4837	2	8	9	582	0	601
4838	588	0	6	4	0	598
4839	4	0	3	591	0	598
4840	595	1	1	7	0	604
4841	6	1	602	4	0	613
4842	619	1	4	5	0	629
4843	620	2	1	3	0	626
4844	11	1	2	612	0	626
4845	5	1	1	619	0	626
4846	5	0	0	614	0	619
4847	2	624	0	8	0	634
4848	2	5	0	633	0	640
4849	1	3	1	635	0	640
4850	627	2	0	8	0	637
4851	629	1	1	6	0	637
4852	7	0	613	4	0	624
4853	610	0	5	3	0	618
4854	8	0	623	1	0	632
4855	599	0	7	1	0	607
4856	7	1	611	0	0	619
4857	3	1	599	2	0	605
4858	3	1	7	585	0	596
4859	2	2	590	4	0	598
4860	575	0	7	6	0	588
4861	5	0	3	597	0	605
4862	606	0	2	8	0	616
4863	610	0	1	4	0	615
4864	561	1	1	3	0	566
4865	567	0	1	6	0	574
4866	12	0	563	0	0	575
4867	6	1	5	569	0	581
4868	5	0	575	4	0	584
4869	4	1	6	575	0	586
4870	578	0	4	7	0	589
4871	5	1	2	580	0	588
4872	579	0	2	8	0	589
4873	6	1	1	589	0	597
4874	3	1	0	591	0	595
4875	585	0	1	8	0	594
4876	6	586	0	4	0	596
4877	595	4	0	5	0	604
4878	6	581	0	2	0	589
4879	4	7	0	588	0	599
4880	592	3	0	7	0	602
4881	6	4	591	2	0	603
4882	2	1	5	597	0	605
4883	594	0	2	6	0	602
4884	599	1	3	4	0	607
4885	7	0	1	586	0	594
4886	7	581	1	4	0	593
4887	3	557	0	7	0	567
4888	5	16	1	502	0	524
4889	516	6	0	4	0	526
4890	5	480	1	7	0	493
4891	5	467	0	0	0	472
4892	457	7	0	1	0	465
4893	4	457	0	0	0	461
4894	491	4	0	2	0	497
4895	6	4	1	490	0	501
4896	6	0	0	491	0	497
4897	0	487	0	10	0	497
4898	0	475	0	5	0	480
4899	455	8	0	0	0	463
4900	4	475	0	0	0	479
4901	5	515	1	0	0	521
4902	4	10	0	520	0	534
4903	523	8	0	4	0	535
4904	4	1	567	8	0	580
4905	574	0	9	1	0	584
4906	6	0	9	637	0	652
4907	10	0	648	7	0	665
4908	0	0	652	11	0	663
4909	1	2	18	657	0	678
4910	1	0	692	7	0	700
4911	693	0	8	13	0	714
4912	689	0	12	2	0	703
4913	19	0	684	0	0	703
4914	13	0	6	679	0	698
4915	2	0	13	680	0	695
4916	691	0	1	19	0	711
4917	9	0	0	675	0	684
4918	10	668	1	7	0	686
4919	676	5	0	15	0	696
4920	8	676	0	2	0	686
4921	13	686	2	2	0	703
4922	3	16	1	684	0	704
4923	1	12	1	682	0	696
4924	1	2	1	702	0	706
4925	0	1	678	21	0	700
4926	642	1	8	16	0	667
4927	7	648	15	2	0	672
4928	668	7	3	4	0	682
4929	660	10	0	4	0	674
4930	19	1	5	653	0	678
4931	17	644	2	10	0	673
4932	6	7	1	676	0	690
4933	2	13	4	671	0	690
4934	672	1	2	24	0	699
4935	675	2	1	17	0	695
4936	23	4	651	1	0	679
4937	681	1	8	4	0	694
4938	10	673	11	4	0	698
4939	688	8	2	5	0	703
4940	11	716	2	4	0	733
4941	12	12	0	699	0	723
4942	6	14	2	695	0	717
4943	4	695	0	22	0	721
4944	5	12	0	720	0	737
4945	3	13	3	716	0	735
4946	2	4	0	731	0	737
4947	0	698	0	28	0	726
4948	4	11	1	717	0	733
4949	6	15	1	717	0	739
4950	4	5	1	732	0	742
4951	5	2	697	25	0	729
4952	685	5	9	19	0	718
4953	10	7	711	7	0	735
4954	706	3	10	6	0	725
4955	15	3	708	7	0	733
4956	701	7	13	7	0	728
4957	712	5	15	5	0	737
4958	26	5	694	6	0	731
4959	22	3	10	694	0	729
4960	9	3	682	10	0	704
4961	670	2	8	20	0	700
4962	12	2	692	10	0	716
4963	17	7	678	6	0	708
4964	682	4	23	11	0	720
4965	12	671	14	13	0	710
4966	19	12	6	676	0	713
4967	683	13	3	15	0	714
4968	13	5	5	690	0	713
4969	18	5	3	689	0	715
4970	673	6	6	30	0	715
4971	684	2	2	24	0	712
4972	28	2	680	9	0	719
4973	18	2	685	7	0	712
4974	9	1	25	685	0	720
4975	7	4	702	13	0	726
4976	8	3	14	699	0	724
4977	9	0	16	686	0	711
4978	7	2	7	710	0	726
4979	693	1	5	28	0	727
4980	13	696	5	22	0	736
4981	699	11	4	8	0	722
4982	691	15	2	10	0	718
4983	25	688	3	11	0	727
4984	682	10	2	6	0	700
4985	14	8	666	6	0	694
4986	14	4	13	668	0	699
4987	672	4	14	11	0	701
4988	13	4	668	14	0	699
4989	674	4	9	6	0	693
4990	14	698	12	5	0	729
4991	764	5	3	10	0	782
4992	759	9	3	9	0	780
4993	18	773	3	7	0	801
4994	788	5	1	9	0	803
4995	11	12	4	794	0	821
4996	16	3	4	802	0	825
4997	789	2	4	22	0	817
4998	773	4	6	16	0	799
4999	21	769	3	7	0	800
5000	9	772	4	9	0	794
5001	3	14	1	714	0	732
5002	6	716	1	7	0	730
5003	4	755	2	6	0	767
5004	699	7	2	3	0	711
5005	7	710	4	0	0	721
5006	639	3	0	2	0	644
5007	3	655	0	0	0	658
5008	2	3	665	1	0	671
5009	0	667	1	3	0	671
5010	654	7	6	0	0	667
5011	641	0	0	2	0	643
5012	3	0	648	2	0	653
5013	3	0	3	627	0	633
5014	3	1	0	645	0	649
5015	0	2	651	4	0	657
5016	2	3	2	644	0	651
5017	2	1	663	3	0	669
5018	1	1	646	2	0	650
5019	662	0	3	4	0	669
5020	3	666	3	0	0	672
5021	667	2	0	2	0	671
5022	4	1	1	666	0	672
5023	2	1	684	2	0	689
5024	2	0	2	670	0	674
5025	0	679	2	1	0	682
5026	690	2	0	3	0	695
5027	692	0	0	2	0	694
5028	4	1	0	692	0	697
5029	3	2	682	2	0	689
5030	666	1	2	2	0	671
5031	4	676	0	1	0	681
5032	672	1	0	0	0	673
5033	3	2	0	669	0	674
5034	668	0	0	1	0	669
5035	1	1	1	657	0	660
5036	1	0	675	3	0	679
5037	1	1	650	1	0	653
5038	657	2	3	0	0	662
5039	4	673	1	0	0	678
5040	657	1	6	0	0	664
5041	654	2	0	1	0	657
5042	3	662	0	0	0	665
5043	656	2	0	2	0	660
5044	1	1	699	1	0	702
5045	1	0	1	700	0	702
5046	2	0	0	701	0	703
5047	0	1	0	711	0	712
5048	0	1	703	1	0	705
5049	0	1	699	1	0	701
5050	0	0	0	705	0	705
5051	0	699	0	1	0	700
5052	1	705	0	2	0	708
5053	719	2	0	0	0	721
5054	719	0	0	5	0	724
5055	1	748	0	0	0	749
5056	0	1	1	762	0	764
5057	0	4	0	761	0	765
5058	777	1	0	6	0	784
5059	3	0	0	814	0	817
5060	2	0	1	803	0	806
5061	3	2	0	808	0	813
5062	1	1	784	2	0	788
5063	0	1	753	3	0	757
5064	793	0	2	2	0	797
5065	4	0	1	829	0	834
5066	0	3	831	2	0	836
5067	2	1	810	0	0	813
5068	845	2	2	1	0	850
5069	9	0	925	1	0	935
5070	1	955	6	1	0	963
5071	2	6	3	1058	0	1069
5072	2	2	1054	7	0	1065
5073	1067	3	7	3	0	1080
5074	10	1	2	1124	0	1137
5075	5	2	1120	9	0	1136
5076	4	0	10	1157	0	1171
5077	3	2	3	1155	0	1163
5078	1165	0	1	13	0	1179
5079	11	1188	1	3	0	1203
5080	3	10	1	1181	0	1195
5081	1187	2	0	13	0	1202
5082	1193	1	0	5	0	1199
5083	1188	0	2	4	0	1194
5084	1212	0	2	1	0	1215
5085	14	0	2	1200	0	1216
5086	1192	0	1	15	0	1208
5087	1210	2	1	5	0	1218
5088	1162	1	1	6	0	1170
5089	1168	0	1	2	0	1171
5090	13	1110	0	4	0	1127
5091	3	1071	4	2	0	1080
5092	1	14	1	1069	0	1085
5093	1	1064	0	12	0	1077
5094	1065	11	0	5	0	1081
5095	15	3	0	1063	0	1081
5096	1066	2	0	17	0	1085
5097	1095	1	1	5	0	1102
5098	18	0	0	1115	0	1133
5099	11	0	1	1113	0	1125
5100	5	1095	1	17	0	1118
5101	1108	11	1	8	0	1128
5102	15	1096	2	5	0	1118
5103	1092	11	1	4	0	1108
5104	16	2	3	1113	0	1134
5105	7	2	1109	13	0	1131
5106	1102	3	11	6	0	1122
5107	1087	3	4	4	0	1098
5108	17	2	1059	3	0	1081
5109	6	2	1073	6	0	1087
5110	7	1	13	1054	0	1075
5111	1153	1	4	16	0	1174
5112	1196	2	2	9	0	1209
5113	1214	0	1	7	0	1222
5114	1228	1	0	3	0	1232
5115	25	1193	0	5	0	1223
5116	1238	16	0	3	0	1257
5117	22	6	1	1208	0	1237
5118	7	5	0	1222	0	1234
5119	9	2	0	1242	0	1253
5120	7	1	0	1261	0	1269
5121	1239	2	2	26	0	1269
5122	24	1	1	1292	0	1318
5123	10	3	1273	21	0	1307
5124	9	2	19	1312	0	1342
5125	7	2	6	1322	0	1337
5126	4	4	2	1333	0	1343
5127	6	1	3	1318	0	1328
5128	1295	4	1	26	0	1326
5129	28	1279	1	5	0	1313
5130	11	1312	2	7	0	1332
5131	7	25	2	1301	0	1335
5132	1294	6	3	19	0	1322
5133	1319	5	4	9	0	1337
5134	28	3	1	1311	0	1343
5135	8	3	1287	24	0	1322
5136	1291	1	18	10	0	1320
5137	23	1	4	1332	0	1360
5138	10	2	1333	24	0	1369
5139	1303	0	20	8	0	1331
5140	26	1333	6	5	0	1370
5141	1489	18	1	8	0	1516
5142	26	1531	2	8	0	1567
5143	15	23	3	1557	0	1598
5144	10	1570	0	28	0	1608
5145	10	26	1	1628	0	1665
5146	1585	14	2	40	0	1641
5147	24	1603	3	21	0	1651
5148	18	28	1585	10	0	1641
5149	16	13	23	1607	0	1659
5150	7	9	1612	34	0	1662
5151	7	9	28	1613	0	1657
5152	8	3	13	1643	0	1667
5153	8	5	1596	43	0	1652
5154	1526	5	29	26	0	1586
5155	33	5	1584	14	0	1636
5156	17	6	1570	9	0	1602
5157	10	1580	36	13	0	1639
5158	11	27	16	1587	0	1641
5159	7	12	11	1594	0	1624
5160	12	10	5	1580	0	1607
5161	7	6	7	1607	0	1627
5162	5	3	1548	51	0	1607
5163	1492	5	27	25	0	1549
5164	28	5	1560	19	0	1612
5165	21	1	28	1533	0	1583
5166	1510	3	18	33	0	1564
5167	32	1519	11	22	0	1584
5168	21	31	10	1481	0	1543
5169	1424	16	5	34	0	1479
5170	32	1359	9	14	0	1414
5171	12	1344	2	10	0	1368
5172	1320	26	3	15	0	1364
5173	25	1312	1	8	0	1346
5174	1266	23	6	9	0	1304
5175	23	1293	2	5	0	1323
5176	1290	24	5	11	0	1330
5177	1302	21	4	5	0	1332
5178	37	1299	1	12	0	1349
5179	21	23	3	1285	0	1332
5180	14	14	1265	20	0	1313
5181	1274	10	20	14	0	1318
5182	24	9	14	1271	0	1318
5183	18	1242	5	23	0	1288
5184	6	1268	5	17	0	1296
5185	9	26	0	1266	0	1301
5186	1245	16	4	26	0	1291
5187	22	6	1246	18	0	1292
5188	17	5	22	1262	0	1306
5189	13	6	13	1277	0	1309
5190	12	5	7	1291	0	1315
5191	4	6	6	1282	0	1298
5192	7	1240	3	39	0	1289
5193	7	18	3	1263	0	1291
5194	5	15	1236	28	0	1284
5195	3	9	1209	23	0	1244
5196	8	9	1219	11	0	1247
5197	3	9	28	1194	0	1234
5198	1161	5	18	21	0	1205
5199	19	8	1178	18	0	1223
5200	13	5	1195	8	0	1221
5201	10	1	30	1170	0	1211
5202	1179	4	20	24	0	1227
5203	15	1170	15	23	0	1223
5204	1161	18	5	11	0	1195
5205	22	18	5	1156	0	1201
5206	20	7	1176	19	0	1222
5207	10	17	18	1148	0	1193
5208	11	1160	18	23	0	1212
5209	1191	21	9	16	0	1237
5210	21	15	1185	14	0	1235
5211	14	1136	18	15	0	1183
5212	1117	16	19	10	0	1162
5213	22	12	10	1136	0	1180
5214	14	8	9	1148	0	1179
5215	1147	9	4	29	0	1189
5216	1143	3	6	22	0	1174
5217	1166	6	8	15	0	1195
5218	37	3	4	1138	0	1182
5219	24	1115	8	18	0	1165
5220	1125	13	6	25	0	1169
5221	21	1120	0	16	0	1157
5222	1081	18	3	9	0	1111
5223	21	1055	2	10	0	1088
5224	21	19	6	1037	0	1083
5225	1045	21	3	18	0	1087
5226	1053	8	4	19	0	1084
5227	1072	8	3	12	0	1095
5228	1074	9	2	6	0	1091
5229	1074	9	1	9	0	1093
5230	38	4	1039	8	0	1089
5231	26	4	13	1038	0	1081
5232	16	7	1045	15	0	1083
5233	14	10	1031	11	0	1066
5234	1031	6	21	10	0	1068
5235	1052	5	17	4	0	1078
5236	1033	7	10	1	0	1051
5237	29	5	6	1002	0	1042
5238	989	2	7	18	0	1016
5239	29	968	5	19	0	1021
5240	21	959	1	14	0	995
5241	14	813	0	7	0	834
5242	730	18	8	4	0	760
5243	8	744	4	7	0	763
5244	698	6	1	1	0	706
5245	676	5	2	1	0	684
5246	12	2	668	1	0	683
5247	8	0	7	660	0	675
5248	4	2	5	692	0	703
5249	708	0	1	10	0	719
5250	706	0	1	8	0	715
5251	12	0	1	707	0	720
5252	9	1	704	7	0	721
5253	2	2	698	6	0	708
5254	4	1	14	702	0	721
5255	3	0	4	703	0	710
5256	0	2	2	712	0	716
5257	685	0	1	12	0	698
5258	691	2	1	6	0	700
5259	13	677	1	2	0	693
5260	8	7	1	687	0	703
5261	2	5	0	684	0	691
5262	3	683	1	12	0	699
5263	3	6	0	691	0	700
5264	686	7	1	9	0	703
5265	9	0	1	683	0	693
5266	8	1	1	690	0	700
5267	673	2	1	11	0	687
5268	675	1	0	9	0	685
5269	683	1	1	4	0	689
5270	19	3	1	661	0	684
5271	10	1	624	6	0	641
5272	8	2	602	6	0	618
5273	4	1	599	2	0	606
5274	3	590	9	4	0	606
5275	564	5	3	2	0	574
5276	6	4	548	0	0	558
5277	534	2	4	2	0	542
5278	6	0	5	535	0	546
5279	512	2	2	5	0	521
5280	547	4	1	5	0	557
5281	9	548	2	2	0	561
5282	560	4	0	2	0	566
5283	557	4	1	4	0	566
5284	12	555	0	2	0	569
5285	9	3	1	562	0	575
5286	2	6	565	5	0	578
5287	3	0	4	562	0	569
5288	5	0	6	563	0	574
5289	558	2	3	9	0	572
5290	4	0	0	565	0	569
5291	7	563	2	6	0	578
5292	3	4	2	563	0	572
5293	2	5	0	575	0	582
5294	4	2	568	8	0	582
5295	3	549	4	6	0	562
5296	2	567	3	3	0	575
5297	556	9	1	4	0	570
5298	6	575	1	2	0	584
5299	6	7	3	560	0	576
5300	3	6	555	7	0	571
5301	2	560	6	6	0	574
5302	560	6	4	4	0	574
5303	10	5	2	560	0	577
5304	9	2	0	570	0	581
5305	2	1	558	11	0	572
5306	4	1	6	538	0	549
5307	4	1	6	542	0	553
5308	535	1	3	12	0	551
5309	503	1	2	10	0	516
5310	12	496	2	3	0	513
5311	461	6	1	4	0	472
5312	7	450	1	5	0	463
5313	6	8	1	418	0	433
5314	3	422	1	7	0	433
5315	3	415	2	5	0	425
5316	411	8	6	5	0	430
5317	405	5	0	3	0	413
5318	10	399	0	4	0	413
5319	403	7	0	3	0	413
5320	401	4	0	3	0	408
5321	408	1	2	2	0	413
5322	11	2	0	406	0	419
5323	408	3	0	9	0	420
5324	8	1	393	4	0	406
5325	397	2	5	2	0	406
5326	6	1	406	1	0	414
5327	5	1	7	410	0	423
5328	1	1	4	421	0	427
5329	1	1	412	8	0	422
5330	408	1	5	5	0	419
5331	424	1	4	2	0	431
5332	12	1	451	0	0	464
5333	4	1	5	443	0	453
5334	2	0	5	446	0	453
5335	4	0	3	453	0	460
5336	444	1	1	10	0	456
5337	447	2	0	4	0	453
5338	11	0	1	441	0	453
5339	3	414	0	12	0	429
5340	2	416	0	3	0	421
5341	402	5	2	3	0	412
5342	6	403	0	2	0	411
5343	2	397	0	2	0	401
5344	3	4	0	360	0	367
5345	1	0	360	4	0	365
5346	1	353	2	1	0	357
5347	1	9	0	347	0	357
5348	0	336	0	4	0	340
5349	0	4	0	325	0	329
5350	326	0	0	3	0	329
5351	3	333	0	0	0	336
5352	330	3	0	1	0	334
5353	334	0	0	1	0	335
5354	3	0	333	1	0	337
5355	322	1	3	0	0	326
5356	3	0	0	334	0	337
5357	0	1	332	3	0	336
5358	0	335	2	1	0	338
5359	1	2	0	334	0	337
5360	0	1	2	332	0	335
5361	333	0	0	3	0	336
5362	4	0	0	335	0	339
5363	0	0	1	340	0	341
5364	333	0	0	3	0	336
5365	3	330	0	1	0	334
5366	323	3	1	2	0	329
5367	3	1	323	0	0	327
5368	312	0	5	1	0	318
5369	3	0	333	1	0	337
5370	1	333	3	2	0	339
5371	346	3	0	1	0	350
5372	340	0	0	2	0	342
5373	3	0	340	0	0	343
5374	1	1	349	0	0	351
5375	1	0	371	0	0	372
5376	0	383	7	0	0	390
5377	1	6	0	387	0	394
5378	0	1	412	6	0	419
5379	0	3	413	0	0	416
5380	1	1	7	411	0	420
5381	0	2	414	7	0	423
5382	424	0	9	1	0	434
5383	513	1	1	2	0	517
5384	10	2	499	0	0	511
5385	1	500	9	1	0	511
5386	1	11	0	495	0	507
5387	1	1	492	11	0	505
5388	1	495	11	0	0	507
5389	1	13	1	497	0	512
5390	489	1	1	11	0	502
5391	498	1	0	2	0	501
5392	11	499	2	1	0	513
5393	1	10	1	504	0	516
5394	1	0	0	509	0	510
5395	2	1	1	503	0	507
5396	3	0	0	508	0	511
5397	2	1	494	11	0	508
5398	0	0	11	495	0	506
5399	0	1	487	12	0	500
5400	1	492	11	2	0	506
5401	487	10	1	3	0	501
5402	10	519	2	0	0	531
5403	1	9	0	516	0	526
5404	4	0	1	522	0	527
5405	515	2	1	9	0	527
5406	10	2	0	514	0	526
5407	1	521	0	11	0	533
5408	2	7	0	528	0	537
5409	2	0	1	538	0	541
5410	526	1	1	10	0	538
5411	9	0	519	2	0	530
5412	0	512	9	2	0	523
5413	1	525	1	2	0	529
5414	0	10	2	520	0	532
5415	514	1	1	8	0	524
5416	8	508	1	1	0	518
5417	0	9	1	511	0	521
5418	2	1	501	9	0	513
5419	3	1	7	507	0	518
5420	509	0	1	10	0	520
5421	508	3	1	1	0	513
5422	8	0	0	499	0	507
5423	505	0	2	12	0	519
5424	510	1	0	1	0	512
5425	9	0	498	1	0	508
5426	487	1	8	0	0	496
5427	9	488	0	1	0	498
5428	499	9	1	1	0	510
5429	11	0	486	1	0	498
5430	0	2	9	503	0	514
5431	513	0	0	10	0	523
5432	7	1	493	1	0	502
5433	2	0	500	2	0	504
5434	4	0	10	494	0	508
5435	1	0	499	9	0	509
5436	495	1	9	2	0	507
5437	13	0	497	0	0	510
5438	3	1	11	509	0	524
5439	2	0	5	524	0	531
5440	533	0	3	13	0	549
5441	11	1	540	3	0	555
5442	4	0	568	2	0	574
5443	2	2	14	599	0	617
5444	1	1	601	15	0	618
5445	607	0	10	7	0	624
5446	12	0	4	607	0	623
5447	1	2	618	8	0	629
5448	2	1	11	613	0	627
5449	3	1	4	621	0	629
5450	609	1	3	13	0	626
5451	12	1	602	4	0	619
5452	594	1	11	6	0	612
5453	11	1	614	5	0	631
5454	599	1	12	5	0	617
5455	612	1	2	5	0	620
5456	608	0	4	2	0	614
5457	13	598	2	3	0	616
5458	601	9	3	1	0	614
5459	615	1	3	1	0	620
5460	16	1	0	601	0	618
5461	5	1	600	10	0	616
5462	593	2	8	5	0	608
5463	11	2	612	4	0	629
5464	5	1	8	610	0	624
5465	4	0	2	630	0	636
5466	625	0	3	13	0	641
5467	11	643	3	3	0	660
5468	4	10	1	638	0	653
5469	4	2	2	643	0	651
5470	1	1	642	15	0	659
5471	2	3	8	641	0	654
5472	5	2	1	649	0	657
5473	2	2	3	642	0	649
5474	1	619	1	14	0	635
5475	596	7	2	4	0	609
5476	604	1	3	3	0	611
5477	8	596	2	5	0	611
5478	568	5	1	5	0	579
5479	6	3	1	605	0	615
5480	3	3	640	9	0	655
5481	5	649	6	4	0	664
5482	4	672	2	0	0	678
5483	613	6	5	0	0	624
5484	652	1	2	0	0	655
5485	7	0	1	664	0	672
5486	4	0	3	677	0	684
5487	4	2	0	676	0	682
5488	666	3	0	6	0	675
5489	7	1	659	1	0	668
5490	670	0	5	2	0	677
5491	8	0	2	682	0	692
5492	2	0	1	676	0	679
5493	2	661	3	9	0	675
5494	5	4	1	685	0	695
5495	3	1	4	687	0	695
5496	3	1	688	7	0	699
5497	5	693	4	7	0	709
5498	716	5	1	7	0	729
5499	700	5	2	3	0	710
5500	722	3	1	5	0	731
5501	719	0	1	7	0	727
5502	6	1	693	4	0	704
5503	691	2	7	3	0	703
5504	10	2	694	3	0	709
5505	7	1	7	689	0	704
5506	8	690	2	4	0	704
5507	9	4	1	691	0	705
5508	6	1	3	699	0	709
5509	6	4	698	3	0	711
5510	690	0	7	2	0	699
5511	701	0	3	5	0	709
5512	3	690	4	3	0	700
5513	2	9	686	4	0	701
5514	5	1	4	700	0	710
5515	3	1	705	8	0	717
5516	3	2	693	2	0	700
5517	6	0	3	706	0	715
5518	4	2	698	7	0	711
5519	2	4	8	701	0	715
5520	4	0	735	10	0	749
5521	5	0	8	732	0	745
5522	739	0	6	7	0	752
5523	731	2	3	7	0	743
5524	736	2	2	9	0	749
5525	730	1	3	2	0	736
5526	5	719	2	5	0	731
5527	5	4	3	739	0	751
5528	4	1	1	741	0	747
5529	5	4	735	7	0	751
5530	9	3	4	720	0	736
5531	5	1	714	8	0	728
5532	6	1	698	2	0	707
5533	685	3	7	1	0	696
5534	5	734	2	4	0	745
5535	734	5	3	4	0	746
5536	740	1	3	3	0	747
5537	8	750	0	5	0	763
5538	755	4	3	2	0	764
5539	8	0	755	1	0	764
5540	5	753	5	3	0	766
5541	744	7	11	4	0	766
5542	8	0	722	3	0	733
5543	699	3	4	1	0	707
5544	10	700	1	3	0	714
5545	707	4	2	2	0	715
5546	700	1	4	0	0	705
5547	6	691	0	0	0	697
5548	6	699	0	0	0	705
5549	2	722	2	0	0	726
5550	2	5	2	734	0	743
5551	1	2	0	725	0	728
5552	745	1	2	5	0	753
5553	741	0	2	3	0	746
5554	4	2	732	4	0	742
5555	2	2	703	1	0	708
5556	3	3	727	3	0	736
5557	1	0	4	740	0	745
5558	1	1	747	8	0	757
5559	5	0	5	746	0	756
5560	751	0	0	5	0	756
5561	6	1	755	0	0	762
5562	756	1	6	5	0	768
5563	763	2	2	2	0	769
5564	5	2	766	4	0	777
5565	1	799	6	1	0	807
5566	3	4	2	802	0	811
5567	4	0	807	7	0	818
5568	3	1	9	796	0	809
5569	4	0	3	864	0	871
5570	856	0	2	8	0	866
5571	8	2	2	847	0	859
5572	3	2	847	11	0	863
5573	6	0	7	844	0	857
5574	852	3	3	11	0	869
5575	8	853	2	6	0	869
5576	862	8	2	7	0	879
5577	11	7	5	859	0	882
5578	3	3	861	10	0	877
5579	7	1	830	0	0	838
5580	3	1	798	5	0	807
5581	2	788	12	1	0	803
5582	766	12	6	1	0	785
5583	9	751	3	0	0	763
5584	713	7	0	1	0	721
5585	9	707	0	0	0	716
5586	3	9	0	713	0	725
5587	3	0	0	724	0	727
5588	0	3	0	724	0	727
5589	0	708	0	9	0	717
5590	0	5	0	761	0	766
5591	4	0	0	889	0	893
5592	922	2	0	10	0	934
5593	17	1	0	972	0	990
5594	1	1	1017	14	0	1033
5595	1001	1	17	2	0	1021
5596	1052	0	0	4	0	1056
5597	17	1031	2	2	0	1052
5598	1032	16	0	2	0	1050
5599	1062	1	0	4	0	1067
5600	19	3	1	1042	0	1065
5601	4	3	1	1054	0	1062
5602	5	1	1	1069	0	1076
5603	1060	1	0	24	0	1085
5604	1075	0	0	6	0	1081
5605	20	2	1061	5	0	1088
5606	1054	1	18	2	0	1075
5607	1078	1	2	0	0	1081
5608	1066	0	1	6	0	1073
5609	24	1	1036	3	0	1064
5610	6	1	1049	2	0	1058
5611	8	0	19	1039	0	1066
5612	4	0	1057	19	0	1080
5613	1	0	22	1048	0	1071
5614	4	0	2	1015	0	1021
5615	4	1049	4	18	0	1075
5616	1049	19	4	6	0	1078
5617	20	1	1055	5	0	1081
5618	1050	3	22	4	0	1079
5619	26	2	2	1062	0	1092
5620	1039	0	4	20	0	1063
5621	22	1028	3	2	0	1055
5622	3	1064	3	7	0	1077
5623	5	21	2	1048	0	1076
5624	1	4	2	1068	0	1075
5625	3	3	1049	23	0	1078
5626	4	2	15	1055	0	1076
5627	1037	1	3	28	0	1069
5628	21	1049	3	2	0	1075
5629	5	18	1038	3	0	1064
5630	10	1	18	1031	0	1060
5631	4	4	1042	23	0	1073
5632	6	2	23	1036	0	1067
5633	1	2	1037	26	0	1066
5634	2	3	1012	3	0	1020
5635	2	2	20	1013	0	1037
5636	1015	2	6	22	0	1045
5637	1011	2	5	5	0	1023
5638	990	0	3	10	0	1003
5639	24	979	3	4	0	1010
5640	976	18	2	2	0	998
5641	977	2	5	4	0	988
5642	25	5	959	2	0	991
5643	7	948	19	4	0	978
5644	9	19	2	939	0	969
5645	930	2	5	22	0	959
5646	20	936	5	3	0	964
5647	946	21	3	6	0	976
5648	955	2	1	7	0	965
5649	941	4	3	0	0	948
5650	934	5	2	2	0	943
5651	26	3	2	910	0	941
5652	913	2	0	25	0	940
5653	26	1	2	892	0	921
5654	5	887	3	24	0	919
5655	7	17	5	896	0	925
5656	892	3	3	25	0	923
5657	24	1	890	5	0	920
5658	8	3	18	888	0	917
5659	892	1	2	20	0	915
5660	25	882	3	3	0	913
5661	870	21	2	6	0	899
5662	884	3	1	3	0	891
5663	22	875	1	6	0	904
5664	863	19	5	5	0	892
5665	25	4	810	5	0	844
5666	6	6	822	4	0	838
5667	799	5	20	3	0	827
5668	22	3	787	3	0	815
5669	6	2	17	742	0	767
5670	8	736	4	16	0	764
5671	754	15	1	5	0	775
5672	21	736	4	0	0	761
5673	4	739	4	4	0	751
5674	9	14	1	749	0	773
5675	7	3	2	750	0	762
5676	4	4	3	746	0	757
5677	3	3	4	742	0	752
5678	2	4	717	20	0	743
5679	6	1	19	696	0	722
5680	4	4	2	713	0	723
5681	683	2	4	15	0	704
5682	16	4	2	685	0	707
5683	5	1	669	17	0	692
5684	667	1	14	5	0	687
5685	16	5	2	669	0	692
5686	6	1	659	17	0	683
5687	5	1	15	662	0	683
5688	5	665	3	18	0	691
5689	660	14	1	7	0	682
5690	18	0	608	3	0	629
5691	4	467	11	3	0	485
5692	433	5	3	6	0	447
5693	7	365	2	1	0	375
5694	2	318	0	2	0	322
5695	308	4	3	0	0	315
5696	6	288	0	1	0	295
5697	1	284	1	1	0	287
5698	9	4	0	275	0	288
5699	1	0	272	2	0	275
5700	0	279	3	0	0	282
5701	1	0	0	272	0	273
5702	2	269	1	1	0	273
5703	265	2	0	1	0	268
5704	2	1	269	1	0	273
5705	2	0	1	267	0	270
5706	280	0	0	1	0	281
5707	2	1	0	285	0	288
5708	0	0	289	3	0	292
5709	264	0	1	1	0	266
5710	281	0	0	2	0	283
5711	2	310	0	1	0	313
5712	0	1	0	310	0	311
5713	1	0	0	323	0	324
5714	324	0	1	2	0	327
5715	315	0	0	1	0	316
5716	3	1	317	1	0	322
5717	1	318	2	0	0	321
5718	333	2	0	1	0	336
5719	4	0	0	333	0	337
5720	0	1	344	3	0	348
5721	1	2	324	1	0	328
5722	0	5	4	320	0	329
5723	327	0	1	3	0	331
5724	4	320	1	0	0	325
5725	362	3	0	0	0	365
5726	3	0	0	371	0	374
5727	0	0	0	375	0	375
5728	0	0	0	377	0	377
5729	378	0	0	3	0	381
5730	3	377	0	2	0	382
5731	0	2	0	390	0	392
5732	0	0	0	391	0	391
5733	0	0	405	3	0	408
5734	0	0	3	395	0	398
5735	0	0	409	3	0	412
5736	0	393	2	0	0	395
5737	0	3	0	403	0	406
5738	393	0	0	3	0	396
5739	3	0	400	0	0	403
5740	0	0	3	409	0	412
5741	0	0	405	3	0	408
5742	393	0	2	1	0	396
5743	3	0	416	0	0	419
5744	2	0	3	410	0	415
5745	410	1	0	3	0	414
5746	3	381	0	0	0	384
5747	399	3	0	0	0	402
5748	3	389	0	0	0	392
5749	0	3	0	420	0	423
5750	0	0	412	4	0	416
5751	0	0	435	0	0	435
5752	0	1	3	446	0	450
5753	453	0	0	3	0	456
5754	458	1	0	2	0	461
5755	4	0	0	461	0	465
5756	1	0	1	462	0	464
5757	460	0	0	4	0	464
5758	4	456	0	0	0	460
5759	0	488	0	1	0	489
5760	499	3	1	0	0	503
5761	4	0	502	0	0	506
5762	2	0	3	500	0	505
5763	0	1	494	3	0	498
5764	0	0	3	498	0	501
5765	0	0	511	4	0	515
5766	1	0	501	0	0	502
5767	1	0	4	517	0	522
5768	0	508	0	2	0	510
5769	527	4	0	0	0	531
5770	4	525	0	0	0	529
5771	1	2	0	537	0	540
5772	542	0	0	4	0	546
5773	3	0	1	567	0	571
5774	577	0	0	4	0	581
5775	579	0	0	0	0	579
5776	581	0	0	0	0	581
5777	5	565	0	0	0	570
5778	586	3	0	1	0	590
5779	3	3	0	602	0	608
5780	615	0	0	4	0	619
5781	4	0	0	649	0	653
5782	659	1	2	5	0	667
5783	674	0	0	1	0	675
5784	6	665	0	2	0	673
5785	0	3	1	737	0	741
5786	1	0	0	735	0	736
5787	0	787	1	6	0	794
5788	1	8	0	811	0	820
5789	829	0	0	10	0	839
5790	873	0	0	1	0	874
5791	851	1	2	3	0	857
5792	14	1	897	1	0	913
5793	951	0	13	2	0	966
5794	980	0	0	1	0	981
5795	988	1	2	2	0	993
5796	14	969	1	1	0	985
5797	3	9	0	987	0	999
5798	5	1	0	996	0	1002
5799	3	3	0	985	0	991
5800	2	1	966	15	0	984
5801	1	0	11	977	0	989
5802	983	1	0	17	0	1001
5803	16	0	3	982	0	1001
5804	5	0	0	1020	0	1025
5805	5	1	1005	14	0	1025
5806	3	997	12	4	0	1016
5807	1030	12	0	7	0	1049
5808	14	2	1	1039	0	1056
5809	1047	3	2	18	0	1070
5810	18	1	1039	4	0	1062
5811	1007	1	14	3	0	1025
5812	16	1059	0	4	0	1079
5813	3	13	1058	2	0	1076
5814	3	0	1056	3	0	1062
5815	7	2	12	1045	0	1066
5816	4	0	1083	13	0	1100
5817	2	1082	15	2	0	1101
5818	6	13	1	1088	0	1108
5819	2	0	2	1115	0	1119
5820	3	2	2	1107	0	1114
5821	1094	3	2	18	0	1117
5822	14	1107	2	4	0	1127
5823	3	13	1	1133	0	1150
5824	6	0	1	1150	0	1157
5825	1102	2	3	15	0	1122
5826	13	1117	2	4	0	1136
5827	1136	13	1	9	0	1159
5828	1134	2	1	3	0	1140
5829	1132	4	2	5	0	1143
5830	17	1	1103	6	0	1127
5831	7	1	14	1104	0	1126
5832	6	1123	3	13	0	1145
5833	5	1154	2	2	0	1163
5834	3	12	3	1144	0	1162
5835	3	1153	2	14	0	1172
5836	1236	14	1	8	0	1259
5837	14	4	1227	5	0	1250
5838	1218	4	13	7	0	1242
5839	1267	3	1	6	0	1277
5840	16	0	3	1278	0	1297
5841	1278	1	2	16	0	1297
5842	17	1383	1	5	0	1406
5843	1408	14	1	8	0	1431
5844	1426	2	0	7	0	1435
5845	1524	3	2	6	0	1535
5846	20	2	1525	4	0	1551
5847	12	6	1568	1	0	1587
5848	8	4	14	1591	0	1617
5849	6	1576	5	12	0	1599
5850	5	1612	6	3	0	1626
5851	6	13	3	1595	0	1617
5852	1611	5	2	17	0	1635
5853	17	5	2	1614	0	1638
5854	9	5	1	1623	0	1638
5855	1608	1	2	18	0	1629
5856	16	1621	4	6	0	1647
5857	3	16	1636	6	0	1661
5858	8	2	1612	4	0	1626
5859	1648	5	15	4	0	1672
5860	17	2	3	1635	0	1657
5861	6	2	1677	18	0	1703
5862	7	1	18	1654	0	1680
5863	5	4	1	1675	0	1685
5864	4	2	3	1704	0	1713
5865	6	2	2	1681	0	1691
5866	5	1658	1	21	0	1685
5867	4	13	5	1680	0	1702
5868	1671	4	4	18	0	1697
5869	17	1665	1	7	0	1690
5870	1693	15	3	7	0	1718
5871	1717	4	1	8	0	1730
5872	1714	4	2	5	0	1725
5873	18	4	1678	5	0	1705
5874	1678	1	15	6	0	1700
5875	1715	5	1	8	0	1729
5876	1691	0	5	7	0	1703
5877	1707	4	3	4	0	1718
5878	21	1683	2	3	0	1709
5879	1680	15	4	4	0	1703
5880	21	3	1674	4	0	1702
5881	8	3	13	1639	0	1663
5882	7	4	3	1656	0	1670
5883	1682	0	4	15	0	1701
5884	14	1661	3	12	0	1690
5885	1608	10	1	6	0	1625
5886	14	1631	1	3	0	1649
5887	1572	11	0	5	0	1588
5888	1567	2	1	5	0	1575
5889	11	1716	1	1	0	1729
5890	1722	10	2	12	0	1746
5891	1805	6	0	7	0	1818
5892	17	1707	0	2	0	1726
5893	6	1752	2	1	0	1761
5894	1867	14	2	4	0	1887
5895	20	6	0	1904	0	1930
5896	1926	1	0	20	0	1947
5897	1973	2	2	12	0	1989
5898	2000	4	1	3	0	2008
5899	2019	0	1	5	0	2025
5900	29	1954	3	4	0	1990
5901	12	2002	0	1	0	2015
5902	2024	22	1	4	0	2051
5903	21	11	2013	2	0	2047
5904	13	3	14	2010	0	2040
5905	4	3	10	2026	0	2043
5906	2013	1	2	28	0	2044
5907	21	1982	2	10	0	2015
5908	16	15	0	1989	0	2020
5909	5	9	3	2036	0	2053
5910	2028	2	0	29	0	2059
5911	21	4	0	2041	0	2066
5912	2023	1	2	23	0	2049
5913	2029	1	1	14	0	2045
5914	2036	2	0	5	0	2043
5915	34	1	0	2014	0	2049
5916	14	2	0	2039	0	2055
5917	6	3	2157	30	0	2196
5918	7	4	2103	11	0	2125
5919	2154	2	34	6	0	2196
5920	33	2	14	2204	0	2253
5921	18	3	2310	30	0	2361
5922	5	1	2331	16	0	2353
5923	11	1	53	2312	0	2377
5924	7	3	2312	37	0	2359
5925	10	3	38	2307	0	2358
5926	4	4	18	2307	0	2333
5927	7	0	2284	58	0	2349
5928	4	2	38	2301	0	2345
5929	15	3	23	2247	0	2288
5930	12	6	5	2341	0	2364
5931	11	2	2273	62	0	2348
5932	7	4	35	2317	0	2363
5933	2298	0	18	52	0	2368
5934	46	2296	4	35	0	2381
5935	2316	40	5	10	0	2371
5936	48	18	2249	9	0	2324
5937	2271	5	42	12	0	2330
5938	2305	5	19	8	0	2337
5939	2289	5	6	9	0	2309
5940	67	5	12	2219	0	2303
5941	29	4	7	2260	0	2300
5942	15	1	2084	67	0	2167
5943	2046	2	43	27	0	2118
5944	52	2034	21	12	0	2119
5945	23	1960	3	19	0	2005
5946	14	1984	8	13	0	2019
5947	13	60	7	1880	0	1960
5948	1846	20	5	55	0	1926
5949	1877	6	3	30	0	1916
5950	63	5	1832	7	0	1907
5951	28	6	40	1842	0	1916
5952	15	3	18	1868	0	1904
5953	10	6	1810	67	0	1893
5954	20	3	1783	22	0	1828
5955	1778	3	61	16	0	1858
5956	53	1784	21	11	0	1869
5957	1802	39	7	17	0	1865
5958	1826	14	9	13	0	1862
5959	62	3	10	1785	0	1860
5960	30	2	5	1820	0	1857
5961	1738	5	14	62	0	1819
5962	53	6	4	1745	0	1808
5963	25	5	4	1763	0	1797
5964	1721	3	8	68	0	1800
5965	48	4	8	1733	0	1793
5966	1738	2	4	55	0	1799
5967	1757	3	7	30	0	1797
5968	60	3	1708	18	0	1789
5969	1724	3	47	16	0	1790
5970	1731	2	22	20	0	1775
5971	1731	6	13	14	0	1764
5972	75	12	1437	16	0	1540
5973	1669	3	37	14	0	1723
5974	59	1643	17	11	0	1730
5975	1683	40	7	15	0	1745
5976	1711	13	9	17	0	1750
5977	72	3	7	1672	0	1754
5978	29	3	7	1698	0	1737
5979	14	1673	8	69	0	1764
5980	23	39	6	1693	0	1761
5981	16	20	7	1729	0	1772
5982	1688	9	6	66	0	1769
5983	55	7	7	1659	0	1728
5984	33	4	5	1671	0	1713
5985	18	6	6	1673	0	1703
5986	23	1580	8	66	0	1677
5987	1574	40	10	26	0	1650
5988	56	1577	4	24	0	1661
5989	1388	37	6	14	0	1445
5990	44	15	1316	12	0	1387
5991	1251	6	37	13	0	1307
5992	50	5	1248	9	0	1312
5993	26	1198	38	9	0	1271
5994	1080	30	36	9	0	1155
5995	1038	12	13	9	0	1072
5996	43	989	3	10	0	1045
5997	17	980	4	4	0	1005
5998	951	34	9	6	0	1000
5999	969	9	4	8	0	990
6000	41	3	4	957	0	1005
6001	13	5	3	980	0	1001
6002	12	4	940	36	0	992
6003	918	6	27	14	0	965
6004	37	1	6	913	0	957
6005	14	914	4	28	0	960
6006	10	25	1	916	0	952
6007	6	8	5	934	0	953
6008	8	5	892	37	0	942
6009	7	6	26	880	0	919
6010	862	5	7	31	0	905
6011	32	835	4	11	0	882
6012	10	850	1	12	0	873
6013	842	29	9	3	0	883
6014	856	9	7	5	0	877
6015	856	5	3	5	0	869
6016	42	798	2	8	0	850
6017	8	672	2	4	0	686
6018	687	14	6	2	0	709
6019	692	5	2	1	0	700
6020	23	640	1	3	0	667
6021	2	526	0	3	0	531
6022	511	9	4	3	0	527
6023	6	2	0	508	0	516
6024	504	1	0	11	0	516
6025	8	0	2	511	0	521
6026	2	501	0	10	0	513
6027	3	503	1	1	0	508
6028	531	7	1	3	0	542
6029	548	1	1	4	0	554
6030	565	1	1	1	0	568
6031	10	552	0	1	0	563
6032	3	7	513	0	0	523
6033	3	513	5	0	0	521
6034	492	7	3	0	0	502
6035	483	0	1	1	0	485
6036	6	1	479	0	0	486
6037	2	465	5	0	0	472
6038	2	5	0	464	0	471
6039	0	1	1	465	0	467
6040	2	434	0	5	0	441
6041	1	5	444	2	0	452
6042	461	1	5	3	0	470
6043	7	2	1	468	0	478
6044	472	0	1	6	0	479
6045	478	0	0	1	0	479
6046	6	2	0	488	0	496
6047	5	1	1	514	0	521
6048	3	2	0	522	0	527
6049	6	0	0	521	0	527
6050	498	2	0	10	0	510
6051	506	1	2	3	0	512
6052	8	4	507	2	0	521
6053	4	0	8	507	0	519
6054	4	0	1	519	0	524
6055	2	2	3	517	0	524
6056	0	3	504	10	0	517
6057	4	0	8	498	0	510
6058	493	1	0	13	0	507
6059	10	3	1	494	0	508
6060	3	0	499	10	0	512
6061	3	1	8	498	0	510
6062	2	1	501	11	0	515
6063	513	0	9	5	0	527
6064	11	1	1	514	0	527
6065	513	1	1	11	0	526
6066	513	1	1	2	0	517
6067	11	1	1	503	0	516
6068	511	1	0	12	0	524
6069	13	0	0	502	0	515
6070	5	517	1	10	0	533
6071	537	9	3	2	0	551
6072	536	2	0	4	0	542
6073	539	1	0	5	0	545
6074	11	1	1	529	0	542
6075	3	2	3	525	0	533
6076	2	0	1	535	0	538
6077	4	0	508	12	0	524
6078	1	505	9	6	0	521
6079	0	11	3	496	0	510
6080	2	0	483	12	0	497
6081	477	1	11	2	0	491
6082	13	1	1	481	0	496
6083	5	0	474	12	0	491
6084	494	0	11	2	0	507
6085	12	0	0	502	0	514
6086	2	1	1	515	0	519
6087	5	0	1	513	0	519
6088	506	0	1	13	0	520
6089	517	2	1	4	0	524
6090	504	1	1	2	0	508
6091	12	486	0	4	0	502
6092	5	495	2	1	0	503
6093	498	8	1	5	0	512
6094	9	7	503	2	0	521
6095	4	2	10	507	0	523
6096	6	1	2	519	0	528
6097	511	2	1	12	0	526
6098	495	0	3	4	0	502
6099	11	487	2	8	0	508
6100	3	8	1	491	0	503
6101	4	0	485	12	0	501
6102	0	3	488	3	0	494
6103	6	1	10	489	0	506
6104	3	0	3	507	0	513
6105	495	0	2	12	0	509
6106	10	1	1	508	0	520
6107	514	0	1	16	0	531
6108	519	1	0	4	0	524
6109	12	0	518	2	0	532
6110	526	3	8	4	0	541
6111	540	2	0	3	0	545
6112	547	0	2	3	0	552
6113	14	536	3	1	0	554
6114	4	546	0	5	0	555
6115	2	14	2	545	0	563
6116	7	2	541	7	0	557
6117	4	517	9	4	0	534
6118	1	8	3	488	0	500
6119	1	2	7	485	0	495
6120	2	483	3	11	0	499
6121	485	8	2	4	0	499
6122	488	1	1	6	0	496
6123	9	4	491	4	0	508
6124	492	1	8	1	0	502
6125	11	0	486	3	0	500
6126	472	0	11	1	0	484
6127	10	0	485	4	0	499
6128	2	459	9	3	0	473
6129	8	6	4	432	0	450
6130	3	1	0	440	0	444
6131	440	1	1	7	0	449
6132	445	1	0	2	0	448
6133	439	0	2	2	0	443
6134	9	0	447	1	0	457
6135	3	0	6	455	0	464
6136	2	0	1	464	0	467
6137	469	1	0	8	0	478
6138	7	471	0	1	0	479
6139	503	5	0	4	0	512
6140	6	1	1	525	0	533
6141	3	1	1	543	0	548
6142	1	1	0	536	0	538
6143	2	0	1	534	0	537
6144	1	1	0	539	0	541
6145	1	525	0	7	0	533
6146	1	503	0	5	0	509
6147	0	484	1	1	0	486
6148	1	2	1	488	0	492
6149	0	1	481	2	0	484
6150	464	0	2	0	0	466
6151	2	501	1	0	0	504
6152	2	2	0	494	0	498
6153	0	0	0	502	0	502
6154	513	0	0	6	0	519
6155	508	0	0	2	0	510
6156	523	0	0	1	0	524
6157	5	0	0	539	0	544
6158	1	0	544	4	0	549
6159	0	0	571	1	0	572
6160	1	0	5	575	0	581
6161	1	0	591	4	0	596
6162	577	1	4	2	0	584
6163	6	0	1	577	0	584
6164	1	0	583	4	0	588
6165	1	0	4	575	0	580
6166	0	0	607	4	0	611
6167	1	2	642	2	0	647
6168	0	0	5	707	0	712
6169	0	0	786	7	0	793
6170	0	0	764	1	0	765
6171	2	748	10	0	0	760
6172	5	8	1	762	0	776
6173	830	2	0	10	0	842
6174	7	0	1	841	0	849
6175	3	0	1	861	0	865
6176	1	1	862	9	0	873
6177	830	0	7	5	0	842
6178	8	0	2	875	0	885
6179	3	0	1	886	0	890
6180	878	0	0	11	0	889
6181	8	0	1	892	0	901
6182	901	0	0	11	0	912
6183	907	0	0	6	0	913
6184	907	0	0	3	0	910
6185	14	886	0	0	0	900
6186	897	8	0	2	0	907
6187	10	895	0	0	0	905
6188	7	8	0	912	0	927
6189	916	4	0	9	0	929
6190	7	912	0	4	0	923
6191	926	8	1	2	0	937
6192	7	923	0	0	0	930
6193	919	9	0	1	0	929
6194	9	900	0	2	0	911
6195	4	925	0	0	0	929
6196	1	985	0	0	0	986
6197	1	13	0	959	0	973
6198	4	993	0	6	0	1003
6199	1	12	0	988	0	1001
6200	3	12	0	989	0	1004
6201	0	5	0	987	0	992
6202	2	2	0	1022	0	1026
6203	1015	4	0	16	0	1035
6204	1018	3	0	9	0	1030
6205	17	3	1011	2	0	1033
6206	1029	6	9	6	0	1050
6207	1121	3	5	7	0	1136
6208	1185	3	1	5	0	1194
6209	20	0	1178	6	0	1204
6210	9	3	1189	0	0	1201
6211	1203	1	20	6	0	1230
6212	18	0	1243	5	0	1266
6213	11	1300	18	3	0	1332
6214	5	17	5	1329	0	1356
6215	1367	5	3	20	0	1395
6216	1370	2	6	12	0	1390
6217	1385	2	10	4	0	1401
6218	34	2	2	1394	0	1432
6219	18	0	4	1412	0	1434
6220	9	5	1408	26	0	1448
6221	8	0	21	1435	0	1464
6222	8	2	9	1457	0	1476
6223	1431	0	2	32	0	1465
6224	27	1420	7	8	0	1462
6225	1434	22	1	13	0	1470
6226	23	6	1	1453	0	1483
6227	1436	4	6	23	0	1469
6228	1430	3	0	14	0	1447
6229	1413	3	2	10	0	1428
6230	31	1374	2	10	0	1417
6231	12	1439	2	5	0	1458
6232	11	24	4	1436	0	1475
6233	1424	6	1	31	0	1462
6234	32	5	2	1421	0	1460
6235	20	5	1	1435	0	1461
6236	7	7	1413	30	0	1457
6237	11	5	18	1402	0	1436
6238	3	8	6	1424	0	1441
6239	7	0	1	1412	0	1420
6240	10	3	1363	30	0	1406
6241	5	1	1351	17	0	1374
6242	2	1357	26	14	0	1399
6243	1366	24	13	8	0	1411
6244	23	8	3	1386	0	1420
6245	12	3	1377	26	0	1418
6246	5	6	16	1374	0	1401
6247	11	3	13	1434	0	1461
6248	1419	2	8	27	0	1456
6249	1416	7	5	15	0	1443
6250	33	1409	8	9	0	1459
6251	1396	23	5	16	0	1440
6252	1398	7	13	10	0	1428
6253	35	7	8	1395	0	1445
6254	11	9	1385	29	0	1434
6255	18	1379	17	15	0	1429
6256	1395	20	9	12	0	1436
6257	1411	15	3	9	0	1438
6258	39	1393	3	18	0	1453
6259	19	21	1	1480	0	1521
6260	1511	7	7	36	0	1561
6261	1519	1	10	17	0	1547
6262	39	13	1	1516	0	1569
6263	1546	3	3	41	0	1593
6264	1621	6	4	17	0	1648
6265	1637	8	4	10	0	1659
6266	47	4	1608	15	0	1674
6267	23	1584	26	6	0	1639
6268	25	1568	8	6	0	1607
6269	1494	31	3	10	0	1538
6270	38	1496	4	8	0	1546
6271	21	32	1482	5	0	1540
6272	15	14	25	1489	0	1543
6273	1446	4	11	34	0	1495
6274	32	9	3	1438	0	1482
6275	1426	11	3	36	0	1476
6276	1438	0	5	21	0	1464
6277	1450	5	2	13	0	1470
6278	35	1383	15	14	0	1447
6279	11	1465	6	20	0	1502
6280	1471	32	5	9	0	1517
6281	1476	7	6	14	0	1503
6282	1478	10	3	6	0	1497
6283	40	8	5	1437	0	1490
6284	1446	2	2	31	0	1481
6285	35	1412	5	11	0	1463
6286	12	1446	4	11	0	1473
6287	17	29	3	1442	0	1491
6288	17	8	1412	31	0	1468
6289	16	4	1410	7	0	1437
6290	7	12	28	1416	0	1463
6291	8	4	1419	29	0	1460
6292	12	4	27	1424	0	1467
6293	1432	5	7	28	0	1472
6294	29	2	4	1439	0	1474
6295	1412	4	8	28	0	1452
6296	30	1355	5	8	0	1398
6297	15	25	1391	6	0	1437
6298	8	8	27	1373	0	1416
6299	8	5	5	1417	0	1435
6300	13	4	1392	33	0	1442
6301	11	3	23	1368	0	1405
6302	8	1384	7	27	0	1426
6303	8	25	0	1416	0	1449
6304	9	5	4	1438	0	1456
6305	10	1	2	1474	0	1487
6306	6	7	1442	37	0	1492
6307	4	2	1351	15	0	1372
6308	1247	1	27	7	0	1282
6309	23	0	1235	4	0	1262
6310	6	1238	23	3	0	1270
6311	1208	17	13	4	0	1242
6312	23	1212	3	2	0	1240
6313	1151	16	0	2	0	1169
6314	1137	4	4	3	0	1148
6315	1134	3	1	0	0	1138
6316	1133	2	0	2	0	1137
6317	22	1096	1	3	0	1122
6318	9	1099	0	2	0	1110
6319	1103	19	0	3	0	1125
6320	20	5	1066	1	0	1092
6321	7	3	16	1070	0	1096
6322	5	4	4	1087	0	1100
6323	4	2	1089	22	0	1117
6324	1050	2	15	4	0	1071
6325	1095	2	8	1	0	1106
6326	1084	3	1	5	0	1093
6327	22	1070	3	2	0	1097
6328	1108	17	2	5	0	1132
6329	23	6	1	1083	0	1113
6330	7	1161	3	16	0	1187
6331	1159	16	1	7	0	1183
6332	1189	7	0	4	0	1200
6333	1294	2	1	2	0	1299
6334	32	6	0	1267	0	1305
6335	12	5	1	1277	0	1295
6336	9	1236	2	28	0	1275
6337	7	21	1259	7	0	1294
6338	6	9	21	1265	0	1301
6339	6	2	5	1265	0	1278
6340	10	1	3	1301	0	1315
6341	7	3	1263	30	0	1303
6342	1256	2	22	13	0	1293
6343	24	4	9	1279	0	1316
6344	13	5	1287	23	0	1328
6345	4	4	27	1295	0	1330
6346	1326	1	11	26	0	1364
6347	24	1318	6	13	0	1361
6348	8	24	4	1367	0	1403
6349	7	7	1357	31	0	1402
6350	1340	2	24	14	0	1380
6351	1377	4	7	7	0	1395
6352	33	7	1358	6	0	1404
6353	13	4	27	1314	0	1358
6354	5	1337	9	25	0	1376
6355	1350	26	5	9	0	1390
6356	26	8	1324	9	0	1367
6357	1315	3	25	7	0	1350
6358	28	5	1289	6	0	1328
6359	11	2	1195	10	0	1218
6360	1170	2	23	2	0	1197
6361	18	1188	6	12	0	1224
6362	10	16	1171	2	0	1199
6363	3	1137	18	10	0	1168
6364	5	14	1101	2	0	1122
6365	3	1104	17	4	0	1128
6366	1046	16	14	5	0	1081
6367	12	6	1032	5	0	1055
6368	8	5	1038	5	0	1056
6369	5	2	1013	1	0	1021
6370	993	3	15	4	0	1015
6371	1000	1	9	7	0	1017
6372	16	1	6	992	0	1015
6373	8	2	1020	15	0	1045
6374	7	1	1030	4	0	1042
6375	1030	2	18	3	0	1053
6376	19	0	6	1034	0	1059
6377	1031	3	6	13	0	1053
6378	1035	1	2	6	0	1044
6379	20	1	4	976	0	1001
6380	9	972	4	15	0	1000
6381	5	13	2	987	0	1007
6382	6	6	4	999	0	1015
6383	6	2	987	18	0	1013
6384	3	972	13	8	0	996
6385	5	994	4	1	0	1004
6386	4	16	6	979	0	1005
6387	2	7	987	14	0	1010
6388	3	995	16	7	0	1021
6389	3	17	989	5	0	1014
6390	975	7	18	2	0	1002
6391	1001	5	10	3	0	1019
6392	17	3	981	3	0	1004
6393	976	5	18	1	0	1000
6394	20	3	6	998	0	1027
6395	9	1041	5	15	0	1070
6396	4	15	6	1049	0	1074
6397	1012	5	6	17	0	1040
6398	1017	2	4	9	0	1032
6399	1024	2	1	5	0	1032
6400	1010	1	3	6	0	1020
6401	22	988	4	5	0	1019
6402	7	969	5	8	0	989
6403	970	19	3	1	0	993
6404	15	7	978	4	0	1004
6405	10	16	10	963	0	999
6406	7	1010	8	13	0	1038
6407	4	16	4	1007	0	1031
6408	5	1033	4	12	0	1054
6409	2	15	1	1045	0	1063
6410	4	6	1031	16	0	1057
6411	1027	5	16	6	0	1054
6412	1049	6	7	5	0	1067
6413	17	5	1038	3	0	1063
6414	1029	5	13	5	0	1052
6415	1036	3	7	2	0	1048
6416	19	3	1015	2	0	1039
6417	9	0	17	1008	0	1034
6418	1024	3	7	13	0	1047
6419	22	1	1017	5	0	1045
6420	10	3	17	1000	0	1030
6421	11	3	1055	14	0	1083
6422	6	2	1056	7	0	1071
6423	1044	3	25	5	0	1077
6424	1073	3	6	7	0	1089
6425	1077	4	5	3	0	1089
6426	1113	0	7	4	0	1124
6427	24	3	5	1080	0	1112
6428	12	1020	5	17	0	1054
6429	8	1047	3	3	0	1061
6430	10	17	2	994	0	1023
6431	1019	4	5	13	0	1041
6432	17	973	5	8	0	1003
6433	3	938	5	2	0	948
6434	926	11	1	2	0	940
6435	15	7	1	914	0	937
6436	915	2	5	13	0	935
6437	15	914	3	1	0	933
6438	919	13	2	3	0	937
6439	15	3	978	2	0	998
6440	1069	10	13	6	0	1098
6441	1125	1	1	1	0	1128
6442	1164	2	3	3	0	1172
6443	27	2	1060	6	0	1095
6444	1128	3	14	0	0	1145
6445	26	1117	4	2	0	1149
6446	7	20	1110	1	0	1138
6447	9	8	19	1046	0	1082
6448	5	5	5	1025	0	1040
6449	7	1024	3	18	0	1052
6450	4	22	3	1035	0	1064
6451	5	4	1	1055	0	1065
6452	0	2	1022	24	0	1048
6453	995	2	18	9	0	1024
6454	20	2	1035	6	0	1063
6455	6	1	19	1032	0	1058
6456	6	0	1046	19	0	1071
6457	8	1	24	1048	0	1081
6458	1063	2	6	25	0	1096
6459	1091	2	7	5	0	1105
6460	27	1	3	1073	0	1104
6461	7	1	1097	26	0	1131
6462	7	3	23	1100	0	1133
6463	6	0	1083	28	0	1117
6464	1067	3	24	8	0	1102
6465	1098	1	8	6	0	1113
6466	1075	1	4	8	0	1088
6467	1082	1	5	7	0	1095
6468	28	1036	5	4	0	1073
6469	11	19	5	1059	0	1094
6470	1053	1	2	27	0	1083
6471	31	1030	5	2	0	1068
6472	13	1061	0	5	0	1079
6473	5	25	1004	6	0	1040
6474	989	6	25	5	0	1025
6475	1030	6	3	5	0	1044
6476	25	6	994	4	0	1029
6477	9	4	22	991	0	1026
6478	7	4	6	1006	0	1023
6479	8	1	994	27	0	1030
6480	13	1	26	988	0	1028
6481	1006	3	5	26	0	1040
6482	24	3	978	11	0	1016
6483	8	1	995	8	0	1012
6484	985	2	26	6	0	1019
6485	24	4	986	5	0	1019
6486	976	1	27	4	0	1008
6487	29	971	6	3	0	1009
6488	984	22	7	4	0	1017
6489	27	3	8	967	0	1005
6490	9	4	5	992	0	1010
6491	983	2	2	26	0	1013
6492	28	3	6	975	0	1012
6493	975	2	2	28	0	1007
6494	29	980	2	9	0	1020
6495	7	21	5	944	0	977
6496	12	3	3	959	0	977
6497	948	3	1	30	0	982
6498	955	2	6	5	0	968
6499	953	4	2	10	0	969
6500	27	910	5	8	0	950
6501	13	939	3	5	0	960
6502	928	23	3	6	0	960
6503	31	4	909	4	0	948
6504	11	881	24	1	0	917
6505	818	29	27	7	0	881
6506	793	5	5	6	0	809
6507	786	4	5	2	0	797
6508	26	2	2	766	0	796
6509	770	4	1	23	0	798
6510	778	1	2	3	0	784
6511	26	2	2	741	0	771
6512	749	0	1	22	0	772
6513	24	4	727	4	0	759
6514	8	4	20	735	0	767
6515	10	1	3	757	0	771
6516	8	1	6	765	0	780
6517	746	4	2	24	0	776
6518	767	3	2	11	0	783
6519	776	0	1	8	0	785
6520	767	2	2	7	0	778
6521	723	1	1	7	0	732
6522	30	2	2	686	0	720
6523	11	2	1	694	0	708
6524	681	1	1	21	0	704
6525	24	667	2	7	0	700
6526	662	16	2	5	0	685
6527	22	1	637	6	0	666
6528	667	1	17	5	0	690
6529	705	2	2	3	0	712
6530	23	2	720	4	0	749
6531	729	0	19	1	0	749
6532	22	3	740	3	0	768
6533	8	0	750	3	0	761
6534	9	2	18	749	0	778
6535	4	0	8	779	0	791
6536	5	1	775	19	0	800
6537	1	0	766	7	0	774
6538	4	744	19	5	0	772
6539	1	710	7	3	0	721
6540	565	11	5	3	0	584
6541	8	602	1	2	0	613
6542	574	11	4	1	0	590
6543	8	552	4	0	0	564
6544	547	10	0	1	0	558
6545	9	5	527	1	0	542
6546	538	2	7	1	0	548
6547	8	2	4	528	0	542
6548	4	528	1	11	0	544
6549	2	9	0	542	0	553
6550	538	3	0	8	0	549
6551	544	2	2	3	0	551
6552	17	1	0	534	0	552
6553	4	2	529	8	0	543
6554	3	1	520	3	0	527
6555	0	529	8	2	0	539
6556	2	8	4	527	0	541
6557	3	3	527	4	0	537
6558	1	506	4	7	0	518
6559	2	3	5	498	0	508
6560	1	2	4	499	0	506
6561	468	2	0	6	0	476
6562	3	0	1	469	0	473
6563	4	0	460	4	0	468
6564	1	1	2	460	0	464
6565	453	1	4	6	0	464
6566	3	1	441	6	0	451
6567	465	0	3	2	0	470
6568	4	465	3	4	0	476
6569	478	3	5	0	0	486
6570	480	5	0	3	0	488
6571	9	2	1	472	0	484
6572	6	0	2	480	0	488
6573	4	471	0	6	0	481
6574	2	5	0	486	0	493
6575	479	4	0	4	0	487
6576	6	1	471	4	0	482
6577	4	0	3	465	0	472
6578	3	468	3	7	0	481
6579	1	4	1	480	0	486
6580	0	5	1	481	0	487
6581	476	1	1	8	0	486
6582	4	468	1	4	0	477
6583	5	2	0	474	0	481
6584	474	5	2	4	0	485
6585	4	2	1	470	0	477
6586	3	0	1	476	0	480
6587	482	2	0	7	0	491
6588	478	2	1	6	0	487
6589	8	1	480	4	0	493
6590	482	1	4	2	0	489
6591	489	0	4	7	0	500
6592	491	0	2	4	0	497
6593	11	460	2	1	0	474
6594	7	459	1	1	0	468
6595	2	6	3	465	0	476
6596	463	5	2	4	0	474
6597	466	1	1	3	0	471
6598	10	0	1	462	0	473
6599	5	2	481	6	0	494
6600	490	4	3	4	0	501
6601	517	1	3	4	0	525
6602	9	0	2	511	0	522
6603	6	0	1	514	0	521
6604	508	1	1	9	0	519
6605	3	0	2	505	0	510
6606	7	510	0	5	0	522
6607	3	4	0	526	0	533
6608	528	3	0	8	0	539
6609	5	2	517	4	0	528
6610	509	1	3	4	0	517
6611	5	0	523	5	0	533
6612	5	3	3	531	0	542
6613	529	1	3	8	0	541
6614	7	0	1	540	0	548
6615	6	0	3	545	0	554
6616	534	0	1	8	0	543
6617	4	1	534	5	0	544
6618	6	0	559	2	0	567
6619	6	0	6	570	0	582
6620	2	1	5	585	0	593
6621	1	3	1	592	0	597
6622	4	0	597	8	0	609
6623	600	0	5	6	0	611
6624	615	1	5	2	0	623
6625	616	1	0	5	0	622
6626	626	0	1	4	0	631
6627	10	600	1	2	0	613
6628	8	612	2	0	0	622
6629	5	610	0	3	0	618
6630	2	2	1	537	0	542
6631	6	5	4	536	0	551
6632	3	0	508	2	0	513
6633	0	477	0	2	0	479
6634	8	0	0	454	0	462
6635	458	0	0	1	0	459
6636	1	446	0	4	0	451
6637	0	0	1	455	0	456
6638	1	463	0	0	0	464
6639	470	0	1	1	0	472
6640	0	0	0	476	0	476
6641	1	0	455	0	0	456
6642	0	0	449	1	0	450
6643	1	0	1	484	0	486
6644	1	0	0	476	0	477
6645	0	0	0	495	0	495
6646	491	0	1	1	0	493
6647	1	0	486	1	0	488
6648	0	477	1	1	0	479
6649	0	1	0	480	0	481
6650	0	0	489	1	0	490
6651	1	489	1	0	0	491
6652	3	1	0	514	0	518
6653	2	0	511	1	0	514
6654	2	0	1	506	0	509
6655	0	2	0	514	0	516
6656	528	2	0	1	0	531
6657	524	1	0	0	0	525
6658	1	0	0	525	0	526
6659	524	0	0	3	0	527
6660	1	0	530	0	0	531
6661	0	1	1	530	0	532
6662	1	0	545	2	0	548
6663	1	0	1	547	0	549
6664	0	539	1	2	0	542
6665	0	540	1	1	0	542
6666	0	564	0	0	0	564
6667	2	1	0	577	0	580
6668	1	0	0	647	0	648
6669	0	0	634	2	0	636
6670	0	0	642	1	0	643
6671	0	0	662	1	0	663
6672	717	0	2	1	0	720
6673	4	0	1	742	0	747
6674	767	0	0	3	0	770
6675	3	799	1	1	0	804
6676	1	6	0	825	0	832
6677	844	1	0	6	0	851
6678	6	0	1	838	0	845
6679	830	2	0	7	0	839
6680	6	0	849	4	0	859
6681	3	864	5	1	0	873
6682	2	5	2	871	0	880
6683	880	2	1	7	0	890
6684	880	1	1	2	0	884
6685	7	1	0	883	0	891
6686	3	0	0	891	0	894
6687	884	0	0	7	0	891
6688	6	0	1	877	0	884
6689	2	0	867	8	0	877
6690	1	867	5	3	0	876
6691	1	7	2	875	0	885
6692	871	4	1	7	0	883
6693	876	2	1	6	0	885
6694	7	2	886	2	0	897
6695	3	867	6	2	0	878
6696	2	901	2	2	0	907
6697	2	7	3	897	0	909
6698	4	2	3	920	0	929
6699	0	2	2	895	0	899
6700	3	2	1	895	0	901
6701	1	870	1	12	0	884
6702	4	4	2	886	0	896
6703	3	3	1	891	0	898
6704	888	1	2	11	0	902
6705	879	2	2	4	0	887
6706	9	875	2	5	0	891
6707	901	7	0	6	0	914
6708	885	2	2	6	0	895
6709	890	3	0	4	0	897
6710	9	1	874	7	0	891
6711	8	0	5	880	0	893
6712	5	1	4	900	0	910
6713	3	2	886	11	0	902
6714	2	2	7	875	0	886
6715	6	1	5	830	0	842
6716	875	0	1	13	0	889
6717	9	0	868	7	0	884
6718	7	3	6	838	0	854
6719	838	0	3	11	0	852
6720	12	838	3	4	0	857
6721	837	7	3	6	0	853
6722	817	4	1	5	0	827
6723	9	805	5	4	0	823
6724	8	8	0	822	0	838
6725	813	3	3	7	0	826
6726	8	795	1	9	0	813
6727	6	9	0	813	0	828
6728	793	5	1	12	0	811
6729	789	6	0	6	0	801
6730	11	783	1	7	0	802
6731	791	7	1	8	0	807
6732	11	3	3	789	0	806
6733	791	3	2	9	0	805
6734	11	2	775	8	0	796
6735	11	0	6	781	0	798
6736	5	0	3	788	0	796
6737	768	1	5	15	0	789
6738	7	756	3	7	0	773
6739	751	5	2	10	0	768
6740	14	740	1	8	0	763
6741	7	6	713	5	0	731
6742	9	2	712	6	0	729
6743	5	8	11	700	0	724
6744	3	4	708	9	0	724
6745	4	4	9	710	0	727
6746	6	2	3	701	0	712
6747	10	1	3	721	0	735
6748	733	2	3	20	0	758
6749	727	3	2	13	0	745
6750	739	2	3	9	0	753
6751	13	720	2	7	0	742
6752	13	752	2	7	0	774
6753	15	11	839	3	0	868
6754	7	9	10	842	0	868
6755	9	4	833	17	0	863
6756	6	3	13	818	0	840
6757	8	3	5	831	0	847
6758	4	2	8	835	0	849
6759	7	1	809	20	0	837
6760	3	4	15	821	0	843
6761	807	1	4	25	0	837
6762	16	782	7	11	0	816
6763	8	13	4	797	0	822
6764	785	7	4	19	0	815
6765	793	4	5	9	0	811
6766	20	4	4	772	0	800
6767	11	2	4	760	0	777
6768	689	3	2	19	0	713
6769	18	3	1	684	0	706
6770	647	3	1	19	0	670
6771	16	3	1	626	0	646
6772	7	1	565	19	0	592
6773	10	534	8	8	0	560
6774	7	535	2	6	0	550
6775	7	8	11	480	0	506
6776	9	2	5	478	0	494
6777	465	2	1	11	0	479
6778	8	2	2	469	0	481
6779	2	2	2	475	0	481
6780	1	1	2	441	0	445
6781	0	430	1	15	0	446
6782	3	6	0	437	0	446
6783	2	2	0	440	0	444
6784	2	2	0	436	0	440
6785	408	1	5	14	0	428
6786	7	424	2	6	0	439
6787	1	4	2	418	0	425
6788	1	2	0	427	0	430
6789	1	2	1	430	0	434
6790	415	0	1	14	0	430
6791	7	1	0	418	0	426
6792	2	1	0	420	0	423
6793	4	2	384	11	0	401
6794	1	369	5	6	0	381
6795	2	4	1	388	0	395
6796	375	1	1	10	0	387
6797	7	374	0	4	0	385
6798	368	7	2	3	0	380
6799	374	2	1	4	0	381
6800	8	2	0	364	0	374
6801	4	1	2	377	0	384
6802	3	4	378	8	0	393
6803	3	1	5	381	0	390
6804	4	1	381	8	0	394
6805	2	2	7	386	0	397
6806	363	0	1	11	0	375
6807	7	357	3	4	0	371
6808	1	7	1	380	0	389
6809	2	1	5	379	0	387
6810	2	1	2	381	0	386
6811	3	1	1	379	0	384
6812	366	2	2	11	0	381
6813	7	358	1	7	0	373
6814	3	6	0	372	0	381
6815	372	2	1	12	0	387
6816	8	1	360	9	0	378
6817	365	0	6	7	0	378
6818	366	3	3	3	0	375
6819	8	1	364	5	0	378
6820	7	1	7	362	0	377
6821	363	2	2	10	0	377
6822	11	388	1	3	0	403
6823	393	6	1	2	0	402
6824	396	1	2	1	0	400
6825	400	0	1	3	0	404
6826	11	1	0	391	0	403
6827	3	2	1	418	0	424
6828	4	443	0	10	0	457
6829	5	8	0	458	0	471
6830	465	3	0	8	0	476
6831	12	0	464	5	0	481
6832	465	1	9	4	0	479
6833	483	4	2	4	0	493
6834	10	2	1	485	0	498
6835	4	1	0	500	0	505
6836	492	1	3	12	0	508
6837	506	0	1	5	0	512
6838	467	0	1	3	0	471
6839	10	1	484	4	0	499
6840	3	474	7	5	0	489
6841	474	8	2	5	0	489
6842	10	2	0	473	0	485
6843	7	468	0	10	0	485
6844	5	10	2	473	0	490
6845	479	5	1	7	0	492
6846	10	1	0	473	0	484
6847	4	1	492	11	0	508
6848	1	473	7	6	0	487
6849	3	480	3	6	0	492
6850	4	9	451	3	0	467
6851	410	7	6	6	0	429
6852	5	414	5	3	0	427
6853	5	3	0	329	0	337
6854	329	2	0	2	0	333
6855	2	327	0	2	0	331
6856	2	2	0	333	0	337
6857	332	2	1	2	0	337
6858	2	0	0	337	0	339
6859	335	0	2	3	0	340
6860	3	1	345	3	0	352
6861	3	350	2	1	0	356
6862	370	3	1	2	0	376
6863	369	2	0	1	0	372
6864	370	0	0	1	0	371
6865	5	0	361	1	0	367
6866	361	0	2	2	0	365
6867	374	0	2	0	0	376
6868	4	1	0	370	0	375
6869	373	0	0	3	0	376
6870	3	360	0	5	0	368
6871	1	2	1	373	0	377
6872	1	2	380	2	0	385
6873	2	0	2	394	0	398
6874	0	0	3	403	0	406
6875	401	0	0	5	0	406
6876	397	0	0	2	0	399
6877	4	2	391	0	0	397
6878	393	0	2	0	0	395
6879	3	1	390	0	0	394
6880	3	0	2	394	0	399
6881	1	0	399	3	0	403
6882	0	0	2	403	0	405
6883	0	401	2	2	0	405
6884	0	3	408	3	0	414
6885	1	2	421	0	0	424
6886	2	1	6	361	0	370
6887	425	0	2	3	0	430
6888	424	0	0	2	0	426
6889	431	0	0	1	0	432
6890	5	0	0	425	0	430
6891	3	0	0	427	0	430
6892	1	0	0	427	0	428
6893	1	0	0	425	0	426
6894	1	0	425	5	0	431
6895	1	1	3	419	0	424
6896	1	416	1	3	0	421
6897	0	3	0	421	0	424
6898	439	3	0	3	0	445
6899	3	0	434	3	0	440
6900	412	0	3	0	0	415
6901	3	0	453	0	0	456
6902	2	0	448	0	0	450
6903	0	443	6	0	0	449
6904	3	4	2	422	0	431
6905	0	2	0	454	0	456
6906	0	413	1	5	0	419
6907	498	6	0	3	0	507
6908	10	3	0	512	0	525
6909	5	0	0	549	0	554
6910	0	0	0	573	0	573
6911	623	0	0	17	0	640
6912	665	0	0	5	0	670
6913	17	0	0	648	0	665
6914	6	0	0	655	0	661
6915	639	0	0	17	0	656
6916	11	0	0	645	0	656
6917	4	0	1	645	0	650
6918	0	0	0	657	0	657
6919	0	0	630	14	0	644
6920	619	0	10	4	0	633
6921	632	0	4	2	0	638
6922	15	1	594	2	0	612
6923	5	0	12	580	0	597
6924	2	595	4	10	0	611
6925	587	11	0	8	0	606
6926	11	588	0	4	0	603
6927	4	569	1	2	0	576
6928	4	13	1	541	0	559
6929	542	3	0	12	0	557
6930	548	0	0	4	0	552
6931	13	1	1	536	0	551
6932	8	1	0	542	0	551
6933	5	1	0	537	0	543
6934	3	1	0	534	0	538
6935	1	2	0	522	0	525
6936	2	506	1	13	0	522
6937	3	11	0	516	0	530
6938	510	3	0	12	0	525
6939	518	1	0	6	0	525
6940	515	1	1	3	0	520
6941	12	503	0	4	0	519
6942	6	9	0	503	0	518
6943	1	3	504	13	0	521
6944	488	1	11	9	0	509
6945	14	2	2	498	0	516
6946	507	0	0	14	0	521
6947	485	1	1	6	0	493
6948	487	1	0	3	0	491
6949	14	2	1	475	0	492
6950	475	1	0	13	0	489
6951	13	1	0	480	0	494
6952	5	1	2	489	0	497
6953	480	0	0	17	0	497
6954	15	1	0	481	0	497
6955	485	0	1	12	0	498
6956	484	1	2	6	0	493
6957	16	3	0	475	0	494
6958	4	0	0	490	0	494
6959	4	1	1	486	0	492
6960	3	0	444	16	0	463
6961	4	1	452	7	0	464
6962	2	1	13	445	0	461
6963	4	1	3	448	0	456
6964	5	0	1	450	0	456
6965	4	0	0	449	0	453
6966	2	2	0	453	0	457
6967	430	0	0	21	0	451
6968	13	426	0	6	0	445
6969	7	11	2	429	0	449
6970	427	3	1	17	0	448
6971	14	0	0	433	0	447
6972	5	1	0	429	0	435
6973	411	0	2	18	0	431
6974	416	1	1	7	0	425
6975	14	0	404	6	0	424
6976	7	2	12	405	0	426
6977	4	2	405	13	0	424
6978	4	0	10	412	0	426
6979	3	0	3	415	0	421
6980	5	0	0	417	0	422
6981	3	2	397	16	0	418
6982	3	389	11	8	0	411
6983	4	404	4	3	0	415
6984	0	12	1	395	0	408
6985	380	3	0	14	0	397
6986	13	1	373	8	0	395
6987	5	0	391	7	0	403
6988	4	0	13	388	0	405
6989	2	0	4	389	0	395
6990	1	380	2	16	0	399
6991	1	11	1	388	0	401
6992	1	3	0	400	0	404
6993	1	2	1	407	0	411
6994	389	0	3	16	0	408
6995	395	1	2	6	0	404
6996	15	1	2	390	0	408
6997	4	382	0	16	0	402
6998	2	12	0	373	0	387
6999	362	3	0	13	0	378
7000	13	370	1	6	0	390
7001	3	9	0	347	0	359
7002	1	341	1	11	0	354
7003	340	9	0	5	0	354
7004	322	2	0	7	0	331
7005	12	335	1	4	0	352
7006	5	320	0	3	0	328
7007	4	2	286	3	0	295
7008	2	258	4	3	0	267
7009	5	8	1	226	0	240
7010	4	3	208	2	0	217
7011	2	140	4	1	0	147
7012	0	1	0	115	0	116
7013	1	1	0	115	0	117
7014	0	0	0	116	0	116
7015	113	0	0	4	0	117
7016	2	1	113	0	0	116
7017	0	0	111	1	0	112
7018	1	0	2	114	0	117
7019	1	1	112	1	0	115
7020	1	1	1	115	0	118
7021	0	1	1	120	0	122
7022	0	0	0	120	0	120
7023	0	1	1	121	0	123
7024	118	0	1	3	0	122
7025	120	0	1	2	0	123
7026	2	1	0	120	0	123
7027	0	0	124	3	0	127
7028	0	0	1	125	0	126
7029	0	109	0	3	0	112
7030	3	1	0	111	0	115
7031	113	1	0	2	0	116
7032	112	0	1	2	0	115
7033	3	0	0	114	0	117
7034	0	0	1	114	0	115
7035	1	0	0	114	0	115
7036	112	0	0	2	0	114
7037	2	0	112	2	0	116
7038	0	0	112	1	0	113
7039	1	110	1	2	0	114
7040	112	2	1	0	0	115
7041	1	0	0	121	0	122
7042	1	0	124	2	0	127
7043	1	122	1	2	0	126
7044	0	123	0	1	0	124
7045	0	1	0	118	0	119
7046	1	0	0	120	0	121
7047	2	118	0	1	0	121
7048	1	1	1	119	0	122
7049	0	0	1	123	0	124
7050	120	2	0	2	0	124
7051	3	117	0	1	0	121
7052	0	1	1	113	0	115
7053	0	1	115	1	0	117
7054	0	1	0	116	0	117
7055	110	2	0	2	0	114
7056	2	112	0	2	0	116
7057	1	1	1	116	0	119
7058	0	3	112	1	0	116
7059	0	2	130	1	0	133
7060	0	0	1	137	0	138
7061	1	1	0	142	0	144
7062	141	1	0	4	0	146
7063	3	154	1	2	0	160
7064	161	4	1	1	0	167
7065	3	0	162	2	0	167
7066	164	1	3	1	0	169
7067	3	1	167	2	0	173
7068	163	0	4	2	0	169
7069	176	0	3	2	0	181
7070	5	0	179	0	0	184
7071	1	1	184	2	0	188
7072	0	173	5	2	0	180
7073	1	3	2	185	0	191
7074	187	2	1	5	0	195
7075	4	0	0	193	0	197
7076	1	0	1	200	0	202
7077	2	0	0	199	0	201
7078	1	1	196	4	0	202
7079	192	0	3	3	0	198
7080	204	0	3	1	0	208
7081	6	203	0	3	0	212
7082	2	4	2	202	0	210
7083	1	212	0	5	0	218
7084	2	4	0	213	0	219
7085	212	1	1	5	0	219
7086	4	214	1	3	0	222
7087	1	4	0	204	0	209
7088	204	1	0	6	0	211
7089	204	0	1	1	0	206
7090	5	0	1	203	0	209
7091	3	0	207	4	0	214
7092	1	1	2	199	0	203
7093	1	205	1	3	0	210
7094	206	2	1	3	0	212
7095	3	206	1	0	0	210
7096	2	4	0	204	0	210
7097	209	1	0	5	0	215
7098	4	2	0	218	0	224
7099	1	0	0	223	0	224
7100	2	0	221	4	0	227
7101	0	220	3	2	0	225
7102	218	3	1	2	0	224
7103	204	1	1	0	0	206
7104	3	209	0	0	0	212
7105	1	207	0	0	0	208
7106	0	4	0	209	0	213
7107	205	0	0	5	0	210
7108	3	208	0	1	0	212
7109	1	2	0	203	0	206
7110	1	1	200	3	0	205
7111	0	1	3	200	0	204
7112	205	0	1	5	0	211
7113	3	211	1	1	0	216
7114	1	3	0	215	0	219
7115	1	1	213	3	0	218
7116	0	1	217	0	0	218
7117	0	0	4	219	0	223
7118	0	0	1	224	0	225
7119	0	225	1	4	0	230
7120	0	3	0	230	0	233
7121	231	1	0	5	0	237
7122	4	1	0	236	0	241
7123	235	0	0	4	0	239
7124	4	234	0	1	0	239
7125	1	238	0	1	0	240
7126	1	4	0	242	0	247
7127	0	0	0	238	0	238
7128	0	1	240	4	0	245
7129	0	0	3	240	0	243
7130	235	0	1	5	0	241
7131	3	0	232	1	0	236
7132	2	0	2	246	0	250
7133	1	0	261	3	0	265
7134	0	0	3	264	0	267
7135	1	0	1	271	0	273
7136	1	2	2	270	0	275
7137	0	0	274	5	0	279
7138	0	1	1	269	0	271
7139	0	278	1	5	0	284
7140	1	3	1	281	0	286
7141	0	1	0	278	0	279
7142	271	1	0	5	0	277
7143	3	0	271	3	0	277
7144	1	0	3	276	0	280
7145	2	0	276	3	0	281
7146	1	0	264	1	0	266
7147	0	1	3	284	0	288
7148	0	0	2	274	0	276
7149	0	0	0	292	0	292
7150	289	0	0	5	0	294
7151	2	0	283	2	0	287
7152	293	1	2	2	0	298
7153	4	0	1	313	0	318
7154	2	0	0	329	0	331
7155	2	341	0	4	0	347
7156	0	3	0	359	0	362
7157	1	1	1	353	0	356
7158	1	1	0	353	0	355
7159	331	1	0	5	0	337
7160	4	0	324	2	0	330
7161	302	1	0	1	0	304
7162	2	314	1	1	0	318
7163	309	1	1	1	0	312
7164	2	304	0	1	0	307
7165	0	308	0	1	0	309
7166	1	2	0	305	0	308
7167	318	1	0	1	0	320
7168	1	0	0	323	0	324
7169	0	320	0	1	0	321
7170	1	339	0	0	0	340
7171	1	2	0	343	0	346
7172	0	1	0	344	0	345
7173	0	344	0	2	0	346
7174	0	2	0	364	0	366
7175	0	0	0	366	0	366
7176	0	1	0	368	0	369
7177	371	0	0	3	0	374
7178	2	1	371	1	0	375
7179	385	0	1	4	0	390
7180	395	0	0	0	0	395
7181	384	0	1	0	0	385
7182	1	375	0	0	0	376
7183	0	1	0	382	0	383
7184	383	0	0	2	0	385
7185	2	0	0	398	0	400
7186	393	0	0	1	0	394
7187	1	415	0	0	0	416
7188	447	1	0	1	0	449
7189	448	0	0	2	0	450
7190	457	0	1	1	0	459
7191	1	0	0	460	0	461
7192	1	0	0	468	0	469
7193	481	0	1	1	0	483
7194	2	468	0	1	0	471
7195	0	483	1	1	0	485
7196	505	2	0	0	0	507
7197	3	0	0	503	0	506
7198	0	0	0	518	0	518
7199	0	0	1	531	0	532
7200	0	522	0	3	0	525
7201	533	3	0	0	0	536
7202	2	0	0	539	0	541
7203	0	552	0	3	0	555
7204	1	2	0	579	0	582
7205	1	0	1	600	0	602
7206	0	0	0	599	0	599
7207	0	0	1	607	0	608
7208	614	0	1	3	0	618
7209	612	0	0	2	0	614
7210	632	0	0	2	0	634
7211	2	0	0	639	0	641
7212	1	0	638	2	0	641
7213	1	0	575	0	0	576
7214	1	0	617	0	0	618
7215	672	0	2	1	0	675
7216	2	0	0	674	0	676
7217	0	1	0	676	0	677
7218	0	0	0	677	0	677
7219	666	0	0	4	0	670
7220	667	0	0	1	0	668
7221	3	709	0	0	0	712
7222	0	2	0	720	0	722
7223	0	0	719	2	0	721
7224	0	732	2	0	0	734
7225	0	5	0	756	0	761
7226	0	0	0	758	0	758
7227	1	0	0	751	0	752
7228	1	0	0	729	0	730
7229	0	0	744	2	0	746
7230	0	0	728	0	0	728
7231	0	753	2	0	0	755
7232	2	2	0	763	0	767
7233	0	0	0	751	0	751
7234	749	0	0	4	0	753
7235	2	0	753	0	0	755
7236	1	0	2	754	0	757
7237	3	0	0	790	0	793
7238	0	0	819	2	0	821
7239	0	825	2	0	0	827
7240	821	2	0	2	0	825
7241	4	0	805	0	0	809
7242	795	0	2	1	0	798
7243	4	0	854	0	0	858
7244	0	0	2	875	0	877
7245	2	0	876	2	0	880
7246	2	2	886	0	0	890
7247	1	0	2	926	0	929
7248	4	0	2	827	0	833
7249	0	0	0	958	0	958
7250	0	0	0	939	0	939
7251	1	0	0	929	0	930
7252	0	0	969	2	0	971
7253	1	0	911	0	0	912
7254	0	968	2	0	0	970
7255	964	2	0	2	0	968
7256	4	0	0	978	0	982
7257	983	0	0	4	0	987
7258	3	0	0	983	0	986
7259	1006	0	0	10	0	1016
7260	5	0	0	1018	0	1023
7261	2	0	0	1026	0	1028
7262	0	1038	0	5	0	1043
7263	1	4	0	1056	0	1061
7264	0	0	0	1064	0	1064
7265	0	0	0	1075	0	1075
7266	0	0	0	1070	0	1070
7267	0	1042	0	5	0	1047
7268	1054	4	0	2	0	1060
7269	3	1021	2	4	0	1030
7270	1	3	0	1021	0	1025
7271	1010	0	0	4	0	1014
7272	2	0	1000	1	0	1003
7273	2	0	1005	0	0	1007
7274	0	0	4	992	0	996
7275	1	0	1	1021	0	1023
7276	0	0	0	1022	0	1022
7277	2	1	1	977	0	981
7278	1	0	0	1003	0	1004
7279	0	974	0	5	0	979
7280	1	3	0	990	0	994
7281	994	0	0	4	0	998
7282	3	0	0	998	0	1001
7283	1	0	1015	4	0	1020
7284	0	0	5	1005	0	1010
7285	1008	0	1	6	0	1015
7286	4	1046	0	1	0	1051
7287	1	5	0	1101	0	1107
7288	0	1	0	1163	0	1164
7289	0	0	1148	11	0	1159
7290	2	2	1456	2	0	1462
7291	1778	1	17	4	0	1800
7292	29	0	4	1794	0	1827
7293	12	0	5	1853	0	1870
7294	9	1	1939	30	0	1979
7295	3	2	1940	16	0	1961
7296	1	1965	29	9	0	2004
7297	4	24	14	1957	0	1999
7298	1	8	1948	25	0	1982
7299	1	1932	28	13	0	1974
7300	1955	27	7	11	0	2000
7301	2004	8	8	6	0	2026
7302	36	9	5	1960	0	2010
7303	14	1972	3	30	0	2019
7304	1963	29	3	10	0	2005
7305	37	8	2	1862	0	1909
7306	12	10	1915	26	0	1963
7307	9	1925	27	12	0	1973
7308	1909	26	8	13	0	1956
7309	1945	7	12	11	0	1975
7310	36	11	7	1917	0	1971
7311	21	6	1	1937	0	1965
7312	18	3	1903	35	0	1959
7313	7	1	25	1933	0	1966
7314	10	6	12	1855	0	1883
7315	6	6	7	1918	0	1937
7316	6	1	5	1917	0	1929
7317	7	2	3	1869	0	1881
7318	2	1869	5	55	0	1931
7319	1881	26	1	26	0	1934
7320	30	8	1876	21	0	1935
7321	11	1837	26	17	0	1891
7322	13	25	11	1863	0	1912
7323	1840	9	11	37	0	1897
7324	33	11	9	1844	0	1897
7325	13	7	4	1858	0	1882
7326	9	5	8	1866	0	1888
7327	11	7	6	1862	0	1886
7328	10	1	1811	53	0	1875
7329	7	1809	25	28	0	1869
7330	1812	25	8	31	0	1876
7331	36	12	1798	10	0	1856
7332	16	11	30	1812	0	1869
7333	1807	10	8	41	0	1866
7334	33	1794	14	17	0	1858
7335	1813	29	8	21	0	1871
7336	40	15	8	1742	0	1805
7337	24	14	4	1821	0	1863
7338	24	4	4	1796	0	1828
7339	12	3	6	1803	0	1824
7340	1748	5	4	62	0	1819
7341	33	2	2	1776	0	1813
7342	12	4	3	1798	0	1817
7343	1703	0	4	50	0	1757
7344	29	6	1680	34	0	1749
7345	18	4	25	1701	0	1748
7346	1642	5	11	40	0	1698
7347	1657	4	7	22	0	1690
7348	45	3	6	1619	0	1673
7349	21	9	7	1607	0	1644
7350	15	1533	6	47	0	1601
7351	14	25	3	1573	0	1615
7352	14	10	4	1551	0	1579
7353	5	10	1495	56	0	1566
7354	6	3	1474	34	0	1517
7355	7	1474	31	27	0	1539
7356	6	25	17	1472	0	1520
7357	4	11	15	1507	0	1537
7358	1490	12	8	36	0	1546
7359	28	9	9	1462	0	1508
7360	12	4	1435	49	0	1500
7361	20	3	27	1460	0	1510
7362	10	5	1418	42	0	1475
7363	8	6	1437	22	0	1473
7364	9	3	36	1412	0	1460
7365	7	6	18	1442	0	1473
7366	1424	5	10	42	0	1481
7367	1438	2	7	36	0	1483
7368	37	2	9	1439	0	1487
7369	1452	4	6	42	0	1504
7370	1478	1	3	23	0	1505
7371	43	4	6	1456	0	1509
7372	23	4	8	1480	0	1515
7373	1443	4	4	46	0	1497
7374	1415	6	5	28	0	1454
7375	39	1	5	1408	0	1453
7376	23	1366	5	43	0	1437
7377	23	25	4	1408	0	1460
7378	18	10	5	1431	0	1464
7379	4	6	1371	59	0	1440
7380	7	3	24	1424	0	1458
7381	1360	2	15	45	0	1422
7382	24	1364	15	24	0	1427
7383	1368	26	6	25	0	1425
7384	1368	10	5	20	0	1403
7385	1392	9	2	16	0	1419
7386	48	13	2	1316	0	1379
7387	31	5	1199	34	0	1269
7388	33	3	1139	18	0	1193
7389	17	1145	24	22	0	1208
7390	5	794	9	14	0	822
7391	5	465	5	4	0	479
7392	8	437	10	3	0	458
7393	9	10	411	6	0	436
7394	290	9	9	4	0	312
7395	1	1	1	284	0	287
7396	2	1	0	269	0	272
7397	0	4	0	263	0	267
7398	0	276	1	0	0	277
7399	264	1	0	3	0	268
7400	2	0	264	1	0	267
7401	2	234	0	0	0	236
7402	1	0	0	239	0	240
7403	238	0	0	2	0	240
7404	0	1	0	239	0	240
7405	0	1	234	1	0	236
7406	1	0	233	1	0	235
7407	0	0	2	244	0	246
7408	1	1	0	240	0	242
7409	244	0	0	1	0	245
7410	1	1	237	0	0	239
7411	246	0	0	1	0	247
7412	244	0	1	0	0	245
7413	2	0	1	256	0	259
7414	0	0	269	3	0	272
7415	1	0	1	269	0	271
7416	279	0	1	1	0	281
7417	1	275	2	0	0	278
7418	288	1	0	1	0	290
7419	2	1	0	298	0	301
7420	0	308	1	2	0	311
7421	0	1	2	311	0	314
7422	2	0	0	317	0	319
7423	2	314	0	2	0	318
7424	1	5	0	322	0	328
7425	1	0	0	339	0	340
7426	1	1	0	352	0	354
7427	2	1	350	2	0	355
7428	1	353	2	2	0	358
7429	365	3	1	2	0	371
7430	4	1	1	372	0	378
7431	3	397	0	4	0	404
7432	412	3	0	4	0	419
7433	5	2	1	413	0	421
7434	2	0	2	415	0	419
7435	1	1	0	401	0	403
7436	3	0	1	398	0	402
7437	396	0	0	7	0	403
7438	5	1	1	400	0	407
7439	3	1	0	400	0	404
7440	405	0	0	6	0	411
7441	6	0	0	403	0	409
7442	3	0	397	6	0	406
7443	1	1	2	402	0	406
7444	392	0	2	6	0	400
7445	4	1	1	393	0	399
7446	2	1	385	6	0	394
7447	2	0	380	4	0	386
7448	402	1	5	2	0	410
7449	411	2	2	1	0	416
7450	414	0	1	2	0	417
7451	415	1	0	0	0	416
7452	8	0	414	3	0	425
7453	4	0	4	411	0	419
7454	1	0	3	417	0	421
7455	409	1	2	6	0	418
7456	6	2	0	414	0	422
7457	5	1	410	5	0	421
7458	3	1	4	413	0	421
7459	0	2	415	4	0	421
7460	1	412	6	3	0	422
7461	423	3	4	6	0	436
7462	5	2	1	420	0	428
7463	2	1	401	6	0	410
7464	1	0	4	406	0	411
7465	1	0	2	415	0	418
7466	0	1	418	6	0	425
7467	0	2	3	420	0	425
7468	421	0	1	6	0	428
7469	4	0	389	6	0	399
7470	393	1	5	2	0	401
7471	5	393	1	1	0	400
7472	4	3	395	1	0	403
7473	4	3	393	2	0	402
7474	3	4	8	349	0	364
7475	1	0	3	376	0	380
7476	1	0	374	7	0	382
7477	0	0	4	376	0	380
7478	370	0	2	9	0	381
7479	378	0	1	4	0	383
7480	7	0	1	379	0	387
7481	4	1	1	376	0	382
7482	2	371	0	7	0	380
7483	383	4	0	4	0	391
7484	4	3	0	381	0	388
7485	3	387	3	3	0	396
7486	387	4	1	6	0	398
7487	392	2	1	1	0	396
7488	7	403	0	4	0	414
7489	5	2	0	399	0	406
7490	3	2	1	396	0	402
7491	1	1	383	7	0	392
7492	2	1	3	384	0	390
7493	383	0	2	7	0	392
7494	7	1	1	382	0	391
7495	3	0	380	6	0	389
7496	383	0	4	5	0	392
7497	7	0	1	380	0	388
7498	4	0	370	6	0	380
7499	1	2	4	377	0	384
7500	1	0	380	5	0	386
7501	2	0	6	382	0	390
7502	2	0	3	388	0	393
7503	381	1	1	8	0	391
7504	6	379	1	2	0	388
7505	388	5	2	3	0	398
7506	385	2	2	3	0	392
7507	386	2	1	2	0	391
7508	8	378	0	3	0	389
7509	4	3	381	3	0	391
7510	3	4	6	382	0	395
7511	386	2	3	6	0	397
7512	385	0	3	4	0	392
7513	9	1	0	372	0	382
7514	367	0	0	6	0	373
7515	7	0	358	4	0	369
7516	350	1	5	4	0	360
7517	7	0	350	3	0	360
7518	3	341	4	4	0	352
7519	343	4	4	1	0	352
7520	328	2	2	3	0	335
7521	7	327	0	0	0	334
7522	335	5	1	1	0	342
7523	320	3	0	4	0	327
7524	7	3	307	1	0	318
7525	293	0	3	2	0	298
7526	5	0	290	2	0	297
7527	5	3	4	273	0	285
7528	2	270	3	5	0	280
7529	0	3	260	2	0	265
7530	240	8	2	5	0	255
7531	226	2	1	3	0	232
7532	2	1	4	214	0	221
7533	4	0	214	3	0	221
7534	2	1	3	216	0	222
7535	214	0	2	4	0	220
7536	1	215	2	3	0	221
7537	220	0	1	2	0	223
7538	219	2	1	2	0	224
7539	4	217	1	0	0	222
7540	4	0	0	219	0	223
7541	226	0	0	1	0	227
7542	2	3	0	235	0	240
7543	0	0	2	238	0	240
7544	2	0	241	1	0	244
7545	2	1	0	239	0	242
7546	4	1	0	245	0	250
7547	249	0	1	3	0	253
7548	250	1	0	2	0	253
7549	2	1	2	260	0	265
7550	6	0	255	1	0	262
7551	2	0	249	1	0	252
7552	1	1	1	249	0	252
7553	3	0	263	2	0	268
7554	3	0	3	259	0	265
7555	0	1	0	265	0	266
7556	262	0	1	1	0	264
7557	3	0	247	2	0	252
7558	244	0	4	3	0	251
7559	248	0	1	0	0	249
7560	1	1	245	1	0	248
7561	2	0	240	2	0	244
7562	3	8	1	233	0	245
7563	0	233	4	1	0	238
7564	2	236	2	0	0	240
7565	3	2	0	228	0	233
7566	1	1	2	221	0	225
7567	0	1	2	225	0	228
7568	0	0	0	230	0	230
7569	222	1	0	3	0	226
7570	1	2	1	222	0	226
7571	2	0	218	3	0	223
7572	3	0	1	218	0	222
7573	0	212	1	4	0	217
7574	0	1	2	217	0	220
7575	216	0	0	3	0	219
7576	1	1	0	217	0	219
7577	0	2	214	3	0	219
7578	1	215	2	2	0	220
7579	1	2	0	215	0	218
7580	213	0	1	4	0	218
7581	212	1	0	1	0	214
7582	3	0	0	223	0	226
7583	1	0	212	3	0	216
7584	1	1	204	0	0	206
7585	214	0	2	3	0	219
7586	2	1	216	1	0	220
7587	1	0	214	1	0	216
7588	2	1	2	195	0	200
7589	199	0	2	2	0	203
7590	194	0	3	0	0	197
7591	198	1	0	2	0	201
7592	2	0	215	1	0	218
7593	2	0	220	0	0	222
7594	1	225	1	1	0	228
7595	2	1	1	230	0	234
7596	1	1	1	233	0	236
7597	1	1	2	226	0	230
7598	1	0	1	233	0	235
7599	0	0	232	2	0	234
7600	1	235	2	2	0	240
7601	247	1	1	3	0	252
7602	278	0	1	4	0	283
7603	281	1	1	2	0	285
7604	5	284	0	1	0	290
7605	2	2	2	287	0	293
7606	298	1	3	3	0	305
7607	3	319	2	1	0	325
7608	317	3	1	3	0	324
7609	5	320	1	2	0	328
7610	326	4	2	2	0	334
7611	329	0	0	3	0	332
7612	6	0	1	325	0	332
7613	4	2	2	329	0	337
7614	3	0	331	3	0	337
7615	4	3	323	3	0	333
7616	333	1	3	2	0	339
7617	340	1	2	0	0	343
7618	4	0	0	334	0	338
7619	2	1	0	333	0	336
7620	1	4	328	4	0	337
7621	5	1	4	319	0	329
7622	3	3	320	5	0	331
7623	3	0	3	322	0	328
7624	5	0	0	337	0	342
7625	335	2	1	7	0	345
7626	327	1	2	2	0	332
7627	6	2	2	324	0	334
7628	5	0	2	324	0	331
7629	3	1	324	9	0	337
7630	1	1	4	325	0	331
7631	2	1	332	7	0	342
7632	329	1	4	4	0	338
7633	5	0	4	332	0	341
7634	333	2	1	7	0	343
7635	7	330	2	3	0	342
7636	330	4	1	5	0	340
7637	7	0	1	323	0	331
7638	7	0	1	320	0	328
7639	1	323	3	7	0	334
7640	3	3	7	317	0	330
7641	2	3	314	8	0	327
7642	6	0	5	297	0	308
7643	4	0	294	4	0	302
7644	2	286	4	4	0	296
7645	2	3	1	292	0	298
7646	1	2	287	7	0	297
7647	3	0	279	0	0	282
7648	1	8	2	262	0	273
7649	261	0	1	4	0	266
7650	5	0	255	1	0	261
7651	3	0	2	254	0	259
7652	262	0	2	3	0	267
7653	2	246	0	3	0	251
7654	260	2	3	0	0	265
7655	3	1	0	261	0	265
7656	1	1	1	261	0	264
7657	3	2	1	258	0	264
7658	261	0	1	5	0	267
7659	3	0	2	259	0	264
7660	2	1	0	256	0	259
7661	247	1	4	2	0	254
7662	3	2	246	3	0	254
7663	3	0	3	246	0	252
7664	1	3	239	3	0	246
7665	244	0	4	3	0	251
7666	2	1	2	246	0	251
7667	2	1	244	4	0	251
7668	247	0	5	1	0	253
7669	253	1	0	2	0	256
7670	4	1	257	4	0	266
7671	0	3	3	257	0	263
7672	3	0	1	261	0	265
7673	0	0	262	6	0	268
7674	1	255	3	4	0	263
7675	1	2	264	2	0	269
7676	260	1	2	2	0	265
7677	3	0	272	3	0	278
7678	271	1	4	3	0	279
7679	6	0	276	1	0	283
7680	273	0	4	3	0	280
7681	3	272	3	5	0	283
7682	0	2	3	273	0	278
7683	3	0	1	278	0	282
7684	2	0	276	5	0	283
7685	0	2	4	267	0	273
7686	5	272	1	2	0	280
7687	269	3	1	1	0	274
7688	3	271	3	2	0	279
7689	1	2	1	281	0	285
7690	282	0	1	3	0	286
7691	3	283	1	2	0	289
7692	267	6	1	1	0	275
7693	6	1	277	1	0	285
7694	3	0	5	276	0	284
7695	1	0	4	277	0	282
7696	2	1	1	281	0	285
7697	279	1	2	5	0	287
7698	282	0	2	1	0	285
7699	281	4	2	1	0	288
7700	277	0	1	4	0	282
7701	8	0	255	1	0	264
7702	216	1	5	0	0	222
7703	5	217	0	1	0	223
7704	0	217	1	0	0	218
7705	219	3	1	0	0	223
7706	203	2	4	2	0	211
7707	4	0	0	184	0	188
7708	191	0	0	2	0	193
7709	189	0	0	0	0	189
7710	210	0	0	0	0	210
7711	2	0	0	208	0	210
7712	0	216	0	2	0	218
7713	0	218	0	0	0	218
7714	1	7	0	213	0	221
7715	212	0	0	3	0	215
7716	1	215	0	0	0	216
7717	1	3	0	213	0	217
7718	0	0	222	3	0	225
7719	218	0	3	1	0	222
7720	3	222	0	0	0	225
7721	0	228	0	0	0	228
7722	222	3	0	1	0	226
7723	3	0	230	0	0	233
7724	0	0	3	219	0	222
7725	0	225	0	3	0	228
7726	1	3	0	225	0	229
7727	0	0	0	226	0	226
7728	1	214	1	3	0	219
7729	0	3	0	227	0	230
7730	0	0	0	232	0	232
7731	230	0	0	3	0	233
7732	3	227	1	0	0	231
7733	230	3	0	0	0	233
7734	3	0	0	232	0	235
7735	0	241	0	2	0	243
7736	0	2	242	0	0	244
7737	0	0	3	244	0	247
7738	0	1	0	251	0	252
7739	0	0	255	3	0	258
7740	254	0	2	0	0	256
7741	3	0	0	288	0	291
7742	291	0	0	4	0	295
7743	4	0	287	2	0	293
7744	2	0	3	289	0	294
7745	0	1	305	4	0	310
7746	0	0	4	314	0	318
7747	2	0	2	317	0	321
7748	319	0	0	6	0	325
7749	4	329	0	2	0	335
7750	334	4	0	0	0	338
7751	4	3	336	0	0	343
7752	3	0	4	338	0	345
7753	0	0	352	4	0	356
7754	322	0	4	3	0	329
7755	343	0	2	0	0	345
7756	6	0	344	0	0	350
7757	343	0	4	0	0	347
7758	350	0	3	0	0	353
7759	7	0	0	350	0	357
7760	3	0	352	4	0	359
7761	0	0	354	3	0	357
7762	0	0	6	356	0	362
7763	0	0	2	354	0	356
7764	0	352	0	6	0	358
7765	0	356	0	1	0	357
7766	355	6	0	1	0	362
7767	3	3	0	353	0	359
7768	3	348	0	4	0	355
7769	0	351	2	3	0	356
7770	348	6	0	0	0	354
7771	4	3	0	357	0	364
7772	3	358	0	4	0	365
7773	1	3	0	361	0	365
7774	0	3	0	361	0	364
7775	0	0	0	361	0	361
7776	350	0	0	9	0	359
7777	4	354	0	2	0	360
7778	3	4	0	356	0	363
7779	2	3	0	353	0	358
7780	0	0	0	363	0	363
7781	0	0	348	6	0	354
7782	339	0	4	3	0	346
7783	4	0	3	341	0	348
7784	345	0	0	3	0	348
7785	345	0	0	2	0	347
7786	348	0	0	1	0	349
7787	7	0	342	0	0	349
7788	2	338	4	0	0	344
7789	0	3	1	332	0	336
7790	0	3	331	2	0	336
7791	0	0	330	3	0	333
7792	0	2	5	312	0	319
7793	0	307	4	2	0	313
7794	314	2	0	3	0	319
7795	323	2	0	0	0	325
7796	326	0	0	0	0	326
7797	331	0	0	1	0	332
7798	6	0	337	0	0	343
7799	337	0	2	2	0	341
7800	2	349	3	1	0	355
7801	3	2	0	348	0	353
7802	0	2	0	353	0	355
7803	353	0	0	6	0	359
7804	2	0	2	355	0	359
7805	3	0	339	3	0	345
7806	335	0	3	4	0	342
7807	347	0	3	1	0	351
7808	347	1	0	0	0	348
7809	5	1	341	0	0	347
7810	323	0	2	1	0	326
7811	3	319	3	1	0	326
7812	317	3	2	1	0	323
7813	3	4	0	314	0	321
7814	4	0	0	308	0	312
7815	0	304	0	6	0	310
7816	0	2	0	311	0	313
7817	0	308	0	1	0	309
7818	0	2	0	303	0	305
7819	1	296	0	2	0	299
7820	1	1	0	305	0	307
7821	0	298	0	1	0	299
7822	0	2	0	309	0	311
7823	0	312	0	2	0	314
7824	337	1	0	5	0	343
7825	1	3	1	338	0	343
7826	4	0	0	343	0	347
7827	0	0	0	362	0	362
7828	1	0	0	366	0	367
7829	2	0	372	6	0	380
7830	1	1	3	376	0	381
7831	0	0	4	376	0	380
7832	374	1	0	7	0	382
7833	367	0	0	6	0	373
7834	5	373	1	1	0	380
7835	3	2	1	373	0	379
7836	0	4	0	393	0	397
7837	409	1	0	3	0	413
7838	6	0	392	3	0	401
7839	398	0	3	0	0	401
7840	6	397	5	0	0	408
7841	369	3	2	1	0	375
7842	368	2	2	0	0	372
7843	6	360	0	0	0	366
7844	1	369	0	0	0	370
7845	3	4	1	353	0	361
7846	1	2	348	4	0	355
7847	341	2	3	2	0	348
7848	4	1	343	2	0	350
7849	326	0	6	1	0	333
7850	6	1	327	0	0	334
7851	2	323	5	3	0	333
7852	3	4	1	323	0	331
7853	311	0	2	5	0	318
7854	317	1	2	0	0	320
7855	4	2	0	313	0	319
7856	311	0	0	7	0	318
7857	316	0	0	2	0	318
7858	6	306	0	2	0	314
7859	304	5	0	1	0	310
7860	5	310	1	0	0	316
7861	3	6	0	318	0	327
7862	317	1	1	5	0	324
7863	321	1	1	1	0	324
7864	322	1	1	1	0	325
7865	6	3	318	1	0	328
7866	3	0	317	1	0	321
7867	4	0	5	324	0	333
7868	1	0	0	340	0	341
7869	0	359	2	6	0	367
7870	355	6	1	2	0	364
7871	8	1	2	354	0	365
7872	3	2	0	358	0	363
7873	2	2	353	8	0	365
7874	3	348	6	3	0	360
7875	0	355	3	3	0	361
7876	1	10	1	356	0	368
7877	343	3	0	7	0	353
7878	8	2	0	341	0	351
7879	3	1	1	347	0	352
7880	343	0	1	10	0	354
7881	347	0	0	3	0	350
7882	9	0	0	348	0	357
7883	4	2	346	7	0	359
7884	4	4	5	347	0	360
7885	2	1	2	353	0	358
7886	349	0	1	12	0	362
7887	8	0	2	350	0	360
7888	347	2	0	10	0	359
7889	9	1	353	4	0	367
7890	4	0	8	364	0	376
7891	4	1	3	372	0	380
7892	2	0	2	376	0	380
7893	2	1	1	369	0	373
7894	1	1	1	366	0	369
7895	3	1	348	11	0	363
7896	346	0	7	7	0	360
7897	9	0	3	351	0	363
7898	3	0	329	9	0	341
7899	1	1	342	4	0	348
7900	2	1	9	323	0	335
7901	325	0	3	10	0	338
7902	330	2	2	1	0	335
7903	331	0	2	3	0	336
7904	10	0	0	315	0	325
7905	6	323	0	8	0	337
7906	330	8	1	3	0	342
7907	332	3	0	3	0	338
7908	327	3	1	3	0	334
7909	325	1	2	3	0	331
7910	14	0	1	315	0	330
7911	6	0	306	10	0	322
7912	3	0	8	315	0	326
7913	3	1	307	8	0	319
7914	312	0	10	4	0	326
7915	317	0	3	5	0	325
7916	10	0	309	4	0	323
7917	315	1	9	2	0	327
7918	324	2	1	4	0	331
7919	12	2	1	314	0	329
7920	4	310	2	10	0	326
7921	316	7	1	3	0	327
7922	9	3	1	307	0	320
7923	4	283	0	9	0	296
7924	3	6	1	281	0	291
7925	3	1	270	11	0	285
7926	0	260	8	7	0	275
7927	235	10	3	8	0	256
7928	234	3	6	8	0	251
7929	235	1	1	0	0	237
7930	236	1	1	3	0	241
7931	11	1	1	224	0	237
7932	5	222	2	6	0	235
7933	215	4	1	5	0	225
7934	8	3	224	1	0	236
7935	3	223	4	4	0	234
7936	3	6	210	1	0	220
7937	0	4	5	183	0	192
7938	0	169	3	6	0	178
7939	2	6	0	184	0	192
7940	0	3	187	7	0	197
7941	2	0	3	182	0	187
7942	1	0	4	198	0	203
7943	1	0	1	200	0	202
7944	192	0	0	7	0	199
7945	5	191	0	5	0	201
7946	4	4	1	188	0	197
7947	185	2	1	5	0	193
7948	3	186	1	3	0	193
7949	192	3	0	0	0	195
7950	5	2	197	1	0	205
7951	4	0	4	194	0	202
7952	1	200	3	4	0	208
7953	201	4	0	4	0	209
7954	4	3	205	0	0	212
7955	2	199	3	1	0	205
7956	1	3	3	199	0	206
7957	1	2	0	206	0	209
7958	202	1	0	6	0	209
7959	5	0	0	203	0	208
7960	4	0	189	3	0	196
7961	2	0	2	183	0	187
7962	1	0	186	4	0	191
7963	0	1	3	184	0	188
7964	2	185	1	2	0	190
7965	182	2	0	5	0	189
7966	182	3	1	0	0	186
7967	4	176	1	1	0	182
7968	2	162	1	1	0	166
7969	3	3	5	142	0	153
7970	145	1	1	1	0	148
7971	3	0	0	142	0	145
7972	142	0	0	2	0	144
7973	1	135	0	0	0	136
7974	2	0	0	138	0	140
7975	1	0	139	2	0	142
7976	1	1	1	141	0	144
7977	1	0	0	146	0	147
7978	147	0	0	3	0	150
7979	1	149	1	0	0	151
7980	1	0	0	153	0	154
7981	154	0	1	1	0	156
7982	3	0	151	0	0	154
7983	151	0	1	0	0	152
7984	1	0	1	154	0	156
7985	1	154	0	1	0	156
7986	156	1	0	0	0	157
7987	0	0	153	0	0	153
7988	0	1	151	0	0	152
7989	1	148	1	0	0	150
7990	134	0	2	2	0	138
7991	0	0	0	139	0	139
7992	0	0	0	145	0	145
7993	145	0	0	0	0	145
7994	1	0	144	0	0	145
7995	1	0	1	151	0	153
7996	0	0	159	1	0	160
7997	0	0	1	159	0	160
7998	0	158	0	1	0	159
7999	0	1	0	161	0	162
8000	0	0	161	1	0	162
8001	155	0	1	0	0	156
8002	1	0	0	161	0	162
8003	0	0	165	1	0	166
8004	0	0	1	164	0	165
8005	0	0	0	163	0	163
8006	0	0	166	1	0	167
8007	0	0	168	0	0	168
8008	0	0	1	174	0	175
8009	0	0	172	1	0	173
8010	171	0	1	0	0	172
8011	1	0	0	174	0	175
8012	177	0	0	1	0	178
8013	1	0	175	0	0	176
8014	1	0	1	176	0	178
8015	0	0	198	1	0	199
8016	0	193	1	0	0	194
8017	0	1	202	0	0	203
8018	0	0	196	0	0	196
8019	197	0	1	0	0	198
8020	197	0	0	0	0	197
8021	1	1	209	0	0	211
8022	0	0	1	204	0	205
8023	0	0	0	215	0	215
8024	0	0	217	1	0	218
8025	0	213	1	0	0	214
8026	213	1	0	0	0	214
8027	1	0	216	0	0	217
8028	1	0	1	222	0	224
8029	0	0	0	224	0	224
8030	227	0	0	1	0	228
8031	228	0	0	0	0	228
8032	227	0	0	1	0	228
8033	231	0	0	0	0	231
8034	1	0	0	232	0	233
8035	0	0	236	1	0	237
8036	0	0	1	232	0	233
8037	0	0	0	240	0	240
8038	0	0	1	247	0	248
8039	1	0	240	3	0	244
8040	238	1	2	0	0	241
8041	2	0	0	247	0	249
8042	0	0	252	2	0	254
8043	1	254	2	0	0	257
8044	2	2	0	261	0	265
8045	0	0	1	266	0	267
8046	263	0	0	3	0	266
8047	2	267	0	0	0	269
8048	0	2	270	0	0	272
8049	0	0	3	270	0	273
8050	0	0	0	264	0	264
8051	258	0	1	2	0	261
8052	265	0	0	0	0	265
8053	2	0	0	265	0	267
8054	264	0	0	2	0	266
8055	2	260	1	0	0	263
8056	0	2	278	1	0	281
8057	1	0	3	277	0	281
8058	0	1	0	285	0	286
8059	0	0	0	288	0	288
8060	0	0	1	285	0	286
8061	0	280	1	2	0	283
8062	281	2	0	0	0	283
8063	2	0	1	281	0	284
8064	0	294	0	3	0	297
8065	299	2	0	1	0	302
8066	298	0	1	0	0	299
8067	2	297	0	0	0	299
8068	1	2	0	313	0	316
8069	1	0	0	317	0	318
8070	0	0	0	316	0	316
8071	0	0	0	322	0	322
8072	325	0	0	3	0	328
8073	329	0	0	0	0	329
8074	4	337	0	0	0	341
8075	2	3	328	0	0	333
8076	0	1	3	334	0	338
8077	335	0	2	3	0	340
8078	3	319	0	2	0	324
8079	2	318	0	4	0	324
8080	334	3	0	1	0	338
8081	341	1	1	1	0	344
8082	7	0	2	341	0	350
8083	1	0	355	7	0	363
8084	1	0	383	2	0	386
8085	413	1	6	0	0	420
8086	425	0	1	3	0	429
8087	429	0	1	1	0	431
8088	425	1	0	1	0	427
8089	426	1	0	2	0	429
8090	6	431	2	1	0	440
8091	2	7	0	434	0	443
8092	1	455	0	3	0	459
8093	479	3	1	3	0	486
8094	476	2	1	5	0	484
8095	475	1	0	2	0	478
8096	475	1	0	0	0	476
8097	5	459	0	0	0	464
8098	468	4	3	1	0	476
8099	5	473	0	0	0	478
8100	2	5	0	482	0	489
8101	478	0	2	5	0	485
8102	5	0	496	2	0	503
8103	3	1	4	494	0	502
8104	2	0	0	509	0	511
8105	0	1	516	6	0	523
8106	0	519	4	2	0	525
8107	524	4	1	1	0	530
8108	520	1	0	0	0	521
8109	5	518	0	1	0	524
8110	3	3	0	530	0	536
8111	1	0	542	3	0	546
8112	0	575	4	1	0	580
8113	583	4	1	3	0	591
8114	5	1	581	1	0	588
8115	552	1	6	1	0	560
8116	568	0	1	2	0	571
8117	6	0	587	0	0	593
8118	1	589	4	0	0	594
8119	2	5	1	588	0	596
8120	0	0	610	4	0	614
8121	576	0	4	3	0	583
8122	609	0	1	0	0	610
8123	5	600	1	0	0	606
8124	1	7	0	603	0	611
8125	2	1	0	622	0	625
8126	1	0	625	6	0	632
8127	1	627	4	2	0	634
8128	677	4	4	1	0	686
8129	690	2	1	1	0	694
8130	701	0	0	3	0	704
8131	8	0	677	1	0	686
8132	688	1	5	1	0	695
8133	699	1	1	1	0	702
8134	8	1	0	693	0	702
8135	3	1	694	4	0	702
8136	1	1	3	698	0	703
8137	1	0	712	3	0	716
8138	2	1	4	692	0	699
8139	3	701	1	2	0	707
8140	2	766	0	3	0	771
8141	1	6	1	770	0	778
8142	3	1	0	759	0	763
8143	766	1	1	6	0	774
8144	5	1	754	3	0	763
8145	733	0	3	2	0	738
8146	4	763	0	0	0	767
8147	782	4	1	4	0	791
8148	784	1	0	1	0	786
8149	8	0	1	780	0	789
8150	3	1	831	4	0	839
8151	4	1	4	821	0	830
8152	2	875	1	3	0	881
8153	1	9	0	888	0	898
8154	1	1	0	898	0	900
8155	892	3	1	10	0	906
8156	7	1	2	883	0	893
8157	3	870	0	10	0	883
8158	3	6	1	888	0	898
8159	899	0	0	9	0	908
8160	6	913	0	2	0	921
8161	4	6	1	938	0	949
8162	2	3	0	944	0	949
8163	0	4	0	1001	0	1005
8164	2	0	1	976	0	979
8165	990	0	2	12	0	1004
8166	9	1	0	997	0	1007
8167	5	0	0	1013	0	1018
8168	2	0	1	1056	0	1059
8169	3	1041	0	17	0	1061
8170	1058	12	4	6	0	1080
8171	14	4	1064	2	0	1084
8172	5	1059	12	1	0	1077
8173	1052	11	2	5	0	1070
8174	14	3	1072	0	0	1089
8175	2	1081	13	1	0	1097
8176	7	13	2	1088	0	1110
8177	1	1102	4	11	0	1118
8178	1	14	1102	3	0	1120
8179	4	4	1121	1	0	1130
8180	0	1123	10	5	0	1138
8181	1123	12	5	3	0	1143
8182	1131	1	1	1	0	1134
8183	12	4	1097	1	0	1114
8184	5	5	1008	1	0	1019
8185	6	1	1050	0	0	1057
8186	1	2	16	1059	0	1078
8187	4	2	4	1060	0	1070
8188	2	0	3	1092	0	1097
8189	0	2	1124	15	0	1141
8190	2	2	10	1089	0	1103
8191	0	1	3	1123	0	1127
8192	0	2	1096	14	0	1112
8193	1070	0	14	9	0	1093
8194	11	1	4	1140	0	1156
8195	7	3	3	1141	0	1154
8196	6	1150	0	16	0	1172
8197	1151	12	2	10	0	1175
8198	13	3	1141	2	0	1159
8199	1122	2	14	2	0	1140
8200	14	0	5	1143	0	1162
8201	2	1	1153	17	0	1173
8202	2	2	10	1136	0	1150
8203	1149	1	3	20	0	1173
8204	11	0	1154	3	0	1168
8205	1126	2	12	7	0	1147
8206	1150	1	4	4	0	1159
8207	1156	0	6	2	0	1164
8208	19	1131	1	2	0	1153
8209	5	12	1	1158	0	1176
8210	1176	4	2	16	0	1198
8211	1159	4	2	6	0	1171
8212	1191	0	2	5	0	1198
8213	19	2	1158	2	0	1181
8214	1188	1	12	4	0	1205
8215	20	0	4	1270	0	1294
8216	3	0	1268	17	0	1288
8217	6	0	16	1325	0	1347
8218	4	0	5	1335	0	1344
8219	4	1	1373	20	0	1398
8220	7	0	16	1358	0	1381
8221	4	0	5	1419	0	1428
8222	3	2	1577	23	0	1605
8223	1626	2	26	14	0	1668
8224	1769	0	8	10	0	1787
8225	37	0	10	1824	0	1871
8226	19	0	1814	31	0	1864
8227	19	0	32	1792	0	1843
8228	12	1774	13	42	0	1841
8229	13	26	5	1785	0	1829
8230	8	7	10	1811	0	1836
8231	1784	6	7	47	0	1844
8232	1781	3	4	23	0	1811
8233	1802	1	5	23	0	1831
8234	42	4	6	1783	0	1835
8235	24	1	2	1808	0	1835
8236	18	3	1763	44	0	1828
8237	16	1	32	1749	0	1798
8238	13	1743	6	49	0	1811
8239	1755	29	11	23	0	1818
8240	37	1708	10	18	0	1773
8241	1720	34	4	20	0	1778
8242	39	14	7	1686	0	1746
8243	17	1700	6	35	0	1758
8244	1695	36	4	18	0	1753
8245	1708	12	4	19	0	1743
8246	46	15	5	1679	0	1745
8247	28	1675	1	36	0	1740
8248	24	36	2	1686	0	1748
8249	15	13	1662	45	0	1735
8250	1625	10	32	26	0	1693
8251	35	1636	11	20	0	1702
8252	1597	32	8	16	0	1653
8253	47	13	7	1593	0	1660
8254	1618	11	3	39	0	1671
8255	41	13	1633	14	0	1701
8256	1664	4	32	15	0	1715
8257	1670	8	14	18	0	1710
8258	55	8	1639	9	0	1711
8259	30	4	33	1632	0	1699
8260	28	4	13	1645	0	1690
8261	1606	5	11	46	0	1668
8262	43	1585	10	20	0	1658
8263	21	27	12	1549	0	1609
8264	19	11	1527	41	0	1598
8265	17	11	1514	22	0	1564
8266	9	1510	38	20	0	1577
8267	19	32	1488	17	0	1556
8268	1432	13	40	15	0	1500
8269	33	10	20	1406	0	1469
8270	1422	10	14	32	0	1478
8271	34	6	1411	19	0	1470
8272	15	5	32	1419	0	1471
8273	15	6	21	1434	0	1476
8274	20	7	1381	38	0	1446
8275	13	8	34	1384	0	1439
8276	1364	4	14	42	0	1424
8277	1374	6	12	27	0	1419
8278	39	3	12	1359	0	1413
8279	1344	4	12	35	0	1395
8280	1360	5	4	20	0	1389
8281	45	1319	5	18	0	1387
8282	29	24	9	1337	0	1399
8283	1319	8	6	43	0	1376
8284	43	8	8	1321	0	1380
8285	1308	9	7	32	0	1356
8286	42	8	4	1304	0	1358
8287	27	8	1282	46	0	1363
8288	23	1286	29	25	0	1363
8289	19	29	9	1197	0	1254
8290	17	1251	11	42	0	1321
8291	1243	34	14	20	0	1311
8292	33	1226	6	23	0	1288
8293	24	1220	12	18	0	1274
8294	22	39	9	1182	0	1252
8295	1183	18	14	33	0	1248
8296	41	20	6	1171	0	1238
8297	1170	13	5	37	0	1225
8298	1166	12	5	28	0	1211
8299	44	1161	5	25	0	1235
8300	1180	33	7	19	0	1239
8301	1181	17	6	13	0	1217
8302	1177	13	7	16	0	1213
8303	56	8	1117	10	0	1191
8304	33	11	24	1119	0	1187
8305	36	7	10	1138	0	1191
8306	31	5	1096	38	0	1170
8307	1120	10	26	21	0	1177
8308	1141	5	12	22	0	1180
8309	1141	4	13	19	0	1177
8310	1083	4	9	20	0	1116
8311	52	1047	9	13	0	1121
8312	1038	22	9	16	0	1085
8313	50	11	7	1019	0	1087
8314	33	7	946	30	0	1016
8315	902	10	21	13	0	946
8316	38	904	11	17	0	970
8317	828	21	5	12	0	866
8318	39	811	8	7	0	865
8319	20	769	4	9	0	802
8320	21	752	6	6	0	785
8321	15	720	8	11	0	754
8322	11	19	524	12	0	566
8323	12	46	15	408	0	481
8324	8	3	351	10	0	372
8325	255	4	9	5	0	273
8326	10	253	2	5	0	270
8327	5	256	0	4	0	265
8328	6	8	0	248	0	262
8329	5	3	1	250	0	259
8330	2	2	244	9	0	257
8331	1	1	247	5	0	254
8332	1	0	10	246	0	257
8333	2	2	244	9	0	257
8334	3	233	8	4	0	248
8335	6	4	3	237	0	250
8336	5	2	1	255	0	263
8337	5	2	242	7	0	256
8338	4	1	7	238	0	250
8339	241	1	2	8	0	252
8340	7	1	0	242	0	250
8341	4	0	5	238	0	247
8342	1	1	234	11	0	247
8343	232	1	6	3	0	242
8344	9	237	3	1	0	250
8345	4	6	0	230	0	240
8346	3	2	230	5	0	240
8347	3	3	5	226	0	237
8348	233	3	2	5	0	243
8349	5	1	232	5	0	243
8350	4	2	6	223	0	235
8351	0	0	228	10	0	238
8352	2	226	5	2	0	235
8353	1	7	223	2	0	233
8354	0	213	8	1	0	222
8355	1	6	167	0	0	174
8356	0	5	5	147	0	157
8357	0	144	2	5	0	151
8358	134	6	0	1	0	141
8359	5	1	0	137	0	143
8360	138	0	0	5	0	143
8361	5	1	0	144	0	150
8362	2	0	0	149	0	151
8363	145	0	0	8	0	153
8364	155	0	0	1	0	156
8365	9	0	0	158	0	167
8366	2	0	165	6	0	173
8367	1	171	5	2	0	179
8368	1	4	179	0	0	184
8369	0	184	5	1	0	190
8370	179	5	3	0	0	187
8371	5	3	172	0	0	180
8372	2	0	175	0	0	177
8373	0	2	7	165	0	174
8374	170	0	2	5	0	177
8375	5	0	179	2	0	186
8376	2	190	6	0	0	198
8377	194	5	2	1	0	202
8378	201	2	0	0	0	203
8379	204	0	1	0	0	205
8380	204	1	0	0	0	205
8381	201	0	0	1	0	202
8382	7	0	192	0	0	199
8383	2	0	5	189	0	196
8384	1	195	2	5	0	203
8385	199	4	0	3	0	206
8386	4	206	1	0	0	211
8387	194	2	0	1	0	197
8388	192	2	0	0	0	194
8389	4	189	0	0	0	193
8390	196	3	0	0	0	199
8391	3	1	0	199	0	203
8392	2	0	0	201	0	203
8393	0	1	194	3	0	198
8394	1	200	2	1	0	204
8395	0	2	1	204	0	207
8396	0	1	0	201	0	202
8397	0	0	1	199	0	200
8398	0	1	196	3	0	200
8399	196	0	2	2	0	200
8400	2	0	0	211	0	213
8401	219	0	0	3	0	222
8402	3	0	1	220	0	224
8403	3	0	227	2	0	232
8404	0	0	238	3	0	241
8405	233	0	4	0	0	237
8406	243	0	2	1	0	246
8407	3	243	1	0	0	247
8408	2	2	240	0	0	244
8409	1	2	2	240	0	245
8410	1	0	3	226	0	230
8411	264	1	0	4	0	269
8412	267	0	1	2	0	270
8413	267	0	0	1	0	268
8414	4	0	257	1	0	262
8415	270	0	2	0	0	272
8416	3	0	2	271	0	276
8417	3	0	0	271	0	274
8418	1	0	1	272	0	274
8419	1	270	0	4	0	275
8420	264	1	0	4	0	269
8421	2	2	0	263	0	267
8422	2	0	265	3	0	270
8423	0	1	2	262	0	265
8424	1	269	2	2	0	274
8425	268	2	0	3	0	273
8426	2	2	0	269	0	273
8427	1	0	0	265	0	266
8428	0	1	266	4	0	271
8429	1	0	2	264	0	267
8430	0	265	2	4	0	271
8431	1	2	0	275	0	278
8432	0	2	273	2	0	277
8433	268	0	2	2	0	272
8434	275	1	1	0	0	277
8435	4	280	0	1	0	285
8436	275	1	0	0	0	276
8437	284	2	0	0	0	286
8438	3	280	0	0	0	283
8439	1	1	0	285	0	287
8440	292	2	0	3	0	297
8441	2	302	0	2	0	306
8442	2	2	303	0	0	307
8443	304	2	2	0	0	308
8444	323	0	2	0	0	325
8445	324	0	0	0	0	324
8446	325	0	0	1	0	326
8447	4	339	0	0	0	343
8448	340	3	0	0	0	343
8449	345	2	0	0	0	347
8450	355	0	0	0	0	355
8451	5	0	0	355	0	360
8452	358	0	0	4	0	362
8453	3	375	0	2	0	380
8454	1	2	399	1	0	403
8455	0	2	4	427	0	433
8456	433	1	1	4	0	439
8457	3	0	430	3	0	436
8458	4	0	3	431	0	438
8459	1	0	429	3	0	433
8460	1	426	3	2	0	432
8461	1	3	2	423	0	429
8462	1	2	429	3	0	435
8463	0	422	2	2	0	426
8464	0	3	1	426	0	430
8465	434	1	1	5	0	441
8466	427	1	0	1	0	429
8467	425	0	0	0	0	425
8468	420	0	1	1	0	422
8469	420	0	1	1	0	422
8470	5	0	417	2	0	424
8471	424	1	4	0	0	429
8472	435	0	2	1	0	438
8473	5	0	1	435	0	441
8474	432	1	1	4	0	438
8475	417	1	0	3	0	421
8476	4	411	1	2	0	418
8477	2	5	1	411	0	419
8478	0	2	0	410	0	412
8479	405	0	1	5	0	411
8480	6	399	0	1	0	406
8481	4	410	0	0	0	414
8482	3	5	0	418	0	426
8483	3	1	0	418	0	422
8484	4	0	1	412	0	417
8485	2	1	1	416	0	420
8486	408	0	0	5	0	413
8487	407	0	0	2	0	409
8488	5	1	404	1	0	411
8489	5	0	4	398	0	407
8490	3	1	1	404	0	409
8491	1	0	393	4	0	398
8492	386	0	3	3	0	392
8493	5	399	1	1	0	406
8494	397	4	0	0	0	401
8495	4	2	0	394	0	400
8496	2	1	401	4	0	408
8497	1	0	3	404	0	408
8498	0	0	421	7	0	428
8499	1	413	4	3	0	421
8500	398	4	3	1	0	406
8501	395	0	0	1	0	396
8502	4	392	1	1	0	398
8503	0	2	1	384	0	387
8504	376	0	1	5	0	382
8505	3	373	1	3	0	380
8506	3	3	2	367	0	375
8507	371	2	0	3	0	376
8508	4	1	358	0	0	363
8509	356	0	3	2	0	361
8510	3	359	1	1	0	364
8511	351	3	1	2	0	357
8512	350	0	1	1	0	352
8513	4	2	345	0	0	351
8514	2	1	3	337	0	343
8515	1	0	0	344	0	345
8516	1	1	339	3	0	344
8517	0	2	3	342	0	347
8518	1	0	1	341	0	343
8519	349	1	0	4	0	354
8520	352	1	0	1	0	354
8521	4	0	1	352	0	357
8522	1	1	345	5	0	352
8523	1	0	4	349	0	354
8524	1	2	0	351	0	354
8525	1	1	355	4	0	361
8526	2	0	4	364	0	370
8527	366	1	1	3	0	371
8528	362	0	1	3	0	366
8529	4	359	0	4	0	367
8530	374	3	1	0	0	378
8531	371	0	1	1	0	373
8532	4	367	0	2	0	373
8533	376	3	0	2	0	381
8534	375	0	2	0	0	377
8535	379	0	0	2	0	381
8536	5	1	368	1	0	375
8537	367	0	4	2	0	373
8538	5	1	0	380	0	386
8539	380	0	1	5	0	386
8540	3	1	368	1	0	373
8541	1	358	4	2	0	365
8542	358	4	1	1	0	364
8543	6	364	2	0	0	372
8544	2	5	0	356	0	363
8545	4	0	0	358	0	362
8546	357	2	0	3	0	362
8547	341	1	0	2	0	344
8548	4	0	338	1	0	343
8549	3	0	324	0	0	327
8550	2	0	321	0	0	323
8551	1	3	4	310	0	318
8552	3	0	310	4	0	317
8553	1	0	294	2	0	297
8554	3	9	3	275	0	290
8555	288	0	1	4	0	293
8556	289	0	2	0	0	291
8557	289	0	0	1	0	290
8558	290	0	1	1	0	292
8559	3	0	0	290	0	293
8560	1	0	1	295	0	297
8561	1	0	308	2	0	311
8562	1	0	2	306	0	309
8563	1	0	0	316	0	317
8564	326	0	0	3	0	329
8565	324	0	0	1	0	325
8566	4	0	0	326	0	330
8567	327	0	0	5	0	332
8568	333	0	0	2	0	335
8569	3	0	2	333	0	338
8570	2	0	0	333	0	335
8571	1	0	333	5	0	339
8572	2	0	331	1	0	334
8573	1	0	3	331	0	335
8574	0	1	1	344	0	346
8575	2	0	342	2	0	346
8576	331	1	3	3	0	338
8577	336	0	0	4	0	340
8578	3	0	337	2	0	342
8579	2	335	4	0	0	341
8580	345	3	1	1	0	350
8581	3	0	365	0	0	368
8582	0	1	4	365	0	370
8583	1	0	2	373	0	376
8584	390	0	2	5	0	397
8585	411	0	1	5	0	417
8586	3	0	2	424	0	429
8587	2	1	0	453	0	456
8588	454	0	0	4	0	458
8589	461	0	1	3	0	465
8590	460	0	0	2	0	462
8591	7	0	457	1	0	465
8592	4	0	5	468	0	477
8593	4	0	0	482	0	486
8594	474	0	3	5	0	482
8595	5	477	2	3	0	487
8596	535	5	1	4	0	545
8597	9	541	0	2	0	552
8598	3	6	1	558	0	568
8599	3	0	2	570	0	575
8600	2	1	562	9	0	574
8601	5	0	8	562	0	575
8602	2	1	569	9	0	581
8603	2	1	8	575	0	586
8604	2	0	2	579	0	583
8605	0	552	2	11	0	565
8606	0	589	0	5	0	594
8607	1	9	1	570	0	581
8608	2	1	2	587	0	592
8609	2	1	0	590	0	593
8610	2	0	1	591	0	594
8611	2	0	0	607	0	609
8612	1	1	595	11	0	608
8613	3	1	8	598	0	610
8614	1	1	2	605	0	609
8615	0	0	591	13	0	604
8616	0	585	8	6	0	599
8617	2	8	1	593	0	604
8618	1	1	599	10	0	611
8619	1	600	8	4	0	613
8620	2	8	1	610	0	621
8621	630	0	2	10	0	642
8622	11	1	0	632	0	644
8623	2	0	3	634	0	639
8624	2	2	2	644	0	650
8625	2	1	1	638	0	642
8626	2	607	1	11	0	621
8627	1	9	0	630	0	640
8628	667	1	1	13	0	682
8629	12	2	0	667	0	681
8630	2	1	0	666	0	669
8631	2	0	2	663	0	667
8632	644	1	0	18	0	663
8633	656	0	2	7	0	665
8634	10	3	2	662	0	677
8635	645	2	1	10	0	658
8636	660	0	1	6	0	667
8637	9	666	0	6	0	681
8638	664	7	1	6	0	678
8639	8	660	0	5	0	673
8640	3	679	0	3	0	685
8641	3	6	2	685	0	696
8642	1	3	702	9	0	715
8643	2	2	6	691	0	701
8644	3	1	0	700	0	704
8645	0	686	0	10	0	696
8646	695	6	2	5	0	708
8647	7	0	0	693	0	700
8648	1	1	732	9	0	743
8649	2	1	7	739	0	749
8650	1	748	0	8	0	757
8651	760	6	0	4	0	770
8652	7	0	1	761	0	769
8653	0	2	778	8	0	788
8654	3	0	6	772	0	781
8655	2	748	0	6	0	756
8656	2	5	0	763	0	770
8657	802	0	0	12	0	814
8658	814	0	2	3	0	819
8659	822	0	1	4	0	827
8660	6	837	0	3	0	846
8661	839	8	0	4	0	851
8662	11	2	0	846	0	859
8663	822	0	0	13	0	835
8664	10	835	2	2	0	849
8665	1	8	0	851	0	860
8666	2	3	867	9	0	881
8667	830	0	7	2	0	839
8668	8	871	1	2	0	882
8669	3	8	1	878	0	890
8670	1	1	0	905	0	907
8671	0	2	2	894	0	898
8672	2	1	0	875	0	878
8673	2	868	1	10	0	881
8674	884	9	0	2	0	895
8675	880	2	0	3	0	885
8676	9	1	892	2	0	904
8677	3	0	6	899	0	908
8678	1	1	904	10	0	916
8679	910	3	7	3	0	923
8680	918	1	1	2	0	922
8681	880	0	2	5	0	887
8682	9	0	3	866	0	878
8683	2	867	1	10	0	880
8684	879	9	0	2	0	890
8685	10	1	0	854	0	865
8686	865	0	0	10	0	875
8687	7	1	838	3	0	849
8688	2	2	827	2	0	833
8689	852	3	7	2	0	864
8690	11	1	1	859	0	872
8691	855	0	1	6	0	862
8692	7	848	2	2	0	859
8693	863	6	0	1	0	870
8694	871	2	1	2	0	876
8695	10	2	862	4	0	878
8696	6	0	796	0	0	802
8697	1	797	5	2	0	805
8698	5	5	3	805	0	818
8699	810	3	4	4	0	821
8700	6	0	1	813	0	820
8701	3	0	1	828	0	832
8702	3	1	808	5	0	817
8703	800	2	6	4	0	812
8704	9	1	2	832	0	844
8705	3	1	819	8	0	831
8706	3	1	783	4	0	791
8707	2	2	6	813	0	823
8708	3	3	807	6	0	819
8709	5	2	799	1	0	807
8710	2	7	5	783	0	797
8711	0	1	830	4	0	835
8712	2	1	3	814	0	820
8713	1	791	3	5	0	800
8714	847	4	0	4	0	855
8715	4	864	0	2	0	870
8716	3	5	0	868	0	876
8717	1	893	2	6	0	902
8718	2	6	921	2	0	931
8719	3	2	5	1069	0	1079
8720	4	0	1233	9	0	1246
8721	1241	0	19	3	0	1263
8722	16	1292	3	4	0	1315
8723	1307	15	5	1	0	1328
8724	20	2	2	1297	0	1321
8725	1301	2	0	20	0	1323
8726	18	1	1284	2	0	1305
8727	4	1284	17	4	0	1309
8728	1262	16	1	2	0	1281
8729	19	2	1	1232	0	1254
8730	4	1265	2	17	0	1288
8731	4	15	4	1288	0	1311
8732	1276	3	1	18	0	1298
8733	14	1357	6	5	0	1382
8734	1369	15	1	4	0	1389
8735	20	7	1352	3	0	1382
8736	1359	3	15	5	0	1382
8737	22	2	5	1352	0	1381
8738	1347	4	3	20	0	1374
8739	23	1333	5	4	0	1365
8740	7	18	3	1338	0	1366
8741	8	5	3	1353	0	1369
8742	5	4	1296	22	0	1327
8743	6	5	15	1289	0	1315
8744	2	4	3	1325	0	1334
8745	3	1	3	1321	0	1328
8746	4	3	2	1331	0	1340
8747	5	1	1300	23	0	1329
8748	3	1240	19	8	0	1270
8749	10	16	3	1253	0	1282
8750	1236	4	5	26	0	1271
8751	1242	3	3	9	0	1257
8752	17	1241	7	6	0	1271
8753	1223	19	3	7	0	1252
8754	1232	3	5	9	0	1249
8755	1217	1	4	9	0	1231
8756	21	1200	5	7	0	1233
8757	1155	19	0	8	0	1182
8758	21	6	1	1130	0	1158
8759	6	4	1110	19	0	1139
8760	8	1099	17	7	0	1131
8761	5	29	6	1083	0	1123
8762	9	3	1071	18	0	1101
8763	1069	6	13	7	0	1095
8764	20	2	4	1066	0	1092
8765	6	5	5	1062	0	1078
8766	8	2	5	1044	0	1059
8767	7	2	4	1044	0	1057
8768	6	2	1012	19	0	1039
8769	978	3	15	10	0	1006
8770	17	986	4	12	0	1019
8771	992	17	4	7	0	1020
8772	17	988	4	10	0	1019
8773	995	19	5	3	0	1022
8774	22	7	3	994	0	1026
8775	6	7	981	17	0	1011
8776	8	2	980	8	0	998
8777	6	7	19	976	0	1008
8778	5	3	6	980	0	994
8779	5	4	3	981	0	993
8780	962	2	4	23	0	991
8781	20	1	968	12	0	1001
8782	5	962	15	11	0	993
8783	7	983	4	7	0	1001
8784	965	17	3	9	0	994
8785	21	8	955	5	0	989
8786	6	950	16	5	0	977
8787	7	18	927	7	0	959
8788	4	3	20	926	0	953
8789	6	3	914	19	0	942
8790	3	2	923	9	0	937
8791	4	6	17	919	0	946
8792	5	1	902	21	0	929
8793	5	3	900	10	0	918
8794	4	3	21	895	0	923
8795	872	4	8	17	0	901
8796	17	7	859	8	0	891
8797	4	5	16	865	0	890
8798	6	3	8	869	0	886
8799	853	2	5	20	0	880
8800	14	4	8	847	0	873
8801	830	2	7	21	0	860
8802	17	835	4	12	0	868
8803	7	12	6	842	0	867
8804	835	3	5	21	0	864
8805	843	6	5	7	0	861
8806	20	2	6	842	0	870
8807	6	3	830	20	0	859
8808	823	2	15	7	0	847
8809	18	833	3	7	0	861
8810	796	12	5	7	0	820
8811	821	2	6	7	0	836
8812	827	4	4	5	0	840
8813	19	6	798	7	0	830
8814	10	776	13	5	0	804
8815	7	20	4	753	0	784
8816	7	12	8	761	0	788
8817	6	4	730	18	0	758
8818	3	689	15	6	0	713
8819	2	518	0	8	0	528
8820	0	373	2	2	0	377
8821	313	0	15	3	0	331
8822	6	1	1	289	0	297
8823	1	1	0	284	0	286
8824	0	1	284	0	0	285
8825	279	1	0	1	0	281
8826	1	0	0	285	0	286
8827	1	1	0	285	0	287
8828	2	0	283	1	0	286
8829	1	283	2	0	0	286
8830	2	6	0	275	0	283
8831	0	1	273	2	0	276
8832	1	256	2	1	0	260
8833	183	0	1	0	0	184
8834	0	1	195	0	0	196
8835	1	0	0	187	0	188
8836	0	193	1	0	0	194
8837	189	0	2	0	0	191
8838	0	0	0	192	0	192
8839	191	1	0	3	0	195
8840	192	0	1	0	0	193
8841	0	191	1	0	0	192
8842	194	1	0	0	0	195
8843	201	1	0	1	0	203
8844	0	0	207	0	0	207
8845	205	0	0	1	0	206
8846	0	0	203	1	0	204
8847	203	0	1	0	0	204
8848	204	0	0	0	0	204
8849	0	0	207	1	0	208
8850	0	0	0	199	0	199
8851	0	0	210	0	0	210
8852	0	1	201	0	0	202
8853	0	0	239	1	0	240
8854	1	0	0	236	0	237
8855	0	2	0	250	0	252
8856	1	0	0	259	0	260
8857	2	0	0	268	0	270
8858	0	0	281	2	0	283
8859	0	1	2	288	0	291
8860	1	285	0	4	0	290
8861	0	4	301	1	0	306
8862	2	0	4	302	0	308
8863	1	0	303	4	0	308
8864	0	302	4	0	0	306
8865	1	309	0	0	0	310
8866	1	4	0	306	0	311
8867	0	0	307	4	0	311
8868	1	0	310	0	0	311
8869	0	0	5	312	0	317
8870	2	0	0	311	0	313
8871	1	0	0	316	0	317
8872	0	0	311	8	0	319
8873	0	311	3	1	0	315
8874	0	323	1	1	0	325
8875	0	4	1	321	0	326
8876	0	0	307	4	0	311
8877	2	0	305	1	0	308
8878	0	319	5	1	0	325
8879	324	5	0	2	0	331
8880	5	321	0	0	0	326
8881	0	3	330	0	0	333
8882	323	0	6	1	0	330
8883	6	1	1	336	0	344
8884	346	0	1	6	0	353
8885	6	0	0	351	0	357
8886	1	0	1	356	0	358
8887	358	1	0	7	0	366
8888	5	372	1	1	0	379
8889	1	6	365	1	0	373
8890	0	377	6	0	0	383
8891	379	6	2	1	0	388
8892	5	376	0	1	0	382
8893	385	6	0	1	0	392
8894	386	2	0	1	0	389
8895	7	386	1	1	0	395
8896	3	7	1	377	0	388
8897	379	3	0	6	0	388
8898	384	0	0	2	0	386
8899	7	0	1	374	0	382
8900	1	0	375	6	0	382
8901	0	3	378	1	0	382
8902	1	0	6	380	0	387
8903	0	1	382	7	0	390
8904	366	0	6	1	0	373
8905	8	380	1	0	0	389
8906	2	7	2	380	0	391
8907	3	1	0	388	0	392
8908	4	0	0	385	0	389
8909	1	0	1	384	0	386
8910	2	0	0	393	0	395
8911	0	1	389	7	0	397
8912	1	384	6	1	0	392
8913	388	6	1	1	0	396
8914	6	1	1	387	0	395
8915	1	0	0	395	0	396
8916	1	0	1	396	0	398
8917	0	381	0	9	0	390
8918	1	6	1	394	0	402
8919	0	1	1	402	0	404
8920	390	0	0	9	0	399
8921	6	389	1	3	0	399
8922	2	398	0	1	0	401
8923	0	8	1	392	0	401
8924	393	1	0	8	0	402
8925	6	1	394	2	0	403
8926	381	0	6	2	0	389
8927	5	0	415	2	0	422
8928	2	0	6	418	0	426
8929	0	0	2	422	0	424
8930	0	0	0	421	0	421
8931	1	0	0	418	0	419
8932	1	0	0	414	0	415
8933	415	0	0	9	0	424
8934	7	0	399	2	0	408
8935	2	0	6	406	0	414
8936	0	1	418	7	0	426
8937	0	421	6	2	0	429
8938	420	6	1	0	0	427
8939	7	1	443	0	0	451
8940	1	0	6	454	0	461
8941	1	0	1	463	0	465
8942	1	0	462	7	0	470
8943	2	1	451	1	0	455
8944	2	0	7	437	0	446
8945	460	0	1	7	0	468
8946	463	0	0	3	0	466
8947	7	457	0	1	0	465
8948	465	6	0	3	0	474
8949	7	1	0	461	0	469
8950	1	486	0	6	0	493
8951	1	6	0	487	0	494
8952	0	1	493	6	0	500
8953	1	0	6	452	0	459
8954	0	0	1	466	0	467
8955	443	0	0	10	0	453
8956	5	443	0	1	0	449
8957	440	4	1	1	0	446
8958	4	432	1	1	0	438
8959	424	2	0	1	0	427
8960	2	422	1	0	0	425
8961	1	419	1	0	0	421
8962	424	3	0	1	0	428
8963	3	1	0	416	0	420
8964	2	427	0	3	0	432
8965	434	3	0	2	0	439
8966	431	1	0	1	0	433
8967	434	0	0	1	0	435
8968	429	1	0	1	0	431
8969	3	440	0	1	0	444
8970	1	2	1	459	0	463
8971	0	1	0	463	0	464
8972	465	0	0	4	0	469
8973	4	0	0	466	0	470
8974	464	1	0	3	0	468
8975	2	1	452	1	0	456
8976	454	1	1	2	0	458
8977	2	1	472	0	0	475
8978	1	4	2	466	0	473
8979	465	1	0	2	0	468
8980	2	464	0	1	0	467
8981	447	0	0	1	0	448
8982	0	443	0	2	0	445
8983	1	3	0	473	0	477
8984	1	0	470	0	0	471
8985	441	0	0	1	0	442
8986	1	470	0	0	0	471
8987	0	3	0	469	0	472
8988	0	0	1	459	0	460
8989	0	0	1	455	0	456
8990	1	0	465	0	0	466
8991	0	460	0	1	0	461
8992	460	0	0	0	0	460
8993	452	0	0	2	0	454
8994	1	459	0	2	0	462
8995	480	0	1	1	0	482
8996	0	2	0	487	0	489
8997	1	474	0	0	0	475
8998	487	0	0	0	0	487
8999	1	0	482	0	0	483
9000	0	485	0	0	0	485
9001	0	0	0	487	0	487
9002	0	0	0	498	0	498
9003	0	1	491	0	0	492
9004	0	0	0	480	0	480
9005	0	0	487	0	0	487
9006	0	0	0	494	0	494
9007	0	0	0	487	0	487
9008	0	0	0	489	0	489
9009	0	0	0	488	0	488
9010	0	1	488	0	0	489
9011	0	0	525	1	0	526
9012	0	570	0	0	0	570
9013	0	2	0	618	0	620
9014	1	0	654	3	0	658
9015	0	636	4	0	0	640
9016	1	4	0	673	0	678
9017	0	0	701	3	0	704
9018	679	0	5	2	0	686
9019	737	0	0	0	0	737
9020	5	0	0	736	0	741
9021	2	4	728	5	0	739
9022	0	0	4	735	0	739
9023	731	0	4	6	0	741
9024	5	733	0	1	0	739
9025	759	5	0	3	0	767
9026	774	1	0	1	0	776
9027	8	0	0	741	0	749
9028	3	0	0	749	0	752
9029	1	0	0	754	0	755
9030	1	0	0	750	0	751
9031	0	0	0	744	0	744
9032	747	0	0	6	0	753
9033	744	0	0	2	0	746
9034	741	0	0	0	0	741
9035	6	0	715	0	0	721
9036	706	1	3	0	0	710
9037	5	0	1	714	0	720
9038	1	0	716	5	0	722
9039	0	688	5	2	0	695
9040	0	6	1	700	0	707
9041	0	1	0	705	0	706
9042	0	699	0	8	0	707
9043	1	8	0	737	0	746
9044	0	1	729	7	0	737
9045	0	0	742	1	0	743
9046	0	1	8	746	0	755
9047	740	0	3	10	0	753
9048	730	1	1	2	0	734
9049	9	0	734	2	0	745
9050	2	692	9	0	0	703
9051	1	714	1	2	0	718
9052	688	7	2	0	0	697
9053	6	1	697	2	0	706
9054	2	0	8	698	0	708
9055	697	1	1	8	0	707
9056	9	683	0	1	0	693
9057	1	694	0	0	0	695
9058	686	8	0	2	0	696
9059	9	1	0	695	0	705
9060	728	0	0	9	0	737
9061	9	0	0	836	0	845
9062	2	0	0	845	0	847
9063	3	0	841	19	0	863
9064	1	0	14	851	0	866
9065	3	0	3	876	0	882
9066	872	0	2	19	0	893
9067	17	0	1	886	0	904
9068	4	0	886	17	0	907
9069	876	0	17	4	0	897
9070	19	1	4	876	0	900
9071	870	0	3	19	0	892
9072	19	847	2	5	0	873
9073	5	879	0	4	0	888
9074	869	19	0	7	0	895
9075	879	4	3	0	0	886
9076	21	3	1	871	0	896
9077	5	1	858	19	0	883
9078	8	0	17	853	0	878
9079	851	1	3	22	0	877
9080	18	856	3	5	0	882
9081	6	17	3	854	0	880
9082	859	5	2	20	0	886
9083	19	4	822	5	0	850
9084	830	4	18	4	0	856
9085	812	0	3	5	0	820
9086	24	0	827	1	0	852
9087	6	2	840	4	0	852
9088	5	1	22	811	0	839
9089	3	2	4	861	0	870
9090	1	840	6	21	0	868
9091	3	18	0	848	0	869
9092	3	3	848	23	0	877
9093	6	2	18	853	0	879
9094	3	1	5	885	0	894
9095	1	2	853	24	0	880
9096	1	849	23	8	0	881
9097	1	19	4	850	0	874
9098	1	2	3	873	0	879
9099	853	3	2	22	0	880
9100	20	2	1	848	0	871
9101	3	1	836	24	0	864
9102	825	2	21	6	0	854
9103	852	2	3	6	0	863
9104	854	1	4	5	0	864
9105	23	2	827	2	0	854
9106	8	3	19	820	0	850
9107	6	2	2	839	0	849
9108	6	1	3	849	0	859
9109	821	1	2	27	0	851
9110	20	809	2	8	0	839
9111	6	21	737	8	0	772
9112	6	719	18	6	0	749
9113	3	692	6	3	0	704
9114	1	669	3	5	0	678
9115	1	22	2	655	0	680
9116	5	8	634	18	0	665
9117	586	6	13	11	0	616
9118	14	612	8	5	0	639
9119	583	14	4	2	0	603
9120	14	597	2	5	0	618
9121	616	16	2	4	0	638
9122	16	620	0	3	0	639
9123	3	21	637	2	0	663
9124	6	6	12	633	0	657
9125	6	2	4	656	0	668
9126	634	1	3	21	0	659
9127	15	1	5	688	0	709
9128	5	5	679	20	0	709
9129	6	1	14	688	0	709
9130	4	3	679	16	0	702
9131	1	681	16	12	0	710
9132	8	13	5	668	0	694
9133	2	687	6	17	0	712
9134	688	16	3	6	0	713
9135	19	4	1	687	0	711
9136	7	3	688	14	0	712
9137	3	2	690	6	0	701
9138	674	2	22	7	0	705
9139	13	1	5	674	0	693
9140	6	4	672	13	0	695
9141	3	3	644	10	0	660
9142	3	646	18	5	0	672
9143	3	12	8	608	0	631
9144	2	625	4	14	0	645
9145	2	13	4	633	0	652
9146	624	6	3	15	0	648
9147	12	3	3	639	0	657
9148	5	3	1	649	0	658
9149	654	1	2	22	0	679
9150	17	2	1	697	0	717
9151	5	1	3	716	0	725
9152	7	727	0	22	0	756
9153	734	14	1	9	0	758
9154	741	4	1	6	0	752
9155	19	2	5	730	0	756
9156	12	2	1	736	0	751
9157	7	0	0	739	0	746
9158	2	699	0	25	0	726
9159	5	725	2	5	0	737
9160	4	17	0	674	0	695
9161	550	3	1	12	0	566
9162	561	0	2	8	0	571
9163	11	547	2	1	0	561
9164	521	7	0	4	0	532
9165	9	510	2	5	0	526
9166	3	511	4	3	0	521
9167	14	11	2	484	0	511
9168	486	5	0	5	0	496
9169	4	475	0	6	0	485
9170	4	481	2	3	0	490
9171	5	5	0	485	0	495
9172	4	4	0	485	0	493
9173	1	1	474	11	0	487
9174	466	2	4	6	0	478
9175	471	3	2	2	0	478
9176	5	3	471	3	0	482
9177	3	2	473	3	0	481
9178	2	2	6	476	0	486
9179	3	3	3	485	0	494
9180	4	478	0	9	0	491
9181	1	5	1	494	0	501
9182	1	4	482	9	0	496
9183	1	4	6	483	0	494
9184	1	4	2	487	0	494
9185	473	2	1	10	0	486
9186	6	1	463	12	0	482
9187	456	1	5	5	0	467
9188	6	2	452	2	0	462
9189	3	2	5	442	0	452
9190	0	2	441	8	0	451
9191	1	1	440	4	0	446
9192	2	3	7	431	0	443
9193	418	2	5	5	0	430
9194	410	2	1	5	0	418
9195	6	414	3	1	0	424
9196	407	5	1	8	0	421
9197	410	3	2	4	0	419
9198	5	410	1	4	0	420
9199	6	4	2	417	0	429
9200	4	3	2	421	0	430
9201	0	2	2	422	0	426
9202	1	0	1	425	0	427
9203	3	1	411	9	0	424
9204	409	2	8	4	0	423
9205	9	1	2	412	0	424
9206	5	0	1	420	0	426
9207	0	413	2	9	0	424
9208	0	6	0	421	0	427
9209	1	3	408	8	0	420
9210	413	1	4	7	0	425
9211	6	2	416	3	0	427
9212	2	0	7	409	0	418
9213	411	2	3	7	0	423
9214	6	413	0	6	0	425
9215	3	5	2	428	0	438
9216	2	4	428	5	0	439
9217	1	2	7	427	0	437
9218	415	0	2	9	0	426
9219	9	1	413	3	0	426
9220	1	4	398	2	0	405
9221	1	384	8	5	0	398
9222	375	5	8	2	0	390
9223	6	358	0	4	0	368
9224	2	5	345	2	0	354
9225	0	2	330	1	0	333
9226	2	330	6	2	0	340
9227	282	6	1	1	0	290
9228	5	285	1	1	0	292
9229	0	5	2	287	0	294
9230	0	1	0	296	0	297
9231	3	1	289	6	0	299
9232	1	2	6	291	0	300
9233	0	0	292	7	0	299
9234	283	1	7	0	0	291
9235	292	1	0	1	0	294
9236	293	1	0	1	0	295
9237	5	1	286	1	0	293
9238	286	1	6	1	0	294
9239	5	2	0	283	0	290
9240	2	284	3	6	0	295
9241	284	7	0	2	0	293
9242	4	0	285	1	0	290
9243	278	0	5	2	0	285
9244	279	1	1	1	0	282
9245	7	1	263	1	0	272
9246	0	268	7	1	0	276
9247	3	6	1	265	0	275
9248	1	0	265	8	0	274
9249	2	1	246	0	0	249
9250	3	8	6	190	0	207
9251	0	0	182	2	0	184
9252	0	0	2	164	0	166
9253	0	0	0	155	0	155
9254	0	0	0	164	0	164
9255	0	0	163	2	0	165
9256	0	0	2	157	0	159
9257	0	0	163	2	0	165
9258	0	0	2	163	0	165
9259	172	0	0	2	0	174
9260	2	0	0	174	0	176
9261	0	172	0	2	0	174
9262	0	2	0	184	0	186
9263	185	0	0	2	0	187
9264	2	186	0	0	0	188
9265	0	2	0	185	0	187
9266	185	0	0	2	0	187
9267	2	0	188	0	0	190
9268	0	0	2	183	0	185
9269	0	0	184	2	0	186
9270	0	0	182	0	0	182
9271	0	0	2	182	0	184
9272	186	0	0	2	0	188
9273	2	0	186	0	0	188
9274	183	0	2	0	0	185
9275	2	0	0	183	0	185
9276	0	0	181	2	0	183
9277	0	0	177	0	0	177
9278	0	0	179	0	0	179
9279	0	0	3	168	0	171
9280	162	2	5	3	0	172
9281	2	160	0	0	0	162
9282	1	1	0	164	0	166
9283	0	0	0	167	0	167
9284	165	0	0	2	0	167
9285	169	0	0	0	0	169
9286	2	169	0	0	0	171
9287	169	2	0	0	0	171
9288	168	0	0	0	0	168
9289	2	0	0	170	0	172
9290	0	0	177	2	0	179
9291	173	0	2	1	0	176
9292	2	0	0	187	0	189
9293	0	0	0	189	0	189
9294	184	0	0	2	0	186
9295	2	0	0	176	0	178
9296	0	0	0	179	0	179
9297	174	0	0	2	0	176
9298	2	174	0	0	0	176
9299	173	2	0	0	0	175
9300	2	0	172	0	0	174
9301	170	0	1	0	0	171
9302	1	0	0	172	0	173
9303	0	178	0	1	0	179
9304	0	1	0	178	0	179
9305	0	0	0	179	0	179
9306	0	0	0	178	0	178
9307	174	0	0	1	0	175
9308	1	169	0	0	0	170
9309	0	171	0	0	0	171
9310	169	1	1	0	0	171
9311	0	1	170	0	0	171
9312	0	0	168	0	0	168
9313	166	1	1	1	0	169
9314	3	0	171	0	0	174
9315	0	0	1	170	0	171
9316	0	0	0	160	0	160
9317	0	0	0	175	0	175
9318	0	0	0	174	0	174
9319	0	164	0	2	0	166
9320	0	2	0	173	0	175
9321	0	1	167	2	0	170
9322	0	0	2	167	0	169
9323	0	0	161	2	0	163
9324	0	0	161	0	0	161
9325	0	0	2	161	0	163
9326	0	0	163	2	0	165
9327	0	0	2	160	0	162
9328	156	0	1	2	0	159
9329	2	0	153	0	0	155
9330	149	0	2	0	0	151
9331	2	0	0	148	0	150
9332	1	2	144	2	0	149
9333	0	145	2	0	0	147
9334	0	2	0	158	0	160
9335	0	0	166	2	0	168
9336	1	0	2	162	0	165
9337	167	0	0	2	0	169
9338	170	0	0	0	0	170
9339	178	0	0	0	0	178
9340	3	0	0	186	0	189
9341	0	0	0	197	0	197
9342	0	0	0	200	0	200
9343	205	0	0	3	0	208
9344	3	206	0	0	0	209
9345	0	3	0	206	0	209
9346	1	0	0	209	0	210
9347	209	0	0	4	0	213
9348	3	209	0	0	0	212
9349	1	3	0	221	0	225
9350	226	0	0	3	0	229
9351	223	0	0	0	0	223
9352	3	0	0	221	0	224
9353	223	0	0	3	0	226
9354	4	0	0	225	0	229
9355	2	0	234	3	0	239
9356	1	0	3	231	0	235
9357	1	0	0	239	0	240
9358	1	0	0	239	0	240
9359	227	0	0	3	0	230
9360	3	228	0	1	0	232
9361	225	3	0	0	0	228
9362	3	220	0	0	0	223
9363	0	224	0	0	0	224
9364	225	3	0	0	0	228
9365	3	228	0	0	0	231
9366	0	3	0	228	0	231
9367	222	0	0	3	0	225
9368	225	0	0	0	0	225
9369	3	0	0	224	0	227
9370	0	0	0	224	0	224
9371	0	221	0	3	0	224
9372	229	3	0	0	0	232
9373	228	0	0	0	0	228
9374	3	234	0	0	0	237
9375	0	249	0	0	0	249
9376	0	3	0	247	0	250
9377	251	0	0	2	0	253
9378	2	0	0	251	0	253
9379	1	0	0	253	0	254
9380	0	0	248	3	0	251
9381	0	0	244	1	0	245
9382	0	0	2	244	0	246
9383	0	0	243	2	0	245
9384	0	248	2	0	0	250
9385	0	2	0	250	0	252
9386	1	0	0	249	0	250
9387	1	0	0	259	0	260
9388	0	1	258	2	0	261
9389	0	0	247	1	0	248
9390	252	0	4	0	0	256
9391	2	257	0	0	0	259
9392	248	2	0	1	0	251
9393	4	0	0	248	0	252
9394	249	0	0	3	0	252
9395	2	0	1	248	0	251
9396	0	250	0	3	0	253
9397	252	2	0	2	0	256
9398	2	0	248	1	0	251
9399	1	249	2	0	0	252
9400	253	4	0	0	0	257
9401	3	0	0	252	0	255
9402	0	244	0	2	0	246
9403	0	2	0	255	0	257
9404	255	0	0	3	0	258
9405	3	1	1	254	0	259
9406	254	1	0	5	0	260
9407	4	0	251	1	0	256
9408	1	0	3	255	0	259
9409	248	0	0	5	0	253
9410	3	0	244	0	0	247
9411	0	242	4	0	0	246
9412	3	3	0	236	0	242
9413	1	1	239	3	0	244
9414	0	1	226	0	0	227
9415	0	0	3	221	0	224
9416	1	0	218	4	0	223
9417	1	0	214	0	0	215
9418	1	1	2	217	0	221
9419	220	0	0	3	0	223
9420	2	0	2	218	0	222
9421	0	1	1	221	0	223
9422	1	0	225	3	0	229
9423	0	0	3	228	0	231
9424	233	2	0	2	0	237
9425	2	0	233	2	0	237
9426	1	236	2	1	0	240
9427	0	2	0	242	0	244
9428	253	0	1	2	0	256
9429	2	0	2	252	0	256
9430	1	255	0	3	0	259
9431	1	3	258	0	0	262
9432	1	0	3	258	0	262
9433	283	1	0	4	0	288
9434	5	0	275	1	0	281
9435	1	0	3	283	0	287
9436	292	1	2	5	0	300
9437	337	0	0	4	0	341
9438	11	332	2	1	0	346
9439	331	9	1	0	0	341
9440	9	4	0	317	0	330
9441	4	0	314	9	0	327
9442	0	306	8	4	0	318
9443	0	318	3	1	0	322
9444	0	12	1	304	0	317
9445	0	3	0	316	0	319
9446	1	0	304	9	0	314
9447	0	294	8	2	0	304
9448	0	299	3	0	0	302
9449	0	11	0	284	0	295
9450	280	3	0	8	0	291
9451	7	277	0	4	0	288
9452	2	7	1	282	0	292
9453	288	2	1	9	0	300
9454	9	1	0	293	0	303
9455	4	0	0	291	0	295
9456	0	0	1	294	0	295
9457	0	0	1	291	0	292
9458	284	1	0	11	0	296
9459	10	1	0	287	0	298
9460	3	1	284	9	0	297
9461	279	0	8	4	0	291
9462	9	1	275	0	0	285
9463	5	0	303	1	0	309
9464	2	1	11	298	0	312
9465	0	1	2	304	0	307
9466	0	0	0	311	0	311
9467	299	0	0	13	0	312
9468	8	0	299	4	0	311
9469	301	0	8	1	0	310
9470	311	1	2	1	0	315
9471	13	0	308	1	0	322
9472	307	1	7	0	0	315
9473	9	1	310	0	0	320
9474	3	313	9	3	0	328
9475	2	8	3	311	0	324
9476	0	1	0	320	0	321
9477	1	2	0	314	0	317
9478	1	0	0	313	0	314
9479	0	0	307	14	0	321
9480	3	0	310	3	0	316
9481	1	1	11	306	0	319
9482	0	1	315	9	0	325
9483	302	0	8	4	0	314
9484	310	0	3	0	0	313
9485	11	2	0	303	0	316
9486	305	1	0	9	0	315
9487	9	309	0	5	0	323
9488	311	7	1	2	0	321
9489	8	3	312	2	0	325
9490	3	1	9	309	0	322
9491	0	311	4	10	0	325
9492	318	8	0	6	0	332
9493	8	2	2	319	0	331
9494	4	1	323	8	0	336
9495	2	1	8	326	0	337
9496	324	0	4	10	0	338
9497	11	0	321	3	0	335
9498	3	1	7	323	0	334
9499	1	0	2	336	0	339
9500	2	0	331	11	0	344
9501	1	327	8	4	0	340
9502	0	279	6	1	0	286
9503	2	9	0	333	0	344
9504	2	3	0	344	0	349
9505	2	0	2	349	0	353
9506	340	1	0	12	0	353
9507	351	0	2	3	0	356
9508	11	1	1	346	0	359
9509	350	0	2	9	0	361
9510	6	351	0	5	0	362
9511	3	7	1	363	0	374
9512	1	4	0	368	0	373
9513	1	1	1	370	0	373
9514	357	0	2	11	0	370
9515	7	358	1	5	0	371
9516	5	7	1	360	0	373
9517	366	3	0	8	0	377
9518	9	0	1	366	0	376
9519	3	1	0	370	0	374
9520	1	349	0	11	0	361
9521	1	370	0	3	0	374
9522	1	9	0	359	0	369
9523	0	2	1	365	0	368
9524	356	0	0	14	0	370
9525	8	1	0	360	0	369
9526	5	0	349	7	0	361
9527	0	0	7	349	0	356
9528	0	335	5	7	0	347
9529	349	7	0	3	0	359
9530	8	2	1	347	0	358
9531	3	0	2	351	0	356
9532	0	344	0	11	0	355
9533	326	7	0	4	0	337
9534	7	338	1	1	0	347
9535	1	4	0	341	0	346
9536	0	0	341	4	0	345
9537	0	5	2	291	0	298
9538	293	0	0	0	0	293
9539	0	295	0	0	0	295
9540	0	0	0	297	0	297
9541	0	287	0	2	0	289
9542	0	0	0	298	0	298
9543	0	0	293	0	0	293
9544	0	1	0	287	0	288
9545	0	0	0	295	0	295
9546	1	0	0	294	0	295
9547	295	0	0	0	0	295
9548	298	0	0	0	0	298
9549	0	297	0	0	0	297
9550	298	1	0	1	0	300
9551	0	290	0	1	0	291
9552	0	289	0	1	0	290
9553	285	0	0	1	0	286
9554	1	0	282	0	0	283
9555	0	0	0	281	0	281
9556	0	0	0	285	0	285
9557	1	0	0	292	0	293
9558	287	0	0	1	0	288
9559	0	289	0	3	0	292
9560	1	0	0	292	0	293
9561	0	295	0	0	0	295
9562	306	0	0	2	0	308
9563	0	1	0	296	0	297
9564	2	0	1	367	0	370
9565	0	404	0	4	0	408
9566	0	4	0	428	0	432
9567	0	1	0	434	0	435
9568	422	1	0	7	0	430
9569	6	408	4	1	0	419
9570	1	426	0	2	0	429
9571	1	8	0	427	0	436
9572	0	3	410	7	0	420
9573	1	1	408	2	0	412
9574	1	3	8	397	0	409
9575	0	0	402	9	0	411
9576	0	0	9	401	0	410
9577	0	1	2	394	0	397
9578	1	0	0	410	0	411
9579	394	1	2	9	0	406
9580	7	0	1	397	0	405
9581	1	1	0	395	0	397
9582	0	388	1	10	0	399
9583	1	7	1	396	0	405
9584	0	1	396	10	0	407
9585	0	0	7	398	0	405
9586	1	0	1	409	0	411
9587	385	0	0	9	0	394
9588	8	1	1	388	0	398
9589	1	2	0	387	0	390
9590	1	0	0	393	0	394
9591	371	1	1	8	0	381
9592	7	378	0	3	0	388
9593	1	7	0	382	0	390
9594	2	1	1	379	0	383
9595	1	0	369	10	0	380
9596	0	1	7	369	0	377
9597	351	0	1	11	0	363
9598	8	359	1	2	0	370
9599	1	9	1	357	0	368
9600	0	1	0	360	0	361
9601	1	1	348	10	0	360
9602	340	3	8	3	0	354
9603	7	339	3	4	0	353
9604	343	7	0	4	0	354
9605	8	3	1	342	0	354
9606	2	1	0	350	0	353
9607	0	1	1	347	0	349
9608	2	1	1	346	0	350
9609	333	0	0	11	0	344
9610	8	1	1	323	0	333
9611	2	317	0	9	0	328
9612	0	7	0	329	0	336
9613	1	1	0	336	0	338
9614	324	0	0	9	0	333
9615	7	322	0	2	0	331
9616	2	8	0	328	0	338
9617	317	1	0	10	0	328
9618	330	0	1	1	0	332
9619	8	1	0	326	0	335
9620	3	0	325	9	0	337
9621	323	0	5	1	0	329
9622	8	1	1	328	0	338
9623	1	0	320	11	0	332
9624	1	0	8	324	0	333
9625	5	0	1	334	0	340
9626	0	2	0	350	0	352
9627	1	336	2	6	0	345
9628	2	7	0	347	0	356
9629	1	3	0	347	0	351
9630	0	0	1	356	0	357
9631	1	2	0	353	0	356
9632	1	0	0	354	0	355
9633	1	0	1	354	0	356
9634	319	2	1	9	0	331
9635	7	1	304	5	0	317
9636	1	303	8	3	0	315
9637	303	7	0	2	0	312
9638	9	303	0	0	0	312
9639	300	7	1	3	0	311
9640	12	1	0	295	0	308
9641	305	0	0	8	0	313
9642	7	0	1	303	0	311
9643	1	2	1	306	0	310
9644	2	294	0	12	0	308
9645	302	8	1	2	0	313
9646	8	1	313	2	0	324
9647	1	0	7	314	0	322
9648	2	1	314	8	0	325
9649	1	0	317	2	0	320
9650	316	1	7	2	0	326
9651	7	1	1	325	0	334
9652	3	0	318	8	0	329
9653	0	1	332	2	0	335
9654	2	0	8	332	0	342
9655	0	0	2	344	0	346
9656	335	0	3	9	0	347
9657	9	0	1	333	0	343
9658	1	0	349	8	0	358
9659	1	2	8	353	0	364
9660	2	6	1	348	0	357
9661	0	348	0	10	0	358
9662	347	7	1	2	0	357
9663	9	341	1	2	0	353
9664	276	6	0	0	0	282
9665	5	233	0	0	0	238
9666	0	217	1	1	0	219
9667	0	3	3	214	0	220
9668	0	0	0	217	0	217
9669	0	0	0	216	0	216
9670	209	0	0	0	0	209
9671	0	1	206	0	0	207
9672	0	0	0	208	0	208
9673	205	0	0	0	0	205
9674	0	204	0	0	0	204
9675	0	202	0	0	0	202
9676	0	0	0	207	0	207
9677	0	0	0	208	0	208
9678	0	0	0	211	0	211
9679	1	209	0	0	0	210
9680	0	0	0	213	0	213
9681	0	0	214	0	0	214
9682	0	1	208	0	0	209
9683	207	0	0	0	0	207
9684	0	0	0	212	0	212
9685	214	0	0	0	0	214
9686	212	0	0	0	0	212
9687	0	210	0	1	0	211
9688	213	0	0	0	0	213
9689	221	0	0	2	0	223
9690	0	0	0	224	0	224
9691	0	0	0	221	0	221
9692	0	0	227	0	0	227
9693	0	232	0	0	0	232
9694	2	0	0	211	0	213
9695	1	0	0	233	0	234
9696	235	0	0	0	0	235
9697	0	0	1	234	0	235
9698	240	0	0	0	0	240
9699	0	0	0	249	0	249
9700	0	245	0	1	0	246
9701	252	1	0	1	0	254
9702	1	0	0	299	0	300
9703	0	0	0	330	0	330
9704	0	0	0	348	0	348
9705	0	0	344	7	0	351
9706	1	0	4	348	0	353
9707	350	0	3	6	0	359
9708	6	0	0	368	0	374
9709	4	0	0	416	0	420
9710	0	0	0	420	0	420
9711	0	410	0	8	0	418
9712	0	435	0	4	0	439
9713	432	6	0	2	0	440
9714	4	437	1	0	0	442
9715	431	5	0	2	0	438
9716	437	3	0	1	0	441
9717	443	2	0	3	0	448
9718	8	0	435	1	0	444
9719	4	434	4	1	0	443
9720	444	5	3	0	0	452
9721	5	4	2	446	0	457
9722	5	2	0	457	0	464
9723	1	2	0	460	0	463
9724	1	440	0	11	0	452
9725	2	3	0	447	0	452
9726	436	4	0	7	0	447
9727	6	2	0	432	0	440
9728	4	1	0	428	0	433
9729	4	0	421	7	0	432
9730	0	0	434	6	0	440
9731	0	1	6	434	0	441
9732	2	0	5	432	0	439
9733	0	438	2	6	0	446
9734	1	3	0	442	0	446
9735	4	3	1	442	0	450
9736	0	3	1	444	0	448
9737	438	0	0	12	0	450
9738	5	0	433	7	0	445
9739	5	0	5	437	0	447
9740	436	0	3	8	0	447
9741	448	1	2	5	0	456
9742	7	2	0	447	0	456
9743	5	0	0	447	0	452
9744	440	1	0	11	0	452
9745	5	437	0	6	0	448
9746	5	431	0	3	0	439
9747	4	7	1	428	0	440
9748	440	5	1	9	0	455
9749	446	3	0	4	0	453
9750	451	0	1	2	0	454
9751	11	0	449	3	0	463
9752	452	0	6	2	0	460
9753	6	2	448	2	0	458
9754	441	2	5	2	0	450
9755	6	442	4	4	0	456
9756	5	4	445	4	0	458
9757	2	3	3	441	0	449
9758	2	3	439	6	0	450
9759	1	0	7	434	0	442
9760	437	0	4	8	0	449
9761	5	1	442	6	0	454
9762	4	1	4	449	0	458
9763	4	470	3	4	0	481
9764	2	5	5	480	0	492
9765	1	4	0	483	0	488
9766	2	2	0	474	0	478
9767	477	2	1	8	0	488
9768	474	0	2	10	0	486
9769	9	1	1	475	0	486
9770	6	1	468	7	0	482
9771	6	0	459	5	0	470
9772	0	1	9	478	0	488
9773	0	0	485	10	0	495
9774	3	1	6	488	0	498
9775	2	2	3	477	0	484
9776	2	1	1	498	0	502
9777	2	470	0	13	0	485
9778	2	456	0	8	0	466
9779	1	9	2	491	0	503
9780	1	6	3	481	0	491
9781	2	1	2	490	0	495
9782	488	0	0	11	0	499
9783	6	1	499	7	0	513
9784	6	1	4	505	0	516
9785	499	1	5	6	0	511
9786	6	508	4	6	0	524
9787	4	4	2	529	0	539
9788	5	2	2	535	0	544
9789	1	3	2	521	0	527
9790	2	0	2	526	0	530
9791	3	0	514	11	0	528
9792	506	0	7	8	0	521
9793	513	1	3	8	0	525
9794	11	0	517	2	0	530
9795	527	0	6	1	0	534
9796	529	1	2	3	0	535
9797	8	3	532	2	0	545
9798	7	540	3	5	0	555
9799	4	4	3	553	0	564
9800	2	3	589	5	0	599
9801	4	578	5	3	0	590
9802	3	0	525	6	0	534
9803	1	497	4	1	0	503
9804	0	4	2	487	0	493
9805	1	0	495	0	0	496
9806	1	3	1	488	0	493
9807	0	0	508	3	0	511
9808	0	495	2	1	0	498
9809	444	1	0	3	0	448
9810	1	440	2	0	0	443
9811	0	481	0	3	0	484
9812	3	1	2	482	0	488
9813	0	0	0	490	0	490
9814	0	0	1	481	0	482
9815	0	0	0	479	0	479
9816	0	0	0	487	0	487
9817	0	2	523	1	0	526
9818	0	0	1	526	0	527
9819	0	0	0	545	0	545
9820	552	0	0	4	0	556
9821	562	0	0	0	0	562
9822	567	0	0	3	0	570
9823	1	0	0	583	0	584
9824	634	0	0	1	0	635
9825	724	0	0	2	0	726
9826	741	0	0	2	0	743
9827	3	0	739	0	0	742
9828	752	0	2	1	0	755
9829	782	0	1	1	0	784
9830	777	0	0	0	0	777
9831	3	0	0	776	0	779
9832	1	0	783	2	0	786
9833	0	0	3	780	0	783
9834	811	0	1	3	0	815
9835	1	0	0	835	0	836
9836	1	878	1	2	0	882
9837	0	3	0	904	0	907
9838	899	1	0	4	0	904
9839	916	0	0	3	0	919
9840	914	0	0	5	0	919
9841	6	2	924	0	0	932
9842	2	0	5	927	0	934
9843	1	0	1	961	0	963
9844	0	1	983	5	0	989
9845	0	967	3	1	0	971
9846	1	4	982	0	0	987
9847	0	2	3	987	0	992
9848	983	0	2	6	0	991
9849	7	0	1004	2	0	1013
9850	2	0	4	1018	0	1024
9851	0	0	1033	4	0	1037
9852	1009	0	4	2	0	1015
9853	5	0	2	1029	0	1036
9854	3	0	1061	3	0	1067
9855	2	0	4	1061	0	1067
9856	0	0	1085	5	0	1090
9857	1	1096	3	4	0	1104
9858	0	6	2	1103	0	1111
9859	1121	2	0	7	0	1130
9860	8	0	0	1115	0	1123
9861	4	0	0	1094	0	1098
9862	1097	0	0	9	0	1106
9863	4	1058	0	2	0	1064
9864	1	1103	0	0	0	1104
9865	1	7	0	1110	0	1118
9866	0	1107	0	5	0	1112
9867	2	3	0	1123	0	1128
9868	1	2	0	1129	0	1132
9869	1137	0	0	9	0	1146
9870	5	1124	1	5	0	1135
9871	3	5	1138	1	0	1147
9872	2	1157	4	0	0	1163
9873	1163	2	3	2	0	1170
9874	1191	2	0	1	0	1194
9875	8	0	1	1180	0	1189
9876	1215	0	0	7	0	1222
9877	7	0	0	1218	0	1225
9878	1227	0	1	9	0	1237
9879	1241	1	0	2	0	1244
9880	9	0	1	1280	0	1290
9881	1296	1	0	9	0	1306
9882	5	0	1297	2	0	1304
9883	1292	0	5	2	0	1299
9884	9	0	2	1302	0	1313
9885	1312	0	1	10	0	1323
9886	7	1326	0	2	0	1335
9887	3	5	1	1337	0	1346
9888	0	3	1	1341	0	1345
9889	1342	0	0	11	0	1353
9890	8	1	1348	2	0	1359
9891	2	1343	5	1	0	1351
9892	3	5	3	1360	0	1371
9893	3	1358	1	7	0	1369
9894	3	6	0	1384	0	1393
9895	1	2	3	1378	0	1384
9896	3	0	2	1388	0	1393
9897	1383	1	1	8	0	1393
9898	11	1	0	1359	0	1371
9899	1370	0	0	13	0	1383
9900	1341	1	2	4	0	1348
9901	8	0	1	1356	0	1365
9902	1360	0	1	11	0	1372
9903	1349	0	0	3	0	1352
9904	7	1	1379	3	0	1390
9905	3	0	5	1369	0	1377
9906	1400	1	2	12	0	1415
9907	7	1403	1	2	0	1413
9908	1411	5	4	3	0	1423
9909	1413	3	0	5	0	1421
9910	6	0	1394	1	0	1401
9911	4	0	4	1353	0	1361
9912	1445	1	3	10	0	1459
9913	6	1	3	1479	0	1489
9914	4	3	1	1566	0	1574
9915	6	0	1	1569	0	1576
9916	2	1	1	1649	0	1653
9917	1649	0	2	18	0	1669
9918	10	1	1713	8	0	1732
9919	11	3	9	1771	0	1794
9920	3	1	1946	11	0	1961
9921	2	2	2045	9	0	2058
9922	2053	0	38	10	0	2101
9923	32	1	2168	1	0	2202
9924	14	2100	33	5	0	2152
9925	2080	25	36	4	0	2145
9926	2114	16	5	10	0	2145
9927	44	5	2	2070	0	2121
9928	22	4	2076	29	0	2131
9929	9	0	2063	18	0	2090
9930	2112	2	46	7	0	2167
9931	35	0	21	2147	0	2203
9932	2161	0	9	35	0	2205
9933	34	2178	7	19	0	2238
9934	2211	32	3	4	0	2250
9935	2201	19	9	7	0	2236
9936	51	2156	0	5	0	2212
9937	28	35	2	2173	0	2238
9938	2182	17	4	36	0	2239
9939	38	5	2191	20	0	2254
9940	20	2193	35	7	0	2255
9941	10	30	20	2174	0	2234
9942	2189	19	7	35	0	2250
9943	34	2194	7	27	0	2262
9944	2216	37	1	8	0	2262
9945	38	21	2182	9	0	2250
9946	2192	7	35	2	0	2236
9947	44	5	2204	1	0	2254
9948	2198	2	39	8	0	2247
9949	2164	4	22	6	0	2196
9950	61	2	2143	3	0	2209
9951	23	2145	33	2	0	2203
9952	15	35	19	2122	0	2191
9953	9	23	2170	32	0	2234
9954	6	2146	39	19	0	2210
9955	7	36	18	2116	0	2177
9956	9	20	9	2163	0	2201
9957	7	5	2103	52	0	2167
9958	12	5	35	2085	0	2137
9959	10	1	26	2115	0	2152
9960	6	6	2094	56	0	2162
9961	8	3	43	2065	0	2119
9962	7	2080	34	43	0	2164
9963	2113	38	18	30	0	2199
9964	46	23	13	2068	0	2150
9965	24	2085	15	40	0	2164
9966	24	42	7	2005	0	2078
9967	17	2109	9	35	0	2170
9968	17	43	2090	26	0	2176
9969	14	2105	43	9	0	2171
9970	2084	38	33	18	0	2173
9971	2095	27	17	10	0	2149
9972	2142	6	14	13	0	2175
9973	67	12	2116	9	0	2204
9974	42	6	2082	10	0	2140
9975	18	2146	66	6	0	2236
9976	23	40	34	2087	0	2184
9977	17	2169	14	37	0	2237
9978	16	49	13	2051	0	2129
9979	17	2150	6	42	0	2215
9980	2143	45	14	30	0	2232
9981	2302	30	11	13	0	2356
9982	72	16	8	2342	0	2438
9983	42	11	2324	54	0	2431
9984	2302	10	45	42	0	2399
9985	56	2322	36	16	0	2430
9986	38	52	16	2294	0	2400
9987	28	33	11	2276	0	2348
9988	21	2323	14	67	0	2425
9989	2343	55	9	29	0	2436
9990	66	30	2310	16	0	2422
9991	45	17	49	2311	0	2422
9992	2321	12	36	53	0	2422
9993	2321	13	17	34	0	2385
9994	71	2293	15	20	0	2399
9995	49	50	10	2258	0	2367
9996	13	2308	19	60	0	2400
9997	2338	57	5	33	0	2433
9998	51	36	2334	21	0	2442
9999	42	12	2340	18	0	2412
10000	14	18	77	2306	0	2415
10001	19	5	40	2322	0	2386
10002	10	2312	20	81	0	2423
10003	19	46	17	2343	0	2425
10004	14	35	2277	61	0	2387
10005	2260	16	47	43	0	2366
10006	57	15	35	2283	0	2390
10007	29	15	2263	62	0	2369
10008	14	18	50	2275	0	2357
10009	17	14	29	2257	0	2317
10010	8	2251	21	75	0	2355
10011	13	55	11	2261	0	2340
10012	15	32	10	2218	0	2275
10013	23	14	8	2212	0	2257
10014	2038	10	9	80	0	2137
10015	52	1993	18	39	0	2102
10016	30	1990	11	18	0	2049
10017	1911	58	10	17	0	1996
10018	1851	28	6	15	0	1900
10019	60	1736	10	10	0	1816
10020	21	1576	4	9	0	1610
10021	1369	30	6	7	0	1412
10022	24	1369	3	2	0	1398
10023	11	1320	2	4	0	1337
10024	1285	24	17	7	0	1333
10025	24	1284	3	7	0	1318
10026	1270	20	2	11	0	1303
10027	1259	12	6	6	0	1283
10028	1273	6	2	7	0	1288
10029	28	1241	3	15	0	1287
10030	15	1246	5	5	0	1271
10031	9	22	1	1220	0	1252
10032	6	1234	3	18	0	1261
10033	9	23	3	1237	0	1272
10034	1227	10	3	25	0	1265
10035	22	8	5	1205	0	1240
10036	13	1182	3	26	0	1224
10037	1161	17	3	16	0	1197
10038	20	1154	3	7	0	1184
10039	11	1172	0	7	0	1190
10040	12	37	3	1142	0	1194
10041	8	1159	4	18	0	1189
10042	1155	21	6	8	0	1190
10043	18	11	1127	8	0	1164
10044	9	1123	17	8	0	1157
10045	7	17	8	1120	0	1152
10046	4	14	1111	23	0	1152
10047	6	8	17	1104	0	1135
10048	7	6	9	1128	0	1150
10049	6	7	5	1123	0	1141
10050	7	6	7	1104	0	1124
10051	7	2	1082	29	0	1120
10052	5	1075	18	16	0	1114
10053	1059	17	7	17	0	1100
10054	19	14	1053	7	0	1093
10055	1047	6	15	15	0	1083
10056	18	10	1061	9	0	1098
10057	12	5	17	1064	0	1098
10058	10	6	1057	21	0	1094
10059	8	5	1068	11	0	1092
10060	7	6	20	1054	0	1087
10061	13	2	9	1017	0	1041
10062	8	7	8	1073	0	1096
10063	7	8	4	1055	0	1074
10064	1041	6	4	30	0	1081
10065	18	6	1046	18	0	1088
10066	1048	11	16	10	0	1085
10067	1048	8	8	9	0	1073
10068	1041	8	5	10	0	1064
10069	1050	7	3	10	0	1070
10070	1055	9	2	10	0	1076
10071	31	5	4	1029	0	1069
10072	19	9	968	16	0	1012
10073	12	7	951	11	0	981
10074	8	956	16	13	0	993
10075	898	24	13	8	0	943
10076	21	11	3	891	0	926
10077	12	16	3	872	0	903
10078	11	856	3	21	0	891
10079	8	868	1	11	0	888
10080	7	836	3	7	0	853
10081	685	13	1	10	0	709
10082	9	12	1	584	0	606
10083	1	571	1	5	0	578
10084	1	8	0	563	0	572
10085	1	2	564	8	0	575
10086	2	1	602	2	0	607
10087	2	3	6	641	0	652
10088	675	2	1	9	0	687
10089	736	2	2	3	0	743
10090	746	0	2	2	0	750
10091	11	1	741	2	0	755
10092	3	1	7	732	0	743
10093	5	0	0	744	0	749
10094	3	3	731	8	0	745
10095	713	1	9	3	0	726
10096	10	1	731	3	0	745
10097	2	1	707	2	0	712
10098	4	1	718	1	0	724
10099	2	4	11	698	0	715
10100	1	1	1	716	0	719
10101	2	0	717	10	0	729
10102	2	0	9	714	0	725
10103	723	0	2	11	0	736
10104	8	0	3	729	0	740
10105	0	0	738	12	0	750
10106	1	1	769	2	0	773
10107	2	1	10	750	0	763
10108	786	0	3	11	0	800
10109	14	842	3	2	0	861
10110	858	13	3	2	0	876
10111	874	3	2	2	0	881
10112	18	1	885	3	0	907
10113	5	0	15	882	0	902
10114	893	1	6	18	0	918
10115	891	2	2	6	0	901
10116	21	897	2	3	0	923
10117	10	14	4	897	0	925
10118	3	3	5	922	0	933
10119	3	2	902	22	0	929
10120	6	0	16	887	0	909
10121	4	3	900	17	0	924
10122	4	2	907	6	0	919
10123	6	1	16	883	0	906
10124	878	0	6	20	0	904
10125	15	847	4	8	0	874
10126	842	15	5	5	0	867
10127	854	3	7	5	0	869
10128	15	847	4	5	0	871
10129	4	13	4	825	0	846
10130	811	5	2	17	0	835
10131	16	809	2	6	0	833
10132	805	12	2	2	0	821
10133	13	773	3	5	0	794
10134	6	11	3	767	0	787
10135	3	4	2	782	0	791
10136	762	3	0	16	0	781
10137	762	3	0	6	0	771
10138	16	770	1	2	0	789
10139	9	10	719	3	0	741
10140	5	5	727	5	0	742
10141	3	1	16	711	0	731
10142	5	723	4	16	0	748
10143	5	12	3	740	0	760
10144	7	5	5	729	0	746
10145	3	4	4	739	0	750
10146	3	1	726	17	0	747
10147	3	4	722	7	0	736
10148	5	725	16	3	0	749
10149	5	12	5	728	0	750
10150	3	6	5	759	0	773
10151	2	2	742	21	0	767
10152	720	1	15	8	0	744
10153	16	3	7	747	0	773
10154	5	5	754	15	0	779
10155	720	2	13	13	0	748
10156	12	731	5	8	0	756
10157	6	11	777	7	0	801
10158	5	7	13	776	0	801
10159	773	1	11	14	0	799
10160	16	3	794	8	0	821
10161	8	1	17	808	0	834
10162	5	5	9	831	0	850
10163	6	2	3	882	0	893
10164	901	3	5	17	0	926
10165	17	860	4	12	0	893
10166	11	13	5	871	0	900
10167	4	6	877	20	0	907
10168	4	3	15	873	0	895
10169	3	864	10	22	0	899
10170	4	899	3	15	0	921
10171	890	21	5	9	0	925
10172	901	7	5	10	0	923
10173	19	3	881	9	0	912
10174	888	0	14	9	0	911
10175	14	888	8	5	0	915
10176	899	16	4	5	0	924
10177	20	9	1	890	0	920
10178	16	3	902	16	0	937
10179	7	5	17	902	0	931
10180	8	6	909	14	0	937
10181	906	4	14	12	0	936
10182	17	2	9	922	0	950
10183	7	942	3	21	0	973
10184	10	17	7	945	0	979
10185	4	8	955	19	0	986
10186	5	926	16	10	0	957
10187	877	9	6	12	0	904
10188	9	831	2	7	0	849
10189	6	795	5	5	0	811
10190	3	15	2	780	0	800
10191	3	782	3	12	0	800
10192	5	8	3	793	0	809
10193	4	5	785	11	0	805
10194	756	4	9	8	0	777
10195	780	5	8	4	0	797
10196	15	4	769	3	0	791
10197	761	1	10	2	0	774
10198	8	770	7	4	0	789
10199	765	8	2	2	0	777
10200	11	6	1	758	0	776
10201	6	3	787	9	0	805
10202	3	808	9	9	0	829
10203	3	12	7	809	0	831
10204	4	6	0	810	0	820
10205	790	0	2	13	0	805
10206	764	1	1	8	0	774
10207	15	748	1	0	0	764
10208	4	711	2	1	0	718
10209	1	664	1	3	0	669
10210	3	6	4	650	0	663
10211	662	2	0	1	0	665
10212	644	0	0	3	0	647
10213	3	0	2	641	0	646
10214	2	1	0	629	0	632
10215	634	0	0	5	0	639
10216	1	0	0	643	0	644
10217	3	1	649	1	0	654
10218	638	0	1	7	0	646
10219	653	1	2	2	0	658
10220	3	0	673	0	0	676
10221	682	2	1	3	0	688
10222	2	0	1	701	0	704
10223	4	0	1	698	0	703
10224	2	0	0	709	0	711
10225	708	1	0	4	0	713
10226	1	723	0	6	0	730
10227	4	1	2	735	0	742
10228	1	721	1	4	0	727
10229	729	2	2	4	0	737
10230	3	3	1	738	0	745
10231	4	1	0	743	0	748
10232	4	750	1	4	0	759
10233	2	3	742	3	0	750
10234	3	2	3	749	0	757
10235	757	2	1	5	0	765
10236	846	0	2	5	0	853
10237	11	0	899	3	0	913
10238	7	0	11	921	0	939
10239	2	945	5	10	0	962
10240	3	8	1	972	0	984
10241	967	7	4	9	0	987
10242	973	1	0	13	0	987
10243	15	3	1	969	0	988
10244	7	944	0	12	0	963
10245	1018	9	4	12	0	1043
10246	11	13	0	1056	0	1080
10247	1061	2	0	15	0	1078
10248	1114	3	1	9	0	1127
10249	18	2	2	1118	0	1140
10250	10	4	0	1121	0	1135
10251	4	7	2	1149	0	1162
10252	6	1156	0	25	0	1187
10253	4	13	2	1191	0	1210
10254	9	7	2	1182	0	1200
10255	8	0	1160	21	0	1189
10256	3	2	1145	12	0	1162
10257	7	0	18	1140	0	1165
10258	1137	3	6	18	0	1164
10259	15	1140	2	13	0	1170
10260	1115	14	1	9	0	1139
10261	15	7	1112	7	0	1141
10262	10	2	1073	3	0	1088
10263	2	1069	18	7	0	1096
10264	4	12	4	1101	0	1121
10265	4	7	1093	14	0	1118
10266	3	6	1110	7	0	1126
10267	5	3	16	1128	0	1152
10268	1127	0	10	15	0	1152
10269	1124	1	7	8	0	1140
10270	16	3	1	1121	0	1141
10271	4	3	1195	18	0	1220
10272	5	1	15	1210	0	1231
10273	4	1	8	1209	0	1222
10274	4	1206	5	20	0	1235
10275	1214	13	4	5	0	1236
10276	1203	6	3	7	0	1219
10277	19	1225	1	8	0	1253
10278	5	14	7	1204	0	1230
10279	5	1204	3	17	0	1229
10280	1215	13	3	14	0	1245
10281	18	8	1186	4	0	1216
10282	13	4	1163	2	0	1182
10283	7	2	1147	5	0	1161
10284	6	9	21	1168	0	1204
10285	4	1	9	1166	0	1180
10286	1152	6	2	22	0	1182
10287	20	1	4	1150	0	1175
10288	9	1	7	1175	0	1192
10289	4	1	1234	21	0	1260
10290	6	4	1181	9	0	1200
10291	1206	2	14	18	0	1240
10292	17	1227	6	6	0	1256
10293	1253	16	4	7	0	1280
10294	17	4	4	1252	0	1277
10295	11	8	4	1247	0	1270
10296	3	1237	7	16	0	1263
10297	5	13	5	1253	0	1276
10298	1234	9	2	18	0	1263
10299	18	6	0	1255	0	1279
10300	11	7	1247	18	0	1283
10301	5	1221	15	15	0	1256
10302	1209	15	8	10	0	1242
10303	1231	8	5	7	0	1251
10304	1234	2	2	11	0	1249
10305	1245	4	3	8	0	1260
10306	21	5	3	1234	0	1263
10307	14	1	3	1250	0	1268
10308	8	5	1234	21	0	1268
10309	10	3	15	1243	0	1271
10310	8	3	1242	24	0	1277
10311	7	5	15	1234	0	1261
10312	1230	2	9	23	0	1264
10313	14	1255	4	18	0	1291
10314	9	14	5	1287	0	1315
10315	4	7	6	1304	0	1321
10316	1275	1	5	28	0	1309
10317	1251	3	5	12	0	1271
10318	23	2	1266	10	0	1301
10319	9	1269	16	5	0	1299
10320	5	19	5	1259	0	1288
10321	6	4	8	1265	0	1283
10322	1241	2	7	25	0	1275
10323	1247	3	6	10	0	1266
10324	24	3	1244	10	0	1281
10325	12	1	1242	8	0	1263
10326	6	7	20	1239	0	1272
10327	5	1	7	1265	0	1278
10328	5	3	1236	28	0	1272
10329	1217	1	21	9	0	1248
10330	24	2	7	1244	0	1277
10331	1235	2	8	23	0	1268
10332	20	1215	6	9	0	1250
10333	1266	18	1	14	0	1299
10334	22	4	1329	15	0	1370
10335	16	1325	14	5	0	1360
10336	7	1287	2	6	0	1302
10337	1212	11	13	12	0	1248
10338	1185	4	4	6	0	1199
10339	19	0	2	1176	0	1197
10340	5	1166	3	12	0	1186
10341	4	1188	3	7	0	1202
10342	3	14	0	1195	0	1212
10343	1197	4	2	21	0	1224
10344	1204	1	4	7	0	1216
10345	18	1	1129	5	0	1153
10346	1106	0	11	6	0	1123
10347	14	1199	5	1	0	1219
10348	1230	16	3	1	0	1250
10349	21	1455	1	3	0	1480
10350	5	1627	2	4	0	1638
10351	7	38	2	1770	0	1817
10352	1881	15	6	40	0	1942
10353	1925	3	0	18	0	1946
10354	58	3	1873	13	0	1947
10355	30	2	40	1876	0	1948
10356	1909	1	15	41	0	1966
10357	48	1	13	1922	0	1984
10358	1932	2	5	52	0	1991
10359	1941	3	1	26	0	1971
10360	63	1	1906	14	0	1984
10361	31	1	37	1905	0	1974
10362	24	0	14	1940	0	1978
10363	8	2	10	1951	0	1971
10364	4	2	1857	67	0	1930
10365	5	1	42	1890	0	1938
10366	3	1	18	1864	0	1886
10367	3	1836	12	62	0	1913
10368	8	47	1813	25	0	1893
10369	3	1848	37	25	0	1913
10370	1839	49	18	12	0	1918
10371	45	19	11	1758	0	1833
10372	28	12	4	1738	0	1782
10373	12	1754	8	48	0	1822
10374	1747	41	6	35	0	1829
10375	1783	17	0	23	0	1823
10376	62	1708	4	15	0	1789
10377	33	1767	1	8	0	1809
10378	1764	49	3	5	0	1821
10379	50	24	1738	3	0	1815
10380	21	18	1741	4	0	1784
10381	1716	5	48	12	0	1781
10382	40	1740	23	8	0	1811
10383	1756	43	15	6	0	1820
10384	53	20	1748	4	0	1825
10385	1755	15	40	10	0	1820
10386	53	1778	16	7	0	1854
10387	27	46	14	1792	0	1879
10388	20	19	8	1821	0	1868
10389	12	15	6	1724	0	1757
10390	8	8	2	1763	0	1781
10391	12	4	0	1734	0	1750
10392	8	1686	2	80	0	1776
10393	1700	39	2	36	0	1777
10394	54	15	1678	25	0	1772
10395	22	14	42	1708	0	1786
10396	17	9	1701	51	0	1778
10397	11	4	51	1725	0	1791
10398	8	3	21	1755	0	1787
10399	1690	2	19	64	0	1775
10400	43	3	1656	34	0	1736
10401	18	1660	41	28	0	1747
10402	18	45	19	1673	0	1755
10403	14	16	20	1706	0	1756
10404	5	16	1677	58	0	1756
10405	10	9	41	1682	0	1742
10406	3	5	17	1734	0	1759
10407	1652	6	12	73	0	1743
10408	37	1654	7	40	0	1738
10409	1667	42	3	29	0	1741
10410	1703	18	4	16	0	1741
10411	61	18	2	1664	0	1745
10412	32	17	1643	50	0	1742
10413	27	7	1643	22	0	1699
10414	13	5	58	1618	0	1694
10415	9	4	32	1600	0	1645
10416	8	1614	19	54	0	1695
10417	1581	43	24	38	0	1686
10418	49	1564	9	19	0	1641
10419	24	1630	13	11	0	1678
10420	1601	62	8	12	0	1683
10421	54	32	1	1589	0	1676
10422	22	1646	7	49	0	1724
10423	18	42	9	1654	0	1723
10424	11	19	1613	62	0	1705
10425	9	22	1617	35	0	1683
10426	12	10	53	1618	0	1693
10427	7	6	1621	57	0	1691
10428	13	8	59	1618	0	1698
10429	13	1	25	1649	0	1688
10430	7	3	18	1660	0	1688
10431	1582	5	12	82	0	1681
10432	40	1545	10	45	0	1640
10433	21	1578	8	37	0	1644
10434	1492	47	9	22	0	1570
10435	1518	32	6	15	0	1571
10436	57	21	7	1470	0	1555
10437	30	13	1485	48	0	1576
10438	22	12	38	1523	0	1595
10439	12	11	1488	54	0	1565
10440	13	1490	47	30	0	1580
10441	8	44	14	1514	0	1580
10442	1508	17	18	49	0	1592
10443	42	18	10	1517	0	1587
10444	24	12	1473	53	0	1562
10445	1455	6	36	29	0	1526
10446	46	9	1475	23	0	1553
10447	34	3	1414	14	0	1465
10448	19	1344	46	11	0	1420
10449	14	1085	21	7	0	1127
10450	2	962	20	3	0	987
10451	709	15	31	20	0	775
10452	644	1	6	1	0	652
10453	2	1	0	678	0	681
10454	0	0	0	692	0	692
10455	0	1	0	707	0	708
10456	1	718	0	2	0	721
10457	725	2	0	1	0	728
10458	2	716	0	1	0	719
10459	1	2	0	724	0	727
10460	719	0	0	4	0	723
10461	3	1	0	722	0	726
10462	2	0	0	732	0	734
10463	744	1	0	5	0	750
10464	747	0	0	1	0	748
10465	3	0	737	0	0	740
10466	0	0	730	1	0	731
10467	0	0	773	2	0	775
10468	2	0	2	780	0	784
10469	1	0	0	791	0	792
10470	0	798	1	3	0	802
10471	829	2	1	1	0	833
10472	4	0	1	842	0	847
10473	1	0	0	856	0	857
10474	0	870	1	5	0	876
10475	0	921	0	0	0	921
10476	0	4	0	940	0	944
10477	1	0	0	1013	0	1014
10478	1025	0	0	7	0	1032
10479	1019	1	0	1	0	1021
10480	6	1	0	1015	0	1022
10481	3	3	1028	6	0	1040
10482	3	0	995	2	0	1000
10483	2	0	7	1023	0	1032
10484	1	0	4	991	0	996
10485	0	988	2	7	0	997
10486	968	4	2	5	0	979
10487	7	1	1	967	0	976
10488	1	2	977	7	0	987
10489	3	0	5	999	0	1007
10490	1	2	987	7	0	997
10491	1	1	998	1	0	1001
10492	1	2	6	1014	0	1023
10493	1015	1	3	5	0	1024
10494	5	1	1006	3	0	1015
10495	1	0	5	1004	0	1010
10496	4	0	1058	4	0	1066
10497	1	0	7	1070	0	1078
10498	2	0	2	1069	0	1073
10499	1	2	1065	6	0	1074
10500	0	0	1052	4	0	1056
10501	2	0	7	1035	0	1044
10502	1	1	2	1079	0	1083
10503	0	1	3	1082	0	1086
10504	1	0	1	1067	0	1069
10505	1063	0	2	12	0	1077
10506	1057	0	1	6	0	1064
10507	6	1053	0	4	0	1063
10508	1064	6	1	3	0	1074
10509	8	1	2	1072	0	1083
10510	1075	2	1	8	0	1086
10511	10	1	1066	1	0	1078
10512	1068	2	6	5	0	1081
10513	8	1	1	1113	0	1123
10514	2	0	2	1151	0	1155
10515	1144	1	3	13	0	1161
10516	10	0	0	1258	0	1268
10517	4	1	1309	11	0	1325
10518	1332	0	9	8	0	1349
10519	10	1365	3	3	0	1381
10520	8	9	2	1411	0	1430
10521	3	5	1492	11	0	1511
10522	5	4	9	1471	0	1489
10523	3	1	1487	13	0	1504
10524	3	0	13	1501	0	1517
10525	0	1504	7	15	0	1526
10526	4	9	3	1539	0	1555
10527	2	1578	1	15	0	1596
10528	5	13	2	1563	0	1583
10529	1	6	3	1646	0	1656
10530	3	4	1	1658	0	1666
10531	3	2	0	1655	0	1660
10532	1	1	0	1666	0	1668
10533	2	1	1638	22	0	1663
10534	4	0	8	1650	0	1662
10535	0	0	10	1650	0	1660
10536	1626	0	4	19	0	1649
10537	10	1612	0	17	0	1639
10538	1607	12	0	10	0	1629
10539	16	9	1	1605	0	1631
10540	10	3	1611	16	0	1640
10541	3	1609	14	12	0	1638
10542	1590	9	8	8	0	1615
10543	9	1576	7	8	0	1600
10544	6	1618	4	6	0	1634
10545	1608	16	5	4	0	1633
10546	11	10	0	1717	0	1738
10547	1704	5	1	20	0	1730
10548	18	3	2	1672	0	1695
10549	8	3	1665	23	0	1699
10550	5	2	1643	13	0	1663
10551	1620	1	22	9	0	1652
10552	1647	0	12	13	0	1672
10553	24	2	4	1595	0	1625
10554	15	1	2	1606	0	1624
10555	1567	3	2	29	0	1601
10556	16	1539	3	14	0	1572
10557	12	1562	1	11	0	1586
10558	1568	19	2	8	0	1597
10559	1570	10	2	6	0	1588
10560	24	1568	2	2	0	1596
10561	14	18	1	1562	0	1595
10562	9	10	1554	15	0	1588
10563	5	7	1535	12	0	1559
10564	1513	2	21	9	0	1545
10565	20	2	1529	3	0	1554
10566	16	3	17	1503	0	1539
10567	7	3	10	1472	0	1492
10568	4	1476	8	24	0	1512
10569	1471	14	3	15	0	1503
10570	26	9	1	1462	0	1498
10571	10	6	1434	16	0	1466
10572	7	1429	15	14	0	1465
10573	8	12	13	1423	0	1456
10574	5	9	1404	15	0	1433
10575	5	8	1349	8	0	1370
10576	3	1334	16	10	0	1363
10577	1238	15	14	9	0	1276
10578	13	1266	3	2	0	1284
10579	1257	13	1	4	0	1275
10580	11	10	1243	4	0	1268
10581	1233	2	13	3	0	1251
10582	12	1243	7	3	0	1265
10583	11	12	4	1241	0	1268
10584	3	9	7	1270	0	1289
10585	1259	0	3	24	0	1286
10586	12	4	1253	10	0	1279
10587	1254	2	14	4	0	1274
10588	1247	6	8	6	0	1267
10589	22	1	1215	5	0	1243
10590	6	4	1220	6	0	1236
10591	6	6	17	1204	0	1233
10592	1214	5	11	15	0	1245
10593	1221	1	5	10	0	1237
10594	17	1228	4	3	0	1252
10595	8	12	4	1251	0	1275
10596	6	8	4	1198	0	1216
10597	7	2	4	1214	0	1227
10598	5	3	4	1220	0	1232
10599	1204	1	3	23	0	1231
10600	18	5	3	1214	0	1240
10601	9	4	1216	16	0	1245
10602	6	4	1207	11	0	1228
10603	1201	0	17	5	0	1223
10604	13	1187	11	7	0	1218
10605	12	1208	4	4	0	1228
10606	6	24	2	1222	0	1254
10607	6	6	4	1240	0	1256
10608	4	4	6	1229	0	1243
10609	9	1	4	1240	0	1254
10610	5	3	1234	25	0	1267
10611	6	3	13	1223	0	1245
10612	5	4	8	1213	0	1230
10613	5	1	1154	23	0	1183
10614	1109	3	16	12	0	1140
10615	17	1129	8	12	0	1166
10616	1015	11	3	10	0	1039
10617	9	5	984	8	0	1006
10618	7	0	927	8	0	942
10619	4	903	13	4	0	924
10620	832	18	42	7	0	899
10621	787	9	4	5	0	805
10622	785	2	0	2	0	789
10623	13	763	2	3	0	781
10624	740	8	3	4	0	755
10625	9	5	739	1	0	754
10626	6	726	6	2	0	740
10627	690	9	5	3	0	707
10628	10	689	3	1	0	703
10629	657	10	0	3	0	670
10630	643	4	1	4	0	652
10631	14	1	653	2	0	670
10632	5	668	9	1	0	683
10633	662	8	6	1	0	677
10634	9	3	652	1	0	665
10635	4	658	7	2	0	671
10636	5	8	2	649	0	664
10637	3	1	646	8	0	658
10638	0	4	629	2	0	635
10639	6	0	8	645	0	659
10640	635	0	2	9	0	646
10641	7	641	0	3	0	651
10642	2	7	630	2	0	641
10643	1	2	631	1	0	635
10644	609	1	9	3	0	622
10645	7	642	5	2	0	656
10646	544	3	0	1	0	548
10647	4	536	0	0	0	540
10648	557	3	0	1	0	561
10649	553	2	1	0	0	556
10650	6	539	1	0	0	546
10651	2	4	0	540	0	546
10652	573	2	0	5	0	580
10653	6	0	0	584	0	590
10654	0	0	0	632	0	632
10655	626	0	0	9	0	635
10656	6	623	0	2	0	631
10657	636	5	0	0	0	641
10658	6	2	632	2	0	642
10659	3	0	3	647	0	653
10660	2	0	2	645	0	649
10661	641	0	1	11	0	653
10662	640	0	1	3	0	644
10663	9	2	0	636	0	647
10664	4	0	659	6	0	669
10665	2	1	5	652	0	660
10666	1	0	2	672	0	675
10667	0	0	0	673	0	673
10668	7	0	0	669	0	676
10669	668	2	0	10	0	680
10670	8	0	657	4	0	669
10671	2	667	9	2	0	680
10672	0	4	2	666	0	672
10673	0	2	0	690	0	692
10674	2	0	680	10	0	692
10675	2	2	654	4	0	662
10676	3	0	6	685	0	694
10677	0	0	7	695	0	702
10678	0	2	667	11	0	680
10679	0	1	6	672	0	679
10680	678	0	1	13	0	692
10681	9	704	2	4	0	719
10682	5	8	703	0	0	716
10683	1	700	10	3	0	714
10684	1	10	3	709	0	723
10685	1	1	710	8	0	720
10686	0	710	5	6	0	721
10687	5	7	4	721	0	737
10688	1	5	727	7	0	740
10689	3	1	9	716	0	729
10690	4	3	2	739	0	748
10691	739	0	4	13	0	756
10692	8	1	2	744	0	755
10693	741	3	0	10	0	754
10694	719	2	1	7	0	729
10695	711	1	5	3	0	720
10696	10	2	2	710	0	724
10697	3	1	695	12	0	711
10698	4	0	687	2	0	693
10699	706	3	8	5	0	722
10700	8	1	702	3	0	714
10701	680	0	11	1	0	692
10702	10	682	1	4	0	697
10703	698	7	3	9	0	717
10704	9	2	706	1	0	718
10705	2	2	710	4	0	718
10706	9	0	7	729	0	745
10707	3	1	738	8	0	750
10708	4	3	753	1	0	761
10709	2	3	10	802	0	817
10710	3	0	6	816	0	825
10711	1	0	6	845	0	852
10712	2	851	3	16	0	872
10713	1	11	2	859	0	873
10714	3	858	4	13	0	878
10715	862	16	4	6	0	888
10716	874	4	1	9	0	888
10717	16	2	3	837	0	858
10718	6	832	3	17	0	858
10719	7	14	853	8	0	882
10720	858	3	15	7	0	883
10721	14	7	5	854	0	880
10722	7	2	5	872	0	886
10723	8	1	2	866	0	877
10724	847	0	1	28	0	876
10725	13	837	2	11	0	863
10726	3	862	5	11	0	881
10727	842	13	1	3	0	859
10728	14	837	1	4	0	856
10729	841	14	0	6	0	861
10730	847	4	1	7	0	859
10731	19	838	3	1	0	861
10732	8	18	2	814	0	842
10733	6	833	2	15	0	856
10734	8	16	2	828	0	854
10735	1	7	1	875	0	884
10736	869	4	0	21	0	894
10737	893	3	0	9	0	905
10738	17	12	0	874	0	903
10739	8	3	851	22	0	884
10740	855	7	17	4	0	883
10741	20	850	3	10	0	883
10742	8	15	6	852	0	881
10743	11	3	1	859	0	874
10744	7	7	2	863	0	879
10745	809	5	1	28	0	843
10746	815	4	4	13	0	836
10747	22	780	0	12	0	814
10748	9	791	0	8	0	808
10749	13	15	1	783	0	812
10750	10	6	1	800	0	817
10751	2	9	789	22	0	822
10752	10	4	17	767	0	798
10753	5	4	749	20	0	778
10754	0	7	709	7	0	723
10755	1	711	15	12	0	739
10756	5	13	8	710	0	736
10757	711	2	7	19	0	739
10758	18	5	4	695	0	722
10759	5	3	693	20	0	721
10760	689	4	16	4	0	713
10761	685	2	3	12	0	702
10762	19	3	686	6	0	714
10763	10	0	17	691	0	718
10764	676	4	4	17	0	701
10765	16	679	7	12	0	714
10766	688	14	7	9	0	718
10767	707	6	4	4	0	721
10768	26	8	0	692	0	726
10769	15	1	3	706	0	725
10770	700	3	1	23	0	727
10771	18	3	4	709	0	734
10772	10	3	711	24	0	748
10773	701	1	16	10	0	728
10774	708	0	10	9	0	727
10775	21	685	7	10	0	723
10776	11	688	4	6	0	709
10777	11	25	4	670	0	710
10778	5	697	2	16	0	720
10779	8	20	3	690	0	721
10780	690	8	0	22	0	720
10781	671	7	0	11	0	689
10782	22	655	3	9	0	689
10783	658	17	0	6	0	681
10784	22	637	4	5	0	668
10785	635	22	4	3	0	664
10786	654	6	1	6	0	667
10787	26	9	628	1	0	664
10788	629	7	13	3	0	652
10789	21	618	5	6	0	650
10790	13	626	5	4	0	648
10791	626	20	1	8	0	655
10792	20	12	2	622	0	656
10793	13	8	615	16	0	652
10794	9	4	14	630	0	657
10795	7	4	6	643	0	660
10796	6	4	622	22	0	654
10797	613	3	14	11	0	641
10798	20	617	3	8	0	648
10799	600	18	7	5	0	630
10800	23	6	3	589	0	621
10801	585	9	2	22	0	618
10802	22	595	1	13	0	631
10803	15	18	3	585	0	621
10804	584	5	1	17	0	607
10805	16	9	554	11	0	590
10806	8	4	509	9	0	530
10807	495	8	16	10	0	529
10808	17	497	10	4	0	528
10809	9	434	8	3	0	454
10810	12	22	4	396	0	434
10811	5	397	6	11	0	419
10812	4	15	1	403	0	423
10813	4	6	2	413	0	425
10814	5	6	1	407	0	419
10815	2	396	1	19	0	418
10816	5	9	3	400	0	417
10817	3	3	390	16	0	412
10818	2	385	14	5	0	406
10819	4	11	4	347	0	366
10820	1	347	4	9	0	361
10821	345	13	2	4	0	364
10822	351	3	3	3	0	360
10823	349	5	2	4	0	360
10824	19	349	3	0	0	371
10825	6	11	1	343	0	361
10826	4	4	324	13	0	345
10827	4	4	319	5	0	332
10828	317	2	12	4	0	335
10829	328	1	8	3	0	340
10830	13	0	5	342	0	360
10831	7	2	0	365	0	374
10832	6	3	357	15	0	381
10833	3	343	10	9	0	365
10834	2	349	6	5	0	362
10835	3	10	312	1	0	326
10836	2	10	7	296	0	315
10837	0	3	3	284	0	290
10838	1	1	1	307	0	310
10839	1	0	0	311	0	312
10840	302	0	0	12	0	314
10841	7	1	294	5	0	307
10842	294	0	8	3	0	305
10843	10	0	3	290	0	303
10844	297	1	4	8	0	310
10845	10	0	0	299	0	309
10846	4	0	299	10	0	313
10847	2	1	7	305	0	315
10848	0	0	317	11	0	328
10849	0	0	8	313	0	321
10850	0	1	334	8	0	343
10851	0	329	7	3	0	339
10852	0	7	3	327	0	337
10853	0	3	2	332	0	337
10854	0	326	0	10	0	336
10855	329	6	0	6	0	341
10856	6	5	0	331	0	342
10857	6	1	0	333	0	340
10858	340	0	2	10	0	352
10859	354	0	0	4	0	358
10860	367	2	0	2	0	371
10861	366	0	0	3	0	369
10862	10	0	348	1	0	359
10863	346	0	9	0	0	355
10864	360	0	1	2	0	363
10865	10	0	1	340	0	351
10866	3	0	0	342	0	345
10867	333	0	1	9	0	343
10868	6	328	3	1	0	338
10869	2	7	0	328	0	337
10870	1	2	345	6	0	354
10871	0	336	6	2	0	344
10872	313	7	1	3	0	324
10873	324	0	0	1	0	325
10874	319	1	0	2	0	322
10875	324	0	0	3	0	327
10876	6	0	1	320	0	327
10877	1	2	318	4	0	325
10878	2	1	322	1	0	326
10879	2	0	7	335	0	344
10880	357	0	1	7	0	365
10881	6	0	0	357	0	363
10882	1	0	361	7	0	369
10883	368	0	6	3	0	377
10884	375	0	2	0	0	377
10885	4	0	0	381	0	385
10886	3	0	397	5	0	405
10887	0	1	408	3	0	412
10888	404	0	7	1	0	412
10889	5	405	1	2	0	413
10890	2	6	414	0	0	422
10891	2	1	5	410	0	418
10892	411	0	1	5	0	417
10893	5	399	1	3	0	408
10894	3	397	0	0	0	400
10895	407	8	0	0	0	415
10896	5	2	1	405	0	413
10897	444	0	1	8	0	453
10898	10	1	1	452	0	464
10899	5	3	0	458	0	466
10900	2	0	456	9	0	467
10901	3	0	451	3	0	457
10902	1	0	462	3	0	466
10903	4	0	8	458	0	470
10904	470	2	0	8	0	480
10905	8	0	464	4	0	476
10906	1	0	8	468	0	477
10907	3	0	487	5	0	495
10908	2	490	7	1	0	500
10909	1	7	1	506	0	515
10910	4	1	1	508	0	514
10911	2	1	1	519	0	523
10912	512	1	0	10	0	523
10913	10	0	2	508	0	520
10914	4	1	3	518	0	526
10915	514	1	1	12	0	528
10916	11	0	507	3	0	521
10917	510	1	8	3	0	522
10918	512	1	3	2	0	518
10919	11	0	503	2	0	516
10920	500	0	8	4	0	512
10921	10	0	2	515	0	527
10922	1	0	528	9	0	538
10923	525	1	7	5	0	538
10924	529	0	2	1	0	532
10925	9	1	2	533	0	545
10926	4	0	2	539	0	545
10927	7	0	1	539	0	547
10928	532	1	2	9	0	544
10929	9	525	0	6	0	540
10930	504	4	2	2	0	512
10931	5	482	4	3	0	494
10932	4	482	1	1	0	488
10933	3	7	2	499	0	511
10934	3	1	1	502	0	507
10935	4	1	2	499	0	506
10936	2	0	1	506	0	509
10937	4	1	500	5	0	510
10938	494	3	5	3	0	505
10939	7	1	2	503	0	513
10940	2	2	502	8	0	514
10941	2	1	6	505	0	514
10942	2	0	1	518	0	521
10943	4	0	530	7	0	541
10944	3	2	3	526	0	534
10945	4	1	2	529	0	536
10946	532	1	3	6	0	542
10947	6	1	534	2	0	543
10948	528	1	4	4	0	537
10949	5	534	3	4	0	546
10950	516	4	1	5	0	526
10951	512	1	2	6	0	521
10952	7	0	5	511	0	523
10953	2	0	507	6	0	515
10954	3	532	3	5	0	543
10955	4	4	2	517	0	527
10956	1	554	4	8	0	567
10957	556	3	3	5	0	567
10958	5	1	548	2	0	556
10959	3	3	537	1	0	544
10960	3	1	4	535	0	543
10961	2	1	553	6	0	562
10962	0	2	6	561	0	569
10963	3	2	1	548	0	554
10964	569	1	0	8	0	578
10965	5	573	0	6	0	584
10966	6	4	0	585	0	595
10967	0	1	4	597	0	602
10968	3	0	3	592	0	598
10969	3	582	1	8	0	594
10970	1	572	5	1	0	579
10971	579	5	1	2	0	587
10972	574	2	0	6	0	582
10973	573	0	4	2	0	579
10974	7	1	570	1	0	579
10975	3	0	4	573	0	580
10976	1	0	570	7	0	578
10977	1	567	6	4	0	578
10978	547	4	4	6	0	561
10979	7	3	552	0	0	562
10980	4	3	3	534	0	544
10981	5	0	541	3	0	549
10982	542	1	3	3	0	549
10983	547	1	6	2	0	556
10984	549	1	1	3	0	554
10985	541	1	1	3	0	546
10986	4	2	539	2	0	547
10987	529	1	3	1	0	534
10988	534	0	4	1	0	539
10989	4	528	2	1	0	535
10990	517	3	1	3	0	524
10991	528	1	1	2	0	532
10992	5	0	1	518	0	524
10993	2	554	0	6	0	562
10994	572	2	1	5	0	580
10995	610	2	1	1	0	614
10996	8	1	689	2	0	700
10997	4	0	686	1	0	691
10998	0	1	696	0	0	697
10999	3	3	8	683	0	697
11000	679	0	5	7	0	691
11001	7	674	0	4	0	685
11002	678	7	0	0	0	685
11003	7	676	0	0	0	683
11004	666	7	0	0	0	673
11005	8	665	0	0	0	673
11006	2	680	0	3	0	685
11007	657	7	1	0	0	665
11008	6	666	0	0	0	672
11009	2	5	0	670	0	677
11010	0	2	676	5	0	683
11011	1	0	674	1	0	676
11012	2	0	7	663	0	672
11013	1	0	2	676	0	679
11014	2	0	674	8	0	684
11015	3	0	8	662	0	673
11016	0	0	3	684	0	687
11017	684	0	2	8	0	694
11018	7	680	0	2	0	689
11019	3	7	0	666	0	676
11020	1	690	1	6	0	698
11021	689	7	0	4	0	700
11022	7	686	0	2	0	695
11023	693	7	0	2	0	702
11024	688	3	0	1	0	692
11025	7	2	1	679	0	689
11026	3	1	1	684	0	689
11027	4	1	1	676	0	682
11028	1	0	1	682	0	684
11029	1	1	668	11	0	681
11030	633	2	9	4	0	648
11031	8	670	2	1	0	681
11032	4	8	1	683	0	696
11033	4	1	2	681	0	688
11034	2	675	1	9	0	687
11035	676	8	2	5	0	691
11036	10	680	0	2	0	692
11037	3	10	1	688	0	702
11038	4	3	1	704	0	712
11039	2	1	2	701	0	706
11040	4	2	2	694	0	702
11041	694	1	0	13	0	708
11042	9	3	688	2	0	702
11043	5	1	8	671	0	685
11044	4	1	2	677	0	684
11045	5	0	1	682	0	688
11046	4	0	0	679	0	683
11047	664	3	2	10	0	679
11048	9	0	660	2	0	671
11049	3	2	7	656	0	668
11050	2	645	2	9	0	658
11051	2	664	1	2	0	669
11052	661	8	1	2	0	672
11053	9	3	659	4	0	675
11054	629	3	6	2	0	640
11055	9	2	639	0	0	650
11056	2	2	7	605	0	616
11057	604	0	1	13	0	618
11058	9	634	3	3	0	649
11059	2	8	2	626	0	638
11060	1	601	1	9	0	612
11061	622	8	1	4	0	635
11062	629	2	2	2	0	635
11063	9	4	1	626	0	640
11064	5	1	612	9	0	627
11065	3	2	605	4	0	614
11066	3	0	9	613	0	625
11067	1	616	2	10	0	629
11068	2	9	1	643	0	655
11069	1	4	0	625	0	630
11070	4	3	1	621	0	629
11071	1	3	632	10	0	646
11072	2	3	9	627	0	641
11073	2	1	2	637	0	642
11074	1	619	1	18	0	639
11075	3	9	1	624	0	637
11076	3	2	3	654	0	662
11077	2	1	3	666	0	672
11078	0	2	2	668	0	672
11079	2	4	1	643	0	650
11080	1	4	1	652	0	658
11081	4	0	0	641	0	645
11082	4	1	3	635	0	643
11083	4	1	615	12	0	632
11084	1	3	9	616	0	629
11085	619	0	2	11	0	632
11086	8	4	0	611	0	623
11087	2	3	623	13	0	641
11088	619	3	8	6	0	636
11089	637	1	4	4	0	646
11090	639	2	0	4	0	645
11091	638	1	2	5	0	646
11092	14	2	0	636	0	652
11093	3	2	620	13	0	638
11094	0	610	10	8	0	628
11095	2	567	1	4	0	574
11096	4	5	14	459	0	482
11097	1	1	3	485	0	490
11098	4	0	0	483	0	487
11099	1	1	0	496	0	498
11100	0	0	2	563	0	565
11101	615	0	4	13	0	632
11102	9	629	0	1	0	639
11103	2	641	0	1	0	644
11104	0	12	0	657	0	669
11105	2	3	0	673	0	678
11106	1	0	1	664	0	666
11107	0	0	1	665	0	666
11108	0	0	632	15	0	647
11109	1	621	10	8	0	640
11110	3	9	1	621	0	634
11111	622	2	1	11	0	636
11112	10	1	0	625	0	636
11113	2	1	625	11	0	639
11114	0	0	614	7	0	621
11115	3	0	640	2	0	645
11116	5	0	9	617	0	631
11117	628	0	4	12	0	644
11118	9	0	2	630	0	641
11119	3	0	2	645	0	650
11120	632	0	0	17	0	649
11121	12	0	0	640	0	652
11122	3	0	0	653	0	656
11123	0	1	679	12	0	692
11124	2	680	10	2	0	694
11125	2	8	2	705	0	717
11126	700	2	0	12	0	714
11127	10	0	1	708	0	719
11128	3	1	703	11	0	718
11129	1	0	9	699	0	709
11130	2	710	2	8	0	722
11131	0	8	0	717	0	725
11132	1	2	707	11	0	721
11133	1	761	8	5	0	775
11134	4	15	3	777	0	799
11135	3	4	1	870	0	878
11136	3	3	2	906	0	914
11137	1	2	0	907	0	910
11138	1	1	877	20	0	899
11139	0	879	14	11	0	904
11140	878	16	3	9	0	906
11141	892	2	3	8	0	905
11142	17	3	2	886	0	908
11143	5	3	882	18	0	908
11144	874	2	17	5	0	898
11145	18	1	4	896	0	919
11146	3	1	912	18	0	934
11147	3	1	18	918	0	940
11148	3	0	5	922	0	930
11149	4	1	2	938	0	945
11150	2	0	928	26	0	956
11151	3	1	15	905	0	924
11152	2	923	4	24	0	953
11153	929	17	5	8	0	959
11154	945	5	3	8	0	961
11155	936	1	1	6	0	944
11156	21	925	3	5	0	954
11157	921	18	1	9	0	949
11158	24	3	3	904	0	934
11159	899	4	1	20	0	924
11160	915	4	3	9	0	931
11161	26	3	889	6	0	924
11162	6	885	17	9	0	917
11163	892	18	4	9	0	923
11164	22	2	5	897	0	926
11165	6	5	879	21	0	911
11166	4	878	18	10	0	910
11167	861	22	8	4	0	895
11168	21	6	2	863	0	892
11169	7	1	3	881	0	892
11170	6	4	2	876	0	888
11171	4	854	4	26	0	888
11172	5	22	2	859	0	888
11173	5	854	2	28	0	889
11174	5	19	2	860	0	886
11175	7	3	847	24	0	881
11176	7	4	20	856	0	887
11177	4	6	3	875	0	888
11178	4	2	4	878	0	888
11179	4	1	854	31	0	890
11180	3	1	21	867	0	892
11181	4	3	7	879	0	893
11182	3	0	4	891	0	898
11183	2	3	2	881	0	888
11184	3	1	3	896	0	903
11185	4	2	853	31	0	890
11186	6	4	17	844	0	871
11187	4	6	4	851	0	865
11188	815	4	2	27	0	848
11189	22	803	5	14	0	844
11190	6	827	4	12	0	849
11191	7	17	3	824	0	851
11192	8	4	1	824	0	837
11193	5	774	3	25	0	807
11194	5	20	4	774	0	803
11195	4	774	2	28	0	808
11196	3	21	3	781	0	808
11197	3	7	2	753	0	765
11198	7	4	725	26	0	762
11199	1	712	16	11	0	740
11200	1	677	4	7	0	689
11201	575	11	5	6	0	597
11202	11	567	2	8	0	588
11203	5	14	2	564	0	585
11204	4	7	551	13	0	575
11205	7	8	12	542	0	569
11206	541	4	3	18	0	566
11207	14	3	564	7	0	588
11208	2	585	13	8	0	608
11209	3	11	5	556	0	575
11210	2	4	4	595	0	605
11211	594	3	2	18	0	617
11212	11	2	2	612	0	627
11213	0	1	6	613	0	620
11214	4	5	0	603	0	612
11215	1	3	0	605	0	609
11216	587	2	0	20	0	609
11217	589	1	1	11	0	602
11218	12	1	1	588	0	602
11219	571	2	3	18	0	594
11220	13	1	2	569	0	585
11221	4	2	556	19	0	581
11222	5	0	549	7	0	561
11223	3	3	11	520	0	537
11224	1	507	3	19	0	530
11225	2	12	3	506	0	523
11226	497	0	4	15	0	516
11227	12	4	3	507	0	526
11228	500	2	1	20	0	523
11229	14	2	1	510	0	527
11230	5	1	506	19	0	531
11231	6	508	8	7	0	529
11232	6	523	3	8	0	540
11233	1	17	3	449	0	470
11234	3	4	459	13	0	479
11235	1	374	3	4	0	382
11236	3	3	1	342	0	349
11237	341	1	0	3	0	345
11238	2	2	345	2	0	351
11239	0	0	3	349	0	352
11240	1	1	1	356	0	359
11241	0	2	359	3	0	364
11242	1	0	343	1	0	345
11243	2	2	356	0	0	360
11244	0	1	3	360	0	364
11245	1	0	360	3	0	364
11246	340	0	2	1	0	343
11247	3	0	0	366	0	369
11248	1	0	445	2	0	448
11249	0	457	2	1	0	460
11250	0	2	460	1	0	463
11251	0	1	1	457	0	459
11252	461	5	1	4	0	471
11253	2	1	0	484	0	487
11254	1	0	0	486	0	487
11255	516	0	0	4	0	520
11256	5	0	0	526	0	531
11257	3	0	530	2	0	535
11258	534	0	2	2	0	538
11259	2	534	1	1	0	538
11260	545	1	0	0	0	546
11261	1	1	0	544	0	546
11262	3	0	541	1	0	545
11263	0	2	536	2	0	540
11264	1	0	4	545	0	550
11265	0	0	1	543	0	544
11266	0	0	547	2	0	549
11267	1	0	542	2	0	545
11268	551	0	3	0	0	554
11269	3	1	2	554	0	560
11270	563	0	0	2	0	565
11271	1	0	0	557	0	558
11272	2	0	575	1	0	578
11273	0	0	590	2	0	592
11274	2	0	4	602	0	608
11275	4	0	2	610	0	616
11276	0	0	637	5	0	642
11277	637	0	3	2	0	642
11278	6	0	2	668	0	676
11279	695	0	0	4	0	699
11280	5	798	1	2	0	806
11281	2	6	0	819	0	827
11282	827	2	0	10	0	839
11283	8	1	834	2	0	845
11284	4	0	8	840	0	852
11285	0	0	1	848	0	849
11286	1	1	0	864	0	866
11287	0	0	845	13	0	858
11288	2	0	8	848	0	858
11289	0	857	3	8	0	868
11290	0	8	0	870	0	878
11291	0	3	862	10	0	875
11292	4	1	871	3	0	879
11293	3	1	9	876	0	889
11294	1	0	2	889	0	892
11295	2	1	0	889	0	892
11296	2	0	1	889	0	892
11297	882	0	2	10	0	894
11298	882	0	2	4	0	888
11299	10	0	870	3	0	883
11300	3	880	9	1	0	893
11301	2	7	2	896	0	907
11302	916	2	0	11	0	929
11303	842	0	0	9	0	851
11304	922	0	1	3	0	926
11305	922	0	1	3	0	926
11306	10	1	902	3	0	916
11307	873	0	11	3	0	887
11308	11	859	4	2	0	876
11309	8	9	1	868	0	886
11310	4	1	877	10	0	892
11311	4	0	9	876	0	889
11312	2	2	883	9	0	896
11313	3	1	10	876	0	890
11314	5	1	3	879	0	888
11315	884	0	3	15	0	902
11316	10	1	3	886	0	900
11317	2	0	891	12	0	905
11318	3	0	8	912	0	923
11319	913	0	5	13	0	931
11320	11	0	2	922	0	935
11321	3	2	918	13	0	936
11322	2	897	10	9	0	918
11323	935	9	7	4	0	955
11324	9	2	4	920	0	935
11325	3	952	2	13	0	970
11326	951	8	3	7	0	969
11327	10	2	951	4	0	967
11328	2	949	10	6	0	967
11329	6	8	3	972	0	989
11330	3	4	950	12	0	969
11331	4	1	9	953	0	967
11332	950	3	2	10	0	965
11333	11	1	941	6	0	959
11334	7	5	8	929	0	949
11335	3	0	939	13	0	955
11336	4	1	10	929	0	944
11337	3	2	4	940	0	949
11338	930	0	2	18	0	950
11339	14	935	3	4	0	956
11340	3	9	3	949	0	964
11341	941	3	4	12	0	960
11342	947	1	4	7	0	959
11343	11	3	2	934	0	950
11344	4	906	6	10	0	926
11345	0	952	3	7	0	962
11346	1	9	2	941	0	953
11347	6	1	3	926	0	936
11348	850	0	2	17	0	869
11349	13	1	5	841	0	860
11350	3	1	818	16	0	838
11351	797	1	9	3	0	810
11352	9	800	3	5	0	817
11353	795	9	4	5	0	813
11354	11	3	827	4	0	845
11355	4	843	9	3	0	859
11356	827	10	3	3	0	843
11357	832	5	2	4	0	843
11358	12	3	833	1	0	849
11359	828	1	10	1	0	840
11360	838	2	3	1	0	844
11361	9	834	1	2	0	846
11362	4	8	2	856	0	870
11363	2	2	858	9	0	871
11364	6	1	7	870	0	884
11365	1	2	887	9	0	899
11366	2	0	8	882	0	892
11367	882	1	4	10	0	897
11368	11	0	1	891	0	903
11369	2	1	952	9	0	964
11370	975	0	10	6	0	991
11371	12	1	3	1012	0	1028
11372	3	0	987	11	0	1001
11373	968	0	8	5	0	981
11374	15	0	2	976	0	993
11375	2	3	958	10	0	973
11376	8	3	919	2	0	932
11377	3	6	6	936	0	951
11378	2	0	933	6	0	941
11379	0	907	9	2	0	918
11380	4	8	3	796	0	811
11381	803	1	3	3	0	810
11382	5	1	799	2	0	807
11383	1	0	798	5	0	804
11384	775	0	6	1	0	782
11385	5	0	789	1	0	795
11386	773	0	7	3	0	783
11387	6	1	792	1	0	800
11388	2	0	6	786	0	794
11389	3	1	791	5	0	800
11390	2	0	10	788	0	800
11391	0	3	807	8	0	818
11392	2	1	803	3	0	809
11393	781	0	9	5	0	795
11394	3	802	4	1	0	810
11395	817	2	5	1	0	825
11396	8	824	1	1	0	834
11397	3	6	3	843	0	855
11398	7	1	3	850	0	861
11399	851	2	1	7	0	861
11400	3	0	4	846	0	853
11401	2	0	839	8	0	849
11402	816	0	11	4	0	831
11403	837	0	3	5	0	845
11404	8	0	8	828	0	844
11405	5	1	829	5	0	840
11406	7	1	6	824	0	838
11407	1	835	4	8	0	848
11408	3	4	3	842	0	852
11409	0	3	2	858	0	863
11410	3	3	832	8	0	846
11411	787	3	5	8	0	803
11412	6	817	2	6	0	831
11413	824	5	4	4	0	837
11414	10	829	3	0	0	842
11415	4	7	1	817	0	829
11416	7	834	3	3	0	847
11417	2	6	816	6	0	830
11418	2	2	8	791	0	803
11419	4	4	1	812	0	821
11420	1	1	4	822	0	828
11421	800	0	2	12	0	814
11422	6	0	2	807	0	815
11423	783	0	2	11	0	796
11424	788	2	2	2	0	794
11425	775	3	3	4	0	785
11426	10	1	764	6	0	781
11427	5	2	8	768	0	783
11428	6	1	3	795	0	805
11429	0	4	6	797	0	807
11430	835	0	1	13	0	849
11431	8	2	2	847	0	859
11432	3	1	3	863	0	870
11433	917	1	1	13	0	932
11434	12	1	2	933	0	948
11435	7	0	968	17	0	992
11436	7	3	978	3	0	991
11437	4	0	16	992	0	1012
11438	979	1	6	17	0	1003
11439	963	0	6	5	0	974
11440	18	1	1	961	0	981
11441	8	0	953	17	0	978
11442	6	940	14	6	0	966
11443	3	17	3	973	0	996
11444	4	1	3	989	0	997
11445	4	5	0	973	0	982
11446	960	0	3	23	0	986
11447	19	0	972	8	0	999
11448	981	0	17	5	0	1003
11449	23	0	2	978	0	1003
11450	3	972	5	16	0	996
11451	986	15	2	5	0	1008
11452	988	2	2	7	0	999
11453	17	4	1001	4	0	1026
11454	6	938	15	6	0	965
11455	6	930	2	4	0	942
11456	925	18	4	8	0	955
11457	20	1	2	927	0	950
11458	2	5	4	934	0	945
11459	8	1	2	922	0	933
11460	7	883	2	26	0	918
11461	4	917	1	6	0	928
11462	884	19	1	7	0	911
11463	25	4	2	869	0	900
11464	2	3	909	20	0	934
11465	5	1	24	946	0	976
11466	1	0	1037	37	0	1075
11467	2	2	1055	4	0	1063
11468	6	1	1059	4	0	1070
11469	1	941	36	2	0	980
11470	13	32	16	891	0	952
11471	2	904	7	28	0	941
11472	1	34	4	871	0	910
11473	1	5	6	939	0	951
11474	904	2	2	42	0	950
11475	32	3	3	909	0	947
11476	901	2	1	39	0	943
11477	918	2	0	8	0	928
11478	37	0	0	883	0	920
11479	8	865	1	34	0	908
11480	8	29	1	851	0	889
11481	4	847	1	36	0	888
11482	3	33	0	843	0	879
11483	1	8	824	35	0	868
11484	5	3	30	834	0	872
11485	3	2	3	865	0	873
11486	822	1	5	40	0	868
11487	31	814	4	14	0	863
11488	5	30	2	820	0	857
11489	2	6	1	831	0	840
11490	3	793	3	37	0	836
11491	3	33	0	799	0	835
11492	757	5	1	38	0	801
11493	804	2	2	11	0	819
11494	34	761	0	6	0	801
11495	6	33	1	769	0	809
11496	745	4	1	34	0	784
11497	37	742	2	6	0	787
11498	7	35	1	724	0	767
11499	3	737	2	31	0	773
11500	733	34	1	7	0	775
11501	33	7	727	6	0	773
11502	4	5	743	7	0	759
11503	4	3	36	719	0	762
11504	3	1	727	35	0	766
11505	3	2	39	718	0	762
11506	718	2	8	34	0	762
11507	32	1	731	14	0	778
11508	10	1	34	732	0	777
11509	5	2	6	767	0	780
11510	730	1	3	36	0	770
11511	32	721	9	10	0	772
11512	715	31	3	9	0	758
11513	742	4	1	7	0	754
11514	39	712	1	5	0	757
11515	12	30	2	720	0	764
11516	9	11	718	30	0	768
11517	7	3	31	722	0	763
11518	3	720	3	38	0	764
11519	734	36	3	10	0	783
11520	34	6	5	736	0	781
11521	9	5	743	34	0	791
11522	6	4	32	760	0	802
11523	6	2	7	780	0	795
11524	1	4	5	782	0	792
11525	3	5	2	794	0	804
11526	4	4	2	790	0	800
11527	2	1	741	50	0	794
11528	8	1	723	17	0	749
11529	1	687	35	11	0	734
11530	3	697	7	8	0	715
11531	663	32	7	6	0	708
11532	29	6	663	4	0	702
11533	588	6	27	5	0	626
11534	26	5	581	5	0	617
11535	8	3	542	1	0	554
11536	4	3	29	516	0	552
11537	529	2	10	22	0	563
11538	21	0	5	541	0	567
11539	5	3	6	558	0	572
11540	5	0	563	32	0	600
11541	4	2	21	575	0	602
11542	4	0	4	575	0	583
11543	2	2	3	588	0	595
11544	4	2	4	583	0	593
11545	2	0	1	589	0	592
11546	546	3	0	31	0	580
11547	21	1	0	545	0	567
11548	5	2	515	26	0	548
11549	6	1	17	527	0	551
11550	4	1	521	25	0	551
11551	4	3	19	526	0	552
11552	1	2	539	26	0	568
11553	0	4	23	507	0	534
11554	1	0	7	550	0	558
11555	1	4	528	23	0	556
11556	508	0	21	11	0	540
11557	17	1	539	9	0	566
11558	6	4	20	544	0	574
11559	554	1	7	21	0	583
11560	21	2	5	564	0	592
11561	8	0	4	577	0	589
11562	5	2	562	24	0	593
11563	3	556	17	11	0	587
11564	3	498	3	7	0	511
11565	0	487	4	7	0	498
11566	8	1	7	373	0	389
11567	395	0	0	1	0	396
11568	0	1	0	398	0	399
11569	0	1	0	395	0	396
11570	0	1	0	400	0	401
11571	1	0	0	403	0	404
11572	1	402	0	0	0	403
11573	1	0	0	409	0	410
11574	0	0	0	406	0	406
11575	0	407	1	1	0	409
11576	417	0	0	2	0	419
11577	0	1	0	417	0	418
11578	420	0	0	1	0	421
11579	418	0	2	1	0	421
11580	0	436	0	0	0	436
11581	1	0	0	468	0	469
11582	0	0	463	1	0	464
11583	1	0	465	0	0	466
11584	1	0	0	469	0	470
11585	488	1	0	1	0	490
11586	500	0	0	1	0	501
11587	1	0	1	510	0	512
11588	509	0	1	2	0	512
11589	0	508	0	2	0	510
11590	511	0	1	0	0	512
11591	1	534	1	0	0	536
11592	0	1	0	545	0	546
11593	1	1	0	546	0	548
11594	1	547	0	1	0	549
11595	558	0	1	0	0	559
11596	1	1	540	1	0	543
11597	0	0	1	543	0	544
11598	0	0	554	0	0	554
11599	0	1	0	553	0	554
11600	559	0	0	0	0	559
11601	0	0	1	557	0	558
11602	551	0	0	3	0	554
11603	546	0	2	0	0	548
11604	0	0	0	558	0	558
11605	1	0	550	1	0	552
11606	0	577	0	2	0	579
11607	1	0	0	576	0	577
11608	562	0	1	1	0	564
11609	1	0	561	2	0	564
11610	0	0	1	577	0	578
11611	1	1	2	576	0	580
11612	1	0	0	587	0	588
11613	595	0	2	1	0	598
11614	0	0	1	588	0	589
11615	1	0	1	591	0	593
11616	0	0	585	3	0	588
11617	0	0	0	591	0	591
11618	2	0	1	608	0	611
11619	1	0	0	614	0	615
11620	0	603	1	1	0	605
11621	0	4	2	598	0	604
11622	1	0	0	601	0	602
11623	590	0	0	4	0	594
11624	0	2	588	2	0	592
11625	1	2	551	3	0	557
11626	0	592	1	4	0	597
11627	2	1	0	611	0	614
11628	614	1	0	1	0	616
11629	1	3	1	607	0	612
11630	1	0	1	613	0	615
11631	1	2	0	611	0	614
11632	1	1	1	604	0	607
11633	2	0	0	604	0	606
11634	2	0	598	1	0	601
11635	2	0	0	602	0	604
11636	600	0	0	2	0	602
11637	2	587	0	3	0	592
11638	0	1	1	594	0	596
11639	1	0	2	592	0	595
11640	1	1	588	2	0	592
11641	4	0	0	577	0	581
11642	1	1	0	632	0	634
11643	648	1	0	3	0	652
11644	4	665	0	4	0	673
11645	1	3	2	672	0	678
11646	2	1	0	687	0	690
11647	0	1	2	683	0	686
11648	1	0	683	6	0	690
11649	2	1	655	3	0	661
11650	0	677	6	5	0	688
11651	2	697	1	2	0	702
11652	1	6	0	692	0	699
11653	0	669	2	6	0	677
11654	0	6	3	755	0	764
11655	1	3	0	831	0	835
11656	1	1	0	869	0	871
11657	2	0	0	978	0	980
11658	0	2	974	16	0	992
11659	0	0	11	994	0	1005
11660	1	0	6	1001	0	1008
11661	2	0	1	1027	0	1030
11662	1000	1	0	23	0	1024
11663	13	999	5	14	0	1031
11664	6	14	1	986	0	1007
11665	2	990	3	19	0	1014
11666	971	15	2	11	0	999
11667	893	7	2	11	0	913
11668	16	966	0	7	0	989
11669	6	984	0	5	0	995
11670	3	24	962	6	0	995
11671	5	986	14	6	0	1011
11672	5	18	6	985	0	1014
11673	996	9	1	20	0	1026
11674	18	1007	1	7	0	1033
11675	10	23	2	1012	0	1047
11676	3	14	2	1034	0	1053
11677	1	7	3	1055	0	1066
11678	1023	4	2	27	0	1056
11679	19	3	1019	14	0	1055
11680	989	5	16	9	0	1019
11681	17	994	8	8	0	1027
11682	9	19	3	1000	0	1031
11683	5	10	977	23	0	1015
11684	968	5	20	11	0	1004
11685	21	972	9	7	0	1009
11686	11	21	4	947	0	983
11687	4	974	3	18	0	999
11688	4	18	4	988	0	1014
11689	5	10	3	998	0	1016
11690	4	7	979	28	0	1018
11691	3	5	945	13	0	966
11692	5	4	22	956	0	987
11693	3	6	957	24	0	990
11694	1	6	17	970	0	994
11695	4	2	12	953	0	971
11696	3	4	8	986	0	1001
11697	961	3	5	29	0	998
11698	16	4	7	978	0	1005
11699	10	2	965	28	0	1005
11700	965	2	20	17	0	1004
11701	20	3	8	998	0	1029
11702	11	2	6	1014	0	1033
11703	991	1	4	32	0	1028
11704	19	1013	3	16	0	1051
11705	12	16	4	1015	0	1047
11706	6	8	6	1006	0	1026
11707	985	1	3	35	0	1024
11708	22	5	973	17	0	1017
11709	13	1	19	983	0	1016
11710	9	4	9	1002	0	1024
11711	4	6	2	997	0	1009
11712	4	973	4	37	0	1018
11713	5	16	8	987	0	1016
11714	969	10	4	27	0	1010
11715	16	970	3	22	0	1011
11716	960	18	6	10	0	994
11717	18	976	2	8	0	1004
11718	952	18	1	19	0	990
11719	23	9	939	13	0	984
11720	14	6	927	7	0	954
11721	942	4	25	9	0	980
11722	21	5	949	8	0	983
11723	16	4	18	943	0	981
11724	7	6	12	898	0	923
11725	4	2	6	974	0	986
11726	945	1	6	28	0	980
11727	21	4	929	12	0	966
11728	931	3	19	16	0	969
11729	20	2	10	969	0	1001
11730	961	3	4	26	0	994
11731	24	1	4	973	0	1002
11732	983	2	5	29	0	1019
11733	32	3	4	1071	0	1110
11734	13	5	1087	31	0	1136
11735	1101	4	21	18	0	1144
11736	1152	1	10	14	0	1177
11737	44	0	3	1126	0	1173
11738	17	4	4	1144	0	1169
11739	9	1129	6	42	0	1186
11740	1102	24	4	18	0	1148
11741	29	1106	3	7	0	1145
11742	1074	25	4	10	0	1113
11743	31	9	1051	7	0	1098
11744	20	5	1053	5	0	1083
11745	8	5	1049	5	0	1067
11746	1036	2	32	8	0	1078
11747	27	1040	11	6	0	1084
11748	16	25	3	1027	0	1071
11749	1021	6	7	23	0	1057
11750	21	1029	11	11	0	1072
11751	20	35	4	997	0	1056
11752	9	1014	3	19	0	1045
11753	6	971	3	12	0	992
11754	5	967	2	8	0	982
11755	859	37	4	7	0	907
11756	16	848	1	9	0	874
11757	2	716	3	1	0	722
11758	10	695	1	0	0	706
11759	686	13	4	5	0	708
11760	678	2	6	4	0	690
11761	14	4	658	4	0	680
11762	640	3	7	2	0	652
11763	674	1	1	2	0	678
11764	10	2	3	663	0	678
11765	678	0	0	12	0	690
11766	13	1	662	1	0	677
11767	1	685	12	8	0	706
11768	713	11	4	0	0	728
11769	17	1	3	732	0	753
11770	736	4	1	14	0	755
11771	15	1	716	5	0	737
11772	716	0	9	1	0	726
11773	16	1	0	730	0	747
11774	5	0	721	16	0	742
11775	2	690	13	2	0	707
11776	1	726	2	1	0	730
11777	4	16	1	714	0	735
11778	3	3	1	716	0	723
11779	0	710	0	16	0	726
11780	707	13	0	6	0	726
11781	715	3	0	2	0	720
11782	716	2	0	3	0	721
11783	16	725	2	0	0	743
11784	5	14	1	702	0	722
11785	4	727	0	8	0	739
11786	729	15	0	3	0	747
11787	730	3	0	4	0	737
11788	18	715	0	0	0	733
11789	724	13	2	0	0	739
11790	15	5	0	710	0	730
11791	11	1	0	720	0	732
11792	720	1	1	20	0	742
11793	710	0	1	3	0	714
11794	715	0	4	3	0	722
11795	22	1	0	701	0	724
11796	7	1	0	722	0	730
11797	1	0	703	19	0	723
11798	5	2	13	687	0	707
11799	1	5	3	693	0	702
11800	4	0	661	18	0	683
11801	0	4	648	5	0	657
11802	2	3	663	2	0	670
11803	2	2	19	662	0	685
11804	4	1	653	13	0	671
11805	2	2	15	645	0	664
11806	2	3	3	657	0	665
11807	1	4	640	18	0	663
11808	2	2	651	5	0	660
11809	5	0	15	643	0	663
11810	3	3	676	14	0	696
11811	1	3	677	3	0	684
11812	3	678	14	2	0	697
11813	685	14	3	4	0	706
11814	692	5	2	3	0	702
11815	699	1	2	0	0	702
11816	18	676	0	0	0	694
11817	9	689	0	0	0	698
11818	4	15	0	683	0	702
11819	3	3	1	684	0	691
11820	4	2	673	14	0	693
11821	3	0	15	663	0	681
11822	670	0	1	19	0	690
11823	16	0	4	634	0	654
11824	2	661	4	14	0	681
11825	691	13	3	4	0	711
11826	709	2	2	6	0	719
11827	712	3	2	4	0	721
11828	18	1	690	1	0	710
11829	5	0	12	702	0	719
11830	778	0	5	13	0	796
11831	19	1	793	6	0	819
11832	6	763	19	4	0	792
11833	2	694	5	7	0	708
11834	655	14	5	2	0	676
11835	12	644	2	0	0	658
11836	6	12	6	622	0	646
11837	2	4	642	13	0	661
11838	5	1	11	642	0	659
11839	646	2	4	13	0	665
11840	11	636	1	4	0	652
11841	640	11	0	1	0	652
11842	12	3	625	2	0	642
11843	5	3	10	617	0	635
11844	1	638	3	12	0	654
11845	4	12	1	642	0	659
11846	647	3	1	16	0	667
11847	659	1	0	5	0	665
11848	658	1	1	1	0	661
11849	659	1	0	2	0	662
11850	18	0	3	633	0	654
11851	5	2	646	12	0	665
11852	2	1	11	646	0	660
11853	3	661	3	10	0	677
11854	670	10	2	4	0	686
11855	12	3	666	1	0	682
11856	662	2	11	2	0	677
11857	13	1	3	669	0	686
11858	4	1	685	11	0	701
11859	2	0	11	693	0	706
11860	701	0	4	13	0	718
11861	705	0	1	5	0	711
11862	704	0	1	1	0	706
11863	14	1	687	1	0	703
11864	7	0	12	692	0	711
11865	2	0	712	11	0	725
11866	1	699	11	5	0	716
11867	672	12	10	2	0	696
11868	8	650	2	4	0	664
11869	627	6	0	2	0	635
11870	9	2	0	614	0	625
11871	2	613	0	6	0	621
11872	610	7	0	8	0	625
11873	7	3	612	1	0	623
11874	2	1	6	611	0	620
11875	611	0	2	7	0	620
11876	6	1	612	2	0	621
11877	4	0	4	593	0	601
11878	1	601	2	6	0	610
11879	1	7	0	628	0	636
11880	1	3	0	630	0	634
11881	628	1	0	9	0	638
11882	6	624	0	3	0	633
11883	2	6	0	610	0	618
11884	0	620	1	6	0	627
11885	2	7	0	619	0	628
11886	2	624	1	5	0	632
11887	620	8	0	2	0	630
11888	7	2	634	1	0	644
11889	3	1	7	631	0	642
11890	2	0	3	635	0	640
11891	0	1	2	637	0	640
11892	0	0	0	634	0	634
11893	0	0	619	11	0	630
11894	1	643	6	5	0	655
11895	648	7	3	3	0	661
11896	655	3	1	2	0	661
11897	9	649	0	2	0	660
11898	658	6	1	1	0	666
11899	668	3	0	1	0	672
11900	9	679	0	2	0	690
11901	5	7	1	675	0	688
11902	2	691	2	5	0	700
11903	685	7	1	4	0	697
11904	7	4	679	3	0	693
11905	654	2	7	1	0	664
11906	8	0	709	3	0	720
11907	6	1	7	701	0	715
11908	697	1	4	7	0	709
11909	6	1	680	3	0	690
11910	668	1	7	3	0	679
11911	688	0	3	1	0	692
11912	11	1	4	699	0	715
11913	7	694	1	6	0	708
11914	704	7	2	4	0	717
11915	6	5	0	705	0	716
11916	5	692	1	8	0	706
11917	695	7	0	3	0	705
11918	9	4	0	705	0	718
11919	5	741	1	8	0	755
11920	3	7	0	767	0	777
11921	764	3	1	14	0	782
11922	773	2	0	5	0	780
11923	780	0	1	2	0	783
11924	11	1	2	763	0	777
11925	6	1	0	751	0	758
11926	3	0	757	12	0	772
11927	0	0	7	772	0	779
11928	1	2	795	13	0	811
11929	3	2	746	4	0	755
11930	2	2	693	2	0	699
11931	4	723	7	1	0	735
11932	3	4	3	714	0	724
11933	1	802	1	5	0	809
11934	825	12	0	4	0	841
11935	826	3	2	6	0	837
11936	16	4	2	854	0	876
11937	6	0	881	14	0	901
11938	7	1	13	876	0	897
11939	4	0	912	17	0	933
11940	3	1	12	894	0	910
11941	2	896	4	16	0	918
11942	3	927	4	8	0	942
11943	919	13	4	9	0	945
11944	14	4	941	4	0	963
11945	5	2	19	929	0	955
11946	4	2	8	960	0	974
11947	957	2	4	23	0	986
11948	13	961	2	6	0	982
11949	962	18	1	7	0	988
11950	19	977	1	2	0	999
11951	961	14	3	5	0	983
11952	994	3	3	4	0	1004
11953	17	2	5	986	0	1010
11954	4	1	983	18	0	1006
11955	959	1	15	9	0	984
11956	16	986	6	4	0	1012
11957	992	17	3	5	0	1017
11958	22	7	1	958	0	988
11959	7	6	2	968	0	983
11960	6	951	2	20	0	979
11961	5	13	3	953	0	974
11962	3	977	3	22	0	1005
11963	6	16	2	969	0	993
11964	8	5	1	961	0	975
11965	944	7	1	21	0	973
11966	20	3	944	6	0	973
11967	7	938	13	5	0	963
11968	5	16	3	955	0	979
11969	952	5	3	14	0	974
11970	969	3	1	8	0	981
11971	968	4	2	5	0	979
11972	23	2	954	5	0	984
11973	954	2	14	8	0	978
11974	20	4	3	974	0	1001
11975	973	2	4	22	0	1001
11976	18	963	3	12	0	996
11977	7	19	1	983	0	1010
11978	972	5	4	23	0	1004
11979	18	984	2	11	0	1015
11980	6	19	4	1000	0	1029
11981	5	4	1011	20	0	1040
11982	1056	6	13	7	0	1082
11983	1100	3	6	10	0	1119
11984	26	4	1075	4	0	1109
11985	10	1059	14	5	0	1088
11986	7	1102	2	6	0	1117
11987	11	20	3	1096	0	1130
11988	7	5	2	1065	0	1079
11989	5	4	5	1097	0	1111
11990	8	1	1092	21	0	1122
11991	1094	4	19	9	0	1126
11992	1146	3	6	8	0	1163
11993	1167	6	4	5	0	1182
11994	1166	7	2	8	0	1183
11995	1190	6	2	10	0	1208
11996	1197	3	3	10	0	1213
11997	25	4	5	1239	0	1273
11998	8	4	1220	30	0	1262
11999	8	4	1254	9	0	1275
12000	10	5	26	1242	0	1283
12001	9	7	7	1239	0	1262
12002	11	5	7	1256	0	1279
12003	10	1258	1	28	0	1297
12004	1271	24	1	15	0	1311
12005	29	1284	4	11	0	1328
12006	12	28	4	1261	0	1305
12007	1257	6	8	31	0	1302
12008	32	1249	3	10	0	1294
12009	13	23	1	1263	0	1300
12010	15	6	3	1282	0	1306
12011	9	7	3	1284	0	1303
12012	9	1251	1	29	0	1290
12013	10	25	4	1260	0	1299
12014	7	8	1260	32	0	1307
12015	10	6	23	1287	0	1326
12016	11	3	8	1301	0	1323
12017	3	8	4	1372	0	1387
12018	8	5	4	1383	0	1400
12019	4	9	1337	43	0	1393
12020	3	1325	29	19	0	1376
12021	8	30	8	1362	0	1408
12022	8	8	8	1404	0	1428
12023	7	9	9	1394	0	1419
12024	8	1339	2	49	0	1398
12025	4	1396	4	25	0	1429
12026	1356	35	3	19	0	1413
12027	39	14	2	1343	0	1398
12028	10	10	1295	35	0	1350
12029	7	1294	26	28	0	1355
12030	1281	27	8	19	0	1335
12031	30	8	1253	17	0	1308
12032	9	10	1255	9	0	1283
12033	9	7	1209	13	0	1238
12034	14	17	32	1168	0	1231
12035	6	4	1186	30	0	1226
12036	4	1139	34	14	0	1191
12037	2	21	13	1092	0	1128
12038	3	10	1096	30	0	1139
12039	6	8	24	1063	0	1101
12040	1061	10	8	29	0	1108
12041	21	3	1062	20	0	1106
12042	1041	6	28	8	0	1083
12043	24	1062	10	13	0	1109
12044	1053	22	9	7	0	1091
12045	26	8	11	1051	0	1096
12046	1044	8	5	23	0	1080
12047	1039	13	8	13	0	1073
12048	1031	6	6	16	0	1059
12049	28	1032	10	14	0	1084
12050	1037	18	9	8	0	1072
12051	1042	9	9	7	0	1067
12052	34	10	1006	4	0	1054
12053	15	995	22	8	0	1040
12054	22	20	12	988	0	1042
12055	14	9	10	1008	0	1041
12056	13	7	11	1010	0	1041
12057	8	10	971	33	0	1022
12058	12	7	22	989	0	1030
12059	5	3	982	38	0	1028
12060	976	3	27	17	0	1023
12061	1007	6	15	11	0	1039
12062	28	4	987	14	0	1033
12063	993	3	28	8	0	1032
12064	1019	2	10	9	0	1040
12065	1024	5	7	10	0	1046
12066	34	6	10	988	0	1038
12067	21	6	989	22	0	1038
12068	18	997	20	14	0	1049
12069	15	23	10	1012	0	1060
12070	9	9	1010	28	0	1056
12071	7	11	990	13	0	1021
12072	976	8	21	15	0	1020
12073	23	999	13	11	0	1046
12074	1019	18	15	10	0	1062
12075	1013	9	12	10	0	1044
12076	31	1003	7	9	0	1050
12077	991	21	10	12	0	1034
12078	32	4	1006	8	0	1050
12079	18	7	1005	5	0	1035
12080	12	10	1007	6	0	1035
12081	14	945	27	6	0	992
12082	907	19	25	2	0	953
12083	907	6	12	8	0	933
12084	25	888	12	5	0	930
12085	13	924	7	5	0	949
12086	18	19	3	919	0	959
12087	9	15	5	935	0	964
12088	920	10	7	24	0	961
12089	17	926	8	15	0	966
12090	926	21	6	12	0	965
12091	917	12	2	8	0	939
12092	31	7	887	3	0	928
12093	15	875	17	7	0	914
12094	17	21	14	858	0	910
12095	843	11	4	13	0	871
12096	20	5	7	825	0	857
12097	781	5	3	17	0	806
12098	14	2	771	11	0	798
12099	11	748	11	4	0	774
12100	10	773	4	10	0	797
12101	14	17	11	740	0	782
12102	5	780	11	7	0	803
12103	773	24	3	5	0	805
12104	14	10	758	5	0	787
12105	739	6	9	4	0	758
12106	20	7	773	2	0	802
12107	12	6	12	766	0	796
12108	6	4	10	775	0	795
12109	14	2	5	788	0	809
12110	775	2	7	19	0	803
12111	12	3	796	13	0	824
12112	4	4	9	787	0	804
12113	10	1	3	787	0	801
12114	8	766	7	10	0	791
12115	3	755	7	5	0	770
12116	1	775	2	13	0	791
12117	6	7	0	731	0	744
12118	2	6	2	705	0	715
12119	1	668	0	8	0	677
12120	3	667	1	4	0	675
12121	667	5	2	4	0	678
12122	3	3	0	664	0	670
12123	1	652	1	3	0	657
12124	665	1	1	2	0	669
12125	1	1	0	687	0	689
12126	762	1	0	2	0	765
12127	3	1	0	788	0	792
12128	1	0	801	3	0	805
12129	2	807	2	1	0	812
12130	804	4	1	0	0	809
12131	3	1	809	1	0	814
12132	0	808	2	1	0	811
12133	2	2	0	825	0	829
12134	0	1	0	822	0	823
12135	1	0	1	811	0	813
12136	0	1	0	795	0	796
12137	2	0	817	1	0	820
12138	0	811	4	0	0	815
12139	0	3	0	821	0	824
12140	811	0	0	3	0	814
12141	1	826	0	2	0	829
12142	3	2	0	892	0	897
12143	0	0	892	7	0	899
12144	0	898	5	5	0	908
12145	2	6	4	851	0	863
12146	1	930	0	4	0	935
12147	930	5	2	2	0	939
12148	939	6	0	2	0	947
12149	10	0	921	3	0	934
12150	926	0	7	2	0	935
12151	955	1	2	2	0	960
12152	13	3	913	1	0	930
12153	6	928	9	1	0	944
12154	5	7	4	943	0	959
12155	4	3	3	960	0	970
12156	959	0	2	10	0	971
12157	11	2	0	963	0	976
12158	4	0	962	7	0	973
12159	943	4	8	6	0	961
12160	8	2	954	3	0	967
12161	5	961	6	4	0	976
12162	931	8	7	2	0	948
12163	9	4	946	3	0	962
12164	6	1	933	1	0	941
12165	3	947	12	0	0	962
12166	3	7	5	959	0	974
12167	1	7	955	7	0	970
12168	7	0	8	866	0	881
12169	3	2	7	930	0	942
12170	1	0	923	13	0	937
12171	0	922	9	5	0	936
12172	2	7	4	930	0	943
12173	915	4	4	9	0	932
12174	903	1	2	7	0	913
12175	14	1	0	902	0	917
12176	5	0	914	8	0	927
12177	1	4	943	5	0	953
12178	2	3	10	925	0	940
12179	5	0	906	8	0	919
12180	916	0	8	4	0	928
12181	8	1	6	945	0	960
12182	6	0	3	957	0	966
12183	3	943	8	11	0	965
12184	1	8	2	962	0	973
12185	1	4	928	13	0	946
12186	898	1	9	6	0	914
12187	914	1	5	7	0	927
12188	12	1	934	9	0	956
12189	7	3	8	987	0	1005
12190	5	1	6	1012	0	1024
12191	3	0	1014	20	0	1037
12192	3	0	16	1021	0	1040
12193	6	2	9	1013	0	1030
12194	4	1024	4	18	0	1050
12195	2	12	5	1097	0	1116
12196	3	7	1	1116	0	1127
12197	1132	2	4	25	0	1163
12198	1174	1	3	14	0	1192
12199	1189	1	1	7	0	1198
12200	1164	5	0	4	0	1173
12201	1166	1	1	5	0	1173
12202	23	0	1116	6	0	1145
12203	17	1	15	1117	0	1150
12204	8	0	5	1145	0	1158
12205	5	0	1125	25	0	1155
12206	1081	2	18	10	0	1111
12207	1100	1	5	11	0	1117
12208	22	2	1075	3	0	1102
12209	1093	1	16	5	0	1115
12210	1108	1	5	7	0	1121
12211	22	1	1097	1	0	1121
12212	16	1	18	1092	0	1127
12213	10	1134	6	15	0	1165
12214	5	17	8	1181	0	1211
12215	7	6	3	1195	0	1211
12216	5	3	0	1179	0	1187
12217	2	3	1154	25	0	1184
12218	1128	2	17	10	0	1157
12219	1159	4	6	6	0	1175
12220	23	0	5	1149	0	1177
12221	11	0	1131	20	0	1162
12222	9	0	15	1131	0	1155
12223	5	1	1151	20	0	1177
12224	5	1	1161	9	0	1176
12225	4	1162	21	8	0	1195
12226	5	17	12	1085	0	1119
12227	1066	5	11	17	0	1099
12228	1055	4	2	13	0	1074
12229	1063	2	4	5	0	1074
12230	25	2	4	1052	0	1083
12231	10	1118	3	17	0	1148
12232	10	17	1	1140	0	1168
12233	7	4	1150	23	0	1184
12234	1247	3	21	9	0	1280
12235	1307	1	6	7	0	1321
12236	27	0	4	1295	0	1326
12237	15	3	4	1308	0	1330
12238	11	1	2	1326	0	1340
12239	4	1	1295	33	0	1333
12240	1221	0	22	17	0	1260
12241	25	1278	9	11	0	1323
12242	7	1241	4	7	0	1259
12243	4	16	1211	8	0	1239
12244	10	7	17	1181	0	1215
12245	6	6	1197	19	0	1228
12246	1167	1	23	5	0	1196
12247	18	1	5	1173	0	1197
12248	7	2	1163	16	0	1188
12249	5	1195	17	7	0	1224
12250	1206	14	4	7	0	1231
12251	20	5	1223	4	0	1252
12252	6	1199	19	4	0	1228
12253	5	1215	6	5	0	1231
12254	1207	19	4	6	0	1236
12255	16	8	4	1224	0	1252
12256	8	6	1255	17	0	1286
12257	10	1246	16	6	0	1278
12258	1260	17	5	6	0	1288
12259	1278	5	6	4	0	1293
12260	22	1257	3	3	0	1285
12261	11	17	1274	5	0	1307
12262	8	4	21	1275	0	1308
12263	1264	8	4	21	0	1297
12264	1279	4	8	7	0	1298
12265	27	5	1266	11	0	1309
12266	16	3	18	1260	0	1297
12267	10	4	7	1279	0	1300
12268	9	2	1276	21	0	1308
12269	6	4	1271	14	0	1295
12270	1272	3	20	13	0	1308
12271	1302	1	11	7	0	1321
12272	1306	4	8	6	0	1324
12273	1312	0	4	6	0	1322
12274	28	4	1275	7	0	1314
12275	1282	3	20	8	0	1313
12276	29	4	6	1275	0	1314
12277	12	2	1299	21	0	1334
12278	11	2	1312	5	0	1330
12279	7	1299	22	7	0	1335
12280	6	18	9	1268	0	1301
12281	4	5	1270	20	0	1299
12282	1243	4	22	9	0	1278
12283	21	2	9	1206	0	1238
12284	7	1260	6	18	0	1291
12285	1280	17	6	3	0	1306
12286	1286	7	5	6	0	1304
12287	26	5	1270	4	0	1305
12288	12	1260	21	6	0	1299
12289	12	11	7	1216	0	1246
12290	1227	6	4	16	0	1253
12291	13	7	5	1207	0	1232
12292	8	3	1180	17	0	1208
12293	1122	3	15	10	0	1150
12294	14	1180	8	6	0	1208
12295	10	1101	9	7	0	1127
12296	10	1174	3	3	0	1190
12297	1137	21	14	5	0	1177
12298	1115	7	6	4	0	1132
12299	1126	3	2	7	0	1138
12300	14	1	4	1116	0	1135
12301	9	2	1141	7	0	1159
12302	6	4	9	1151	0	1170
12303	1161	2	6	10	0	1179
12304	10	4	2	1163	0	1179
12305	1187	3	3	11	0	1204
12306	1196	1	5	5	0	1207
12307	1183	1	3	4	0	1191
12308	14	1172	2	4	0	1192
12309	1181	9	2	2	0	1194
12310	13	3	1171	3	0	1190
12311	9	2	1170	2	0	1183
12312	4	1176	11	5	0	1196
12313	10	9	7	1121	0	1147
12314	1113	1	6	11	0	1131
12315	12	4	1101	2	0	1119
12316	1083	3	8	4	0	1098
12317	12	1	5	1092	0	1110
12318	8	1116	5	8	0	1137
12319	7	7	4	1153	0	1171
12320	6	5	1152	8	0	1171
12321	1097	3	10	11	0	1121
12322	12	4	1160	2	0	1178
12323	10	1	1134	2	0	1147
12324	1120	1	13	2	0	1136
12325	8	1113	6	3	0	1130
12326	1155	9	2	3	0	1169
12327	1153	2	4	5	0	1164
12328	14	1	1126	3	0	1144
12329	1109	2	10	6	0	1127
12330	12	0	1116	2	0	1130
12331	7	1	1042	2	0	1052
12332	4	2	1049	1	0	1056
12333	4	1032	12	1	0	1049
12334	928	9	13	5	0	955
12335	926	0	3	6	0	935
12336	927	1	2	0	0	930
12337	934	1	3	1	0	939
12338	6	0	942	0	0	948
12339	2	0	6	947	0	955
12340	2	2	3	949	0	956
12341	951	1	1	7	0	960
12342	7	954	0	1	0	962
12343	3	4	0	964	0	971
12344	963	0	1	5	0	969
12345	8	0	983	1	0	992
12346	3	0	6	970	0	979
12347	2	2	985	6	0	995
12348	2	975	4	4	0	985
12349	6	5	3	946	0	960
12350	937	1	2	6	0	946
12351	5	1	1	965	0	972
12352	1	0	973	6	0	980
12353	2	983	6	1	0	992
12354	999	5	0	4	0	1008
12355	11	1	988	0	0	1000
12356	962	1	7	1	0	971
12357	7	978	1	0	0	986
12358	1006	5	4	2	0	1017
12359	1012	0	2	1	0	1015
12360	7	1	1	1026	0	1035
12361	0	0	1033	6	0	1039
12362	2	1028	5	1	0	1036
12363	2	5	4	1096	0	1107
12364	2	0	1	1117	0	1120
12365	4	0	0	1190	0	1194
12366	1	2	1	1270	0	1274
12367	1	1393	1	12	0	1407
12368	1468	13	1	5	0	1487
12369	13	1455	2	3	0	1473
12370	8	14	1	1504	0	1527
12371	1535	5	1	17	0	1558
12372	22	2	1	1534	0	1559
12373	5	2	1544	18	0	1569
12374	5	1519	15	4	0	1543
12375	5	19	3	1522	0	1549
12376	6	4	4	1547	0	1561
12377	1487	3	0	22	0	1512
12378	18	2	1463	10	0	1493
12379	1454	1	19	10	0	1484
12380	1464	4	4	10	0	1482
12381	1462	4	3	11	0	1480
12382	27	4	1457	4	0	1492
12383	13	2	16	1440	0	1471
12384	8	2	6	1465	0	1481
12385	7	3	1463	22	0	1495
12386	7	2	1485	7	0	1501
12387	1484	2	21	10	0	1517
12388	23	1	8	1500	0	1532
12389	1503	3	5	28	0	1539
12390	1541	1	4	14	0	1560
12391	30	2	4	1543	0	1579
12392	10	3	1617	27	0	1657
12393	1585	4	30	12	0	1631
12394	29	3	5	1615	0	1652
12395	16	9	1581	32	0	1638
12396	14	1567	25	7	0	1613
12397	1563	28	12	10	0	1613
12398	32	1566	7	12	0	1617
12399	19	29	3	1486	0	1537
12400	13	1573	8	28	0	1622
12401	1549	26	10	11	0	1596
12402	1559	8	5	19	0	1591
12403	32	1542	8	12	0	1594
12404	1556	26	7	10	0	1599
12405	1544	7	6	12	0	1569
12406	29	1516	11	13	0	1569
12407	1523	24	5	13	0	1565
12408	43	6	5	1513	0	1567
12409	21	6	7	1525	0	1559
12410	1513	4	11	31	0	1559
12411	39	6	6	1434	0	1485
12412	19	1452	7	27	0	1505
12413	1453	25	8	17	0	1503
12414	1455	11	11	18	0	1495
12415	39	1458	9	8	0	1514
12416	1460	24	6	20	0	1510
12417	1482	12	8	7	0	1509
12418	40	11	3	1427	0	1481
12419	23	5	1406	33	0	1467
12420	18	1416	24	11	0	1469
12421	1432	26	7	9	0	1474
12422	1413	9	4	14	0	1440
12423	41	10	1374	13	0	1438
12424	1390	10	26	11	0	1437
12425	43	7	1336	10	0	1396
12426	1337	17	29	9	0	1392
12427	37	9	6	1339	0	1391
12428	22	14	1333	26	0	1395
12429	19	10	1338	12	0	1379
12430	15	13	31	1323	0	1382
12431	16	11	8	1324	0	1359
12432	26	6	1273	34	0	1339
12433	20	5	27	1279	0	1331
12434	15	14	1282	26	0	1337
12435	27	9	25	1264	0	1325
12436	22	8	8	1260	0	1298
12437	17	1228	10	30	0	1285
12438	17	1213	6	19	0	1255
12439	13	1262	10	16	0	1301
12440	15	26	11	1241	0	1293
12441	21	7	8	1256	0	1292
12442	18	8	1219	35	0	1280
12443	1208	10	34	14	0	1266
12444	1248	11	10	10	0	1279
12445	39	1198	7	10	0	1254
12446	1203	26	6	16	0	1251
12447	31	6	15	1186	0	1238
12448	1188	11	10	34	0	1243
12449	1210	3	10	17	0	1240
12450	38	9	7	1176	0	1230
12451	1117	10	12	29	0	1168
12452	37	1101	10	10	0	1158
12453	16	1115	15	13	0	1159
12454	24	22	9	1060	0	1115
12455	15	1084	7	33	0	1139
12456	18	22	7	1080	0	1127
12457	19	9	13	1085	0	1126
12458	1048	12	7	39	0	1106
12459	30	1042	9	17	0	1098
12460	1016	24	10	12	0	1062
12461	993	9	7	23	0	1032
12462	31	983	15	14	0	1043
12463	939	20	5	12	0	976
12464	28	5	920	14	0	967
12465	12	827	21	8	0	868
12466	740	14	2	13	0	769
12467	19	3	611	6	0	639
12468	8	522	8	2	0	540
12469	7	529	2	7	0	545
12470	460	10	19	6	0	495
12471	456	1	4	5	0	466
12472	452	1	2	5	0	460
12473	8	461	2	2	0	473
12474	6	6	1	461	0	474
12475	474	3	1	10	0	488
12476	475	6	0	4	0	485
12477	12	3	1	464	0	480
12478	2	2	461	10	0	475
12479	2	5	463	5	0	475
12480	9	0	7	463	0	479
12481	4	1	3	474	0	482
12482	4	4	462	6	0	476
12483	7	4	4	454	0	469
12484	7	458	1	4	0	470
12485	449	9	0	4	0	462
12486	12	1	1	429	0	443
12487	398	1	2	7	0	408
12488	6	417	1	5	0	429
12489	5	431	2	2	0	440
12490	406	4	0	4	0	414
12491	4	1	393	2	0	400
12492	297	2	3	2	0	304
12493	1	312	3	0	0	316
12494	2	0	0	284	0	286
12495	285	0	1	2	0	288
12496	1	2	0	282	0	285
12497	292	0	0	4	0	296
12498	289	0	4	0	0	293
12499	1	303	0	0	0	304
12500	293	2	0	0	0	295
12501	2	290	1	0	0	293
12502	292	2	0	0	0	294
12503	4	1	2	284	0	291
12504	291	1	0	2	0	294
12505	2	0	0	305	0	307
12506	316	0	0	2	0	318
12507	323	1	0	0	0	324
12508	329	0	0	2	0	331
12509	334	0	1	0	0	335
12510	339	0	0	0	0	339
12511	1	0	0	343	0	344
12512	335	0	1	3	0	339
12513	0	339	1	0	0	340
12514	0	2	337	2	0	341
12515	1	1	1	335	0	338
12516	1	0	348	2	0	351
12517	1	0	2	354	0	357
12518	1	1	358	2	0	362
12519	351	0	1	1	0	353
12520	2	0	0	356	0	358
12521	1	0	356	2	0	359
12522	0	1	368	0	0	369
12523	0	1	1	377	0	379
12524	411	0	0	2	0	413
12525	2	438	1	0	0	441
12526	445	2	0	1	0	448
12527	448	2	0	0	0	450
12528	3	450	0	1	0	454
12529	486	2	0	1	0	489
12530	3	1	0	492	0	496
12531	2	0	0	488	0	490
12532	2	1	0	488	0	491
12533	493	1	0	3	0	497
12534	3	499	0	2	0	504
12535	1	4	0	509	0	514
12536	1	1	0	516	0	518
12537	513	0	0	6	0	519
12538	5	1	0	510	0	516
12539	1	1	529	6	0	537
12540	1	563	4	4	0	572
12541	574	4	1	0	0	579
12542	5	0	0	568	0	573
12543	2	582	1	4	0	589
12544	585	4	0	2	0	591
12545	5	1	579	1	0	586
12546	2	576	3	1	0	582
12547	581	5	2	0	0	588
12548	6	1	1	577	0	585
12549	1	0	1	578	0	580
12550	0	1	580	5	0	586
12551	1	0	4	583	0	588
12552	0	0	645	5	0	650
12553	2	0	626	2	0	630
12554	1	0	664	1	0	666
12555	671	0	6	2	0	679
12556	668	0	2	0	0	670
12557	685	0	1	1	0	687
12558	5	0	0	679	0	684
12559	2	667	0	3	0	672
12560	1	684	0	1	0	686
12561	695	4	0	2	0	701
12562	704	1	0	2	0	707
12563	5	708	0	0	0	713
12564	705	4	0	0	0	709
12565	5	0	692	0	0	697
12566	2	1	697	0	0	700
12567	0	1	5	691	0	697
12568	3	0	1	729	0	733
12569	0	0	729	5	0	734
12570	0	0	5	717	0	722
12571	724	0	1	4	0	729
12572	3	1	721	2	0	727
12573	702	0	5	4	0	711
12574	5	0	1	732	0	738
12575	2	0	728	5	0	735
12576	0	743	6	2	0	751
12577	759	5	0	1	0	765
12578	5	1	744	3	0	753
12579	742	0	6	2	0	750
12580	6	1	1	748	0	756
12581	755	0	0	5	0	760
12582	5	0	791	1	0	797
12583	3	0	5	813	0	821
12584	838	0	1	9	0	848
12585	880	1	0	2	0	883
12586	901	0	1	2	0	904
12587	917	0	1	3	0	921
12588	7	0	0	884	0	891
12589	3	0	1	876	0	880
12590	2	0	887	6	0	895
12591	1	0	5	891	0	897
12592	1	0	2	898	0	901
12593	1	913	0	7	0	921
12594	919	7	2	1	0	929
12595	935	1	1	2	0	939
12596	7	968	1	2	0	978
12597	2	11	0	962	0	975
12598	3	2	0	972	0	977
12599	958	1	0	11	0	970
12600	12	2	974	3	0	991
12601	7	1	8	991	0	1007
12602	2	2	1008	12	0	1024
12603	1006	2	8	4	0	1020
12604	1024	0	2	4	0	1030
12605	1022	1	1	6	0	1030
12606	13	1	4	1006	0	1024
12607	6	0	3	1005	0	1014
12608	993	0	2	13	0	1008
12609	13	4	980	2	0	999
12610	6	0	9	984	0	999
12611	973	0	2	18	0	993
12612	12	1	0	987	0	1000
12613	6	0	1045	11	0	1062
12614	1	0	1022	5	0	1028
12615	1031	1	8	4	0	1044
12616	10	1038	3	4	0	1055
12617	1088	8	2	4	0	1102
12618	1104	1	2	5	0	1112
12619	14	0	3	1118	0	1135
12620	4	2	3	1118	0	1127
12621	6	1107	1	14	0	1128
12622	1113	9	2	3	0	1127
12623	10	1108	1	4	0	1123
12624	4	1109	1	3	0	1117
12625	2	8	0	1089	0	1099
12626	1087	1	1	10	0	1099
12627	1115	2	1	5	0	1123
12628	11	2	0	1108	0	1121
12629	4	3	1	1085	0	1093
12630	2	2	1	1086	0	1091
12631	1078	1	0	13	0	1092
12632	10	1	1073	3	0	1087
12633	3	1072	8	4	0	1087
12634	1074	8	0	8	0	1090
12635	9	5	0	1073	0	1087
12636	4	2	1076	9	0	1091
12637	3	4	1074	2	0	1083
12638	4	1094	7	3	0	1108
12639	1	1106	3	2	0	1112
12640	7	10	1	1081	0	1099
12641	1	988	3	10	0	1002
12642	3	7	2	1072	0	1084
12643	2	2	2	1076	0	1082
12644	1087	2	1	10	0	1100
12645	6	3	2	1088	0	1099
12646	2	3	1	1095	0	1101
12647	4	2	1091	10	0	1107
12648	5	0	6	1102	0	1113
12649	1131	0	1	13	0	1145
12650	1129	1	1	5	0	1136
12651	8	1189	2	3	0	1202
12652	1144	11	3	6	0	1164
12653	13	2	1140	4	0	1159
12654	4	1133	12	2	0	1151
12655	3	12	0	1165	0	1180
12656	6	1	1	1190	0	1198
12657	6	1	2	1202	0	1211
12658	1188	3	2	17	0	1210
12659	1160	2	2	8	0	1172
12660	15	2	1170	2	0	1189
12661	2	1	1150	6	0	1159
12662	2	0	1182	6	0	1190
12663	4	1166	10	4	0	1184
12664	4	1196	0	3	0	1203
12665	1197	11	2	5	0	1215
12666	1194	1	5	2	0	1202
12667	12	3	3	1192	0	1210
12668	4	2	2	1192	0	1200
12669	3	1220	3	14	0	1240
12670	3	15	2	1250	0	1270
12671	5	2	1240	17	0	1264
12672	4	1249	11	8	0	1272
12673	3	13	1	1279	0	1296
12674	4	2	1305	14	0	1325
12675	5	2	12	1258	0	1277
12676	2	1299	2	10	0	1313
12677	1321	10	3	8	0	1342
12678	1330	6	4	7	0	1347
12679	1358	2	3	10	0	1373
12680	17	4	5	1372	0	1398
12681	7	4	3	1412	0	1426
12682	1403	6	1	18	0	1428
12683	24	1389	1	5	0	1419
12684	1408	14	3	5	0	1430
12685	21	3	1483	5	0	1512
12686	1476	2	20	7	0	1505
12687	1496	1	4	8	0	1509
12688	33	1	1	1476	0	1511
12689	1497	5	3	28	0	1533
12690	1566	2	3	9	0	1580
12691	31	1	6	1543	0	1581
12692	11	1	1505	25	0	1542
12693	1458	1	23	10	0	1492
12694	24	1	1527	4	0	1556
12695	11	1550	17	4	0	1582
12696	7	20	9	1557	0	1593
12697	2	6	0	1603	0	1611
12698	1751	1	5	30	0	1787
12699	28	3	1757	6	0	1794
12700	11	1	24	1702	0	1738
12701	2	1726	5	20	0	1753
12702	4	1736	1	11	0	1752
12703	3	24	1	1739	0	1767
12704	7	6	1720	22	0	1755
12705	2	4	20	1723	0	1749
12706	4	3	6	1756	0	1769
12707	1	4	1719	30	0	1754
12708	1	1742	24	8	0	1775
12709	1726	21	9	9	0	1765
12710	22	1733	4	4	0	1763
12711	11	17	4	1753	0	1785
12712	1697	9	3	26	0	1735
12713	24	1673	4	18	0	1719
12714	6	28	1684	2	0	1720
12715	1655	7	22	7	0	1691
12716	23	1725	8	1	0	1757
12717	1691	23	2	11	0	1727
12718	27	7	1652	3	0	1689
12719	1639	5	23	4	0	1671
12720	25	4	9	1654	0	1692
12721	13	2	1648	23	0	1686
12722	2	5	24	1640	0	1671
12723	7	1609	7	23	0	1646
12724	2	23	5	1642	0	1672
12725	7	7	3	1645	0	1662
12726	3	4	1606	33	0	1646
12727	6	2	22	1598	0	1628
12728	3	6	1434	33	0	1476
12729	7	1594	16	7	0	1624
12730	5	24	9	1606	0	1644
12731	7	8	1603	27	0	1645
12732	3	1594	27	11	0	1635
12733	4	1663	5	9	0	1681
12734	9	29	1639	3	0	1680
12735	3	14	1647	2	0	1666
12736	6	2	32	1624	0	1664
12737	1603	4	9	28	0	1644
12738	26	1609	4	10	0	1649
12739	13	28	4	1563	0	1608
12740	1557	8	7	31	0	1603
12741	32	1589	4	11	0	1636
12742	1586	27	2	13	0	1628
12743	31	1614	6	9	0	1660
12744	1633	29	5	6	0	1673
12745	1641	12	2	7	0	1662
12746	1674	3	4	6	0	1687
12747	30	1713	3	14	0	1760
12748	17	27	6	1726	0	1776
12749	9	12	1686	30	0	1737
12750	10	1686	25	14	0	1735
12751	6	28	14	1615	0	1663
12752	12	11	3	1634	0	1660
12753	6	6	1598	31	0	1641
12754	4	1556	26	12	0	1598
12755	1546	26	11	12	0	1595
12756	26	1528	4	10	0	1568
12757	15	25	3	1527	0	1570
12758	6	10	1527	28	0	1571
12759	1504	3	29	13	0	1549
12760	27	12	7	1543	0	1589
12761	12	6	1521	32	0	1571
12762	1461	7	31	12	0	1511
12763	26	1495	11	8	0	1540
12764	1498	26	8	12	0	1544
12765	1510	14	5	10	0	1539
12766	36	2	6	1500	0	1544
12767	11	10	1492	27	0	1540
12768	12	1481	25	11	0	1529
12769	7	29	1451	3	0	1490
12770	4	15	27	1411	0	1457
12771	12	5	13	1446	0	1476
12772	1417	10	2	38	0	1467
12773	26	2	1425	15	0	1468
12774	12	1375	27	11	0	1425
12775	5	25	10	1379	0	1419
12776	10	12	6	1388	0	1416
12777	1355	6	6	31	0	1398
12778	28	1363	1	12	0	1404
12779	12	22	2	1328	0	1364
12780	1278	10	6	26	0	1320
12781	25	1258	1	9	0	1293
12782	1220	28	3	6	0	1257
12783	1217	6	7	9	0	1239
12784	32	1187	0	5	0	1224
12785	1045	19	2	1	0	1067
12786	14	1042	3	2	0	1061
12787	1048	11	5	4	0	1068
12788	1044	7	0	6	0	1057
12789	18	1017	2	6	0	1043
12790	958	15	4	1	0	978
12791	992	5	2	5	0	1004
12792	987	3	1	5	0	996
12793	17	4	968	4	0	993
12794	7	3	941	3	0	954
12795	4	2	944	2	0	952
12796	916	5	17	5	0	943
12797	13	2	904	5	0	924
12798	9	3	739	1	0	752
12799	5	4	14	684	0	707
12800	695	3	5	12	0	715
12801	10	0	695	8	0	713
12802	6	3	717	1	0	727
12803	3	2	15	717	0	737
12804	3	1	5	720	0	729
12805	0	1	2	726	0	729
12806	5	1	701	13	0	720
12807	3	5	10	701	0	719
12808	703	2	5	12	0	722
12809	12	700	2	9	0	723
12810	5	11	2	704	0	722
12811	4	4	2	717	0	727
12812	3	3	726	16	0	748
12813	2	709	11	8	0	730
12814	694	9	7	2	0	712
12815	11	711	2	2	0	726
12816	7	12	1	690	0	710
12817	5	6	693	11	0	715
12818	3	2	11	739	0	755
12819	2	1	8	762	0	773
12820	780	3	2	19	0	804
12821	14	1	3	757	0	775
12822	9	751	2	13	0	775
12823	2	788	1	8	0	799
12824	4	11	785	3	0	803
12825	780	7	12	4	0	803
12826	17	1	6	791	0	815
12827	8	2	4	797	0	811
12828	2	2	4	806	0	814
12829	801	0	3	22	0	826
12830	15	805	3	10	0	833
12831	803	16	2	7	0	828
12832	16	5	761	8	0	790
12833	9	3	747	4	0	763
12834	755	7	17	1	0	780
12835	17	3	12	751	0	783
12836	12	1	3	768	0	784
12837	3	3	5	780	0	791
12838	8	2	768	16	0	794
12839	774	3	11	13	0	801
12840	792	2	7	4	0	805
12841	756	3	1	8	0	768
12842	25	5	5	724	0	759
12843	11	2	717	12	0	742
12844	8	1	695	9	0	713
12845	7	2	710	4	0	723
12846	4	671	17	7	0	699
12847	5	9	16	595	0	625
12848	588	6	8	9	0	611
12849	10	1	581	9	0	601
12850	600	1	9	3	0	613
12851	9	2	9	603	0	623
12852	10	1	3	604	0	618
12853	2	584	5	14	0	605
12854	3	591	6	8	0	608
12855	1	610	5	5	0	621
12856	3	10	3	613	0	629
12857	607	6	2	13	0	628
12858	605	1	2	13	0	621
12859	14	2	602	3	0	621
12860	597	1	9	6	0	613
12861	9	1	604	5	0	619
12862	9	1	8	594	0	612
12863	1	2	599	11	0	613
12864	594	4	8	10	0	616
12865	11	2	9	601	0	623
12866	5	6	611	10	0	632
12867	2	2	600	11	0	615
12868	603	0	14	3	0	620
12869	604	2	6	5	0	617
12870	14	605	4	4	0	627
12871	8	8	2	619	0	637
12872	2	5	620	8	0	635
12873	4	3	599	8	0	614
12874	1	7	12	608	0	628
12875	600	0	9	9	0	618
12876	9	593	2	10	0	614
12877	6	7	3	606	0	622
12878	609	6	1	11	0	627
12879	10	0	3	617	0	630
12880	7	606	3	5	0	621
12881	4	7	3	618	0	632
12882	615	3	3	7	0	628
12883	7	0	3	615	0	625
12884	612	3	4	7	0	626
12885	7	630	2	7	0	646
12886	641	6	3	4	0	654
12887	10	2	620	5	0	637
12888	619	1	6	3	0	629
12889	628	1	6	3	0	638
12890	12	632	2	2	0	648
12891	7	10	5	611	0	633
12892	3	2	616	8	0	629
12893	4	4	601	4	0	613
12894	584	5	6	3	0	598
12895	575	1	4	3	0	583
12896	7	572	3	3	0	585
12897	1	576	5	4	0	586
12898	583	5	2	3	0	593
12899	7	564	1	3	0	575
12900	3	587	1	3	0	594
12901	2	7	1	600	0	610
12902	3	0	0	585	0	588
12903	1	4	597	5	0	607
12904	2	2	5	603	0	612
12905	606	1	1	7	0	615
12906	10	0	600	3	0	613
12907	5	0	606	1	0	612
12908	4	3	5	606	0	618
12909	5	0	3	619	0	627
12910	3	0	4	616	0	623
12911	1	2	620	5	0	628
12912	3	0	5	589	0	597
12913	3	1	2	618	0	624
12914	616	1	2	7	0	626
12915	5	606	1	3	0	615
12916	604	5	2	1	0	612
12917	6	0	621	1	0	628
12918	559	0	3	1	0	563
12919	3	576	0	0	0	579
12920	534	3	0	2	0	539
12921	2	535	1	1	0	539
12922	528	2	3	0	0	533
12923	2	523	0	0	0	525
12924	0	519	0	0	0	519
12925	5	1	2	530	0	538
12926	537	0	0	2	0	539
12927	536	0	0	0	0	536
12928	540	0	0	0	0	540
12929	2	0	528	0	0	530
12930	0	0	524	0	0	524
12931	0	0	1	541	0	542
12932	1	553	0	2	0	556
12933	0	568	0	0	0	568
12934	0	1	0	560	0	561
12935	558	0	0	2	0	560
12936	560	0	0	1	0	561
12937	561	0	0	0	0	561
12938	1	0	566	0	0	567
12939	1	0	1	565	0	567
12940	0	0	584	2	0	586
12941	592	0	2	0	0	594
12942	604	0	1	2	0	607
12943	2	0	611	0	0	613
12944	1	0	2	617	0	620
12945	626	1	0	4	0	631
12946	3	0	0	639	0	642
12947	0	0	0	641	0	641
12948	3	0	0	674	0	677
12949	713	0	0	4	0	717
12950	3	0	0	775	0	778
12951	799	0	1	9	0	809
12952	3	874	0	3	0	880
12953	2	4	1	918	0	925
12954	3	3	0	921	0	927
12955	4	1	0	915	0	920
12956	915	1	1	8	0	925
12957	6	0	0	913	0	919
12958	8	0	0	913	0	921
12959	920	0	0	10	0	930
12960	930	0	0	5	0	935
12961	926	0	1	3	0	930
12962	11	1	902	1	0	915
12963	5	0	889	2	0	896
12964	928	1	9	0	0	938
12965	7	1	4	918	0	930
12966	4	0	2	914	0	920
12967	933	1	2	8	0	944
12968	923	0	0	6	0	929
12969	930	1	0	2	0	933
12970	10	918	1	2	0	931
12971	913	5	1	4	0	923
12972	907	3	0	2	0	912
12973	11	886	1	1	0	899
12974	7	904	0	2	0	913
12975	4	6	3	919	0	932
12976	930	2	1	10	0	943
12977	936	2	1	5	0	944
12978	924	1	1	5	0	931
12979	12	0	1	929	0	942
12980	928	0	0	11	0	939
12981	11	0	919	4	0	934
12982	925	1	5	3	0	934
12983	10	1	927	2	0	940
12984	6	0	905	1	0	912
12985	3	1	9	886	0	899
12986	899	1	5	6	0	911
12987	6	0	2	911	0	919
12988	4	1	903	9	0	917
12989	5	3	907	6	0	921
12990	4	0	8	923	0	935
12991	923	0	3	7	0	933
12992	7	924	3	6	0	940
12993	9	4	0	942	0	955
12994	3	1	0	959	0	963
12995	3	2	954	10	0	969
12996	2	3	927	6	0	938
12997	4	0	9	957	0	970
12998	958	0	6	10	0	974
12999	9	0	949	5	0	963
13000	8	1	6	944	0	959
13001	6	0	4	950	0	960
13002	3	0	2	962	0	967
13003	928	1	3	11	0	943
13004	9	1	876	6	0	892
13005	6	930	5	4	0	945
13006	5	5	5	934	0	949
13007	2	6	929	9	0	946
13008	5	914	7	6	0	932
13009	3	934	5	4	0	946
13010	932	10	2	8	0	952
13011	7	924	4	2	0	937
13012	936	7	1	4	0	948
13013	10	5	918	2	0	935
13014	8	3	5	924	0	940
13015	924	2	5	9	0	940
13016	10	943	2	10	0	965
13017	7	6	939	4	0	956
13018	6	5	8	902	0	921
13019	4	931	5	7	0	947
13020	2	9	2	948	0	961
13021	937	6	3	16	0	962
13022	7	959	1	10	0	977
13023	955	8	0	4	0	967
13024	949	6	1	5	0	961
13025	18	2	952	1	0	973
13026	8	1001	11	2	0	1022
13027	5	11	5	1035	0	1056
13028	5	6	1078	10	0	1099
13029	4	2	1157	5	0	1168
13030	3	5	18	1200	0	1226
13031	1231	2	12	19	0	1264
13032	1237	0	7	9	0	1253
13033	28	1	2	1227	0	1258
13034	13	1	1229	24	0	1267
13035	8	1226	18	8	0	1260
13036	1254	20	7	8	0	1289
13037	1266	7	4	4	0	1281
13038	27	1243	2	5	0	1277
13039	1243	20	1	2	0	1266
13040	27	8	1207	2	0	1244
13041	1215	7	17	2	0	1241
13042	1203	3	7	5	0	1218
13043	27	1	1213	2	0	1243
13044	14	1	21	1191	0	1227
13045	8	1	1193	23	0	1225
13046	7	1167	22	8	0	1204
13047	4	1182	8	5	0	1199
13048	7	26	3	1109	0	1145
13049	3	8	1117	19	0	1147
13050	0	1038	19	5	0	1062
13051	0	1030	4	4	0	1038
13052	914	26	8	6	0	954
13053	936	5	0	0	0	941
13054	19	4	0	930	0	953
13055	8	0	0	936	0	944
13056	3	952	0	18	0	973
13057	944	14	0	8	0	966
13058	959	4	0	3	0	966
13059	17	947	1	0	0	965
13060	9	19	0	940	0	968
13061	1	3	944	15	0	963
13062	1	4	15	951	0	971
13063	934	1	6	20	0	961
13064	16	1	1	941	0	959
13065	4	1	1	973	0	979
13066	977	1	0	17	0	995
13067	15	2	0	970	0	987
13068	7	971	0	15	0	993
13069	4	14	1	986	0	1005
13070	1	2	0	997	0	1000
13071	2	4	0	985	0	991
13072	2	976	0	18	0	996
13073	2	13	1	978	0	994
13074	1	5	957	19	0	982
13075	2	5	14	956	0	977
13076	1	0	954	20	0	975
13077	1	949	15	7	0	972
13078	2	16	4	971	0	993
13079	5	4	3	970	0	982
13080	2	1	2	983	0	988
13081	2	1	2	977	0	982
13082	2	1	957	24	0	984
13083	1	948	16	9	0	974
13084	2	14	5	980	0	1001
13085	1	4	982	18	0	1005
13086	3	3	18	990	0	1014
13087	989	3	5	23	0	1020
13088	21	2	960	8	0	991
13089	955	0	17	5	0	977
13090	23	3	7	970	0	1003
13091	8	2	976	20	0	1006
13092	9	965	20	5	0	999
13093	5	18	5	961	0	989
13094	7	4	973	21	0	1005
13095	2	972	21	7	0	1002
13096	5	18	6	964	0	993
13097	966	4	7	22	0	999
13098	991	5	5	4	0	1005
13099	1005	3	1	8	0	1017
13100	26	2	991	4	0	1023
13101	7	995	22	4	0	1028
13102	5	23	6	1003	0	1037
13103	3	6	3	1076	0	1088
13104	1079	5	4	24	0	1112
13105	24	1100	2	10	0	1136
13106	1115	24	3	7	0	1149
13107	1114	6	2	4	0	1126
13108	1140	8	0	3	0	1151
13109	34	2	1101	5	0	1142
13110	1125	1	25	6	0	1157
13111	29	5	4	1127	0	1165
13112	9	3	5	1147	0	1164
13113	1124	3	1	28	0	1156
13114	28	3	1	1113	0	1145
13115	8	1097	2	32	0	1139
13116	5	24	3	1080	0	1112
13117	1062	5	0	38	0	1105
13118	27	4	1044	7	0	1082
13119	10	1044	21	10	0	1085
13120	8	22	4	1047	0	1081
13121	1037	6	6	26	0	1075
13122	25	6	1027	9	0	1067
13123	7	14	24	1012	0	1057
13124	10	0	1009	24	0	1043
13125	7	4	1001	6	0	1018
13126	0	0	948	12	0	960
13127	6	1	935	4	0	946
13128	4	0	889	5	0	898
13129	732	9	31	4	0	776
13130	12	732	2	1	0	747
13131	703	9	3	2	0	717
13132	712	0	1	2	0	715
13133	9	704	3	1	0	717
13134	4	709	1	2	0	716
13135	705	12	0	4	0	721
13136	703	5	1	1	0	710
13137	10	2	3	685	0	700
13138	5	701	2	8	0	716
13139	709	7	4	5	0	725
13140	9	709	4	1	0	723
13141	4	11	3	705	0	723
13142	714	1	3	11	0	729
13143	717	2	3	2	0	724
13144	10	2	0	712	0	724
13145	6	4	0	722	0	732
13146	6	0	705	10	0	721
13147	5	1	8	707	0	721
13148	1	4	703	10	0	718
13149	1	3	9	685	0	698
13150	5	1	1	704	0	711
13151	697	0	1	10	0	708
13152	695	1	1	4	0	701
13153	10	1	673	3	0	687
13154	671	2	7	1	0	681
13155	11	1	2	677	0	691
13156	2	3	677	8	0	690
13157	5	0	9	671	0	685
13158	2	0	3	716	0	721
13159	1	0	716	11	0	728
13160	0	1	9	742	0	752
13161	2	0	756	10	0	768
13162	3	3	9	774	0	789
13163	841	1	3	17	0	862
13164	13	855	2	3	0	873
13165	864	9	0	8	0	881
13166	19	865	2	1	0	887
13167	853	16	1	4	0	874
13168	16	859	1	1	0	877
13169	853	14	0	4	0	871
13170	19	849	1	1	0	870
13171	5	14	1	857	0	877
13172	4	3	855	16	0	878
13173	6	4	859	4	0	873
13174	3	3	16	854	0	876
13175	855	1	9	14	0	879
13176	15	856	5	6	0	882
13177	6	12	2	863	0	883
13178	7	4	862	13	0	886
13179	3	5	866	5	0	879
13180	4	6	11	835	0	856
13181	6	861	5	13	0	885
13182	861	15	5	4	0	885
13183	16	4	869	5	0	894
13184	6	6	874	2	0	888
13185	8	874	14	1	0	897
13186	855	13	8	6	0	882
13187	864	6	8	2	0	880
13188	15	4	5	857	0	881
13189	871	1	2	13	0	887
13190	864	3	5	4	0	876
13191	10	852	5	5	0	872
13192	848	9	4	4	0	865
13193	14	4	867	1	0	886
13194	6	5	14	845	0	870
13195	7	4	4	849	0	864
13196	845	3	6	12	0	866
13197	12	843	4	6	0	865
13198	842	11	3	4	0	860
13199	14	852	2	1	0	869
13200	8	854	0	2	0	864
13201	7	11	829	3	0	850
13202	6	10	799	5	0	820
13203	750	8	15	3	0	776
13204	751	8	5	1	0	765
13205	10	2	722	1	0	735
13206	5	700	6	2	0	713
13207	4	715	4	2	0	725
13208	702	7	2	0	0	711
13209	701	5	0	0	0	706
13210	10	2	0	706	0	718
13211	709	1	3	6	0	719
13212	8	2	2	705	0	717
13213	3	0	709	9	0	721
13214	4	1	697	2	0	704
13215	724	1	8	3	0	736
13216	7	2	3	720	0	732
13217	4	760	2	6	0	772
13218	773	7	0	3	0	783
13219	774	3	3	4	0	784
13220	7	3	771	1	0	782
13221	789	0	7	2	0	798
13222	794	2	2	3	0	801
13223	10	3	3	786	0	802
13224	6	785	4	6	0	801
13225	4	818	3	2	0	827
13226	2	10	2	831	0	845
13227	7	4	0	815	0	826
13228	5	2	1	822	0	830
13229	4	0	812	12	0	828
13230	2	2	802	6	0	812
13231	4	1	9	803	0	817
13232	3	2	808	8	0	821
13233	4	1	802	5	0	812
13234	3	3	9	802	0	817
13235	3	1	848	9	0	861
13236	1	853	10	6	0	870
13237	892	7	3	7	0	909
13238	12	5	5	863	0	885
13239	5	875	4	14	0	898
13240	4	11	907	4	0	926
13241	3	7	12	915	0	937
13242	4	3	949	13	0	969
13243	3	2	18	949	0	972
13244	2	4	3	995	0	1004
13245	4	1	1013	20	0	1038
13246	4	1	18	1003	0	1026
13247	2	1009	10	19	0	1040
13248	1	19	5	1038	0	1063
13249	3	5	1039	20	0	1067
13250	4	0	19	1042	0	1065
13251	1028	3	5	21	0	1057
13252	17	1039	5	6	0	1067
13253	7	16	3	1049	0	1075
13254	2	6	1078	20	0	1106
13255	2	1051	19	8	0	1080
13256	7	1070	6	5	0	1088
13257	4	23	1051	3	0	1081
13258	4	8	18	1018	0	1048
13259	2	10	8	1014	0	1034
13260	5	4	997	21	0	1027
13261	2	970	22	10	0	1004
13262	1	982	8	5	0	996
13263	890	16	4	3	0	913
13264	12	910	0	3	0	925
13265	905	12	3	3	0	923
13266	14	5	2	885	0	906
13267	934	3	0	16	0	953
13268	13	1	928	4	0	946
13269	939	2	12	3	0	956
13270	14	1	3	953	0	971
13271	3	958	0	14	0	975
13272	968	12	2	5	0	987
13273	14	4	2	964	0	984
13274	7	968	0	14	0	989
13275	1	1026	1	6	0	1034
13276	1024	19	1	3	0	1047
13277	1036	4	3	1	0	1044
13278	1051	0	0	8	0	1059
13279	18	2	2	1016	0	1038
13280	3	1010	2	13	0	1028
13281	5	1032	0	4	0	1041
13282	3	17	2	1032	0	1054
13283	1023	6	1	17	0	1047
13284	1006	3	0	9	0	1018
13285	1022	4	4	3	0	1033
13286	15	9	1025	2	0	1051
13287	9	1	1031	3	0	1044
13288	1087	0	15	7	0	1109
13289	18	5	4	1083	0	1110
13290	6	2	5	1102	0	1115
13291	4	1	2	1104	0	1111
13292	2	3	7	1103	0	1115
13293	6	2	1056	19	0	1083
13294	5	2	13	1064	0	1084
13295	3	0	1060	17	0	1080
13296	1024	2	16	8	0	1050
13297	17	1068	5	3	0	1093
13298	7	13	5	1093	0	1118
13299	2	5	5	1073	0	1085
13300	1053	0	3	29	0	1085
13301	1063	0	1	12	0	1076
13302	1067	8	3	3	0	1081
13303	1067	4	2	9	0	1082
13304	20	2	1058	7	0	1087
13305	8	6	1037	2	0	1053
13306	6	6	16	1053	0	1081
13307	1059	3	8	17	0	1087
13308	1065	1	1	10	0	1077
13309	18	5	1054	5	0	1082
13310	8	1	17	1043	0	1069
13311	1047	4	4	19	0	1074
13312	19	5	2	1048	0	1074
13313	13	2	1055	18	0	1088
13314	5	4	19	1051	0	1079
13315	1044	1	7	18	0	1070
13316	17	1104	3	11	0	1135
13317	1090	11	5	7	0	1113
13318	1097	4	9	5	0	1115
13319	1104	3	1	8	0	1116
13320	20	1	1	1097	0	1119
13321	1072	9	3	17	0	1101
13322	19	1126	2	8	0	1155
13323	9	1172	4	6	0	1191
13324	6	22	2	1181	0	1211
13325	1175	8	1	22	0	1206
13326	24	1229	3	6	0	1262
13327	1486	18	1	6	0	1511
13328	1606	8	1	7	0	1622
13329	33	1631	1	8	0	1673
13330	15	29	0	1658	0	1702
13331	13	14	0	1694	0	1721
13332	8	7	1676	37	0	1728
13333	10	4	28	1672	0	1714
13334	7	4	1687	33	0	1731
13335	8	1644	31	7	0	1690
13336	8	43	7	1647	0	1705
13337	1615	3	4	34	0	1656
13338	1659	4	1	12	0	1676
13339	32	6	7	1628	0	1673
13340	7	4	1599	33	0	1643
13341	1537	3	27	12	0	1579
13342	26	1548	3	9	0	1586
13343	7	1538	3	8	0	1556
13344	7	1543	6	2	0	1558
13345	13	25	5	1495	0	1538
13346	6	4	1531	26	0	1567
13347	6	4	23	1522	0	1555
13348	9	4	1540	22	0	1575
13349	3	8	1524	4	0	1539
13350	4	6	1556	3	0	1569
13351	4	5	21	1524	0	1554
13352	4	1	6	1568	0	1579
13353	3	3	7	1567	0	1580
13354	4	6	3	1535	0	1548
13355	1526	2	8	27	0	1563
13356	18	1519	7	6	0	1550
13357	1521	20	5	8	0	1554
13358	21	1537	5	11	0	1574
13359	4	20	3	1563	0	1590
13360	3	4	4	1587	0	1598
13361	1574	3	2	34	0	1613
13362	1600	1	3	11	0	1615
13363	1610	8	1	6	0	1625
13364	1598	2	1	8	0	1609
13365	1574	5	2	8	0	1589
13366	26	1573	0	9	0	1608
13367	1524	20	0	9	0	1553
13368	28	1518	1	0	0	1547
13369	1518	19	0	6	0	1543
13370	27	5	1522	4	0	1558
13371	9	4	18	1542	0	1573
13372	10	1549	2	20	0	1581
13373	7	27	2	1548	0	1584
13374	13	7	1548	19	0	1587
13375	8	7	21	1488	0	1524
13376	1502	4	4	27	0	1537
13377	20	1506	9	9	0	1544
13378	4	1519	3	16	0	1542
13379	3	24	1552	5	0	1584
13380	2	8	22	1548	0	1580
13381	5	1579	10	25	0	1619
13382	5	21	7	1622	0	1655
13383	9	7	1632	26	0	1674
13384	2	1623	23	10	0	1658
13385	6	24	1610	8	0	1648
13386	7	5	1588	7	0	1607
13387	5	3	24	1576	0	1608
13388	1580	9	8	19	0	1616
13389	20	7	4	1584	0	1615
13390	4	8	1610	22	0	1644
13391	6	9	24	1607	0	1646
13392	3	4	1703	26	0	1736
13393	5	5	1727	7	0	1744
13394	1738	3	27	16	0	1784
13395	1821	0	10	8	0	1839
13396	1832	3	10	12	0	1857
13397	22	2	1808	7	0	1839
13398	5	1	1808	10	0	1824
13399	5	2	28	1795	0	1830
13400	5	2	13	1822	0	1842
13401	1827	2	1	32	0	1862
13402	31	3	5	1821	0	1860
13403	12	7	1847	24	0	1890
13404	5	7	1814	8	0	1834
13405	5	1827	29	9	0	1870
13406	9	22	4	1869	0	1904
13407	10	4	1875	30	0	1919
13408	19	5	21	1863	0	1908
13409	1856	2	10	31	0	1899
13410	23	3	1904	9	0	1939
13411	9	5	24	1888	0	1926
13412	12	6	6	1913	0	1937
13413	7	6	1885	29	0	1927
13414	10	4	21	1847	0	1882
13415	6	3	1879	25	0	1913
13416	1765	4	29	12	0	1810
13417	23	5	12	1779	0	1819
13418	5	1798	6	30	0	1839
13419	1797	20	6	18	0	1841
13420	1794	5	15	15	0	1829
13421	28	1793	2	12	0	1835
13422	26	102	16	1600	0	1744
13423	8	1674	2	17	0	1701
13424	6	1672	4	13	0	1695
13425	20	27	1591	5	0	1643
13426	13	1561	15	5	0	1594
13427	10	6	1287	5	0	1308
13428	1123	8	3	1	0	1135
13429	1118	2	2	5	0	1127
13430	2	1141	1	0	0	1144
13431	4	1148	0	0	0	1152
13432	2	1180	3	0	0	1185
13433	1205	5	1	1	0	1212
13434	3	3	1	1242	0	1249
13435	3	4	1321	3	0	1331
13436	3	1326	8	2	0	1339
13437	0	9	3	1335	0	1347
13438	1	3	1	1336	0	1341
13439	0	1497	1	9	0	1507
13440	1600	13	1	3	0	1617
13441	17	4	1614	2	0	1637
13442	6	2	17	1954	0	1979
13443	2	2078	5	32	0	2117
13444	2078	28	1	7	0	2114
13445	31	7	2063	3	0	2104
13446	9	2013	28	6	0	2056
13447	9	23	8	2030	0	2070
13448	0	10	2019	27	0	2056
13449	1977	6	27	10	0	2020
13450	30	2	9	2002	0	2043
13451	10	2	2004	25	0	2041
13452	6	2008	28	8	0	2050
13453	1951	30	7	14	0	2002
13454	28	2000	3	5	0	2036
13455	1997	32	2	7	0	2038
13456	2021	7	2	10	0	2040
13457	41	7	4	1972	0	2024
13458	13	1931	1	28	0	1973
13459	9	28	1944	8	0	1989
13460	7	5	29	1945	0	1986
13461	25	7	8	1687	0	1727
13462	10	0	6	1941	0	1957
13463	8	3	4	1953	0	1968
13464	4	4	1	1955	0	1964
13465	1920	2	3	47	0	1972
13466	1883	2	4	19	0	1908
13467	1885	2	1	19	0	1907
13468	38	1860	2	6	0	1906
13469	14	30	1884	9	0	1937
13470	7	10	1881	6	0	1904
13471	6	11	1874	4	0	1895
13472	8	3	43	1831	0	1885
13473	10	4	17	1864	0	1895
13474	5	8	6	1869	0	1888
13475	1	3	1832	46	0	1882
13476	4	1798	39	15	0	1856
13477	7	33	1797	8	0	1845
13478	6	9	1821	8	0	1844
13479	13	11	39	1743	0	1806
13480	5	8	1770	33	0	1816
13481	9	3	44	1730	0	1786
13482	1702	7	14	42	0	1765
13483	1692	5	9	19	0	1725
13484	42	2	1659	16	0	1719
13485	16	5	35	1658	0	1714
13486	11	7	1665	39	0	1722
13487	7	1670	42	15	0	1734
13488	1674	34	8	15	0	1731
13489	40	13	1666	5	0	1724
13490	14	1610	37	9	0	1670
13491	9	1616	15	8	0	1648
13492	8	1575	13	8	0	1604
13493	7	46	1472	8	0	1533
13494	8	27	32	1411	0	1478
13495	8	1426	9	38	0	1481
13496	7	33	11	1435	0	1486
13497	10	12	10	1454	0	1486
13498	1393	14	7	46	0	1460
13499	36	1398	10	22	0	1466
13500	1381	39	11	14	0	1445
13501	43	1365	8	10	0	1426
13502	10	1402	9	12	0	1433
13503	11	38	1347	9	0	1405
13504	11	21	40	1337	0	1409
13505	10	10	1337	39	0	1396
13506	5	1316	42	19	0	1382
13507	7	33	1324	15	0	1379
13508	5	13	1334	7	0	1359
13509	6	1311	43	15	0	1375
13510	1257	39	17	10	0	1323
13511	41	1267	16	10	0	1334
13512	1275	44	8	14	0	1341
13513	45	17	1270	12	0	1344
13514	11	10	1293	11	0	1325
13515	10	1267	45	14	0	1336
13516	1261	35	19	12	0	1327
13517	38	1254	16	19	0	1327
13518	17	38	10	1268	0	1333
13519	1267	14	8	43	0	1332
13520	38	15	1258	10	0	1321
13521	14	10	36	1260	0	1320
13522	1260	9	10	38	0	1317
13523	39	1256	14	6	0	1315
13524	12	39	8	1255	0	1314
13525	11	13	1240	39	0	1303
13526	1239	12	44	17	0	1312
13527	38	9	15	1251	0	1313
13528	12	9	1231	42	0	1294
13529	8	7	39	1226	0	1280
13530	7	1216	15	45	0	1283
13531	7	36	1207	18	0	1268
13532	11	10	38	1152	0	1211
13533	1128	8	12	40	0	1188
13534	45	6	11	1079	0	1141
13535	989	7	7	32	0	1035
13536	29	989	13	9	0	1040
13537	986	26	13	9	0	1034
13538	30	7	965	4	0	1006
13539	7	10	799	4	0	820
13540	9	4	682	5	0	700
13541	1	634	37	5	0	677
13542	18	9	37	174	0	238
13543	0	0	0	176	0	176
13544	0	0	0	176	0	176
13545	1	0	0	179	0	180
13546	0	0	180	4	0	184
13547	174	0	4	0	0	178
13548	4	181	0	0	0	185
13549	191	3	0	0	0	194
13550	4	0	0	187	0	191
13551	0	192	0	4	0	196
13552	1	3	0	195	0	199
13553	196	0	0	3	0	199
13554	3	201	0	0	0	204
13555	204	3	0	0	0	207
13556	202	0	0	0	0	202
13557	3	0	0	201	0	204
13558	0	0	205	3	0	208
13559	196	2	2	0	0	200
13560	3	0	0	204	0	207
13561	205	0	0	4	0	209
13562	212	0	0	0	0	212
13563	211	0	0	0	0	211
13564	4	0	206	0	0	210
13565	0	0	2	202	0	204
13566	205	0	0	2	0	207
13567	2	0	213	0	0	215
13568	0	209	1	0	0	210
13569	0	1	0	200	0	201
13570	1	0	209	1	0	211
13571	1	3	194	0	0	198
13572	0	0	2	193	0	195
13573	0	0	0	197	0	197
13574	1	0	0	196	0	197
13575	0	0	1	194	0	195
13576	0	1	195	1	0	197
13577	0	198	2	1	0	201
13578	0	1	1	211	0	213
13579	207	0	1	1	0	209
13580	202	0	0	1	0	203
13581	208	0	0	1	0	209
13582	1	0	0	208	0	209
13583	0	1	0	208	0	209
13584	0	202	1	1	0	204
13585	0	212	0	0	0	212
13586	0	1	0	207	0	208
13587	204	0	0	1	0	205
13588	210	0	0	0	0	210
13589	208	0	0	0	0	208
13590	205	0	0	1	0	206
13591	207	0	0	1	0	208
13592	1	215	0	0	0	216
13593	0	2	0	221	0	223
13594	230	0	0	2	0	232
13595	236	0	0	1	0	237
13596	2	0	0	235	0	237
13597	1	0	0	236	0	237
13598	1	0	249	1	0	251
13599	1	0	1	246	0	248
13600	0	1	0	251	0	252
13601	1	0	268	2	0	271
13602	1	0	0	255	0	256
13603	1	274	0	1	0	276
13604	0	3	276	1	0	280
13605	0	282	1	1	0	284
13606	0	1	1	280	0	282
13607	0	0	0	286	0	286
13608	0	282	0	1	0	283
13609	0	292	1	0	0	293
13610	293	1	0	1	0	295
13611	299	1	0	0	0	300
13612	1	0	291	0	0	292
13613	308	1	1	1	0	311
13614	319	0	0	2	0	321
13615	314	0	0	2	0	316
13616	316	1	1	0	0	318
13617	1	1	307	0	0	309
13618	1	0	312	0	0	313
13619	335	0	1	0	0	336
13620	1	348	1	0	0	350
13621	1	1	349	0	0	351
13622	359	0	1	0	0	360
13623	362	0	0	0	0	362
13624	2	0	359	0	0	361
13625	359	0	2	1	0	362
13626	2	0	1	395	0	398
13627	3	0	423	1	0	427
13628	405	2	1	0	0	408
13629	1	439	2	2	0	444
13630	457	1	1	2	0	461
13631	534	0	1	3	0	538
13632	2	0	1	542	0	545
13633	2	0	0	538	0	540
13634	0	0	1	553	0	554
13635	549	0	2	3	0	554
13636	591	0	1	0	0	592
13637	4	2	0	586	0	592
13638	3	0	1	586	0	590
13639	3	2	579	6	0	590
13640	567	0	5	2	0	574
13641	6	2	2	601	0	611
13642	2	0	0	608	0	610
13643	1	601	0	7	0	609
13644	1	5	1	606	0	613
13645	1	2	0	605	0	608
13646	596	2	0	8	0	606
13647	7	601	2	2	0	612
13648	4	4	0	614	0	622
13649	3	1	0	601	0	605
13650	1	1	0	612	0	614
13651	1	1	596	8	0	606
13652	1	1	5	591	0	598
13653	596	0	1	9	0	606
13654	7	1	600	2	0	610
13655	3	1	5	616	0	625
13656	4	0	2	629	0	635
13657	635	0	1	8	0	644
13658	620	0	1	5	0	626
13659	6	1	632	2	0	641
13660	600	1	4	4	0	609
13661	7	1	636	2	0	646
13662	671	0	6	4	0	681
13663	7	699	2	0	0	708
13664	722	6	2	1	0	731
13665	7	730	0	2	0	739
13666	759	6	0	5	0	770
13667	7	777	0	2	0	786
13668	4	6	2	788	0	800
13669	4	3	0	794	0	801
13670	2	1	0	798	0	801
13671	1	785	2	11	0	799
13672	2	7	0	793	0	802
13673	2	796	0	8	0	806
13674	3	6	0	810	0	819
13675	809	3	1	8	0	821
13676	807	2	3	6	0	818
13677	10	801	2	3	0	816
13678	7	5	1	805	0	818
13679	804	4	1	8	0	817
13680	5	808	2	4	0	819
13681	5	825	2	5	0	837
13682	827	10	0	3	0	840
13683	841	5	1	1	0	848
13684	9	834	0	2	0	845
13685	841	7	0	6	0	854
13686	9	4	1	847	0	861
13687	7	3	874	7	0	891
13688	876	3	8	8	0	895
13689	892	1	3	7	0	903
13690	10	5	900	1	0	916
13691	917	0	11	2	0	930
13692	926	1	5	2	0	934
13693	949	1	1	5	0	956
13694	16	930	1	2	0	949
13695	953	7	0	4	0	964
13696	960	6	0	3	0	969
13697	13	6	0	957	0	976
13698	10	3	1	962	0	976
13699	7	0	0	978	0	985
13700	975	3	0	16	0	994
13701	13	1	0	968	0	982
13702	978	2	0	13	0	993
13703	986	0	1	11	0	998
13704	16	2	1	974	0	993
13705	11	1	0	1009	0	1021
13706	10	2	1	1013	0	1026
13707	1025	0	0	18	0	1043
13708	13	1010	1	9	0	1033
13709	7	10	0	1042	0	1059
13710	6	6	0	1059	0	1071
13711	1052	6	0	17	0	1075
13712	1061	1	1	11	0	1074
13713	14	2	1031	7	0	1054
13714	10	2	1038	4	0	1054
13715	1136	1	12	3	0	1152
13716	20	0	9	1159	0	1188
13717	5	2	5	1355	0	1367
13718	4	1	1334	25	0	1364
13719	6	5	19	1333	0	1363
13720	5	1327	6	21	0	1359
13721	3	1364	4	5	0	1376
13722	1335	21	5	6	0	1367
13723	19	11	1324	3	0	1357
13724	4	1363	16	3	0	1386
13725	13	22	4	1370	0	1409
13726	5	6	1355	21	0	1387
13727	3	5	20	1309	0	1337
13728	7	3	4	1345	0	1359
13729	3	0	1331	26	0	1360
13730	1	1319	21	12	0	1353
13731	8	18	6	1258	0	1290
13732	1267	6	4	23	0	1300
13733	1268	6	3	10	0	1287
13734	1276	2	2	6	0	1286
13735	29	1249	1	7	0	1286
13736	1233	17	1	2	0	1253
13737	24	5	1	1218	0	1248
13738	8	5	1209	14	0	1236
13739	1205	3	18	5	0	1231
13740	21	1225	5	5	0	1256
13741	7	15	6	1222	0	1250
13742	4	4	3	1224	0	1235
13743	3	1205	1	22	0	1231
13744	4	17	1	1232	0	1254
13745	4	6	1	1247	0	1258
13746	4	4	5	1255	0	1268
13747	1239	3	3	23	0	1268
13748	1237	1	0	13	0	1251
13749	18	2	1240	10	0	1270
13750	11	2	15	1250	0	1278
13751	10	0	5	1274	0	1289
13752	2	2	4	1280	0	1288
13753	1259	3	4	27	0	1293
13754	15	4	1231	16	0	1266
13755	1210	3	17	9	0	1239
13756	1251	3	5	7	0	1266
13757	27	1	2	1254	0	1284
13758	1270	1	5	15	0	1291
13759	22	2	1228	6	0	1258
13760	1233	1	13	11	0	1258
13761	18	1357	6	7	0	1388
13762	9	14	1327	4	0	1354
13763	6	9	1341	5	0	1361
13764	6	11	18	1315	0	1350
13765	4	4	1336	15	0	1359
13766	1297	1	19	10	0	1327
13767	16	1291	6	6	0	1319
13768	1305	14	4	9	0	1332
13769	18	5	3	1319	0	1345
13770	8	4	1322	17	0	1351
13771	7	3	1315	7	0	1332
13772	9	4	15	1328	0	1356
13773	1355	1	11	16	0	1383
13774	13	1323	6	6	0	1348
13775	3	1365	2	8	0	1378
13776	1369	13	0	11	0	1393
13777	16	1373	0	6	0	1395
13778	1378	17	2	5	0	1402
13779	19	3	2	1378	0	1402
13780	1365	3	1	15	0	1384
13781	21	2	2	1367	0	1392
13782	1386	0	2	18	0	1406
13783	18	1	3	1365	0	1387
13784	8	1356	1	17	0	1382
13785	1371	12	1	11	0	1395
13786	15	1367	4	8	0	1394
13787	5	13	1332	4	0	1354
13788	6	3	15	1307	0	1331
13789	6	1360	6	11	0	1383
13790	1333	17	1	3	0	1354
13791	1318	4	6	3	0	1331
13792	18	1319	3	5	0	1345
13793	4	14	1315	3	0	1336
13794	6	3	15	1313	0	1337
13795	3	1292	8	13	0	1316
13796	1	15	4	1336	0	1356
13797	4	2	7	1331	0	1344
13798	1310	1	3	20	0	1334
13799	11	1313	2	4	0	1330
13800	7	13	3	1319	0	1342
13801	1331	5	0	17	0	1353
13802	1327	2	2	3	0	1334
13803	1320	3	2	3	0	1328
13804	15	2	1	1316	0	1334
13805	1286	0	1	13	0	1300
13806	16	1279	2	4	0	1301
13807	1271	9	1	5	0	1286
13808	11	1290	0	3	0	1304
13809	1292	10	2	3	0	1307
13810	1279	7	0	3	0	1289
13811	17	5	1	1269	0	1292
13812	4	5	1277	10	0	1296
13813	5	1	1252	6	0	1264
13814	6	1267	9	2	0	1284
13815	1206	7	4	6	0	1223
13816	8	3	1177	2	0	1190
13817	953	0	2	4	0	959
13818	2	961	1	0	0	964
13819	4	969	0	0	0	973
13820	1	3	1	1025	0	1030
13821	1	1063	0	4	0	1068
13822	0	7	1087	1	0	1095
13823	2	1	5	1071	0	1079
13824	1	1133	1	5	0	1140
13825	1	5	0	1141	0	1147
13826	1147	1	1	10	0	1159
13827	7	0	0	1169	0	1176
13828	1	2	1171	6	0	1180
13829	1	1163	10	3	0	1177
13830	3	9	2	1175	0	1189
13831	1	2	0	1184	0	1187
13832	1	0	1	1192	0	1194
13833	1170	1	0	13	0	1184
13834	1162	1	0	7	0	1170
13835	10	1	1168	1	0	1180
13836	2	0	1160	5	0	1167
13837	1	1175	11	0	0	1187
13838	1200	10	1	2	0	1213
13839	10	3	1	1204	0	1218
13840	3	1	1	1201	0	1206
13841	2	1	0	1204	0	1207
13842	2	0	0	1205	0	1207
13843	1	1	1174	11	0	1187
13844	1145	0	11	5	0	1161
13845	9	1	3	1299	0	1312
13846	2	0	1295	22	0	1319
13847	1310	0	20	10	0	1340
13848	1446	0	7	4	0	1457
13849	29	2	1621	2	0	1654
13850	9	0	1661	4	0	1674
13851	8	0	43	1634	0	1685
13852	1653	1	7	39	0	1700
13853	1682	1	4	9	0	1696
13854	43	0	4	1644	0	1691
13855	15	0	6	1683	0	1704
13856	3	0	1658	42	0	1703
13857	5	4	34	1629	0	1672
13858	6	0	1619	41	0	1666
13859	1573	0	32	12	0	1617
13860	36	1624	10	15	0	1685
13861	1523	32	6	10	0	1571
13862	35	1512	3	6	0	1556
13863	1495	35	9	4	0	1543
13864	39	8	3	1460	0	1510
13865	10	4	3	1486	0	1503
13866	1468	3	4	45	0	1520
13867	1489	4	1	14	0	1508
13868	1493	2	2	4	0	1501
13869	1499	3	2	9	0	1513
13870	48	2	1438	6	0	1494
13871	1436	2	32	10	0	1480
13872	1465	2	6	5	0	1478
13873	1473	0	3	5	0	1481
13874	50	0	2	1419	0	1471
13875	1382	3	2	40	0	1427
13876	41	1380	6	9	0	1436
13877	17	35	3	1399	0	1454
13878	15	8	4	1420	0	1447
13879	13	6	1375	43	0	1437
13880	9	4	31	1368	0	1412
13881	9	1365	8	38	0	1420
13882	1352	35	3	14	0	1404
13883	40	1364	1	12	0	1417
13884	1370	35	4	8	0	1417
13885	47	7	3	1369	0	1426
13886	1333	7	5	43	0	1388
13887	43	1315	5	12	0	1375
13888	1323	38	2	6	0	1369
13889	1347	9	3	3	0	1362
13890	47	7	3	1306	0	1363
13891	21	3	0	1343	0	1367
13892	13	4	1288	46	0	1351
13893	15	4	34	1286	0	1339
13894	11	3	10	1310	0	1334
13895	14	1	1252	49	0	1316
13896	7	4	37	1270	0	1318
13897	6	2	1258	45	0	1311
13898	1240	4	37	16	0	1297
13899	45	2	11	1246	0	1304
13900	11	3	1216	45	0	1275
13901	1204	4	37	18	0	1263
13902	45	2	11	1220	0	1278
13903	16	3	1215	43	0	1277
13904	1219	1	37	12	0	1269
13905	43	2	10	1222	0	1277
13906	17	1	6	1251	0	1275
13907	1223	3	6	48	0	1280
13908	42	1	4	1202	0	1249
13909	15	2	6	1224	0	1247
13910	10	1	4	1201	0	1216
13911	5	1169	1	54	0	1229
13912	1137	35	7	17	0	1196
13913	1166	9	3	14	0	1192
13914	49	3	2	1126	0	1180
13915	1120	1	6	41	0	1168
13916	1139	4	2	18	0	1163
13917	1147	3	4	10	0	1164
13918	977	6	6	10	0	999
13919	1117	2	3	10	0	1132
13920	47	1	1009	9	0	1066
13921	17	3	977	8	0	1005
13922	953	3	35	9	0	1000
13923	40	932	14	7	0	993
13924	21	27	7	891	0	946
13925	11	7	892	37	0	947
13926	6	4	899	13	0	922
13927	6	9	35	868	0	918
13928	857	8	13	36	0	914
13929	35	3	4	841	0	883
13930	11	2	830	37	0	880
13931	850	0	32	16	0	898
13932	34	1	11	853	0	899
13933	17	2	4	876	0	899
13934	13	0	1	887	0	901
13935	8	0	5	872	0	885
13936	6	0	835	42	0	883
13937	7	1	29	836	0	873
13938	829	0	8	38	0	875
13939	33	1	808	16	0	858
13940	823	3	30	12	0	868
13941	853	1	5	9	0	868
13942	854	0	6	8	0	868
13943	847	0	8	6	0	861
13944	44	799	3	7	0	853
13945	15	686	0	3	0	704
13946	7	715	4	7	0	733
13947	598	49	33	18	0	698
13948	22	7	544	7	0	580
13949	330	2	10	4	0	346
13950	8	1	2	307	0	318
13951	305	0	0	5	0	310
13952	1	1	1	308	0	311
13953	310	0	2	2	0	314
13954	2	0	0	307	0	309
13955	5	0	0	309	0	314
13956	291	1	1	4	0	297
13957	4	337	0	3	0	344
13958	4	1	338	0	0	343
13959	2	333	2	2	0	339
13960	2	2	301	1	0	306
13961	1	2	4	288	0	295
13962	288	0	4	4	0	296
13963	4	0	0	283	0	287
13964	285	0	1	3	0	289
13965	3	308	1	2	0	314
13966	1	3	334	0	0	338
13967	1	324	2	2	0	329
13968	0	325	0	2	0	327
13969	298	2	1	3	0	304
13970	292	1	1	2	0	296
13971	2	298	1	0	0	301
13972	2	1	0	305	0	308
13973	3	0	0	295	0	298
13974	296	0	1	5	0	302
13975	3	0	298	1	0	302
13976	3	1	288	1	0	293
13977	1	0	2	301	0	304
13978	2	0	298	2	0	302
13979	299	2	1	3	0	305
13980	304	1	2	1	0	308
13981	2	302	0	0	0	304
13982	2	1	315	1	0	319
13983	1	0	2	326	0	329
13984	2	0	339	1	0	342
13985	1	0	1	336	0	338
13986	343	0	0	1	0	344
13987	2	348	0	2	0	352
13988	2	1	374	0	0	377
13989	0	382	1	1	0	384
13990	0	390	0	1	0	391
13991	400	2	0	1	0	403
13992	390	2	0	0	0	392
13993	2	1	405	0	0	408
13994	2	420	1	1	0	424
13995	0	1	2	422	0	425
13996	3	1	0	421	0	425
13997	1	0	1	423	0	425
13998	1	0	436	3	0	440
13999	1	0	1	432	0	434
14000	0	1	2	455	0	458
14001	471	0	1	4	0	476
14002	469	2	0	3	0	474
14003	471	2	1	0	0	474
14004	467	1	2	0	0	470
14005	463	0	1	1	0	465
14006	1	460	1	1	0	463
14007	451	0	0	3	0	454
14008	1	1	450	2	0	454
14009	6	0	0	450	0	456
14010	460	0	0	2	0	462
14011	1	469	1	1	0	472
14012	473	2	0	1	0	476
14013	492	1	1	1	0	495
14014	4	0	0	498	0	502
14015	2	0	0	498	0	500
14016	0	525	0	2	0	527
14017	0	1	0	530	0	531
14018	0	1	546	3	0	550
14019	1	0	2	563	0	566
14020	0	0	568	2	0	570
14021	548	0	1	1	0	550
14022	2	0	0	572	0	574
14023	2	0	585	1	0	588
14024	2	567	1	1	0	571
14025	1	584	1	1	0	587
14026	575	2	0	0	0	577
14027	1	2	0	581	0	584
14028	1	1	626	1	0	629
14029	1	636	2	1	0	640
14030	0	1	658	1	0	660
14031	652	0	2	1	0	655
14032	660	1	0	0	0	661
14033	662	0	1	1	0	664
14034	3	0	0	674	0	677
14035	2	0	669	1	0	672
14036	2	665	1	3	0	671
14037	1	1	0	690	0	692
14038	0	1	671	1	0	673
14039	0	0	640	1	0	641
14040	2	0	1	672	0	675
14041	681	0	1	2	0	684
14042	1	0	1	682	0	684
14043	1	0	0	714	0	715
14044	1	0	726	1	0	728
14045	2	0	1	723	0	726
14046	2	0	0	713	0	715
14047	1	1	738	1	0	741
14048	1	0	721	1	0	723
14049	1	0	1	739	0	741
14050	1	0	740	2	0	743
14051	0	0	2	744	0	746
14052	752	1	0	2	0	755
14053	1	785	1	1	0	788
14054	2	1	1	805	0	809
14055	1	1	787	2	0	791
14056	740	1	2	1	0	744
14057	3	750	0	3	0	756
14058	766	1	1	4	0	772
14059	2	0	2	770	0	774
14060	1	2	0	773	0	776
14061	797	2	0	3	0	802
14062	3	1	807	1	0	812
14063	801	0	1	6	0	808
14064	3	0	2	820	0	825
14065	812	0	2	1	0	815
14066	798	0	1	1	0	800
14067	7	0	0	803	0	810
14068	2	822	0	3	0	827
14069	859	4	0	0	0	863
14070	871	0	0	3	0	874
14071	5	0	876	0	0	881
14072	867	1	5	0	0	873
14073	6	0	0	876	0	882
14074	0	894	2	4	0	900
14075	4	4	2	886	0	896
14076	0	895	0	7	0	902
14077	898	6	0	1	0	905
14078	925	0	0	3	0	928
14079	7	1	0	953	0	961
14080	1	0	937	9	0	947
14081	1	1	933	2	0	937
14082	1	0	8	965	0	974
14083	956	0	3	12	0	971
14084	1047	0	3	2	0	1052
14085	9	1061	0	4	0	1074
14086	3	11	2	1063	0	1079
14087	2	0	1110	12	0	1124
14088	2	2	1150	0	0	1154
14089	2	6	16	1266	0	1290
14090	1367	0	2	23	0	1392
14091	24	0	5	1380	0	1409
14092	3	2	1372	25	0	1402
14093	1383	2	20	4	0	1409
14094	25	0	4	1381	0	1410
14095	8	0	3	1398	0	1409
14096	5	0	2	1399	0	1406
14097	6	1378	1	24	0	1409
14098	2	20	1374	10	0	1406
14099	1	2	1392	7	0	1402
14100	5	3	25	1379	0	1412
14101	4	6	1373	26	0	1409
14102	1372	1	27	5	0	1405
14103	24	0	5	1380	0	1409
14104	2	5	4	1393	0	1404
14105	8	0	5	1383	0	1396
14106	4	1378	5	25	0	1412
14107	1396	21	3	11	0	1431
14108	26	2	3	1393	0	1424
14109	1394	4	0	29	0	1427
14110	25	1390	1	7	0	1423
14111	1376	22	2	7	0	1407
14112	1358	4	1	12	0	1375
14113	1374	6	1	6	0	1387
14114	32	1329	4	2	0	1367
14115	8	1368	2	6	0	1384
14116	1331	24	1	7	0	1363
14117	26	1345	2	2	0	1375
14118	7	25	1312	3	0	1347
14119	8	1266	24	4	0	1302
14120	6	1316	4	3	0	1329
14121	1300	29	3	3	0	1335
14122	24	11	1289	2	0	1326
14123	9	6	1284	4	0	1303
14124	7	6	25	1289	0	1327
14125	1296	2	10	26	0	1334
14126	22	3	1315	5	0	1345
14127	6	4	24	1325	0	1359
14128	9	0	1270	28	0	1307
14129	4	4	1246	6	0	1260
14130	1211	1	32	6	0	1250
14131	25	2	1229	8	0	1264
14132	14	2	24	1218	0	1258
14133	7	3	9	1233	0	1252
14134	5	1206	6	28	0	1245
14135	3	1240	8	10	0	1261
14136	2	26	6	1212	0	1246
14137	5	9	1224	26	0	1264
14138	6	4	25	1227	0	1262
14139	6	6	5	1253	0	1270
14140	4	4	1252	30	0	1290
14141	3	4	27	1269	0	1303
14142	1273	4	9	31	0	1317
14143	24	1	1247	13	0	1285
14144	1250	2	28	8	0	1288
14145	28	0	9	1256	0	1293
14146	10	2	4	1304	0	1320
14147	5	1287	7	31	0	1330
14148	7	24	5	1309	0	1345
14149	11	5	6	1337	0	1359
14150	1308	2	6	40	0	1356
14151	32	3	2	1316	0	1353
14152	9	4	3	1341	0	1357
14153	1281	5	5	38	0	1329
14154	31	4	5	1282	0	1322
14155	6	3	8	1274	0	1291
14156	5	1261	8	38	0	1312
14157	1294	23	3	16	0	1336
14158	30	8	3	1281	0	1322
14159	7	3	3	1308	0	1321
14160	7	3	1277	33	0	1320
14161	8	3	23	1268	0	1302
14162	5	2	7	1287	0	1301
14163	1248	3	3	42	0	1296
14164	1267	2	5	16	0	1290
14165	35	5	2	1228	0	1270
14166	8	2	1219	32	0	1261
14167	9	1193	30	9	0	1241
14168	7	1204	5	12	0	1228
14169	9	29	5	1176	0	1219
14170	1178	9	4	27	0	1218
14171	29	5	1	1182	0	1217
14172	1193	5	3	34	0	1235
14173	26	4	4	1217	0	1251
14174	11	9	0	1219	0	1239
14175	1197	5	1	34	0	1237
14176	1187	3	3	18	0	1211
14177	35	1176	2	10	0	1223
14178	9	1226	3	11	0	1249
14179	9	25	5	1153	0	1192
14180	10	9	1	1177	0	1197
14181	4	5	1149	29	0	1187
14182	1095	3	17	12	0	1127
14183	21	1118	7	9	0	1155
14184	9	1054	5	5	0	1073
14185	1015	22	8	8	0	1053
14186	19	5	1027	6	0	1057
14187	9	4	973	2	0	988
14188	5	7	917	1	0	930
14189	2	818	13	1	0	834
14190	2	3	9	706	0	720
14191	0	3	0	715	0	718
14192	1	0	0	722	0	723
14193	696	0	0	8	0	704
14194	694	0	0	3	0	697
14195	7	703	0	1	0	711
14196	5	4	0	724	0	733
14197	1	4	735	4	0	744
14198	0	752	3	5	0	760
14199	750	3	3	3	0	759
14200	4	4	745	0	0	753
14201	710	1	5	1	0	717
14202	4	0	734	1	0	739
14203	4	0	4	727	0	735
14204	1	737	3	4	0	745
14205	741	3	1	6	0	751
14206	3	745	0	1	0	749
14207	738	4	0	1	0	743
14208	5	2	0	738	0	745
14209	2	2	754	5	0	763
14210	1	0	5	789	0	795
14211	0	1	2	867	0	870
14212	2	0	862	9	0	873
14213	859	0	7	4	0	870
14214	8	892	3	1	0	904
14215	881	7	1	2	0	891
14216	8	878	0	0	0	886
14217	3	8	0	906	0	917
14218	2	3	892	9	0	906
14219	1035	1	8	6	0	1050
14220	11	1061	4	1	0	1077
14221	3	11	0	1061	0	1075
14222	3	2	0	1083	0	1088
14223	1142	1	2	18	0	1163
14224	1208	1	0	4	0	1213
14225	19	1223	1	3	0	1246
14226	1307	15	0	3	0	1325
14227	1320	6	0	1	0	1327
14228	1338	2	0	1	0	1341
14229	28	3	1333	0	0	1364
14230	12	1324	23	0	0	1359
14231	4	1359	8	1	0	1372
14232	5	24	4	1315	0	1348
14233	4	10	1	1351	0	1366
14234	1331	5	0	28	0	1364
14235	23	1334	1	11	0	1369
14236	1354	19	2	6	0	1381
14237	25	12	0	1338	0	1375
14238	13	5	1	1353	0	1372
14239	1322	5	0	33	0	1360
14240	1300	1	1	13	0	1315
14241	36	1	1261	7	0	1305
14242	16	5	21	1257	0	1299
14243	11	2	1239	20	0	1272
14244	6	6	1231	11	0	1254
14245	4	4	1239	8	0	1255
14246	1188	5	30	10	0	1233
14247	26	1	12	1189	0	1228
14248	13	3	7	1187	0	1210
14249	12	1	4	1207	0	1224
14250	8	3	1188	29	0	1228
14251	6	2	20	1193	0	1221
14252	5	1	12	1216	0	1234
14253	1179	4	2	30	0	1215
14254	1190	1	3	16	0	1210
14255	1205	3	2	11	0	1221
14256	1207	2	2	9	0	1220
14257	36	2	5	1162	0	1205
14258	1178	3	3	29	0	1213
14259	31	1	3	1182	0	1217
14260	19	1	1132	26	0	1178
14261	1143	3	19	17	0	1182
14262	29	1146	9	8	0	1192
14263	15	20	5	1157	0	1197
14264	6	11	5	1177	0	1199
14265	7	1161	5	33	0	1206
14266	1144	19	7	17	0	1187
14267	22	1128	4	8	0	1162
14268	17	20	1127	6	0	1170
14269	9	12	1133	6	0	1160
14270	1127	3	27	11	0	1168
14271	1139	4	14	7	0	1164
14272	35	6	1091	6	0	1138
14273	1097	3	27	3	0	1130
14274	30	2	1084	9	0	1125
14275	1089	3	23	6	0	1121
14276	31	4	1090	4	0	1129
14277	19	4	1094	8	0	1125
14278	11	7	32	1032	0	1082
14279	10	4	14	1060	0	1088
14280	1041	3	7	37	0	1088
14281	1042	1	8	17	0	1068
14282	1048	4	4	12	0	1068
14283	1075	3	7	6	0	1091
14284	42	1022	3	8	0	1075
14285	20	18	4	1015	0	1057
14286	15	1025	4	29	0	1073
14287	13	21	5	1028	0	1067
14288	10	16	7	1013	0	1046
14289	10	3	7	1019	0	1039
14290	9	7	981	34	0	1031
14291	962	2	28	22	0	1014
14292	24	951	18	14	0	1007
14293	18	994	5	9	0	1026
14294	11	29	985	8	0	1033
14295	15	13	22	967	0	1017
14296	11	3	14	966	0	994
14297	939	6	9	32	0	986
14298	33	2	8	922	0	965
14299	15	6	5	935	0	961
14300	12	3	3	948	0	966
14301	12	3	4	955	0	974
14302	917	0	5	40	0	962
14303	932	2	4	20	0	958
14304	935	2	5	11	0	953
14305	39	1	5	917	0	962
14306	925	4	2	30	0	961
14307	28	5	7	941	0	981
14308	21	4	6	956	0	987
14309	7	6	910	38	0	961
14310	9	2	891	22	0	924
14311	8	3	829	12	0	852
14312	786	4	33	14	0	837
14313	24	0	16	764	0	804
14314	16	768	7	27	0	818
14315	780	18	4	20	0	822
14316	24	12	766	5	0	807
14317	756	0	17	9	0	782
14318	22	705	17	6	0	750
14319	557	10	4	4	0	575
14320	17	9	4	539	0	569
14321	539	4	2	15	0	560
14322	18	512	2	16	0	548
14323	11	485	7	5	0	508
14324	409	11	7	3	0	430
14325	19	401	3	4	0	427
14326	5	288	0	0	0	293
14327	3	289	2	2	0	296
14328	262	5	5	0	0	272
14329	240	4	0	1	0	245
14330	236	2	0	0	0	238
14331	8	1	0	227	0	236
14332	2	3	0	233	0	238
14333	1	2	235	5	0	243
14334	0	3	3	238	0	244
14335	2	1	237	3	0	243
14336	2	1	3	234	0	240
14337	3	0	2	240	0	245
14338	236	0	0	7	0	243
14339	238	0	0	4	0	242
14340	5	233	2	1	0	241
14341	1	3	1	235	0	240
14342	1	2	246	3	0	252
14343	0	1	3	257	0	261
14344	2	0	3	256	0	261
14345	3	0	0	260	0	263
14346	3	0	246	6	0	255
14347	1	2	237	2	0	242
14348	245	0	3	2	0	250
14349	4	1	4	253	0	262
14350	2	1	250	6	0	259
14351	243	1	4	4	0	252
14352	3	248	2	3	0	256
14353	253	2	2	1	0	258
14354	4	2	263	1	0	270
14355	260	0	3	0	0	263
14356	2	0	2	263	0	267
14357	2	0	267	3	0	272
14358	2	263	2	2	0	269
14359	265	4	2	1	0	272
14360	5	2	2	265	0	274
14361	1	1	2	264	0	268
14362	4	269	0	4	0	277
14363	1	2	2	275	0	280
14364	3	1	278	2	0	284
14365	0	281	2	2	0	285
14366	281	2	2	2	0	287
14367	2	2	1	279	0	284
14368	2	0	0	279	0	281
14369	0	3	277	4	0	284
14370	2	1	2	278	0	283
14371	1	1	287	2	0	291
14372	1	280	3	2	0	286
14373	285	3	3	1	0	292
14374	284	3	0	5	0	292
14375	285	0	2	3	0	290
14376	5	308	4	1	0	318
14377	1	3	1	315	0	320
14378	2	1	4	315	0	322
14379	1	3	1	291	0	296
14380	312	1	2	3	0	318
14381	312	2	0	3	0	317
14382	6	0	3	308	0	317
14383	3	3	337	3	0	346
14384	3	1	2	338	0	344
14385	2	2	1	341	0	346
14386	1	0	0	341	0	342
14387	3	2	0	339	0	344
14388	338	1	0	6	0	345
14389	4	2	2	341	0	349
14390	3	2	2	338	0	345
14391	2	345	0	7	0	354
14392	0	13	0	340	0	353
14393	0	352	1	6	0	359
14394	1	3	2	363	0	369
14395	364	1	0	4	0	369
14396	5	360	0	5	0	370
14397	360	4	1	4	0	369
14398	5	3	360	3	0	371
14399	2	1	2	356	0	361
14400	2	1	373	4	0	380
14401	1	1	5	376	0	383
14402	4	0	2	380	0	386
14403	0	376	0	9	0	385
14404	4	378	1	2	0	385
14405	2	393	0	0	0	395
14406	381	2	0	2	0	385
14407	1	361	0	2	0	364
14408	0	357	1	1	0	359
14409	3	2	1	361	0	367
14410	365	0	0	3	0	368
14411	1	401	1	1	0	404
14412	407	2	0	1	0	410
14413	407	0	0	1	0	408
14414	1	0	422	2	0	425
14415	1	0	1	415	0	417
14416	0	0	0	430	0	430
14417	0	0	0	432	0	432
14418	0	0	0	430	0	430
14419	1	0	423	1	0	425
14420	0	1	384	0	0	385
14421	405	0	1	0	0	406
14422	1	417	0	0	0	418
14423	0	418	1	0	0	419
14424	423	1	0	0	0	424
14425	1	423	0	0	0	424
14426	0	3	0	428	0	431
14427	441	0	0	2	0	443
14428	2	0	448	3	0	453
14429	0	0	2	459	0	461
14430	0	0	469	2	0	471
14431	459	0	2	0	0	461
14432	2	0	511	0	0	513
14433	527	0	2	2	0	531
14434	533	0	0	1	0	534
14435	538	0	0	2	0	540
14436	539	0	0	1	0	540
14437	537	1	0	0	0	538
14438	3	0	0	539	0	542
14439	556	0	1	2	0	559
14440	2	0	0	562	0	564
14441	0	1	1	562	0	564
14442	1	0	0	568	0	569
14443	1	0	568	3	0	572
14444	0	1	2	562	0	565
14445	0	0	0	583	0	583
14446	0	1	585	1	0	587
14447	555	0	3	0	0	558
14448	4	1	0	593	0	598
14449	1	1	592	2	0	596
14450	1	1	574	1	0	577
14451	2	0	2	580	0	584
14452	0	1	610	4	0	615
14453	2	0	3	623	0	628
14454	1	0	1	624	0	626
14455	0	628	2	4	0	634
14456	0	623	1	2	0	626
14457	634	2	1	2	0	639
14458	2	0	0	646	0	648
14459	0	0	0	646	0	646
14460	0	1	2	649	0	652
14461	2	0	664	2	0	668
14462	1	0	2	660	0	663
14463	661	0	1	4	0	666
14464	2	0	647	1	0	650
14465	1	0	3	683	0	687
14466	0	1	1	697	0	699
14467	1	0	0	704	0	705
14468	1	766	1	3	0	771
14469	776	6	1	1	0	784
14470	813	2	0	2	0	817
14471	7	824	1	1	0	833
14472	3	6	0	901	0	910
14473	1	1	895	5	0	902
14474	2	2	875	4	0	883
14475	929	1	6	3	0	939
14476	9	0	5	932	0	946
14477	982	0	3	7	0	992
14478	10	999	3	5	0	1017
14479	5	1008	3	5	0	1021
14480	1001	9	1	2	0	1013
14481	9	1038	1	1	0	1049
14482	6	12	1	1050	0	1069
14483	7	5	0	1024	0	1036
14484	3	1077	3	11	0	1094
14485	1083	12	0	7	0	1102
14486	9	4	1079	6	0	1098
14487	1064	6	9	5	0	1084
14488	11	2	1097	2	0	1112
14489	1049	2	9	6	0	1066
14490	10	3	1108	1	0	1122
14491	8	1088	11	1	0	1108
14492	7	8	8	1095	0	1118
14493	1098	5	4	8	0	1115
14494	8	4	1078	3	0	1093
14495	6	2	1080	3	0	1091
14496	3	3	11	1074	0	1091
14497	3	3	1097	5	0	1108
14498	0	1	11	1093	0	1105
14499	5	1	5	1071	0	1082
14500	2	4	1087	12	0	1105
14501	2	0	8	1086	0	1096
14502	1107	1	4	14	0	1126
14503	8	1105	7	5	0	1125
14504	1129	6	3	9	0	1147
14505	9	6	3	1111	0	1129
14506	1119	4	2	7	0	1132
14507	1128	3	1	7	0	1139
14508	12	0	3	1134	0	1149
14509	7	1141	1	9	0	1158
14510	1156	7	1	6	0	1170
14511	9	5	1102	5	0	1121
14512	7	3	1096	2	0	1108
14513	1099	4	9	5	0	1117
14514	9	0	9	1108	0	1126
14515	5	3	1127	7	0	1142
14516	7	2	7	1123	0	1139
14517	1138	3	5	11	0	1157
14518	1147	3	6	10	0	1166
14519	1144	1	2	7	0	1154
14520	12	1184	4	11	0	1211
14521	14	6	2	1197	0	1219
14522	8	3	2	1207	0	1220
14523	1196	4	3	16	0	1219
14524	10	1199	1	9	0	1219
14525	1204	7	2	6	0	1219
14526	9	6	4	1198	0	1217
14527	1191	3	3	10	0	1207
14528	12	4	1145	7	0	1168
14529	7	1143	9	6	0	1165
14530	8	9	5	1143	0	1165
14531	7	1169	6	6	0	1188
14532	4	10	4	1150	0	1168
14533	1135	5	0	14	0	1154
14534	9	3	1119	6	0	1137
14535	1099	8	7	5	0	1119
14536	13	1154	5	9	0	1181
14537	4	8	5	1188	0	1205
14538	8	3	3	1198	0	1212
14539	1171	5	2	12	0	1190
14540	8	5	1173	10	0	1196
14541	8	1	8	1197	0	1214
14542	7	5	6	1185	0	1203
14543	6	1	5	1174	0	1186
14544	4	2	3	1188	0	1197
14545	1162	1	3	18	0	1184
14546	1155	3	4	11	0	1173
14547	13	1	1152	9	0	1175
14548	11	5	1118	4	0	1138
14549	1186	0	12	6	0	1204
14550	1218	2	7	9	0	1236
14551	16	2	5	1214	0	1237
14552	9	2	3	1198	0	1212
14553	1193	1	2	15	0	1211
14554	11	1188	5	7	0	1211
14555	8	5	3	1192	0	1208
14556	8	4	4	1205	0	1221
14557	5	6	1180	13	0	1204
14558	6	2	6	1187	0	1201
14559	7	1	1188	15	0	1211
14560	3	4	11	1193	0	1211
14561	1171	2	6	14	0	1193
14562	9	2	6	1179	0	1196
14563	6	3	1176	12	0	1197
14564	9	1139	6	10	0	1164
14565	6	7	8	1182	0	1203
14566	3	4	1174	10	0	1191
14567	5	1179	7	11	0	1202
14568	7	6	3	1130	0	1146
14569	2	4	1116	7	0	1129
14570	983	5	2	8	0	998
14571	5	1084	4	8	0	1101
14572	5	1019	3	3	0	1030
14573	3	1031	3	4	0	1041
14574	4	10	6	1018	0	1038
14575	0	3	1044	5	0	1052
14576	5	1037	2	3	0	1047
14577	11	11	5	1001	0	1028
14578	1073	2	4	5	0	1084
14579	7	3	1	1397	0	1408
14580	4	5	1644	15	0	1668
14581	1	1656	17	7	0	1681
14582	1630	17	5	7	0	1659
14583	17	1649	4	3	0	1673
14584	7	20	1593	3	0	1623
14585	5	1597	19	2	0	1623
14586	6	18	8	1587	0	1619
14587	1	11	1590	18	0	1620
14588	5	1592	19	5	0	1621
14589	7	21	6	1574	0	1608
14590	3	11	9	1550	0	1573
14591	2	1569	10	19	0	1600
14592	6	23	4	1584	0	1617
14593	1	11	1579	29	0	1620
14594	1	8	1584	10	0	1603
14595	5	8	23	1579	0	1615
14596	1574	4	9	29	0	1616
14597	1575	5	7	17	0	1604
14598	25	8	4	1563	0	1600
14599	9	1549	5	29	0	1592
14600	6	16	12	1572	0	1606
14601	1549	9	8	28	0	1594
14602	24	5	3	1548	0	1580
14603	18	5	4	1550	0	1577
14604	1519	5	6	34	0	1564
14605	19	1505	4	17	0	1545
14606	11	25	2	1515	0	1553
14607	1500	9	5	28	0	1542
14608	25	7	1469	16	0	1517
14609	1474	6	17	19	0	1516
14610	27	3	8	1487	0	1525
14611	1491	7	5	23	0	1526
14612	1500	6	2	16	0	1524
14613	1426	2	5	22	0	1455
14614	35	1458	6	7	0	1506
14615	16	20	1445	4	0	1485
14616	12	1447	19	9	0	1487
14617	1459	18	10	10	0	1497
14618	32	1440	8	9	0	1489
14619	22	23	3	1459	0	1507
14620	1415	12	3	23	0	1453
14621	26	1409	5	10	0	1450
14622	10	26	1405	9	0	1450
14623	11	14	20	1411	0	1456
14624	13	13	1394	23	0	1443
14625	5	1404	23	26	0	1458
14626	9	26	11	1399	0	1445
14627	12	17	6	1417	0	1452
14628	7	13	9	1418	0	1447
14629	5	11	7	1400	0	1423
14630	6	1379	8	38	0	1431
14631	1359	30	8	14	0	1411
14632	23	16	1350	16	0	1405
14633	13	5	23	1370	0	1411
14634	1353	4	8	35	0	1400
14635	27	7	1345	20	0	1399
14636	11	1319	20	18	0	1368
14637	12	29	10	1294	0	1345
14638	9	12	1293	28	0	1342
14639	6	1298	28	16	0	1348
14640	1260	26	10	13	0	1309
14641	29	1274	10	10	0	1323
14642	14	32	12	1264	0	1322
14643	9	16	3	1303	0	1331
14644	1270	10	7	39	0	1326
14645	22	1273	14	14	0	1323
14646	13	29	4	1292	0	1338
14647	1263	14	5	34	0	1316
14648	1230	16	11	19	0	1276
14649	30	1224	1	25	0	1280
14650	1208	24	3	16	0	1251
14651	1224	20	6	6	0	1256
14652	34	15	5	1198	0	1252
14653	24	10	1179	36	0	1249
14654	23	5	26	1165	0	1219
14655	19	8	14	1178	0	1219
14656	10	14	1146	42	0	1212
14657	20	1135	25	21	0	1201
14658	19	26	13	1137	0	1195
14659	4	15	8	1166	0	1193
14660	10	10	10	1175	0	1205
14661	11	6	10	1151	0	1178
14662	4	1134	11	44	0	1193
14663	1134	21	7	26	0	1188
14664	1149	15	4	18	0	1186
14665	1120	8	2	23	0	1153
14666	37	1061	6	21	0	1125
14667	18	26	3	1060	0	1107
14668	15	13	1052	32	0	1112
14669	14	20	20	1036	0	1090
14670	16	1055	10	32	0	1113
14671	1035	25	7	16	0	1083
14672	1036	15	4	14	0	1069
14673	1014	13	3	17	0	1047
14674	37	970	5	18	0	1030
14675	19	935	9	13	0	976
14676	10	967	9	10	0	996
14677	18	35	929	11	0	993
14678	21	14	836	20	0	891
14679	21	109	29	390	0	549
14680	253	4	13	5	0	275
14681	254	0	1	3	0	258
14682	8	1	2	253	0	264
14683	3	2	0	249	0	254
14684	2	1	1	265	0	269
14685	0	3	1	265	0	269
14686	259	0	1	9	0	269
14687	271	1	0	5	0	277
14688	7	276	1	1	0	285
14689	274	8	0	1	0	283
14690	282	1	0	4	0	287
14691	284	0	0	1	0	285
14692	8	1	248	2	0	259
14693	256	3	3	0	0	262
14694	7	267	1	0	0	275
14695	3	6	1	274	0	284
14696	2	1	1	281	0	285
14697	2	258	2	7	0	269
14698	1	6	0	274	0	281
14699	273	1	1	8	0	283
14700	4	0	3	278	0	285
14701	1	1	273	8	0	283
14702	266	1	6	4	0	277
14703	5	275	1	3	0	284
14704	3	5	0	279	0	287
14705	1	1	0	276	0	278
14706	0	3	1	275	0	279
14707	3	0	272	6	0	281
14708	3	262	5	3	0	273
14709	4	6	1	259	0	270
14710	1	2	260	5	0	268
14711	3	0	4	257	0	264
14712	1	3	260	5	0	269
14713	1	0	5	254	0	260
14714	0	259	2	6	0	267
14715	5	5	0	247	0	257
14716	244	2	0	7	0	253
14717	243	0	0	1	0	244
14718	6	0	235	1	0	242
14719	1	0	222	1	0	224
14720	1	0	239	0	0	240
14721	1	0	4	240	0	245
14722	0	0	2	266	0	268
14723	1	0	0	271	0	272
14724	1	267	0	5	0	273
14725	1	3	0	263	0	267
14726	1	1	0	268	0	270
14727	2	0	0	271	0	273
14728	275	2	0	4	0	281
14729	279	0	0	2	0	281
14730	5	0	277	1	0	283
14731	2	1	274	0	0	277
14732	281	0	4	1	0	286
14733	296	0	1	0	0	297
14734	4	1	310	1	0	316
14735	1	0	303	1	0	305
14736	299	0	3	1	0	303
14737	309	1	1	0	0	311
14738	5	0	321	2	0	328
14739	2	0	3	322	0	327
14740	0	0	1	324	0	325
14741	0	334	1	6	0	341
14742	2	5	0	341	0	348
14743	0	2	348	5	0	355
14744	1	0	3	344	0	348
14745	0	0	2	353	0	355
14746	0	0	340	7	0	347
14747	338	0	5	3	0	346
14748	350	1	2	0	0	353
14749	7	1	0	345	0	353
14750	4	0	1	349	0	354
14751	349	0	0	7	0	356
14752	348	0	2	2	0	352
14753	326	0	1	3	0	330
14754	349	0	1	1	0	351
14755	6	339	0	1	0	346
14756	341	3	0	2	0	346
14757	4	339	0	1	0	344
14758	3	4	1	346	0	354
14759	0	3	1	345	0	349
14760	0	341	1	6	0	348
14761	0	3	0	347	0	350
14762	1	1	0	342	0	344
14763	1	341	0	7	0	349
14764	0	5	0	345	0	350
14765	1	2	1	347	0	351
14766	2	0	0	347	0	349
14767	1	1	341	5	0	348
14768	1	344	4	3	0	352
14769	1	3	3	331	0	338
14770	1	336	1	4	0	342
14771	335	3	1	2	0	341
14772	4	3	331	0	0	338
14773	3	0	323	2	0	328
14774	318	1	3	1	0	323
14775	2	5	2	317	0	326
14776	2	0	310	2	0	314
14777	1	0	296	1	0	298
14778	1	2	2	286	0	291
14779	279	0	1	3	0	283
14780	278	0	2	1	0	281
14781	5	0	1	272	0	278
14782	2	0	271	2	0	275
14783	1	279	1	1	0	282
14784	1	2	1	283	0	287
14785	1	1	283	2	0	287
14786	1	281	1	1	0	284
14787	4	2	1	267	0	274
14788	273	1	0	2	0	276
14789	1	0	1	269	0	271
14790	1	273	0	1	0	275
14791	269	1	0	4	0	274
14792	2	1	288	1	0	292
14793	1	285	0	1	0	287
14794	0	3	287	2	0	292
14795	277	3	3	2	0	285
14796	3	0	3	276	0	282
14797	2	1	0	286	0	289
14798	288	0	2	2	0	292
14799	4	0	1	286	0	291
14800	1	0	277	4	0	282
14801	277	0	2	3	0	282
14802	4	286	0	2	0	292
14803	2	2	2	285	0	291
14804	285	1	2	1	0	289
14805	5	290	0	1	0	296
14806	3	3	0	297	0	303
14807	297	1	1	4	0	303
14808	4	1	0	302	0	307
14809	1	304	0	7	0	312
14810	2	3	307	3	0	315
14811	1	1	2	313	0	317
14812	0	2	2	296	0	300
14813	307	1	1	7	0	316
14814	2	0	1	318	0	321
14815	316	1	1	5	0	323
14816	321	0	0	3	0	324
14817	6	0	0	319	0	325
14818	2	315	0	6	0	323
14819	2	3	1	312	0	318
14820	297	2	0	5	0	304
14821	3	299	1	4	0	307
14822	1	306	0	1	0	308
14823	304	4	0	1	0	309
14824	316	2	1	0	0	319
14825	5	314	2	0	0	321
14826	312	5	2	0	0	319
14827	317	1	0	2	0	320
14828	7	1	0	305	0	313
14829	2	1	321	4	0	328
14830	3	0	5	323	0	331
14831	1	0	333	6	0	340
14832	3	1	6	322	0	332
14833	1	0	326	7	0	334
14834	307	0	7	4	0	318
14835	5	1	3	315	0	324
14836	327	0	1	8	0	336
14837	6	0	2	327	0	335
14838	3	325	0	8	0	336
14839	323	4	0	5	0	332
14840	6	3	305	2	0	316
14841	299	2	6	2	0	309
14842	5	301	2	0	0	308
14843	301	4	0	0	0	305
14844	303	1	0	1	0	305
14845	5	307	0	0	0	312
14846	2	5	0	331	0	338
14847	334	1	0	6	0	341
14848	7	331	0	3	0	341
14849	4	6	0	336	0	346
14850	340	3	0	7	0	350
14851	7	1	0	350	0	358
14852	3	0	0	356	0	359
14853	1	1	0	357	0	359
14854	0	0	340	10	0	350
14855	0	0	6	349	0	355
14856	349	0	3	8	0	360
14857	7	0	340	3	0	350
14858	3	0	8	342	0	353
14859	1	0	2	347	0	350
14860	0	0	346	11	0	357
14861	331	0	8	4	0	343
14862	355	0	3	2	0	360
14863	11	0	342	0	0	353
14864	4	1	8	338	0	351
14865	1	0	3	347	0	351
14866	1	1	370	10	0	382
14867	1	0	8	386	0	395
14868	2	0	2	376	0	380
14869	2	1	388	11	0	402
14870	380	3	9	5	0	397
14871	10	0	2	397	0	409
14872	397	0	1	11	0	409
14873	407	0	1	5	0	413
14874	13	0	398	5	0	416
14875	6	0	11	397	0	414
14876	390	0	6	11	0	407
14877	11	391	1	6	0	409
14878	6	8	2	400	0	416
14879	3	4	3	407	0	417
14880	0	1	0	423	0	424
14881	0	0	407	16	0	423
14882	389	0	13	6	0	408
14883	13	1	3	397	0	414
14884	8	0	2	398	0	408
14885	1	0	396	14	0	411
14886	2	0	10	394	0	406
14887	1	1	4	406	0	412
14888	388	0	4	15	0	407
14889	12	390	0	6	0	408
14890	3	11	395	4	0	413
14891	393	3	12	2	0	410
14892	13	1	2	378	0	394
14893	4	2	387	11	0	404
14894	4	0	396	6	0	406
14895	6	0	13	388	0	407
14896	0	1	397	12	0	410
14897	1	0	388	6	0	395
14898	3	380	12	2	0	397
14899	0	9	4	402	0	415
14900	0	3	400	14	0	417
14901	2	0	10	402	0	414
14902	412	0	4	16	0	432
14903	10	0	2	426	0	438
14904	6	0	1	432	0	439
14905	416	1	1	18	0	436
14906	433	0	2	7	0	442
14907	14	0	2	428	0	444
14908	3	1	425	13	0	442
14909	1	412	12	10	0	435
14910	3	11	3	421	0	438
14911	425	3	2	13	0	443
14912	437	0	3	5	0	445
14913	15	414	2	1	0	432
14914	3	430	2	3	0	438
14915	424	12	2	1	0	439
14916	425	3	3	2	0	433
14917	12	1	430	2	0	445
14918	5	0	11	420	0	436
14919	0	435	4	8	0	447
14920	441	11	0	7	0	459
14921	12	4	1	439	0	456
14922	4	435	2	10	0	451
14923	1	8	428	8	0	445
14924	3	6	8	415	0	432
14925	1	434	3	12	0	450
14926	433	8	1	9	0	451
14927	436	3	1	1	0	441
14928	14	424	0	2	0	440
14929	409	7	0	4	0	420
14930	413	4	3	1	0	421
14931	11	396	0	1	0	408
14932	2	401	0	2	0	405
14933	5	8	1	391	0	405
14934	396	3	0	8	0	407
14935	8	2	407	2	0	419
14936	389	2	7	1	0	399
14937	9	393	1	3	0	406
14938	403	8	2	1	0	414
14939	415	2	3	0	0	420
14940	421	1	1	4	0	427
14941	11	4	0	410	0	425
14942	5	409	1	7	0	422
14943	417	9	1	3	0	430
14944	9	6	425	2	0	442
14945	5	421	9	1	0	436
14946	3	7	1	421	0	432
14947	1	1	423	6	0	431
14948	1	2	422	1	0	426
14949	2	2	6	428	0	438
14950	1	1	2	439	0	443
14951	1	2	0	439	0	442
14952	2	0	0	432	0	434
14953	3	422	1	7	0	433
14954	0	440	1	0	0	441
14955	449	6	0	1	0	456
14956	7	1	0	446	0	454
14957	3	0	1	450	0	454
14958	1	2	1	465	0	469
14959	464	0	1	7	0	472
14960	467	1	1	1	0	470
14961	7	1	0	463	0	471
14962	469	0	2	6	0	477
14963	476	0	1	1	0	478
14964	493	0	0	6	0	499
14965	6	1	1	496	0	504
14966	2	1	460	5	0	468
14967	0	0	438	0	0	438
14968	2	1	441	1	0	445
14969	1	1	462	2	0	466
14970	2	1	5	462	0	470
14971	469	0	3	4	0	476
14972	467	0	0	2	0	469
14973	4	1	460	1	0	466
14974	1	0	460	2	0	463
14975	1	537	3	2	0	543
14976	1	5	0	553	0	559
14977	561	2	0	6	0	569
14978	4	0	559	2	0	565
14979	558	1	3	1	0	563
14980	4	598	2	1	0	605
14981	1	3	1	625	0	630
14982	2	2	0	647	0	651
14983	4	0	0	646	0	650
14984	665	0	0	5	0	670
14985	5	2	0	675	0	682
14986	2	1	2	675	0	680
14987	676	0	0	5	0	681
14988	5	2	0	672	0	679
14989	1	1	668	4	0	674
14990	673	0	4	0	0	677
14991	3	1	1	682	0	687
14992	4	0	1	671	0	676
14993	2	669	0	4	0	675
14994	675	4	0	5	0	684
14995	691	1	0	3	0	695
14996	4	1	1	688	0	694
14997	4	0	691	3	0	698
14998	665	2	4	1	0	672
14999	6	1	704	2	0	713
15000	4	1	3	691	0	699
15001	1	0	3	710	0	714
15002	716	0	2	4	0	722
15003	6	0	0	740	0	746
15004	1	0	732	7	0	740
15005	719	1	4	5	0	729
15006	6	1	790	3	0	800
15007	4	0	791	0	0	795
15008	826	1	4	4	0	835
15009	5	0	1	851	0	857
15010	1	889	3	3	0	896
15011	883	4	1	6	0	894
15012	885	0	3	3	0	891
15013	6	0	886	1	0	893
15014	872	0	5	4	0	881
15015	7	1	0	905	0	913
15016	1	0	916	6	0	923
15017	0	902	6	3	0	911
15018	913	4	2	4	0	923
15019	8	918	2	0	0	928
15020	0	4	0	933	0	937
15021	3	1	0	931	0	935
15022	4	1	0	926	0	931
15023	4	1	0	922	0	927
15024	2	911	4	5	0	922
15025	5	3	899	1	0	908
15026	1	900	5	7	0	913
15027	913	3	1	7	0	924
15028	5	3	1	917	0	926
15029	921	1	2	5	0	929
15030	9	3	0	925	0	937
15031	957	1	0	10	0	968
15032	4	973	2	4	0	983
15033	1005	4	1	4	0	1014
15034	1011	0	3	6	0	1020
15035	993	1	0	8	0	1002
15036	998	2	1	8	0	1009
15037	8	990	1	0	0	999
15038	4	4	991	3	0	1002
15039	4	0	6	995	0	1005
15040	997	0	0	6	0	1003
15041	1016	0	3	3	0	1022
15042	9	0	3	1023	0	1035
15043	3	2	1053	6	0	1064
15044	3	1	5	1035	0	1044
15045	6	1068	0	7	0	1081
15046	1066	5	2	3	0	1076
15047	11	0	2	1065	0	1078
15048	4	1052	3	6	0	1065
15049	3	1113	1	3	0	1120
15050	1	1130	2	5	0	1138
15051	2	5	2	1170	0	1179
15052	1177	4	0	7	0	1188
15053	7	1179	0	5	0	1191
15054	1	9	1	1195	0	1206
15055	1184	1	3	10	0	1198
15056	7	3	0	1191	0	1201
15057	1196	4	2	8	0	1210
15058	1193	1	1	8	0	1203
15059	10	1239	0	5	0	1254
15060	3	8	3	1225	0	1239
15061	4	1256	0	6	0	1266
15062	1252	7	1	6	0	1266
15063	1242	3	1	4	0	1250
15064	1242	1	3	4	0	1250
15065	10	9	3	1234	0	1256
15066	11	0	1235	6	0	1252
15067	1217	5	7	4	0	1233
15068	1239	2	4	4	0	1249
15069	13	2	0	1220	0	1235
15070	9	1224	2	5	0	1240
15071	10	7	1	1244	0	1262
15072	7	4	1	1260	0	1272
15073	1260	2	3	10	0	1275
15074	1232	4	5	9	0	1250
15075	12	5	1174	4	0	1195
15076	10	1	6	1171	0	1188
15077	1187	2	3	10	0	1202
15078	10	3	4	1196	0	1213
15079	5	2	1201	13	0	1221
15080	2	1143	5	10	0	1160
15081	6	1173	1	4	0	1184
15082	1332	11	3	4	0	1350
15083	15	3	4	1434	0	1456
15084	6	6	0	1626	0	1638
15085	1619	2	2	28	0	1651
15086	28	1	1595	12	0	1636
15087	12	3	25	1611	0	1651
15088	8	3	1606	30	0	1647
15089	7	1622	28	8	0	1665
15090	1643	26	11	11	0	1691
15091	1682	8	6	9	0	1705
15092	1707	9	4	4	0	1724
15093	39	5	1667	3	0	1714
15094	1673	1	24	5	0	1703
15095	1708	7	6	9	0	1730
15096	40	4	7	1683	0	1734
15097	1429	7	9	36	0	1481
15098	31	4	1649	7	0	1691
15099	1653	2	25	9	0	1689
15100	30	6	1631	5	0	1672
15101	14	1680	29	5	0	1728
15102	16	30	6	1570	0	1622
15103	10	1660	3	24	0	1697
15104	7	30	1631	14	0	1682
15105	5	1653	29	6	0	1693
15106	1557	29	6	7	0	1599
15107	31	1542	6	2	0	1581
15108	8	1537	4	6	0	1555
15109	11	32	1493	4	0	1540
15110	8	11	22	1469	0	1510
15111	1481	12	9	24	0	1526
15112	29	4	1463	6	0	1502
15113	15	1483	25	6	0	1529
15114	9	27	7	1487	0	1530
15115	6	9	1477	29	0	1521
15116	10	7	1460	8	0	1485
15117	5	3	25	1476	0	1509
15118	7	0	1477	30	0	1514
15119	8	5	32	1373	0	1418
15120	4	1431	10	25	0	1470
15121	8	23	8	1447	0	1486
15122	7	1446	7	31	0	1491
15123	7	27	7	1453	0	1494
15124	1448	10	7	30	0	1495
15125	30	7	8	1444	0	1489
15126	13	1441	2	30	0	1486
15127	11	25	4	1465	0	1505
15128	10	11	1450	30	0	1501
15129	9	6	26	1462	0	1503
15130	1456	5	9	29	0	1499
15131	29	2	1434	12	0	1477
15132	14	6	29	1413	0	1462
15133	1387	6	8	31	0	1432
15134	32	1363	10	10	0	1415
15135	9	25	9	1374	0	1417
15136	1375	10	3	30	0	1418
15137	34	7	8	1369	0	1418
15138	11	6	1362	30	0	1409
15139	1338	7	26	14	0	1385
15140	29	1339	12	6	0	1386
15141	10	1371	8	10	0	1399
15142	1351	29	4	7	0	1391
15143	1336	9	8	3	0	1356
15144	30	10	3	1315	0	1358
15145	1305	5	6	23	0	1339
15146	27	5	1281	8	0	1321
15147	1287	4	21	5	0	1317
15148	24	1260	12	10	0	1306
15149	1237	20	10	7	0	1274
15150	35	5	1208	8	0	1256
15151	15	9	24	1206	0	1254
15152	12	4	9	1233	0	1258
15153	5	6	11	1178	0	1200
15154	6	1186	9	33	0	1234
15155	1199	25	6	15	0	1245
15156	25	8	2	1155	0	1190
15157	8	1175	7	24	0	1214
15158	1260	25	4	12	0	1301
15159	1204	11	6	12	0	1233
15160	1230	12	3	10	0	1255
15161	1226	4	5	6	0	1241
15162	1227	3	5	6	0	1241
15163	36	2	7	1206	0	1251
15164	19	5	5	1198	0	1227
15165	1182	5	3	30	0	1220
15166	28	3	9	1194	0	1234
15167	15	2	3	1204	0	1224
15168	12	4	1140	30	0	1186
15169	1158	5	27	16	0	1206
15170	1179	5	10	13	0	1207
15171	1189	9	5	9	0	1212
15172	34	9	4	1114	0	1161
15173	14	1154	5	25	0	1198
15174	1255	24	4	10	0	1293
15175	1212	14	5	12	0	1243
15176	32	6	4	1341	0	1383
15177	1327	5	8	26	0	1366
15178	43	13	1074	17	0	1147
15179	14	1328	24	9	0	1375
15180	15	1363	12	6	0	1396
15181	30	32	1316	5	0	1383
15182	6	1125	22	11	0	1164
15183	5	1061	7	7	0	1080
15184	854	9	8	5	0	876
15185	8	847	1	7	0	863
15186	6	11	3	870	0	890
15187	896	1	1	10	0	908
15188	12	2	884	0	0	898
15189	868	1	7	7	0	883
15190	9	2	874	4	0	889
15191	4	0	866	6	0	876
15192	851	3	9	3	0	866
15193	9	1	872	5	0	887
15194	5	841	8	1	0	855
15195	4	8	5	851	0	868
15196	846	1	3	8	0	858
15197	8	839	0	1	0	848
15198	4	9	1	847	0	861
15199	5	1	844	9	0	859
15200	5	3	5	850	0	863
15201	825	0	2	11	0	838
15202	9	0	813	1	0	823
15203	4	2	7	814	0	827
15204	820	2	2	9	0	833
15205	841	1	4	4	0	850
15206	11	1	2	845	0	859
15207	5	1	1	844	0	851
15208	6	1	870	8	0	885
15209	10	1	862	4	0	877
15210	899	1	8	6	0	914
15211	912	4	2	4	0	922
15212	7	900	2	3	0	912
15213	899	7	2	3	0	911
15214	933	2	1	4	0	940
15215	10	3	989	5	0	1007
15216	4	1023	8	3	0	1038
15217	1025	9	3	2	0	1039
15218	1036	0	2	3	0	1041
15219	1046	2	0	3	0	1051
15220	12	1	1	1042	0	1056
15221	5	0	0	1048	0	1053
15222	3	1027	3	12	0	1045
15223	2	7	3	1051	0	1063
15224	1046	0	1	10	0	1057
15225	12	2	1	1040	0	1055
15226	3	2	1025	12	0	1042
15227	4	2	1016	2	0	1024
15228	6	0	9	1025	0	1040
15229	2	1	1038	9	0	1050
15230	1	3	1044	3	0	1051
15231	3	1	11	1023	0	1038
15232	4	0	2	1040	0	1046
15233	5	1	1052	10	0	1068
15234	3	0	1047	3	0	1053
15235	1	1070	9	6	0	1086
15236	1075	12	2	1	0	1090
15237	11	1094	3	1	0	1109
15238	1094	12	0	2	0	1108
15239	1119	0	0	2	0	1121
15240	10	1126	2	2	0	1140
15241	1131	11	3	0	0	1145
15242	13	0	1	1125	0	1139
15243	2	2	1153	11	0	1168
15244	3	1	13	1149	0	1166
15245	3	0	1	1171	0	1175
15246	1132	0	3	14	0	1149
15247	1137	0	3	5	0	1145
15248	1149	1	2	3	0	1155
15249	1144	1	2	1	0	1148
15250	1123	2	0	0	0	1125
15251	13	1088	0	1	0	1102
15252	5	11	0	1103	0	1119
15253	4	1	1111	10	0	1126
15254	2	3	10	1106	0	1121
15255	1	1	1	1105	0	1108
15256	3	0	2	1147	0	1152
15257	1207	0	1	15	0	1223
15258	13	0	3	1191	0	1207
15259	1208	0	1	21	0	1230
15260	19	0	1239	3	0	1261
15261	8	0	16	1443	0	1467
15262	4	0	1480	27	0	1511
15263	1486	0	29	6	0	1521
15264	29	0	5	1501	0	1535
15265	5	2	1520	26	0	1553
15266	6	1	28	1514	0	1549
15267	1530	0	5	33	0	1568
15268	29	1	1546	6	0	1582
15269	1544	1	26	8	0	1579
15270	1586	0	3	4	0	1593
15271	1576	0	6	4	0	1586
15272	1570	2	1	2	0	1575
15273	38	1513	0	3	0	1554
15274	6	1454	2	1	0	1463
15275	2	1430	2	2	0	1436
15276	5	41	0	1299	0	1345
15277	1	1330	1	20	0	1352
15278	1289	22	0	4	0	1315
15279	23	1272	1	2	0	1298
15280	5	1288	1	2	0	1296
15281	4	24	2	1268	0	1298
15282	5	9	1	1283	0	1298
15283	1268	2	1	28	0	1299
15284	21	2	2	1278	0	1303
15285	7	0	1245	27	0	1279
15286	4	2	1203	7	0	1216
15287	3	1	1242	3	0	1249
15288	4	1	29	1233	0	1267
15289	4	1	7	1313	0	1325
15290	5	0	1279	26	0	1310
15291	4	0	1244	9	0	1257
15292	4	2	1311	4	0	1321
15293	1313	3	30	3	0	1349
15294	22	3	8	1341	0	1374
15295	9	2	3	1357	0	1371
15296	1336	3	2	31	0	1372
15297	27	0	0	1332	0	1359
15298	7	1313	4	24	0	1348
15299	4	1363	6	6	0	1379
15300	3	28	4	1353	0	1388
15301	1353	8	1	31	0	1393
15302	1366	3	0	11	0	1380
15303	1377	1	4	9	0	1391
15304	33	0	3	1355	0	1391
15305	9	2	1334	23	0	1368
15306	7	0	24	1327	0	1358
15307	2	1	1336	30	0	1369
15308	1279	3	26	11	0	1319
15309	29	0	7	1287	0	1323
15310	1264	0	6	27	0	1297
15311	27	3	1270	10	0	1310
15312	1237	3	25	6	0	1271
15313	27	1	1302	7	0	1337
15314	12	1226	21	5	0	1264
15315	10	1211	13	4	0	1238
15316	1181	26	6	7	0	1220
15317	29	11	0	1184	0	1224
15318	8	7	1196	24	0	1235
15319	4	1178	20	12	0	1214
15320	3	1217	12	8	0	1240
15321	14	26	3	1202	0	1245
15322	1205	11	3	27	0	1246
15323	1217	4	1	14	0	1236
15324	31	1204	5	7	0	1247
15325	1219	23	3	6	0	1251
15326	26	8	5	1211	0	1250
15327	10	8	1205	25	0	1248
15328	5	1212	24	15	0	1256
15329	9	24	9	1211	0	1253
15330	4	7	9	1216	0	1236
15331	1200	4	5	31	0	1240
15332	26	3	1175	14	0	1218
15333	1181	7	24	6	0	1218
15334	1201	5	10	7	0	1223
15335	33	4	6	1175	0	1218
15336	13	3	3	1192	0	1211
15337	1144	5	4	31	0	1184
15338	28	3	2	1164	0	1197
15339	9	4	1140	28	0	1181
15340	8	2	1123	12	0	1145
15341	6	1096	30	4	0	1136
15342	5	1159	11	8	0	1183
15343	6	34	3	1088	0	1131
15344	8	1092	2	24	0	1126
15345	1102	22	6	17	0	1147
15346	29	1106	7	3	0	1145
15347	12	26	3	1125	0	1166
15348	3	9	4	1142	0	1158
15349	1	6	1125	36	0	1168
15350	10	1	20	1130	0	1161
15351	7	2	11	1153	0	1173
15352	7	1140	7	27	0	1181
15353	10	24	4	1154	0	1192
15354	5	9	2	1173	0	1189
15355	6	6	1150	32	0	1194
15356	4	1125	23	16	0	1168
15357	1	69	7	984	0	1061
15358	6	1025	3	17	0	1051
15359	1	20	994	6	0	1021
15360	2	950	18	7	0	977
15361	730	15	9	5	0	759
15362	699	4	2	0	0	705
15363	702	1	1	2	0	706
15364	9	696	0	2	0	707
15365	688	8	0	1	0	697
15366	6	3	1	677	0	687
15367	658	1	0	9	0	668
15368	5	637	3	3	0	648
15369	636	8	0	1	0	645
15370	651	4	0	3	0	658
15371	10	668	1	1	0	680
15372	3	7	671	1	0	682
15373	3	5	7	736	0	751
15374	4	3	775	10	0	792
15375	3	0	14	801	0	818
15376	3	2	4	852	0	861
15377	0	2	845	23	0	870
15378	3	2	17	886	0	908
15379	882	0	4	22	0	908
15380	20	0	894	5	0	919
15381	7	890	17	1	0	915
15382	4	20	6	876	0	906
15383	2	4	0	914	0	920
15384	1	1	883	24	0	909
15385	3	0	17	867	0	887
15386	0	873	4	19	0	896
15387	848	18	2	3	0	871
15388	17	847	2	3	0	869
15389	789	19	1	1	0	810
15390	18	796	2	0	0	816
15391	3	822	0	3	0	828
15392	0	18	754	3	0	775
15393	3	6	18	752	0	779
15394	1	1	4	751	0	757
15395	2	0	1	764	0	767
15396	1	798	3	19	0	821
15397	1	18	0	808	0	827
15398	802	3	0	23	0	828
15399	19	2	2	806	0	829
15400	804	2	1	23	0	830
15401	21	0	800	7	0	828
15402	815	1	21	3	0	840
15403	23	2	4	811	0	840
15404	4	3	1	857	0	865
15405	861	1	1	24	0	887
15406	24	4	860	7	0	895
15407	6	851	20	4	0	881
15408	2	23	5	864	0	894
15409	860	3	1	28	0	892
15410	879	3	3	5	0	890
15411	27	1	2	866	0	896
15412	3	3	861	26	0	893
15413	818	1	21	7	0	847
15414	25	3	832	2	0	862
15415	4	1	23	833	0	861
15416	3	1	823	24	0	851
15417	1	3	23	814	0	841
15418	2	1	792	24	0	819
15419	1	804	20	6	0	831
15420	2	22	5	752	0	781
15421	3	804	2	21	0	830
15422	813	22	2	4	0	841
15423	825	5	1	3	0	834
15424	25	1	793	2	0	821
15425	8	1	20	800	0	829
15426	810	1	3	24	0	838
15427	21	0	2	799	0	822
15428	6	0	2	809	0	817
15429	3	2	788	26	0	819
15430	772	1	23	9	0	805
15431	23	1	789	7	0	820
15432	7	0	22	790	0	819
15433	1	1	791	24	0	817
15434	799	0	24	7	0	830
15435	813	1	8	3	0	825
15436	811	2	4	3	0	820
15437	26	2	3	789	0	820
15438	7	1	771	26	0	805
15439	4	2	781	5	0	792
15440	1	1	23	749	0	774
15441	3	775	6	20	0	804
15442	752	21	4	6	0	783
15443	21	6	2	756	0	785
15444	6	2	743	26	0	777
15445	7	5	20	746	0	778
15446	5	2	759	22	0	788
15447	2	4	27	771	0	804
15448	5	1	764	24	0	794
15449	2	2	788	9	0	801
15450	3	771	27	5	0	806
15451	2	21	769	4	0	796
15452	4	3	779	5	0	791
15453	5	2	29	693	0	729
15454	2	1	6	734	0	743
15455	4	737	6	18	0	765
15456	749	19	4	7	0	779
15457	23	740	4	2	0	769
15458	6	21	1	750	0	778
15459	745	4	2	26	0	777
15460	24	3	4	749	0	780
15461	750	1	6	22	0	779
15462	25	4	3	751	0	783
15463	7	1	774	28	0	810
15464	10	1	20	777	0	808
15465	6	0	9	797	0	812
15466	779	2	3	33	0	817
15467	800	1	7	6	0	814
15468	806	1	4	6	0	817
15469	25	766	4	9	0	804
15470	5	781	4	5	0	795
15471	771	19	8	3	0	801
15472	22	4	770	6	0	802
15473	4	3	719	2	0	728
15474	3	17	19	648	0	687
15475	3	1	641	10	0	655
15476	2	2	608	5	0	617
15477	571	5	11	6	0	593
15478	569	1	3	5	0	578
15479	11	560	4	3	0	578
15480	3	574	4	1	0	582
15481	3	9	1	531	0	544
15482	2	567	2	11	0	582
15483	590	9	4	4	0	607
15484	13	1	1	575	0	590
15485	6	589	2	9	0	606
15486	597	11	2	5	0	615
15487	8	5	598	2	0	613
15488	4	1	586	6	0	597
15489	592	3	9	1	0	605
15490	15	1	588	1	0	605
15491	587	1	7	3	0	598
15492	9	6	4	589	0	608
15493	8	1	593	8	0	610
15494	1	582	12	6	0	601
15495	1	596	7	1	0	605
15496	539	11	2	2	0	554
15497	9	557	3	2	0	571
15498	538	7	3	1	0	549
15499	530	3	2	4	0	539
15500	10	524	4	2	0	540
15501	5	6	3	525	0	539
15502	1	4	547	7	0	559
15503	4	547	7	3	0	561
15504	3	25	3	528	0	559
15505	5	4	4	572	0	585
15506	573	2	0	4	0	579
15507	2	2	1	570	0	575
15508	1	1	562	4	0	568
15509	2	559	6	2	0	569
15510	1	8	1	565	0	575
15511	567	0	0	6	0	573
15512	582	0	0	6	0	588
15513	7	0	2	587	0	596
15514	594	0	1	7	0	602
15515	5	0	602	0	0	607
15516	0	3	6	603	0	612
15517	1	0	601	8	0	610
15518	5	0	6	659	0	670
15519	6	0	2	652	0	660
15520	0	1	1	657	0	659
15521	3	1	1	653	0	658
15522	1	0	4	649	0	654
15523	646	1	0	11	0	658
15524	648	1	4	6	0	659
15525	7	651	2	3	0	663
15526	655	8	0	7	0	670
15527	6	1	1	661	0	669
15528	3	2	1	665	0	671
15529	2	2	0	669	0	673
15530	6	0	669	9	0	684
15531	10	0	7	655	0	672
15532	2	677	1	11	0	691
15533	678	7	1	5	0	691
15534	672	0	4	5	0	681
15535	7	2	663	8	0	680
15536	1	663	10	8	0	682
15537	1	7	3	675	0	686
15538	2	1	672	13	0	688
15539	2	4	7	640	0	653
15540	6	659	0	13	0	678
15541	662	7	2	2	0	673
15542	10	656	4	3	0	673
15543	4	11	660	1	0	676
15544	0	2	657	8	0	667
15545	2	643	11	9	0	665
15546	1	643	0	8	0	652
15547	624	10	2	6	0	642
15548	630	0	2	4	0	636
15549	9	4	2	620	0	635
15550	2	1	616	9	0	628
15551	4	3	9	617	0	633
15552	7	4	0	612	0	623
15553	613	4	2	8	0	627
15554	614	1	2	2	0	619
15555	12	1	1	632	0	646
15556	1	0	652	13	0	666
15557	0	662	12	5	0	679
15558	654	8	2	6	0	670
15559	11	671	0	3	0	685
15560	8	9	1	679	0	697
15561	3	2	3	694	0	702
15562	1	1	6	690	0	698
15563	2	4	4	661	0	671
15564	655	6	2	11	0	674
15565	12	5	0	651	0	668
15566	8	646	0	10	0	664
15567	4	7	1	655	0	667
15568	626	3	3	19	0	651
15569	7	628	2	9	0	646
15570	6	7	0	634	0	647
15571	7	1	618	9	0	635
15572	616	1	7	8	0	632
15573	10	1	4	623	0	638
15574	5	3	612	13	0	633
15575	3	2	603	4	0	612
15576	3	4	8	607	0	622
15577	602	2	7	10	0	621
15578	602	3	1	8	0	614
15579	10	611	1	9	0	631
15580	604	6	2	7	0	619
15581	611	3	2	8	0	624
15582	613	1	3	6	0	623
15583	606	2	1	4	0	613
15584	12	1	1	595	0	609
15585	4	5	1	592	0	602
15586	5	2	574	12	0	593
15587	3	553	7	6	0	569
15588	2	567	4	4	0	577
15589	7	8	579	4	0	598
15590	565	2	11	4	0	582
15591	10	1	4	575	0	590
15592	575	4	4	12	0	595
15593	571	1	4	8	0	584
15594	11	2	560	4	0	577
15595	4	2	7	564	0	577
15596	567	4	2	8	0	581
15597	11	1	2	558	0	572
15598	8	3	551	6	0	568
15599	6	19	6	522	0	553
15600	7	562	5	6	0	580
15601	5	567	2	4	0	578
15602	2	7	545	3	0	557
15603	1	539	7	7	0	554
15604	488	13	8	5	0	514
15605	468	4	1	2	0	475
15606	10	0	1	458	0	469
15607	4	2	1	460	0	467
15608	3	2	1	469	0	475
15609	460	3	0	9	0	472
15610	9	461	2	3	0	475
15611	454	8	1	2	0	465
15612	448	4	2	3	0	457
15613	10	447	3	2	0	462
15614	424	6	0	2	0	432
15615	8	424	1	3	0	436
15616	425	5	2	1	0	433
15617	4	3	416	4	0	427
15618	357	2	7	3	0	369
15619	7	358	3	1	0	369
15620	9	3	4	356	0	372
15621	1	6	1	375	0	383
15622	6	0	0	379	0	385
15623	383	2	0	10	0	395
15624	8	0	1	390	0	399
15625	7	0	380	7	0	394
15626	378	2	5	7	0	392
15627	7	3	386	3	0	399
15628	4	3	7	387	0	401
15629	6	2	387	6	0	401
15630	3	4	4	372	0	383
15631	3	372	7	5	0	387
15632	0	5	2	375	0	382
15633	1	375	3	4	0	383
15634	2	4	1	380	0	387
15635	378	7	1	5	0	391
15636	3	2	0	403	0	408
15637	405	2	0	4	0	411
15638	6	1	387	7	0	401
15639	399	2	4	2	0	407
15640	395	0	5	5	0	405
15641	399	2	0	2	0	403
15642	9	1	3	396	0	409
15643	397	0	2	4	0	403
15644	5	0	381	5	0	391
15645	391	3	3	2	0	399
15646	4	1	383	3	0	391
15647	389	1	3	3	0	396
15648	5	1	6	385	0	397
15649	10	0	384	4	0	398
15650	3	0	5	391	0	399
15651	3	1	6	385	0	395
15652	3	0	388	10	0	401
15653	375	0	6	5	0	386
15654	5	397	5	7	0	414
15655	381	3	0	2	0	386
15656	4	362	2	0	0	368
15657	348	3	3	3	0	357
15658	5	5	348	0	0	358
15659	324	1	6	5	0	336
15660	5	318	3	0	0	326
15661	4	3	1	311	0	319
15662	1	2	2	318	0	323
15663	2	0	0	324	0	326
15664	0	2	320	6	0	328
15665	0	0	3	321	0	324
15666	0	0	347	6	0	353
15667	376	0	4	4	0	384
15668	397	0	4	1	0	402
15669	6	0	1	400	0	407
15670	4	0	408	3	0	415
15671	412	1	4	2	0	419
15672	6	0	525	1	0	532
15673	3	0	7	530	0	540
15674	1	0	5	543	0	549
15675	2	1	0	557	0	560
15676	0	0	2	560	0	562
15677	542	1	0	11	0	554
15678	5	552	0	7	0	564
15679	3	5	529	3	0	540
15680	0	534	7	4	0	545
15681	546	5	4	0	0	555
15682	6	5	1	543	0	555
15683	549	0	2	6	0	557
15684	7	1	0	547	0	555
15685	8	0	1	552	0	561
15686	3	0	1	560	0	564
15687	4	1	548	7	0	560
15688	0	532	6	6	0	544
15689	1	5	549	4	0	559
15690	0	3	5	549	0	557
15691	555	0	4	8	0	567
15692	551	1	0	6	0	558
15693	554	1	3	0	0	558
15694	7	545	1	3	0	556
15695	558	6	0	1	0	565
15696	8	4	1	550	0	563
15697	7	0	0	556	0	563
15698	1	3	0	556	0	560
15699	4	548	0	8	0	560
15700	0	5	0	526	0	531
15701	2	540	0	8	0	550
15702	529	6	2	3	0	540
15703	539	5	2	0	0	546
15704	9	3	1	543	0	556
15705	4	2	542	7	0	555
15706	543	0	4	5	0	552
15707	10	0	3	548	0	561
15708	6	0	548	8	0	562
15709	546	0	7	5	0	558
15710	8	0	1	553	0	562
15711	549	0	1	9	0	559
15712	6	548	2	4	0	560
15713	5	5	1	540	0	551
15714	1	558	1	9	0	569
15715	4	9	0	567	0	580
15716	1	581	1	6	0	589
15717	1	5	3	591	0	600
15718	2	4	583	5	0	594
15719	529	0	5	7	0	541
15720	5	577	2	4	0	588
15721	1	3	561	2	0	567
15722	555	1	3	2	0	561
15723	5	1	1	568	0	575
15724	1	0	565	3	0	569
15725	1	574	4	1	0	580
15726	1	3	1	583	0	588
15727	2	1	582	4	0	589
15728	1	1	3	587	0	592
15729	3	0	3	589	0	595
15730	2	0	609	6	0	617
15731	0	1	5	607	0	613
15732	1	1	625	4	0	631
15733	2	0	6	624	0	632
15734	0	0	657	9	0	666
15735	3	0	5	667	0	675
15736	1	2	1	661	0	665
15737	0	0	2	659	0	661
15738	3	652	0	6	0	661
15739	650	6	0	3	0	659
15740	659	2	3	2	0	666
15741	7	1	2	672	0	682
15742	686	0	3	6	0	695
15743	6	1	690	3	0	700
15744	3	704	5	2	0	714
15745	716	5	3	4	0	728
15746	7	731	2	2	0	742
15747	1	5	0	742	0	748
15748	3	1	5	739	0	748
15749	725	5	0	7	0	737
15750	5	0	3	740	0	748
15751	1	0	739	9	0	749
15752	3	743	5	3	0	754
15753	743	4	1	4	0	752
15754	5	1	2	731	0	739
15755	2	754	0	5	0	761
15756	7	3	1	748	0	759
15757	0	764	1	5	0	770
15758	759	3	3	2	0	767
15759	755	2	1	3	0	761
15760	6	1	753	2	0	762
15761	3	1	751	4	0	759
15762	1	5	4	761	0	771
15763	3	778	1	4	0	786
15764	5	3	1	789	0	798
15765	792	1	0	8	0	801
15766	4	0	768	4	0	776
15767	5	0	8	710	0	723
15768	0	2	725	6	0	733
15769	3	1	704	2	0	710
15770	2	741	4	1	0	748
15771	11	8	1	710	0	730
15772	614	2	0	3	0	619
15773	2	0	614	0	0	616
15774	0	607	1	1	0	609
15775	610	1	1	1	0	613
15776	2	0	0	604	0	606
15777	631	0	0	1	0	632
15778	643	0	0	1	0	644
15779	636	0	0	1	0	637
15780	1	0	666	0	0	667
15781	650	0	1	2	0	653
15782	677	0	0	1	0	678
15783	2	695	2	0	0	699
15784	1	2	0	702	0	705
15785	0	0	0	690	0	690
15786	0	1	0	705	0	706
15787	712	0	0	3	0	715
15788	692	0	0	1	0	693
15789	2	1	713	1	0	717
15790	1	0	2	707	0	710
15791	1	706	1	2	0	710
15792	717	2	1	0	0	720
15793	2	0	727	1	0	730
15794	0	1	2	727	0	730
15795	1	0	0	728	0	729
15796	0	728	2	2	0	732
15797	0	2	0	740	0	742
15798	1	0	0	716	0	717
15799	0	1	0	745	0	746
15800	740	0	0	5	0	745
15801	2	1	0	738	0	741
15802	1	1	0	736	0	738
15803	743	0	0	3	0	746
15804	2	0	0	761	0	763
15805	4	849	0	5	0	858
15806	885	6	0	0	0	891
15807	941	2	0	2	0	945
15808	975	1	0	1	0	977
15809	1064	0	0	0	0	1064
15810	14	1112	0	0	0	1126
15811	1260	12	0	0	0	1272
15812	1276	3	0	7	0	1286
15813	17	1	0	1272	0	1290
15814	4	0	1252	14	0	1270
15815	6	0	13	1240	0	1259
15816	1	0	3	1257	0	1261
15817	2	0	0	1233	0	1235
15818	3	1	1	1229	0	1234
15819	3	0	0	1241	0	1244
15820	1221	0	0	20	0	1241
15821	14	0	0	1223	0	1237
15822	3	0	1255	17	0	1275
15823	3	0	14	1238	0	1255
15824	1	1248	4	18	0	1271
15825	2	15	1	1252	0	1270
15826	0	2	1244	17	0	1263
15827	1170	0	13	7	0	1190
15828	1225	1	3	2	0	1231
15829	19	1	1283	3	0	1306
15830	6	1258	16	1	0	1281
15831	1276	12	3	4	0	1295
15832	1300	6	2	3	0	1311
15833	1300	1	0	4	0	1305
15834	1269	1	1	1	0	1272
15835	26	0	0	1242	0	1268
15836	8	1	1230	19	0	1258
15837	4	2	17	1236	0	1259
15838	6	1	4	1262	0	1273
15839	4	0	1247	25	0	1276
15840	2	0	1237	9	0	1248
15841	1222	0	22	8	0	1252
15842	19	1216	5	7	0	1247
15843	12	16	2	1225	0	1255
15844	4	5	1197	23	0	1229
15845	1159	1	19	15	0	1194
15846	17	1	1178	6	0	1202
15847	1171	2	19	8	0	1200
15848	15	1193	5	10	0	1223
15849	7	16	3	1203	0	1229
15850	3	6	1179	23	0	1211
15851	1138	5	17	11	0	1171
15852	20	1165	5	6	0	1196
15853	8	1227	5	5	0	1245
15854	6	21	7	1220	0	1254
15855	6	7	1	1254	0	1268
15856	1302	7	2	26	0	1337
15857	21	1301	2	10	0	1334
15858	12	19	5	1320	0	1356
15859	1322	3	2	22	0	1349
15860	1346	3	2	8	0	1359
15861	1369	5	4	7	0	1385
15862	28	3	1387	6	0	1424
15863	14	2	1413	4	0	1433
15864	1489	0	26	4	0	1519
15865	32	1470	7	3	0	1512
15866	11	1507	7	4	0	1529
15867	9	32	5	1459	0	1505
15868	8	1480	5	24	0	1517
15869	1477	30	2	11	0	1520
15870	27	9	4	1455	0	1495
15871	9	5	1463	25	0	1502
15872	1462	3	25	13	0	1503
15873	1493	5	8	8	0	1514
15874	32	4	5	1471	0	1512
15875	8	4	8	1491	0	1511
15876	11	3	5	1490	0	1509
15877	10	2	5	1466	0	1483
15878	7	4	1423	38	0	1472
15879	5	1413	23	18	0	1459
15880	8	28	5	1348	0	1389
15881	5	1392	6	36	0	1439
15882	12	25	6	1323	0	1366
15883	12	1374	4	24	0	1414
15884	1378	33	1	14	0	1426
15885	1381	9	4	12	0	1406
15886	31	1369	8	15	0	1423
15887	1379	26	4	8	0	1417
15888	36	9	3	1367	0	1415
15889	1351	7	7	28	0	1393
15890	33	1339	4	12	0	1388
15891	1352	27	1	8	0	1388
15892	1370	11	6	7	0	1394
15893	39	6	6	1333	0	1384
15894	13	7	1317	29	0	1366
15895	14	1311	26	13	0	1364
15896	12	26	11	1330	0	1379
15897	1330	9	7	31	0	1377
15898	31	9	1323	13	0	1376
15899	12	9	26	1324	0	1371
15900	11	3	10	1344	0	1368
15901	1334	2	7	36	0	1379
15902	1343	5	6	14	0	1368
15903	1318	6	6	11	0	1341
15904	36	1278	6	11	0	1331
15905	1190	25	2	10	0	1227
15906	27	6	1145	11	0	1189
15907	7	8	1091	11	0	1117
15908	7	6	1061	13	0	1087
15909	20	41	24	915	0	1000
15910	5	8	910	13	0	936
15911	755	2	16	4	0	777
15912	11	3	2	775	0	791
15913	6	3	783	12	0	804
15914	811	2	9	4	0	826
15915	15	1	3	806	0	825
15916	4	4	4	819	0	831
15917	824	2	1	13	0	840
15918	13	1	3	833	0	850
15919	4	4	844	14	0	866
15920	5	1	9	857	0	872
15921	4	3	866	13	0	886
15922	6	1	12	833	0	852
15923	814	1	5	14	0	834
15924	8	797	4	11	0	820
15925	5	813	3	8	0	829
15926	9	10	0	810	0	829
15927	5	4	1	818	0	828
15928	1	786	2	14	0	803
15929	6	752	1	7	0	766
15930	4	10	1	741	0	756
15931	4	8	2	741	0	755
15932	721	3	3	9	0	736
15933	8	716	3	5	0	732
15934	5	706	2	9	0	722
15935	5	730	0	3	0	738
15936	704	12	3	3	0	722
15937	9	6	707	0	0	722
15938	699	4	9	5	0	717
15939	12	1	4	696	0	713
15940	5	676	2	10	0	693
15941	6	702	3	5	0	716
15942	704	10	1	6	0	721
15943	11	3	3	695	0	712
15944	3	739	2	11	0	755
15945	746	9	2	6	0	763
15946	750	2	2	6	0	760
15947	13	3	725	5	0	746
15948	735	1	10	3	0	749
15949	743	3	3	2	0	751
15950	11	2	4	728	0	745
15951	3	712	4	12	0	731
15952	5	719	3	3	0	730
15953	0	17	0	689	0	706
15954	678	4	0	9	0	691
15955	8	4	638	3	0	653
15956	5	3	577	2	0	587
15957	4	2	575	3	0	584
15958	11	0	577	2	0	590
15959	1	586	9	0	0	596
15960	1	577	3	2	0	583
15961	6	6	508	1	0	521
15962	1	3	493	4	0	501
15963	1	422	5	0	0	428
15964	0	5	1	382	0	388
15965	0	1	406	2	0	409
15966	1	0	1	410	0	412
15967	1	0	1	432	0	434
15968	1	0	0	447	0	448
15969	1	0	0	480	0	481
15970	0	0	484	3	0	487
15971	1	0	2	459	0	462
15972	470	0	1	5	0	476
15973	2	0	467	1	0	470
15974	481	0	2	1	0	484
15975	5	0	1	488	0	494
15976	1	0	498	1	0	500
15977	498	0	2	1	0	501
15978	2	0	2	504	0	508
15979	513	0	1	3	0	517
15980	4	1	0	503	0	508
15981	1	505	1	4	0	511
15982	1	2	530	1	0	534
15983	0	2	2	528	0	532
15984	534	0	1	4	0	539
15985	535	0	1	1	0	537
15986	533	0	1	1	0	535
15987	536	0	1	1	0	538
15988	529	0	1	0	0	530
15989	4	523	2	0	0	529
15990	531	3	0	1	0	535
15991	4	2	530	0	0	536
15992	530	2	3	0	0	535
15993	4	1	1	520	0	526
15994	1	2	526	3	0	532
15995	1	0	523	3	0	527
15996	1	1	4	529	0	535
15997	535	1	2	4	0	542
15998	2	522	1	2	0	527
15999	521	2	0	4	0	527
16000	4	532	0	1	0	537
16001	1	4	1	556	0	562
16002	1	2	0	561	0	564
16003	566	2	0	3	0	571
16004	3	0	1	567	0	571
16005	2	0	566	4	0	572
16006	555	0	3	2	0	560
16007	3	0	1	573	0	577
16008	3	1	1	575	0	580
16009	1	1	568	5	0	575
16010	545	0	3	3	0	551
16011	569	0	1	3	0	573
16012	4	558	2	1	0	565
16013	2	3	548	0	0	553
16014	2	1	518	1	0	522
16015	2	1	5	518	0	526
16016	1	2	2	522	0	527
16017	2	516	1	3	0	522
16018	1	4	514	2	0	521
16019	1	3	3	498	0	505
16020	0	3	516	3	0	522
16021	4	0	4	494	0	502
16022	0	512	1	4	0	517
16023	1	3	1	523	0	528
16024	1	0	0	527	0	528
16025	0	1	0	521	0	522
16026	519	0	1	7	0	527
16027	3	1	521	2	0	527
16028	1	544	3	2	0	550
16029	2	4	0	575	0	581
16030	592	1	1	4	0	598
16031	5	2	0	604	0	611
16032	608	0	0	8	0	616
16033	5	0	628	2	0	635
16034	629	0	4	2	0	635
16035	6	0	4	649	0	659
16036	5	0	656	5	0	666
16037	2	652	5	5	0	664
16038	0	6	2	654	0	662
16039	2	4	2	659	0	667
16040	650	1	1	12	0	664
16041	7	652	0	5	0	664
16042	5	635	0	1	0	641
16043	2	659	0	2	0	663
16044	632	8	0	2	0	642
16045	5	630	0	0	0	635
16046	5	6	0	620	0	631
16047	2	4	0	625	0	631
16048	619	1	1	8	0	629
16049	5	613	0	7	0	625
16050	4	4	0	629	0	637
16051	651	4	1	5	0	661
16052	647	1	0	3	0	651
16053	655	0	0	2	0	657
16054	10	646	0	0	0	656
16055	626	4	0	0	0	630
16056	5	4	0	621	0	630
16057	4	609	0	5	0	618
16058	1	621	0	5	0	627
16059	1	7	0	622	0	630
16060	621	5	0	3	0	629
16061	632	1	0	6	0	639
16062	7	0	1	625	0	633
16063	6	624	0	3	0	633
16064	634	3	0	5	0	642
16065	3	3	628	2	0	636
16066	6	1	592	0	0	599
16067	595	1	7	0	0	603
16068	3	0	596	0	0	599
16069	4	0	3	553	0	560
16070	564	0	4	4	0	572
16071	4	0	0	572	0	576
16072	3	0	565	5	0	573
16073	0	575	5	3	0	583
16074	0	4	4	585	0	593
16075	0	4	582	5	0	591
16076	562	0	8	5	0	575
16077	5	0	4	571	0	580
16078	4	0	573	5	0	582
16079	0	0	4	567	0	571
16080	0	559	4	4	0	567
16081	0	5	0	584	0	589
16082	0	4	0	574	0	578
16083	1	0	0	571	0	572
16084	0	562	0	9	0	571
16085	580	5	0	5	0	590
16086	4	4	0	593	0	601
16087	4	0	0	597	0	601
16088	0	0	0	605	0	605
16089	0	1	594	9	0	604
16090	0	0	5	603	0	608
16091	612	0	4	5	0	621
16092	5	601	0	4	0	610
16093	4	5	0	629	0	638
16094	0	4	0	636	0	640
16095	627	0	0	9	0	636
16096	5	633	0	7	0	645
16097	651	5	0	0	0	656
16098	654	6	0	0	0	660
16099	10	0	0	648	0	658
16100	648	0	0	7	0	655
16101	5	619	0	6	0	630
16102	627	5	0	3	0	635
16103	8	6	0	634	0	648
16104	701	0	0	5	0	706
16105	714	0	0	8	0	722
16106	18	1	707	1	0	727
16107	726	1	8	1	0	736
16108	763	0	5	1	0	769
16109	829	0	0	4	0	833
16110	24	0	848	0	0	872
16111	5	851	19	3	0	878
16112	3	23	8	866	0	900
16113	867	6	2	23	0	898
16114	21	862	0	10	0	893
16115	879	24	0	4	0	907
16116	27	8	0	883	0	918
16117	9	2	877	24	0	912
16118	894	1	24	9	0	928
16119	27	0	7	909	0	943
16120	8	0	892	22	0	922
16121	900	0	24	10	0	934
16122	27	0	912	2	0	941
16123	10	0	25	954	0	989
16124	6	0	7	1007	0	1020
16125	989	0	2	41	0	1032
16126	1012	0	1	14	0	1027
16127	42	1000	0	2	0	1044
16128	992	29	2	2	0	1025
16129	35	9	950	1	0	995
16130	10	4	953	3	0	970
16131	930	2	37	2	0	971
16132	29	932	13	5	0	979
16133	917	28	3	3	0	951
16134	29	911	0	2	0	942
16135	909	28	0	2	0	939
16136	31	8	0	893	0	932
16137	11	2	898	26	0	937
16138	5	1	26	893	0	925
16139	2	0	8	933	0	943
16140	900	0	4	38	0	942
16141	30	1	886	12	0	929
16142	888	0	28	4	0	920
16143	31	882	7	3	0	923
16144	880	25	4	3	0	912
16145	36	7	0	871	0	914
16146	14	2	868	29	0	913
16147	8	3	27	867	0	905
16148	871	1	9	31	0	912
16149	32	4	5	870	0	911
16150	11	3	1	873	0	888
16151	10	828	0	35	0	873
16152	3	30	3	842	0	878
16153	8	7	831	30	0	876
16154	1	5	29	845	0	880
16155	9	0	9	865	0	883
16156	832	3	2	37	0	874
16157	31	0	4	842	0	877
16158	10	0	822	34	0	866
16159	6	823	31	10	0	870
16160	6	26	8	827	0	867
16161	2	9	3	844	0	858
16162	824	3	2	36	0	865
16163	34	788	2	12	0	836
16164	16	28	4	807	0	855
16165	786	13	0	32	0	831
16166	820	3	5	10	0	838
16167	41	0	4	797	0	842
16168	18	2	799	28	0	847
16169	818	3	25	9	0	855
16170	32	6	6	830	0	874
16171	834	4	5	27	0	870
16172	845	4	2	14	0	865
16173	36	801	3	5	0	845
16174	792	24	3	10	0	829
16175	30	794	5	7	0	836
16176	10	29	0	799	0	838
16177	9	7	1	809	0	826
16178	11	786	4	32	0	833
16179	799	27	7	12	0	845
16180	812	11	4	6	0	833
16181	36	8	773	9	0	826
16182	20	1	785	4	0	810
16183	4	5	33	782	0	824
16184	780	2	12	35	0	829
16185	31	3	3	784	0	821
16186	14	2	1	811	0	828
16187	6	2	794	42	0	844
16188	2	2	808	18	0	830
16189	3	3	815	9	0	830
16190	787	1	33	10	0	831
16191	797	0	15	9	0	821
16192	36	759	4	10	0	809
16193	15	788	1	6	0	810
16194	12	31	1	764	0	808
16195	3	11	764	31	0	809
16196	752	4	30	10	0	796
16197	30	4	762	12	0	808
16198	9	1	30	766	0	806
16199	9	1	6	799	0	815
16200	9	2	2	803	0	816
16201	1	6	3	814	0	824
16202	782	0	4	40	0	826
16203	31	2	2	769	0	804
16204	12	0	726	29	0	767
16205	706	0	21	12	0	739
16206	28	1	710	6	0	745
16207	7	2	719	6	0	734
16208	8	674	26	5	0	713
16209	13	16	8	556	0	593
16210	543	4	1	17	0	565
16211	13	2	1	548	0	564
16212	4	1	545	14	0	564
16213	3	3	11	556	0	573
16214	546	0	4	17	0	567
16215	12	545	3	5	0	565
16216	540	12	1	2	0	555
16217	12	532	0	4	0	548
16218	518	12	2	1	0	533
16219	14	503	2	2	0	521
16220	3	520	6	2	0	531
16221	2	14	497	2	0	515
16222	3	491	11	0	0	505
16223	418	10	3	1	0	432
16224	10	1	1	411	0	423
16225	410	1	0	9	0	420
16226	9	419	1	0	0	429
16227	409	9	0	1	0	419
16228	9	1	404	0	0	414
16229	0	2	9	409	0	420
16230	3	397	1	7	0	408
16231	1	7	2	408	0	418
16232	3	0	0	422	0	425
16233	490	2	0	9	0	501
16234	10	491	1	4	0	506
16235	496	12	1	2	0	511
16236	15	1	499	2	0	517
16237	1	1	499	2	0	503
16238	2	500	13	1	0	516
16239	3	12	2	503	0	520
16240	0	1	506	11	0	518
16241	4	2	14	496	0	516
16242	0	3	1	525	0	529
16243	1	1	503	17	0	522
16244	3	1	508	2	0	514
16245	0	1	536	5	0	542
16246	2	1	539	1	0	543
16247	1	557	13	3	0	574
16248	4	12	3	552	0	571
16249	1	3	4	570	0	578
16250	2	4	561	15	0	582
16251	2	4	14	556	0	576
16252	3	1	585	16	0	605
16253	1	3	16	584	0	604
16254	2	2	2	584	0	590
16255	0	587	6	15	0	608
16256	1	15	2	591	0	609
16257	4	1	2	600	0	607
16258	0	3	3	600	0	606
16259	3	0	584	16	0	603
16260	0	585	15	3	0	603
16261	589	13	0	6	0	608
16262	599	1	4	3	0	607
16263	15	4	2	581	0	602
16264	2	2	2	577	0	583
16265	2	586	2	13	0	603
16266	584	13	0	8	0	605
16267	15	595	2	5	0	617
16268	578	19	1	1	0	599
16269	18	2	569	0	0	589
16270	551	2	15	4	0	572
16271	16	576	4	2	0	598
16272	0	14	3	579	0	596
16273	2	3	1	584	0	590
16274	2	567	2	15	0	586
16275	575	13	0	8	0	596
16276	14	1	0	596	0	611
16277	1	2	3	607	0	613
16278	600	2	3	14	0	619
16279	607	2	3	3	0	615
16280	16	0	602	3	0	621
16281	604	4	14	2	0	624
16282	15	1	1	612	0	629
16283	2	1	631	15	0	649
16284	3	1	15	618	0	637
16285	1	0	623	20	0	644
16286	3	1	627	1	0	632
16287	3	1	13	612	0	629
16288	1	1	626	15	0	643
16289	2	636	17	5	0	660
16290	0	13	1	648	0	662
16291	0	1	3	676	0	680
16292	0	2	664	18	0	684
16293	0	670	15	4	0	689
16294	668	14	2	3	0	687
16295	13	2	3	674	0	692
16296	680	2	1	16	0	699
16297	14	672	1	4	0	691
16298	2	13	686	3	0	704
16299	2	3	12	687	0	704
16300	686	1	1	15	0	703
16301	12	1	689	3	0	705
16302	676	0	15	3	0	694
16303	15	694	2	4	0	715
16304	1	685	3	0	0	689
16305	689	9	5	1	0	704
16306	8	2	1	678	0	689
16307	4	1	2	680	0	687
16308	1	696	0	8	0	705
16309	1	7	0	711	0	719
16310	0	1	1	715	0	717
16311	705	0	1	9	0	715
16312	7	1	0	695	0	703
16313	2	2	690	8	0	702
16314	1	0	8	693	0	702
16315	2	0	1	709	0	712
16316	0	1	704	8	0	713
16317	2	3	8	709	0	722
16318	699	0	1	10	0	710
16319	694	0	1	3	0	698
16320	693	0	1	4	0	698
16321	10	0	0	698	0	708
16322	3	2	690	6	0	701
16323	2	698	7	3	0	710
16324	0	7	1	709	0	717
16325	1	2	711	7	0	721
16326	1	1	8	687	0	697
16327	1	0	1	709	0	711
16328	695	1	1	9	0	706
16329	7	713	1	4	0	725
16330	2	7	707	1	0	717
16331	675	2	8	3	0	688
16332	10	698	2	0	0	710
16333	1	626	1	1	0	629
16334	661	4	0	2	0	667
16335	7	1	1	664	0	673
16336	2	0	729	4	0	735
16337	0	0	7	729	0	736
16338	1	729	2	6	0	738
16339	738	5	0	3	0	746
16340	6	1	1	742	0	750
16341	770	0	0	8	0	778
16342	7	0	1	778	0	786
16343	1	790	1	6	0	798
16344	808	6	0	3	0	817
16345	813	1	0	1	0	815
16346	7	802	0	0	0	809
16347	785	6	1	1	0	793
16348	6	1	0	780	0	787
16349	1	771	2	5	0	779
16350	777	8	0	2	0	787
16351	7	778	0	1	0	786
16352	780	6	0	2	0	788
16353	6	2	0	784	0	792
16354	796	2	0	6	0	804
16355	802	1	0	3	0	806
16356	811	0	0	5	0	816
16357	8	1	0	810	0	819
16358	3	0	1	820	0	824
16359	814	0	0	8	0	822
16360	7	2	816	2	0	827
16361	2	0	6	819	0	827
16362	0	823	2	6	0	831
16363	3	7	0	838	0	848
16364	0	2	1	844	0	847
16365	1	0	829	10	0	840
16366	3	3	6	879	0	891
16367	1	956	2	6	0	965
16368	2	6	0	985	0	993
16369	0	7	1094	8	0	1109
16370	3	0	10	1106	0	1119
16371	0	1	10	1136	0	1147
16372	1122	0	2	26	0	1150
16373	1123	1	1	13	0	1138
16374	25	0	1	1129	0	1155
16375	14	1071	1	17	0	1103
16376	3	1091	1	15	0	1110
16377	3	19	1094	4	0	1120
16378	4	16	12	1093	0	1125
16379	1098	2	13	17	0	1130
16380	15	3	4	1110	0	1132
16381	13	3	1099	15	0	1130
16382	6	2	13	1104	0	1125
16383	5	1	12	1097	0	1115
16384	5	1	3	1123	0	1132
16385	2	1	1084	29	0	1116
16386	2	1090	13	17	0	1122
16387	1077	12	12	6	0	1107
16388	1079	13	4	5	0	1101
16389	27	4	2	1050	0	1083
16390	18	5	1039	14	0	1076
16391	7	1049	12	13	0	1081
16392	4	20	11	1025	0	1060
16393	5	1050	4	11	0	1070
16394	4	1059	2	10	0	1075
16395	1056	24	1	4	0	1085
16396	14	18	1044	4	0	1080
16397	14	5	1039	5	0	1063
16398	9	3	23	1033	0	1068
16399	6	5	13	1049	0	1073
16400	3	1	1052	26	0	1082
16401	3	3	14	1036	0	1056
16402	1	4	1040	18	0	1063
16403	993	0	16	18	0	1027
16404	14	1	14	1011	0	1040
16405	12	2	1029	15	0	1058
16406	6	2	14	1005	0	1027
16407	3	1059	13	19	0	1094
16408	1058	12	8	15	0	1093
16409	14	1070	2	8	0	1094
16410	1077	16	3	8	0	1104
16411	17	12	1061	6	0	1096
16412	1079	3	14	3	0	1099
16413	16	2	13	1095	0	1126
16414	14	3	1098	16	0	1131
16415	7	4	14	1093	0	1118
16416	5	1	1077	19	0	1102
16417	1028	1	16	20	0	1065
16418	18	1091	11	5	0	1125
16419	18	14	5	1059	0	1096
16420	3	1103	6	13	0	1125
16421	1092	16	3	15	0	1126
16422	1095	12	5	6	0	1118
16423	25	1101	1	11	0	1138
16424	19	14	5	1112	0	1150
16425	7	13	2	1121	0	1143
16426	4	6	2	1125	0	1137
16427	1100	1	2	32	0	1135
16428	15	1088	2	19	0	1124
16429	14	14	1	1081	0	1110
16430	6	13	2	1090	0	1111
16431	1078	8	1	27	0	1114
16432	16	5	1060	21	0	1102
16433	16	4	1062	6	0	1088
16434	1026	4	22	9	0	1061
16435	12	0	1037	9	0	1058
16436	14	4	954	2	0	974
16437	7	3	20	948	0	978
16438	967	1	19	13	0	1000
16439	9	5	7	969	0	990
16440	15	5	966	10	0	996
16441	936	1	14	15	0	966
16442	10	2	945	8	0	965
16443	14	953	13	5	0	985
16444	13	17	14	964	0	1008
16445	971	9	7	12	0	999
16446	11	3	3	981	0	998
16447	12	0	1	991	0	1004
16448	1001	1	4	22	0	1028
16449	9	1	2	1016	0	1028
16450	12	2	3	1032	0	1049
16451	7	1	1017	21	0	1046
16452	3	2	7	1031	0	1043
16453	1039	1	10	14	0	1064
16454	1021	1	6	17	0	1045
16455	1035	3	1	6	0	1045
16456	23	1	2	1010	0	1036
16457	14	1001	2	10	0	1027
16458	1010	10	0	14	0	1034
16459	11	1017	3	4	0	1035
16460	1013	10	3	3	0	1029
16461	14	11	4	1003	0	1032
16462	1015	4	2	13	0	1034
16463	994	3	0	13	0	1010
16464	1005	2	1	5	0	1013
16465	22	986	1	2	0	1011
16466	11	949	2	1	0	963
16467	875	13	0	4	0	892
16468	10	869	1	1	0	881
16469	2	766	0	3	0	771
16470	7	754	1	1	0	763
16471	749	2	8	2	0	761
16472	0	0	0	752	0	752
16473	1	0	0	750	0	751
16474	754	0	1	2	0	757
16475	1	0	769	0	0	770
16476	0	0	1	845	0	846
16477	0	0	1	856	0	857
16478	2	0	0	933	0	935
16479	3	0	1	985	0	989
16480	1	993	2	13	0	1009
16481	0	1200	0	5	0	1205
16482	1214	13	0	4	0	1231
16483	14	8	0	1216	0	1238
16484	9	3	0	1229	0	1241
16485	5	0	1212	21	0	1238
16486	0	0	17	1224	0	1241
16487	1	1	1229	19	0	1250
16488	2	0	17	1235	0	1254
16489	2	0	1309	20	0	1331
16490	0	1300	22	12	0	1334
16491	2	18	8	1307	0	1335
16492	1309	6	4	18	0	1337
16493	1310	3	1	10	0	1324
16494	27	0	2	1300	0	1329
16495	9	1	1298	20	0	1328
16496	4	1	1285	10	0	1300
16497	1245	1	25	7	0	1278
16498	21	1258	11	1	0	1291
16499	1283	18	2	3	0	1306
16500	1283	7	3	4	0	1297
16501	28	5	1260	3	0	1296
16502	15	0	21	1261	0	1297
16503	7	2	7	1272	0	1288
16504	6	1	6	1323	0	1336
16505	3	1	0	1283	0	1287
16506	5	0	4	1268	0	1277
16507	5	1	1205	31	0	1242
16508	1	4	1199	12	0	1216
16509	6	2	23	1202	0	1233
16510	4	2	11	1213	0	1230
16511	7	0	4	1226	0	1237
16512	1196	1	3	32	0	1232
16513	23	4	4	1188	0	1219
16514	1189	1	2	29	0	1221
16515	28	3	0	1207	0	1238
16516	1229	0	3	27	0	1259
16517	1252	2	1	13	0	1268
16518	1237	1	5	5	0	1248
16519	1236	1	1	9	0	1247
16520	1236	0	1	7	0	1244
16521	35	1	0	1209	0	1245
16522	1208	0	3	23	0	1234
16523	25	1177	3	12	0	1217
16524	1194	18	3	5	0	1220
16525	27	7	3	1196	0	1233
16526	10	6	1187	28	0	1231
16527	11	2	22	1202	0	1237
16528	3	1	1208	33	0	1245
16529	5	1	25	1207	0	1238
16530	2	1	11	1235	0	1249
16531	4	2	1197	32	0	1235
16532	3	2	1195	19	0	1219
16533	6	2	28	1200	0	1236
16534	1187	0	15	32	0	1234
16535	25	3	1182	13	0	1223
16536	9	1198	26	14	0	1247
16537	10	20	1223	6	0	1259
16538	1211	7	25	13	0	1256
16539	30	3	5	1221	0	1259
16540	1215	5	5	30	0	1255
16541	1228	1	5	9	0	1243
16542	37	0	1	1211	0	1249
16543	18	2	1169	27	0	1216
16544	9	1	23	1167	0	1200
16545	10	1	9	1166	0	1186
16546	1142	1	7	36	0	1186
16547	27	1137	2	17	0	1183
16548	12	24	4	1139	0	1179
16549	11	7	1115	29	0	1162
16550	1080	4	24	18	0	1126
16551	27	1080	12	9	0	1128
16552	11	20	7	1094	0	1132
16553	6	7	6	1100	0	1119
16554	2	4	7	1116	0	1129
16555	1071	0	4	41	0	1116
16556	1087	2	4	19	0	1112
16557	37	1	5	1074	0	1117
16558	15	0	1070	34	0	1119
16559	7	1059	25	18	0	1109
16560	1064	20	12	13	0	1109
16561	1094	6	5	7	0	1112
16562	34	4	2	1070	0	1110
16563	24	1	4	1089	0	1118
16564	9	3	1069	35	0	1116
16565	9	1079	24	16	0	1128
16566	1095	22	9	11	0	1137
16567	1089	7	3	9	0	1108
16568	32	1068	2	7	0	1109
16569	1048	23	1	8	0	1080
16570	32	9	3	1040	0	1084
16571	15	3	1014	33	0	1065
16572	8	2	27	1043	0	1080
16573	8	2	1029	31	0	1070
16574	1015	3	27	17	0	1062
16575	28	1007	11	14	0	1060
16576	11	28	4	933	0	976
16577	6	6	926	27	0	965
16578	5	2	869	10	0	886
16579	800	7	20	6	0	833
16580	16	776	8	5	0	805
16581	586	11	13	1	0	611
16582	581	1	0	6	0	588
16583	576	1	1	0	0	578
16584	13	3	1	556	0	573
16585	1	0	554	9	0	564
16586	2	552	8	1	0	563
16587	2	14	6	550	0	572
16588	1	0	554	11	0	566
16589	0	1	486	2	0	489
16590	0	1	4	474	0	479
16591	2	0	472	5	0	479
16592	461	0	5	0	0	466
16593	6	1	0	481	0	488
16594	1	1	1	496	0	499
16595	494	1	0	7	0	502
16596	7	492	1	0	0	500
16597	513	5	0	3	0	521
16598	5	0	1	515	0	521
16599	1	0	2	518	0	521
16600	0	1	1	520	0	522
16601	0	1	0	510	0	511
16602	503	0	2	5	0	510
16603	7	0	495	0	0	502
16604	1	487	5	1	0	494
16605	1	5	1	489	0	496
16606	471	0	0	9	0	480
16607	496	0	1	4	0	501
16608	7	497	0	1	0	505
16609	497	6	0	0	0	503
16610	7	498	0	0	0	505
16611	2	517	0	0	0	519
16612	0	7	0	518	0	525
16613	0	0	512	7	0	519
16614	0	0	5	495	0	500
16615	479	0	2	6	0	487
16616	6	484	0	0	0	490
16617	1	5	1	483	0	490
16618	0	0	520	4	0	524
16619	522	0	5	4	0	531
16620	534	0	0	6	0	540
16621	533	0	1	2	0	536
16622	5	2	524	0	0	531
16623	514	1	5	1	0	521
16624	5	518	1	0	0	524
16625	0	6	1	501	0	508
16626	1	516	0	6	0	523
16627	517	4	2	0	0	523
16628	505	1	0	1	0	507
16629	6	0	519	1	0	526
16630	0	527	4	2	0	533
16631	0	4	1	531	0	536
16632	0	1	1	536	0	538
16633	2	0	1	532	0	535
16634	3	0	0	555	0	558
16635	1	1	0	549	0	551
16636	0	0	523	5	0	528
16637	1	516	6	1	0	524
16638	504	7	1	2	0	514
16639	8	0	527	1	0	536
16640	0	544	5	0	0	549
16641	555	6	0	0	0	561
16642	8	0	573	0	0	581
16643	552	2	6	1	0	561
16644	552	0	0	3	0	555
16645	567	0	2	0	0	569
16646	8	566	0	0	0	574
16647	3	5	565	1	0	574
16648	2	572	7	0	0	581
16649	2	5	1	527	0	535
16650	0	579	2	3	0	584
16651	577	7	1	1	0	586
16652	610	0	0	1	0	611
16653	607	2	0	3	0	612
16654	9	0	607	1	0	617
16655	3	646	4	0	0	653
16656	2	7	0	707	0	716
16657	772	0	2	7	0	781
16658	11	765	0	1	0	777
16659	1	12	0	766	0	779
16660	2	1	772	11	0	786
16661	779	2	11	3	0	795
16662	16	0	807	2	0	825
16663	4	0	834	0	0	838
16664	813	2	18	0	0	833
16665	16	0	801	2	0	819
16666	764	1	16	2	0	783
16667	17	779	4	0	0	800
16668	796	14	3	3	0	816
16669	18	3	2	792	0	815
16670	6	2	0	801	0	809
16671	2	1	2	814	0	819
16672	788	0	1	20	0	809
16673	787	1	0	7	0	795
16674	788	0	2	3	0	793
16675	21	767	1	2	0	791
16676	7	15	2	771	0	795
16677	6	2	773	14	0	795
16678	5	2	11	746	0	764
16679	3	744	4	17	0	768
16680	2	16	3	755	0	776
16681	4	4	1	770	0	779
16682	754	3	1	20	0	778
16683	15	1	1	760	0	777
16684	4	0	752	19	0	775
16685	6	1	737	5	0	749
16686	4	1	19	737	0	761
16687	726	0	7	18	0	751
16688	18	1	4	715	0	738
16689	4	0	2	735	0	741
16690	3	1	715	20	0	739
16691	3	712	15	6	0	736
16692	1	16	3	713	0	733
16693	697	3	3	19	0	722
16694	14	691	2	8	0	715
16695	4	16	1	697	0	718
16696	4	3	689	15	0	711
16697	3	3	14	676	0	696
16698	666	1	3	18	0	688
16699	16	668	2	9	0	695
16700	6	15	673	5	0	699
16701	7	5	17	677	0	706
16702	2	3	685	19	0	709
16703	678	4	18	7	0	707
16704	701	3	3	6	0	713
16705	18	2	689	5	0	714
16706	8	0	18	677	0	703
16707	7	2	689	15	0	713
16708	2	680	23	5	0	710
16709	5	15	10	682	0	712
16710	2	6	689	19	0	716
16711	6	6	19	660	0	691
16712	3	664	4	20	0	691
16713	3	15	4	674	0	696
16714	3	3	660	22	0	688
16715	659	3	17	7	0	686
16716	18	653	6	6	0	683
16717	656	15	2	5	0	678
16718	20	6	621	2	0	649
16719	613	3	16	6	0	638
16720	19	2	624	3	0	648
16721	620	2	17	4	0	643
16722	646	4	6	5	0	661
16723	22	2	6	630	0	660
16724	7	3	4	653	0	667
16725	643	4	1	20	0	668
16726	19	636	2	11	0	668
16727	648	15	3	7	0	673
16728	23	3	2	634	0	662
16729	7	625	4	20	0	656
16730	9	14	4	645	0	672
16731	7	3	5	659	0	674
16732	5	4	3	655	0	667
16733	2	641	7	25	0	675
16734	630	12	2	10	0	654
16735	16	8	5	634	0	663
16736	8	3	626	16	0	653
16737	1	8	629	7	0	645
16738	5	3	640	5	0	653
16739	618	2	16	8	0	644
16740	620	3	6	8	0	637
16741	19	2	600	7	0	628
16742	7	3	15	566	0	591
16743	9	1	8	586	0	604
16744	6	2	609	20	0	637
16745	3	2	625	5	0	635
16746	4	3	14	627	0	648
16747	615	1	9	16	0	641
16748	612	1	5	11	0	629
16749	613	2	3	6	0	624
16750	20	591	4	6	0	621
16751	7	618	2	5	0	632
16752	3	15	4	593	0	615
16753	582	4	7	14	0	607
16754	10	1	568	9	0	588
16755	521	2	12	5	0	540
16756	11	474	4	6	0	495
16757	5	425	3	2	0	435
16758	422	6	1	4	0	433
16759	5	415	1	5	0	426
16760	2	400	1	1	0	404
16761	392	7	6	3	0	408
16762	1	406	0	0	0	407
16763	0	2	0	390	0	392
16764	0	0	0	395	0	395
16765	392	0	0	2	0	394
16766	387	0	1	0	0	388
16767	2	389	0	0	0	391
16768	0	392	0	1	0	393
16769	0	3	387	0	0	390
16770	406	0	2	0	0	408
16771	421	0	0	1	0	422
16772	436	0	0	0	0	436
16773	3	0	0	446	0	449
16774	0	0	0	463	0	463
16775	474	0	0	4	0	478
16776	3	0	0	477	0	480
16777	0	0	482	3	0	485
16778	1	0	3	481	0	485
16779	0	494	0	2	0	496
16780	0	3	0	503	0	506
16781	0	0	0	512	0	512
16782	0	0	0	515	0	515
16783	510	0	0	3	0	513
16784	2	504	1	0	0	507
16785	0	3	0	523	0	526
16786	0	1	530	3	0	534
16787	1	0	509	3	0	513
16788	1	0	3	532	0	536
16789	0	0	1	537	0	538
16790	536	0	0	3	0	539
16791	2	0	0	534	0	536
16792	1	541	0	2	0	544
16793	0	3	552	1	0	556
16794	1	3	2	565	0	571
16795	0	0	576	3	0	579
16796	2	1	2	571	0	576
16797	575	0	1	3	0	579
16798	579	0	0	2	0	581
16799	3	571	0	1	0	575
16800	2	2	0	568	0	572
16801	587	1	0	3	0	591
16802	578	1	0	2	0	581
16803	581	0	1	1	0	583
16804	582	0	1	1	0	584
16805	578	0	0	1	0	579
16806	6	571	0	0	0	577
16807	572	3	0	0	0	575
16808	2	1	578	1	0	582
16809	1	0	3	578	0	582
16810	584	0	2	3	0	589
16811	576	0	1	3	0	580
16812	591	0	0	1	0	592
16813	5	0	589	1	0	595
16814	3	0	3	599	0	605
16815	620	1	1	3	0	625
16816	4	624	1	1	0	630
16817	664	3	0	5	0	672
16818	656	2	1	0	0	659
16819	660	0	0	2	0	662
16820	6	0	0	681	0	687
16821	688	0	1	5	0	694
16822	5	1	674	1	0	681
16823	1	0	659	2	0	662
16824	669	1	5	4	0	679
16825	6	0	675	0	0	681
16826	660	0	4	2	0	666
16827	5	0	671	0	0	676
16828	2	0	5	667	0	674
16829	660	0	1	5	0	666
16830	5	669	0	1	0	675
16831	688	4	1	6	0	699
16832	4	675	0	2	0	681
16833	2	710	0	1	0	713
16834	0	6	0	719	0	725
16835	1	2	0	720	0	723
16836	1	0	0	710	0	711
16837	1	0	697	7	0	705
16838	685	0	5	2	0	692
16839	739	1	1	1	0	742
16840	749	0	0	4	0	753
16841	749	0	0	1	0	750
16842	740	0	0	4	0	744
16843	7	1	712	1	0	721
16844	2	0	711	1	0	714
16845	1	0	11	737	0	749
16846	0	1	742	7	0	750
16847	760	0	5	3	0	768
16848	7	804	1	2	0	814
16849	5	8	0	854	0	867
16850	870	2	1	11	0	884
16851	9	0	0	900	0	909
16852	4	0	909	8	0	921
16853	2	1	915	3	0	921
16854	2	0	10	936	0	948
16855	2	2	938	11	0	953
16856	916	1	9	3	0	929
16857	11	1	3	936	0	951
16858	3	1	940	8	0	952
16859	0	935	8	5	0	948
16860	0	8	3	963	0	974
16861	4	2	963	9	0	978
16862	5	0	9	945	0	959
16863	5	0	3	975	0	983
16864	4	1	987	12	0	1004
16865	2	1	9	987	0	999
16866	4	0	3	979	0	986
16867	2	1	1	998	0	1002
16868	981	0	0	13	0	994
16869	11	974	2	2	0	989
16870	5	975	0	1	0	981
16871	1	11	958	2	0	972
16872	931	2	9	3	0	945
16873	10	0	932	1	0	943
16874	3	1	915	1	0	920
16875	1	2	11	902	0	916
16876	910	0	4	8	0	922
16877	8	917	0	9	0	934
16878	914	8	3	0	0	925
16879	921	2	1	3	0	927
16880	12	934	0	2	0	948
16881	945	8	1	0	0	954
16882	933	3	0	5	0	941
16883	12	946	0	1	0	959
16884	3	7	0	952	0	962
16885	2	2	1	971	0	976
16886	987	1	1	13	0	1002
16887	8	989	0	4	0	1001
16888	1012	9	2	2	0	1025
16889	1020	2	0	3	0	1025
16890	1073	0	1	2	0	1076
16891	11	0	1	1075	0	1087
16892	4	2	0	1085	0	1091
16893	1060	0	0	15	0	1075
16894	1091	1	1	6	0	1099
16895	1102	0	0	2	0	1104
16896	13	0	0	1137	0	1150
16897	2	1	1156	12	0	1171
16898	7	0	10	1166	0	1183
16899	5	0	2	1247	0	1254
16900	1	1	1232	14	0	1248
16901	2	0	1331	11	0	1344
16902	1	0	22	1354	0	1377
16903	1	1	1357	19	0	1378
16904	1380	1	17	13	0	1411
16905	18	0	8	1389	0	1415
16906	10	0	4	1407	0	1421
16907	1423	0	1	25	0	1449
16908	15	0	0	1419	0	1434
16909	12	0	0	1428	0	1440
16910	7	1	0	1442	0	1450
16911	3	1	0	1442	0	1446
16912	3	1	1398	21	0	1423
16913	2	1	13	1406	0	1422
16914	2	0	1386	15	0	1403
16915	1	1383	16	12	0	1412
16916	2	14	8	1379	0	1403
16917	0	7	1349	13	0	1369
16918	1304	2	14	11	0	1331
16919	14	1337	9	5	0	1365
16920	1326	13	5	2	0	1346
16921	19	8	1	1299	0	1327
16922	9	1313	2	15	0	1339
16923	1317	11	0	13	0	1341
16924	14	1322	3	3	0	1342
16925	1332	14	0	6	0	1352
16926	15	8	0	1338	0	1361
16927	1348	3	2	15	0	1368
16928	18	1345	1	13	0	1377
16929	1357	14	3	7	0	1381
16930	18	9	1334	3	0	1364
16931	12	2	14	1337	0	1365
16932	1327	3	8	17	0	1355
16933	1330	1	2	13	0	1346
16934	23	0	4	1312	0	1339
16935	17	7	1300	14	0	1338
16936	4	1257	10	13	0	1284
16937	7	1311	8	3	0	1329
16938	1327	16	6	10	0	1359
16939	11	13	2	1320	0	1346
16940	14	2	3	1302	0	1321
16941	1308	4	1	21	0	1334
16942	1300	2	3	12	0	1317
16943	21	1	1310	7	0	1339
16944	16	1	10	1310	0	1337
16945	7	4	1275	13	0	1299
16946	5	1269	13	13	0	1300
16947	1219	9	8	10	0	1246
16948	9	1203	5	9	0	1226
16949	15	1185	3	4	0	1207
16950	12	12	3	1178	0	1205
16951	1150	11	2	14	0	1177
16952	8	1151	6	10	0	1175
16953	1144	9	2	7	0	1162
16954	11	1131	4	4	0	1150
16955	12	10	2	1146	0	1170
16956	1146	8	0	14	0	1168
16957	11	4	1146	15	0	1176
16958	15	3	12	1136	0	1166
16959	9	1	1136	12	0	1158
16960	2	1087	12	16	0	1117
16961	2	1103	12	9	0	1126
16962	1083	16	8	7	0	1114
16963	9	1106	3	6	0	1124
16964	1097	14	4	4	0	1119
16965	1092	12	2	5	0	1111
16966	16	3	1094	5	0	1118
16967	1100	0	9	10	0	1119
16968	16	4	1136	3	0	1159
16969	14	1124	10	5	0	1153
16970	1140	9	11	8	0	1168
16971	10	1142	5	7	0	1164
16972	14	10	1	1155	0	1180
16973	1159	9	2	12	0	1182
16974	14	5	2	1159	0	1180
16975	9	3	1174	21	0	1207
16976	5	6	8	1178	0	1197
16977	4	7	8	1173	0	1192
16978	1164	6	5	19	0	1194
16979	14	4	1149	11	0	1178
16980	1174	3	8	12	0	1197
16981	1202	3	11	2	0	1218
16982	22	2	5	1201	0	1230
16983	15	2	2	1198	0	1217
16984	1194	1	8	20	0	1223
16985	14	1229	3	16	0	1262
16986	12	19	3	1193	0	1227
16987	10	10	1179	11	0	1210
16988	3	8	1144	12	0	1167
16989	3	1187	16	8	0	1214
16990	11	12	9	1130	0	1162
16991	8	7	6	1137	0	1158
16992	1128	3	3	21	0	1155
16993	16	3	0	1119	0	1138
16994	1086	3	1	16	0	1106
16995	13	1058	5	10	0	1086
16996	12	1040	5	4	0	1061
16997	7	1056	5	1	0	1069
16998	1027	16	0	9	0	1052
16999	941	4	6	9	0	960
17000	13	923	3	7	0	946
17001	813	5	0	0	0	818
17002	4	798	0	6	0	808
17003	2	4	1	799	0	806
17004	3	788	1	4	0	796
17005	793	9	0	3	0	805
17006	798	2	0	1	0	801
17007	6	3	0	769	0	778
17008	768	1	0	5	0	774
17009	5	4	0	772	0	781
17010	4	782	0	5	0	791
17011	3	8	0	790	0	801
17012	0	784	0	5	0	789
17013	789	7	0	0	0	796
17014	7	2	763	1	0	773
17015	753	1	4	1	0	759
17016	5	2	0	778	0	785
17017	5	0	769	4	0	778
17018	768	1	3	3	0	775
17019	4	2	796	3	0	805
17020	3	1	5	796	0	805
17021	2	1	0	815	0	818
17022	4	1	1	791	0	797
17023	0	0	2	800	0	802
17024	3	798	0	6	0	807
17025	2	5	0	848	0	855
17026	842	1	4	9	0	856
17027	11	1	826	0	0	838
17028	0	891	8	3	0	902
17029	909	10	2	2	0	923
17030	990	0	1	3	0	994
17031	12	1	1	1124	0	1138
17032	1	1	1127	20	0	1149
17033	4	3	16	1125	0	1148
17034	4	0	1	1198	0	1203
17035	2	0	1174	24	0	1200
17036	1	1227	22	5	0	1255
17037	1260	25	3	9	0	1297
17038	1268	3	2	7	0	1280
17039	1299	1	3	5	0	1308
17040	28	3	1	1276	0	1308
17041	5	1	4	1326	0	1336
17042	1326	3	1	32	0	1362
17043	38	1	0	1289	0	1328
17044	7	1307	4	32	0	1350
17045	1358	31	1	12	0	1402
17046	1369	4	3	10	0	1386
17047	1431	3	3	7	0	1444
17048	1442	3	1	8	0	1454
17049	45	6	1354	4	0	1409
17050	13	6	1362	4	0	1385
17051	17	4	32	1365	0	1418
17052	14	0	4	1396	0	1414
17053	10	3	1356	40	0	1409
17054	9	4	1375	10	0	1398
17055	9	0	38	1355	0	1402
17056	1361	3	7	42	0	1413
17057	47	2	6	1333	0	1388
17058	8	2	1330	40	0	1380
17059	13	1336	35	9	0	1393
17060	1351	30	6	12	0	1399
17061	1379	2	5	9	0	1395
17062	1375	5	8	8	0	1396
17063	1373	1	11	5	0	1390
17064	43	4	1304	9	0	1360
17065	15	4	35	1313	0	1367
17066	1306	2	7	46	0	1361
17067	44	3	12	1297	0	1356
17068	10	3	7	1278	0	1298
17069	11	1247	4	45	0	1307
17070	12	31	3	1271	0	1317
17071	1236	5	7	45	0	1293
17072	40	1249	7	9	0	1305
17073	1233	39	6	11	0	1289
17074	47	1223	3	7	0	1280
17075	19	37	1	1178	0	1235
17076	18	1180	4	38	0	1240
17077	10	1237	4	12	0	1263
17078	1210	38	7	7	0	1262
17079	39	6	1188	16	0	1249
17080	12	4	1166	12	0	1194
17081	11	8	1143	10	0	1172
17082	1098	6	35	13	0	1152
17083	37	1120	8	12	0	1177
17084	17	1146	8	6	0	1177
17085	1069	37	4	9	0	1119
17086	44	1058	7	7	0	1116
17087	16	1112	5	5	0	1138
17088	12	37	7	1094	0	1150
17089	7	13	1082	41	0	1143
17090	8	13	1115	9	0	1145
17091	16	12	31	1100	0	1159
17092	1087	10	11	39	0	1147
17093	42	1097	12	10	0	1161
17094	13	36	14	1100	0	1163
17095	15	7	1083	41	0	1146
17096	15	9	1080	12	0	1116
17097	10	12	39	1062	0	1123
17098	1054	13	10	39	0	1116
17099	1086	8	8	11	0	1113
17100	42	11	1041	10	0	1104
17101	1043	12	40	11	0	1106
17102	41	10	1048	12	0	1111
17103	18	0	44	1021	0	1083
17104	13	1037	15	37	0	1102
17105	1055	33	14	11	0	1113
17106	41	9	8	1072	0	1130
17107	15	9	8	1092	0	1124
17108	15	8	8	1110	0	1141
17109	11	4	14	1109	0	1138
17110	14	4	1041	43	0	1102
17111	10	1035	38	14	0	1097
17112	20	31	6	1055	0	1112
17113	1036	7	10	48	0	1101
17114	40	7	9	1050	0	1106
17115	12	8	13	1076	0	1109
17116	15	7	1009	45	0	1076
17117	12	10	1010	16	0	1048
17118	15	994	36	13	0	1058
17119	14	1016	12	17	0	1059
17120	11	36	14	998	0	1059
17121	991	8	7	50	0	1056
17122	37	10	992	17	0	1056
17123	13	1005	32	14	0	1064
17124	12	37	11	984	0	1044
17125	3	965	9	36	0	1013
17126	11	34	7	936	0	988
17127	9	942	5	42	0	998
17128	12	30	9	882	0	933
17129	851	12	6	33	0	902
17130	28	771	7	7	0	813
17131	7	17	3	628	0	655
17132	612	9	1	21	0	643
17133	19	594	0	11	0	624
17134	6	519	4	6	0	535
17135	10	522	7	3	0	542
17136	5	25	12	445	0	487
17137	3	4	0	453	0	460
17138	4	436	0	16	0	456
17139	1	16	1	435	0	453
17140	2	2	438	17	0	459
17141	1	429	10	1	0	441
17142	2	32	1	379	0	414
17143	3	395	0	4	0	402
17144	3	7	375	3	0	388
17145	2	364	3	0	0	369
17146	311	8	3	5	0	327
17147	3	1	0	307	0	311
17148	305	0	2	3	0	310
17149	1	1	315	1	0	318
17150	0	1	2	320	0	323
17151	1	0	316	1	0	318
17152	0	1	1	322	0	324
17153	328	1	0	3	0	332
17154	2	1	0	334	0	337
17155	334	1	0	3	0	338
17156	1	336	1	2	0	340
17157	344	2	0	0	0	346
17158	1	0	370	1	0	372
17159	0	378	2	0	0	380
17160	1	0	0	389	0	390
17161	1	0	0	384	0	385
17162	0	1	380	1	0	382
17163	0	384	1	1	0	386
17164	0	1	1	393	0	395
17165	0	391	1	1	0	393
17166	0	1	0	390	0	391
17167	1	388	0	1	0	390
17168	391	1	0	0	0	392
17169	2	1	0	390	0	393
17170	0	0	394	1	0	395
17171	0	389	3	0	0	392
17172	0	406	0	0	0	406
17173	0	1	401	0	0	402
17174	0	410	1	0	0	411
17175	1	1	0	404	0	406
17176	0	0	413	1	0	414
17177	0	0	1	411	0	412
17178	1	0	0	418	0	419
17179	0	0	422	1	0	423
17180	401	0	1	1	0	403
17181	1	0	0	425	0	426
17182	0	0	472	1	0	473
17183	0	473	1	0	0	474
17184	476	0	0	2	0	478
17185	0	468	1	0	0	469
17186	0	2	0	485	0	487
17187	475	0	0	1	0	476
17188	2	0	0	467	0	469
17189	0	0	492	1	0	493
17190	0	0	1	503	0	504
17191	0	0	512	0	0	512
17192	496	0	1	1	0	498
17193	1	0	509	0	0	510
17194	515	0	1	1	0	517
17195	529	0	2	1	0	532
17196	1	0	530	0	0	531
17197	1	1	498	0	0	500
17198	0	537	1	0	0	538
17199	550	1	0	1	0	552
17200	1	0	1	561	0	563
17201	0	0	0	570	0	570
17202	627	0	0	3	0	630
17203	645	0	1	1	0	647
17204	652	0	1	0	0	653
17205	644	1	0	1	0	646
17206	2	0	0	639	0	641
17207	641	0	0	3	0	644
17208	1	1	0	643	0	645
17209	2	0	0	636	0	638
17210	1	1	0	650	0	652
17211	1	0	640	1	0	642
17212	2	624	1	0	0	627
17213	1	635	0	1	0	637
17214	2	1	0	649	0	652
17215	646	0	0	3	0	649
17216	2	0	1	647	0	650
17217	645	0	0	5	0	650
17218	1	0	683	0	0	684
17219	664	1	1	1	0	667
17220	2	1	0	703	0	706
17221	727	0	0	3	0	730
17222	722	0	0	2	0	724
17223	736	1	0	3	0	740
17224	3	0	0	741	0	744
17225	0	0	740	1	0	741
17226	1	1	1	745	0	748
17227	755	0	0	6	0	761
17228	3	1	832	1	0	837
17229	2	0	3	896	0	901
17230	922	1	0	7	0	930
17231	4	1	938	2	0	945
17232	993	1	5	3	0	1002
17233	1043	0	0	4	0	1047
17234	8	0	1	1054	0	1063
17235	2	0	1	1085	0	1088
17236	1078	0	0	12	0	1090
17237	6	0	1	1139	0	1146
17238	1136	1	1	12	0	1150
17239	11	1169	0	2	0	1182
17240	4	1182	1	2	0	1189
17241	4	10	0	1169	0	1183
17242	2	4	1207	9	0	1222
17243	2	1211	9	3	0	1225
17244	1204	8	1	7	0	1220
17245	10	1189	2	3	0	1204
17246	2	13	1189	1	0	1205
17247	3	2	9	1195	0	1209
17248	0	3	1214	10	0	1227
17249	0	1253	13	2	0	1268
17250	1	11	1	1256	0	1269
17251	0	1250	4	12	0	1266
17252	0	12	1245	3	0	1260
17253	2	2	11	1245	0	1260
17254	1	4	1250	11	0	1266
17255	0	2	11	1253	0	1266
17256	1246	1	2	17	0	1266
17257	11	1	1242	3	0	1257
17258	1183	2	11	5	0	1201
17259	14	1	1197	2	0	1214
17260	4	1	13	1194	0	1212
17261	2	0	1255	11	0	1268
17262	1	0	13	1265	0	1279
17263	1	0	4	1277	0	1282
17264	1	0	3	1268	0	1272
17265	2	0	1	1278	0	1281
17266	1	0	1354	14	0	1369
17267	1367	0	12	6	0	1385
17268	11	0	2	1467	0	1480
17269	1490	0	3	15	0	1508
17270	1539	0	1	8	0	1548
17271	1569	0	1	6	0	1576
17272	11	0	1	1587	0	1599
17273	5	1	1	1642	0	1649
17274	4	1799	1	19	0	1823
17275	2000	17	2	7	0	2026
17276	2111	3	2	4	0	2120
17277	2148	5	0	3	0	2156
17278	34	2	2144	2	0	2182
17279	15	1	22	2146	0	2184
17280	9	1	2150	22	0	2182
17281	2147	2	23	8	0	2180
17282	2147	0	8	8	0	2163
17283	28	3	4	2118	0	2153
17284	14	1	5	2120	0	2140
17285	11	2154	1	31	0	2197
17286	2176	21	3	14	0	2214
17287	2186	5	3	9	0	2203
17288	32	2148	2	10	0	2192
17289	2165	22	3	6	0	2196
17290	35	5	3	2151	0	2194
17291	11	4	3	2172	0	2190
17292	2164	3	5	32	0	2204
17293	28	0	2153	12	0	2193
17294	2167	3	20	13	0	2203
17295	2199	1	7	9	0	2216
17296	32	2160	5	4	0	2201
17297	2191	23	4	7	0	2225
17298	34	8	2154	2	0	2198
17299	15	5	22	2167	0	2209
17300	2180	4	6	34	0	2224
17301	32	2	4	2171	0	2209
17302	8	1	2120	29	0	2158
17303	13	0	24	2093	0	2130
17304	10	2244	7	27	0	2288
17305	10	24	6	2286	0	2326
17306	9	10	4	2315	0	2338
17307	8	4	2	2299	0	2313
17308	5	4	1	2324	0	2334
17309	8	2	2289	38	0	2337
17310	11	1	24	2303	0	2339
17311	2299	1	7	40	0	2347
17312	24	2294	6	16	0	2340
17313	9	24	3	2367	0	2403
17314	7	8	2391	31	0	2437
17315	9	4	25	2406	0	2444
17316	2417	4	5	41	0	2467
17317	2439	1	5	23	0	2468
17318	2408	1	7	13	0	2429
17319	42	3	1	2399	0	2445
17320	18	2	2396	28	0	2444
17321	14	2379	23	12	0	2428
17322	2404	22	10	13	0	2449
17323	30	8	8	2385	0	2431
17324	13	5	5	2422	0	2445
17325	12	7	2404	37	0	2460
17326	11	2368	27	16	0	2422
17327	10	2427	11	15	0	2463
17328	11	35	4	2362	0	2412
17329	12	9	2306	26	0	2353
17330	2208	13	22	19	0	2262
17331	26	7	2222	8	0	2263
17332	2180	3	21	14	0	2218
17333	24	2279	12	9	0	2324
17334	17	18	2275	9	0	2319
17335	2235	7	24	11	0	2277
17336	28	2256	13	5	0	2302
17337	2301	18	4	7	0	2330
17338	24	9	2321	2	0	2356
17339	14	2294	15	6	0	2329
17340	2321	21	10	5	0	2357
17341	26	6	2303	5	0	2340
17342	2277	5	23	4	0	2309
17343	24	2	8	2282	0	2316
17344	2287	4	7	23	0	2321
17345	21	2	6	2292	0	2321
17346	2294	3	2	25	0	2324
17347	19	4	2306	17	0	2346
17348	12	4	16	2329	0	2361
17349	9	2	10	2303	0	2324
17350	8	4	2298	26	0	2336
17351	6	4	20	2333	0	2363
17352	12	2014	14	28	0	2068
17353	6	13	7	2484	0	2510
17354	7	6	6	2639	0	2658
17355	7	4	2	2833	0	2846
17356	5	4	2824	42	0	2875
17357	2816	1	28	24	0	2869
17358	47	2	14	2977	0	3040
17359	20	3	3048	44	0	3115
17360	3030	3	45	19	0	3097
17361	3103	5	17	13	0	3138
17362	3167	0	9	14	0	3190
17363	63	5	8	3157	0	3233
17364	31	4	4	3472	0	3511
17365	18	3	7	3440	0	3468
17366	12	3397	3	78	0	3490
17367	3374	55	4	35	0	3468
17368	3360	21	6	25	0	3412
17369	76	12	2	3296	0	3386
17370	34	9	3223	69	0	3335
17371	28	6	3223	30	0	3287
17372	25	3110	71	16	0	3222
17373	13	3203	29	15	0	3260
17374	2903	81	47	26	0	3057
17375	47	2808	10	9	0	2874
17376	2751	44	9	5	0	2809
17377	2740	21	2	10	0	2773
17378	2747	11	2	14	0	2774
17379	67	7	4	2731	0	2809
17380	32	6	3	2894	0	2935
17381	2932	5	2	58	0	2997
17382	63	2	4	2981	0	3050
17383	33	2	2959	61	0	3055
17384	2985	3	43	35	0	3066
17385	57	4	23	2969	0	3053
17386	32	5	8	3023	0	3068
17387	21	6	5	3056	0	3088
17388	15	4	2977	75	0	3071
17389	2844	4	53	37	0	2938
17390	64	3	2960	19	0	3046
17391	27	3	54	2955	0	3039
17392	17	4	2968	58	0	3047
17393	26	4	55	2919	0	3004
17394	16	4	26	2991	0	3037
17395	16	8	2968	75	0	3067
17396	19	9	52	2827	0	2907
17397	12	2944	27	59	0	3042
17398	2976	51	9	38	0	3074
17399	3005	21	9	22	0	3057
17400	80	4	8	2971	0	3063
17401	30	10	2960	63	0	3063
17402	14	2838	54	34	0	2940
17403	22	2974	29	8	0	3033
17404	2822	59	14	16	0	2911
17405	58	26	2773	21	0	2878
17406	2781	12	59	19	0	2871
17407	66	11	23	2776	0	2876
17408	33	13	9	2828	0	2883
17409	2752	7	11	79	0	2849
17410	63	2736	18	35	0	2852
17411	36	48	2733	25	0	2842
17412	21	22	49	2725	0	2817
17413	23	6	2721	68	0	2818
17414	17	2664	57	39	0	2777
17415	14	51	31	2701	0	2797
17416	2658	22	22	67	0	2769
17417	2694	10	13	41	0	2758
17418	78	8	2640	22	0	2748
17419	33	2635	59	21	0	2748
17420	2631	47	29	24	0	2731
17421	61	2626	18	19	0	2724
17422	35	54	13	2613	0	2715
17423	2597	29	16	65	0	2707
17424	63	16	13	2619	0	2711
17425	34	15	2553	60	0	2662
17426	25	11	48	2569	0	2653
17427	16	7	2541	72	0	2636
17428	24	9	58	2541	0	2632
17429	2509	8	25	77	0	2619
17430	59	2535	22	39	0	2655
17431	2538	53	19	23	0	2633
17432	73	27	13	2507	0	2620
17433	39	14	13	2508	0	2574
17434	24	15	2273	90	0	2402
17435	27	15	2440	44	0	2526
17436	23	2445	77	27	0	2572
17437	20	58	2406	30	0	2514
17438	2310	27	64	32	0	2433
17439	63	2328	41	17	0	2449
17440	38	2377	22	21	0	2458
17441	19	2403	23	23	0	2468
17442	24	75	14	2360	0	2473
17443	24	33	2372	67	0	2496
17444	13	2374	67	45	0	2499
17445	17	71	30	2281	0	2399
17446	17	2387	21	63	0	2488
17447	2318	63	20	41	0	2442
17448	2365	32	19	28	0	2444
17449	89	23	14	2320	0	2446
17450	45	24	10	2327	0	2406
17451	2228	19	7	90	0	2344
17452	69	2163	9	44	0	2285
17453	39	2156	11	20	0	2226
17454	28	82	18	1925	0	2053
17455	17	19	1720	59	0	1815
17456	7	1702	42	34	0	1785
17457	1572	43	23	16	0	1654
17458	36	1527	13	13	0	1589
17459	19	1496	6	15	0	1536
17460	1421	42	12	11	0	1486
17461	33	1454	7	10	0	1504
17462	23	47	1358	4	0	1432
17463	8	1367	32	11	0	1418
17464	1044	26	21	5	0	1096
17465	17	1040	4	0	0	1061
17466	1029	18	8	2	0	1057
17467	20	11	3	1009	0	1043
17468	13	9	1	1041	0	1064
17469	8	6	1038	19	0	1071
17470	2	1043	13	13	0	1071
17471	10	14	9	1051	0	1084
17472	1046	12	4	17	0	1079
17473	1046	4	4	14	0	1068
17474	23	1066	1	10	0	1100
17475	15	15	4	1064	0	1098
17476	1081	11	6	18	0	1116
17477	1093	4	1	17	0	1115
17478	21	4	1054	7	0	1086
17479	14	9	960	5	0	988
17480	10	1	918	4	0	933
17481	1	855	19	3	0	878
17482	781	11	18	3	0	813
17483	11	772	3	1	0	787
17484	755	13	4	4	0	776
17485	10	801	3	2	0	816
17486	8	9	0	820	0	837
17487	833	7	2	8	0	850
17488	10	5	832	5	0	852
17489	835	1	9	6	0	851
17490	843	3	6	2	0	854
17491	16	836	1	2	0	855
17492	4	853	1	2	0	860
17493	861	10	1	4	0	876
17494	12	8	890	0	0	910
17495	854	4	10	3	0	871
17496	859	1	9	0	0	869
17497	16	1	5	849	0	871
17498	868	3	1	10	0	882
17499	12	2	0	901	0	915
17500	7	1	1	915	0	924
17501	4	1	1	889	0	895
17502	3	880	0	13	0	896
17503	892	10	0	6	0	908
17504	912	5	0	4	0	921
17505	15	2	1	906	0	924
17506	10	1	1	901	0	913
17507	5	896	0	14	0	915
17508	906	7	1	8	0	922
17509	9	10	892	2	0	913
17510	11	4	10	899	0	924
17511	3	4	892	11	0	910
17512	2	1	11	908	0	922
17513	3	5	901	10	0	919
17514	7	3	9	906	0	925
17515	919	3	6	12	0	940
17516	11	1	947	10	0	969
17517	942	0	9	6	0	957
17518	10	981	7	4	0	1002
17519	7	11	3	1007	0	1028
17520	4	8	1	1028	0	1041
17521	1051	3	1	18	0	1073
17522	9	4	1	1094	0	1108
17523	9	3	1134	19	0	1165
17524	1137	4	10	7	0	1158
17525	1190	5	5	4	0	1204
17526	1189	2	2	3	0	1196
17527	1184	1	1	3	0	1189
17528	15	1161	3	2	0	1181
17529	8	10	4	1187	0	1209
17530	1174	6	3	11	0	1194
17531	10	3	1	1169	0	1183
17532	1161	3	0	8	0	1172
17533	12	1	1134	5	0	1152
17534	9	1	1145	2	0	1157
17535	1	23	12	1082	0	1118
17536	3	1119	4	9	0	1135
17537	2	1157	0	7	0	1166
17538	1141	7	1	6	0	1155
17539	8	3	1148	1	0	1160
17540	1090	1	4	2	0	1097
17541	4	1140	2	0	0	1146
17542	1159	3	2	2	0	1166
17543	5	2	1	1155	0	1163
17544	3	0	1187	6	0	1196
17545	1	1	5	1191	0	1198
17546	0	1	4	1192	0	1197
17547	2	1185	1	7	0	1195
17548	0	1223	0	3	0	1226
17549	2	7	0	1230	0	1239
17550	0	1248	1	5	0	1254
17551	3	5	1238	3	0	1249
17552	1	3	1197	1	0	1202
17553	1185	1	8	2	0	1196
17554	1248	1	2	4	0	1255
17555	7	1212	0	2	0	1221
17556	6	5	1	1223	0	1235
17557	2	3	0	1229	0	1234
17558	1	1	1223	8	0	1233
17559	5	1	4	1190	0	1200
17560	1	1220	2	4	0	1227
17561	2	5	1193	2	0	1202
17562	2	2	1172	1	0	1177
17563	2	1138	10	9	0	1159
17564	1	7	1192	2	0	1202
17565	0	3	5	1198	0	1206
17566	5	2	2	1126	0	1135
17567	0	2	1218	6	0	1226
17568	2	0	5	1211	0	1218
17569	0	1185	6	4	0	1195
17570	2	1226	0	3	0	1231
17571	2	7	2	1213	0	1224
17572	2	2	1245	9	0	1258
17573	2	1270	8	3	0	1283
17574	0	5	4	1274	0	1283
17575	2	2	1257	7	0	1268
17576	1210	2	5	4	0	1221
17577	1254	0	1	5	0	1260
17578	1262	0	0	2	0	1264
17579	10	0	0	1247	0	1257
17580	2	0	0	1263	0	1265
17581	0	0	1283	7	0	1290
17582	5	0	5	1278	0	1288
17583	2	0	1	1294	0	1297
17584	2	0	1296	8	0	1306
17585	1151	1	6	4	0	1162
17586	7	1233	2	0	0	1242
17587	1231	6	1	6	0	1244
17588	7	1216	1	2	0	1226
17589	1	9	1	1240	0	1251
17590	4	2	1244	7	0	1257
17591	3	0	11	1205	0	1219
17592	1	3	1222	7	0	1233
17593	1100	1	7	7	0	1115
17594	7	2	1174	0	0	1183
17595	2	1	7	1152	0	1162
17596	0	1	1188	7	0	1196
17597	1	1203	7	4	0	1215
17598	0	7	5	1278	0	1290
17599	1	2	2	1285	0	1290
17600	1	0	2	1318	0	1321
17601	1	0	1303	13	0	1317
17602	1	2	1338	6	0	1347
17603	2	1	16	1351	0	1370
17604	0	1	5	1620	0	1626
17605	0	1	1	1761	0	1763
17606	1801	0	0	45	0	1846
17607	36	0	1	1856	0	1893
17608	10	1	1975	35	0	2021
17609	2059	0	37	14	0	2110
17610	37	0	10	2147	0	2194
17611	2227	0	4	43	0	2274
17612	2257	0	1	16	0	2274
17613	59	0	0	2245	0	2304
17614	2248	0	2	50	0	2300
17615	2276	1	3	15	0	2295
17616	61	0	2200	7	0	2268
17617	20	2207	42	6	0	2275
17618	21	40	10	2165	0	2236
17619	12	11	4	2227	0	2254
17620	2206	4	1	54	0	2265
17621	2206	2	2	20	0	2230
17622	2196	1	1	10	0	2208
17623	62	2	2057	3	0	2124
17624	20	2078	42	5	0	2145
17625	2078	43	14	9	0	2144
17626	46	2085	6	6	0	2143
17627	2109	44	3	6	0	2162
17628	58	15	0	2094	0	2167
17629	2105	6	1	46	0	2158
17630	2121	5	4	16	0	2146
17631	2132	6	3	11	0	2152
17632	68	3	2097	7	0	2175
17633	2146	4	43	6	0	2199
17634	61	2129	12	5	0	2207
17635	2156	43	7	13	0	2219
17636	2186	14	3	7	0	2210
17637	2180	5	2	12	0	2199
17638	76	3	6	2098	0	2183
17639	33	2096	8	46	0	2183
17640	2105	42	3	20	0	2170
17641	56	20	2070	9	0	2155
17642	31	2076	42	10	0	2159
17643	20	48	12	1984	0	2064
17644	18	2043	9	34	0	2104
17645	2041	53	3	18	0	2115
17646	2105	20	2	14	0	2141
17647	65	12	4	2061	0	2142
17648	32	6	2012	47	0	2097
17649	15	2033	49	20	0	2117
17650	18	42	18	1901	0	1979
17651	13	19	8	2098	0	2138
17652	24	7	2	2148	0	2181
17653	2117	7	4	67	0	2195
17654	2163	6	2	24	0	2195
17655	2166	2	11	15	0	2194
17656	2183	12	7	13	0	2215
17657	79	8	2	2131	0	2220
17658	34	4	2160	58	0	2256
17659	23	7	47	2195	0	2272
17660	23	2	14	2216	0	2255
17661	22	9	6	2225	0	2262
17662	25	3	6	2231	0	2265
17663	2174	3	3	72	0	2252
17664	62	7	6	2182	0	2257
17665	2187	6	10	63	0	2266
17666	2230	8	5	33	0	2276
17667	75	8	2155	21	0	2259
17668	39	5	2155	16	0	2215
17669	27	7	2203	21	0	2258
17670	30	6	64	2164	0	2264
17671	19	6	2205	66	0	2296
17672	26	9	58	2149	0	2242
17673	25	6	19	2171	0	2221
17674	2158	5	17	69	0	2249
17675	67	5	13	2130	0	2215
17676	35	2155	9	65	0	2264
17677	2224	48	9	36	0	2317
17678	65	2214	8	26	0	2313
17679	34	53	2237	24	0	2348
17680	29	2267	47	20	0	2363
17681	2238	54	23	17	0	2332
17682	68	25	9	2242	0	2344
17683	38	13	2206	55	0	2312
17684	2229	9	49	26	0	2313
17685	69	13	18	2217	0	2317
17686	36	7	2235	55	0	2333
17687	27	12	50	2253	0	2342
17688	27	6	23	2283	0	2339
17689	25	7	11	2270	0	2313
17690	21	2205	12	69	0	2307
17691	2257	47	8	30	0	2342
17692	60	21	8	2234	0	2323
17693	37	2236	9	56	0	2338
17694	29	51	7	2260	0	2347
17695	21	25	2226	56	0	2328
17696	30	2248	44	28	0	2350
17697	2231	53	18	20	0	2322
17698	2214	16	16	13	0	2259
17699	69	18	5	2133	0	2225
17700	36	10	7	2157	0	2210
17701	2151	7	11	64	0	2233
17702	2100	11	12	30	0	2153
17703	64	2093	4	29	0	2190
17704	1821	26	9	13	0	1869
17705	38	9	1709	10	0	1766
17706	21	5	1655	11	0	1692
17707	13	1622	22	14	0	1671
17708	12	1553	5	7	0	1577
17709	1400	23	35	8	0	1466
17710	19	1399	2	7	0	1427
17711	1332	10	1	8	0	1351
17712	1327	3	1	6	0	1337
17713	1310	1	2	5	0	1318
17714	15	1	4	1306	0	1326
17715	1312	1	3	14	0	1330
17716	13	3	1295	3	0	1314
17717	3	3	1314	2	0	1322
17718	3	1317	10	9	0	1339
17719	2	10	1335	3	0	1350
17720	9	4	10	1302	0	1325
17721	1	1	1324	15	0	1341
17722	5	2	1312	2	0	1321
17723	4	1	11	1319	0	1335
17724	1328	3	2	10	0	1343
17725	1329	1	4	2	0	1336
17726	14	4	1376	1	0	1395
17727	1363	2	12	3	0	1380
17728	12	2	1399	1	0	1414
17729	1397	2	12	3	0	1414
17730	1460	0	3	5	0	1468
17731	12	1	4	1463	0	1480
17732	5	0	2	1425	0	1432
17733	3	1400	1	12	0	1416
17734	3	1424	2	7	0	1436
17735	1	11	2	1419	0	1433
17736	5	2	1	1427	0	1435
17737	1405	2	2	12	0	1421
17738	8	1396	4	2	0	1410
17739	1394	9	1	4	0	1408
17740	9	1409	3	3	0	1424
17741	2	10	1411	2	0	1425
17742	5	1	11	1423	0	1440
17743	1426	1	4	11	0	1442
17744	1522	1	2	7	0	1532
17745	14	1551	3	3	0	1571
17746	5	1653	2	1	0	1661
17747	3	1696	2	2	0	1703
17748	6	24	0	1774	0	1804
17749	2	3	1817	20	0	1842
17750	4	1807	17	3	0	1831
17751	5	24	3	1814	0	1846
17752	2	2	1	1856	0	1861
17753	1	1	1822	25	0	1849
17754	3	1	1827	2	0	1833
17755	1820	1	23	11	0	1855
17756	23	2	1885	2	0	1912
17757	1867	3	23	5	0	1898
17758	1834	0	10	5	0	1849
17759	1832	3	3	4	0	1842
17760	1833	3	3	5	0	1844
17761	25	4	1776	3	0	1808
17762	8	1786	21	4	0	1819
17763	6	22	6	1785	0	1819
17764	6	3	1793	25	0	1827
17765	7	2	24	1745	0	1778
17766	7	1653	10	26	0	1696
17767	7	19	6	1794	0	1826
17768	8	2	5	1811	0	1826
17769	5	4	4	1774	0	1787
17770	1775	1	3	29	0	1808
17771	27	5	4	1761	0	1797
17772	8	0	3	1782	0	1793
17773	6	6	3	1766	0	1781
17774	5	1709	3	30	0	1747
17775	1701	21	3	16	0	1741
17776	25	1626	2	13	0	1666
17777	8	1678	3	6	0	1695
17778	6	25	3	1683	0	1717
17779	6	7	2	1663	0	1678
17780	1636	4	3	36	0	1679
17781	26	5	3	1647	0	1681
17782	1652	2	3	32	0	1689
17783	1913	5	2	11	0	1931
17784	41	5	2	1903	0	1951
17785	8	4	1	1934	0	1947
17786	5	1914	1	47	0	1967
17787	1976	39	2	12	0	2029
17788	46	2049	1	9	0	2105
17789	2063	48	1	11	0	2123
17790	52	14	2030	8	0	2104
17791	2031	7	38	12	0	2088
17792	2111	4	8	12	0	2135
17793	50	8	2	2050	0	2110
17794	17	5	2061	44	0	2127
17795	10	2051	37	25	0	2123
17796	12	44	10	2092	0	2158
17797	6	14	2102	48	0	2170
17798	13	6	45	2098	0	2162
17799	2078	5	11	48	0	2142
17800	56	2	2061	16	0	2135
17801	15	2041	45	10	0	2111
17802	11	2087	16	9	0	2123
17803	16	55	5	1917	0	1993
17804	9	2042	8	35	0	2094
17805	2032	50	6	21	0	2109
17806	2051	12	2	12	0	2077
17807	2040	6	10	9	0	2065
17808	52	10	1928	6	0	1996
17809	1959	12	43	7	0	2021
17810	52	5	10	1952	0	2019
17811	14	7	8	1984	0	2013
17812	13	8	6	1994	0	2021
17813	16	7	6	1981	0	2010
17814	12	7	1919	59	0	1997
17815	10	9	1919	22	0	1960
17816	9	3	1898	18	0	1928
17817	1835	7	51	11	0	1904
17818	51	1847	16	11	0	1925
17819	20	43	9	1856	0	1928
17820	1841	12	8	57	0	1918
17821	46	1856	7	23	0	1932
17822	20	1896	9	12	0	1937
17823	1854	51	13	10	0	1928
17824	1876	18	6	13	0	1913
17825	57	1876	4	9	0	1946
17826	19	46	9	1787	0	1861
17827	12	1814	6	46	0	1878
17828	1790	47	6	18	0	1861
17829	1798	21	6	12	0	1837
17830	1782	10	2	11	0	1805
17831	62	1715	3	9	0	1789
17832	25	41	2	1726	0	1794
17833	13	18	1700	50	0	1781
17834	15	10	42	1708	0	1775
17835	16	12	9	1731	0	1768
17836	18	8	1680	56	0	1762
17837	1682	1	49	21	0	1753
17838	55	12	11	1695	0	1773
17839	17	9	2	1717	0	1745
17840	10	1668	7	58	0	1743
17841	1665	43	10	23	0	1741
17842	50	19	4	1646	0	1719
17843	17	1636	4	61	0	1718
17844	1521	46	11	15	0	1593
17845	45	1503	4	13	0	1565
17846	1382	38	3	15	0	1438
17847	47	13	1350	8	0	1418
17848	11	19	1252	6	0	1288
17849	12	4	1215	7	0	1238
17850	8	1192	40	6	0	1246
17851	11	44	20	1091	0	1166
17852	12	1133	5	25	0	1175
17853	1144	33	3	12	0	1192
17854	39	12	1112	3	0	1166
17855	1104	3	32	8	0	1147
17856	1120	6	16	6	0	1148
17857	35	8	7	1098	0	1148
17858	1108	7	4	31	0	1150
17859	33	4	3	1111	0	1151
17860	13	8	1094	29	0	1144
17861	1092	3	26	14	0	1135
17862	27	1093	19	5	0	1144
17863	17	29	4	1101	0	1151
17864	1106	10	3	32	0	1151
17865	30	5	4	1101	0	1140
17866	15	4	1091	30	0	1140
17867	12	2	23	1088	0	1125
17868	3	1079	14	32	0	1128
17869	1085	27	3	12	0	1127
17870	28	11	5	1084	0	1128
17871	1091	2	5	32	0	1130
17872	28	5	4	1087	0	1124
17873	13	4	3	1080	0	1100
17874	4	1076	7	32	0	1119
17875	1080	24	1	14	0	1119
17876	28	1113	4	5	0	1150
17877	13	22	5	1038	0	1078
17878	5	1040	4	25	0	1074
17879	1032	22	2	10	0	1066
17880	1038	13	3	9	0	1063
17881	1044	6	0	13	0	1063
17882	36	985	1	5	0	1027
17883	11	735	2	4	0	752
17884	731	12	2	1	0	746
17885	9	753	0	4	0	766
17886	11	18	4	687	0	720
17887	10	7	657	7	0	681
17888	582	0	3	6	0	591
17889	583	2	5	3	0	593
17890	581	1	1	2	0	585
17891	7	573	1	4	0	585
17892	559	6	0	1	0	566
17893	6	3	573	1	0	583
17894	5	579	4	1	0	589
17895	1	10	3	527	0	541
17896	1	525	0	2	0	528
17897	500	0	1	3	0	504
17898	0	514	1	1	0	516
17899	3	0	0	523	0	526
17900	0	530	0	0	0	530
17901	1	1	0	542	0	544
17902	1	2	0	528	0	531
17903	1	1	520	1	0	523
17904	1	0	1	518	0	520
17905	517	1	2	1	0	521
17906	516	0	1	3	0	520
17907	2	1	0	522	0	525
17908	3	0	526	0	0	529
17909	0	2	0	525	0	527
17910	526	0	1	1	0	528
17911	550	0	1	3	0	554
17912	570	1	0	1	0	572
17913	1	591	0	1	0	593
17914	606	1	1	1	0	609
17915	1	1	595	1	0	598
17916	661	1	0	2	0	664
17917	1	0	1	679	0	681
17918	1	1	0	683	0	685
17919	0	0	2	680	0	682
17920	669	1	0	4	0	674
17921	664	0	1	2	0	667
17922	4	0	0	661	0	665
17923	4	0	691	1	0	696
17924	1	1	2	688	0	692
17925	1	0	1	688	0	690
17926	1	0	697	1	0	699
17927	1	699	1	3	0	704
17928	2	0	1	725	0	728
17929	729	1	0	5	0	735
17930	2	0	1	739	0	742
17931	4	1	0	738	0	743
17932	745	0	0	5	0	750
17933	1	742	2	3	0	748
17934	3	756	1	0	0	760
17935	759	1	0	3	0	763
17936	1	1	755	2	0	759
17937	745	0	2	1	0	748
17938	1	2	837	0	0	840
17939	3	840	1	2	0	846
17940	861	1	1	2	0	865
17941	866	2	1	2	0	871
17942	866	0	0	4	0	870
17943	871	1	0	4	0	876
17944	3	1	877	0	0	881
17945	2	2	1	867	0	872
17946	878	0	1	2	0	881
17947	2	1	915	2	0	920
17948	4	2	905	1	0	912
17949	1	898	2	2	0	903
17950	913	2	1	0	0	916
17951	2	2	0	911	0	915
17952	923	0	1	5	0	929
17953	2	937	0	0	0	939
17954	2	2	0	1026	0	1030
17955	3	0	0	1033	0	1036
17956	1	1	0	1062	0	1064
17957	3	1	1095	5	0	1104
17958	0	1111	6	3	0	1120
17959	1203	6	1	2	0	1212
17960	7	1	0	1203	0	1211
17961	1215	1	2	6	0	1224
17962	1204	2	0	3	0	1209
17963	12	1	0	1208	0	1221
17964	5	2	1222	9	0	1238
17965	4	1	7	1220	0	1232
17966	2	1225	3	8	0	1238
17967	2	5	1	1245	0	1253
17968	0	2	1245	7	0	1254
17969	1222	1	7	6	0	1236
17970	11	2	3	1253	0	1269
17971	1242	0	1	12	0	1255
17972	8	1	1239	4	0	1252
17973	1199	0	8	3	0	1210
17974	8	0	1233	3	0	1244
17975	1213	0	9	2	0	1224
17976	9	1184	3	1	0	1197
17977	4	1218	1	0	0	1223
17978	2	10	2	1242	0	1256
17979	3	6	0	1178	0	1187
17980	0	3	0	1234	0	1237
17981	1228	2	0	13	0	1243
17982	8	0	0	1246	0	1254
17983	3	0	1243	11	0	1257
17984	1229	0	7	10	0	1246
17985	10	1264	3	3	0	1280
17986	1280	8	0	5	0	1293
17987	1278	4	2	1	0	1285
17988	14	1	1284	0	0	1299
17989	9	2	9	1268	0	1288
17990	8	0	4	1337	0	1349
17991	3	0	1378	11	0	1392
17992	2	1366	10	5	0	1383
17993	1359	9	3	6	0	1377
17994	1371	3	3	6	0	1383
17995	12	3	3	1393	0	1411
17996	8	3	0	1404	0	1415
17997	6	0	1	1471	0	1478
17998	1441	0	1	21	0	1463
17999	13	1463	1	10	0	1487
18000	1473	12	1	7	0	1493
18001	1477	4	1	3	0	1485
18002	20	3	1532	0	0	1555
18003	11	1	11	1521	0	1544
18004	5	1558	5	14	0	1582
18005	4	15	4	1588	0	1611
18006	2	6	2	1650	0	1660
18007	2	5	1671	23	0	1701
18008	1731	2	16	12	0	1761
18009	1906	0	6	9	0	1921
18010	1974	0	7	5	0	1986
18011	42	1	2	1924	0	1969
18012	21	2	1	1915	0	1939
18013	9	1878	2	36	0	1925
18014	7	1946	2	17	0	1972
18015	1932	39	1	11	0	1983
18016	29	1879	0	7	0	1915
18017	15	37	1861	2	0	1915
18018	15	13	28	1870	0	1926
18019	1882	6	19	31	0	1938
18020	29	2	1870	18	0	1919
18021	17	6	1855	9	0	1887
18022	1893	5	37	7	0	1942
18023	1886	2	19	7	0	1914
18024	44	3	12	1864	0	1923
18025	24	4	1839	30	0	1897
18026	15	3	27	1860	0	1905
18027	8	3	1835	38	0	1884
18028	4	1	1883	21	0	1909
18029	4	1880	44	12	0	1940
18030	1897	28	21	11	0	1957
18031	1918	14	11	4	0	1947
18032	46	1904	6	2	0	1958
18033	27	32	4	1889	0	1952
18034	14	16	4	1909	0	1943
18035	10	8	3	1941	0	1962
18036	1894	6	5	54	0	1959
18037	29	1888	3	27	0	1947
18038	1821	31	5	16	0	1873
18039	1834	16	5	11	0	1866
18040	50	9	1772	5	0	1836
18041	26	1774	27	5	0	1832
18042	15	31	16	1796	0	1858
18043	7	16	1803	28	0	1854
18044	1777	8	30	21	0	1836
18045	1812	8	15	14	0	1849
18046	1811	5	8	12	0	1836
18047	1796	3	5	6	0	1810
18048	54	4	5	1736	0	1799
18049	28	2	1721	33	0	1784
18050	17	2	34	1719	0	1772
18051	1721	4	18	36	0	1779
18052	1722	4	9	17	0	1752
18053	46	1665	7	12	0	1730
18054	1619	27	5	7	0	1658
18055	39	16	1607	4	0	1666
18056	22	7	1577	7	0	1613
18057	1528	6	37	8	0	1579
18058	30	1526	21	8	0	1585
18059	16	22	11	1445	0	1494
18060	13	1440	5	23	0	1481
18061	15	27	1	1467	0	1510
18062	7	14	3	1485	0	1509
18063	10	11	5	1509	0	1535
18064	1471	4	2	42	0	1519
18065	1510	3	7	19	0	1539
18066	1488	5	4	12	0	1509
18067	43	4	1460	6	0	1513
18068	1486	2	27	6	0	1521
18069	35	6	18	1498	0	1557
18070	22	4	9	1583	0	1618
18071	11	4	1572	43	0	1630
18072	7	3	31	1726	0	1767
18073	1753	0	13	49	0	1815
18074	38	6	1747	19	0	1810
18075	21	4	36	1756	0	1817
18076	1763	2	16	37	0	1818
18077	1785	2	12	18	0	1817
18078	51	3	1749	10	0	1813
18079	29	4	1770	8	0	1811
18080	15	4	44	1782	0	1845
18081	1801	3	23	41	0	1868
18082	1828	5	12	21	0	1866
18083	51	5	5	1751	0	1812
18084	25	1789	7	37	0	1858
18085	1776	32	7	23	0	1838
18086	43	1806	4	17	0	1870
18087	24	40	4	1798	0	1866
18088	12	15	1789	36	0	1852
18089	11	6	1762	16	0	1795
18090	10	1	1764	12	0	1787
18091	10	2	49	1709	0	1770
18092	11	2	18	1747	0	1778
18093	1709	3	11	50	0	1773
18094	38	1681	5	25	0	1749
18095	1702	34	3	13	0	1752
18096	44	11	5	1626	0	1686
18097	18	1627	3	37	0	1685
18098	11	1690	6	15	0	1722
18099	9	32	9	1675	0	1725
18100	1654	16	7	36	0	1713
18101	32	1670	7	17	0	1726
18102	1583	29	6	8	0	1626
18103	32	1610	5	9	0	1656
18104	1607	28	3	7	0	1645
18105	36	11	1563	3	0	1613
18106	16	5	1521	4	0	1546
18107	7	1497	36	5	0	1545
18108	1358	37	33	4	0	1432
18109	22	1277	1	1	0	1301
18110	4	1202	1	3	0	1210
18111	7	20	3	1222	0	1252
18112	1223	6	2	20	0	1251
18113	17	1232	1	9	0	1259
18114	1213	12	2	2	0	1229
18115	13	1205	2	4	0	1224
18116	1197	13	6	2	0	1218
18117	17	1193	1	1	0	1212
18118	7	1205	3	0	0	1215
18119	3	17	0	1183	0	1203
18120	1	1182	2	18	0	1203
18121	1187	14	1	4	0	1206
18122	15	4	1178	2	0	1199
18123	6	2	13	1186	0	1207
18124	5	0	1211	15	0	1231
18125	3	6	14	1220	0	1243
18126	2	2	3	1215	0	1222
18127	3	3	1140	16	0	1162
18128	1075	1	14	11	0	1101
18129	15	1118	4	5	0	1142
18130	1128	15	5	2	0	1150
18131	15	1141	2	3	0	1161
18132	8	13	2	1139	0	1162
18133	1138	5	3	16	0	1162
18134	1145	1	4	7	0	1157
18135	1147	3	4	9	0	1163
18136	21	0	2	1141	0	1164
18137	5	2	4	1165	0	1176
18138	7	1177	2	16	0	1202
18139	1192	16	1	8	0	1217
18140	1208	6	1	7	0	1222
18141	1212	7	1	6	0	1226
18142	1205	5	3	3	0	1216
18143	17	1170	4	6	0	1197
18144	7	16	6	1178	0	1207
18145	5	4	1169	19	0	1197
18146	1163	2	18	13	0	1196
18147	1223	2	4	5	0	1234
18148	19	6	1194	5	0	1224
18149	11	3	1191	2	0	1207
18150	4	6	19	1222	0	1251
18151	5	5	6	1255	0	1271
18152	5	4	4	1271	0	1284
18153	1253	4	4	22	0	1283
18154	17	6	3	1262	0	1288
18155	5	4	1231	21	0	1261
18156	8	2	16	1238	0	1264
18157	6	7	1239	19	0	1271
18158	9	2	17	1248	0	1276
18159	4	4	8	1314	0	1330
18160	5	3	1317	23	0	1348
18161	1257	6	19	9	0	1291
18162	22	1310	4	9	0	1345
18163	1322	21	3	2	0	1348
18164	24	8	1	1394	0	1427
18165	1393	2	4	27	0	1426
18166	24	1477	2	5	0	1508
18167	7	1563	1	2	0	1573
18168	8	39	1	1662	0	1710
18169	3	12	1763	33	0	1811
18170	5	14	1697	8	0	1724
18171	8	1696	38	8	0	1750
18172	1492	31	11	11	0	1545
18173	27	10	10	1498	0	1545
18174	1482	3	11	28	0	1524
18175	29	1469	3	10	0	1511
18176	17	1503	6	6	0	1532
18177	9	35	5	1483	0	1532
18178	1482	13	2	27	0	1524
18179	1478	15	0	15	0	1508
18180	38	12	1436	5	0	1491
18181	17	4	1395	13	0	1429
18182	1422	8	30	3	0	1463
18183	35	1414	11	5	0	1465
18184	1396	28	14	4	0	1442
18185	36	7	9	1387	0	1439
18186	20	5	1370	27	0	1422
18187	1331	11	33	10	0	1385
18188	34	1355	13	5	0	1407
18189	12	1364	6	12	0	1394
18190	13	31	11	1346	0	1401
18191	1361	13	3	30	0	1407
18192	32	13	2	1363	0	1410
18193	1387	12	4	34	0	1437
18194	32	7	1353	19	0	1411
18195	1379	6	22	8	0	1415
18196	1395	6	4	9	0	1414
18197	45	4	1333	4	0	1386
18198	1317	2	31	10	0	1360
18199	45	1283	11	2	0	1341
18200	24	24	6	1296	0	1350
18201	11	1295	11	23	0	1340
18202	1320	30	4	8	0	1362
18203	35	16	5	1271	0	1327
18204	16	1241	4	28	0	1289
18205	9	34	2	1255	0	1300
18206	13	1267	6	30	0	1316
18207	3	33	2	1277	0	1315
18208	1265	18	1	34	0	1318
18209	33	8	3	1261	0	1305
18210	16	14	1234	33	0	1297
18211	1232	3	28	21	0	1284
18212	39	6	9	1238	0	1292
18213	14	3	1198	42	0	1257
18214	10	2	1195	11	0	1218
18215	15	1	1232	9	0	1257
18216	11	4	36	1214	0	1265
18217	8	3	23	1225	0	1259
18218	7	3	15	1233	0	1258
18219	9	4	13	1236	0	1262
18220	1207	2	5	51	0	1265
18221	1244	4	7	23	0	1278
18222	1250	4	5	17	0	1276
18223	1262	2	3	15	0	1282
18224	46	3	0	1222	0	1271
18225	21	3	1219	35	0	1278
18226	1241	1	23	17	0	1282
18227	1280	4	9	9	0	1302
18228	44	1	6	1254	0	1305
18229	19	3	8	1275	0	1305
18230	1279	4	5	39	0	1327
18231	40	1	7	1237	0	1285
18232	12	1198	8	42	0	1260
18233	1238	25	7	23	0	1293
18234	1250	9	3	14	0	1276
18235	41	3	1245	15	0	1304
18236	17	9	28	1247	0	1301
18237	22	2	8	1276	0	1308
18238	1248	5	6	37	0	1296
18239	1264	4	10	17	0	1295
18240	42	4	3	1240	0	1289
18241	22	3	1216	41	0	1282
18242	20	2	1218	14	0	1254
18243	17	2	34	1219	0	1272
18244	11	6	12	1247	0	1276
18245	1206	0	13	37	0	1256
18246	32	1161	10	15	0	1218
18247	16	1152	4	19	0	1191
18248	8	1185	6	20	0	1219
18249	18	34	5	1159	0	1216
18250	1146	18	3	34	0	1201
18251	1156	11	2	12	0	1181
18252	33	1143	2	10	0	1188
18253	1142	26	2	12	0	1182
18254	40	9	1	1139	0	1189
18255	18	8	1162	29	0	1217
18256	10	10	25	1160	0	1205
18257	16	1	9	1170	0	1196
18258	9	4	3	1170	0	1186
18259	1094	3	9	36	0	1142
18260	28	3	4	1066	0	1101
18261	11	1061	2	41	0	1115
18262	1036	22	3	22	0	1083
18263	34	1015	3	11	0	1063
18264	9	931	1	16	0	957
18265	10	972	3	8	0	993
18266	8	17	834	7	0	866
18267	5	792	13	3	0	813
18268	3	8	649	3	0	663
18269	545	0	8	1	0	554
18270	558	0	0	2	0	560
18271	2	0	583	1	0	586
18272	601	0	2	0	0	603
18273	614	0	0	1	0	615
18274	2	0	622	0	0	624
18275	0	646	2	0	0	648
18276	0	2	0	665	0	667
18277	682	0	0	4	0	686
18278	2	0	0	678	0	680
18279	718	0	0	3	0	721
18280	717	0	0	2	0	719
18281	2	1	720	0	0	723
18282	713	0	2	2	0	717
18283	3	751	0	1	0	755
18284	762	2	1	1	0	766
18285	4	0	0	770	0	774
18286	0	0	773	5	0	778
18287	1	1	3	768	0	773
18288	774	0	1	3	0	778
18289	3	768	1	2	0	774
18290	0	2	764	1	0	767
18291	3	0	3	759	0	765
18292	0	1	778	4	0	783
18293	1	797	2	1	0	801
18294	786	3	0	0	0	789
18295	2	1	0	797	0	800
18296	1	1	794	2	0	798
18297	1	2	765	0	0	768
18298	816	1	2	2	0	821
18299	4	0	0	809	0	813
18300	2	0	0	816	0	818
18301	0	2	822	2	0	826
18302	1	0	813	1	0	815
18303	1	868	3	2	0	874
18304	0	3	1	878	0	882
18305	3	0	0	890	0	893
18306	1	872	0	4	0	877
18307	0	5	872	1	0	878
18308	854	0	3	1	0	858
18309	4	1	0	891	0	896
18310	0	2	907	3	0	912
18311	2	2	3	890	0	897
18312	0	911	2	3	0	916
18313	0	4	916	1	0	921
18314	896	1	4	0	0	901
18315	4	2	925	1	0	932
18316	2	2	912	0	0	916
18317	2	0	902	0	0	904
18318	4	1	994	0	0	999
18319	3	0	5	1033	0	1041
18320	0	1	1075	4	0	1080
18321	1	1	5	1046	0	1053
18322	1	1074	1	6	0	1082
18323	1173	4	1	1	0	1179
18324	6	2	1	1177	0	1186
18325	5	1	1174	5	0	1185
18326	2	1175	4	3	0	1184
18327	6	4	2	1174	0	1186
18328	1172	2	1	3	0	1178
18329	4	1179	3	1	0	1187
18330	5	5	1	1206	0	1217
18331	1213	2	1	6	0	1222
18332	5	1	1207	3	0	1216
18333	1200	2	4	2	0	1208
18334	4	0	1229	1	0	1234
18335	1182	0	10	1	0	1193
18336	1194	0	5	3	0	1202
18337	6	0	1179	1	0	1186
18338	2	1175	3	1	0	1181
18339	2	3	2	1125	0	1132
18340	1	3	1204	2	0	1210
18341	2	1	3	1169	0	1175
18342	0	0	4	1183	0	1187
18343	0	0	1207	5	0	1212
18344	0	1	1182	3	0	1186
18345	1	1	4	1217	0	1223
18346	1231	0	3	8	0	1242
18347	2	1225	2	4	0	1233
18348	2	1230	2	2	0	1236
18349	1258	5	0	3	0	1266
18350	1284	2	1	4	0	1291
18351	7	1	0	1282	0	1290
18352	3	3	1	1287	0	1294
18353	5	1	0	1298	0	1304
18354	1289	0	0	5	0	1294
18355	3	1230	2	4	0	1239
18356	3	1260	0	4	0	1267
18357	1	4	1	1284	0	1290
18358	4	3	2	1295	0	1304
18359	4	1	1	1281	0	1287
18360	1286	1	1	6	0	1294
18361	3	1294	3	4	0	1304
18362	1321	3	1	2	0	1327
18363	4	2	1334	2	0	1342
18364	4	1347	5	1	0	1357
18365	0	6	3	1330	0	1339
18366	1318	4	2	8	0	1332
18367	5	0	1329	4	0	1338
18368	4	1	1313	3	0	1321
18369	1	1	8	1341	0	1351
18370	1	1	4	1342	0	1348
18371	2	1	1	1319	0	1323
18372	5	0	2	1273	0	1280
18373	3	0	0	1285	0	1288
18374	0	1266	0	9	0	1275
18375	2	5	0	1266	0	1273
18376	1243	2	1	8	0	1254
18377	5	1245	0	7	0	1257
18378	1263	5	0	5	0	1273
18379	5	5	1224	3	0	1237
18380	6	0	1217	3	0	1226
18381	2	2	9	1303	0	1316
18382	1	4	1566	9	0	1580
18383	5	1	24	1549	0	1579
18384	3	1	12	1541	0	1557
18385	1577	0	3	36	0	1616
18386	1580	0	4	17	0	1601
18387	36	1602	2	5	0	1645
18388	13	1664	2	8	0	1687
18389	12	38	1	1674	0	1725
18390	1694	18	2	36	0	1750
18391	32	6	1683	16	0	1737
18392	17	4	28	1678	0	1727
18393	8	1	16	1701	0	1726
18394	12	3	1665	45	0	1725
18395	4	1669	32	20	0	1725
18396	3	25	16	1666	0	1710
18397	3	17	1679	35	0	1734
18398	4	3	35	1669	0	1711
18399	1631	4	15	40	0	1690
18400	28	1629	7	20	0	1684
18401	16	1652	4	9	0	1681
18402	8	38	2	1644	0	1692
18403	1593	19	3	30	0	1645
18404	28	1604	4	17	0	1653
18405	1617	32	3	15	0	1667
18406	32	15	1608	12	0	1667
18407	18	5	1666	6	0	1695
18408	9	5	43	1618	0	1675
18409	6	3	19	1693	0	1721
18410	1648	0	11	54	0	1713
18411	38	3	6	1666	0	1713
18412	19	14	1638	39	0	1710
18413	11	11	28	1624	0	1674
18414	10	5	15	1662	0	1692
18415	11	3	1585	48	0	1647
18416	1544	6	31	24	0	1605
18417	33	6	15	1589	0	1643
18418	1502	2	7	42	0	1553
18419	33	1427	13	21	0	1494
18420	1429	34	7	10	0	1480
18421	31	1423	2	21	0	1477
18422	18	1421	10	11	0	1460
18423	21	45	13	1307	0	1386
18424	1307	17	6	39	0	1369
18425	1323	9	5	27	0	1364
18426	42	5	7	1305	0	1359
18427	1312	7	3	42	0	1364
18428	1322	7	5	19	0	1353
18429	45	13	7	1291	0	1356
18430	1256	8	1	44	0	1309
18431	39	1249	8	22	0	1318
18432	1267	34	10	7	0	1318
18433	40	18	1222	12	0	1292
18434	1285	8	31	17	0	1341
18435	40	6	16	1288	0	1350
18436	23	8	9	1314	0	1354
18437	16	3	7	1331	0	1357
18438	15	5	6	1329	0	1355
18439	6	9	7	1324	0	1346
18440	11	1207	10	52	0	1280
18441	13	1278	8	26	0	1325
18442	1264	43	6	23	0	1336
18443	41	17	1254	15	0	1327
18444	1250	9	32	16	0	1307
18445	54	7	1260	10	0	1331
18446	22	11	37	1247	0	1317
18447	17	10	18	1280	0	1325
18448	1242	8	10	56	0	1316
18449	48	7	1217	27	0	1299
18450	24	7	36	1215	0	1282
18451	20	7	1251	46	0	1324
18452	18	1279	37	25	0	1359
18453	19	39	15	1314	0	1387
18454	1323	20	5	48	0	1396
18455	1335	6	2	26	0	1369
18456	1373	12	5	12	0	1402
18457	61	1309	8	9	0	1387
18458	18	1360	10	12	0	1400
18459	1273	44	5	13	0	1335
18460	41	1353	3	14	0	1411
18461	24	1349	9	17	0	1399
18462	19	45	1298	18	0	1380
18463	12	1296	32	18	0	1358
18464	9	1299	12	20	0	1340
18465	12	45	8	1306	0	1371
18466	9	25	1302	42	0	1378
18467	14	12	1280	21	0	1327
18468	1264	8	49	16	0	1337
18469	50	8	1288	9	0	1355
18470	1300	7	43	11	0	1361
18471	53	4	15	1312	0	1384
18472	21	1320	13	39	0	1393
18473	1372	39	8	21	0	1440
18474	1442	15	7	19	0	1483
18475	46	12	7	1439	0	1504
18476	27	8	8	1458	0	1501
18477	18	9	8	1458	0	1493
18478	1413	4	10	59	0	1486
18479	1373	4	8	32	0	1417
18480	1440	6	7	19	0	1472
18481	50	1311	2	15	0	1378
18482	1052	15	2	10	0	1079
18483	26	1022	2	2	0	1052
18484	6	1038	3	3	0	1050
18485	14	35	3	971	0	1023
18486	2	991	5	10	0	1008
18487	934	13	4	2	0	953
18488	16	3	1	921	0	941
18489	901	2	1	9	0	913
18490	9	872	2	3	0	886
18491	3	908	0	6	0	917
18492	928	7	1	4	0	940
18493	11	947	2	2	0	962
18494	3	10	2	963	0	978
18495	6	2	0	980	0	988
18496	978	2	3	8	0	991
18497	11	2	0	986	0	999
18498	2	1	1014	10	0	1027
18499	2	1	9	1020	0	1032
18500	1053	1	1	13	0	1068
18501	10	1082	2	1	0	1095
18502	1123	9	2	4	0	1138
18503	1133	1	0	4	0	1138
18504	1147	2	4	1	0	1154
18505	14	2	1134	0	0	1150
18506	4	3	1110	3	0	1120
18507	1102	1	14	1	0	1118
18508	15	1116	3	1	0	1135
18509	1	14	3	1115	0	1133
18510	4	1	3	1125	0	1133
18511	6	1095	1	14	0	1116
18512	0	1125	0	3	0	1128
18513	3	16	2	1124	0	1145
18514	1	3	0	1139	0	1143
18515	2	4	1120	15	0	1141
18516	1	3	1091	3	0	1098
18517	1112	1	16	3	0	1132
18518	1162	1	3	3	0	1169
18519	17	1	2	1152	0	1172
18520	2	2	1155	16	0	1175
18521	6	1	15	1142	0	1164
18522	1147	2	3	19	0	1171
18523	15	2	1154	4	0	1175
18524	6	1	17	1177	0	1201
18525	3	1	1183	18	0	1205
18526	4	1167	17	3	0	1191
18527	1	18	1174	4	0	1197
18528	7	6	15	1162	0	1190
18529	1167	5	3	16	0	1191
18530	19	2	4	1194	0	1219
18531	1205	2	2	17	0	1226
18532	1230	2	0	6	0	1238
18533	1217	0	2	6	0	1225
18534	16	1	1188	4	0	1209
18535	1205	1	15	1	0	1222
18536	19	2	1	1212	0	1234
18537	5	1	3	1227	0	1236
18538	3	1	1215	16	0	1235
18539	6	2	9	1219	0	1236
18540	1225	4	1	17	0	1247
18541	12	1228	1	4	0	1245
18542	1261	9	4	3	0	1277
18543	1286	1	3	5	0	1295
18544	1290	4	3	2	0	1299
18545	18	3	1	1263	0	1285
18546	8	1	1276	16	0	1301
18547	8	0	11	1316	0	1335
18548	8	0	4	1324	0	1336
18549	1318	1	4	22	0	1345
18550	1315	0	2	4	0	1321
18551	18	2	1240	7	0	1267
18552	4	2	13	1251	0	1270
18553	7	0	1244	15	0	1266
18554	1297	2	13	3	0	1315
18555	16	1382	4	8	0	1410
18556	1384	12	3	7	0	1406
18557	17	1418	5	3	0	1443
18558	1413	18	4	6	0	1441
18559	21	1428	1	0	0	1450
18560	13	17	0	1415	0	1445
18561	6	6	2	1437	0	1451
18562	1437	3	2	20	0	1462
18563	1422	4	2	10	0	1438
18564	1429	0	3	6	0	1438
18565	1368	4	1	7	0	1380
18566	1406	2	1	3	0	1412
18567	27	2	1	1365	0	1395
18568	13	1360	0	19	0	1392
18569	11	19	2	1353	0	1385
18570	6	1346	1	20	0	1373
18571	4	20	2	1329	0	1355
18572	5	1323	2	24	0	1354
18573	7	24	1	1313	0	1345
18574	5	7	1258	21	0	1291
18575	1235	6	14	10	0	1265
18576	24	1251	2	9	0	1286
18577	1251	15	3	5	0	1274
18578	23	8	1238	3	0	1272
18579	1225	4	17	6	0	1252
18580	23	4	1273	4	0	1304
18581	10	3	21	1282	0	1316
18582	5	1359	5	22	0	1391
18583	5	22	1377	5	0	1409
18584	5	6	21	1389	0	1421
18585	1365	7	6	22	0	1400
18586	26	4	5	1403	0	1438
18587	8	6	1	1424	0	1439
18588	9	3	2	1437	0	1451
18589	7	2	1400	29	0	1438
18590	11	0	21	1391	0	1423
18591	6	1375	6	28	0	1415
18592	8	19	4	1363	0	1394
18593	10	6	6	1364	0	1386
18594	1343	4	3	31	0	1381
18595	24	2	4	1370	0	1400
18596	10	2	1377	32	0	1421
18597	4	5	1373	12	0	1394
18598	6	2	1352	12	0	1372
18599	1	1332	28	13	0	1374
18600	1307	19	18	5	0	1349
18601	20	1276	5	7	0	1308
18602	1234	25	8	7	0	1274
18603	22	11	5	1226	0	1264
18604	7	7	1242	19	0	1275
18605	10	2	1211	8	0	1231
18606	7	1243	25	6	0	1281
18607	3	20	13	1260	0	1296
18608	7	7	8	1263	0	1285
18609	6	3	6	1268	0	1283
18610	3	5	1247	29	0	1284
18611	1210	4	22	12	0	1248
18612	22	8	1234	7	0	1271
18613	9	1	20	1226	0	1256
18614	7	4	7	1252	0	1270
18615	2	3	1231	29	0	1265
18616	1199	3	25	15	0	1242
18617	26	1250	6	8	0	1290
18618	1225	20	7	11	0	1263
18619	24	7	2	1221	0	1254
18620	9	1213	5	27	0	1254
18621	7	24	8	1232	0	1271
18622	1237	7	3	29	0	1276
18623	22	10	5	1221	0	1258
18624	14	3	1191	32	0	1240
18625	1179	4	22	19	0	1224
18626	1198	5	11	5	0	1219
18627	29	4	1185	10	0	1228
18628	15	7	23	1180	0	1225
18629	1208	2	10	32	0	1252
18630	25	3	9	1177	0	1214
18631	17	6	3	1167	0	1193
18632	11	2	1	1178	0	1192
18633	8	2	3	1166	0	1179
18634	3	3	1122	38	0	1166
18635	8	2	23	1123	0	1156
18636	5	1	1115	31	0	1152
18637	1097	0	24	18	0	1139
18638	1118	4	12	15	0	1149
18639	1112	2	9	16	0	1139
18640	1125	0	8	9	0	1142
18641	36	2	3	1101	0	1142
18642	1077	1	6	27	0	1111
18643	30	2	1052	17	0	1101
18644	13	1	1059	10	0	1083
18645	1031	1	28	11	0	1071
18646	23	1010	10	9	0	1052
18647	10	1000	9	6	0	1025
18648	14	26	3	990	0	1033
18649	6	10	992	23	0	1031
18650	960	6	20	14	0	1000
18651	25	1	983	12	0	1021
18652	10	934	22	9	0	975
18653	8	18	917	8	0	951
18654	2	854	24	5	0	885
18655	739	23	14	14	0	790
18656	20	728	3	3	0	754
18657	4	707	7	3	0	721
18658	4	18	3	704	0	729
18659	2	7	698	18	0	725
18660	7	3	15	688	0	713
18661	5	2	5	711	0	723
18662	5	5	679	18	0	707
18663	3	3	12	691	0	709
18664	4	655	11	15	0	685
18665	1	13	5	688	0	707
18666	678	3	6	18	0	705
18667	19	2	3	685	0	709
18668	8	1	679	15	0	703
18669	4	6	14	694	0	718
18670	4	1	691	21	0	717
18671	689	1	17	12	0	719
18672	19	1	5	709	0	734
18673	703	2	5	19	0	729
18674	20	2	694	7	0	723
18675	665	0	15	10	0	690
18676	13	691	8	4	0	716
18677	8	12	694	8	0	722
18678	4	8	14	677	0	703
18679	8	0	695	15	0	718
18680	5	664	17	6	0	692
18681	6	679	5	6	0	696
18682	587	15	2	5	0	609
18683	9	627	5	5	0	646
18684	630	10	1	5	0	646
18685	12	4	3	636	0	655
18686	5	1	631	9	0	646
18687	2	633	12	8	0	655
18688	3	12	5	639	0	659
18689	4	10	0	673	0	687
18690	4	0	3	681	0	688
18691	3	1	2	674	0	680
18692	4	642	5	13	0	664
18693	3	667	3	6	0	679
18694	641	13	1	3	0	658
18695	11	622	1	1	0	635
18696	4	9	4	586	0	603
18697	3	2	578	9	0	592
18698	1	576	8	4	0	589
18699	2	8	5	566	0	581
18700	2	4	1	572	0	579
18701	2	572	1	11	0	586
18702	557	7	0	4	0	568
18703	8	3	553	3	0	567
18704	524	2	7	3	0	536
18705	8	549	3	1	0	561
18706	500	5	0	0	0	505
18707	5	507	0	0	0	512
18708	2	5	0	539	0	546
18709	0	2	0	545	0	547
18710	536	0	1	7	0	544
18711	5	1	0	540	0	546
18712	2	0	537	6	0	545
18713	0	521	5	3	0	529
18714	0	533	1	0	0	534
18715	2	6	0	528	0	536
18716	0	2	532	3	0	537
18717	1	0	3	515	0	519
18718	0	1	2	521	0	524
18719	1	0	509	5	0	515
18720	0	1	505	2	0	508
18721	0	510	5	1	0	516
18722	508	3	3	1	0	515
18723	4	2	0	498	0	504
18724	2	476	0	4	0	482
18725	494	3	1	2	0	500
18726	3	3	0	495	0	501
18727	2	1	0	485	0	488
18728	0	471	0	7	0	478
18729	0	4	1	467	0	472
18730	467	3	0	5	0	475
18731	5	1	0	471	0	477
18732	4	1	2	467	0	474
18733	1	1	461	6	0	469
18734	2	3	447	3	0	455
18735	459	3	5	1	0	468
18736	5	1	1	461	0	468
18737	3	2	0	464	0	469
18738	2	2	1	466	0	471
18739	2	1	458	7	0	468
18740	445	1	5	4	0	455
18741	4	2	2	439	0	447
18742	2	3	1	445	0	451
18743	436	0	0	8	0	444
18744	3	432	1	5	0	441
18745	1	4	445	6	0	456
18746	0	2	5	425	0	432
18747	2	446	4	5	0	457
18748	2	4	1	455	0	462
18749	439	4	2	6	0	451
18750	5	3	0	438	0	446
18751	440	3	1	5	0	449
18752	427	2	2	6	0	437
18753	8	1	4	424	0	437
18754	2	412	1	9	0	424
18755	0	426	1	9	0	436
18756	2	6	426	3	0	437
18757	2	4	6	415	0	427
18758	2	2	5	421	0	430
18759	3	0	3	423	0	429
18760	413	3	2	7	0	425
18761	6	4	1	419	0	430
18762	5	1	417	5	0	428
18763	423	2	3	7	0	435
18764	6	0	2	435	0	443
18765	5	3	1	436	0	445
18766	3	0	428	10	0	441
18767	429	3	5	5	0	442
18768	6	2	2	433	0	443
18769	4	2	443	7	0	456
18770	0	1	5	437	0	443
18771	2	0	5	409	0	416
18772	2	440	2	7	0	451
18773	438	4	3	7	0	452
18774	437	2	3	6	0	448
18775	6	437	3	2	0	448
18776	428	3	2	3	0	436
18777	428	3	0	4	0	435
18778	7	1	1	430	0	439
18779	4	1	411	8	0	424
18780	3	2	390	3	0	398
18781	2	3	386	3	0	394
18782	1	3	392	2	0	398
18783	4	4	8	347	0	363
18784	2	3	2	361	0	368
18785	1	1	0	343	0	345
18786	3	2	1	353	0	359
18787	355	0	1	11	0	367
18788	8	362	2	2	0	374
18789	363	3	0	6	0	372
18790	7	2	361	3	0	373
18791	5	2	383	3	0	393
18792	1	3	8	393	0	405
18793	395	1	7	6	0	409
18794	393	0	1	5	0	399
18795	8	398	3	2	0	411
18796	2	406	0	5	0	413
18797	3	5	1	415	0	424
18798	414	3	1	8	0	426
18799	7	414	2	3	0	426
18800	418	6	0	3	0	427
18801	427	3	0	3	0	433
18802	432	0	0	3	0	435
18803	7	1	414	2	0	424
18804	5	419	5	4	0	433
18805	416	6	3	3	0	428
18806	419	3	2	1	0	425
18807	7	402	4	2	0	415
18808	2	382	0	0	0	384
18809	384	5	0	2	0	391
18810	6	1	2	383	0	392
18811	2	2	385	5	0	394
18812	384	2	4	1	0	391
18813	6	1	1	390	0	398
18814	1	404	0	5	0	410
18815	2	5	2	402	0	411
18816	2	1	415	5	0	423
18817	3	0	3	414	0	420
18818	442	1	2	5	0	450
18819	6	1	0	450	0	457
18820	1	1	1	457	0	460
18821	0	1	485	8	0	494
18822	2	0	3	479	0	484
18823	1	487	2	4	0	494
18824	495	4	0	4	0	503
18825	496	2	1	1	0	500
18826	7	0	506	2	0	515
18827	2	0	4	495	0	501
18828	1	492	2	3	0	498
18829	2	506	0	2	0	510
18830	504	6	0	1	0	511
18831	5	3	0	514	0	522
18832	2	2	512	5	0	521
18833	1	1	515	1	0	518
18834	1	0	5	515	0	521
18835	515	1	2	6	0	524
18836	512	1	1	4	0	518
18837	6	0	0	547	0	553
18838	1	1	548	6	0	556
18839	1	552	4	3	0	560
18840	552	5	3	0	0	560
18841	4	548	0	4	0	556
18842	563	4	1	1	0	569
18843	5	2	1	560	0	568
18844	3	0	558	7	0	568
18845	1	2	6	544	0	553
18846	557	2	1	7	0	567
18847	5	2	564	3	0	574
18848	2	569	5	3	0	579
18849	4	3	2	572	0	581
18850	575	2	1	5	0	583
18851	4	0	580	3	0	587
18852	4	2	4	582	0	592
18853	4	1	1	599	0	605
18854	2	0	596	6	0	604
18855	0	2	6	585	0	593
18856	1	2	594	6	0	603
18857	590	0	5	3	0	598
18858	4	2	3	622	0	631
18859	3	2	656	6	0	667
18860	3	661	4	3	0	671
18861	685	6	3	3	0	697
18862	739	1	3	3	0	746
18863	11	2	2	834	0	849
18864	4	859	1	8	0	872
18865	865	10	0	4	0	879
18866	10	2	1	863	0	876
18867	3	3	868	10	0	884
18868	856	3	9	5	0	873
18869	10	850	2	3	0	865
18870	4	7	1	870	0	882
18871	861	3	5	9	0	878
18872	12	3	845	4	0	864
18873	2	3	850	5	0	860
18874	5	2	10	841	0	858
18875	4	1	867	10	0	882
18876	1	1	13	847	0	862
18877	2	855	5	13	0	875
18878	7	7	2	890	0	906
18879	891	3	4	12	0	910
18880	8	3	890	4	0	905
18881	4	903	9	2	0	918
18882	3	7	5	889	0	904
18883	2	3	923	9	0	937
18884	3	5	10	899	0	917
18885	3	907	2	9	0	921
18886	3	923	2	3	0	931
18887	905	5	9	5	0	924
18888	3	913	0	2	0	918
18889	2	5	893	1	0	901
18890	857	8	6	2	0	873
18891	4	1	894	2	0	901
18892	3	5	5	836	0	849
18893	1	1	889	2	0	893
18894	2	896	4	1	0	903
18895	1	7	2	888	0	898
18896	1	1	2	885	0	889
18897	4	2	1	864	0	871
18898	0	1	883	4	0	888
18899	2	0	3	869	0	874
18900	0	0	3	889	0	892
18901	868	1	1	9	0	879
18902	872	0	2	5	0	879
18903	4	1	899	4	0	908
18904	2	879	4	3	0	888
18905	2	5	892	1	0	900
18906	2	1	4	900	0	907
18907	0	1	926	4	0	931
18908	1	1	4	931	0	937
18909	1	1	2	940	0	944
18910	2	0	928	5	0	935
18911	898	1	3	5	0	907
18912	3	949	4	2	0	958
18913	4	4	1	953	0	962
18914	1	2	999	3	0	1005
18915	3	2	954	4	0	963
18916	955	1	5	3	0	964
18917	3	974	4	2	0	983
18918	4	4	2	977	0	987
18919	973	2	2	6	0	983
18920	6	1	1	973	0	981
18921	4	2	1	979	0	986
18922	1	1	988	6	0	996
18923	966	0	4	4	0	974
18924	982	1	3	2	0	988
18925	7	0	1	988	0	996
18926	970	3	0	5	0	978
18927	7	0	0	981	0	988
18928	4	963	1	6	0	974
18929	1	1002	2	4	0	1009
18930	3	5	1	1016	0	1025
18931	998	3	1	10	0	1012
18932	8	2	1	1001	0	1012
18933	1025	2	0	7	0	1034
18934	1031	0	1	5	0	1037
18935	12	1	0	1029	0	1042
18936	5	1	1	1038	0	1045
18937	3	0	1016	10	0	1029
18938	2	2	1025	5	0	1034
18939	1	1	10	1045	0	1057
18940	2	0	1091	8	0	1101
18941	1108	0	10	6	0	1124
18942	8	1	4	1224	0	1237
18943	4	1	1283	10	0	1298
18944	1327	0	11	10	0	1348
18945	1397	1	6	4	0	1408
18946	19	1476	3	4	0	1502
18947	16	15	5	1505	0	1541
18948	11	7	1560	15	0	1593
18949	1554	5	17	18	0	1594
18950	1599	4	11	6	0	1620
18951	26	1	1596	6	0	1629
18952	1612	0	19	2	0	1633
18953	26	3	10	1594	0	1633
18954	14	0	5	1624	0	1643
18955	1604	0	9	26	0	1639
18956	1613	1	0	17	0	1631
18957	30	8	3	1598	0	1639
18958	17	0	1602	18	0	1637
18959	10	1557	15	10	0	1592
18960	6	11	1569	6	0	1592
18961	3	5	1550	9	0	1567
18962	6	1506	27	1	0	1540
18963	13	16	16	1384	0	1429
18964	5	8	7	1402	0	1422
18965	2	6	1392	21	0	1421
18966	5	5	14	1385	0	1409
18967	1392	0	12	20	0	1424
18968	17	2	1402	13	0	1434
18969	1415	2	17	9	0	1443
18970	1438	1	9	10	0	1458
18971	1450	1	5	9	0	1465
18972	27	3	1431	4	0	1465
18973	20	3	1426	6	0	1455
18974	16	2	21	1425	0	1464
18975	9	0	15	1416	0	1440
18976	5	1433	10	22	0	1470
18977	1432	15	6	14	0	1467
18978	1427	8	4	13	0	1452
18979	27	1427	10	7	0	1471
18980	1437	18	4	11	0	1470
18981	25	1425	2	10	0	1462
18982	1441	16	5	9	0	1471
18983	23	13	4	1397	0	1437
18984	17	5	1393	18	0	1433
18985	13	5	1385	12	0	1415
18986	14	4	28	1390	0	1436
18987	5	4	10	1398	0	1417
18988	7	4	1396	27	0	1434
18989	8	3	20	1385	0	1416
18990	4	6	12	1399	0	1421
18991	1378	0	12	30	0	1420
18992	1381	1	11	17	0	1410
18993	1378	4	3	14	0	1399
18994	31	3	1329	12	0	1375
18995	23	1341	19	6	0	1389
18996	15	16	13	1364	0	1408
18997	12	9	1397	22	0	1440
18998	9	1395	24	9	0	1437
18999	1418	19	16	6	0	1459
19000	26	9	6	1426	0	1467
19001	14	4	9	1442	0	1469
19002	1406	6	8	34	0	1454
19003	22	2	8	1409	0	1441
19004	19	3	3	1442	0	1467
19005	1440	3	2	35	0	1480
19006	27	5	1406	15	0	1453
19007	19	1393	16	14	0	1442
19008	1400	17	15	14	0	1446
19009	25	17	1437	6	0	1485
19010	1437	6	21	10	0	1474
19011	22	1464	20	11	0	1517
19012	1469	19	9	11	0	1508
19013	1481	11	12	8	0	1512
19014	1432	10	6	18	0	1466
19015	37	4	6	1419	0	1466
19016	23	7	10	1429	0	1469
19017	16	1424	1	37	0	1478
19018	15	1423	6	19	0	1463
19019	16	1458	5	8	0	1487
19020	1448	23	5	10	0	1486
19021	24	15	1450	7	0	1496
19022	19	7	18	1443	0	1487
19023	13	5	17	1448	0	1483
19024	9	1454	8	34	0	1505
19025	8	24	6	1465	0	1503
19026	9	16	3	1461	0	1489
19027	10	1469	3	32	0	1514
19028	1465	20	9	17	0	1511
19029	20	1477	2	14	0	1513
19030	19	20	1461	9	0	1509
19031	1462	14	18	9	0	1503
19032	20	1486	10	9	0	1525
19033	1455	18	4	12	0	1489
19034	21	8	4	1457	0	1490
19035	13	8	10	1448	0	1479
19036	9	8	1432	24	0	1473
19037	9	7	1407	14	0	1437
19038	13	7	22	1406	0	1448
19039	1403	5	11	22	0	1441
19040	1382	1	9	15	0	1407
19041	23	1387	5	12	0	1427
19042	13	1305	0	7	0	1325
19043	8	1289	4	4	0	1305
19044	14	26	4	1204	0	1248
19045	1183	6	18	25	0	1232
19046	1165	1	0	6	0	1172
19047	1168	0	0	1	0	1169
19048	19	2	1125	1	0	1147
19049	4	1367	13	3	0	1387
19050	5	14	3	1516	0	1538
19051	1542	5	1	24	0	1572
19052	24	1	0	1586	0	1611
19053	8	0	0	1645	0	1653
19054	1626	0	0	36	0	1662
19055	1776	1	1	9	0	1787
19056	39	0	1750	0	0	1789
19057	11	3	28	1768	0	1810
19058	3	1	1762	32	0	1798
19059	4	2	29	1759	0	1794
19060	2	0	1749	34	0	1785
19061	7	2	29	1739	0	1777
19062	1713	0	11	34	0	1758
19063	31	1709	3	12	0	1755
19064	9	1776	2	5	0	1792
19065	5	40	2	1672	0	1719
19066	1	1787	2	30	0	1820
19067	1778	32	2	14	0	1826
19068	1771	9	1	4	0	1785
19069	42	1	1740	2	0	1785
19070	9	1728	31	1	0	1769
19071	7	26	9	1744	0	1786
19072	3	9	1742	29	0	1783
19073	1724	3	30	11	0	1768
19074	33	1	9	1743	0	1786
19075	9	1	1729	30	0	1769
19076	3	2	31	1742	0	1778
19077	1738	0	10	34	0	1782
19078	30	1	1723	12	0	1766
19079	1718	2	31	4	0	1755
19080	1748	0	9	5	0	1762
19081	41	1	2	1719	0	1763
19082	12	1	1727	28	0	1768
19083	3	2	1688	12	0	1705
19084	1702	0	35	5	0	1742
19085	1733	0	12	4	0	1749
19086	39	4	1692	4	0	1739
19087	17	1	29	1694	0	1741
19088	8	0	9	1699	0	1716
19089	4	1673	5	40	0	1722
19090	4	25	2	1704	0	1735
19091	1687	14	5	30	0	1736
19092	36	2	3	1703	0	1744
19093	10	4	1676	31	0	1721
19094	1677	0	31	17	0	1725
19095	35	1	11	1674	0	1721
19096	13	2	1667	32	0	1714
19097	4	1628	28	14	0	1674
19098	1603	29	9	7	0	1648
19099	29	1632	5	5	0	1671
19100	1640	26	3	6	0	1675
19101	35	10	1618	6	0	1669
19102	16	1581	30	6	0	1633
19103	4	1647	12	8	0	1671
19104	9	35	5	1589	0	1638
19105	5	9	4	1624	0	1642
19106	8	5	1566	37	0	1616
19107	5	4	29	1596	0	1634
19108	1579	3	16	33	0	1631
19109	28	1	1525	20	0	1574
19110	18	3	32	1527	0	1580
19111	8	3	1502	33	0	1546
19112	1475	3	30	21	0	1529
19113	32	1491	21	4	0	1548
19114	1492	32	3	18	0	1545
19115	1530	12	10	7	0	1559
19116	1534	4	5	10	0	1553
19117	51	6	1451	4	0	1512
19118	16	1467	31	6	0	1520
19119	2	32	18	1452	0	1504
19120	9	13	5	1509	0	1536
19121	1522	5	6	48	0	1581
19122	38	4	6	1542	0	1590
19123	1551	4	6	37	0	1598
19124	1540	2	6	25	0	1573
19125	1561	5	9	7	0	1582
19126	1558	3	9	11	0	1581
19127	59	4	5	1499	0	1567
19128	1518	0	4	35	0	1557
19129	38	4	1460	24	0	1526
19130	1460	4	37	4	0	1505
19131	1495	2	16	9	0	1522
19132	60	5	1413	30	0	1508
19133	1468	2	32	6	0	1508
19134	1486	1	18	9	0	1514
19135	54	4	5	1452	0	1515
19136	25	4	8	1482	0	1519
19137	1426	27	5	54	0	1512
19138	42	2	7	1460	0	1511
19139	24	3	7	1444	0	1478
19140	12	1376	5	54	0	1447
19141	15	27	8	1362	0	1412
19142	1333	14	3	34	0	1384
19143	36	1	3	1325	0	1365
19144	21	4	8	1294	0	1327
19145	10	1215	5	52	0	1282
19146	13	24	6	1183	0	1226
19147	15	13	3	1160	0	1191
19148	1113	2	6	38	0	1159
19149	27	18	3	840	0	888
19150	18	1	700	18	0	737
19151	5	640	15	13	0	673
19152	3	607	11	6	0	627
19153	558	14	2	7	0	581
19154	10	567	5	5	0	587
19155	433	3	4	4	0	444
19156	5	437	3	2	0	447
19157	459	5	3	4	0	471
19158	7	6	1	459	0	473
19159	8	2	0	463	0	473
19160	2	463	0	14	0	479
19161	6	6	0	474	0	486
19162	3	8	473	6	0	490
19163	466	1	7	6	0	480
19164	7	496	5	3	0	511
19165	483	4	1	3	0	491
19166	475	7	2	3	0	487
19167	482	2	2	1	0	487
19168	16	2	0	468	0	486
19169	9	2	0	476	0	487
19170	2	470	2	10	0	484
19171	475	2	1	8	0	486
19172	6	482	0	2	0	490
19173	476	5	0	2	0	483
19174	9	7	482	1	0	499
19175	528	1	5	2	0	536
19176	7	0	7	526	0	540
19177	8	0	520	8	0	536
19178	3	2	520	8	0	533
19179	3	0	12	524	0	539
19180	3	1	538	6	0	548
19181	2	1	7	527	0	537
19182	501	1	8	9	0	519
19183	9	1	2	507	0	519
19184	10	0	492	9	0	511
19185	4	480	5	9	0	498
19186	1	499	9	3	0	512
19187	4	13	2	489	0	508
19188	495	8	2	7	0	512
19189	9	4	0	504	0	517
19190	8	1	1	510	0	520
19191	4	1	0	517	0	522
19192	5	2	1	518	0	526
19193	4	2	510	14	0	530
19194	3	4	502	8	0	517
19195	512	0	13	4	0	529
19196	511	0	7	4	0	522
19197	13	1	1	507	0	522
19198	11	1	0	508	0	520
19199	2	0	504	18	0	524
19200	2	503	7	11	0	523
19201	491	7	8	2	0	508
19202	499	9	2	2	0	512
19203	22	2	0	486	0	510
19204	12	0	492	8	0	512
19205	6	0	6	493	0	505
19206	0	490	6	13	0	509
19207	2	7	489	9	0	507
19208	488	10	6	4	0	508
19209	9	2	7	494	0	512
19210	509	3	3	7	0	522
19211	10	0	489	10	0	509
19212	498	1	8	2	0	509
19213	10	1	7	491	0	509
19214	489	0	3	11	0	503
19215	8	3	4	479	0	494
19216	9	462	4	8	0	483
19217	2	475	1	12	0	490
19218	7	16	2	455	0	480
19219	4	7	466	8	0	485
19220	3	459	2	10	0	474
19221	3	5	5	397	0	410
19222	383	1	5	5	0	394
19223	388	1	1	3	0	393
19224	5	1	1	388	0	395
19225	4	0	0	387	0	391
19226	3	374	1	6	0	384
19227	0	392	0	5	0	397
19228	385	6	0	3	0	394
19229	4	3	1	378	0	386
19230	1	2	1	385	0	389
19231	2	0	385	6	0	393
19232	1	0	4	380	0	385
19233	1	0	2	377	0	380
19234	1	0	2	384	0	387
19235	0	0	382	9	0	391
19236	0	1	4	389	0	394
19237	387	0	4	6	0	397
19238	7	1	377	2	0	387
19239	398	0	5	2	0	405
19240	8	0	1	400	0	409
19241	1	0	2	410	0	413
19242	3	1	1	417	0	422
19243	0	0	407	10	0	417
19244	409	1	5	4	0	419
19245	6	420	3	1	0	430
19246	420	7	1	0	0	428
19247	9	430	1	0	0	440
19248	3	8	0	437	0	448
19249	437	2	2	6	0	447
19250	7	3	427	2	0	439
19251	425	0	6	3	0	434
19252	10	1	441	0	0	452
19253	3	4	8	435	0	450
19254	2	0	435	7	0	444
19255	0	431	8	3	0	442
19256	7	8	1	408	0	424
19257	396	1	2	6	0	405
19258	7	1	0	385	0	393
19259	1	377	0	5	0	383
19260	1	6	0	378	0	385
19261	371	0	0	7	0	378
19262	366	1	0	2	0	369
19263	7	356	0	2	0	365
19264	1	342	0	0	0	343
19265	1	6	0	335	0	342
19266	0	0	0	341	0	341
19267	339	1	0	4	0	344
19268	335	0	0	1	0	336
19269	4	337	0	1	0	342
19270	1	4	0	329	0	334
19271	1	1	0	333	0	335
19272	0	1	336	4	0	341
19273	0	338	4	1	0	343
19274	0	329	0	1	0	330
19275	0	5	1	296	0	302
19276	0	0	294	3	0	297
19277	0	1	301	0	0	302
19278	0	0	3	305	0	308
19279	0	0	1	303	0	304
19280	0	0	300	3	0	303
19281	0	0	3	308	0	311
19282	0	0	312	4	0	316
19283	325	0	4	0	0	329
19284	6	0	0	332	0	338
19285	0	0	348	5	0	353
19286	1	0	344	0	0	345
19287	1	0	5	356	0	362
19288	0	0	384	5	0	389
19289	0	0	399	0	0	399
19290	0	393	5	1	0	399
19291	401	5	1	1	0	408
19292	5	0	405	0	0	410
19293	0	1	5	401	0	407
19294	2	0	0	408	0	410
19295	1	0	1	412	0	414
19296	0	0	407	6	0	413
19297	2	0	5	402	0	409
19298	406	0	1	7	0	414
19299	5	1	1	399	0	406
19300	2	0	395	6	0	403
19301	1	1	5	400	0	407
19302	404	0	2	7	0	413
19303	413	0	2	3	0	418
19304	403	1	1	1	0	406
19305	9	0	0	403	0	412
19306	405	0	2	6	0	413
19307	406	0	0	4	0	410
19308	407	0	0	3	0	410
19309	7	395	0	0	0	402
19310	396	5	1	1	0	403
19311	8	1	0	394	0	403
19312	2	1	389	6	0	398
19313	1	393	5	1	0	400
19314	392	5	2	3	0	402
19315	6	1	1	393	0	401
19316	4	1	0	400	0	405
19317	1	392	0	7	0	400
19318	1	406	1	3	0	411
19319	380	6	2	3	0	391
19320	6	381	1	1	0	389
19321	370	6	0	1	0	377
19322	8	364	1	0	0	373
19323	364	7	1	1	0	373
19324	5	360	0	3	0	368
19325	1	369	0	4	0	374
19326	364	5	2	2	0	373
19327	4	3	360	1	0	368
19328	2	366	4	1	0	373
19329	2	4	1	367	0	374
19330	1	1	3	376	0	381
19331	0	2	1	373	0	376
19332	1	1	0	379	0	381
19333	3	0	372	7	0	382
19334	372	1	5	2	0	380
19335	6	0	1	384	0	391
19336	388	1	2	4	0	395
19337	410	0	0	1	0	411
19338	417	1	0	2	0	420
19339	407	2	1	0	0	410
19340	9	1	398	0	0	408
19341	3	0	6	406	0	415
19342	1	1	407	6	0	415
19343	0	399	8	2	0	409
19344	1	6	2	380	0	389
19345	1	1	1	392	0	395
19346	4	0	0	393	0	397
19347	0	0	0	379	0	379
19348	1	1	374	5	0	381
19349	1	1	4	374	0	380
19350	2	0	1	376	0	379
19351	381	1	1	6	0	389
19352	382	1	1	1	0	385
19353	9	2	1	383	0	395
19354	1	0	2	388	0	391
19355	0	2	3	392	0	397
19356	388	2	1	9	0	400
19357	400	1	1	4	0	406
19358	387	1	3	5	0	396
19359	399	1	0	5	0	405
19360	6	391	1	5	0	403
19361	400	5	1	5	0	411
19362	399	1	4	4	0	408
19363	7	1	1	399	0	408
19364	5	0	1	396	0	402
19365	392	0	0	10	0	402
19366	8	375	0	4	0	387
19367	4	389	0	5	0	398
19368	392	6	1	4	0	403
19369	9	1	0	398	0	408
19370	6	0	2	401	0	409
19371	3	0	1	400	0	404
19372	6	1	1	389	0	397
19373	4	2	1	386	0	393
19374	3	386	0	9	0	398
19375	3	6	0	375	0	384
19376	376	3	0	8	0	387
19377	8	1	1	372	0	382
19378	6	0	2	374	0	382
19379	365	3	2	10	0	380
19380	8	365	0	3	0	376
19381	7	6	0	352	0	365
19382	5	347	1	7	0	360
19383	3	7	0	327	0	337
19384	0	2	322	8	0	332
19385	301	0	4	6	0	311
19386	5	303	1	2	0	311
19387	288	6	2	1	0	297
19388	5	2	261	1	0	269
19389	3	0	3	248	0	254
19390	1	241	1	6	0	249
19391	1	256	0	4	0	261
19392	239	4	2	1	0	246
19393	3	2	0	244	0	249
19394	1	1	247	5	0	254
19395	1	1	3	252	0	257
19396	2	0	252	5	0	259
19397	248	1	3	1	0	253
19398	4	0	249	4	0	257
19399	1	1	3	249	0	254
19400	2	256	1	4	0	263
19401	1	3	0	253	0	257
19402	1	249	0	5	0	255
19403	254	4	0	2	0	260
19404	4	1	1	266	0	272
19405	4	0	275	4	0	283
19406	3	1	271	1	0	276
19407	280	0	3	3	0	286
19408	293	0	1	2	0	296
19409	293	0	1	2	0	296
19410	291	1	0	0	0	292
19411	5	291	1	0	0	297
19412	297	3	0	1	0	301
19413	298	1	0	2	0	301
19414	4	1	285	5	0	295
19415	1	1	3	293	0	298
19416	294	0	1	5	0	300
19417	5	1	285	3	0	294
19418	0	2	5	285	0	292
19419	1	1	296	6	0	304
19420	2	2	3	299	0	306
19421	2	308	0	4	0	314
19422	310	4	0	1	0	315
19423	7	0	293	1	0	301
19424	299	2	3	2	0	306
19425	4	1	1	304	0	310
19426	306	0	1	4	0	311
19427	5	0	1	309	0	315
19428	337	1	1	7	0	346
19429	6	1	345	2	0	354
19430	378	1	4	1	0	384
19431	5	1	0	388	0	394
19432	2	1	1	386	0	390
19433	382	0	0	5	0	387
19434	3	2	1	383	0	389
19435	1	0	373	6	0	380
19436	1	2	4	364	0	371
19437	348	0	0	4	0	352
19438	2	342	1	2	0	347
19439	1	336	0	0	0	337
19440	333	2	0	2	0	337
19441	3	357	0	0	0	360
19442	1	2	0	353	0	356
19443	353	0	1	3	0	357
19444	361	0	0	0	0	361
19445	362	1	0	0	0	363
19446	1	0	363	1	0	365
19447	0	0	1	359	0	360
19448	0	370	0	2	0	372
19449	0	1	1	368	0	370
19450	0	0	381	0	0	381
19451	0	375	1	0	0	376
19452	2	5	0	367	0	374
19453	361	0	0	1	0	362
19454	1	362	0	1	0	364
19455	0	1	377	0	0	378
19456	1	0	2	377	0	380
19457	0	1	376	2	0	379
19458	0	0	2	370	0	372
19459	377	0	1	3	0	381
19460	3	0	0	386	0	389
19461	396	0	0	3	0	399
19462	405	0	0	2	0	407
19463	3	403	0	1	0	407
19464	414	2	1	0	0	417
19465	2	409	0	1	0	412
19466	2	1	426	0	0	429
19467	0	2	2	437	0	441
19468	1	0	2	467	0	470
19469	2	0	462	4	0	468
19470	1	467	2	2	0	472
19471	470	2	1	1	0	474
19472	475	2	0	3	0	480
19473	4	0	4	488	0	496
19474	3	1	0	493	0	497
19475	3	0	0	500	0	503
19476	497	0	2	5	0	504
19477	2	1	486	5	0	494
19478	3	0	486	2	0	491
19479	1	0	3	504	0	508
19480	3	0	498	2	0	503
19481	1	0	493	3	0	497
19482	1	0	6	499	0	506
19483	2	0	523	4	0	529
19484	0	513	6	5	0	524
19485	2	2	5	528	0	537
19486	0	2	537	5	0	544
19487	2	0	5	529	0	536
19488	1	526	4	4	0	535
19489	2	2	0	551	0	555
19490	0	2	558	3	0	563
19491	2	1	2	541	0	546
19492	547	2	1	3	0	553
19493	2	0	552	5	0	559
19494	535	0	5	1	0	541
19495	2	554	1	3	0	560
19496	557	2	0	1	0	560
19497	2	3	3	559	0	567
19498	3	561	0	3	0	567
19499	585	5	0	3	0	593
19500	7	3	1	588	0	599
19501	3	0	596	7	0	606
19502	1	602	3	2	0	608
19503	4	3	2	606	0	615
19504	594	2	1	6	0	603
19505	580	1	2	3	0	586
19506	7	0	0	586	0	593
19507	2	1	572	6	0	581
19508	548	0	4	6	0	558
19509	5	2	579	0	0	586
19510	3	0	3	580	0	586
19511	586	0	4	5	0	595
19512	6	582	0	2	0	590
19513	588	3	2	3	0	596
19514	3	2	579	3	0	587
19515	597	0	4	1	0	602
19516	3	3	2	604	0	612
19517	4	0	0	611	0	615
19518	1	0	611	6	0	618
19519	4	1	3	589	0	597
19520	597	0	2	6	0	605
19521	3	0	2	605	0	610
19522	4	604	2	2	0	612
19523	1	3	1	616	0	621
19524	2	611	1	5	0	619
19525	1	3	612	4	0	620
19526	599	4	3	1	0	607
19527	4	0	2	622	0	628
19528	2	2	589	4	0	597
19529	1	575	3	2	0	581
19530	3	3	2	558	0	566
19531	0	2	0	558	0	560
19532	549	0	4	6	0	559
19533	4	1	0	567	0	572
19534	566	0	0	7	0	573
19535	564	0	0	5	0	569
19536	8	567	1	3	0	579
19537	575	3	0	5	0	583
19538	6	4	0	629	0	639
19539	6	0	640	4	0	650
19540	647	2	5	6	0	660
19541	9	0	2	628	0	639
19542	3	0	627	8	0	638
19543	616	2	7	3	0	628
19544	9	0	3	628	0	640
19545	3	639	0	10	0	652
19546	1	5	3	625	0	634
19547	3	639	1	7	0	650
19548	628	5	0	7	0	640
19549	7	5	627	0	0	639
19550	3	621	5	4	0	633
19551	1	8	4	624	0	637
19552	4	6	630	6	0	646
19553	3	0	614	5	0	622
19554	1	624	8	1	0	634
19555	0	8	2	613	0	623
19556	3	3	3	621	0	630
19557	2	0	4	781	0	787
19558	799	3	1	10	0	813
19559	7	3	881	6	0	897
19560	3	886	9	4	0	902
19561	4	11	4	900	0	919
19562	5	3	2	919	0	929
19563	0	3	902	14	0	919
19564	1	6	11	893	0	911
19565	1	1	899	17	0	918
19566	0	0	871	8	0	879
19567	1	0	871	4	0	876
19568	3	2	17	834	0	856
19569	1	2	5	851	0	859
19570	3	0	4	854	0	861
19571	844	0	3	17	0	864
19572	13	841	1	5	0	860
19573	841	11	1	7	0	860
19574	830	3	1	5	0	839
19575	850	2	2	2	0	856
19576	16	852	1	6	0	875
19577	857	11	4	3	0	875
19578	864	3	1	3	0	871
19579	16	4	1	854	0	875
19580	7	2	1	871	0	881
19581	5	3	2	874	0	884
19582	3	0	851	19	0	873
19583	842	1	13	5	0	861
19584	15	1	3	858	0	877
19585	837	1	7	15	0	860
19586	15	836	2	6	0	859
19587	9	11	1	841	0	862
19588	5	3	2	850	0	860
19589	829	4	1	14	0	848
19590	11	4	1	832	0	848
19591	790	1	2	19	0	812
19592	825	1	2	7	0	835
19593	16	792	1	6	0	815
19594	8	814	1	3	0	826
19595	10	15	3	805	0	833
19596	3	820	2	14	0	839
19597	2	14	1	813	0	830
19598	4	5	796	15	0	820
19599	4	4	773	8	0	789
19600	763	2	15	10	0	790
19601	780	1	7	3	0	791
19602	16	770	5	4	0	795
19603	776	11	1	3	0	791
19604	14	792	1	10	0	817
19605	5	17	1	805	0	828
19606	4	5	1	812	0	822
19607	10	4	2	808	0	824
19608	2	2	2	818	0	824
19609	797	2	5	19	0	823
19610	13	796	4	10	0	823
19611	794	12	3	10	0	819
19612	803	4	4	4	0	815
19613	18	5	779	6	0	808
19614	784	2	12	7	0	805
19615	16	771	4	6	0	797
19616	12	10	3	767	0	792
19617	9	6	1	760	0	776
19618	7	768	1	13	0	789
19619	773	14	2	7	0	796
19620	15	9	754	7	0	785
19621	755	5	10	7	0	777
19622	17	5	757	4	0	783
19623	8	2	16	759	0	785
19624	5	3	6	780	0	794
19625	8	2	7	781	0	798
19626	786	5	7	26	0	824
19627	17	4	814	14	0	849
19628	817	2	15	11	0	845
19629	821	4	9	7	0	841
19630	824	2	6	5	0	837
19631	813	4	5	9	0	831
19632	22	2	5	807	0	836
19633	10	2	795	18	0	825
19634	7	3	13	793	0	816
19635	7	1	791	20	0	819
19636	3	4	782	10	0	799
19637	9	771	14	9	0	803
19638	10	11	11	722	0	754
19639	5	9	4	726	0	744
19640	10	5	1	684	0	700
19641	8	4	0	726	0	738
19642	719	0	2	17	0	738
19643	712	3	3	9	0	727
19644	18	1	3	707	0	729
19645	11	1	700	12	0	724
19646	11	1	8	706	0	726
19647	5	2	2	725	0	734
19648	3	2	708	19	0	732
19649	4	2	12	703	0	721
19650	702	2	2	18	0	724
19651	698	0	7	9	0	714
19652	697	1	2	7	0	707
19653	13	5	0	687	0	705
19654	691	1	0	15	0	707
19655	690	3	0	9	0	702
19656	13	2	681	9	0	705
19657	7	0	500	8	0	515
19658	8	1	501	0	0	510
19659	396	0	5	0	0	401
19660	1	389	3	2	0	395
19661	389	0	4	0	0	393
19662	1	439	1	4	0	445
19663	1	1	0	447	0	449
19664	1	1	2	459	0	463
19665	0	1	0	457	0	458
19666	2	0	454	2	0	458
19667	434	0	0	3	0	437
19668	3	0	1	450	0	454
19669	1	0	451	2	0	454
19670	3	0	430	1	0	434
19671	432	0	1	1	0	434
19672	0	443	3	0	0	446
19673	444	0	2	0	0	446
19674	441	1	1	0	0	443
19675	1	441	0	0	0	442
19676	437	0	0	0	0	437
19677	1	1	443	0	0	445
19678	1	1	423	0	0	425
19679	1	0	455	0	0	456
19680	0	3	4	437	0	444
19681	1	0	449	0	0	450
19682	435	1	0	2	0	438
19683	448	0	2	0	0	450
19684	2	0	452	0	0	454
19685	2	0	0	447	0	449
19686	460	0	2	0	0	462
19687	0	478	0	2	0	480
19688	2	489	0	0	0	491
19689	506	2	0	0	0	508
19690	0	2	514	0	0	516
19691	2	1	0	497	0	500
19692	0	0	2	505	0	507
19693	0	0	0	513	0	513
19694	1	509	0	2	0	512
19695	4	0	1	505	0	510
19696	553	2	0	1	0	556
19697	0	0	0	566	0	566
19698	2	564	0	3	0	569
19699	583	3	0	1	0	587
19700	3	1	0	594	0	598
19701	3	0	0	628	0	631
19702	643	0	0	5	0	648
19703	646	0	0	3	0	649
19704	4	0	0	651	0	655
19705	684	0	0	3	0	687
19706	684	0	1	3	0	688
19707	8	703	0	0	0	711
19708	710	4	0	1	0	715
19709	5	700	1	0	0	706
19710	2	5	1	706	0	714
19711	1	2	720	5	0	728
19712	1	1	5	730	0	737
19713	1	0	2	735	0	738
19714	1	0	0	743	0	744
19715	733	1	0	7	0	741
19716	6	741	0	4	0	751
19717	773	5	0	0	0	778
19718	4	805	1	0	0	810
19719	818	5	1	0	0	824
19720	820	2	0	1	0	823
19721	827	0	1	0	0	828
19722	808	0	0	3	0	811
19723	7	0	809	0	0	816
19724	2	0	6	818	0	826
19725	1	0	2	841	0	844
19726	1	0	809	8	0	818
19727	780	1	7	3	0	791
19728	8	0	2	803	0	813
19729	3	0	793	8	0	804
19730	0	0	781	2	0	783
19731	0	0	10	797	0	807
19732	0	0	822	8	0	830
19733	3	0	7	818	0	828
19734	0	1	2	832	0	835
19735	0	0	813	11	0	824
19736	796	1	8	3	0	808
19737	10	0	3	807	0	820
19738	3	0	828	12	0	843
19739	4	0	7	832	0	843
19740	840	0	3	10	0	853
19741	8	1	837	3	0	849
19742	827	0	8	2	0	837
19743	860	1	3	0	0	864
19744	15	0	0	856	0	871
19745	3	0	1	847	0	851
19746	1	0	853	11	0	865
19747	3	0	8	855	0	866
19748	1	1	2	806	0	810
19749	3	0	1	866	0	870
19750	0	2	851	11	0	864
19751	838	0	8	4	0	850
19752	871	1	4	3	0	879
19753	911	0	0	3	0	914
19754	942	1	1	3	0	947
19755	14	1	1	940	0	956
19756	930	1	0	10	0	941
19757	932	2	2	9	0	945
19758	840	3	3	7	0	853
19759	936	1	3	4	0	944
19760	11	932	2	6	0	951
19761	946	9	3	4	0	962
19762	920	2	1	5	0	928
19763	17	903	2	5	0	927
19764	905	10	5	3	0	923
19765	18	4	1	910	0	933
19766	5	3	3	921	0	932
19767	915	0	2	18	0	935
19768	16	887	2	11	0	916
19769	8	904	1	5	0	918
19770	6	12	4	925	0	947
19771	3	4	935	15	0	957
19772	6	1	12	929	0	948
19773	5	0	6	944	0	955
19774	937	3	4	14	0	958
19775	942	0	2	8	0	952
19776	15	1	4	935	0	955
19777	5	0	927	17	0	949
19778	5	0	14	939	0	958
19779	952	0	4	16	0	972
19780	13	2	983	5	0	1003
19781	5	996	11	9	0	1021
19782	1017	13	7	4	0	1041
19783	16	3	2	1021	0	1042
19784	7	1	2	1021	0	1031
19785	5	2	2	1036	0	1045
19786	7	1	1015	18	0	1041
19787	932	0	14	9	0	955
19788	17	1	967	2	0	987
19789	8	975	13	6	0	1002
19790	11	12	3	980	0	1006
19791	5	3	5	1003	0	1016
19792	8	3	1	1063	0	1075
19793	7	0	1057	18	0	1082
19794	4	2	1050	9	0	1065
19795	5	1	1051	8	0	1065
19796	4	1055	18	9	0	1086
19797	7	14	6	1064	0	1091
19798	1084	4	4	21	0	1113
19799	1166	3	4	7	0	1180
19800	27	3	1197	6	0	1233
19801	11	1202	19	8	0	1240
19802	6	18	1194	6	0	1224
19803	7	1211	20	6	0	1244
19804	1187	22	18	4	0	1231
19805	1186	6	8	3	0	1203
19806	18	1177	4	5	0	1204
19807	1168	21	3	2	0	1194
19808	22	5	4	1157	0	1188
19809	10	5	4	1161	0	1180
19810	1171	4	2	19	0	1196
19811	1136	2	2	10	0	1150
19812	1131	4	1	9	0	1145
19813	26	1095	4	3	0	1128
19814	8	1144	3	10	0	1165
19815	1144	18	4	5	0	1171
19816	24	7	1121	4	0	1156
19817	9	17	17	1098	0	1141
19818	1079	3	6	17	0	1105
19819	19	1055	5	9	0	1088
19820	8	1083	3	8	0	1102
19821	1082	19	2	6	0	1109
19822	20	7	1057	5	0	1089
19823	1036	9	14	6	0	1065
19824	22	7	1036	0	0	1065
19825	9	7	1036	0	0	1052
19826	9	3	18	1036	0	1066
19827	4	3	1052	13	0	1072
19828	1034	2	18	7	0	1061
19829	1052	2	7	5	0	1066
19830	1060	1	9	1	0	1071
19831	1058	0	4	6	0	1068
19832	25	2	2	1020	0	1049
19833	1022	1	2	15	0	1040
19834	20	1009	0	8	0	1037
19835	15	11	1	1001	0	1028
19836	10	1024	4	14	0	1052
19837	1049	14	2	9	0	1074
19838	1052	6	3	7	0	1068
19839	20	4	4	1045	0	1073
19840	1054	6	2	14	0	1076
19841	1062	2	3	9	0	1076
19842	23	4	1	1033	0	1061
19843	14	1	0	1041	0	1056
19844	12	1	3	1057	0	1073
19845	7	2	1027	21	0	1057
19846	4	1	998	14	0	1017
19847	5	3	1004	7	0	1019
19848	4	1	19	1019	0	1043
19849	5	1	1024	18	0	1048
19850	4	4	19	1024	0	1051
19851	6	1	1079	16	0	1102
19852	5	4	1047	10	0	1066
19853	1016	1	22	10	0	1049
19854	20	998	10	5	0	1033
19855	1013	13	7	4	0	1037
19856	20	7	6	1003	0	1036
19857	10	5	5	1007	0	1027
19858	8	3	995	22	0	1028
19859	5	995	13	11	0	1024
19860	7	11	7	995	0	1020
19861	8	4	1005	19	0	1036
19862	5	975	16	11	0	1007
19863	5	11	9	987	0	1012
19864	974	9	4	16	0	1003
19865	975	7	4	10	0	996
19866	18	3	8	975	0	1004
19867	981	3	3	14	0	1001
19868	16	989	2	10	0	1017
19869	12	14	4	997	0	1027
19870	5	9	1022	19	0	1055
19871	7	5	18	1012	0	1042
19872	8	2	1022	21	0	1053
19873	1014	5	20	7	0	1046
19874	21	5	6	1031	0	1063
19875	10	1028	10	17	0	1065
19876	5	20	5	1063	0	1093
19877	5	6	1042	24	0	1077
19878	7	6	1072	8	0	1093
19879	9	3	1028	4	0	1044
19880	978	12	23	7	0	1020
19881	19	981	8	5	0	1013
19882	7	18	4	982	0	1011
19883	981	3	5	19	0	1008
19884	20	972	9	4	0	1005
19885	1024	16	3	10	0	1053
19886	1038	6	2	7	0	1053
19887	1055	6	1	2	0	1064
19888	1056	5	1	7	0	1069
19889	25	5	1009	5	0	1044
19890	993	2	17	6	0	1018
19891	25	1	998	2	0	1026
19892	908	3	18	6	0	935
19893	22	1	7	931	0	961
19894	10	1	913	17	0	941
19895	6	909	17	5	0	937
19896	5	51	6	868	0	930
19897	4	896	1	14	0	915
19898	3	896	4	6	0	909
19899	797	9	9	5	0	820
19900	9	2	761	3	0	775
19901	2	730	7	1	0	740
19902	716	8	6	5	0	735
19903	8	748	0	0	0	756
19904	736	7	6	2	0	751
19905	9	0	0	731	0	740
19906	734	1	1	6	0	742
19907	9	0	0	724	0	733
19908	736	0	0	9	0	745
19909	8	0	1	735	0	744
19910	1	774	0	7	0	782
19911	0	7	1	794	0	802
19912	795	0	0	7	0	802
19913	7	789	1	0	0	797
19914	2	7	0	795	0	804
19915	810	0	0	11	0	821
19916	7	1	1	813	0	822
19917	2	1	0	813	0	816
19918	0	1	818	8	0	827
19919	2	1	814	0	0	817
19920	0	1	7	802	0	810
19921	2	0	856	7	0	865
19922	1	0	8	850	0	859
19923	2	2	0	788	0	792
19924	1	1	0	857	0	859
19925	1	1	854	7	0	863
19926	1	1	6	824	0	832
19927	3	0	0	848	0	851
19928	1	857	0	8	0	866
19929	1	8	0	863	0	872
19930	861	0	0	10	0	871
19931	10	0	0	876	0	886
19932	0	0	1012	10	0	1022
19933	1010	1	10	5	0	1026
19934	12	1124	5	3	0	1144
19935	8	15	4	1150	0	1177
19936	7	7	1130	17	0	1161
19937	1097	5	15	8	0	1125
19938	16	1110	4	13	0	1143
19939	1128	15	6	7	0	1156
19940	22	6	5	1118	0	1151
19941	1116	6	3	20	0	1145
19942	22	2	1119	7	0	1150
19943	8	1110	16	8	0	1142
19944	7	1182	6	4	0	1199
19945	1196	21	5	5	0	1227
19946	1212	12	1	5	0	1230
19947	21	6	1193	1	0	1221
19948	1189	3	18	3	0	1213
19949	1218	3	6	7	0	1234
19950	1213	2	6	6	0	1227
19951	28	1162	2	1	0	1193
19952	13	1175	1	5	0	1194
19953	1179	20	1	2	0	1202
19954	1185	9	1	4	0	1199
19955	22	1199	2	1	0	1224
19956	14	17	0	1208	0	1239
19957	9	7	1210	14	0	1240
19958	1204	7	15	10	0	1236
19959	1193	4	8	15	0	1220
19960	1293	5	6	6	0	1310
19961	28	1275	2	0	0	1305
19962	13	14	1300	2	0	1329
19963	1340	6	13	2	0	1361
19964	18	6	7	1348	0	1379
19965	11	3	7	1365	0	1386
19966	8	1	1	1392	0	1402
19967	2	1	1374	23	0	1400
19968	3	0	13	1351	0	1367
19969	2	3	1383	18	0	1406
19970	0	1326	17	9	0	1352
19971	1317	9	6	11	0	1343
19972	9	1313	8	3	0	1333
19973	6	1343	1	5	0	1355
19974	1335	14	2	5	0	1356
19975	11	1366	2	0	0	1379
19976	7	16	0	1339	0	1362
19977	7	1340	1	8	0	1356
19978	1318	19	0	7	0	1344
19979	12	1331	0	4	0	1347
19980	8	15	1	1342	0	1366
19981	8	9	1348	11	0	1376
19982	3	7	10	1366	0	1386
19983	2	1371	6	17	0	1396
19984	4	9	6	1404	0	1423
19985	2	7	2	1362	0	1373
19986	4	10	1	1356	0	1371
19987	1	2	3	1388	0	1394
19988	4	2	1	1389	0	1396
19989	2	1	1	1394	0	1398
19990	0	2	1393	25	0	1420
19991	1371	2	12	19	0	1404
19992	11	0	9	1477	0	1497
19993	10	2	1490	18	0	1520
19994	9	1	1485	12	0	1507
19995	5	4	23	1517	0	1549
19996	1524	1	16	19	0	1560
19997	17	4	1494	11	0	1526
19998	1481	2	17	12	0	1512
19999	22	3	1535	1	0	1561
20000	13	0	18	1542	0	1573
20001	12	2	10	1579	0	1603
20002	6	1	1563	22	0	1592
20003	1499	2	18	17	0	1536
20004	17	5	10	1547	0	1579
20005	9	2	1554	20	0	1585
20006	10	1	1578	13	0	1602
20007	7	2	28	1546	0	1583
20008	4	1578	18	15	0	1615
20009	1589	15	9	13	0	1626
20010	1587	8	5	14	0	1614
20011	31	7	1589	1	0	1628
20012	18	4	19	1575	0	1616
20013	1606	5	10	20	0	1641
20014	22	2	1600	10	0	1634
20015	1564	2	18	11	0	1595
20016	27	1574	11	5	0	1617
20017	10	15	8	1625	0	1658
20018	11	9	4	1634	0	1658
20019	1661	6	4	28	0	1699
20020	26	1	3	1680	0	1710
20021	18	3	2	1647	0	1670
20022	7	4	4	1677	0	1692
20023	1644	1	3	37	0	1685
20024	26	3	1630	19	0	1678
20025	1636	1	21	17	0	1675
20026	1657	1	10	9	0	1677
20027	1673	1	7	10	0	1691
20028	39	1	2	1633	0	1675
20029	18	1	1674	26	0	1719
20030	11	1645	23	13	0	1692
20031	7	1682	10	9	0	1708
20032	4	1599	3	2	0	1608
20033	8	23	1606	3	0	1640
20034	7	13	27	1773	0	1820
20035	1808	1	37	30	0	1876
20036	1977	1	3	14	0	1995
20037	43	2	1	2043	0	2089
20038	13	1	2036	31	0	2081
20039	0	3	2041	13	0	2057
20040	2	0	39	2060	0	2101
20041	3	0	2097	32	0	2132
20042	3	0	30	2124	0	2157
20043	8	0	12	2103	0	2123
20044	2	2090	3	43	0	2138
20045	4	29	3	2133	0	2169
20046	4	13	4	2187	0	2208
20047	2157	1	4	47	0	2209
20048	40	3	3	2163	0	2209
20049	18	2	3	2180	0	2203
20050	2128	2	2	52	0	2184
20051	36	2122	5	19	0	2182
20052	2137	34	8	8	0	2187
20053	37	12	2115	10	0	2174
20054	2107	0	40	8	0	2155
20055	2119	1	16	13	0	2149
20056	49	1	2068	11	0	2129
20057	19	4	2076	7	0	2106
20058	8	3	46	2016	0	2073
20059	2011	3	14	42	0	2070
20060	41	3	1972	19	0	2035
20061	24	0	38	1968	0	2030
20062	3	2	1956	43	0	2004
20063	8	1	39	1953	0	2001
20064	8	2	17	1978	0	2005
20065	1947	1	6	55	0	2009
20066	1958	2	6	19	0	1985
20067	1972	2	9	13	0	1996
20068	51	0	1962	9	0	2022
20069	17	2	1950	11	0	1980
20070	12	3	51	1925	0	1991
20071	11	4	16	1966	0	1997
20072	14	2	10	1987	0	2013
20073	1927	2	8	49	0	1986
20074	41	1910	9	21	0	1981
20075	1884	34	11	15	0	1944
20076	1877	12	8	15	0	1912
20077	52	1842	10	10	0	1914
20078	22	1885	5	13	0	1925
20079	1866	45	6	15	0	1932
20080	43	12	5	1858	0	1918
20081	22	1840	7	50	0	1919
20082	19	33	6	1857	0	1915
20083	15	13	1813	51	0	1892
20084	13	3	36	1840	0	1892
20085	1819	5	24	49	0	1897
20086	49	1	1793	24	0	1867
20087	20	3	1815	17	0	1855
20088	23	24	49	1717	0	1813
20089	14	1734	17	43	0	1808
20090	12	1721	6	24	0	1763
20091	7	1782	10	22	0	1821
20092	1722	38	13	22	0	1795
20093	1728	11	2	25	0	1766
20094	1684	7	6	14	0	1711
20095	40	1673	8	21	0	1742
20096	1703	31	7	16	0	1757
20097	1694	15	7	17	0	1733
20098	49	8	1675	10	0	1742
20099	21	1636	39	10	0	1706
20100	13	35	21	1630	0	1699
20101	1626	14	8	39	0	1687
20102	46	6	1617	20	0	1689
20103	22	7	37	1591	0	1657
20104	18	1595	21	36	0	1670
20105	10	31	13	1615	0	1669
20106	16	12	11	1608	0	1647
20107	1585	6	12	52	0	1655
20108	1605	8	10	26	0	1649
20109	54	3	13	1583	0	1653
20110	19	10	1567	45	0	1641
20111	15	9	1543	28	0	1595
20112	1574	7	39	14	0	1634
20113	46	4	1581	16	0	1647
20114	32	4	32	1491	0	1559
20115	24	1509	19	35	0	1587
20116	1514	27	15	18	0	1574
20117	36	1511	18	17	0	1582
20118	1535	24	11	25	0	1595
20119	37	8	12	1520	0	1577
20120	25	8	6	1536	0	1575
20121	1509	9	10	45	0	1573
20122	1545	5	7	22	0	1579
20123	53	12	9	1514	0	1588
20124	25	11	9	1535	0	1580
20125	13	13	1501	35	0	1562
20126	21	10	1488	14	0	1533
20127	1479	4	32	18	0	1533
20128	34	15	1428	20	0	1497
20129	1430	5	31	17	0	1483
20130	1443	4	24	16	0	1487
20131	37	7	1374	19	0	1437
20132	25	1343	31	16	0	1415
20133	16	1323	15	16	0	1370
20134	10	20	1088	7	0	1125
20135	33	56	27	940	0	1056
20136	868	14	15	26	0	923
20137	832	2	2	5	0	841
20138	948	4	3	3	0	958
20139	1109	0	1	7	0	1117
20140	1142	0	4	3	0	1149
20141	17	1172	0	6	0	1195
20142	1127	12	0	4	0	1143
20143	17	1122	4	1	0	1144
20144	1097	15	6	0	0	1118
20145	16	2	1068	2	0	1088
20146	8	2	11	1036	0	1057
20147	12	0	2	1024	0	1038
20148	3	1026	4	15	0	1048
20149	1047	13	0	2	0	1062
20150	1044	5	2	3	0	1054
20151	18	4	0	1031	0	1053
20152	6	3	3	1036	0	1048
20153	1028	2	3	17	0	1050
20154	16	7	0	1029	0	1052
20155	4	3	1	1047	0	1055
20156	1035	2	0	16	0	1053
20157	22	1	1	1026	0	1050
20158	1025	2	0	19	0	1046
20159	1033	0	0	12	0	1045
20160	21	1	1015	4	0	1041
20161	1027	0	12	6	0	1045
20162	1016	2	1	7	0	1026
20163	1009	1	1	6	0	1017
20164	19	2	965	5	0	991
20165	11	0	11	958	0	980
20166	10	0	3	972	0	985
20167	5	2	971	15	0	993
20168	949	1	15	3	0	968
20169	19	1	3	936	0	959
20170	7	0	928	15	0	950
20171	7	0	946	3	0	956
20172	4	0	17	942	0	963
20173	5	0	940	22	0	967
20174	4	1	20	943	0	968
20175	11	0	4	951	0	966
20176	4	4	925	21	0	954
20177	8	0	18	913	0	939
20178	4	882	9	14	0	909
20179	5	914	3	9	0	931
20180	893	15	8	5	0	921
20181	901	4	7	9	0	921
20182	17	886	0	13	0	916
20183	891	15	5	6	0	917
20184	914	4	3	6	0	927
20185	22	5	3	892	0	922
20186	9	5	2	911	0	927
20187	889	3	1	23	0	916
20188	23	863	2	7	0	895
20189	10	883	1	6	0	900
20190	8	15	2	888	0	913
20191	11	2	873	18	0	904
20192	836	1	18	11	0	866
20193	847	2	4	10	0	863
20194	845	0	4	6	0	855
20195	20	820	5	3	0	848
20196	9	17	2	814	0	842
20197	8	7	2	829	0	846
20198	803	4	3	22	0	832
20199	22	804	4	6	0	836
20200	11	17	1	791	0	820
20201	17	4	2	815	0	838
20202	14	4	4	808	0	830
20203	795	8	1	26	0	830
20204	23	787	1	17	0	828
20205	13	20	3	784	0	820
20206	14	788	2	14	0	818
20207	780	14	7	14	0	815
20208	22	8	764	13	0	807
20209	767	4	14	16	0	801
20210	21	7	748	8	0	784
20211	12	13	17	710	0	752
20212	714	3	6	22	0	745
20213	19	8	686	13	0	726
20214	697	5	13	10	0	725
20215	715	1	7	7	0	730
20216	711	3	6	9	0	729
20217	27	2	4	688	0	721
20218	19	1	3	687	0	710
20219	15	1	1	698	0	715
20220	674	1	5	24	0	704
20221	26	664	3	12	0	705
20222	674	13	6	14	0	707
20223	690	5	3	6	0	704
20224	31	5	664	4	0	704
20225	675	2	15	9	0	701
20226	691	1	10	11	0	713
20227	28	0	5	683	0	716
20228	13	4	6	688	0	711
20229	10	3	11	690	0	714
20230	676	3	1	24	0	704
20231	674	2	7	17	0	700
20232	648	0	9	11	0	668
20233	26	607	5	7	0	645
20234	8	558	2	13	0	581
20235	6	570	10	6	0	592
20236	559	15	3	13	0	590
20237	15	5	548	16	0	584
20238	10	3	436	4	0	453
20239	247	2	6	3	0	258
20240	4	1	280	1	0	286
20241	2	0	3	215	0	220
20242	1	209	2	1	0	213
20243	219	3	2	1	0	225
20244	221	2	0	0	0	223
20245	221	1	0	0	0	222
20246	5	0	0	237	0	242
20247	3	0	249	2	0	254
20248	1	0	241	2	0	244
20249	245	0	3	1	0	249
20250	257	0	3	0	0	260
20251	259	0	1	0	0	260
20252	5	0	0	262	0	267
20253	3	0	0	270	0	273
20254	1	0	265	4	0	270
20255	267	0	2	4	0	273
20256	2	0	2	280	0	284
20257	2	0	1	279	0	282
20258	2	0	0	281	0	283
20259	0	282	0	5	0	287
20260	0	2	0	286	0	288
20261	1	2	0	285	0	288
20262	280	1	0	3	0	284
20263	3	0	282	3	0	288
20264	279	0	2	1	0	282
20265	287	0	2	0	0	289
20266	5	0	0	284	0	289
20267	4	0	0	274	0	278
20268	276	0	0	4	0	280
20269	2	0	272	3	0	277
20270	2	271	2	1	0	276
20271	1	0	1	267	0	269
20272	266	1	2	1	0	270
20273	1	1	0	258	0	260
20274	1	0	254	2	0	257
20275	1	0	266	1	0	268
20276	277	0	2	1	0	280
20277	1	0	2	287	0	290
20278	1	0	291	1	0	293
20279	306	0	1	1	0	308
20280	327	0	1	2	0	330
20281	2	0	1	324	0	327
20282	3	0	0	329	0	332
20283	1	325	0	2	0	328
20284	348	1	0	3	0	352
20285	1	1	0	356	0	358
20286	1	1	0	354	0	356
20287	1	0	362	2	0	365
20288	344	0	1	2	0	347
20289	368	0	1	2	0	371
20290	2	362	1	0	0	365
20291	1	0	359	0	0	360
20292	1	0	355	0	0	356
20293	0	7	1	353	0	361
20294	368	0	1	3	0	372
20295	1	0	1	374	0	376
20296	391	0	0	3	0	394
20297	392	0	0	1	0	393
20298	397	0	0	1	0	398
20299	2	0	0	403	0	405
20300	0	0	0	405	0	405
20301	412	0	0	1	0	413
20302	1	0	416	1	0	418
20303	393	0	1	3	0	397
20304	401	0	1	1	0	403
20305	1	0	411	0	0	412
20306	0	0	396	0	0	396
20307	1	409	1	0	0	411
20308	1	0	1	411	0	413
20309	410	0	0	0	0	410
20310	1	0	0	416	0	417
20311	0	0	425	0	0	425
20312	0	418	0	0	0	418
20313	0	425	0	0	0	425
20314	0	0	0	436	0	436
20315	0	0	0	429	0	429
20316	0	435	0	0	0	435
20317	0	0	427	0	0	427
20318	398	0	0	1	0	399
20319	434	0	0	0	0	434
20320	0	430	1	0	0	431
20321	429	0	0	0	0	429
20322	0	0	0	422	0	422
20323	419	0	0	0	0	419
20324	1	0	0	417	0	418
20325	1	437	0	0	0	438
20326	0	0	440	0	0	440
20327	0	0	0	481	0	481
20328	1	1	0	457	0	459
20329	1	0	0	499	0	500
20330	520	0	0	0	0	520
20331	1	0	0	524	0	525
20332	1	0	556	1	0	558
20333	0	0	572	0	0	572
20334	605	0	3	1	0	609
20335	4	0	607	0	0	611
20336	617	0	4	1	0	622
20337	6	0	1	667	0	674
20338	4	0	0	683	0	687
20339	2	0	0	734	0	736
20340	0	0	0	713	0	713
20341	706	0	1	16	0	723
20342	10	0	712	5	0	727
20343	7	0	11	704	0	722
20344	2	718	4	9	0	733
20345	733	11	1	4	0	749
20346	12	3	1	713	0	729
20347	704	1	3	13	0	721
20348	13	1	707	7	0	728
20349	9	0	13	685	0	707
20350	4	703	6	13	0	726
20351	704	10	4	7	0	725
20352	15	3	705	8	0	731
20353	5	2	14	706	0	727
20354	6	0	5	711	0	722
20355	695	2	2	21	0	720
20356	16	1	692	9	0	718
20357	7	1	699	5	0	712
20358	3	1	18	692	0	714
20359	3	3	689	16	0	711
20360	3	3	697	6	0	709
20361	5	2	18	696	0	721
20362	5	1	7	717	0	730
20363	2	1	7	737	0	747
20364	714	1	1	26	0	742
20365	14	724	3	10	0	751
20366	737	13	3	3	0	756
20367	18	3	5	734	0	760
20368	6	730	6	15	0	757
20369	6	13	3	754	0	776
20370	777	4	4	17	0	802
20371	14	804	5	8	0	831
20372	8	13	5	822	0	848
20373	3	3	816	17	0	839
20374	814	3	17	11	0	845
20375	18	1	7	815	0	841
20376	9	1	2	830	0	842
20377	3	2	808	21	0	834
20378	2	2	808	14	0	826
20379	786	4	19	5	0	814
20380	18	767	7	10	0	802
20381	10	16	3	776	0	805
20382	770	8	3	20	0	801
20383	16	2	777	11	0	806
20384	8	761	17	6	0	792
20385	10	16	6	761	0	793
20386	768	13	3	19	0	803
20387	755	2	2	18	0	777
20388	773	1	6	8	0	788
20389	26	753	5	3	0	787
20390	10	15	752	11	0	788
20391	7	6	16	757	0	786
20392	9	3	14	715	0	741
20393	7	3	7	771	0	788
20394	5	2	5	771	0	783
20395	753	7	2	23	0	785
20396	744	2	5	14	0	765
20397	28	1	721	8	0	758
20398	10	4	729	3	0	746
20399	713	5	24	8	0	750
20400	727	4	9	13	0	753
20401	28	2	5	704	0	739
20402	14	695	4	22	0	735
20403	702	16	4	15	0	737
20404	22	696	4	7	0	729
20405	11	695	8	5	0	719
20406	9	18	5	716	0	748
20407	6	7	3	736	0	752
20408	6	4	5	738	0	753
20409	6	1	6	735	0	748
20410	8	2	703	32	0	745
20411	704	4	18	11	0	737
20412	723	1	13	9	0	746
20413	24	5	8	708	0	745
20414	18	3	2	707	0	730
20415	701	4	4	27	0	736
20416	19	4	663	16	0	702
20417	692	8	19	8	0	727
20418	701	5	9	9	0	724
20419	23	6	684	11	0	724
20420	702	8	17	10	0	737
20421	23	2	11	693	0	729
20422	9	3	5	727	0	744
20423	9	1	7	719	0	736
20424	9	2	4	724	0	739
20425	675	4	5	29	0	713
20426	26	2	4	662	0	694
20427	15	1	5	625	0	646
20428	10	577	3	27	0	617
20429	6	601	0	18	0	625
20430	7	18	4	578	0	607
20431	574	5	7	18	0	604
20432	21	5	2	533	0	561
20433	11	1	490	21	0	523
20434	5	2	466	12	0	485
20435	461	3	13	8	0	485
20436	17	460	6	9	0	492
20437	411	10	6	5	0	432
20438	12	4	413	4	0	433
20439	5	16	7	354	0	382
20440	352	0	3	8	0	363
20441	5	345	2	4	0	356
20442	338	3	2	5	0	348
20443	5	3	374	1	0	383
20444	4	2	4	367	0	377
20445	2	0	1	385	0	388
20446	382	1	1	4	0	388
20447	371	0	1	7	0	379
20448	388	1	2	0	0	391
20449	380	1	2	0	0	383
20450	385	0	0	2	0	387
20451	5	376	0	3	0	384
20452	3	3	0	381	0	387
20453	385	1	2	4	0	392
20454	3	0	1	386	0	390
20455	4	0	0	383	0	387
20456	2	2	0	381	0	385
20457	2	370	0	6	0	378
20458	377	2	2	3	0	384
20459	3	1	0	383	0	387
20460	376	0	1	5	0	382
20461	374	1	0	1	0	376
20462	5	357	0	0	0	362
20463	362	2	1	1	0	366
20464	6	1	352	0	0	359
20465	355	0	1	2	0	358
20466	1	3	6	351	0	361
20467	1	0	355	4	0	360
20468	3	369	0	2	0	374
20469	0	1	366	2	0	369
20470	0	336	1	2	0	339
20471	307	3	9	1	0	320
20472	308	0	1	1	0	310
20473	310	0	0	0	0	310
20474	2	306	0	0	0	308
20475	299	1	0	0	0	300
20476	1	1	291	0	0	293
20477	3	2	295	0	0	300
20478	1	0	0	293	0	294
20479	0	0	0	307	0	307
20480	0	304	0	0	0	304
20481	307	0	0	0	0	307
20482	1	0	0	312	0	313
20483	0	314	0	1	0	315
20484	1	0	0	320	0	321
20485	320	0	0	1	0	321
20486	322	0	0	0	0	322
20487	1	0	308	0	0	309
20488	0	0	1	312	0	313
20489	0	0	315	1	0	316
20490	0	0	1	313	0	314
20491	0	0	311	1	0	312
20492	0	0	1	310	0	311
20493	0	0	321	0	0	321
20494	0	0	1	318	0	319
20495	0	0	329	1	0	330
20496	1	0	1	324	0	326
20497	0	0	0	329	0	329
20498	0	348	0	1	0	349
20499	0	1	0	357	0	358
20500	0	0	354	1	0	355
20501	0	0	1	349	0	350
20502	0	0	0	353	0	353
20503	362	0	0	2	0	364
20504	1	0	0	367	0	368
20505	0	0	0	365	0	365
20506	0	0	362	1	0	363
20507	353	0	1	1	0	355
20508	2	0	1	362	0	365
20509	0	0	0	366	0	366
20510	0	0	0	364	0	364
20511	365	1	0	3	0	369
20512	2	0	0	364	0	366
20513	0	0	1	364	0	365
20514	361	0	0	4	0	365
20515	2	358	0	2	0	362
20516	1	2	0	355	0	358
20517	0	0	0	356	0	356
20518	0	2	350	3	0	355
20519	322	0	1	2	0	325
20520	3	0	0	347	0	350
20521	0	0	342	3	0	345
20522	341	0	1	1	0	343
20523	2	0	0	356	0	358
20524	1	0	0	371	0	372
20525	0	0	0	373	0	373
20526	0	0	0	378	0	378
20527	0	0	404	3	0	407
20528	2	1	5	415	0	423
20529	1	0	0	562	0	563
20530	0	0	637	12	0	649
20531	650	1	15	1	0	667
20532	676	0	2	1	0	679
20533	672	0	1	2	0	675
20534	16	0	4	655	0	675
20535	666	0	0	14	0	680
20536	686	0	0	3	0	689
20537	19	0	0	681	0	700
20538	679	0	0	19	0	698
20539	689	0	0	3	0	692
20540	681	0	1	2	0	684
20541	689	0	0	4	0	693
20542	20	2	0	664	0	686
20543	5	633	1	12	0	651
20544	5	643	1	2	0	651
20545	5	642	0	1	0	648
20546	622	17	1	3	0	643
20547	660	6	0	2	0	668
20548	18	3	642	1	0	664
20549	652	3	14	1	0	670
20550	23	0	1	656	0	680
20551	9	0	1	663	0	673
20552	6	0	5	670	0	681
20553	654	0	0	20	0	674
20554	20	0	0	647	0	667
20555	6	643	1	19	0	669
20556	2	15	1	657	0	675
20557	6	5	664	17	0	692
20558	6	3	16	662	0	687
20559	667	5	2	19	0	693
20560	21	0	654	4	0	679
20561	7	3	16	664	0	690
20562	6	1	3	672	0	682
20563	11	1	1	679	0	692
20564	2	678	4	22	0	706
20565	3	16	0	689	0	708
20566	677	4	4	21	0	706
20567	683	3	0	8	0	694
20568	22	4	646	4	0	676
20569	5	1	666	6	0	678
20570	5	1	18	665	0	689
20571	8	1	4	669	0	682
20572	1	2	661	26	0	690
20573	2	5	19	629	0	655
20574	2	655	3	24	0	684
20575	670	15	4	9	0	698
20576	675	1	6	4	0	686
20577	663	3	3	5	0	674
20578	18	3	646	7	0	674
20579	9	1	16	652	0	678
20580	11	1	642	23	0	677
20581	644	0	18	4	0	666
20582	17	643	9	5	0	674
20583	3	16	2	640	0	661
20584	641	2	5	18	0	666
20585	23	1	3	634	0	661
20586	8	4	2	656	0	670
20587	3	1	636	23	0	663
20588	629	2	17	10	0	658
20589	20	634	4	6	0	664
20590	10	15	5	645	0	675
20591	648	7	5	16	0	676
20592	21	4	1	651	0	677
20593	645	4	1	21	0	671
20594	20	632	5	9	0	666
20595	649	13	0	10	0	672
20596	18	2	643	5	0	668
20597	656	1	16	6	0	679
20598	649	8	3	3	0	663
20599	652	0	2	9	0	663
20600	22	3	5	629	0	659
20601	7	3	1	633	0	644
20602	12	3	2	636	0	653
20603	7	616	2	18	0	643
20604	622	18	0	8	0	648
20605	21	2	5	615	0	643
20606	10	1	5	626	0	642
20607	8	4	0	628	0	640
20608	616	1	1	23	0	641
20609	18	1	3	627	0	649
20610	2	3	614	28	0	647
20611	9	609	14	12	0	644
20612	9	18	2	621	0	650
20613	9	5	2	636	0	652
20614	2	2	4	641	0	649
20615	4	4	618	23	0	649
20616	3	2	621	14	0	640
20617	9	2	17	623	0	651
20618	5	0	644	23	0	672
20619	3	2	21	650	0	676
20620	654	4	3	22	0	683
20621	672	2	2	14	0	690
20622	674	3	3	9	0	689
20623	20	2	640	12	0	674
20624	644	0	17	6	0	667
20625	20	4	6	649	0	679
20626	10	0	643	18	0	671
20627	3	4	618	6	0	631
20628	2	596	13	12	0	623
20629	4	468	2	4	0	478
20630	377	2	9	0	0	388
20631	7	1	0	372	0	380
20632	0	0	392	3	0	395
20633	4	0	3	393	0	400
20634	402	0	0	6	0	408
20635	3	0	435	0	0	438
20636	442	0	6	1	0	449
20637	467	3	0	1	0	471
20638	463	3	0	0	0	466
20639	7	454	0	0	0	461
20640	467	3	0	4	0	474
20641	5	0	3	475	0	483
20642	0	0	0	473	0	473
20643	4	0	0	480	0	484
20644	0	0	3	476	0	479
20645	473	0	0	8	0	481
20646	7	458	0	0	0	465
20647	3	441	0	0	0	444
20648	0	462	0	0	0	462
20649	461	3	3	0	0	467
20650	460	0	0	0	0	460
20651	456	0	0	5	0	461
20652	456	0	1	4	0	461
20653	4	0	0	465	0	469
20654	1	0	0	463	0	464
20655	463	0	1	5	0	469
20656	3	458	2	2	0	465
20657	440	4	1	2	0	447
20658	452	1	1	0	0	454
20659	4	0	0	456	0	460
20660	0	452	0	4	0	456
20661	0	3	1	461	0	465
20662	453	0	0	4	0	457
20663	5	1	463	0	0	469
20664	1	0	3	449	0	453
20665	1	458	1	2	0	462
20666	462	3	0	0	0	465
20667	468	0	0	2	0	470
20668	3	1	461	0	0	465
20669	1	443	5	1	0	450
20670	0	5	454	1	0	460
20671	1	1	4	452	0	458
20672	1	0	459	5	0	465
20673	0	0	448	2	0	450
20674	1	451	5	0	0	457
20675	459	5	0	1	0	465
20676	467	1	0	0	0	468
20677	5	472	1	0	0	478
20678	2	477	1	0	0	480
20679	3	4	458	1	0	466
20680	1	0	450	1	0	452
20681	1	1	463	0	0	465
20682	2	0	4	469	0	475
20683	0	1	470	6	0	477
20684	1	1	4	461	0	467
20685	2	1	0	458	0	461
20686	1	0	453	6	0	460
20687	2	460	5	0	0	467
20688	0	5	0	460	0	465
20689	457	2	0	5	0	464
20690	4	1	1	456	0	462
20691	2	0	452	4	0	458
20692	2	450	5	0	0	457
20693	2	472	0	1	0	475
20694	1	6	0	469	0	476
20695	466	0	0	5	0	471
20696	464	0	0	2	0	466
20697	6	0	1	463	0	470
20698	1	504	0	5	0	510
20699	2	10	0	504	0	516
20700	2	1	0	523	0	526
20701	2	0	1	529	0	532
20702	571	2	1	7	0	581
20703	8	576	1	3	0	588
20704	582	8	0	1	0	591
20705	594	0	1	3	0	598
20706	598	1	0	2	0	601
20707	612	3	0	0	0	615
20708	9	0	1	601	0	611
20709	0	1	601	8	0	610
20710	2	590	8	0	0	600
20711	605	8	0	3	0	616
20712	615	0	0	1	0	616
20713	625	0	0	1	0	626
20714	8	1	612	3	0	624
20715	604	1	9	1	0	615
20716	624	1	0	1	0	626
20717	11	2	0	619	0	632
20718	3	0	591	8	0	602
20719	2	592	6	3	0	603
20720	0	10	2	595	0	607
20721	591	2	4	8	0	605
20722	10	0	0	585	0	595
20723	2	1	0	600	0	603
20724	606	0	1	9	0	616
20725	8	0	604	1	0	613
20726	606	1	8	2	0	617
20727	617	0	0	0	0	617
20728	620	1	0	1	0	622
20729	622	0	2	1	0	625
20730	9	1	605	0	0	615
20731	1	0	8	598	0	607
20732	3	0	591	8	0	602
20733	3	0	8	575	0	586
20734	2	0	574	8	0	584
20735	523	2	10	1	0	536
20736	8	513	2	1	0	524
20737	2	505	0	2	0	509
20738	3	6	1	568	0	578
20739	1	0	1	598	0	600
20740	2	596	1	9	0	608
20741	606	8	1	2	0	617
20742	641	3	0	2	0	646
20743	657	1	1	1	0	660
20744	696	1	0	2	0	699
20745	11	0	1	686	0	698
20746	5	1	0	716	0	722
20747	720	0	0	18	0	738
20748	11	3	0	705	0	719
20749	6	0	685	12	0	703
20750	3	0	691	5	0	699
20751	4	0	12	698	0	714
20752	3	0	693	12	0	708
20753	687	0	11	4	0	702
20754	12	0	4	690	0	706
20755	697	0	3	12	0	712
20756	11	0	704	6	0	721
20757	5	0	11	706	0	722
20758	3	0	703	12	0	718
20759	2	693	12	6	0	713
20760	690	10	5	4	0	709
20761	698	4	2	4	0	708
20762	13	693	2	3	0	711
20763	685	10	1	3	0	699
20764	16	3	2	678	0	699
20765	7	4	0	682	0	693
20766	679	1	1	12	0	693
20767	13	664	1	5	0	683
20768	7	668	0	4	0	679
20769	7	12	1	662	0	682
20770	653	4	0	15	0	672
20771	662	1	1	5	0	669
20772	665	2	2	2	0	671
20773	17	3	641	4	0	665
20774	8	1	643	1	0	653
20775	4	631	14	2	0	651
20776	637	12	6	2	0	657
20777	15	4	2	622	0	643
20778	625	1	2	11	0	639
20779	630	2	1	6	0	639
20780	16	0	4	617	0	637
20781	5	3	612	13	0	633
20782	613	0	11	5	0	629
20783	14	1	4	609	0	628
20784	7	2	612	12	0	633
20785	605	1	11	4	0	621
20786	620	2	3	2	0	627
20787	18	1	3	605	0	627
20788	9	0	604	13	0	626
20789	5	1	11	600	0	617
20790	5	599	5	13	0	622
20791	3	10	607	6	0	626
20792	2	611	15	0	0	628
20793	602	12	3	3	0	620
20794	603	5	2	3	0	613
20795	604	2	3	4	0	613
20796	609	1	3	2	0	615
20797	18	1	1	581	0	601
20798	549	1	1	12	0	563
20799	15	0	3	539	0	557
20800	530	1	1	9	0	541
20801	13	522	0	6	0	541
20802	7	5	1	482	0	495
20803	3	473	2	14	0	492
20804	478	7	0	4	0	489
20805	475	3	1	4	0	483
20806	10	460	3	2	0	475
20807	5	8	1	450	0	464
20808	4	4	450	6	0	464
20809	2	4	6	440	0	452
20810	1	3	446	9	0	459
20811	4	1	6	436	0	447
20812	2	426	5	10	0	443
20813	428	5	1	3	0	437
20814	426	5	3	1	0	435
20815	9	2	0	427	0	438
20816	431	1	2	5	0	439
20817	9	0	0	428	0	437
20818	5	2	1	429	0	437
20819	4	1	0	433	0	438
20820	420	1	0	10	0	431
20821	423	0	1	7	0	431
20822	426	0	0	3	0	429
20823	9	410	1	3	0	423
20824	412	6	0	2	0	420
20825	7	392	0	4	0	403
20826	388	5	1	1	0	395
20827	10	3	0	386	0	399
20828	7	2	0	388	0	397
20829	382	1	0	10	0	393
20830	384	0	2	4	0	390
20831	8	379	0	3	0	390
20832	377	6	1	2	0	386
20833	8	2	0	369	0	379
20834	6	3	0	372	0	381
20835	367	1	0	9	0	377
20836	8	0	361	6	0	375
20837	6	362	6	3	0	377
20838	4	4	3	303	0	314
20839	1	1	272	4	0	278
20840	1	11	5	252	0	269
20841	260	0	2	5	0	267
20842	5	230	1	3	0	239
20843	2	214	1	2	0	219
20844	1	182	1	2	0	186
20845	3	16	5	151	0	175
20846	154	1	9	1	0	165
20847	2	0	0	152	0	154
20848	154	1	0	1	0	156
20849	153	0	0	1	0	154
20850	2	1	0	152	0	155
20851	153	0	0	3	0	156
20852	1	0	1	155	0	157
20853	1	0	154	2	0	157
20854	158	1	1	1	0	161
20855	2	0	168	0	0	170
20856	157	0	1	0	0	158
20857	1	0	153	1	0	155
20858	2	0	1	152	0	155
20859	0	0	1	152	0	153
20860	158	0	0	3	0	161
20861	1	0	0	161	0	162
20862	160	0	0	2	0	162
20863	2	153	0	1	0	156
20864	162	1	0	1	0	164
20865	1	2	0	167	0	170
20866	2	0	0	167	0	169
20867	0	1	0	169	0	170
20868	1	0	0	170	0	171
20869	0	0	166	2	0	168
20870	0	0	166	2	0	168
20871	1	0	1	167	0	169
20872	1	0	173	0	0	174
20873	0	170	0	1	0	171
20874	1	0	1	172	0	174
20875	1	1	177	1	0	180
20876	0	0	181	2	0	183
20877	0	3	1	187	0	191
20878	0	0	1	187	0	188
20879	0	189	0	1	0	190
20880	1	0	0	194	0	195
20881	0	1	197	0	0	198
20882	192	0	0	1	0	193
20883	1	0	1	200	0	202
20884	205	0	0	1	0	206
20885	206	0	0	1	0	207
20886	210	0	0	0	0	210
20887	1	0	212	0	0	213
20888	3	1	209	1	0	214
20889	208	0	1	2	0	211
20890	0	1	216	0	0	217
20891	1	0	0	203	0	204
20892	0	0	1	206	0	207
20893	1	1	212	1	0	215
20894	0	211	0	2	0	213
20895	211	0	0	1	0	212
20896	1	206	0	0	0	207
20897	2	207	1	0	0	210
20898	210	1	1	0	0	212
20899	0	1	216	0	0	217
20900	2	1	216	0	0	219
20901	1	0	3	207	0	211
20902	206	0	1	2	0	209
20903	1	211	0	2	0	214
20904	210	1	1	0	0	212
20905	1	2	216	0	0	219
20906	2	243	1	0	0	246
20907	0	2	1	247	0	250
20908	0	1	249	2	0	252
20909	1	0	1	251	0	253
20910	3	0	1	221	0	225
20911	0	0	3	245	0	248
20912	1	0	0	248	0	249
20913	244	0	0	3	0	247
20914	244	0	0	1	0	245
20915	2	0	243	3	0	248
20916	241	0	2	1	0	244
20917	2	241	1	1	0	245
20918	239	1	0	2	0	242
20919	2	1	246	1	0	250
20920	0	1	2	244	0	247
20921	1	0	255	4	0	260
20922	0	0	249	2	0	251
20923	0	1	2	254	0	257
20924	2	0	1	250	0	253
20925	1	0	248	2	0	251
20926	0	245	3	1	0	249
20927	1	247	0	2	0	250
20928	0	2	1	247	0	250
20929	245	2	1	1	0	249
20930	1	251	3	3	0	258
20931	1	1	248	3	0	253
20932	2	0	246	1	0	249
20933	0	3	247	1	0	251
20934	1	0	1	248	0	250
20935	247	0	2	2	0	251
20936	3	243	2	0	0	248
20937	2	2	240	2	0	246
20938	2	242	1	0	0	245
20939	3	1	0	241	0	245
20940	2	1	245	1	0	249
20941	0	243	2	1	0	246
20942	1	1	1	246	0	249
20943	1	0	2	246	0	249
20944	0	2	253	1	0	256
20945	1	0	1	255	0	257
20946	1	242	0	3	0	246
20947	0	2	245	0	0	247
20948	240	1	1	1	0	243
20949	2	2	1	247	0	252
20950	1	1	2	243	0	247
20951	1	242	1	4	0	248
20952	243	2	0	1	0	246
20953	1	1	240	2	0	244
20954	232	1	2	1	0	236
20955	2	0	1	227	0	230
20956	1	231	1	2	0	235
20957	1	3	0	234	0	238
20958	0	0	1	241	0	242
20959	240	1	0	2	0	243
20960	241	0	0	2	0	243
20961	3	0	1	240	0	244
20962	0	1	241	2	0	244
20963	239	0	3	1	0	243
20964	4	251	1	1	0	257
20965	1	5	1	247	0	254
20966	2	0	0	253	0	255
20967	0	2	1	252	0	255
20968	0	1	249	6	0	256
20969	0	0	4	249	0	253
20970	1	250	1	4	0	256
20971	1	4	1	248	0	254
20972	0	247	0	6	0	253
20973	0	5	1	249	0	255
20974	1	0	244	7	0	252
20975	232	2	4	1	0	239
20976	5	0	1	238	0	244
20977	0	0	227	5	0	232
20978	1	231	4	0	0	236
20979	229	5	0	2	0	236
20980	5	1	223	0	0	229
20981	223	1	5	1	0	230
20982	5	1	1	232	0	239
20983	1	0	2	237	0	240
20984	0	233	1	4	0	238
20985	232	4	1	2	0	239
20986	226	1	3	0	0	230
20987	5	239	1	0	0	245
20988	2	4	1	233	0	240
20989	2	1	0	237	0	240
20990	0	1	0	241	0	242
20991	1	1	228	6	0	236
20992	234	1	4	1	0	240
20993	5	0	0	234	0	239
20994	2	0	2	238	0	242
20995	1	1	229	4	0	235
20996	0	0	232	3	0	235
20997	2	0	4	237	0	243
20998	0	2	247	5	0	254
20999	244	2	6	1	0	253
21000	5	0	0	249	0	254
21001	0	0	1	262	0	263
21002	1	0	280	4	0	285
21003	0	0	5	291	0	296
21004	0	1	292	5	0	298
21005	0	280	5	1	0	286
21006	253	6	2	2	0	263
21007	256	0	0	0	0	256
21008	4	252	0	1	0	257
21009	0	5	0	268	0	273
21010	0	0	269	5	0	274
21011	1	0	4	265	0	270
21012	266	0	0	6	0	272
21013	4	270	1	0	0	275
21014	273	4	0	0	0	277
21015	6	1	0	266	0	273
21016	271	1	0	6	0	278
21017	4	272	0	1	0	277
21018	271	4	1	1	0	277
21019	4	0	265	1	0	270
21020	2	264	4	0	0	270
21021	0	5	0	249	0	254
21022	258	0	2	4	0	264
21023	265	1	0	3	0	269
21024	6	0	0	262	0	268
21025	265	1	1	4	0	271
21026	271	0	0	0	0	271
21027	270	0	1	2	0	273
21028	4	1	0	270	0	275
21029	0	1	266	5	0	272
21030	2	0	261	0	0	263
21031	1	1	264	1	0	267
21032	266	1	4	2	0	273
21033	5	0	1	275	0	281
21034	1	283	0	6	0	290
21035	1	4	1	282	0	288
21036	0	290	1	3	0	294
21037	293	4	1	0	0	298
21038	5	0	0	299	0	304
21039	0	1	0	315	0	316
21040	321	0	1	6	0	328
21041	4	0	2	326	0	332
21042	0	1	0	337	0	338
21043	341	0	1	8	0	350
21044	5	2	358	0	0	365
21045	2	0	5	360	0	367
21046	0	0	366	8	0	374
21047	365	0	6	2	0	373
21048	6	1	0	374	0	381
21049	369	0	0	6	0	375
21050	5	1	1	372	0	379
21051	2	1	391	5	0	399
21052	1	0	6	394	0	401
21053	398	1	1	7	0	407
21054	7	399	1	4	0	411
21055	3	4	401	1	0	409
21056	395	1	4	3	0	403
21057	8	402	1	0	0	411
21058	3	418	0	1	0	422
21059	2	453	1	1	0	457
21060	1	4	1	476	0	482
21061	491	1	2	3	0	497
21062	498	2	2	1	0	503
21063	7	0	487	1	0	495
21064	478	0	2	2	0	482
21065	3	471	1	1	0	476
21066	1	3	1	489	0	494
21067	511	1	0	2	0	514
21068	511	2	0	1	0	514
21069	512	0	0	2	0	514
21070	510	0	0	4	0	514
21071	511	0	0	1	0	512
21072	5	0	0	507	0	512
21073	4	0	508	4	0	516
21074	3	0	2	517	0	522
21075	3	0	1	521	0	525
21076	526	0	2	7	0	535
21077	2	521	1	3	0	527
21078	526	2	1	1	0	530
21079	528	1	0	2	0	531
21080	549	1	0	1	0	551
21081	554	0	0	2	0	556
21082	4	0	543	1	0	548
21083	536	0	3	1	0	540
21084	540	0	1	1	0	542
21085	510	1	1	1	0	513
21086	543	1	1	0	0	545
21087	5	0	1	530	0	536
21088	3	1	524	3	0	531
21089	522	1	2	3	0	528
21090	3	526	1	1	0	531
21091	1	3	1	521	0	526
21092	2	524	0	4	0	530
21093	3	2	0	534	0	539
21094	538	1	2	4	0	545
21095	541	1	1	2	0	545
21096	543	1	1	1	0	546
21097	5	1	509	0	0	515
21098	505	0	2	3	0	510
21099	4	0	497	0	0	501
21100	2	0	497	1	0	500
21101	2	0	504	0	0	506
21102	2	3	3	484	0	492
21103	3	0	2	482	0	487
21104	1	0	1	486	0	488
21105	2	0	1	491	0	494
21106	3	1	0	480	0	484
21107	1	1	1	494	0	497
21108	2	489	0	3	0	494
21109	476	3	0	3	0	482
21110	3	489	0	2	0	494
21111	3	2	0	491	0	496
21112	4	1	0	496	0	501
21113	493	1	1	2	0	497
21114	3	490	1	2	0	496
21115	493	3	0	2	0	498
21116	3	1	0	495	0	499
21117	3	2	0	491	0	496
21118	5	0	0	491	0	496
21119	1	4	487	4	0	496
21120	2	0	2	491	0	495
21121	4	1	489	2	0	496
21122	0	0	490	3	0	493
21123	2	0	504	1	0	507
21124	1	0	4	521	0	526
21125	0	0	3	526	0	529
21126	2	0	2	528	0	532
21127	547	2	0	5	0	554
21128	3	0	0	567	0	570
21129	574	0	0	4	0	578
21130	5	570	0	5	0	580
21131	606	2	0	2	0	610
21132	646	2	1	2	0	651
21133	7	662	0	0	0	669
21134	663	4	0	2	0	669
21135	662	2	6	1	0	671
21136	674	1	0	3	0	678
21137	669	0	4	4	0	677
21138	9	0	650	0	0	659
21139	2	642	4	0	0	648
21140	5	6	3	624	0	638
21141	630	2	1	8	0	641
21142	4	1	628	3	0	636
21143	3	610	1	2	0	616
21144	4	3	4	580	0	591
21145	1	592	3	3	0	599
21146	2	4	1	597	0	604
21147	2	2	1	607	0	612
21148	1	1	604	5	0	611
21149	0	0	591	5	0	596
21150	568	0	10	2	0	580
21151	4	0	586	1	0	591
21152	3	1	573	0	0	577
21153	2	1	4	579	0	586
21154	3	1	2	576	0	582
21155	1	584	1	4	0	590
21156	1	605	0	2	0	608
21157	3	5	616	1	0	625
21158	4	8	4	620	0	636
21159	2	1	603	7	0	613
21160	2	0	564	0	0	566
21161	1	565	8	1	0	575
21162	2	8	1	558	0	569
21163	563	1	1	10	0	575
21164	7	0	0	567	0	574
21165	565	0	0	8	0	573
21166	567	1	0	2	0	570
21167	555	0	1	1	0	557
21168	9	2	538	0	0	549
21169	546	0	7	3	0	556
21170	7	1	1	556	0	565
21171	562	0	1	9	0	572
21172	563	0	1	3	0	567
21173	10	547	1	0	0	558
21174	546	7	2	2	0	557
21175	8	1	564	0	0	573
21176	555	0	8	3	0	566
21177	559	0	3	2	0	564
21178	7	555	0	1	0	563
21179	566	8	1	0	0	575
21180	7	1	1	538	0	547
21181	1	0	1	544	0	546
21182	0	539	1	9	0	549
21183	1	6	1	552	0	560
21184	3	1	0	558	0	562
21185	1	0	545	9	0	555
21186	1	0	536	2	0	539
21187	533	0	8	2	0	543
21188	550	1	1	1	0	553
21189	9	0	0	543	0	552
21190	3	0	551	7	0	561
21191	0	548	7	1	0	556
21192	2	6	2	551	0	561
21193	1	1	565	8	0	575
21194	548	0	7	2	0	557
21195	9	0	1	568	0	578
21196	1	578	2	8	0	589
21197	2	13	0	584	0	599
21198	1	3	1	600	0	605
21199	3	0	0	603	0	606
21200	589	1	1	11	0	602
21201	12	3	0	579	0	594
21202	589	0	0	12	0	601
21203	590	2	0	7	0	599
21204	11	0	579	3	0	593
21205	3	586	9	1	0	599
21206	4	12	2	562	0	580
21207	1	610	3	7	0	621
21208	616	9	1	3	0	629
21209	9	2	3	616	0	630
21210	3	2	617	10	0	632
21211	4	1	608	1	0	614
21212	1	1	627	4	0	633
21213	615	1	12	2	0	630
21214	10	628	2	2	0	642
21215	623	10	2	3	0	638
21216	13	627	1	1	0	642
21217	4	11	0	634	0	649
21218	5	2	2	620	0	629
21219	2	643	1	9	0	655
21220	1	7	647	5	0	660
21221	2	641	10	5	0	658
21222	628	11	1	2	0	642
21223	10	3	2	603	0	618
21224	2	2	585	9	0	598
21225	2	0	588	2	0	592
21226	2	0	9	592	0	603
21227	0	1	564	9	0	574
21228	0	1	554	1	0	556
21229	524	0	8	3	0	535
21230	8	522	2	1	0	533
21231	483	6	3	1	0	493
21232	9	2	470	0	0	481
21233	1	459	7	1	0	468
21234	4	462	0	2	0	468
21235	1	9	6	451	0	467
21236	0	2	1	463	0	466
21237	2	2	0	469	0	473
21238	1	0	466	10	0	477
21239	3	0	7	469	0	479
21240	1	0	2	477	0	480
21241	461	2	2	9	0	474
21242	7	459	0	5	0	471
21243	1	7	1	472	0	481
21244	470	1	0	9	0	480
21245	467	1	0	3	0	471
21246	8	1	0	458	0	467
21247	4	0	454	7	0	465
21248	4	0	7	449	0	460
21249	0	0	451	10	0	461
21250	460	1	8	1	0	470
21251	496	0	1	3	0	500
21252	12	1	2	509	0	524
21253	4	0	511	12	0	527
21254	3	530	12	2	0	547
21255	0	15	532	2	0	549
21256	0	10	14	486	0	510
21257	0	508	2	9	0	519
21258	476	9	2	2	0	489
21259	9	2	0	469	0	480
21260	2	477	0	8	0	487
21261	482	9	0	4	0	495
21262	13	1	0	478	0	492
21263	2	481	0	9	0	492
21264	2	9	0	483	0	494
21265	0	2	482	11	0	495
21266	464	2	9	4	0	479
21267	480	0	1	5	0	486
21268	12	0	464	0	0	476
21269	4	459	7	1	0	471
21270	467	9	3	1	0	480
21271	10	2	1	464	0	477
21272	4	2	0	469	0	475
21273	3	0	0	476	0	479
21274	1	1	1	480	0	483
21275	0	0	0	454	0	454
21276	437	0	1	13	0	451
21277	450	0	0	4	0	454
21278	12	0	0	445	0	457
21279	5	0	1	448	0	454
21280	2	0	440	13	0	455
21281	0	1	439	4	0	444
21282	424	0	9	2	0	435
21283	11	0	3	424	0	438
21284	2	1	424	11	0	438
21285	5	0	11	419	0	435
21286	425	1	3	13	0	442
21287	433	1	3	2	0	439
21288	12	0	1	426	0	439
21289	4	1	0	433	0	438
21290	416	1	0	14	0	431
21291	10	0	0	416	0	426
21292	3	409	1	11	0	424
21293	4	11	0	400	0	415
21294	2	2	1	405	0	410
21295	0	3	392	11	0	406
21296	0	3	375	5	0	383
21297	3	374	12	2	0	391
21298	365	10	3	2	0	380
21299	367	2	1	2	0	372
21300	365	2	2	2	0	371
21301	13	357	1	2	0	373
21302	4	356	0	2	0	362
21303	348	12	0	1	0	361
21304	13	346	0	1	0	360
21305	3	11	328	4	0	346
21306	1	326	9	4	0	340
21307	2	10	305	2	0	319
21308	297	3	9	2	0	311
21309	308	1	4	1	0	314
21310	12	303	0	3	0	318
21311	298	11	4	3	0	316
21312	339	2	2	3	0	346
21313	349	1	2	1	0	353
21314	18	2	2	333	0	355
21315	335	0	1	16	0	352
21316	15	3	330	5	0	353
21317	330	1	11	0	0	342
21318	14	0	3	338	0	355
21319	5	2	320	16	0	343
21320	4	0	330	7	0	341
21321	2	0	17	324	0	343
21322	4	1	3	336	0	344
21323	327	1	1	16	0	345
21324	12	2	3	322	0	339
21325	2	3	318	17	0	340
21326	2	0	13	321	0	336
21327	2	323	4	17	0	346
21328	330	14	2	6	0	352
21329	14	3	1	332	0	350
21330	4	1	333	15	0	353
21331	4	327	12	5	0	348
21332	318	12	2	2	0	334
21333	16	4	1	310	0	331
21334	4	2	304	16	0	326
21335	4	299	12	5	0	320
21336	292	12	5	1	0	310
21337	293	3	1	4	0	301
21338	297	2	2	4	0	305
21339	12	3	2	287	0	304
21340	3	2	2	292	0	299
21341	284	0	2	15	0	301
21342	16	279	2	2	0	299
21343	280	13	1	3	0	297
21344	15	1	0	281	0	297
21345	284	0	2	14	0	300
21346	16	3	1	281	0	301
21347	4	3	0	293	0	300
21348	5	2	0	291	0	298
21349	5	0	3	291	0	299
21350	3	1	260	15	0	279
21351	1	3	240	5	0	249
21352	206	0	10	2	0	218
21353	7	1	194	3	0	205
21354	2	0	160	3	0	165
21355	151	2	8	1	0	162
21356	162	0	2	0	0	164
21357	8	0	1	171	0	180
21358	177	0	3	7	0	187
21359	7	176	1	3	0	187
21360	188	6	0	3	0	197
21361	194	0	1	1	0	196
21362	194	2	0	3	0	199
21363	8	2	1	185	0	196
21364	2	186	0	7	0	195
21365	5	183	0	1	0	189
21366	185	5	1	2	0	193
21367	183	1	1	3	0	188
21368	6	1	0	182	0	189
21369	2	2	0	183	0	187
21370	2	181	3	5	0	191
21371	182	6	2	0	0	190
21372	10	0	175	2	0	187
21373	2	0	7	176	0	185
21374	2	1	1	182	0	186
21375	4	2	180	7	0	193
21376	5	0	8	179	0	192
21377	3	158	0	10	0	171
21378	3	4	0	183	0	190
21379	1	2	1	186	0	190
21380	0	179	2	7	0	188
21381	3	186	0	3	0	192
21382	3	5	0	188	0	196
21383	188	0	1	9	0	198
21384	5	3	1	191	0	200
21385	1	3	0	195	0	199
21386	2	201	2	5	0	210
21387	3	5	2	205	0	215
21388	4	1	0	209	0	214
21389	2	0	1	213	0	216
21390	206	3	2	7	0	218
21391	9	2	0	209	0	220
21392	1	0	2	215	0	218
21393	1	0	0	218	0	219
21394	2	1	204	8	0	215
21395	198	2	5	2	0	207
21396	6	205	1	4	0	216
21397	208	4	1	1	0	214
21398	4	1	0	208	0	213
21399	1	0	203	5	0	209
21400	203	0	3	1	0	207
21401	4	4	262	1	0	271
21402	2	1	2	279	0	284
21403	292	0	0	6	0	298
21404	295	0	1	5	0	301
21405	307	0	1	2	0	310
21406	3	2	1	317	0	323
21407	1	0	0	326	0	327
21408	3	1	1	325	0	330
21409	0	312	0	7	0	319
21410	3	308	0	0	0	311
21411	0	307	1	4	0	312
21412	1	287	1	3	0	292
21413	1	0	0	302	0	303
21414	0	0	1	304	0	305
21415	303	0	0	1	0	304
21416	299	2	0	0	0	301
21417	307	0	0	0	0	307
21418	0	0	1	310	0	311
21419	0	0	1	312	0	313
21420	315	0	0	1	0	316
21421	310	0	2	0	0	312
21422	0	0	317	2	0	319
21423	1	2	310	0	0	313
21424	2	0	339	1	0	342
21425	2	0	353	2	0	357
21426	1	0	0	359	0	360
21427	355	1	0	1	0	357
21428	1	350	0	2	0	353
21429	0	0	1	363	0	364
21430	0	0	370	0	0	370
21431	0	401	1	0	0	402
21432	1	0	1	412	0	414
21433	1	1	423	1	0	426
21434	1	0	0	418	0	419
21435	0	1	0	421	0	422
21436	431	0	0	1	0	432
21437	0	0	1	435	0	436
21438	0	1	427	0	0	428
21439	0	0	0	427	0	427
21440	0	465	1	0	0	466
21441	1	0	0	507	0	508
21442	0	0	0	519	0	519
21443	2	0	0	517	0	519
21444	534	0	0	1	0	535
21445	540	0	1	1	0	542
21446	567	0	0	3	0	570
21447	567	1	0	1	0	569
21448	0	0	560	1	0	561
21449	559	0	0	1	0	560
21450	568	0	0	2	0	570
21451	1	1	571	0	0	573
21452	1	0	602	0	0	603
21453	1	0	0	615	0	616
21454	1	622	0	0	0	623
21455	647	0	1	1	0	649
21456	665	1	0	2	0	668
21457	670	0	0	0	0	670
21458	0	0	1	665	0	666
21459	0	699	2	0	0	701
21460	740	0	0	1	0	741
21461	753	0	0	0	0	753
21462	1	1	0	755	0	757
21463	1	0	752	0	0	753
21464	762	0	0	0	0	762
21465	0	0	0	788	0	788
21466	803	1	0	0	0	804
21467	1	0	0	834	0	835
21468	1	0	852	0	0	853
21469	905	0	0	4	0	909
21470	1	0	1	949	0	951
21471	2	0	0	956	0	958
21472	0	0	0	960	0	960
21473	2	0	0	958	0	960
21474	974	0	0	2	0	976
21475	0	0	0	969	0	969
21476	1	966	0	0	0	967
21477	0	0	0	985	0	985
21478	0	997	0	1	0	998
21479	1	0	0	1028	0	1029
21480	0	0	0	1028	0	1028
21481	0	1027	0	0	0	1027
21482	2	0	0	1040	0	1042
21483	1	1	0	1043	0	1045
21484	1040	1	0	2	0	1043
21485	0	3	1060	3	0	1066
21486	1	0	2	1095	0	1098
21487	1100	0	0	4	0	1104
21488	1097	1	1	1	0	1100
21489	1099	0	0	5	0	1104
21490	4	2	1093	1	0	1100
21491	2	5	1098	0	0	1105
21492	1	0	5	1151	0	1157
21493	1173	0	2	5	0	1180
21494	5	0	1157	1	0	1163
21495	1158	0	3	3	0	1164
21496	5	1214	1	0	0	1220
21497	2	3	1	1297	0	1303
21498	0	1	1	1326	0	1328
21499	1340	2	0	5	0	1347
21500	4	0	0	1360	0	1364
21501	1319	0	1	11	0	1331
21502	1350	1	0	5	0	1356
21503	3	1	0	1350	0	1354
21504	2	0	0	1341	0	1343
21505	1360	0	0	7	0	1367
21506	5	0	1446	2	0	1453
21507	1451	0	4	5	0	1460
21508	7	1	1549	0	0	1557
21509	1584	0	5	1	0	1590
21510	1682	0	1	3	0	1686
21511	1666	0	2	4	0	1672
21512	1655	0	1	3	0	1659
21513	7	1653	3	3	0	1666
21514	1697	5	0	4	0	1706
21515	1711	1	1	3	0	1716
21516	9	1789	0	0	0	1798
21517	1816	6	0	4	0	1826
21518	7	3	1788	1	0	1799
21519	1794	1	6	4	0	1805
21520	7	4	1817	1	0	1829
21521	2	0	5	1835	0	1842
21522	3	0	2	1840	0	1845
21523	2	0	1819	6	0	1827
21524	4	2	5	1827	0	1838
21525	29	8	12	1245	0	1294
21526	1905	0	1	10	0	1916
21527	6	0	1	1916	0	1923
21528	4	0	0	1910	0	1914
21529	2	0	1	1926	0	1929
21530	2	1893	0	8	0	1903
21531	2	5	0	1906	0	1913
21532	1915	1	0	12	0	1928
21533	8	1	1923	2	0	1934
21534	2	0	8	1951	0	1961
21535	3	2	1952	7	0	1964
21536	1913	0	8	6	0	1927
21537	12	1	2	2057	0	2072
21538	7	0	2612	9	0	2628
21539	5	1	30	2649	0	2685
21540	5	1	15	2664	0	2685
21541	3	2649	12	49	0	2713
21542	8	28	9	2740	0	2785
21543	4	13	3	2930	0	2950
21544	1	12	2919	57	0	2989
21545	5	8	29	2936	0	2978
21546	7	4	19	2963	0	2993
21547	2909	3	14	62	0	2988
21548	2909	1	9	50	0	2969
21549	50	2905	8	30	0	2993
21550	2948	29	5	28	0	3010
21551	2942	22	7	24	0	2995
21552	61	3050	5	22	0	3138
21553	44	39	8	3068	0	3159
21554	3091	22	2	51	0	3166
21555	3104	15	2	36	0	3157
21556	3081	16	5	30	0	3132
21557	80	3013	3	17	0	3113
21558	46	46	3060	17	0	3169
21559	3096	26	32	19	0	3173
21560	3123	18	18	21	0	3180
21561	70	3115	18	11	0	3214
21562	3158	43	8	19	0	3228
21563	3191	24	12	11	0	3238
21564	81	25	7	3131	0	3244
21565	53	13	3151	49	0	3266
21566	40	13	44	3206	0	3303
21567	40	7	22	3196	0	3265
21568	26	11	14	3223	0	3274
21569	31	8	3086	78	0	3203
21570	31	8	50	3023	0	3112
21571	24	7	20	3127	0	3178
21572	21	8	22	3138	0	3189
21573	11	5	13	3158	0	3187
21574	18	4	11	3152	0	3185
21575	16	3084	4	112	0	3216
21576	15	44	7	3178	0	3244
21577	14	22	13	3259	0	3308
21578	16	17	3167	95	0	3295
21579	17	11	52	3386	0	3466
21580	9	14	26	3447	0	3496
21581	17	6	18	3560	0	3601
21582	21	9	12	3617	0	3659
21583	3531	8	11	147	0	3697
21584	75	11	10	3617	0	3713
21585	45	5	9	3630	0	3689
21586	21	11	3455	135	0	3622
21587	18	3338	58	92	0	3506
21588	21	3518	36	60	0	3635
21589	3458	79	21	64	0	3622
21590	71	3488	20	46	0	3625
21591	41	81	14	3478	0	3614
21592	3438	43	12	108	0	3601
21593	72	28	3435	70	0	3605
21594	45	27	62	3477	0	3611
21595	33	3445	38	101	0	3617
21596	25	79	20	3458	0	3582
21597	19	3405	19	109	0	3552
21598	29	83	15	3432	0	3559
21599	3373	46	10	124	0	3553
21600	75	40	3370	74	0	3559
21601	59	17	68	3351	0	3495
21602	33	3393	35	103	0	3564
21603	3370	78	30	75	0	3553
21604	93	48	3328	55	0	3524
21605	46	31	79	3350	0	3506
21606	43	23	3232	102	0	3400
21607	29	26	89	3213	0	3357
21608	33	17	3103	119	0	3272
21609	26	26	99	3070	0	3221
21610	23	16	41	3097	0	3177
21611	2990	15	42	130	0	3177
21612	3025	18	28	89	0	3160
21613	101	14	29	2983	0	3127
21614	65	2933	20	113	0	3131
21615	43	75	19	2994	0	3131
21616	23	42	18	2975	0	3058
21617	2832	28	14	141	0	3015
21618	88	2822	20	89	0	3019
21619	2826	75	16	85	0	3002
21620	2835	44	17	68	0	2964
21621	105	2722	18	56	0	2901
21622	65	2818	11	62	0	2956
21623	2776	101	17	57	0	2951
21624	104	50	2706	64	0	2924
21625	2736	38	74	57	0	2905
21626	2758	20	37	52	0	2867
21627	118	2675	33	42	0	2868
21628	75	79	18	2562	0	2734
21629	58	2667	27	95	0	2847
21630	2665	97	18	65	0	2845
21631	2704	59	22	57	0	2842
21632	126	46	13	2633	0	2818
21633	77	36	17	2655	0	2785
21634	2554	40	15	125	0	2734
21635	104	2514	6	99	0	2723
21636	65	2488	21	60	0	2634
21637	55	2439	14	62	0	2570
21638	30	1791	8	40	0	1869
21639	22	1806	14	37	0	1879
21640	35	90	9	1730	0	1864
21641	21	38	1676	68	0	1803
21642	25	1651	34	47	0	1757
21643	1458	56	23	25	0	1562
21644	53	26	14	1426	0	1519
21645	1417	23	10	52	0	1502
21646	51	1408	14	33	0	1506
21647	1406	47	17	24	0	1494
21648	54	1420	14	19	0	1507
21649	28	46	18	1422	0	1514
21650	1420	24	16	55	0	1515
21651	1436	18	15	31	0	1500
21652	59	16	16	1426	0	1517
21653	33	11	11	1449	0	1504
21654	23	1387	11	67	0	1488
21655	30	41	6	1404	0	1481
21656	35	17	8	1417	0	1477
21657	23	26	6	1401	0	1456
21658	18	1320	1	81	0	1420
21659	1238	43	5	42	0	1328
21660	48	1249	4	29	0	1330
21661	1202	51	5	22	0	1280
21662	56	1189	2	25	0	1272
21663	40	43	1167	16	0	1266
21664	30	23	34	1162	0	1249
21665	20	28	1116	38	0	1202
21666	23	22	1115	21	0	1181
21667	21	19	46	1097	0	1183
21668	24	12	1114	36	0	1186
21669	24	10	39	1105	0	1178
21670	17	18	19	1120	0	1174
21671	21	12	14	1136	0	1183
21672	1101	17	10	60	0	1188
21673	51	17	6	1104	0	1178
21674	35	13	5	1099	0	1152
21675	1033	12	2	61	0	1108
21676	44	1014	6	39	0	1103
21677	26	939	4	22	0	991
21678	21	942	4	15	0	982
21679	14	62	2	705	0	783
21680	12	14	708	23	0	757
21681	565	20	18	18	0	621
21682	14	565	4	4	0	587
21683	527	9	5	4	0	545
21684	522	6	2	5	0	535
21685	522	4	2	3	0	531
21686	13	5	511	3	0	532
21687	8	4	3	524	0	539
21688	10	3	2	525	0	540
21689	6	3	3	529	0	541
21690	8	3	0	512	0	523
21691	9	514	1	7	0	531
21692	510	8	1	8	0	527
21693	7	3	471	8	0	489
21694	454	3	4	5	0	466
21695	7	10	2	429	0	448
21696	7	421	0	7	0	435
21697	5	443	0	5	0	453
21698	5	26	5	382	0	418
21699	5	398	0	4	0	407
21700	335	3	0	2	0	340
21701	0	2	321	0	0	323
21702	0	1	0	310	0	311
21703	0	1	1	307	0	309
21704	0	1	0	314	0	315
21705	0	0	0	311	0	311
21706	318	0	1	0	0	319
21707	1	5	0	335	0	341
21708	386	0	0	4	0	390
21709	6	0	0	403	0	409
21710	5	0	0	437	0	442
21711	1	445	0	9	0	455
21712	459	5	0	4	0	468
21713	469	3	0	2	0	474
21714	10	460	0	2	0	472
21715	5	6	0	447	0	458
21716	1	446	0	7	0	454
21717	440	5	0	7	0	452
21718	6	6	443	2	0	457
21719	6	2	433	0	0	441
21720	429	2	9	1	0	441
21721	8	436	5	1	0	450
21722	4	6	2	438	0	450
21723	2	5	1	442	0	450
21724	2	1	442	10	0	455
21725	0	2	6	449	0	457
21726	1	0	5	453	0	459
21727	1	439	1	11	0	452
21728	0	7	2	445	0	454
21729	0	5	0	445	0	450
21730	433	2	1	12	0	448
21731	7	425	3	5	0	440
21732	6	430	0	3	0	439
21733	1	10	0	431	0	442
21734	2	5	0	438	0	445
21735	0	2	0	440	0	442
21736	1	430	0	12	0	443
21737	2	5	1	433	0	441
21738	0	5	1	435	0	441
21739	2	2	0	446	0	450
21740	0	2	0	449	0	451
21741	0	446	0	15	0	461
21742	0	473	0	7	0	480
21743	466	9	1	3	0	479
21744	468	5	0	5	0	478
21745	10	3	0	469	0	482
21746	7	3	473	7	0	490
21747	5	0	6	473	0	484
21748	3	4	4	467	0	478
21749	455	1	1	13	0	470
21750	7	463	1	6	0	477
21751	7	7	0	467	0	481
21752	2	4	2	464	0	472
21753	1	2	460	11	0	474
21754	2	1	464	7	0	474
21755	1	2	10	468	0	481
21756	1	1	5	470	0	477
21757	0	460	2	12	0	474
21758	0	468	2	8	0	478
21759	463	10	1	6	0	480
21760	6	6	1	476	0	489
21761	5	4	480	7	0	496
21762	2	481	6	8	0	497
21763	2	7	4	493	0	506
21764	491	6	2	10	0	509
21765	7	6	2	494	0	509
21766	475	4	0	10	0	489
21767	9	476	1	9	0	495
21768	459	8	2	5	0	474
21769	9	7	0	463	0	479
21770	5	5	480	10	0	500
21771	3	2	7	492	0	504
21772	0	498	7	15	0	520
21773	1	10	4	506	0	521
21774	0	518	1	15	0	534
21775	1	11	0	536	0	548
21776	0	11	501	12	0	524
21777	1	7	500	7	0	515
21778	5	1	505	5	0	516
21779	501	1	16	5	0	523
21780	8	488	10	5	0	511
21781	5	505	4	2	0	516
21782	502	13	1	8	0	524
21783	506	8	2	3	0	519
21784	15	7	1	497	0	520
21785	8	4	497	12	0	521
21786	6	2	482	10	0	500
21787	3	2	14	486	0	505
21788	483	1	12	11	0	507
21789	8	477	7	9	0	501
21790	6	7	2	491	0	506
21791	477	9	1	12	0	499
21792	491	7	1	8	0	507
21793	16	3	480	5	0	504
21794	476	1	9	7	0	493
21795	12	1	485	3	0	501
21796	6	4	493	1	0	504
21797	3	3	14	471	0	491
21798	6	0	8	480	0	494
21799	2	3	4	487	0	496
21800	2	1	473	21	0	497
21801	482	4	7	11	0	504
21802	12	4	7	494	0	517
21803	490	2	4	14	0	510
21804	501	1	4	11	0	517
21805	16	491	4	7	0	518
21806	8	502	1	7	0	518
21807	5	487	4	3	0	499
21808	10	13	2	439	0	464
21809	0	5	430	9	0	444
21810	3	11	5	397	0	416
21811	1	392	4	5	0	402
21812	1	396	4	2	0	403
21813	1	4	1	408	0	414
21814	397	2	1	3	0	403
21815	3	396	3	1	0	403
21816	1	401	0	4	0	406
21817	416	4	1	3	0	424
21818	4	5	0	413	0	422
21819	1	3	0	415	0	419
21820	5	0	1	422	0	428
21821	408	0	1	8	0	417
21822	408	0	2	5	0	415
21823	6	0	0	408	0	414
21824	4	1	394	4	0	403
21825	392	0	4	2	0	398
21826	5	0	1	400	0	406
21827	2	1	392	4	0	399
21828	3	1	396	2	0	402
21829	2	1	5	406	0	414
21830	1	0	409	4	0	414
21831	1	0	8	435	0	444
21832	1	0	0	424	0	425
21833	3	1	2	449	0	455
21834	445	2	0	10	0	457
21835	4	1	1	450	0	456
21836	4	1	0	454	0	459
21837	4	0	0	452	0	456
21838	1	1	1	454	0	457
21839	2	0	434	10	0	446
21840	0	430	4	7	0	441
21841	0	5	3	407	0	415
21842	0	2	4	401	0	407
21843	2	385	1	7	0	395
21844	2	402	0	3	0	407
21845	394	7	2	5	0	408
21846	5	387	1	5	0	398
21847	5	6	1	387	0	399
21848	4	2	383	7	0	396
21849	381	4	4	4	0	393
21850	5	1	368	2	0	376
21851	363	0	8	3	0	374
21852	374	0	3	3	0	380
21853	7	0	374	1	0	382
21854	7	2	4	352	0	365
21855	4	362	2	6	0	374
21856	1	4	4	381	0	390
21857	395	2	2	9	0	408
21858	394	2	2	6	0	404
21859	9	385	3	5	0	402
21860	390	5	1	3	0	399
21861	7	2	3	379	0	391
21862	375	3	1	9	0	388
21863	380	0	0	6	0	386
21864	7	0	0	377	0	384
21865	372	2	2	7	0	383
21866	362	0	1	5	0	368
21867	7	1	366	7	0	381
21868	368	0	7	2	0	377
21869	7	1	361	5	0	374
21870	1	3	344	2	0	350
21871	3	345	5	1	0	354
21872	2	4	8	325	0	339
21873	1	3	327	5	0	336
21874	0	6	322	3	0	331
21875	320	3	5	1	0	329
21876	6	0	2	323	0	331
21877	1	1	3	330	0	335
21878	3	1	0	332	0	336
21879	1	1	1	334	0	337
21880	2	1	1	335	0	339
21881	1	1	331	7	0	340
21882	2	1	328	3	0	334
21883	2	1	5	327	0	335
21884	321	2	3	3	0	329
21885	5	319	1	4	0	329
21886	1	5	1	326	0	333
21887	326	1	1	4	0	332
21888	4	320	0	4	0	328
21889	5	3	1	320	0	329
21890	4	2	0	322	0	328
21891	0	1	1	326	0	328
21892	318	0	0	8	0	326
21893	7	1	316	2	0	326
21894	316	0	4	4	0	324
21895	6	0	2	323	0	331
21896	2	0	3	308	0	313
21897	1	318	1	6	0	326
21898	1	4	317	2	0	324
21899	317	1	3	5	0	326
21900	324	0	2	7	0	333
21901	6	0	300	2	0	308
21902	296	3	3	2	0	304
21903	4	303	1	5	0	313
21904	2	305	1	4	0	312
21905	0	303	1	3	0	307
21906	289	6	2	2	0	299
21907	5	2	287	2	0	296
21908	2	2	5	268	0	277
21909	0	257	2	7	0	266
21910	0	274	1	4	0	279
21911	2	271	0	1	0	274
21912	3	11	2	228	0	244
21913	240	2	1	6	0	249
21914	5	254	0	3	0	262
21915	2	4	1	261	0	268
21916	1	2	1	266	0	270
21917	256	1	1	6	0	264
21918	4	0	2	254	0	260
21919	5	1	0	260	0	266
21920	2	0	257	5	0	264
21921	2	1	4	254	0	261
21922	1	2	0	265	0	268
21923	264	1	0	7	0	272
21924	263	0	1	3	0	267
21925	9	0	0	264	0	273
21926	260	1	0	6	0	267
21927	264	1	0	2	0	267
21928	6	259	1	1	0	267
21929	3	3	250	1	0	257
21930	3	250	4	0	0	257
21931	4	4	4	219	0	231
21932	208	0	4	2	0	214
21933	2	207	1	0	0	210
21934	0	3	0	215	0	218
21935	210	0	0	3	0	213
21936	209	0	1	0	0	210
21937	2	0	1	211	0	214
21938	1	0	229	2	0	232
21939	0	0	2	238	0	240
21940	0	0	0	242	0	242
21941	0	0	248	3	0	251
21942	0	0	2	249	0	251
21943	0	0	0	251	0	251
21944	257	0	1	2	0	260
21945	3	0	1	253	0	257
21946	0	0	0	263	0	263
21947	259	0	0	2	0	261
21948	257	0	0	0	0	257
21949	262	0	0	2	0	264
21950	2	0	260	0	0	262
21951	0	1	2	258	0	261
21952	0	262	0	2	0	264
21953	0	2	0	262	0	264
21954	0	0	273	3	0	276
21955	5	0	2	258	0	265
21956	0	0	261	1	0	262
21957	241	0	1	0	0	242
21958	243	0	0	0	0	243
21959	2	0	0	257	0	259
21960	0	0	0	255	0	255
21961	0	0	0	259	0	259
21962	0	274	0	1	0	275
21963	276	1	0	1	0	278
21964	283	0	0	1	0	284
21965	1	0	0	285	0	286
21966	0	0	0	290	0	290
21967	0	0	0	297	0	297
21968	0	0	0	296	0	296
21969	0	0	296	1	0	297
21970	0	0	1	296	0	297
21971	290	0	0	2	0	292
21972	288	0	0	1	0	289
21973	1	0	0	285	0	286
21974	0	0	280	1	0	281
21975	270	0	1	1	0	272
21976	2	0	0	284	0	286
21977	0	282	0	1	0	283
21978	0	300	0	1	0	301
21979	309	1	0	3	0	313
21980	2	0	0	335	0	337
21981	0	0	0	347	0	347
21982	0	1	1	353	0	355
21983	0	0	0	356	0	356
21984	0	0	0	372	0	372
21985	0	0	373	2	0	375
21986	0	0	369	2	0	371
21987	0	0	367	1	0	368
21988	1	0	4	368	0	373
21989	0	0	390	4	0	394
21990	0	0	3	387	0	390
21991	3	0	1	390	0	394
21992	1	0	0	400	0	401
21993	424	0	0	4	0	428
21994	3	0	1	427	0	431
21995	2	0	0	430	0	432
21996	428	1	0	5	0	434
21997	3	415	0	1	0	419
21998	1	421	1	0	0	423
21999	430	3	0	1	0	434
22000	2	430	1	0	0	433
22001	436	2	1	3	0	442
22002	441	1	0	2	0	444
22003	440	0	0	3	0	443
22004	437	0	0	2	0	439
22005	435	0	0	3	0	438
22006	3	435	1	0	0	439
22007	433	2	1	2	0	438
22008	447	1	1	0	0	449
22009	3	460	0	2	0	465
22010	502	2	1	1	0	506
22011	510	1	0	3	0	514
22012	549	0	0	2	0	551
22013	569	0	1	2	0	572
22014	10	1	623	1	0	635
22015	3	0	8	654	0	665
22016	1	0	2	670	0	673
22017	1	0	660	11	0	672
22018	0	1	653	2	0	656
22019	653	1	9	2	0	665
22020	9	0	2	666	0	677
22021	2	2	669	8	0	681
22022	3	0	656	2	0	661
22023	663	0	10	0	0	673
22024	674	0	3	3	0	680
22025	668	0	1	4	0	673
22026	11	0	665	4	0	680
22027	4	1	9	668	0	682
22028	2	0	669	9	0	680
22029	681	0	11	2	0	694
22030	10	2	688	2	0	702
22031	7	0	10	677	0	694
22032	4	0	7	686	0	697
22033	3	693	2	11	0	709
22034	703	9	0	4	0	716
22035	13	2	703	0	0	718
22036	694	0	12	4	0	710
22037	11	0	716	3	0	730
22038	2	0	13	699	0	714
22039	3	0	6	690	0	699
22040	5	0	4	691	0	700
22041	677	0	1	13	0	691
22042	12	1	2	677	0	692
22043	6	2	1	681	0	690
22044	3	668	3	9	0	683
22045	6	9	2	671	0	688
22046	667	2	4	9	0	682
22047	13	0	663	3	0	679
22048	3	0	12	661	0	676
22049	1	1	659	14	0	675
22050	4	646	9	5	0	664
22051	2	9	658	1	0	670
22052	658	3	9	2	0	672
22053	673	1	3	2	0	679
22054	13	4	1	647	0	665
22055	654	2	2	13	0	671
22056	656	0	1	7	0	664
22057	15	0	3	648	0	666
22058	3	0	4	659	0	666
22059	4	0	628	15	0	647
22060	0	627	11	7	0	645
22061	623	9	4	6	0	642
22062	13	599	3	1	0	616
22063	6	9	2	609	0	626
22064	5	2	1	611	0	619
22065	6	1	3	602	0	612
22066	3	1	2	604	0	610
22067	3	0	588	14	0	605
22068	579	2	11	7	0	599
22069	595	0	6	2	0	603
22070	15	2	3	587	0	607
22071	595	2	0	11	0	608
22072	11	2	1	595	0	609
22073	7	1	589	13	0	610
22074	4	0	10	583	0	597
22075	2	573	4	15	0	594
22076	2	10	2	576	0	590
22077	2	573	4	10	0	589
22078	2	10	0	555	0	567
22079	5	560	2	11	0	578
22080	532	9	1	6	0	548
22081	14	2	522	4	0	542
22082	3	504	7	7	0	521
22083	0	517	7	6	0	530
22084	2	8	6	501	0	517
22085	3	1	2	499	0	505
22086	4	1	0	503	0	508
22087	5	2	1	494	0	502
22088	0	484	1	14	0	499
22089	3	9	2	472	0	486
22090	4	4	1	477	0	486
22091	470	1	7	9	0	487
22092	9	1	3	474	0	487
22093	2	6	442	10	0	460
22094	0	1	436	9	0	446
22095	432	2	8	4	0	446
22096	10	433	1	5	0	449
22097	1	438	1	6	0	446
22098	7	10	0	433	0	450
22099	2	2	3	437	0	444
22100	1	2	426	15	0	444
22101	430	2	8	4	0	444
22102	433	0	2	5	0	440
22103	9	0	438	5	0	452
22104	1	2	435	5	0	443
22105	437	0	8	4	0	449
22106	451	4	2	3	0	460
22107	452	3	1	3	0	459
22108	444	1	0	5	0	450
22109	12	413	2	4	0	431
22110	366	6	3	4	0	379
22111	10	0	344	1	0	355
22112	1	0	311	2	0	314
22113	2	0	300	1	0	303
22114	1	28	10	182	0	221
22115	183	1	1	1	0	186
22116	183	1	0	0	0	184
22117	1	1	0	183	0	185
22118	0	0	0	181	0	181
22119	0	0	0	187	0	187
22120	0	197	0	3	0	200
22121	196	1	1	1	0	199
22122	201	0	1	1	0	203
22123	200	0	0	0	0	200
22124	199	0	0	1	0	200
22125	197	0	0	1	0	198
22126	2	0	0	192	0	194
22127	0	195	1	2	0	198
22128	2	0	1	200	0	203
22129	0	1	0	184	0	185
22130	184	0	0	1	0	185
22131	0	1	178	0	0	179
22132	0	0	161	1	0	162
22133	0	1	170	0	0	171
22134	169	0	0	0	0	169
22135	174	0	0	0	0	174
22136	0	0	0	168	0	168
22137	0	0	1	165	0	166
22138	1	0	0	175	0	176
22139	0	0	176	0	0	176
22140	0	0	0	171	0	171
22141	0	0	180	1	0	181
22142	0	0	0	185	0	185
22143	0	0	1	187	0	188
22144	0	0	0	188	0	188
22145	188	0	1	0	0	189
22146	191	1	0	3	0	195
22147	0	0	202	1	0	203
22148	200	0	0	2	0	202
22149	203	0	1	1	0	205
22150	2	0	1	201	0	204
22151	204	0	2	1	0	207
22152	1	0	1	212	0	214
22153	2	0	0	212	0	214
22154	0	0	213	2	0	215
22155	209	0	1	1	0	211
22156	0	0	0	216	0	216
22157	0	0	215	2	0	217
22158	0	0	238	1	0	239
22159	1	0	1	241	0	243
22160	0	0	1	242	0	243
22161	250	0	1	3	0	254
22162	2	0	0	251	0	253
22163	0	0	1	255	0	256
22164	2	0	0	255	0	257
22165	3	0	0	271	0	274
22166	297	0	1	3	0	301
22167	303	0	0	0	0	303
22168	309	0	0	4	0	313
22169	314	0	0	3	0	317
22170	4	0	1	331	0	336
22171	341	0	0	2	0	343
22172	3	0	0	338	0	341
22173	339	0	2	2	0	343
22174	3	0	1	340	0	344
22175	1	0	0	339	0	340
22176	1	338	1	3	0	343
22177	2	1	0	334	0	337
22178	329	0	0	5	0	334
22179	331	1	0	5	0	337
22180	3	0	332	2	0	337
22181	1	332	1	4	0	338
22182	333	1	0	2	0	336
22183	3	340	0	2	0	345
22184	341	2	1	2	0	346
22185	4	358	0	0	0	362
22186	2	2	361	2	0	367
22187	4	353	1	0	0	358
22188	3	365	0	1	0	369
22189	2	2	2	375	0	381
22190	386	1	1	4	0	392
22191	2	2	0	397	0	401
22192	1	3	0	399	0	403
22193	394	0	0	5	0	399
22194	404	1	0	4	0	409
22195	3	1	1	406	0	411
22196	1	1	1	407	0	410
22197	4	1	0	406	0	411
22198	405	0	0	4	0	409
22199	2	1	400	2	0	405
22200	2	0	1	399	0	402
22201	2	1	410	3	0	416
22202	2	410	3	0	0	415
22203	2	2	405	1	0	410
22204	0	2	1	401	0	404
22205	0	1	404	3	0	408
22206	397	2	2	1	0	402
22207	2	1	1	403	0	407
22208	0	406	3	4	0	413
22209	4	1	1	408	0	414
22210	2	400	1	4	0	407
22211	1	407	0	3	0	411
22212	1	415	3	5	0	424
22213	3	2	0	405	0	410
22214	1	405	1	3	0	410
22215	409	2	2	4	0	417
22216	4	1	410	3	0	418
22217	2	2	400	2	0	406
22218	3	2	404	2	0	411
22219	3	1	2	414	0	420
22220	0	1	3	402	0	406
22221	1	3	3	399	0	406
22222	2	0	2	400	0	404
22223	4	1	0	394	0	399
22224	3	420	1	4	0	428
22225	2	1	425	4	0	432
22226	3	4	423	3	0	433
22227	1	431	2	2	0	436
22228	4	5	1	440	0	450
22229	2	0	2	447	0	451
22230	2	3	2	447	0	454
22231	446	2	1	5	0	454
22232	2	0	448	5	0	455
22233	438	4	1	1	0	444
22234	444	0	2	4	0	450
22235	4	440	2	1	0	447
22236	3	456	1	1	0	461
22237	460	3	1	4	0	468
22238	2	4	0	449	0	455
22239	4	1	0	460	0	465
22240	4	1	475	4	0	484
22241	1	0	482	4	0	487
22242	2	1	3	487	0	493
22243	498	0	3	3	0	504
22244	3	2	519	1	0	525
22245	541	2	4	4	0	551
22246	5	0	2	551	0	558
22247	2	1	1	566	0	570
22248	2	0	1	576	0	579
22249	0	0	579	7	0	586
22250	1	563	6	2	0	572
22251	2	586	2	2	0	592
22252	594	6	1	2	0	603
22253	602	3	2	1	0	608
22254	7	1	0	611	0	619
22255	616	1	1	5	0	623
22256	7	1	604	2	0	614
22257	2	1	606	4	0	613
22258	3	0	7	594	0	604
22259	608	3	4	6	0	621
22260	6	1	3	617	0	627
22261	2	0	1	624	0	627
22262	616	1	2	7	0	626
22263	624	1	1	6	0	632
22264	8	640	1	6	0	655
22265	637	6	1	1	0	645
22266	7	4	1	623	0	635
22267	3	617	0	9	0	629
22268	617	7	1	1	0	626
22269	8	617	1	3	0	629
22270	2	9	0	613	0	624
22271	611	1	1	8	0	621
22272	8	1	602	2	0	613
22273	1	0	599	3	0	603
22274	4	4	9	597	0	614
22275	1	0	2	607	0	610
22276	1	2	1	593	0	597
22277	2	610	0	9	0	621
22278	633	8	1	2	0	644
22279	634	3	0	3	0	640
22280	642	1	0	2	0	645
22281	11	683	0	2	0	696
22282	1	10	0	732	0	743
22283	4	4	1	732	0	741
22284	2	3	1	739	0	745
22285	714	1	0	17	0	732
22286	14	708	0	5	0	727
22287	4	10	2	712	0	728
22288	1	4	3	717	0	725
22289	1	3	703	16	0	723
22290	2	692	12	5	0	711
22291	5	10	4	682	0	701
22292	3	4	1	700	0	708
22293	3	1	0	700	0	704
22294	675	0	0	19	0	694
22295	12	673	1	10	0	696
22296	678	12	1	5	0	696
22297	15	3	0	679	0	697
22298	682	4	0	12	0	698
22299	14	2	668	7	0	691
22300	678	0	11	6	0	695
22301	670	1	5	2	0	678
22302	17	2	665	1	0	685
22303	4	3	11	663	0	681
22304	2	1	4	663	0	670
22305	666	1	1	18	0	686
22306	12	1	1	673	0	687
22307	5	2	1	679	0	687
22308	2	2	0	680	0	684
22309	5	1	657	18	0	681
22310	649	0	11	7	0	667
22311	15	679	6	1	0	701
22312	6	12	3	660	0	681
22313	6	666	2	14	0	688
22314	2	690	4	5	0	701
22315	1	16	1	686	0	704
22316	2	5	680	17	0	704
22317	3	2	691	4	0	700
22318	2	0	15	695	0	712
22319	2	0	693	18	0	713
22320	694	2	15	6	0	717
22321	15	0	4	712	0	731
22322	5	0	2	725	0	732
22323	2	718	3	18	0	741
22324	1	16	1	714	0	732
22325	3	6	0	708	0	717
22326	0	704	1	19	0	724
22327	1	15	0	699	0	715
22328	2	5	3	695	0	705
22329	3	691	4	16	0	714
22330	687	14	2	10	0	713
22331	16	2	686	5	0	709
22332	6	2	682	1	0	691
22333	3	2	19	671	0	695
22334	1	1	3	690	0	695
22335	3	2	667	19	0	691
22336	1	1	660	8	0	670
22337	639	0	17	7	0	663
22338	13	655	4	3	0	675
22339	648	15	3	4	0	670
22340	15	2	638	7	0	662
22341	3	641	12	3	0	659
22342	4	16	2	652	0	674
22343	3	3	660	17	0	683
22344	2	4	636	2	0	644
22345	3	5	17	653	0	678
22346	0	0	653	20	0	673
22347	0	640	17	6	0	663
22348	5	15	7	623	0	650
22349	1	3	636	15	0	655
22350	1	622	14	6	0	643
22351	638	13	3	4	0	658
22352	17	3	634	1	0	655
22353	4	636	14	1	0	655
22354	5	19	3	612	0	639
22355	2	3	1	640	0	646
22356	629	1	2	17	0	649
22357	14	1	3	621	0	639
22358	3	0	1	626	0	630
22359	604	1	2	16	0	623
22360	14	1	2	605	0	622
22361	2	0	591	16	0	609
22362	0	2	15	597	0	614
22363	3	1	595	15	0	614
22364	1	0	568	7	0	576
22365	1	3	585	2	0	591
22366	1	2	14	563	0	580
22367	0	0	8	581	0	589
22368	567	2	0	14	0	583
22369	11	2	0	561	0	574
22370	4	602	3	13	0	622
22371	1	11	1	616	0	629
22372	3	4	1	620	0	628
22373	1	612	5	14	0	632
22374	611	13	3	5	0	632
22375	612	3	2	4	0	621
22376	13	601	4	4	0	622
22377	4	605	3	1	0	613
22378	6	30	5	572	0	613
22379	585	4	4	15	0	608
22380	12	3	581	3	0	599
22381	2	2	517	6	0	527
22382	482	1	9	2	0	494
22383	10	486	1	1	0	498
22384	2	9	1	480	0	492
22385	1	2	1	497	0	501
22386	2	1	0	497	0	500
22387	1	0	0	497	0	498
22388	1	485	2	9	0	497
22389	1	6	1	489	0	497
22390	488	1	3	8	0	500
22391	8	1	2	493	0	504
22392	3	1	2	501	0	507
22393	501	0	0	11	0	512
22394	502	1	0	6	0	509
22395	517	0	0	1	0	518
22396	514	0	0	1	0	515
22397	9	5	0	503	0	517
22398	504	1	0	10	0	515
22399	8	0	1	503	0	512
22400	501	2	1	7	0	511
22401	506	0	1	3	0	510
22402	10	0	0	504	0	514
22403	4	2	509	7	0	522
22404	516	3	8	1	0	528
22405	525	0	1	3	0	529
22406	523	0	0	3	0	526
22407	522	1	2	2	0	527
22408	9	0	3	526	0	538
22409	4	2	529	6	0	541
22410	1	3	531	3	0	538
22411	521	0	9	6	0	536
22412	540	0	8	4	0	552
22413	6	529	1	5	0	541
22414	2	533	3	3	0	541
22415	537	10	3	1	0	551
22416	9	2	0	529	0	540
22417	6	1	2	554	0	563
22418	548	2	2	10	0	562
22419	9	551	2	4	0	566
22420	561	6	2	4	0	573
22421	10	3	544	1	0	558
22422	555	3	6	1	0	565
22423	9	1	1	548	0	559
22424	5	0	557	8	0	570
22425	4	564	5	5	0	578
22426	2	4	1	586	0	593
22427	6	1	628	5	0	640
22428	7	1	5	627	0	640
22429	637	0	2	10	0	649
22430	6	0	633	2	0	641
22431	617	0	6	4	0	627
22432	7	630	4	1	0	642
22433	6	5	3	641	0	655
22434	3	3	685	6	0	697
22435	1	1	5	679	0	686
22436	2	1	692	7	0	702
22437	1	691	7	4	0	703
22438	685	5	1	2	0	693
22439	7	706	1	1	0	715
22440	3	7	0	706	0	716
22441	2	4	0	705	0	711
22442	2	0	678	8	0	688
22443	605	0	7	3	0	615
22444	5	643	2	3	0	653
22445	1	603	1	0	0	605
22446	0	613	0	0	0	613
22447	1	8	0	606	0	615
22448	0	606	1	4	0	611
22449	1	4	0	601	0	606
22450	1	612	1	7	0	621
22451	0	2	0	600	0	602
22452	1	609	0	1	0	611
22453	612	2	0	2	0	616
22454	3	0	608	0	0	611
22455	589	0	2	0	0	591
22456	612	0	0	1	0	613
22457	615	0	0	2	0	617
22458	2	621	1	3	0	627
22459	635	3	0	1	0	639
22460	636	0	0	2	0	638
22461	634	0	1	3	0	638
22462	4	1	633	1	0	639
22463	1	0	4	627	0	632
22464	0	0	639	4	0	643
22465	1	0	3	626	0	630
22466	626	1	0	5	0	632
22467	5	627	0	1	0	633
22468	0	4	707	0	0	711
22469	0	0	5	728	0	733
22470	1	0	2	744	0	747
22471	0	1	813	7	0	821
22472	811	0	7	2	0	820
22473	840	1	1	0	0	842
22474	864	0	0	1	0	865
22475	8	0	0	864	0	872
22476	3	846	1	7	0	857
22477	2	875	0	2	0	879
22478	0	8	0	885	0	893
22479	1	4	0	877	0	882
22480	0	878	0	8	0	886
22481	883	7	0	4	0	894
22482	7	883	0	1	0	891
22483	2	8	0	879	0	889
22484	1	2	871	8	0	882
22485	1	1	7	852	0	861
22486	862	0	2	8	0	872
22487	8	1	858	3	0	870
22488	867	1	7	1	0	876
22489	882	0	2	3	0	887
22490	896	0	2	2	0	900
22491	907	0	1	3	0	911
22492	934	0	0	2	0	936
22493	12	1	895	0	0	908
22494	5	0	909	0	0	914
22495	974	0	9	1	0	984
22496	1011	0	3	0	0	1014
22497	12	1	1	1049	0	1063
22498	5	1043	0	12	0	1060
22499	5	11	1	1078	0	1095
22500	1099	3	1	16	0	1119
22501	14	2	0	1080	0	1096
22502	2	1126	0	12	0	1140
22503	1120	11	0	8	0	1139
22504	1119	3	0	4	0	1126
22505	1118	1	0	6	0	1125
22506	17	1107	2	0	0	1126
22507	9	13	1	1106	0	1129
22508	8	3	0	1098	0	1109
22509	5	1071	0	12	0	1088
22510	3	16	0	1085	0	1104
22511	1070	3	0	18	0	1091
22512	1079	3	0	6	0	1088
22513	14	1056	1	5	0	1076
22514	5	12	1	1080	0	1098
22515	9	3	0	1078	0	1090
22516	9	2	0	1086	0	1097
22517	1054	6	0	17	0	1077
22518	13	1	1027	8	0	1049
22519	1013	1	13	12	0	1039
22520	19	1	1018	7	0	1045
22521	13	1	14	1003	0	1031
22522	6	995	7	13	0	1021
22523	9	1025	3	3	0	1040
22524	1002	16	5	4	0	1027
22525	997	2	0	7	0	1006
22526	17	981	1	3	0	1002
22527	5	938	0	6	0	949
22528	955	18	1	3	0	977
22529	980	6	1	4	0	991
22530	20	981	1	3	0	1005
22531	1000	15	0	5	0	1020
22532	22	8	973	4	0	1007
22533	989	6	12	5	0	1012
22534	981	5	4	5	0	995
22535	24	2	2	972	0	1000
22536	6	964	5	16	0	991
22537	12	12	1	968	0	993
22538	979	3	3	20	0	1005
22539	18	6	0	952	0	976
22540	9	5	1	958	0	973
22541	5	3	977	24	0	1009
22542	13	1	12	1004	0	1030
22543	5	3	6	1027	0	1041
22544	1007	2	4	21	0	1034
22545	17	1	997	11	0	1026
22546	997	1	15	13	0	1026
22547	20	3	4	1005	0	1032
22548	11	4	4	1007	0	1026
22549	8	1	5	1001	0	1015
22550	9	946	3	17	0	975
22551	5	988	3	15	0	1011
22552	7	16	3	981	0	1007
22553	971	7	5	20	0	1003
22554	987	9	0	6	0	1002
22555	23	6	1	974	0	1004
22556	976	3	1	19	0	999
22557	21	6	1	975	0	1003
22558	12	3	1	989	0	1005
22559	949	0	1	24	0	974
22560	19	984	1	12	0	1016
22561	983	12	0	11	0	1006
22562	986	6	2	7	0	1001
22563	975	3	2	7	0	987
22564	24	953	0	4	0	981
22565	12	11	2	971	0	996
22566	11	7	2	981	0	1001
22567	8	4	961	20	0	993
22568	4	12	11	879	0	906
22569	4	2	842	20	0	868
22570	2	794	12	13	0	821
22571	3	703	9	6	0	721
22572	5	713	2	10	0	730
22573	11	10	13	699	0	733
22574	10	9	1	697	0	717
22575	1	9	4	699	0	713
22576	2	3	1	710	0	716
22577	3	1	708	19	0	731
22578	1	5	864	9	0	879
22579	6	1	10	914	0	931
22580	3	3	927	17	0	950
22581	928	3	15	8	0	954
22582	941	3	7	9	0	960
22583	15	2	938	12	0	967
22584	9	2	12	953	0	976
22585	10	1	6	966	0	983
22586	11	1	3	976	0	991
22587	5	0	7	971	0	983
22588	5	1	2	979	0	987
22589	747	3	3	21	0	774
22590	935	2	1	16	0	954
22591	12	926	1	13	0	952
22592	11	10	880	10	0	911
22593	7	886	9	6	0	908
22594	7	886	8	4	0	905
22595	818	12	2	6	0	838
22596	8	822	3	6	0	839
22597	7	763	2	3	0	775
22598	766	12	3	3	0	784
22599	6	8	747	2	0	763
22600	737	2	6	2	0	747
22601	9	4	7	738	0	758
22602	7	3	2	710	0	722
22603	6	1	2	724	0	733
22604	0	5	706	13	0	724
22605	3	710	7	8	0	728
22606	708	5	6	7	0	726
22607	9	7	4	720	0	740
22608	10	725	0	8	0	743
22609	3	7	2	738	0	750
22610	1	9	736	10	0	756
22611	5	2	6	737	0	750
22612	3	2	10	749	0	764
22613	5	2	3	750	0	760
22614	737	3	1	17	0	758
22615	8	2	6	753	0	769
22616	7	3	738	12	0	760
22617	4	743	8	13	0	768
22618	6	6	7	755	0	774
22619	6	8	4	748	0	766
22620	0	3	742	21	0	766
22621	3	3	730	14	0	750
22622	736	3	15	9	0	763
22623	717	4	7	10	0	738
22624	15	739	5	8	0	767
22625	730	8	4	8	0	750
22626	12	8	730	8	0	758
22627	13	2	724	5	0	744
22628	701	8	19	9	0	737
22629	676	4	8	10	0	698
22630	13	5	663	10	0	691
22631	666	4	7	8	0	685
22632	10	3	664	8	0	685
22633	661	4	12	4	0	681
22634	651	6	8	3	0	668
22635	15	7	5	634	0	661
22636	13	669	5	9	0	696
22637	540	12	11	8	0	571
22638	6	10	668	8	0	692
22639	12	670	8	6	0	696
22640	678	11	8	7	0	704
22641	631	14	6	4	0	655
22642	18	625	3	6	0	652
22643	13	5	9	629	0	656
22644	5	10	616	14	0	645
22645	6	2	10	640	0	658
22646	7	2	626	16	0	651
22647	4	5	10	636	0	655
22648	5	1	10	640	0	656
22649	5	6	631	15	0	657
22650	6	627	6	16	0	655
22651	10	7	10	622	0	649
22652	3	9	499	11	0	522
22653	619	6	9	15	0	649
22654	9	3	9	631	0	652
22655	9	4	5	642	0	660
22656	627	4	5	22	0	658
22657	11	3	10	629	0	653
22658	18	3	3	612	0	636
22659	8	620	5	15	0	648
22660	7	9	5	609	0	630
22661	7	7	606	11	0	631
22662	7	3	11	600	0	621
22663	8	585	12	11	0	616
22664	6	590	8	10	0	614
22665	7	12	5	588	0	612
22666	593	7	6	7	0	613
22667	11	3	8	584	0	606
22668	586	8	6	8	0	608
22669	15	3	5	584	0	607
22670	591	2	4	11	0	608
22671	593	3	4	8	0	608
22672	16	3	5	580	0	604
22673	16	37	6	543	0	602
22674	7	565	5	17	0	594
22675	10	570	6	10	0	596
22676	8	14	564	5	0	591
22677	8	544	6	8	0	566
22678	333	19	13	6	0	371
22679	11	4	3	320	0	338
22680	4	315	0	4	0	323
22681	317	3	3	3	0	326
22682	4	6	1	317	0	328
22683	6	1	0	308	0	315
22684	0	0	2	314	0	316
22685	0	1	1	313	0	315
22686	3	311	1	8	0	323
22687	0	323	1	7	0	331
22688	332	4	0	6	0	342
22689	5	332	1	7	0	345
22690	1	8	1	335	0	345
22691	1	4	1	336	0	342
22692	0	1	0	339	0	340
22693	2	1	0	339	0	342
22694	334	3	0	7	0	344
22695	337	0	0	6	0	343
22696	8	0	327	2	0	337
22697	3	0	5	342	0	350
22698	1	1	347	6	0	355
22699	2	2	5	342	0	351
22700	3	1	1	343	0	348
22701	358	0	2	9	0	369
22702	5	0	1	362	0	368
22703	3	1	352	6	0	362
22704	0	3	347	4	0	354
22705	352	3	6	2	0	363
22706	8	0	356	1	0	365
22707	2	1	4	339	0	346
22708	1	0	356	5	0	362
22709	2	0	5	351	0	358
22710	2	351	2	7	0	362
22711	4	5	3	347	0	359
22712	1	337	0	10	0	348
22713	0	346	2	7	0	355
22714	2	8	1	342	0	353
22715	330	3	2	10	0	345
22716	5	334	3	1	0	343
22717	1	4	3	341	0	349
22718	337	2	1	5	0	345
22719	342	0	2	5	0	349
22720	344	1	0	4	0	349
22721	5	1	3	338	0	347
22722	3	1	0	344	0	348
22723	342	3	1	7	0	353
22724	339	0	0	7	0	346
22725	339	4	0	3	0	346
22726	6	3	0	336	0	345
22727	1	1	327	7	0	336
22728	332	1	4	1	0	338
22729	5	2	1	326	0	334
22730	3	332	0	6	0	341
22731	2	5	0	336	0	343
22732	3	331	0	6	0	340
22733	4	6	0	336	0	346
22734	2	1	333	5	0	341
22735	2	321	3	3	0	329
22736	3	4	1	296	0	304
22737	2	1	1	297	0	301
22738	4	0	0	296	0	300
22739	314	0	1	7	0	322
22740	5	317	3	2	0	327
22741	4	5	0	334	0	343
22742	342	2	0	8	0	352
22743	349	3	0	3	0	355
22744	6	1	1	349	0	357
22745	2	3	350	6	0	361
22746	3	0	3	351	0	357
22747	0	350	3	7	0	360
22748	1	7	1	354	0	363
22749	345	2	1	7	0	355
22750	6	2	0	370	0	378
22751	2	0	369	10	0	381
22752	4	398	4	4	0	410
22753	407	8	1	5	0	421
22754	8	1	415	4	0	428
22755	420	2	7	2	0	431
22756	9	0	1	428	0	438
22757	2	1	1	432	0	436
22758	3	428	3	7	0	441
22759	448	4	0	6	0	458
22760	7	3	1	454	0	465
22761	2	2	1	464	0	469
22762	4	2	1	477	0	484
22763	1	2	471	12	0	486
22764	2	1	9	473	0	485
22765	477	2	1	8	0	488
22766	487	0	2	3	0	492
22767	6	1	2	488	0	497
22768	6	1	1	505	0	513
22769	496	1	0	11	0	508
22770	9	0	491	5	0	505
22771	483	3	7	4	0	497
22772	10	0	484	4	0	498
22773	2	1	476	3	0	482
22774	3	0	5	478	0	486
22775	1	0	490	10	0	501
22776	482	1	10	2	0	495
22777	8	0	1	502	0	511
22778	3	1	496	6	0	506
22779	491	0	6	3	0	500
22780	500	0	3	3	0	506
22781	8	0	529	4	0	541
22782	8	0	7	515	0	530
22783	1	532	4	6	0	543
22784	539	5	1	4	0	549
22785	9	1	530	2	0	542
22786	524	2	7	0	0	533
22787	7	535	2	6	0	550
22788	525	4	7	2	0	538
22789	527	2	0	2	0	531
22790	533	2	0	3	0	538
22791	8	1	4	538	0	551
22792	4	535	2	8	0	549
22793	4	5	533	3	0	545
22794	3	542	6	3	0	554
22795	4	5	3	516	0	528
22796	7	539	3	5	0	554
22797	3	549	3	3	0	558
22798	542	7	2	2	0	553
22799	7	2	530	3	0	542
22800	3	2	548	2	0	555
22801	3	2	536	1	0	542
22802	2	560	6	1	0	569
22803	562	4	1	8	0	575
22804	562	2	1	3	0	568
22805	566	2	0	2	0	570
22806	7	557	3	1	0	568
22807	2	6	0	577	0	585
22808	3	0	573	7	0	583
22809	2	2	574	1	0	579
22810	599	0	6	4	0	609
22811	615	0	1	3	0	619
22812	618	0	1	3	0	622
22813	6	2	604	1	0	613
22814	603	1	4	2	0	610
22815	7	1	1	608	0	617
22816	2	0	4	623	0	629
22817	2	0	651	6	0	659
22818	2	639	9	1	0	651
22819	1	5	2	654	0	662
22820	3	0	657	7	0	667
22821	641	2	6	1	0	650
22822	8	0	1	671	0	680
22823	2	1	1	678	0	682
22824	673	0	2	6	0	681
22825	5	0	3	677	0	685
22826	679	1	1	7	0	688
22827	682	1	3	2	0	688
22828	5	0	4	681	0	690
22829	3	0	0	691	0	694
22830	679	2	2	7	0	690
22831	9	0	1	689	0	699
22832	706	0	2	7	0	715
22833	701	1	3	3	0	708
22834	703	1	0	3	0	707
22835	10	1	2	693	0	706
22836	2	0	4	698	0	704
22837	696	1	1	7	0	705
22838	5	683	3	3	0	694
22839	2	659	1	1	0	663
22840	658	3	2	1	0	664
22841	5	0	646	0	0	651
22842	642	1	1	1	0	645
22843	4	0	1	676	0	681
22844	2	0	686	2	0	690
22845	700	0	2	1	0	703
22846	3	1	2	711	0	717
22847	2	0	1	740	0	743
22848	1	1	0	762	0	764
22849	3	0	0	761	0	764
22850	743	1	1	4	0	749
22851	4	735	0	0	0	739
22852	697	3	0	0	0	700
22853	3	0	699	0	0	702
22854	0	0	683	0	0	683
22855	2	716	1	0	0	719
22856	1	4	0	712	0	717
22857	0	0	710	1	0	711
22858	0	664	2	1	0	667
22859	0	0	681	0	0	681
22860	0	0	0	678	0	678
22861	0	0	0	670	0	670
22862	672	0	0	1	0	673
22863	1	0	0	665	0	666
22864	666	0	1	3	0	670
22865	0	1	673	0	0	674
22866	0	692	0	1	0	693
22867	0	0	0	720	0	720
22868	0	0	0	748	0	748
22869	1	0	756	0	0	757
22870	0	1	725	0	0	726
22871	756	0	1	0	0	757
22872	775	0	0	1	0	776
22873	0	0	0	776	0	776
22874	0	0	0	776	0	776
22875	0	756	0	0	0	756
22876	0	0	0	780	0	780
22877	792	0	0	2	0	794
22878	799	0	0	1	0	800
22879	0	804	0	0	0	804
22880	815	0	0	1	0	816
22881	798	0	0	1	0	799
22882	1	0	0	849	0	850
22883	0	836	0	3	0	839
22884	0	4	0	858	0	862
22885	0	1	0	881	0	882
22886	0	0	870	6	0	876
22887	872	0	6	1	0	879
22888	7	0	1	977	0	985
22889	4	0	0	1043	0	1047
22890	0	1187	3	15	0	1205
22891	1	18	0	1288	0	1307
22892	1308	4	0	21	0	1333
22893	1405	2	0	5	0	1412
22894	29	0	1371	3	0	1403
22895	7	2	1389	2	0	1400
22896	2	2	28	1405	0	1437
22897	5	1	5	1446	0	1457
22898	7	0	1426	34	0	1467
22899	7	1	1435	8	0	1451
22900	3	0	36	1392	0	1431
22901	2	1	1431	30	0	1464
22902	2	1	1437	14	0	1454
22903	6	0	35	1410	0	1451
22904	1434	1	15	28	0	1478
22905	1463	0	8	12	0	1483
22906	35	0	4	1445	0	1484
22907	7	1	7	1457	0	1472
22908	1413	0	9	40	0	1462
22909	29	0	5	1420	0	1454
22910	1401	0	3	34	0	1438
22911	1424	0	2	13	0	1439
22912	36	0	4	1408	0	1448
22913	13	1	3	1432	0	1449
22914	1395	1	1	41	0	1438
22915	32	1375	2	15	0	1424
22916	17	1414	1	6	0	1438
22917	13	29	1	1364	0	1407
22918	5	6	1349	35	0	1395
22919	8	1	27	1364	0	1400
22920	1357	3	5	33	0	1398
22921	33	5	2	1363	0	1403
22922	1360	6	2	33	0	1401
22923	30	2	1348	15	0	1395
22924	1374	2	33	10	0	1419
22925	35	2	9	1386	0	1432
22926	10	3	2	1411	0	1426
22927	7	2	1419	41	0	1469
22928	11	0	30	1438	0	1479
22929	8	2	13	1463	0	1486
22930	11	3	2	1486	0	1502
22931	1459	2	1	49	0	1511
22932	30	0	1446	21	0	1497
22933	16	3	1451	7	0	1477
22934	1438	0	35	17	0	1490
22935	1479	1	12	14	0	1506
22936	39	2	1475	14	0	1530
22937	19	0	30	1473	0	1522
22938	7	1507	18	29	0	1561
22939	6	24	11	1535	0	1576
22940	1531	8	7	36	0	1582
22941	1552	2	8	17	0	1579
22942	41	1	10	1512	0	1564
22943	11	1500	9	36	0	1556
22944	8	28	6	1475	0	1517
22945	13	1477	5	36	0	1531
22946	1488	27	4	17	0	1536
22947	1461	6	7	12	0	1486
22948	1461	3	8	14	0	1486
22949	37	1404	4	15	0	1460
22950	13	1448	3	19	0	1483
22951	17	37	3	1450	0	1507
22952	15	12	9	1481	0	1517
22953	13	3	6	1478	0	1500
22954	17	5	3	1493	0	1518
22955	10	10	1418	40	0	1478
22956	1392	11	33	20	0	1456
22957	40	6	1428	16	0	1490
22958	1456	3	28	17	0	1504
22959	35	4	1472	20	0	1531
22960	1478	3	30	16	0	1527
22961	35	4	1501	13	0	1553
22962	1502	1	31	20	0	1554
22963	40	2	17	1511	0	1570
22964	1553	1	9	37	0	1600
22965	41	2	7	1574	0	1624
22966	19	4	9	1586	0	1618
22967	13	1	9	1547	0	1570
22968	12	1483	11	42	0	1548
22969	1481	26	5	21	0	1533
22970	1496	8	6	15	0	1525
22971	41	1476	3	23	0	1543
22972	21	27	6	1500	0	1554
22973	10	9	1480	37	0	1536
22974	1463	6	29	18	0	1516
22975	1510	3	11	18	0	1542
22976	1501	3	5	13	0	1522
22977	41	6	9	1448	0	1504
22978	14	1426	7	42	0	1489
22979	11	30	9	1436	0	1486
22980	1427	9	4	38	0	1478
22981	49	4	4	1384	0	1441
22982	16	1345	6	36	0	1403
22983	1342	24	3	17	0	1386
22984	30	11	1364	11	0	1416
22985	27	5	1331	8	0	1371
22986	13	1325	31	12	0	1381
22987	9	1310	7	14	0	1340
22988	22	30	1204	6	0	1262
22989	22	9	1122	6	0	1159
22990	7	69	13	888	0	977
22991	890	1	5	9	0	905
22992	7	0	880	4	0	891
22993	2	814	4	0	0	820
22994	822	3	7	1	0	833
22995	1	817	1	0	0	819
22996	787	0	0	3	0	790
22997	2	782	0	1	0	785
22998	0	790	0	0	0	790
22999	0	0	0	801	0	801
23000	2	0	0	792	0	794
23001	0	0	771	0	0	771
23002	0	0	1	759	0	760
23003	764	0	0	1	0	765
23004	757	0	1	1	0	759
23005	1	0	0	756	0	757
23006	0	0	751	0	0	751
23007	1	0	731	0	0	732
23008	0	0	0	762	0	762
23009	0	0	772	0	0	772
23010	1	1	0	760	0	762
23011	2	0	0	750	0	752
23012	0	0	835	0	0	835
23013	815	0	2	2	0	819
23014	836	0	1	2	0	839
23015	2	0	846	0	0	848
23016	3	0	858	0	0	861
23017	2	0	4	891	0	897
23018	2	0	1	975	0	978
23019	1	0	1	993	0	995
23020	2	0	1	988	0	991
23021	1004	0	0	7	0	1011
23022	1043	0	0	4	0	1047
23023	6	0	0	1120	0	1126
23024	4	1	0	1150	0	1155
23025	2	0	1240	9	0	1251
23026	8	0	9	1270	0	1287
23027	1	0	4	1317	0	1322
23028	1356	0	2	21	0	1379
23029	14	1434	5	6	0	1459
23030	9	14	0	1448	0	1471
23031	6	7	1	1444	0	1458
23032	4	2	0	1428	0	1434
23033	0	1332	2	33	0	1367
23034	2	1410	2	13	0	1427
23035	3	18	0	1412	0	1433
23036	4	9	0	1393	0	1406
23037	1	3	0	1403	0	1407
23038	1331	3	3	25	0	1362
23039	17	1345	0	23	0	1385
23040	1373	12	1	10	0	1396
23041	1377	10	1	5	0	1393
23042	25	9	0	1346	0	1380
23043	10	1330	1	16	0	1357
23044	1334	14	1	15	0	1364
23045	19	9	1	1332	0	1361
23046	1347	4	0	20	0	1371
23047	20	5	0	1355	0	1380
23048	11	3	1340	19	0	1373
23049	6	3	1347	15	0	1371
23050	7	3	22	1355	0	1387
23051	3	4	9	1359	0	1375
23052	3	4	3	1337	0	1347
23053	5	1304	2	32	0	1343
23054	5	1361	1	14	0	1381
23055	1347	23	1	13	0	1384
23056	1335	13	2	13	0	1363
23057	26	1330	2	3	0	1361
23058	12	1306	0	9	0	1327
23059	5	1322	1	9	0	1337
23060	1276	26	0	9	0	1311
23061	19	1278	2	10	0	1309
23062	12	21	2	1276	0	1311
23063	1271	11	1	26	0	1309
23064	1256	3	2	17	0	1278
23065	26	4	3	1214	0	1247
23066	13	6	1185	24	0	1228
23067	7	5	1185	15	0	1212
23068	10	3	21	1189	0	1223
23069	7	6	1190	22	0	1225
23070	3	6	19	1199	0	1227
23071	7	4	11	1187	0	1209
23072	7	3	1172	29	0	1211
23073	7	3	1175	17	0	1202
23074	4	7	28	1157	0	1196
23075	2	11	13	1193	0	1219
23076	1177	3	5	34	0	1219
23077	21	1157	4	20	0	1202
23078	9	1204	2	15	0	1230
23079	1176	25	4	8	0	1213
23080	1215	13	4	6	0	1238
23081	26	1169	5	12	0	1212
23082	11	1184	3	16	0	1214
23083	1187	28	3	15	0	1233
23084	22	15	2	1172	0	1211
23085	1161	7	4	22	0	1194
23086	24	1151	4	21	0	1200
23087	1167	17	1	13	0	1198
23088	24	11	1140	10	0	1185
23089	1147	8	18	8	0	1181
23090	22	7	1152	8	0	1189
23091	20	4	18	1135	0	1177
23092	1121	5	12	30	0	1168
23093	25	5	1108	18	0	1156
23094	13	7	19	1095	0	1134
23095	1087	7	10	27	0	1131
23096	22	1	1081	19	0	1123
23097	14	5	19	1088	0	1126
23098	1065	7	12	22	0	1106
23099	17	1060	5	18	0	1100
23100	19	17	3	1091	0	1130
23101	11	10	3	1087	0	1111
23102	9	11	2	1100	0	1122
23103	11	1076	5	30	0	1122
23104	11	18	4	1108	0	1141
23105	12	9	3	1117	0	1141
23106	13	9	5	1112	0	1139
23107	9	9	5	1131	0	1154
23108	6	7	1092	34	0	1139
23109	1088	2	15	21	0	1126
23110	1095	2	12	24	0	1133
23111	29	1083	4	11	0	1127
23112	14	20	9	1029	0	1072
23113	10	9	3	1040	0	1062
23114	7	1012	6	31	0	1056
23115	10	13	3	1020	0	1046
23116	972	14	5	24	0	1015
23117	17	942	4	16	0	979
23118	868	13	3	7	0	891
23119	16	10	4	853	0	883
23120	10	6	845	17	0	878
23121	3	841	13	15	0	872
23122	785	11	14	6	0	816
23123	8	703	4	7	0	722
23124	8	686	2	4	0	700
23125	564	8	8	3	0	583
23126	6	4	544	1	0	555
23127	5	480	0	2	0	487
23128	363	13	32	9	0	417
23129	312	3	1	2	0	318
23130	0	315	0	0	0	315
23131	0	0	0	330	0	330
23132	0	0	344	0	0	344
23133	0	0	0	349	0	349
23134	0	0	0	342	0	342
23135	0	0	0	355	0	355
23136	0	0	362	1	0	363
23137	3	0	0	360	0	363
23138	0	1	367	1	0	369
23139	0	1	341	0	0	342
23140	330	0	0	0	0	330
23141	2	346	0	0	0	348
23142	0	350	0	0	0	350
23143	0	0	1	378	0	379
23144	415	0	0	3	0	418
23145	412	1	0	2	0	415
23146	400	0	0	1	0	401
23147	398	1	0	1	0	400
23148	396	1	0	0	0	397
23149	2	0	384	0	0	386
23150	1	0	1	381	0	383
23151	0	370	1	0	0	371
23152	0	2	0	383	0	385
23153	387	0	0	1	0	388
23154	1	387	1	0	0	389
23155	0	1	0	391	0	392
23156	394	0	0	2	0	396
23157	419	0	2	4	0	425
23158	1	1	1	426	0	429
23159	3	0	0	415	0	418
23160	1	1	0	422	0	424
23161	0	1	414	3	0	418
23162	0	0	413	2	0	415
23163	1	0	2	414	0	417
23164	1	1	1	422	0	425
23165	425	0	1	3	0	429
23166	424	0	0	3	0	427
23167	430	1	1	1	0	433
23168	442	1	0	6	0	449
23169	452	0	2	1	0	455
23170	3	453	1	0	0	457
23171	476	1	0	3	0	480
23172	472	3	0	0	0	475
23173	475	1	0	1	0	477
23174	2	1	0	493	0	496
23175	2	0	484	1	0	487
23176	3	1	1	490	0	495
23177	1	2	521	2	0	526
23178	2	0	2	520	0	524
23179	3	526	0	1	0	530
23180	523	3	2	1	0	529
23181	534	0	0	3	0	537
23182	3	1	0	551	0	555
23183	3	0	0	584	0	587
23184	2	0	0	581	0	583
23185	0	601	0	2	0	603
23186	599	3	0	4	0	606
23187	611	0	1	0	0	612
23188	4	622	1	0	0	627
23189	0	3	0	627	0	630
23190	0	0	0	626	0	626
23191	1	622	0	5	0	628
23192	634	3	2	0	0	639
23193	631	0	1	0	0	632
23194	4	0	0	632	0	636
23195	1	0	640	6	0	647
23196	2	1	627	0	0	630
23197	4	0	3	647	0	654
23198	3	0	0	654	0	657
23199	4	0	0	664	0	668
23200	671	0	0	4	0	675
23201	678	2	1	0	0	681
23202	7	698	0	4	0	709
23203	714	5	1	0	0	720
23204	7	0	710	2	0	719
23205	1	2	707	2	0	712
23206	1	730	7	1	0	739
23207	711	9	8	2	0	730
23208	4	709	0	2	0	715
23209	707	6	0	3	0	716
23210	6	1	715	1	0	723
23211	2	1	704	0	0	707
23212	3	0	5	706	0	714
23213	1	0	721	6	0	728
23214	0	1	5	734	0	740
23215	2	2	1	678	0	683
23216	1	732	0	9	0	742
23217	3	6	0	740	0	749
23218	3	1	0	752	0	756
23219	771	1	0	8	0	780
23220	5	774	0	2	0	781
23221	3	6	1	799	0	809
23222	1	1	806	8	0	816
23223	765	0	8	1	0	774
23224	9	0	811	2	0	822
23225	0	6	9	790	0	805
23226	1	837	2	6	0	846
23227	1	9	1	834	0	845
23228	855	0	0	11	0	866
23229	861	0	0	3	0	864
23230	11	884	1	1	0	897
23231	905	10	4	2	0	921
23232	915	1	0	1	0	917
23233	903	2	0	2	0	907
23234	925	0	1	2	0	928
23235	894	0	1	2	0	897
23236	9	1	905	0	0	915
23237	2	1	10	905	0	918
23238	2	1	0	906	0	909
23239	3	3	0	914	0	920
23240	2	909	1	10	0	922
23241	2	10	1	901	0	914
23242	0	0	915	11	0	926
23243	0	884	13	1	0	898
23244	1	882	1	2	0	886
23245	5	10	0	876	0	891
23246	1	1	0	877	0	879
23247	1	0	0	877	0	878
23248	2	850	0	9	0	861
23249	2	870	2	0	0	874
23250	872	9	0	3	0	884
23251	876	0	0	3	0	879
23252	9	871	2	1	0	883
23253	880	10	1	2	0	893
23254	925	1	2	5	0	933
23255	12	1	1	933	0	947
23256	1	2	1	953	0	957
23257	5	0	0	943	0	948
23258	1	2	940	11	0	954
23259	1	0	926	3	0	930
23260	1	976	11	2	0	990
23261	1007	10	2	1	0	1020
23262	10	2	1010	2	0	1024
23263	1001	1	10	4	0	1016
23264	15	1	1087	0	0	1103
23265	1101	1	12	3	0	1117
23266	14	1144	5	2	0	1165
23267	1156	13	2	4	0	1175
23268	13	6	3	1140	0	1162
23269	8	0	1	1175	0	1184
23270	3	2	1182	17	0	1204
23271	6	1200	14	7	0	1227
23272	4	15	5	1206	0	1230
23273	4	6	1201	15	0	1226
23274	1150	3	18	6	0	1177
23275	17	1191	6	1	0	1215
23276	1184	15	0	5	0	1204
23277	14	1145	3	8	0	1170
23278	8	14	4	1141	0	1167
23279	1136	6	4	14	0	1160
23280	15	1148	2	7	0	1172
23281	4	14	5	1157	0	1180
23282	5	3	1133	18	0	1159
23283	1090	4	15	8	0	1117
23284	16	4	4	1122	0	1146
23285	3	5	1101	15	0	1124
23286	1	1099	10	10	0	1120
23287	5	9	3	1107	0	1124
23288	2	9	1099	15	0	1125
23289	3	3	12	1076	0	1094
23290	0	1094	8	11	0	1113
23291	4	1104	2	5	0	1115
23292	3	16	1093	3	0	1115
23293	6	6	14	1082	0	1108
23294	1	5	1106	14	0	1126
23295	1076	3	10	10	0	1099
23296	16	1	8	1075	0	1100
23297	6	1059	1	17	0	1083
23298	2	1104	2	4	0	1112
23299	1081	19	0	2	0	1102
23300	14	1095	3	7	0	1119
23301	1096	10	2	5	0	1113
23302	14	4	1075	2	0	1095
23303	1047	3	10	2	0	1062
23304	10	1059	5	4	0	1078
23305	1052	15	5	2	0	1074
23306	11	1030	3	2	0	1046
23307	11	11	1	1029	0	1052
23308	4	8	1	1058	0	1071
23309	4	2	1034	16	0	1056
23310	1020	4	15	4	0	1043
23311	15	2	1062	3	0	1082
23312	1078	5	11	5	0	1099
23313	16	2	6	1076	0	1100
23314	7	3	1	1103	0	1114
23315	2	1104	3	20	0	1129
23316	4	12	3	1152	0	1171
23317	4	4	4	1169	0	1181
23318	5	3	1154	20	0	1182
23319	1081	8	17	4	0	1110
23320	18	1128	3	4	0	1153
23321	1130	13	2	8	0	1153
23322	13	3	5	1128	0	1149
23323	11	6	1	1129	0	1147
23324	1119	3	1	25	0	1148
23325	15	1128	4	9	0	1156
23326	1105	13	5	5	0	1128
23327	18	1094	2	3	0	1117
23328	6	1083	3	1	0	1093
23329	1077	17	1	4	0	1099
23330	15	6	1	1052	0	1074
23331	5	3	1037	16	0	1061
23332	4	3	13	1020	0	1040
23333	3	4	4	1023	0	1034
23334	5	1016	2	14	0	1037
23335	2	15	2	1026	0	1045
23336	4	4	2	1027	0	1037
23337	3	3	1	1044	0	1051
23338	3	3	1	1064	0	1071
23339	2	2	1054	16	0	1074
23340	3	2	1062	9	0	1076
23341	2	3	14	1082	0	1101
23342	0	4	1070	15	0	1089
23343	4	2	1063	5	0	1074
23344	3	4	17	1063	0	1087
23345	3	1	1092	19	0	1115
23346	8	2	14	1063	0	1087
23347	2	1104	8	13	0	1127
23348	1127	15	3	7	0	1152
23349	13	6	1190	5	0	1214
23350	6	3	17	1195	0	1221
23351	5	2	1228	17	0	1252
23352	7	2	16	1306	0	1331
23353	7	1	8	1309	0	1325
23354	1277	3	0	34	0	1314
23355	23	4	3	1303	0	1333
23356	1271	2	1	24	0	1298
23357	1280	2	4	14	0	1300
23358	26	1252	2	2	0	1282
23359	1239	21	2	4	0	1266
23360	21	1219	1	2	0	1243
23361	7	1224	2	2	0	1235
23362	1188	26	6	5	0	1225
23363	20	6	1191	6	0	1223
23364	6	2	1138	1	0	1147
23365	1097	7	25	4	0	1133
23366	1097	3	5	1	0	1106
23367	19	1085	0	1	0	1105
23368	1112	16	1	3	0	1132
23369	1122	4	0	6	0	1132
23370	1100	0	1	0	0	1101
23371	20	0	1	1084	0	1105
23372	1076	0	1	22	0	1099
23373	15	1112	2	5	0	1134
23374	7	14	1	1143	0	1165
23375	1	4	1	1153	0	1159
23376	1	1137	1	21	0	1160
23377	1	17	2	1163	0	1183
23378	1150	3	1	18	0	1172
23379	1167	2	1	4	0	1174
23380	21	1122	1	3	0	1147
23381	5	1140	4	5	0	1154
23382	1138	19	2	5	0	1164
23383	16	3	1129	2	0	1150
23384	6	2	1128	3	0	1139
23385	5	0	20	1132	0	1157
23386	5	2	3	1146	0	1156
23387	4	4	1129	20	0	1157
23388	5	1106	16	5	0	1132
23389	4	17	3	1073	0	1097
23390	1	6	1139	17	0	1163
23391	5	2	16	1141	0	1164
23392	2	4	4	1137	0	1147
23393	2	1181	1	20	0	1204
23394	2	16	2	1174	0	1194
23395	2	5	3	1185	0	1195
23396	5	1	3	1194	0	1203
23397	1181	1	0	21	0	1203
23398	21	1	2	1158	0	1182
23399	6	1169	1	12	0	1188
23400	1152	17	1	9	0	1179
23401	21	4	1126	1	0	1152
23402	8	0	1118	0	0	1126
23403	1118	2	20	4	0	1144
23404	21	1	5	1119	0	1146
23405	4	2	1124	20	0	1150
23406	2	3	16	1127	0	1148
23407	2	4	3	1153	0	1162
23408	1136	1	3	24	0	1164
23409	1149	0	2	9	0	1160
23410	22	1137	2	2	0	1163
23411	8	18	0	1109	0	1135
23412	1	8	1100	13	0	1122
23413	5	1116	14	5	0	1140
23414	1102	12	6	6	0	1126
23415	12	1126	2	2	0	1142
23416	1112	11	1	4	0	1128
23417	13	5	1113	4	0	1135
23418	1097	3	16	2	0	1118
23419	1155	2	5	4	0	1166
23420	19	2	1183	3	0	1207
23421	5	3	17	1151	0	1176
23422	2	1144	6	20	0	1172
23423	1	1186	3	15	0	1205
23424	4	1215	2	6	0	1227
23425	1	29	1	1186	0	1217
23426	2	11	1197	20	0	1230
23427	7	2	15	1193	0	1217
23428	3	1	6	1223	0	1233
23429	3	3	1216	22	0	1244
23430	3	1216	16	9	0	1244
23431	6	15	7	1211	0	1239
23432	1219	8	5	16	0	1248
23433	20	3	3	1232	0	1258
23434	8	1	2	1231	0	1242
23435	4	1233	3	19	0	1259
23436	1237	16	3	10	0	1266
23437	21	6	3	1274	0	1304
23438	10	4	1256	16	0	1286
23439	4	1241	16	10	0	1271
23440	1243	16	7	6	0	1272
23441	17	8	1269	5	0	1299
23442	1258	3	17	4	0	1282
23443	19	6	7	1259	0	1291
23444	8	1281	3	16	0	1308
23445	1271	17	0	8	0	1296
23446	1285	11	5	4	0	1305
23447	18	1342	3	3	0	1366
23448	8	16	2	1324	0	1350
23449	4	3	4	1289	0	1300
23450	1250	1	3	20	0	1274
23451	14	1247	6	7	0	1274
23452	6	10	1	1170	0	1187
23453	4	1145	0	12	0	1161
23454	2	1145	4	2	0	1153
23455	7	12	1	1111	0	1131
23456	1106	2	0	16	0	1124
23457	8	1116	1	4	0	1129
23458	3	9	1	1137	0	1150
23459	2	3	0	1149	0	1154
23460	1	4	1144	9	0	1158
23461	1	3	1120	4	0	1128
23462	1	1138	9	5	0	1153
23463	2	10	1122	2	0	1136
23464	2	8	9	1109	0	1128
23465	4	4	1160	10	0	1178
23466	4	3	11	1175	0	1193
23467	2	2	1	1209	0	1214
23468	0	0	3	1211	0	1214
23469	1176	2	2	16	0	1196
23470	14	3	0	1181	0	1198
23471	5	2	2	1182	0	1191
23472	2	1171	1	15	0	1189
23473	2	11	2	1168	0	1183
23474	1173	2	2	16	0	1193
23475	12	1192	0	4	0	1208
23476	1213	12	2	2	0	1229
23477	22	4	1199	4	0	1229
23478	4	6	1226	2	0	1238
23479	4	3	14	1258	0	1279
23480	1	3	3	1288	0	1295
23481	0	1275	3	23	0	1301
23482	8	16	3	1234	0	1261
23483	1279	4	2	21	0	1306
23484	1286	2	0	10	0	1298
23485	18	4	4	1293	0	1319
23486	5	2	1392	18	0	1417
23487	4	2	17	1413	0	1436
23488	2	3	2	1466	0	1473
23489	4	1	0	1473	0	1478
23490	0	1	2	1449	0	1452
23491	4	1	3	1429	0	1437
23492	3	1417	1	18	0	1439
23493	1399	17	1	9	0	1426
23494	1440	4	6	1	0	1451
23495	1455	4	1	5	0	1465
23496	24	1463	2	4	0	1493
23497	1459	22	2	6	0	1489
23498	21	1461	2	4	0	1488
23499	4	19	1468	7	0	1498
23500	5	6	20	1455	0	1486
23501	5	3	1495	23	0	1526
23502	2	1502	20	8	0	1532
23503	1508	23	4	5	0	1540
23504	22	4	1546	6	0	1578
23505	5	4	1638	5	0	1652
23506	6	1668	23	2	0	1699
23507	3	25	8	1716	0	1752
23508	2	3	1841	28	0	1874
23509	5	6	26	1843	0	1880
23510	5	1	5	2064	0	2075
23511	2	2	4	2211	0	2219
23512	2318	2	1	42	0	2363
23513	2355	1	1	14	0	2371
23514	45	0	2	2340	0	2387
23515	2356	3	1	37	0	2397
23516	40	1	2318	7	0	2366
23517	8	0	2287	10	0	2305
23518	7	2	2299	6	0	2314
23519	6	2	2335	6	0	2349
23520	8	2313	37	7	0	2365
23521	14	35	15	2288	0	2352
23522	12	5	2316	28	0	2361
23523	2237	5	34	12	0	2288
23524	2336	4	9	11	0	2360
23525	34	2328	15	6	0	2383
23526	2320	27	15	6	0	2368
23527	35	8	12	2317	0	2372
23528	12	10	2374	28	0	2424
23529	14	7	31	2288	0	2340
23530	7	2394	13	30	0	2444
23531	2336	29	16	11	0	2392
23532	2394	8	9	8	0	2419
23533	42	2385	4	9	0	2440
23534	2409	37	8	7	0	2461
23535	2429	8	7	6	0	2450
23536	39	2404	7	11	0	2461
23537	13	33	8	2375	0	2429
23538	12	2370	7	30	0	2419
23539	2398	37	6	10	0	2451
23540	41	12	6	2383	0	2442
23541	2355	9	6	35	0	2405
23542	45	12	2	2349	0	2408
23543	21	7	2313	36	0	2377
23544	2285	7	33	13	0	2338
23545	43	7	2319	13	0	2382
23546	10	6	33	2314	0	2363
23547	16	10	2258	40	0	2324
23548	18	6	35	2251	0	2310
23549	12	6	2251	44	0	2313
23550	2232	3	36	14	0	2285
23551	32	2248	13	16	0	2309
23552	2260	28	14	9	0	2311
23553	45	6	11	2258	0	2320
23554	2251	4	15	36	0	2306
23555	35	2240	8	16	0	2299
23556	11	2235	15	13	0	2274
23557	12	2313	14	14	0	2353
23558	2306	34	11	10	0	2361
23559	40	15	7	2300	0	2362
23560	12	17	4	2329	0	2362
23561	18	8	2280	39	0	2345
23562	15	8	2271	19	0	2313
23563	21	4	33	2324	0	2382
23564	8	13	2339	39	0	2399
23565	11	2328	38	10	0	2387
23566	2328	35	5	20	0	2388
23567	36	8	2335	12	0	2391
23568	13	11	2317	17	0	2358
23569	12	8	38	2315	0	2373
23570	2372	5	19	32	0	2428
23571	38	7	20	2368	0	2433
23572	2365	5	14	43	0	2427
23573	35	13	16	2356	0	2420
23574	20	7	2397	33	0	2457
23575	13	2370	38	19	0	2440
23576	17	26	2393	15	0	2451
23577	8	2377	42	19	0	2446
23578	14	33	11	2349	0	2407
23579	2334	8	13	40	0	2395
23580	35	8	2331	15	0	2389
23581	16	7	27	2324	0	2374
23582	13	5	13	2365	0	2396
23583	2371	5	17	39	0	2432
23584	32	8	16	2347	0	2403
23585	15	2357	13	35	0	2420
23586	2280	31	12	16	0	2339
23587	40	10	2262	13	0	2325
23588	2199	9	34	14	0	2256
23589	33	2261	17	7	0	2318
23590	18	32	8	2237	0	2295
23591	11	2278	9	34	0	2332
23592	2280	30	5	19	0	2334
23593	35	15	2258	16	0	2324
23594	2221	14	23	12	0	2270
23595	36	2285	8	11	0	2340
23596	22	25	13	2296	0	2356
23597	2312	11	6	35	0	2364
23598	2329	10	9	14	0	2362
23599	35	12	3	2327	0	2377
23600	13	16	10	2325	0	2364
23601	22	2295	7	33	0	2357
23602	14	31	15	2329	0	2389
23603	13	2637	8	37	0	2695
23604	9	2735	9	18	0	2771
23605	22	58	4	2582	0	2666
23606	12	2657	10	48	0	2727
23607	17	36	2697	14	0	2764
23608	19	14	2733	20	0	2786
23609	8	2793	46	16	0	2863
23610	7	45	2760	11	0	2823
23611	9	13	2698	5	0	2725
23612	1	8	2545	7	0	2561
23613	0	2491	50	10	0	2551
23614	2418	42	28	6	0	2494
23615	32	2423	11	3	0	2469
23616	14	37	2425	0	0	2476
23617	11	14	40	2393	0	2458
23618	2401	10	12	42	0	2465
23619	39	6	2374	11	0	2430
23620	15	5	42	2364	0	2426
23621	4	6	2375	38	0	2423
23622	9	2	40	2343	0	2394
23623	2332	5	13	48	0	2398
23624	37	4	2352	13	0	2406
23625	12	2367	40	10	0	2429
23626	13	40	16	2341	0	2410
23627	2405	10	7	39	0	2461
23628	42	12	2349	11	0	2414
23629	15	9	45	2255	0	2324
23630	8	2332	18	40	0	2398
23631	2350	44	12	16	0	2422
23632	2375	12	13	10	0	2410
23633	46	5	14	2335	0	2400
23634	15	2336	7	43	0	2401
23635	12	2426	6	12	0	2456
23636	2449	49	9	9	0	2516
23637	47	24	6	2408	0	2485
23638	12	2431	9	49	0	2501
23639	2435	45	2	18	0	2500
23640	49	15	9	2447	0	2520
23641	16	7	10	2494	0	2527
23642	5	9	2364	60	0	2438
23643	9	2395	42	22	0	2468
23644	12	2494	12	16	0	2534
23645	9	47	13	2478	0	2547
23646	2465	21	10	46	0	2542
23647	44	2448	7	17	0	2516
23648	2448	47	4	13	0	2512
23649	44	2436	10	12	0	2502
23650	21	49	8	2435	0	2513
23651	2430	21	3	50	0	2504
23652	49	16	4	2432	0	2501
23653	25	5	2406	49	0	2485
23654	17	5	46	2358	0	2426
23655	7	2387	13	49	0	2456
23656	2366	46	9	24	0	2445
23657	42	2357	9	11	0	2419
23658	19	49	5	2315	0	2388
23659	14	25	5	2345	0	2389
23660	15	22	2273	53	0	2363
23661	16	11	2278	21	0	2326
23662	9	8	48	2276	0	2341
23663	8	15	2252	51	0	2326
23664	10	2227	50	20	0	2307
23665	2191	51	19	12	0	2273
23666	46	26	2192	19	0	2283
23667	2169	14	50	19	0	2252
23668	2223	19	22	11	0	2275
23669	2213	21	15	9	0	2258
23670	2205	12	12	15	0	2244
23671	59	17	12	2150	0	2238
23672	26	12	17	2126	0	2181
23673	22	2120	11	60	0	2213
23674	2072	44	18	28	0	2162
23675	48	20	2037	21	0	2126
23676	25	18	41	2013	0	2097
23677	19	17	21	2031	0	2088
23678	19	16	1977	52	0	2064
23679	14	2006	47	28	0	2095
23680	13	44	23	1976	0	2056
23681	19	21	15	2049	0	2104
23682	1994	12	17	60	0	2083
23683	45	1970	19	33	0	2067
23684	23	43	9	1959	0	2034
23685	15	1932	16	52	0	2015
23686	16	45	16	1985	0	2062
23687	1954	25	9	53	0	2041
23688	1988	15	10	30	0	2043
23689	64	13	8	1942	0	2027
23690	1943	9	10	52	0	2014
23691	1947	13	6	32	0	1998
23692	66	1902	11	23	0	2002
23693	29	46	7	1886	0	1968
23694	22	1874	7	49	0	1952
23695	23	46	5	1890	0	1964
23696	1876	19	7	50	0	1952
23697	45	23	4	1856	0	1928
23698	26	16	3	1893	0	1938
23699	26	13	1798	54	0	1891
23700	18	1745	36	27	0	1826
23701	18	1807	11	28	0	1864
23702	1739	45	10	32	0	1826
23703	35	27	3	1364	0	1429
23704	1257	5	6	27	0	1295
23705	28	1206	4	18	0	1256
23706	12	1115	5	12	0	1144
23707	7	1127	6	11	0	1151
23708	936	26	17	9	0	988
23709	14	897	5	5	0	921
23710	805	19	12	5	0	841
23711	770	2	0	5	0	777
23712	821	3	1	2	0	827
23713	16	4	1	866	0	887
23714	3	3	2	883	0	891
23715	2	3	0	892	0	897
23716	6	2	1	879	0	888
23717	869	3	0	17	0	889
23718	13	871	1	4	0	889
23719	5	9	0	866	0	880
23720	888	4	1	13	0	906
23721	14	1	1	883	0	899
23722	3	4	0	889	0	896
23723	886	2	1	17	0	906
23724	11	3	876	5	0	895
23725	7	2	9	866	0	884
23726	3	4	899	12	0	918
23727	5	1	8	878	0	892
23728	5	3	3	884	0	895
23729	862	1	2	18	0	883
23730	14	838	2	6	0	860
23731	3	833	2	2	0	840
23732	815	9	1	4	0	829
23733	11	831	1	4	0	847
23734	841	5	2	4	0	852
23735	6	3	826	2	0	837
23736	751	2	5	3	0	761
23737	773	0	0	2	0	775
23738	766	1	1	0	0	768
23739	6	0	0	761	0	767
23740	2	0	2	754	0	758
23741	0	757	1	6	0	764
23742	2	6	0	747	0	755
23743	758	0	2	5	0	765
23744	4	752	1	3	0	760
23745	1	744	0	1	0	746
23746	755	3	0	1	0	759
23747	4	1	757	1	0	763
23748	2	1	4	752	0	759
23749	2	0	770	4	0	776
23750	1	2	4	766	0	773
23751	2	767	0	5	0	774
23752	2	3	1	787	0	793
23753	783	0	0	6	0	789
23754	7	1	0	783	0	791
23755	1	0	815	5	0	821
23756	788	0	5	3	0	796
23757	6	835	1	1	0	843
23758	0	883	0	3	0	886
23759	923	6	1	1	0	931
23760	996	0	0	3	0	999
23761	8	1	1007	1	0	1017
23762	980	2	7	2	0	991
23763	11	1001	0	1	0	1013
23764	1008	8	2	3	0	1021
23765	10	1	0	989	0	1000
23766	4	955	1	8	0	968
23767	971	10	0	2	0	983
23768	10	3	976	1	0	990
23769	4	0	8	989	0	1001
23770	1007	2	0	10	0	1019
23771	7	0	998	4	0	1009
23772	1005	1	9	2	0	1017
23773	10	0	0	1005	0	1015
23774	3	2	1	1012	0	1018
23775	3	2	1018	10	0	1033
23776	3	1	10	1018	0	1032
23777	1021	0	0	15	0	1036
23778	9	1018	3	3	0	1033
23779	1028	7	1	6	0	1042
23780	1034	3	1	4	0	1042
23781	11	2	0	1033	0	1046
23782	4	1	1037	14	0	1056
23783	2	2	9	1035	0	1048
23784	1047	1	2	10	0	1060
23785	10	1049	2	2	0	1063
23786	1064	8	2	9	0	1083
23787	13	2	0	1067	0	1082
23788	8	1	2	1070	0	1081
23789	5	1	0	1074	0	1080
23790	5	1	1061	9	0	1076
23791	4	1	10	1059	0	1074
23792	3	1	1056	12	0	1072
23793	2	3	1059	3	0	1067
23794	5	1	10	1163	0	1179
23795	1	5	1160	15	0	1181
23796	1301	1	15	8	0	1325
23797	22	0	5	1354	0	1381
23798	6	1	2	1351	0	1360
23799	5	1359	2	22	0	1388
23800	1381	19	1	10	0	1411
23801	1418	7	2	4	0	1431
23802	27	1439	1	5	0	1472
23803	11	19	1	1457	0	1488
23804	4	4	1449	27	0	1484
23805	1436	3	22	9	0	1470
23806	1480	2	5	9	0	1496
23807	32	2	3	1414	0	1451
23808	12	6	1372	21	0	1411
23809	5	1379	19	9	0	1412
23810	1363	19	7	5	0	1394
23811	23	10	1366	3	0	1402
23812	9	1323	19	5	0	1356
23813	1274	17	6	9	0	1306
23814	1286	8	2	3	0	1299
23815	25	5	4	1263	0	1297
23816	14	1285	0	18	0	1317
23817	7	21	4	1314	0	1346
23818	4	9	1	1339	0	1353
23819	7	3	5	1306	0	1321
23820	5	3	5	1317	0	1330
23821	6	5	1297	27	0	1335
23822	9	4	21	1316	0	1350
23823	6	5	7	1327	0	1345
23824	2	4	1297	31	0	1334
23825	4	1289	22	13	0	1328
23826	1279	19	7	12	0	1317
23827	1290	9	4	15	0	1318
23828	28	4	3	1286	0	1321
23829	1293	6	2	23	0	1324
23830	28	3	4	1310	0	1345
23831	11	8	1322	23	0	1364
23832	8	4	1327	12	0	1351
23833	6	1295	25	10	0	1336
23834	1278	20	9	8	0	1315
23835	26	5	1374	9	0	1414
23836	13	5	20	1360	0	1398
23837	7	3	8	1468	0	1486
23838	7	4	8	1504	0	1523
23839	3	4	4	1505	0	1516
23840	12	3	4	1501	0	1520
23841	4	6	1479	35	0	1524
23842	6	5	21	1485	0	1517
23843	1461	1	11	34	0	1507
23844	26	1480	6	18	0	1530
23845	1473	22	5	16	0	1516
23846	22	1484	5	12	0	1523
23847	1488	22	7	11	0	1528
23848	1518	14	5	8	0	1545
23849	37	4	1	1509	0	1551
23850	16	4	5	1517	0	1542
23851	1491	5	7	41	0	1544
23852	1474	2	7	20	0	1503
23853	1483	6	4	16	0	1509
23854	32	1422	3	10	0	1467
23855	15	1435	4	11	0	1465
23856	12	28	1428	8	0	1476
23857	16	16	21	1382	0	1435
23858	7	5	1374	34	0	1420
23859	7	1337	18	20	0	1382
23860	9	19	12	1274	0	1314
23861	10	10	3	1270	0	1293
23862	10	4	4	1281	0	1299
23863	1251	7	5	29	0	1292
23864	1262	5	3	16	0	1286
23865	26	1261	6	9	0	1302
23866	20	20	1	1264	0	1305
23867	11	11	1291	20	0	1333
23868	15	8	1245	11	0	1279
23869	1268	3	20	15	0	1306
23870	1274	5	11	14	0	1304
23871	28	5	6	1269	0	1308
23872	1270	5	3	25	0	1303
23873	28	2	1243	13	0	1286
23874	14	1238	22	7	0	1281
23875	8	23	11	1238	0	1280
23876	7	13	1257	20	0	1297
23877	4	4	23	1277	0	1308
23878	7	4	12	1279	0	1302
23879	9	4	1275	29	0	1317
23880	1254	7	19	22	0	1302
23881	1289	4	7	21	0	1321
23882	26	1334	7	22	0	1389
23883	1360	25	6	15	0	1406
23884	1414	8	6	13	0	1441
23885	41	7	1390	4	0	1442
23886	1396	8	26	11	0	1441
23887	37	1450	13	9	0	1509
23888	1459	33	14	7	0	1513
23889	1514	12	7	8	0	1541
23890	1560	6	5	5	0	1576
23891	1529	8	3	8	0	1548
23892	1545	1	5	12	0	1563
23893	53	1491	3	10	0	1557
23894	1421	28	5	11	0	1465
23895	41	1389	4	5	0	1439
23896	17	1209	4	6	0	1236
23897	8	1257	1	4	0	1270
23898	1226	29	5	5	0	1265
23899	1219	12	3	3	0	1237
23900	33	6	1200	2	0	1241
23901	1242	5	24	5	0	1276
23902	1245	5	5	3	0	1258
23903	35	6	1223	5	0	1269
23904	15	2	26	1232	0	1275
23905	18	0	7	1205	0	1230
23906	11	2	6	1272	0	1291
23907	8	3	3	1285	0	1299
23908	7	3	1	1283	0	1294
23909	7	3	1235	35	0	1280
23910	4	1219	26	17	0	1266
23911	1214	26	8	9	0	1257
23912	31	1206	6	9	0	1252
23913	1210	29	6	5	0	1250
23914	1221	11	0	6	0	1238
23915	36	6	1196	3	0	1241
23916	13	6	26	1125	0	1170
23917	10	1158	6	20	0	1194
23918	1169	28	11	5	0	1213
23919	1184	7	7	7	0	1205
23920	1194	5	2	5	0	1206
23921	31	1189	3	3	0	1226
23922	1200	22	2	4	0	1228
23923	1219	6	4	3	0	1232
23924	1220	5	3	2	0	1230
23925	40	5	2	1166	0	1213
23926	18	3	0	1195	0	1216
23927	10	0	0	1208	0	1218
23928	1177	4	2	31	0	1214
23929	23	1173	3	12	0	1211
23930	1177	25	2	4	0	1208
23931	1159	9	2	7	0	1177
23932	1148	2	2	4	0	1156
23933	1145	7	2	5	0	1159
23934	41	1116	1	3	0	1161
23935	1021	24	1	3	0	1049
23936	34	985	2	0	0	1021
23937	10	957	0	2	0	969
23938	946	25	0	4	0	975
23939	30	935	0	0	0	965
23940	11	964	2	1	0	978
23941	961	26	3	0	0	990
23942	970	11	1	3	0	985
23943	32	8	0	948	0	988
23944	14	3	0	970	0	987
23945	972	4	0	25	0	1001
23946	1016	4	1	11	0	1032
23947	995	3	1	6	0	1005
23948	35	3	966	3	0	1007
23949	994	1	22	4	0	1021
23950	31	5	4	998	0	1038
23951	11	1	4	1025	0	1041
23952	10	2	1	1028	0	1041
23953	8	2	3	1031	0	1044
23954	8	3	988	32	0	1031
23955	8	5	999	8	0	1020
23956	10	2	25	999	0	1036
23957	6	5	994	24	0	1029
23958	9	5	993	8	0	1015
23959	10	4	28	1015	0	1057
23960	6	5	9	1040	0	1060
23961	8	4	6	1054	0	1072
23962	10	2	3	1042	0	1057
23963	1042	3	4	32	0	1081
23964	1096	1	4	17	0	1118
23965	29	2	4	1074	0	1109
23966	16	3	2	1093	0	1114
23967	8	3	1	1073	0	1085
23968	9	2	0	1085	0	1096
23969	5	2	4	1079	0	1090
23970	14	1053	1	28	0	1096
23971	1059	22	2	13	0	1096
23972	26	1061	1	12	0	1100
23973	1059	23	3	8	0	1093
23974	1076	8	2	6	0	1092
23975	1078	3	4	6	0	1091
23976	31	5	3	1034	0	1073
23977	1034	6	0	27	0	1067
23978	33	6	2	1013	0	1054
23979	16	3	5	1021	0	1045
23980	1018	2	2	27	0	1049
23981	28	1003	1	12	0	1044
23982	8	957	2	13	0	980
23983	934	16	6	8	0	964
23984	21	4	913	4	0	942
23985	871	6	14	7	0	898
23986	20	2	1	884	0	907
23987	9	816	3	14	0	842
23988	11	837	1	5	0	854
23989	836	10	0	7	0	853
23990	9	5	0	850	0	864
23991	4	861	0	10	0	875
23992	852	8	3	2	0	865
23993	863	3	0	1	0	867
23994	853	2	0	2	0	857
23995	860	3	0	1	0	864
23996	9	830	1	1	0	841
23997	4	816	1	5	0	826
23998	833	2	0	5	0	840
23999	873	1	0	3	0	877
24000	5	1	844	2	0	852
24001	1	827	3	0	0	831
24002	829	3	4	0	0	836
24003	867	0	0	2	0	869
24004	3	0	875	0	0	878
24005	902	0	3	2	0	907
24006	2	0	923	0	0	925
24007	0	0	980	0	0	980
24008	2	0	7	959	0	968
24009	0	980	1	4	0	985
24010	1037	4	0	2	0	1043
24011	4	1	0	1037	0	1042
24012	3	0	0	1051	0	1054
24013	2	0	0	1057	0	1059
24014	1058	1	0	9	0	1068
24015	7	1	0	1048	0	1056
24016	3	0	0	1069	0	1072
24017	0	0	1071	9	0	1080
24018	1087	0	6	7	0	1100
24019	1113	0	2	1	0	1116
24020	13	1	1094	1	0	1109
24021	1074	0	11	3	0	1088
24022	11	0	3	1079	0	1093
24023	3	1083	1	8	0	1095
24024	2	11	0	1091	0	1104
24025	1085	2	1	11	0	1099
24026	12	1086	1	3	0	1102
24027	4	10	0	1095	0	1109
24028	0	2	1	1113	0	1116
24029	1	1	0	1111	0	1113
24030	4	0	0	1086	0	1090
24031	2	1142	0	9	0	1153
24032	1151	13	1	3	0	1168
24033	1162	2	1	5	0	1170
24034	18	1171	1	3	0	1193
24035	1270	18	0	4	0	1292
24036	1309	3	1	2	0	1315
24037	1294	2	0	0	0	1296
24038	25	0	1254	1	0	1280
24039	6	1	20	1260	0	1287
24040	4	1	1240	22	0	1267
24041	1241	2	19	5	0	1267
24042	28	1246	4	0	0	1278
24043	1236	20	1	2	0	1259
24044	21	1230	5	4	0	1260
24045	5	23	3	1202	0	1233
24046	9	3	3	1204	0	1219
24047	5	3	1196	23	0	1227
24048	5	1208	21	5	0	1239
24049	1187	24	7	3	0	1221
24050	24	6	1183	4	0	1217
24051	1181	2	20	8	0	1211
24052	23	1	8	1187	0	1219
24053	6	6	1192	22	0	1226
24054	6	1191	23	8	0	1228
24055	4	24	5	1187	0	1220
24056	5	7	1190	24	0	1226
24057	6	4	1197	9	0	1216
24058	6	1179	30	4	0	1219
24059	4	28	9	1168	0	1209
24060	6	8	6	1158	0	1178
24061	5	1155	6	30	0	1196
24062	1161	23	5	7	0	1196
24063	28	11	4	1138	0	1181
24064	8	1120	5	29	0	1162
24065	1136	26	2	11	0	1175
24066	1137	10	2	9	0	1158
24067	1153	3	3	8	0	1167
24068	34	1125	2	9	0	1170
24069	1141	26	2	13	0	1182
24070	1145	12	3	9	0	1169
24071	36	2	2	1129	0	1169
24072	1139	1	3	28	0	1171
24073	32	7	2	1127	0	1168
24074	15	7	1115	26	0	1163
24075	16	4	1132	7	0	1159
24076	10	4	28	1138	0	1180
24077	11	4	1142	30	0	1187
24078	1141	3	25	17	0	1186
24079	30	4	10	1144	0	1188
24080	13	6	6	1148	0	1173
24081	9	6	1118	34	0	1167
24082	6	1101	30	14	0	1151
24083	12	1127	9	7	0	1155
24084	7	31	5	1096	0	1139
24085	6	9	5	1115	0	1135
24086	9	6	1077	34	0	1126
24087	9	8	1084	9	0	1110
24088	7	10	32	1081	0	1130
24089	12	6	1054	29	0	1101
24090	1028	8	26	12	0	1074
24091	33	4	10	1024	0	1071
24092	1031	5	10	33	0	1079
24093	29	4	9	1029	0	1071
24094	11	7	9	1052	0	1079
24095	8	5	1027	38	0	1078
24096	9	1045	28	13	0	1095
24097	14	24	13	1029	0	1080
24098	9	15	1014	31	0	1069
24099	7	965	27	18	0	1017
24100	6	25	13	995	0	1039
24101	1008	11	6	28	0	1053
24102	30	4	997	19	0	1050
24103	941	5	35	9	0	990
24104	30	6	942	4	0	982
24105	860	5	33	8	0	906
24106	28	861	10	9	0	908
24107	11	823	8	4	0	846
24108	8	34	7	770	0	819
24109	6	775	3	26	0	810
24110	761	24	3	19	0	807
24111	27	7	7	762	0	803
24112	13	6	3	776	0	798
24113	3	4	2	786	0	795
24114	3	6	746	31	0	786
24115	6	7	25	747	0	785
24116	10	2	728	29	0	769
24117	5	708	28	13	0	754
24118	661	20	6	4	0	691
24119	22	671	3	10	0	706
24120	701	16	6	7	0	730
24121	704	5	10	5	0	724
24122	708	7	1	7	0	723
24123	687	3	5	7	0	702
24124	25	3	665	6	0	699
24125	6	2	19	669	0	696
24126	3	2	10	655	0	670
24127	5	1	6	680	0	692
24128	623	5	4	23	0	655
24129	645	1	6	7	0	659
24130	20	660	3	10	0	693
24131	4	16	627	7	0	654
24132	8	4	624	7	0	643
24133	3	621	20	8	0	652
24134	4	610	4	5	0	623
24135	11	10	11	486	0	518
24136	2	3	0	481	0	486
24137	480	1	1	12	0	494
24138	7	481	3	5	0	496
24139	5	6	1	496	0	508
24140	0	3	513	10	0	526
24141	3	0	8	533	0	544
24142	2	0	6	541	0	549
24143	2	0	0	555	0	557
24144	1	1	1	545	0	548
24145	2	0	529	14	0	545
24146	0	517	9	6	0	532
24147	0	528	2	0	0	530
24148	505	11	0	1	0	517
24149	8	500	1	2	0	511
24150	2	523	1	1	0	527
24151	0	10	0	525	0	535
24152	2	1	1	530	0	534
24153	1	0	1	529	0	531
24154	1	0	518	11	0	530
24155	1	514	11	2	0	528
24156	3	9	3	509	0	524
24157	2	521	0	7	0	530
24158	513	8	1	1	0	523
24159	8	513	0	1	0	522
24160	513	8	2	3	0	526
24161	11	3	505	0	0	519
24162	511	0	10	3	0	524
24163	9	0	2	535	0	546
24164	1	2	534	10	0	547
24165	526	1	8	4	0	539
24166	531	1	3	3	0	538
24167	534	2	2	0	0	538
24168	10	2	1	520	0	533
24169	3	2	513	8	0	526
24170	525	1	7	2	0	535
24171	8	4	1	540	0	553
24172	3	1	0	548	0	552
24173	3	1	572	10	0	586
24174	3	571	7	1	0	582
24175	4	8	2	561	0	575
24176	1	566	1	7	0	575
24177	552	7	0	5	0	564
24178	559	1	2	1	0	563
24179	10	1	1	552	0	564
24180	560	0	1	10	0	571
24181	9	565	1	2	0	577
24182	562	7	1	1	0	571
24183	8	577	1	1	0	587
24184	3	8	1	583	0	595
24185	2	2	0	582	0	586
24186	4	578	0	7	0	589
24187	4	12	0	579	0	595
24188	2	2	588	7	0	599
24189	1	578	9	3	0	591
24190	554	7	0	3	0	564
24191	7	570	0	2	0	579
24192	1	7	0	570	0	578
24193	1	0	567	7	0	575
24194	1	1	6	573	0	581
24195	2	0	0	574	0	576
24196	553	2	0	6	0	561
24197	7	0	557	1	0	565
24198	0	563	8	0	0	571
24199	1	7	590	2	0	600
24200	0	0	590	2	0	592
24201	0	0	573	1	0	574
24202	4	6	2	592	0	604
24203	609	0	5	3	0	617
24204	3	601	0	1	0	605
24205	616	2	1	1	0	620
24206	637	1	1	0	0	639
24207	3	1	0	623	0	627
24208	1	638	0	3	0	642
24209	632	2	0	1	0	635
24210	2	630	1	0	0	633
24211	2	3	0	638	0	643
24212	2	0	0	659	0	661
24213	0	657	0	3	0	660
24214	4	2	1	662	0	669
24215	1	0	659	2	0	662
24216	0	1	644	3	0	648
24217	1	2	2	657	0	662
24218	1	1	0	659	0	661
24219	2	1	633	2	0	638
24220	1	1	619	1	0	622
24221	594	0	2	3	0	599
24222	3	614	1	1	0	619
24223	1	660	0	4	0	665
24224	2	2	2	655	0	661
24225	2	0	2	657	0	661
24226	2	1	0	663	0	666
24227	2	0	659	3	0	664
24228	0	1	640	1	0	642
24229	1	0	4	666	0	671
24230	2	0	662	2	0	666
24231	0	641	3	2	0	646
24232	647	4	0	2	0	653
24233	4	0	636	1	0	641
24234	0	3	644	0	0	647
24235	2	1	3	659	0	665
24236	0	1	731	3	0	735
24237	0	747	6	1	0	754
24238	1	3	2	766	0	772
24239	1	0	772	4	0	777
24240	1	752	4	0	0	757
24241	736	4	0	0	0	740
24242	4	0	1	727	0	732
24243	2	0	1	733	0	736
24244	736	0	0	3	0	739
24245	2	736	1	0	0	739
24246	741	3	0	0	0	744
24247	751	1	0	1	0	753
24248	756	0	1	1	0	758
24249	3	1	0	749	0	753
24250	738	1	0	2	0	741
24251	2	720	1	2	0	725
24252	0	742	1	1	0	744
24253	758	2	1	1	0	762
24254	3	1	1	762	0	767
24255	1	1	0	764	0	766
24256	3	0	1	762	0	766
24257	1	0	748	5	0	754
24258	0	739	3	3	0	745
24259	2	3	0	759	0	764
24260	763	1	1	4	0	769
24261	6	1	0	753	0	760
24262	2	1	747	6	0	756
24263	2	734	4	2	0	742
24264	739	4	0	3	0	746
24265	738	0	2	1	0	741
24266	739	3	1	0	0	743
24267	7	2	1	746	0	756
24268	4	0	748	8	0	760
24269	2	1	801	2	0	806
24270	0	808	8	4	0	820
24271	1	5	3	800	0	809
24272	2	3	2	815	0	822
24273	770	2	0	11	0	783
24274	11	1	0	776	0	788
24275	804	0	0	9	0	813
24276	9	2	790	3	0	804
24277	2	1	812	2	0	817
24278	1	2	10	802	0	815
24279	1	2	2	808	0	813
24280	1	0	1	830	0	832
24281	839	0	1	11	0	851
24282	878	0	1	5	0	884
24283	12	0	2	877	0	891
24284	3	0	866	11	0	880
24285	1	1	886	1	0	889
24286	1	0	12	891	0	904
24287	892	0	3	13	0	908
24288	12	0	2	886	0	900
24289	3	1	0	896	0	900
24290	3	2	888	12	0	905
24291	0	2	891	4	0	897
24292	875	0	12	5	0	892
24293	10	0	891	3	0	904
24294	2	0	11	870	0	883
24295	6	0	1	891	0	898
24296	886	0	3	12	0	901
24297	11	875	3	3	0	892
24298	859	9	1	5	0	874
24299	11	826	2	6	0	845
24300	822	11	5	4	0	842
24301	13	1	814	3	0	831
24302	764	2	10	0	0	776
24303	760	0	4	4	0	768
24304	11	0	2	755	0	768
24305	2	0	756	10	0	768
24306	1	0	10	726	0	737
24307	3	0	3	733	0	739
24308	1	720	2	12	0	735
24309	1	9	0	724	0	734
24310	0	720	1	14	0	735
24311	5	9	2	722	0	738
24312	713	2	1	16	0	732
24313	16	1	2	719	0	738
24314	1	1	720	12	0	734
24315	706	0	11	5	0	722
24316	11	0	731	6	0	748
24317	727	1	11	3	0	742
24318	751	1	1	3	0	756
24319	17	736	2	2	0	757
24320	6	766	3	0	0	775
24321	744	14	2	7	0	767
24322	773	1	3	2	0	779
24323	742	2	3	0	0	747
24324	735	0	0	7	0	742
24325	738	1	1	3	0	743
24326	17	0	2	725	0	744
24327	3	0	1	751	0	755
24328	2	1	734	17	0	754
24329	718	1	15	3	0	737
24330	23	1	1	706	0	731
24331	2	1	5	724	0	732
24332	4	1	707	16	0	728
24333	3	699	13	6	0	721
24334	5	719	2	3	0	729
24335	689	20	3	2	0	714
24336	638	3	3	2	0	646
24337	15	586	2	2	0	605
24338	8	584	1	1	0	594
24339	575	13	4	1	0	593
24340	597	2	1	2	0	602
24341	19	2	3	578	0	602
24342	4	0	0	598	0	602
24343	4	0	2	599	0	605
24344	580	1	0	19	0	600
24345	588	3	0	8	0	599
24346	17	4	0	585	0	606
24347	589	2	0	19	0	610
24348	19	2	589	2	0	612
24349	4	1	16	591	0	612
24350	8	1	584	15	0	608
24351	3	578	15	7	0	603
24352	2	14	5	578	0	599
24353	571	2	3	15	0	591
24354	13	2	4	571	0	590
24355	6	2	0	578	0	586
24356	5	4	571	15	0	595
24357	5	4	576	3	0	588
24358	2	583	10	1	0	596
24359	580	13	2	2	0	597
24360	586	2	2	0	0	590
24361	588	0	2	4	0	594
24362	588	0	3	6	0	597
24363	20	1	1	591	0	613
24364	4	1	3	597	0	605
24365	5	585	0	16	0	606
24366	592	10	4	4	0	610
24367	593	3	0	4	0	600
24368	13	2	567	5	0	587
24369	478	1	10	0	0	489
24370	12	482	2	0	0	496
24371	5	17	0	461	0	483
24372	5	476	1	10	0	492
24373	474	10	1	1	0	486
24374	11	475	0	5	0	491
24375	5	8	0	455	0	468
24376	1	1	2	466	0	470
24377	2	1	1	451	0	455
24378	2	441	2	10	0	455
24379	6	13	2	433	0	454
24380	7	1	4	428	0	440
24381	2	384	1	12	0	399
24382	2	372	2	0	0	376
24383	344	10	0	1	0	355
24384	7	348	0	2	0	357
24385	331	7	0	1	0	339
24386	9	0	329	2	0	340
24387	1	324	6	2	0	333
24388	322	7	1	2	0	332
24389	321	0	3	3	0	327
24390	7	2	314	2	0	325
24391	4	1	6	324	0	335
24392	1	2	323	9	0	335
24393	1	319	5	3	0	328
24394	312	13	3	1	0	329
24395	9	309	0	3	0	321
24396	1	9	0	307	0	317
24397	3	3	0	321	0	327
24398	3	0	313	7	0	323
24399	1	1	307	2	0	311
24400	305	2	7	3	0	317
24401	314	1	0	1	0	316
24402	310	0	1	4	0	315
24403	309	1	1	3	0	314
24404	6	305	1	3	0	315
24405	2	7	1	301	0	311
24406	2	2	1	306	0	311
24407	3	306	1	6	0	316
24408	308	8	0	2	0	318
24409	314	1	0	4	0	319
24410	9	0	302	1	0	312
24411	302	0	7	1	0	310
24412	8	0	2	305	0	315
24413	2	1	300	8	0	311
24414	3	1	7	292	0	303
24415	4	2	304	6	0	316
24416	2	1	292	0	0	295
24417	2	6	6	278	0	292
24418	0	276	1	5	0	282
24419	279	4	1	4	0	288
24420	264	1	1	1	0	267
24421	5	285	1	0	0	291
24422	2	291	1	0	0	294
24423	298	3	1	1	0	303
24424	308	0	1	0	0	309
24425	307	1	0	1	0	309
24426	305	1	1	0	0	307
24427	5	1	0	315	0	321
24428	0	0	315	7	0	322
24429	0	318	6	1	0	325
24430	312	8	0	1	0	321
24431	5	331	1	0	0	337
24432	334	6	0	0	0	340
24433	340	0	0	0	0	340
24434	7	1	348	0	0	356
24435	1	367	6	2	0	376
24436	1	7	0	369	0	377
24437	1	0	0	376	0	377
24438	1	0	0	370	0	371
24439	370	0	0	7	0	377
24440	364	0	0	1	0	365
24441	361	0	1	1	0	363
24442	6	360	1	2	0	369
24443	364	5	0	0	0	369
24444	4	366	0	1	0	371
24445	1	5	371	0	0	377
24446	1	367	5	2	0	375
24447	4	9	1	344	0	358
24448	1	0	0	349	0	350
24449	0	0	340	5	0	345
24450	1	1	5	337	0	344
24451	1	0	0	346	0	347
24452	347	1	0	5	0	353
24453	350	0	0	0	0	350
24454	358	0	0	1	0	359
24455	5	353	1	0	0	359
24456	352	6	0	2	0	360
24457	351	0	0	2	0	353
24458	5	353	0	1	0	359
24459	1	3	0	352	0	356
24460	1	0	0	359	0	360
24461	355	0	0	3	0	358
24462	5	0	347	0	0	352
24463	0	329	4	0	0	333
24464	1	3	0	330	0	334
24465	0	333	0	6	0	339
24466	0	349	1	0	0	350
24467	346	5	0	0	0	351
24468	354	0	0	1	0	355
24469	5	0	0	362	0	367
24470	0	0	1	365	0	366
24471	1	0	0	364	0	365
24472	0	0	0	362	0	362
24473	1	0	352	5	0	358
24474	1	0	342	0	0	343
24475	1	0	5	363	0	369
24476	0	1	373	5	0	379
24477	1	377	5	0	0	383
24478	384	5	1	0	0	390
24479	389	2	0	0	0	391
24480	6	0	0	391	0	397
24481	1	0	0	403	0	404
24482	2	0	0	401	0	403
24483	0	395	1	6	0	402
24484	395	6	0	2	0	403
24485	391	1	0	2	0	394
24486	6	1	389	0	0	396
24487	1	1	4	419	0	425
24488	1	0	436	4	0	441
24489	1	0	5	469	0	475
24490	0	0	1	468	0	469
24491	0	0	1	470	0	471
24492	2	0	0	473	0	475
24493	477	0	0	9	0	486
24494	493	0	1	1	0	495
24495	495	0	0	0	0	495
24496	9	0	0	496	0	505
24497	2	0	484	6	0	492
24498	476	1	7	1	0	485
24499	10	0	1	487	0	498
24500	486	0	0	7	0	493
24501	7	0	0	489	0	496
24502	1	477	0	7	0	485
24503	0	500	0	1	0	501
24504	1	10	0	500	0	511
24505	3	1	0	507	0	511
24506	2	0	0	515	0	517
24507	0	498	0	8	0	506
24508	498	7	0	2	0	507
24509	7	499	1	1	0	508
24510	2	9	494	1	0	506
24511	3	1	8	499	0	511
24512	0	516	1	10	0	527
24513	0	9	1	517	0	527
24514	2	1	0	523	0	526
24515	1	1	517	11	0	530
24516	499	0	9	3	0	511
24517	10	525	1	4	0	540
24518	532	10	4	1	0	547
24519	540	1	0	4	0	545
24520	536	1	1	3	0	541
24521	11	0	513	3	0	527
24522	4	0	10	509	0	523
24523	7	2	1	508	0	518
24524	2	0	493	12	0	507
24525	485	0	8	3	0	496
24526	9	0	495	4	0	508
24527	2	1	481	0	0	484
24528	2	487	6	1	0	496
24529	4	5	2	488	0	499
24530	2	1	490	6	0	499
24531	463	1	5	5	0	474
24532	476	2	2	1	0	481
24533	6	1	479	0	0	486
24534	2	2	4	485	0	493
24535	1	1	487	7	0	496
24536	0	489	7	3	0	499
24537	531	7	3	3	0	544
24538	537	1	1	2	0	541
24539	542	3	1	2	0	548
24540	13	0	1	534	0	548
24541	5	1	0	547	0	553
24542	2	3	527	9	0	541
24543	533	0	6	7	0	546
24544	8	0	4	539	0	551
24545	534	0	2	7	0	543
24546	8	0	531	6	0	545
24547	4	1	536	3	0	544
24548	5	0	10	532	0	547
24549	3	2	5	550	0	560
24550	3	1	541	10	0	555
24551	531	0	8	6	0	545
24552	9	0	5	533	0	547
24553	3	549	4	9	0	565
24554	552	7	0	7	0	566
24555	8	550	0	2	0	560
24556	554	8	3	0	0	565
24557	11	3	560	0	0	574
24558	2	2	547	6	0	557
24559	2	557	10	3	0	572
24560	560	6	5	3	0	574
24561	8	3	558	2	0	571
24562	550	2	8	1	0	561
24563	10	555	5	2	0	572
24564	6	5	2	570	0	583
24565	4	4	2	560	0	570
24566	2	544	1	12	0	559
24567	573	5	2	6	0	586
24568	587	3	3	3	0	596
24569	581	2	2	3	0	588
24570	14	0	585	3	0	602
24571	3	2	8	591	0	604
24572	5	0	8	589	0	602
24573	3	2	3	597	0	605
24574	2	1	594	13	0	610
24575	3	582	9	5	0	599
24576	569	5	5	5	0	584
24577	7	3	572	2	0	584
24578	561	3	5	2	0	571
24579	8	565	3	4	0	580
24580	568	8	3	1	0	580
24581	10	5	0	558	0	573
24582	575	2	4	7	0	588
24583	9	2	5	576	0	592
24584	7	3	595	7	0	612
24585	6	3	6	601	0	616
24586	4	2	598	8	0	612
24587	545	0	7	5	0	557
24588	7	550	4	2	0	563
24589	3	4	2	507	0	516
24590	3	519	1	5	0	528
24591	533	4	1	5	0	543
24592	530	2	3	2	0	537
24593	9	521	1	1	0	532
24594	524	4	0	3	0	531
24595	537	2	2	3	0	544
24596	9	1	0	526	0	536
24597	5	2	1	534	0	542
24598	548	1	0	8	0	557
24599	553	1	2	5	0	561
24600	10	2	0	550	0	562
24601	7	1	1	591	0	600
24602	598	1	3	7	0	609
24603	8	0	602	6	0	616
24604	578	2	8	1	0	589
24605	11	0	584	1	0	596
24606	2	576	7	2	0	587
24607	5	6	2	582	0	595
24608	1	4	587	7	0	599
24609	3	608	7	3	0	621
24610	604	5	2	5	0	616
24611	4	3	598	1	0	606
24612	581	1	4	1	0	587
24613	597	1	3	0	0	601
24614	605	0	0	2	0	607
24615	6	2	0	578	0	586
24616	5	586	0	5	0	596
24617	583	5	0	1	0	589
24618	5	3	591	2	0	601
24619	566	0	4	3	0	573
24620	6	1	605	1	0	613
24621	3	588	4	1	0	596
24622	5	3	2	594	0	604
24623	1	1	3	596	0	601
24624	3	586	0	8	0	597
24625	1	3	2	603	0	609
24626	2	3	600	6	0	611
24627	1	608	5	4	0	618
24628	1	7	4	602	0	614
24629	597	2	1	7	0	607
24630	627	0	3	2	0	632
24631	11	2	1	639	0	653
24632	7	645	1	5	0	658
24633	3	7	2	649	0	661
24634	3	4	0	620	0	627
24635	4	0	601	10	0	615
24636	2	607	8	4	0	621
24637	4	5	1	579	0	589
24638	1	2	569	7	0	579
24639	3	566	7	0	0	576
24640	4	4	1	575	0	584
24641	571	3	1	7	0	582
24642	6	576	0	4	0	586
24643	0	6	0	576	0	582
24644	587	1	2	6	0	596
24645	590	2	0	4	0	596
24646	588	1	1	2	0	592
24647	583	1	0	2	0	586
24648	6	1	1	579	0	587
24649	0	1	585	9	0	595
24650	4	0	7	579	0	590
24651	3	588	0	5	0	596
24652	601	7	0	2	0	610
24653	6	0	584	3	0	593
24654	567	1	5	5	0	578
24655	8	0	582	1	0	591
24656	5	2	6	575	0	588
24657	1	3	593	7	0	604
24658	3	0	7	583	0	593
24659	2	4	584	5	0	595
24660	2	0	5	587	0	594
24661	585	0	2	7	0	594
24662	9	605	2	1	0	617
24663	4	5	1	612	0	622
24664	2	0	2	613	0	617
24665	2	0	625	8	0	635
24666	3	2	607	2	0	614
24667	599	0	5	4	0	608
24668	6	605	1	2	0	614
24669	597	6	1	2	0	606
24670	614	0	2	3	0	619
24671	8	1	1	614	0	624
24672	2	623	3	4	0	632
24673	642	5	2	2	0	651
24674	655	1	1	1	0	658
24675	661	0	1	8	0	670
24676	666	1	2	1	0	670
24677	654	1	1	5	0	661
24678	8	1	642	2	0	653
24679	647	1	6	0	0	654
24680	7	0	661	2	0	670
24681	4	0	6	661	0	671
24682	2	1	3	672	0	678
24683	2	1	659	7	0	669
24684	645	0	7	3	0	655
24685	8	1	1	673	0	683
24686	1	0	2	676	0	679
24687	2	1	2	676	0	681
24688	3	1	0	667	0	671
24689	3	2	1	676	0	682
24690	3	0	683	7	0	693
24691	2	0	6	678	0	686
24692	3	1	689	8	0	701
24693	2	1	695	2	0	700
24694	693	0	8	1	0	702
24695	730	1	2	3	0	736
24696	799	1	2	2	0	804
24697	13	0	818	3	0	834
24698	3	1	816	2	0	822
24699	3	1	839	3	0	846
24700	3	854	11	0	0	868
24701	8	17	8	834	0	867
24702	879	0	5	13	0	897
24703	13	0	2	947	0	962
24704	2	953	1	14	0	970
24705	968	12	2	5	0	987
24706	16	3	1	964	0	984
24707	3	982	2	14	0	1001
24708	5	12	1	993	0	1011
24709	3	2	2	991	0	998
24710	968	1	5	16	0	990
24711	16	1	3	972	0	992
24712	6	2	972	15	0	995
24713	3	1	12	967	0	983
24714	3	942	3	14	0	962
24715	3	963	2	8	0	976
24716	1	13	2	941	0	957
24717	3	4	2	942	0	951
24718	1	922	2	18	0	943
24719	3	929	1	6	0	939
24720	3	947	2	4	0	956
24721	4	19	2	893	0	918
24722	4	938	4	14	0	960
24723	941	12	1	5	0	959
24724	12	9	945	3	0	969
24725	6	4	15	942	0	967
24726	0	939	4	17	0	960
24727	937	16	2	5	0	960
24728	13	6	937	6	0	962
24729	4	942	12	10	0	968
24730	919	17	2	4	0	942
24731	11	905	1	8	0	925
24732	3	911	5	0	0	919
24733	3	13	2	907	0	925
24734	1	915	4	13	0	933
24735	910	16	1	5	0	932
24736	14	5	0	903	0	922
24737	4	1	898	14	0	917
24738	2	8	892	2	0	904
24739	3	4	16	899	0	922
24740	4	5	908	12	0	929
24741	1	4	12	916	0	933
24742	902	7	4	13	0	926
24743	15	5	904	6	0	930
24744	6	3	10	896	0	915
24745	2	885	3	16	0	906
24746	3	15	3	911	0	932
24747	5	8	3	904	0	920
24748	6	912	4	15	0	937
24749	1	14	4	914	0	933
24750	3	4	4	918	0	929
24751	1	3	905	21	0	930
24752	5	892	11	4	0	912
24753	892	13	6	7	0	918
24754	10	10	1	903	0	924
24755	8	1	908	14	0	931
24756	0	6	10	904	0	920
24757	2	9	892	12	0	915
24758	867	5	13	10	0	895
24759	11	897	3	12	0	923
24760	7	15	3	896	0	921
24761	3	5	3	918	0	929
24762	889	2	5	15	0	911
24763	11	3	5	889	0	908
24764	2	3	883	16	0	904
24765	4	6	9	852	0	871
24766	3	843	6	16	0	868
24767	2	872	3	11	0	888
24768	3	879	4	2	0	888
24769	4	17	3	871	0	895
24770	1	11	849	15	0	876
24771	3	844	12	8	0	867
24772	829	16	3	5	0	853
24773	15	825	2	3	0	845
24774	835	10	3	10	0	858
24775	827	3	4	9	0	843
24776	14	5	810	4	0	833
24777	830	4	12	3	0	849
24778	858	2	5	7	0	872
24779	823	6	2	10	0	841
24780	838	3	2	5	0	848
24781	13	4	826	8	0	851
24782	811	4	15	4	0	834
24783	830	4	3	9	0	846
24784	15	851	2	3	0	871
24785	6	11	1	836	0	854
24786	3	7	1	843	0	854
24787	6	838	2	14	0	860
24788	834	11	3	9	0	857
24789	13	834	5	5	0	857
24790	826	12	5	2	0	845
24791	839	6	2	3	0	850
24792	23	821	0	1	0	845
24793	5	14	4	817	0	840
24794	3	4	835	17	0	859
24795	5	801	10	7	0	823
24796	8	22	5	700	0	735
24797	5	714	1	6	0	726
24798	4	761	0	4	0	769
24799	6	19	1	733	0	759
24800	8	6	736	8	0	758
24801	3	723	11	9	0	746
24802	5	686	7	5	0	703
24803	603	8	4	2	0	617
24804	6	9	1	603	0	619
24805	4	4	1	609	0	618
24806	3	3	0	616	0	622
24807	1	1	613	17	0	632
24808	1	0	12	632	0	645
24809	0	639	5	15	0	659
24810	680	12	3	7	0	702
24811	17	7	1	678	0	703
24812	6	3	674	17	0	700
24813	672	1	16	7	0	696
24814	20	1	7	702	0	730
24815	9	0	741	18	0	768
24816	3	0	762	8	0	773
24817	751	0	27	3	0	781
24818	798	0	9	1	0	808
24819	797	0	5	2	0	804
24820	812	0	2	3	0	817
24821	31	0	788	0	0	819
24822	12	797	19	0	0	828
24823	795	19	5	2	0	821
24824	21	792	4	1	0	818
24825	790	23	1	2	0	816
24826	23	800	1	1	0	825
24827	9	25	0	794	0	828
24828	4	9	0	808	0	821
24829	2	4	0	809	0	815
24830	1	769	1	26	0	797
24831	0	805	0	11	0	816
24832	0	26	1	781	0	808
24833	3	781	0	21	0	805
24834	0	22	771	10	0	803
24835	0	8	20	775	0	803
24836	2	5	781	21	0	809
24837	777	1	24	11	0	813
24838	795	1	9	6	0	811
24839	28	3	778	1	0	810
24840	12	1	779	1	0	793
24841	6	2	24	765	0	797
24842	5	0	772	20	0	797
24843	5	2	22	744	0	773
24844	2	727	8	27	0	764
24845	0	21	10	767	0	798
24846	3	7	3	779	0	792
24847	3	4	1	786	0	794
24848	4	1	754	30	0	789
24849	3	5	19	754	0	781
24850	3	1	7	763	0	774
24851	2	1	6	759	0	768
24852	1	753	1	26	0	781
24853	748	23	4	10	0	785
24854	761	10	1	8	0	780
24855	760	4	3	3	0	770
24856	32	5	1	738	0	776
24857	15	3	739	22	0	779
24858	10	1	746	11	0	768
24859	3	735	29	8	0	775
24860	722	25	7	4	0	758
24861	25	733	5	3	0	766
24862	733	22	5	6	0	766
24863	21	735	6	2	0	764
24864	723	24	3	5	0	755
24865	23	766	3	8	0	800
24866	10	22	4	769	0	805
24867	8	11	761	19	0	799
24868	8	4	774	11	0	797
24869	3	1	30	765	0	799
24870	3	2	12	773	0	790
24871	5	2	7	779	0	793
24872	4	2	758	30	0	794
24873	4	3	21	757	0	785
24874	739	4	8	28	0	779
24875	749	3	4	16	0	772
24876	29	724	4	9	0	766
24877	724	22	5	6	0	757
24878	25	723	3	5	0	756
24879	727	22	1	7	0	757
24880	742	10	3	5	0	760
24881	715	9	2	4	0	730
24882	31	8	711	3	0	753
24883	17	1	710	4	0	732
24884	699	6	28	3	0	736
24885	725	3	10	4	0	742
24886	30	2	7	705	0	744
24887	10	1	10	728	0	749
24888	9	4	4	744	0	761
24889	6	4	3	754	0	767
24890	3	2	3	784	0	792
24891	742	3	4	35	0	784
24892	24	3	1	756	0	784
24893	14	3	742	27	0	786
24894	718	3	20	14	0	755
24895	741	4	9	9	0	763
24896	32	712	6	7	0	757
24897	12	731	5	7	0	755
24898	660	17	3	6	0	686
24899	14	668	2	4	0	688
24900	650	18	2	5	0	675
24901	680	5	3	6	0	694
24902	693	1	6	2	0	702
24903	24	1	1	671	0	697
24904	11	669	2	15	0	697
24905	688	16	3	6	0	713
24906	16	6	2	692	0	716
24907	4	4	1	667	0	676
24908	630	1	2	14	0	647
24909	9	620	1	7	0	637
24910	6	5	0	601	0	612
24911	622	2	2	9	0	635
24912	6	632	3	6	0	647
24913	641	5	5	4	0	655
24914	12	2	626	2	0	642
24915	605	3	6	3	0	617
24916	5	608	2	1	0	616
24917	606	3	9	2	0	620
24918	607	2	0	2	0	611
24919	3	619	1	4	0	627
24920	607	3	0	4	0	614
24921	5	601	1	0	0	607
24922	620	4	0	2	0	626
24923	5	1	2	624	0	632
24924	4	1	0	620	0	625
24925	3	1	0	618	0	622
24926	1	1	611	5	0	618
24927	4	1	3	607	0	615
24928	2	1	616	4	0	623
24929	3	2	4	621	0	630
24930	2	611	1	4	0	618
24931	3	3	1	621	0	628
24932	2	2	615	4	0	623
24933	1	2	630	2	0	635
24934	2	1	4	633	0	640
24935	631	0	3	5	0	639
24936	624	0	1	5	0	630
24937	4	637	1	3	0	645
24938	4	3	1	640	0	648
24939	2	3	647	6	0	658
24940	0	1	3	652	0	656
24941	5	0	647	5	0	657
24942	649	3	4	1	0	657
24943	4	0	1	665	0	670
24944	4	0	665	3	0	672
24945	4	2	3	658	0	667
24946	3	2	1	662	0	668
24947	2	0	665	5	0	672
24948	5	0	4	663	0	672
24949	669	4	1	5	0	679
24950	677	0	2	2	0	681
24951	8	1	0	682	0	691
24952	686	3	1	6	0	696
24953	7	0	702	2	0	711
24954	4	2	687	5	0	698
24955	714	1	4	5	0	724
24956	720	0	6	2	0	728
24957	4	1	2	708	0	715
24958	4	0	2	711	0	717
24959	3	0	705	7	0	715
24960	3	1	4	692	0	700
24961	3	709	3	6	0	721
24962	725	4	5	3	0	737
24963	784	3	3	3	0	793
24964	8	783	1	3	0	795
24965	741	6	3	3	0	753
24966	743	4	2	2	0	751
24967	10	765	0	4	0	779
24968	781	6	2	4	0	793
24969	6	773	2	1	0	782
24970	790	11	0	3	0	804
24971	11	2	777	3	0	793
24972	6	3	7	785	0	801
24973	3	4	2	802	0	811
24974	2	1	6	828	0	837
24975	833	0	1	13	0	847
24976	9	2	0	870	0	881
24977	4	1	867	11	0	883
24978	868	1	7	6	0	882
24979	10	2	2	868	0	882
24980	5	848	7	7	0	867
24981	6	884	0	6	0	896
24982	5	8	0	882	0	895
24983	2	5	2	876	0	885
24984	1	4	1	894	0	900
24985	5	0	871	16	0	892
24986	2	866	11	6	0	885
24987	855	8	2	5	0	870
24988	847	1	4	1	0	853
24989	9	840	2	0	0	851
24990	6	845	1	1	0	853
24991	10	9	2	832	0	853
24992	2	5	831	6	0	844
24993	799	5	8	3	0	815
24994	823	1	1	9	0	834
24995	11	0	5	825	0	841
24996	7	0	0	831	0	838
24997	808	2	2	8	0	820
24998	9	3	804	6	0	822
24999	785	0	7	8	0	800
25000	9	794	1	1	0	805
25001	2	6	4	760	0	772
25002	3	757	0	7	0	767
25003	763	10	2	1	0	776
25004	9	1	0	760	0	770
25005	1	4	0	755	0	760
25006	5	752	0	8	0	765
25007	756	6	2	3	0	767
25008	759	2	1	5	0	767
25009	10	2	743	1	0	756
25010	5	1	723	1	0	730
25011	720	0	7	1	0	728
25012	6	2	716	1	0	725
25013	2	1	685	3	0	691
25014	682	0	9	2	0	693
25015	7	2	766	0	0	775
25016	4	1	13	767	0	785
25017	3	0	2	778	0	783
25018	805	0	5	13	0	823
25019	16	1	842	5	0	864
25020	876	0	15	8	0	899
25021	22	1	1	893	0	917
25022	905	1	6	17	0	929
25023	918	0	1	2	0	921
25024	915	2	0	8	0	925
25025	25	0	2	904	0	931
25026	912	0	1	17	0	930
25027	22	1	1	912	0	936
25028	4	2	0	918	0	924
25029	11	0	0	913	0	924
25030	8	0	1	929	0	938
25031	908	0	2	26	0	936
25032	920	1	1	9	0	931
25033	19	0	892	11	0	922
25034	906	1	15	4	0	926
25035	926	1	5	5	0	937
25036	19	0	9	902	0	930
25037	16	887	2	17	0	922
25038	905	16	1	7	0	929
25039	20	2	2	888	0	912
25040	884	8	2	16	0	910
25041	27	869	5	5	0	906
25042	876	14	0	11	0	901
25043	23	3	1	869	0	896
25044	7	855	0	17	0	879
25045	863	17	1	6	0	887
25046	23	853	1	9	0	886
25047	7	887	1	5	0	900
25048	885	20	5	1	0	911
25049	20	10	856	5	0	891
25050	873	7	16	6	0	902
25051	26	2	3	864	0	895
25052	8	3	878	17	0	906
25053	13	3	13	847	0	876
25054	2	4	2	888	0	896
25055	8	2	869	21	0	900
25056	865	1	18	11	0	895
25057	27	0	5	871	0	903
25058	10	0	7	878	0	895
25059	11	2	3	869	0	885
25060	858	0	4	31	0	893
25061	21	2	843	17	0	883
25062	6	1	860	13	0	880
25063	10	1	18	797	0	826
25064	8	1	798	18	0	825
25065	788	1	18	12	0	819
25066	14	791	7	13	0	825
25067	776	14	11	6	0	807
25068	26	3	3	747	0	779
25069	5	756	5	20	0	786
25070	10	18	4	755	0	787
25071	8	763	3	19	0	793
25072	10	20	0	766	0	796
25073	10	4	760	19	0	793
25074	4	12	727	7	0	750
25075	10	723	13	11	0	757
25076	690	13	9	8	0	720
25077	12	8	6	688	0	714
25078	7	7	1	692	0	707
25079	683	4	4	17	0	708
25080	684	4	3	10	0	701
25081	21	4	3	669	0	697
25082	11	3	661	15	0	690
25083	11	658	11	9	0	689
25084	5	13	2	670	0	690
25085	6	4	8	658	0	676
25086	6	674	1	23	0	704
25087	679	13	1	13	0	706
25088	17	5	677	4	0	703
25089	10	6	16	674	0	706
25090	5	4	4	669	0	682
25091	4	5	652	22	0	683
25092	5	2	13	667	0	687
25093	664	3	5	22	0	694
25094	666	5	8	5	0	684
25095	665	1	5	9	0	680
25096	17	650	6	10	0	683
25097	684	13	6	5	0	708
25098	23	4	3	685	0	715
25099	8	8	3	698	0	717
25100	16	738	0	18	0	772
25101	808	19	0	13	0	840
25102	847	6	3	5	0	861
25103	845	9	2	7	0	863
25104	866	5	0	7	0	878
25105	856	2	1	11	0	870
25106	33	2	824	5	0	864
25107	842	4	22	5	0	873
25108	853	4	6	4	0	867
25109	850	0	9	2	0	861
25110	40	2	0	817	0	859
25111	20	1	2	835	0	858
25112	17	1	798	25	0	841
25113	745	2	17	16	0	780
25114	22	777	7	12	0	818
25115	9	717	8	2	0	736
25116	12	17	691	5	0	725
25117	5	679	16	4	0	704
25118	5	651	7	4	0	667
25119	10	36	5	538	0	589
25120	0	559	1	8	0	568
25121	536	15	1	6	0	558
25122	531	4	3	3	0	541
25123	16	6	0	517	0	539
25124	9	1	511	12	0	533
25125	511	3	11	4	0	529
25126	13	1	520	4	0	538
25127	8	0	532	0	0	540
25128	8	0	15	513	0	536
25129	2	0	10	523	0	535
25130	3	0	513	16	0	532
25131	1	498	14	8	0	521
25132	2	533	9	4	0	548
25133	531	13	4	0	0	548
25134	539	6	0	2	0	547
25135	13	4	521	3	0	541
25136	528	0	13	2	0	543
25137	548	1	4	1	0	554
25138	16	2	3	531	0	552
25139	7	2	0	543	0	552
25140	4	3	1	543	0	551
25141	536	0	2	16	0	554
25142	543	1	0	5	0	549
25143	548	2	0	5	0	555
25144	17	0	1	535	0	553
25145	7	2	528	12	0	549
25146	525	0	12	5	0	542
25147	527	0	3	4	0	534
25148	18	0	4	510	0	532
25149	10	519	3	12	0	544
25150	8	11	2	523	0	544
25151	3	516	4	15	0	538
25152	4	14	3	505	0	526
25153	5	518	1	21	0	545
25154	505	13	1	7	0	526
25155	16	5	3	502	0	526
25156	7	491	0	18	0	516
25157	4	13	493	3	0	513
25158	493	2	12	7	0	514
25159	14	6	2	491	0	513
25160	4	488	7	11	0	510
25161	6	12	1	481	0	500
25162	6	475	1	13	0	495
25163	4	499	2	3	0	508
25164	494	13	0	8	0	515
25165	497	8	1	3	0	509
25166	18	5	489	0	0	512
25167	499	0	10	1	0	510
25168	497	1	3	4	0	505
25169	13	486	5	3	0	507
25170	8	10	3	486	0	507
25171	8	4	0	481	0	493
25172	5	3	468	14	0	490
25173	3	2	468	7	0	480
25174	461	3	12	5	0	481
25175	474	1	9	6	0	490
25176	476	4	4	0	0	484
25177	17	2	462	1	0	482
25178	10	3	11	454	0	478
25179	462	1	2	14	0	479
25180	10	1	4	464	0	479
25181	2	3	452	14	0	471
25182	447	1	10	5	0	463
25183	15	4	466	4	0	489
25184	7	449	11	6	0	473
25185	459	11	4	3	0	477
25186	11	2	447	4	0	464
25187	7	7	8	441	0	463
25188	448	2	2	8	0	460
25189	11	1	3	445	0	460
25190	448	0	1	15	0	464
25191	12	1	3	449	0	465
25192	459	0	1	16	0	476
25193	467	1	1	3	0	472
25194	460	2	0	5	0	467
25195	455	2	0	5	0	462
25196	15	3	1	452	0	471
25197	6	1	418	7	0	432
25198	6	2	412	4	0	424
25199	3	407	9	4	0	423
25200	2	347	2	2	0	353
25201	274	4	6	0	0	284
25202	1	1	0	260	0	262
25203	0	2	268	2	0	272
25204	2	0	286	0	0	288
25205	1	0	2	290	0	293
25206	289	0	0	2	0	291
25207	3	294	0	0	0	297
25208	307	2	0	2	0	311
25209	2	0	1	310	0	313
25210	0	0	1	308	0	309
25211	0	0	0	307	0	307
25212	0	1	308	2	0	311
25213	1	0	306	0	0	307
25214	0	310	2	1	0	313
25215	0	1	1	313	0	315
25216	310	0	0	2	0	312
25217	1	0	307	1	0	309
25218	2	0	314	0	0	316
25219	1	1	1	318	0	321
25220	1	0	0	330	0	331
25221	1	0	0	328	0	329
25222	0	0	0	360	0	360
25223	369	0	0	3	0	372
25224	2	0	1	382	0	385
25225	386	0	1	2	0	389
25226	2	0	391	0	0	393
25227	0	399	2	1	0	402
25228	2	2	0	405	0	409
25229	0	0	406	2	0	408
25230	0	0	396	0	0	396
25231	0	398	2	1	0	401
25232	1	2	0	378	0	381
25233	0	0	0	377	0	377
25234	0	0	386	4	0	390
25235	378	0	2	2	0	382
25236	3	0	1	389	0	393
25237	2	0	1	383	0	386
25238	0	0	407	4	0	411
25239	1	412	2	2	0	417
25240	0	459	1	4	0	464
25241	461	3	0	1	0	465
25242	2	1	2	462	0	467
25243	485	2	0	5	0	492
25244	4	1	486	2	0	493
25245	2	1	3	485	0	491
25246	479	0	4	5	0	488
25247	489	2	2	1	0	494
25248	6	0	1	492	0	499
25249	2	1	475	5	0	483
25250	1	0	480	1	0	482
25251	1	1	4	480	0	486
25252	0	1	479	5	0	485
25253	465	0	4	3	0	472
25254	3	477	3	3	0	486
25255	476	4	2	2	0	484
25256	485	2	1	1	0	489
25257	4	2	0	484	0	490
25258	3	1	1	485	0	490
25259	499	1	0	5	0	505
25260	3	1	1	495	0	500
25261	3	1	494	5	0	503
25262	2	490	5	2	0	499
25263	3	3	1	490	0	497
25264	1	1	2	489	0	493
25265	2	1	2	486	0	491
25266	1	1	483	6	0	491
25267	2	480	4	3	0	489
25268	2	3	3	486	0	494
25269	1	2	486	4	0	493
25270	1	2	5	485	0	493
25271	485	0	1	7	0	493
25272	4	1	2	489	0	496
25273	2	0	487	6	0	495
25274	487	2	4	4	0	497
25275	5	492	2	3	0	502
25276	2	503	1	3	0	509
25277	510	4	1	5	0	520
25278	4	3	511	2	0	520
25279	2	1	5	510	0	518
25280	1	1	1	526	0	529
25281	0	0	520	6	0	526
25282	0	525	4	6	0	535
25283	4	4	1	501	0	510
25284	1	1	524	8	0	534
25285	2	2	5	522	0	531
25286	521	0	3	8	0	532
25287	5	2	538	2	0	547
25288	2	1	4	543	0	550
25289	6	1	3	547	0	557
25290	1	0	541	8	0	550
25291	1	1	6	536	0	544
25292	2	482	3	5	0	492
25293	3	5	3	507	0	518
25294	1	528	2	6	0	537
25295	525	5	3	3	0	536
25296	518	3	3	2	0	526
25297	7	1	516	3	0	527
25298	4	1	512	5	0	522
25299	2	0	514	2	0	518
25300	0	531	6	3	0	540
25301	3	6	3	533	0	545
25302	4	1	554	3	0	562
25303	1	1	3	535	0	540
25304	2	1	2	527	0	532
25305	1	0	533	5	0	539
25306	1	0	3	532	0	536
25307	1	0	1	518	0	520
25308	2	524	2	4	0	532
25309	1	4	0	538	0	543
25310	2	2	3	545	0	552
25311	2	1	547	5	0	555
25312	2	2	2	538	0	544
25313	3	2	538	5	0	548
25314	2	1	536	3	0	542
25315	527	1	9	2	0	539
25316	4	6	3	523	0	536
25317	2	531	1	3	0	537
25318	1	531	2	4	0	538
25319	2	2	1	549	0	554
25320	2	2	543	4	0	551
25321	1	551	4	3	0	559
25322	2	5	1	532	0	540
25323	0	0	550	2	0	552
25324	0	542	4	1	0	547
25325	569	2	0	4	0	575
25326	571	0	2	2	0	575
25327	564	1	2	3	0	570
25328	4	2	1	587	0	594
25329	2	0	0	590	0	592
25330	1	1	1	599	0	602
25331	1	2	597	7	0	607
25332	589	0	3	2	0	594
25333	2	1	3	605	0	611
25334	3	1	582	4	0	590
25335	596	0	3	2	0	601
25336	604	1	3	2	0	610
25337	5	3	536	3	0	547
25338	589	1	1	3	0	594
25339	3	606	2	0	0	611
25340	2	3	568	1	0	574
25341	563	2	2	1	0	568
25342	3	577	2	3	0	585
25343	1	1	0	551	0	553
25344	0	557	0	1	0	558
25345	0	1	0	571	0	572
25346	0	0	570	1	0	571
25347	530	0	1	2	0	533
25348	1	0	573	0	0	574
25349	1	576	1	0	0	578
25350	0	575	1	0	0	576
25351	577	2	0	0	0	579
25352	1	1	571	0	0	573
25353	1	0	1	570	0	572
25354	0	0	579	1	0	580
25355	0	584	1	1	0	586
25356	1	1	1	570	0	573
25357	0	595	0	1	0	596
25358	613	2	1	1	0	617
25359	603	0	0	0	0	603
25360	608	0	0	0	0	608
25361	3	0	601	1	0	605
25362	1	1	593	0	0	595
25363	601	0	3	1	0	605
25364	2	0	612	0	0	614
25365	2	0	2	597	0	601
25366	0	602	2	2	0	606
25367	623	2	0	1	0	626
25368	620	2	0	0	0	622
25369	635	0	0	2	0	637
25370	3	0	1	638	0	642
25371	2	0	0	645	0	647
25372	645	0	1	3	0	649
25373	1	645	0	1	0	647
25374	643	3	0	2	0	648
25375	5	2	0	639	0	646
25376	3	0	0	642	0	645
25377	629	0	1	4	0	634
25378	5	619	0	1	0	625
25379	628	3	1	3	0	635
25380	3	630	3	0	0	636
25381	631	5	0	1	0	637
25382	4	1	1	748	0	754
25383	747	0	0	5	0	752
25384	776	1	0	2	0	779
25385	879	1	0	0	0	880
25386	6	905	1	0	0	912
25387	4	4	868	0	0	876
25388	874	3	5	2	0	884
25389	896	0	2	2	0	900
25390	9	881	2	0	0	892
25391	3	7	0	891	0	901
25392	1	2	3	893	0	899
25393	881	1	0	12	0	894
25394	8	1	1	888	0	898
25395	5	2	893	6	0	906
25396	1	4	872	3	0	880
25397	895	0	9	1	0	905
25398	9	1	4	896	0	910
25399	5	1	0	897	0	903
25400	1	1	2	896	0	900
25401	1	2	904	8	0	915
25402	4	0	6	889	0	899
25403	3	2	2	891	0	898
25404	2	0	0	898	0	900
25405	882	0	3	10	0	895
25406	10	1	3	880	0	894
25407	8	0	899	8	0	915
25408	917	3	9	6	0	935
25409	11	0	947	3	0	961
25410	997	3	10	5	0	1015
25411	987	0	3	6	0	996
25412	15	5	1	1026	0	1047
25413	9	1029	2	15	0	1055
25414	5	12	3	1050	0	1070
25415	10	4	1	1057	0	1072
25416	2	1051	4	20	0	1077
25417	1051	13	6	6	0	1076
25418	16	1044	3	4	0	1067
25419	1045	12	5	4	0	1066
25420	1046	3	1	8	0	1058
25421	19	5	1	1036	0	1061
25422	9	2	0	1020	0	1031
25423	8	2	992	14	0	1016
25424	6	4	959	11	0	980
25425	960	0	12	8	0	980
25426	962	1	3	10	0	976
25427	19	930	5	2	0	956
25428	6	13	2	924	0	945
25429	9	1	950	9	0	969
25430	8	10	10	946	0	974
25431	938	1	6	17	0	962
25432	920	1	3	4	0	928
25433	16	908	3	4	0	931
25434	7	11	2	901	0	921
25435	5	6	0	913	0	924
25436	7	2	0	902	0	911
25437	3	4	856	17	0	880
25438	828	6	9	6	0	849
25439	851	1	3	9	0	864
25440	16	4	839	6	0	865
25441	11	823	11	5	0	850
25442	828	12	4	6	0	850
25443	836	3	5	9	0	853
25444	17	4	793	4	0	818
25445	7	4	829	3	0	843
25446	8	2	14	817	0	841
25447	10	3	815	12	0	840
25448	805	3	13	4	0	825
25449	793	5	3	9	0	810
25450	793	1	6	9	0	809
25451	16	5	6	767	0	794
25452	8	816	2	16	0	842
25453	831	11	3	7	0	852
25454	835	3	4	5	0	847
25455	16	4	813	7	0	840
25456	6	2	785	10	0	803
25457	775	2	12	9	0	798
25458	16	2	5	791	0	814
25459	8	0	789	15	0	812
25460	8	775	14	7	0	804
25461	7	13	4	776	0	800
25462	771	4	6	16	0	797
25463	15	792	3	5	0	815
25464	7	11	3	790	0	811
25465	7	785	5	11	0	808
25466	4	798	6	7	0	815
25467	8	12	5	784	0	809
25468	7	2	3	792	0	804
25469	3	788	8	13	0	812
25470	786	10	1	6	0	803
25471	16	3	777	7	0	803
25472	791	4	12	6	0	813
25473	19	3	4	786	0	812
25474	11	6	3	788	0	808
25475	10	3	5	787	0	805
25476	10	2	6	788	0	806
25477	7	2	786	14	0	809
25478	9	2	14	782	0	807
25479	8	1	5	794	0	808
25480	3	826	4	18	0	851
25481	5	11	865	3	0	884
25482	6	894	11	10	0	921
25483	3	14	908	7	0	932
25484	6	892	12	2	0	912
25485	10	11	4	782	0	807
25486	777	2	1	12	0	792
25487	9	779	2	3	0	793
25488	5	13	2	792	0	812
25489	2	5	806	15	0	828
25490	4	816	15	4	0	839
25491	810	16	2	6	0	834
25492	826	3	3	7	0	839
25493	18	819	4	2	0	843
25494	4	17	806	3	0	830
25495	800	3	13	3	0	819
25496	16	4	4	820	0	844
25497	819	5	2	14	0	840
25498	15	822	1	5	0	843
25499	4	831	1	7	0	843
25500	3	17	823	4	0	847
25501	821	5	13	7	0	846
25502	16	3	5	839	0	863
25503	835	4	3	14	0	856
25504	14	840	3	9	0	866
25505	845	15	2	3	0	865
25506	843	3	4	6	0	856
25507	16	4	847	5	0	872
25508	3	795	14	4	0	816
25509	5	807	2	4	0	818
25510	7	20	1	698	0	726
25511	3	719	1	7	0	730
25512	696	10	3	3	0	712
25513	9	699	1	0	0	709
25514	4	11	1	673	0	689
25515	3	673	2	7	0	685
25516	1	670	0	4	0	675
25517	1	687	1	0	0	689
25518	4	11	2	684	0	701
25519	2	2	2	687	0	693
25520	5	1	0	690	0	696
25521	0	675	1	9	0	685
25522	0	9	670	3	0	682
25523	0	4	673	0	0	677
25524	666	0	9	1	0	676
25525	6	1	2	679	0	688
25526	4	0	677	8	0	689
25527	0	4	706	2	0	712
25528	1	714	10	1	0	726
25529	1	9	1	682	0	693
25530	0	2	0	688	0	690
25531	689	2	0	11	0	702
25532	7	1	0	685	0	693
25533	4	1	0	697	0	702
25534	0	1	747	10	0	758
25535	1	3	8	746	0	758
25536	2	2	3	781	0	788
25537	0	0	784	12	0	796
25538	1	2	782	4	0	789
25539	0	780	10	5	0	795
25540	0	10	778	0	0	788
25541	0	2	9	782	0	793
25542	5	3	4	687	0	699
25543	2	0	796	11	0	809
25544	0	792	8	5	0	805
25545	748	7	5	1	0	761
25546	8	765	4	1	0	778
25547	2	10	2	770	0	784
25548	1	4	1	780	0	786
25549	1	774	4	13	0	792
25550	3	9	2	783	0	797
25551	1	6	2	785	0	794
25552	2	2	736	13	0	753
25553	1	730	8	5	0	744
25554	4	9	3	738	0	754
25555	4	3	759	10	0	776
25556	2	3	9	751	0	765
25557	4	2	5	756	0	767
25558	2	4	1	770	0	777
25559	3	2	1	762	0	768
25560	2	2	2	752	0	758
25561	4	761	1	11	0	777
25562	762	11	2	6	0	781
25563	9	7	743	1	0	760
25564	699	2	10	5	0	716
25565	13	3	772	3	0	791
25566	5	792	12	4	0	813
25567	4	10	792	2	0	808
25568	2	802	10	4	0	818
25569	8	12	6	757	0	783
25570	3	7	0	791	0	801
25571	1	796	2	13	0	812
25572	2	841	0	7	0	850
25573	844	17	1	4	0	866
25574	865	3	1	6	0	875
25575	864	5	2	3	0	874
25576	875	1	2	3	0	881
25577	14	5	2	857	0	878
25578	4	842	1	14	0	861
25579	833	10	3	5	0	851
25580	8	6	2	791	0	807
25581	764	2	3	9	0	778
25582	734	2	2	8	0	746
25583	11	706	0	4	0	721
25584	2	685	0	2	0	689
25585	2	718	1	0	0	721
25586	1	19	1	679	0	700
25587	1	693	0	7	0	701
25588	683	5	2	2	0	692
25589	701	1	0	3	0	705
25590	695	0	0	2	0	697
25591	711	1	1	2	0	715
25592	718	0	1	3	0	722
25593	5	1	732	1	0	739
25594	739	0	7	1	0	747
25595	5	1	748	1	0	755
25596	751	0	5	2	0	758
25597	6	0	3	753	0	762
25598	1	0	773	7	0	781
25599	1	0	815	2	0	818
25600	0	859	8	1	0	868
25601	872	10	3	3	0	888
25602	907	1	0	2	0	910
25603	10	1001	0	0	0	1011
25604	6	15	0	1155	0	1176
25605	1226	5	1	17	0	1249
25606	19	0	1246	5	0	1270
25607	8	1234	16	0	0	1258
25608	1217	18	7	3	0	1245
25609	18	1244	2	0	0	1264
25610	8	16	1	1208	0	1233
25611	0	1249	0	15	0	1264
25612	3	19	0	1230	0	1252
25613	1	1238	0	19	0	1258
25614	1	1264	0	12	0	1277
25615	1234	25	0	2	0	1261
25616	1267	8	2	4	0	1281
25617	24	2	1240	1	0	1267
25618	12	2	1213	0	0	1227
25619	3	2	1238	0	0	1243
25620	3	2	23	1239	0	1267
25621	3	1	1255	18	0	1277
25622	1	2	19	1245	0	1267
25623	3	0	9	1243	0	1255
25624	0	1248	2	30	0	1280
25625	1252	19	2	11	0	1284
25626	19	1269	1	3	0	1292
25627	12	16	3	1285	0	1316
25628	1	9	4	1307	0	1321
25629	2	3	2	1304	0	1311
25630	2	2	1281	27	0	1312
25631	5	1	19	1285	0	1310
25632	5	1	8	1295	0	1309
25633	4	1	1	1324	0	1330
25634	5	3	1254	28	0	1290
25635	5	1254	19	12	0	1290
25636	1227	22	9	5	0	1263
25637	1221	11	2	7	0	1241
25638	28	1267	2	3	0	1300
25639	10	19	2	1280	0	1311
25640	5	13	2	1303	0	1323
25641	3	3	1287	31	0	1324
25642	1	1297	18	13	0	1329
25643	3	19	10	1289	0	1321
25644	4	13	1301	20	0	1338
25645	5	3	21	1298	0	1327
25646	7	4	12	1283	0	1306
25647	5	1	1304	29	0	1339
25648	4	4	22	1294	0	1324
25649	5	2	10	1294	0	1311
25650	4	1	1327	30	0	1362
25651	6	3	21	1322	0	1352
25652	6	3	10	1302	0	1321
25653	4	5	1	1355	0	1365
25654	5	0	1333	29	0	1367
25655	3	4	20	1320	0	1347
25656	1307	1	12	29	0	1349
25657	1319	2	7	18	0	1346
25658	26	1316	5	7	0	1354
25659	1328	17	2	9	0	1356
25660	21	8	1407	4	0	1440
25661	10	1	20	1428	0	1459
25662	2	3	11	1449	0	1465
25663	6	1	5	1462	0	1474
25664	1404	4	4	33	0	1445
25665	19	1399	3	13	0	1434
25666	11	17	1	1378	0	1407
25667	5	1393	1	22	0	1421
25668	1383	19	3	17	0	1422
25669	17	1398	2	5	0	1422
25670	1380	17	4	8	0	1409
25671	14	1347	2	6	0	1369
25672	12	1341	2	8	0	1363
25673	1	23	5	1347	0	1376
25674	6	9	3	1344	0	1362
25675	5	3	3	1340	0	1351
25676	2	5	2	1334	0	1343
25677	2	5	1329	29	0	1365
25678	3	1325	17	17	0	1362
25679	1	17	9	1311	0	1338
25680	3	1339	1	17	0	1360
25681	2	18	1343	7	0	1370
25682	3	13	14	1318	0	1348
25683	4	2	11	1361	0	1378
25684	1	1	1346	27	0	1375
25685	2	1322	18	13	0	1355
25686	4	17	10	1331	0	1362
25687	0	12	1323	21	0	1356
25688	5	1324	20	10	0	1359
25689	0	24	10	1307	0	1341
25690	0	10	1310	24	0	1344
25691	1	3	1297	11	0	1312
25692	1	1288	26	8	0	1323
25693	2	1409	10	6	0	1427
25694	3	30	5	1449	0	1487
25695	3	11	3	1507	0	1524
25696	1	5	1492	38	0	1536
25697	1474	3	29	11	0	1517
25698	1491	6	6	5	0	1508
25699	36	4	1456	8	0	1504
25700	8	1425	27	5	0	1465
25701	4	1426	11	3	0	1444
25702	3	1408	3	6	0	1420
25703	5	1138	11	9	0	1163
25704	25	44	8	1178	0	1255
25705	0	5	0	1323	0	1328
25706	0	3	0	1323	0	1326
25707	0	3	0	1353	0	1356
25708	0	1344	0	41	0	1385
25709	2	26	1	1350	0	1379
25710	1	1345	1	31	0	1378
25711	2	29	0	1374	0	1405
25712	1365	6	1	34	0	1406
25713	32	4	1	1372	0	1409
25714	4	1362	0	30	0	1396
25715	5	31	0	1393	0	1429
25716	6	5	0	1423	0	1434
25717	0	4	0	1434	0	1438
25718	1380	3	0	46	0	1429
25719	30	2	0	1414	0	1446
25720	3	2	1390	43	0	1438
25721	4	1420	28	10	0	1462
25722	5	35	3	1445	0	1488
25723	3	4	2	1498	0	1507
25724	8	5	1	1501	0	1515
25725	1452	6	0	46	0	1504
25726	33	5	1422	14	0	1474
25727	5	3	32	1412	0	1452
25728	4	1399	4	42	0	1449
25729	6	36	3	1416	0	1461
25730	1376	4	2	49	0	1431
25731	31	1387	2	23	0	1443
25732	8	36	2	1395	0	1441
25733	7	5	1	1415	0	1428
25734	4	1372	2	41	0	1419
25735	3	34	1	1388	0	1426
25736	4	5	1	1421	0	1431
25737	3	4	1363	43	0	1413
25738	2	1348	34	15	0	1399
25739	1335	32	5	20	0	1392
25740	33	6	1335	11	0	1385
25741	1318	3	33	12	0	1366
25742	41	9	1309	4	0	1363
25743	7	4	38	1331	0	1380
25744	1305	3	7	45	0	1360
25745	33	8	2	1317	0	1360
25746	1320	5	2	46	0	1373
25747	1334	5	2	22	0	1363
25748	1329	4	4	17	0	1354
25749	38	1303	3	12	0	1356
25750	12	35	3	1282	0	1332
25751	13	9	3	1315	0	1340
25752	5	11	3	1316	0	1335
25753	7	6	1279	48	0	1340
25754	4	4	37	1287	0	1332
25755	1272	5	7	48	0	1332
25756	1308	3	6	16	0	1333
25757	40	3	1261	16	0	1320
25758	1266	4	33	9	0	1312
25759	1297	5	8	12	0	1322
25760	49	4	5	1187	0	1245
25761	1176	5	5	43	0	1229
25762	1205	3	3	18	0	1229
25763	43	3	4	1177	0	1227
25764	1175	3	7	46	0	1231
25765	1192	3	9	15	0	1219
25766	41	6	3	1170	0	1220
25767	19	8	981	41	0	1049
25768	1130	2	31	16	0	1179
25769	46	6	1142	10	0	1204
25770	16	8	1154	7	0	1185
25771	11	1144	38	19	0	1212
25772	14	36	8	1122	0	1180
25773	13	11	4	1167	0	1195
25774	14	4	5	1160	0	1183
25775	8	4	1128	56	0	1196
25776	18	5	1139	15	0	1177
25777	11	1121	34	20	0	1186
25778	12	38	10	1117	0	1177
25779	14	5	9	1147	0	1175
25780	11	6	5	1166	0	1188
25781	9	2	1109	46	0	1166
25782	11	1094	36	20	0	1161
25783	11	32	8	1102	0	1153
25784	6	6	1101	42	0	1155
25785	13	8	1117	16	0	1154
25786	1091	3	41	13	0	1148
25787	1113	3	14	18	0	1148
25788	1108	6	11	9	0	1134
25789	41	3	3	1083	0	1130
25790	17	1	1068	42	0	1128
25791	12	1047	29	17	0	1105
25792	8	1074	15	18	0	1115
25793	7	31	913	10	0	961
25794	9	32	27	816	0	884
25795	4	6	14	789	0	813
25796	3	748	12	24	0	787
25797	8	755	8	11	0	782
25798	721	27	3	8	0	759
25799	744	5	7	4	0	760
25800	748	4	2	5	0	759
25801	722	2	5	9	0	738
25802	702	1	8	7	0	718
25803	32	664	0	3	0	699
25804	6	505	4	5	0	520
25805	1	417	4	1	0	423
25806	384	7	11	1	0	403
25807	14	9	11	330	0	364
25808	2	0	1	318	0	321
25809	311	0	1	4	0	316
25810	4	310	1	2	0	317
25811	1	3	1	306	0	311
25812	2	2	1	307	0	312
25813	0	2	3	303	0	308
25814	285	1	1	5	0	292
25815	3	1	0	286	0	290
25816	1	0	274	4	0	279
25817	282	2	3	1	0	288
25818	3	4	1	289	0	297
25819	1	1	288	2	0	292
25820	1	291	3	1	0	296
25821	1	279	0	0	0	280
25822	258	2	1	2	0	263
25823	253	0	1	0	0	254
25824	2	257	0	0	0	259
25825	0	2	0	273	0	275
25826	284	0	0	4	0	288
25827	3	0	0	306	0	309
25828	1	0	0	319	0	320
25829	0	0	0	322	0	322
25830	0	0	0	323	0	323
25831	0	311	0	5	0	316
25832	0	4	0	318	0	322
25833	1	1	0	317	0	319
25834	1	0	0	321	0	322
25835	2	0	304	7	0	313
25836	1	310	6	1	0	318
25837	1	6	1	313	0	321
25838	0	3	306	5	0	314
25839	1	0	294	2	0	297
25840	3	308	5	0	0	316
25841	307	6	1	2	0	316
25842	6	1	1	308	0	316
25843	309	1	0	6	0	316
25844	5	312	0	3	0	320
25845	2	5	0	313	0	320
25846	301	1	0	7	0	309
25847	305	1	0	2	0	308
25848	5	1	0	305	0	311
25849	2	0	1	308	0	311
25850	0	1	305	7	0	313
25851	0	0	5	304	0	309
25852	0	2	3	311	0	316
25853	299	1	1	7	0	308
25854	5	303	0	2	0	310
25855	2	5	303	1	0	311
25856	295	1	5	2	0	303
25857	6	306	1	1	0	314
25858	3	6	1	309	0	319
25859	303	2	0	8	0	313
25860	7	0	0	305	0	312
25861	2	1	1	312	0	316
25862	0	0	304	7	0	311
25863	1	1	5	305	0	312
25864	314	0	1	5	0	320
25865	5	0	0	317	0	322
25866	310	0	0	7	0	317
25867	6	298	1	1	0	306
25868	0	308	0	2	0	310
25869	0	6	1	310	0	317
25870	3	1	0	312	0	316
25871	299	2	0	7	0	308
25872	5	291	1	3	0	300
25873	303	5	1	0	0	309
25874	303	2	0	2	0	307
25875	6	0	0	300	0	306
25876	299	0	1	5	0	305
25877	4	1	282	3	0	290
25878	2	0	6	281	0	289
25879	1	0	287	5	0	293
25880	1	0	5	285	0	291
25881	288	1	2	6	0	297
25882	295	1	0	2	0	298
25883	5	297	0	4	0	306
25884	1	6	1	294	0	302
25885	1	2	2	300	0	305
25886	0	298	0	7	0	305
25887	3	5	0	303	0	311
25888	2	2	0	304	0	308
25889	2	291	2	6	0	301
25890	292	7	0	1	0	300
25891	292	2	1	1	0	296
25892	7	0	0	290	0	297
25893	3	4	0	291	0	298
25894	1	0	286	9	0	296
25895	2	1	4	276	0	283
25896	2	279	2	6	0	289
25897	286	6	0	2	0	294
25898	5	1	0	289	0	295
25899	3	0	0	282	0	285
25900	275	1	1	6	0	283
25901	5	268	1	4	0	278
25902	2	3	1	287	0	293
25903	1	2	0	287	0	290
25904	2	282	1	6	0	291
25905	291	6	0	1	0	298
25906	5	2	283	3	0	293
25907	1	0	289	3	0	293
25908	0	0	6	294	0	300
25909	0	2	291	7	0	300
25910	292	1	6	2	0	301
25911	6	0	1	296	0	303
25912	3	1	296	6	0	306
25913	1	2	298	2	0	303
25914	2	300	4	1	0	307
25915	303	4	1	1	0	309
25916	4	309	1	4	0	318
25917	301	3	1	2	0	307
25918	300	1	0	1	0	302
25919	8	287	1	1	0	297
25920	277	4	0	1	0	282
25921	276	1	0	2	0	279
25922	7	2	267	0	0	276
25923	1	13	5	244	0	263
25924	0	247	1	5	0	253
25925	0	239	1	0	0	240
25926	1	5	2	230	0	238
25927	208	0	3	2	0	213
25928	3	0	0	207	0	210
25929	0	1	0	221	0	222
25930	0	0	0	225	0	225
25931	0	236	0	4	0	240
25932	1	4	0	252	0	257
25933	0	0	274	5	0	279
25934	268	0	3	2	0	273
25935	282	0	2	0	0	284
25936	5	271	0	0	0	276
25937	279	3	0	0	0	282
25938	3	2	0	283	0	288
25939	2	1	278	3	0	284
25940	277	0	3	2	0	282
25941	4	277	2	0	0	283
25942	1	3	0	284	0	288
25943	291	2	0	3	0	296
25944	3	283	0	3	0	289
25945	2	288	1	0	0	291
25946	286	4	0	0	0	290
25947	3	3	281	0	0	287
25948	282	0	3	1	0	286
25949	5	0	2	278	0	285
25950	3	1	0	279	0	283
25951	0	1	274	5	0	280
25952	1	0	272	2	0	275
25953	0	0	5	277	0	282
25954	1	0	272	3	0	276
25955	0	0	271	3	0	274
25956	0	0	5	271	0	276
25957	0	0	3	273	0	276
25958	269	0	1	5	0	275
25959	3	0	0	271	0	274
25960	271	0	0	3	0	274
25961	3	266	0	2	0	271
25962	4	3	0	264	0	271
25963	0	3	277	4	0	284
25964	275	0	3	2	0	280
25965	280	0	2	2	0	284
25966	285	0	1	1	0	287
25967	284	1	0	0	0	285
25968	279	1	0	1	0	281
25969	5	0	1	272	0	278
25970	4	0	277	3	0	284
25971	1	1	281	2	0	285
25972	1	1	288	0	0	290
25973	281	0	6	0	0	287
25974	288	0	3	0	0	291
25975	7	0	0	278	0	285
25976	2	282	0	5	0	289
25977	0	4	1	292	0	297
25978	0	2	289	5	0	296
25979	1	0	287	2	0	290
25980	281	0	8	3	0	292
25981	6	0	294	1	0	301
25982	3	1	7	285	0	296
25983	292	1	2	7	0	302
25984	282	0	2	3	0	287
25985	294	0	2	2	0	298
25986	296	0	1	1	0	298
25987	11	0	286	0	0	297
25988	283	3	4	1	0	291
25989	8	282	2	2	0	294
25990	4	5	2	288	0	299
25991	3	3	292	5	0	303
25992	4	2	5	296	0	307
25993	3	2	297	6	0	308
25994	2	0	7	301	0	310
25995	3	2	2	305	0	312
25996	0	1	301	9	0	311
25997	0	1	8	305	0	314
25998	300	0	5	7	0	312
25999	6	0	4	305	0	315
26000	4	0	1	314	0	319
26001	304	0	0	9	0	313
26002	6	301	2	5	0	314
26003	302	6	1	3	0	312
26004	8	302	1	1	0	312
26005	318	6	1	1	0	326
26006	6	1	317	2	0	326
26007	7	1	6	307	0	321
26008	1	2	4	309	0	316
26009	303	0	1	12	0	316
26010	7	304	1	4	0	316
26011	6	5	0	311	0	322
26012	4	2	2	304	0	312
26013	2	294	0	10	0	306
26014	300	5	1	5	0	311
26015	7	301	2	1	0	311
26016	5	8	0	287	0	300
26017	3	3	1	294	0	301
26018	1	282	2	9	0	294
26019	282	5	1	5	0	293
26020	8	3	285	1	0	297
26021	282	3	4	2	0	291
26022	6	282	3	3	0	294
26023	3	5	2	294	0	304
26024	296	4	2	6	0	308
26025	6	1	1	298	0	306
26026	4	0	2	298	0	304
26027	307	0	0	10	0	317
26028	6	295	1	5	0	307
26029	2	305	1	4	0	312
26030	298	4	1	2	0	305
26031	7	0	305	1	0	313
26032	4	294	3	2	0	303
26033	5	7	0	274	0	286
26034	1	2	326	3	0	332
26035	1	5	4	319	0	329
26036	330	0	2	5	0	337
26037	4	328	1	2	0	335
26038	5	3	1	317	0	326
26039	1	321	3	4	0	329
26040	327	5	0	2	0	334
26041	335	2	0	2	0	339
26042	5	340	0	2	0	347
26043	3	4	1	340	0	348
26044	3	358	0	5	0	366
26045	366	5	1	2	0	374
26046	372	3	0	2	0	377
26047	9	2	0	366	0	377
26048	4	3	0	371	0	378
26049	3	1	361	7	0	372
26050	352	0	5	4	0	361
26051	5	2	364	2	0	373
26052	5	0	5	369	0	379
26053	365	1	5	5	0	376
26054	6	365	2	4	0	377
26055	355	5	2	2	0	364
26056	4	4	346	4	0	358
26057	360	1	4	4	0	369
26058	6	366	1	2	0	375
26059	366	5	1	3	0	375
26060	9	371	2	0	0	382
26061	4	7	0	370	0	381
26062	3	5	363	5	0	376
26063	2	3	349	4	0	358
26064	4	1	6	353	0	364
26065	2	3	363	6	0	374
26066	1	1	6	364	0	372
26067	2	0	5	362	0	369
26068	0	2	374	8	0	384
26069	355	1	5	4	0	365
26070	372	1	4	3	0	380
26071	5	363	2	5	0	375
26072	371	5	1	1	0	378
26073	6	1	0	366	0	373
26074	6	0	370	3	0	379
26075	2	2	4	367	0	375
26076	3	1	1	372	0	377
26077	364	2	0	7	0	373
26078	4	354	1	4	0	363
26079	3	364	1	1	0	369
26080	2	4	0	370	0	376
26081	4	1	0	370	0	375
26082	1	368	0	4	0	373
26083	4	3	0	366	0	373
26084	0	5	1	367	0	373
26085	2	364	0	8	0	374
26086	368	3	1	4	0	376
26087	2	4	0	372	0	378
26088	4	370	0	5	0	379
26089	0	4	2	375	0	381
26090	370	2	0	5	0	377
26091	3	366	1	3	0	373
26092	373	3	0	3	0	379
26093	364	2	0	2	0	368
26094	6	1	0	372	0	379
26095	383	1	0	4	0	388
26096	392	1	1	3	0	397
26097	392	1	2	1	0	396
26098	397	2	1	1	0	401
26099	6	0	0	390	0	396
26100	4	1	2	391	0	398
26101	2	1	391	6	0	400
26102	2	0	3	393	0	398
26103	3	0	5	395	0	403
26104	2	0	398	8	0	408
26105	386	1	3	3	0	393
26106	3	2	2	393	0	400
26107	3	0	407	6	0	416
26108	408	0	4	3	0	415
26109	6	0	433	2	0	441
26110	3	460	4	4	0	471
26111	0	479	4	2	0	485
26112	6	4	1	499	0	510
26113	1	2	551	6	0	560
26114	540	1	8	4	0	553
26115	577	1	0	3	0	581
26116	6	2	572	2	0	582
26117	565	1	6	1	0	573
26118	570	1	2	1	0	574
26119	9	569	1	2	0	581
26120	572	6	2	0	0	580
26121	9	0	2	564	0	575
26122	4	2	564	6	0	576
26123	1	2	6	531	0	540
26124	2	563	2	7	0	574
26125	3	573	1	2	0	579
26126	571	7	0	2	0	580
26127	559	1	1	1	0	562
26128	559	0	1	2	0	562
26129	7	1	1	551	0	560
26130	3	1	2	539	0	545
26131	3	530	0	4	0	537
26132	529	8	0	1	0	538
26133	8	534	1	3	0	546
26134	473	4	2	2	0	481
26135	8	479	2	3	0	492
26136	473	5	2	1	0	481
26137	461	2	2	4	0	469
26138	8	2	0	466	0	476
26139	7	476	2	4	0	489
26140	3	8	461	1	0	473
26141	455	1	3	3	0	462
26142	6	450	3	2	0	461
26143	4	5	450	1	0	460
26144	2	2	457	1	0	462
26145	3	4	3	440	0	450
26146	4	3	0	435	0	442
26147	3	461	3	2	0	469
26148	481	3	0	0	0	484
26149	7	1	1	474	0	483
26150	1	498	2	7	0	508
26151	1	532	1	2	0	536
26152	1	5	536	1	0	543
26153	4	2	527	1	0	534
26154	535	3	3	0	0	541
26155	8	1	539	0	0	548
26156	2	2	4	545	0	553
26157	4	1	0	559	0	564
26158	2	1	567	6	0	576
26159	1	2	4	556	0	563
26160	7	3	2	536	0	548
26161	563	1	1	5	0	570
26162	573	1	2	0	0	576
26163	4	3	0	560	0	567
26164	1	561	5	4	0	571
26165	1	577	4	1	0	583
26166	579	3	0	5	0	587
26167	4	2	572	3	0	581
26168	3	2	3	568	0	576
26169	579	0	0	7	0	586
26170	576	2	1	4	0	583
26171	4	5	1	584	0	594
26172	1	2	578	5	0	586
26173	1	2	558	1	0	562
26174	569	1	6	1	0	577
26175	597	2	2	2	0	603
26176	6	598	3	1	0	608
26177	2	616	1	4	0	623
26178	628	4	2	7	0	641
26179	648	3	6	2	0	659
26180	5	1	3	665	0	674
26181	6	0	0	663	0	669
26182	10	1	3	656	0	670
26183	655	1	2	9	0	667
26184	6	3	1	664	0	674
26185	1	4	679	5	0	689
26186	676	2	4	1	0	683
26187	7	1	1	682	0	691
26188	1	2	703	6	0	712
26189	690	1	2	7	0	700
26190	667	3	0	3	0	673
26191	6	729	1	4	0	740
26192	2	747	3	4	0	756
26193	3	4	732	1	0	740
26194	754	1	6	4	0	765
26195	7	753	3	2	0	765
26196	5	6	741	5	0	757
26197	734	4	6	1	0	745
26198	10	807	1	1	0	819
26199	3	7	810	4	0	824
26200	791	1	7	2	0	801
26201	7	810	1	4	0	822
26202	5	12	0	814	0	831
26203	819	1	0	9	0	829
26204	7	816	0	1	0	824
26205	1	10	4	809	0	824
26206	817	0	2	6	0	825
26207	9	0	826	2	0	837
26208	0	808	6	5	0	819
26209	2	5	796	1	0	804
26210	2	5	5	766	0	778
26211	1	0	761	4	0	766
26212	0	739	4	1	0	744
26213	0	705	0	0	0	705
26214	0	3	0	701	0	704
26215	1	0	0	680	0	681
26216	1	0	0	688	0	689
26217	0	0	720	3	0	723
26218	0	0	3	723	0	726
26219	731	0	0	4	0	735
26220	725	0	0	2	0	727
26221	2	0	740	0	0	742
26222	0	736	3	1	0	740
26223	748	3	0	1	0	752
26224	3	745	0	0	0	748
26225	754	3	0	0	0	757
26226	761	0	0	0	0	761
26227	3	0	755	0	0	758
26228	0	772	3	0	0	775
26229	0	3	0	787	0	790
26230	0	0	783	4	0	787
26231	771	0	3	0	0	774
26232	4	1	0	791	0	796
26233	0	0	781	4	0	785
26234	776	1	3	2	0	782
26235	3	2	811	0	0	816
26236	1	1	3	828	0	833
26237	870	0	1	7	0	878
26238	3	908	0	1	0	912
26239	1	4	934	1	0	940
26240	935	0	4	1	0	940
26241	1030	1	0	1	0	1032
26242	6	1058	2	1	0	1067
26243	2	6	1	1063	0	1072
26244	3	0	1	1054	0	1058
26245	1055	1	0	8	0	1064
26246	9	2	1	1060	0	1072
26247	1	1	1061	7	0	1070
26248	2	0	8	1047	0	1057
26249	1065	2	0	8	0	1075
26250	7	1036	7	1	0	1051
26251	2	9	0	1022	0	1033
26252	2	1021	1	8	0	1032
26253	1038	8	0	3	0	1049
26254	10	1	2	1096	0	1109
26255	2	1	1	1118	0	1122
26256	3	1112	1	16	0	1132
26257	2	13	1112	3	0	1130
26258	3	2	16	1088	0	1109
26259	3	2	2	1121	0	1128
26260	2	2	2	1114	0	1120
26261	3	1097	0	19	0	1119
26262	3	14	1096	2	0	1115
26263	2	2	1113	3	0	1120
26264	1096	2	16	6	0	1120
26265	1130	2	3	2	0	1137
26266	17	3	1132	2	0	1154
26267	1105	2	17	4	0	1128
26268	17	0	1147	6	0	1170
26269	1134	4	15	5	0	1158
26270	16	1160	4	3	0	1183
26271	1164	15	2	9	0	1190
26272	18	1	1186	3	0	1208
26273	5	2	1200	4	0	1211
26274	6	1	21	1257	0	1285
26275	1276	2	4	24	0	1306
26276	24	1357	5	4	0	1390
26277	8	28	1489	2	0	1527
26278	5	6	30	1536	0	1577
26279	10	4	4	1574	0	1592
26280	1554	5	3	31	0	1593
26281	1565	2	4	10	0	1581
26282	36	1	2	1556	0	1595
26283	1558	3	1	39	0	1601
26284	36	2	1543	5	0	1586
26285	5	4	34	1517	0	1560
26286	7	4	5	1541	0	1557
26287	1513	2	5	40	0	1560
26288	1513	2	2	12	0	1529
26289	36	5	3	1488	0	1532
26290	1488	0	7	34	0	1529
26291	38	2	1446	4	0	1490
26292	12	1443	31	6	0	1492
26293	9	30	1438	3	0	1480
26294	10	4	34	1434	0	1482
26295	1424	4	4	34	0	1466
26296	32	1392	11	6	0	1441
26297	13	30	4	1405	0	1452
26298	12	3	3	1383	0	1401
26299	7	1361	3	34	0	1405
26300	8	28	7	1384	0	1427
26301	6	4	7	1389	0	1406
26302	2	5	6	1394	0	1407
26303	9	4	4	1380	0	1397
26304	11	5	6	1357	0	1379
26305	8	1315	5	41	0	1369
26306	11	27	3	1336	0	1377
26307	9	3	4	1337	0	1353
26308	12	3	1294	37	0	1346
26309	6	1293	29	16	0	1344
26310	11	28	3	1302	0	1344
26311	11	7	7	1310	0	1335
26312	9	3	8	1316	0	1336
26313	6	1272	2	44	0	1324
26314	7	22	1266	16	0	1311
26315	15	7	26	1289	0	1337
26316	8	4	1285	37	0	1334
26317	7	3	1262	16	0	1288
26318	9	2	38	1265	0	1314
26319	1275	5	9	39	0	1328
26320	31	5	7	1294	0	1337
26321	7	4	6	1289	0	1306
26322	14	1265	3	36	0	1318
26323	11	32	4	1301	0	1348
26324	6	7	2	1345	0	1360
26325	5	4	1314	46	0	1369
26326	2	1300	33	14	0	1349
26327	5	25	7	1330	0	1367
26328	1277	4	5	50	0	1336
26329	37	5	1282	20	0	1344
26330	9	7	28	1295	0	1339
26331	5	7	5	1322	0	1339
26332	1271	6	8	44	0	1329
26333	25	1270	6	20	0	1321
26334	1240	32	4	23	0	1299
26335	29	1235	5	19	0	1288
26336	13	33	4	1231	0	1281
26337	1198	8	6	38	0	1250
26338	31	6	1177	20	0	1234
26339	1	1142	30	23	0	1196
26340	5	1164	5	22	0	1196
26341	1068	30	5	15	0	1118
26342	31	7	8	1039	0	1085
26343	8	1036	7	34	0	1085
26344	6	1052	9	16	0	1083
26345	10	29	8	1047	0	1094
26346	5	5	6	1075	0	1091
26347	1032	7	3	37	0	1079
26348	27	1026	5	15	0	1073
26349	2	31	6	1026	0	1065
26350	6	5	1006	34	0	1051
26351	6	1012	26	12	0	1056
26352	2	28	1003	16	0	1049
26353	3	996	23	12	0	1034
26354	14	24	7	943	0	988
26355	4	5	1	929	0	939
26356	5	912	5	25	0	947
26357	4	17	911	14	0	946
26358	908	6	20	14	0	948
26359	20	4	4	937	0	965
26360	7	7	3	944	0	961
26361	6	5	928	24	0	963
26362	5	9	17	922	0	953
26363	4	5	929	27	0	965
26364	3	4	18	933	0	958
26365	2	4	964	31	0	1001
26366	3	987	21	10	0	1021
26367	5	25	1008	5	0	1043
26368	4	10	16	1011	0	1041
26369	1011	4	5	32	0	1052
26370	22	997	4	10	0	1033
26371	7	21	7	1003	0	1038
26372	8	4	975	29	0	1016
26373	3	976	23	14	0	1016
26374	6	22	4	893	0	925
26375	4	5	902	21	0	932
26376	2	803	14	2	0	821
26377	612	26	17	11	0	666
26378	591	2	5	1	0	599
26379	6	1	0	588	0	595
26380	588	0	1	6	0	595
26381	4	0	0	593	0	597
26382	3	0	0	595	0	598
26383	0	1	638	4	0	643
26384	1	0	4	629	0	634
26385	0	0	2	644	0	646
26386	638	0	0	7	0	645
26387	637	0	0	4	0	641
26388	6	640	1	0	0	647
26389	1	5	638	0	0	644
26390	1	1	5	647	0	654
26391	1	0	635	5	0	641
26392	600	2	4	2	0	608
26393	6	1	625	0	0	632
26394	0	0	7	621	0	628
26395	0	624	1	6	0	631
26396	2	4	0	638	0	644
26397	4	2	0	638	0	644
26398	0	0	642	8	0	650
26399	2	0	6	642	0	650
26400	635	1	1	9	0	646
26401	647	1	0	2	0	650
26402	649	0	3	1	0	653
26403	650	1	0	2	0	653
26404	7	623	1	6	0	637
26405	3	642	0	0	0	645
26406	1	6	1	628	0	636
26407	2	1	0	650	0	653
26408	0	629	1	7	0	637
26409	1	4	0	652	0	657
26410	0	0	1	655	0	656
26411	0	1	0	656	0	657
26412	0	0	0	658	0	658
26413	2	0	0	656	0	658
26414	651	0	0	7	0	658
26415	6	637	0	2	0	645
26416	1	5	628	1	0	635
26417	0	1	5	624	0	630
26418	0	0	2	629	0	631
26419	1	0	1	614	0	616
26420	625	0	1	8	0	634
26421	5	679	1	2	0	687
26422	2	11	0	700	0	713
26423	0	718	1	13	0	732
26424	1	12	0	704	0	717
26425	1	690	1	11	0	703
26426	0	12	723	5	0	740
26427	2	2	13	772	0	789
26428	1	1	916	14	0	932
26429	1	1	17	917	0	936
26430	5	1	3	980	0	989
26431	970	2	1	22	0	995
26432	981	2	0	8	0	991
26433	988	0	1	0	0	989
26434	992	2	1	3	0	998
26435	985	2	1	4	0	992
26436	23	1	1	948	0	973
26437	4	954	0	20	0	978
26438	2	18	0	938	0	958
26439	3	5	920	17	0	945
26440	914	1	17	11	0	943
26441	949	1	7	5	0	962
26442	24	1	1	929	0	955
26443	8	1	2	923	0	934
26444	4	899	2	24	0	929
26445	7	15	1	923	0	946
26446	6	4	2	924	0	936
26447	4	896	1	22	0	923
26448	8	19	0	911	0	938
26449	879	4	0	24	0	907
26450	17	3	889	5	0	914
26451	873	2	15	8	0	898
26452	20	3	882	4	0	909
26453	8	0	19	870	0	897
26454	2	1	7	881	0	891
26455	2	847	2	24	0	875
26456	2	879	0	12	0	893
26457	6	22	2	852	0	882
26458	6	7	848	18	0	879
26459	849	0	18	10	0	877
26460	22	0	5	850	0	877
26461	7	840	3	26	0	876
26462	7	19	0	858	0	884
26463	3	6	3	847	0	859
26464	2	830	1	23	0	856
26465	3	16	7	776	0	802
26466	3	7	728	15	0	753
26467	3	3	710	7	0	723
26468	1	5	14	714	0	734
26469	1	738	7	13	0	759
26470	3	14	2	732	0	751
26471	717	7	0	20	0	744
26472	729	8	1	5	0	743
26473	696	2	1	9	0	708
26474	15	686	2	5	0	708
26475	3	14	675	6	0	698
26476	664	7	11	6	0	688
26477	675	1	11	7	0	694
26478	15	665	2	7	0	689
26479	5	13	2	667	0	687
26480	666	7	1	15	0	689
26481	672	2	3	8	0	685
26482	676	3	2	6	0	687
26483	20	2	4	614	0	640
26484	626	1	1	15	0	643
26485	15	5	3	619	0	642
26486	9	2	3	625	0	639
26487	616	1	2	23	0	642
26488	22	2	2	612	0	638
26489	612	3	1	15	0	631
26490	19	0	1	610	0	630
26491	15	3	2	612	0	632
26492	608	3	1	21	0	633
26493	15	2	595	12	0	624
26494	8	3	13	607	0	631
26495	11	1	1	615	0	628
26496	7	4	3	608	0	622
26497	8	2	0	609	0	619
26498	12	0	2	589	0	603
26499	7	573	1	22	0	603
26500	10	12	2	579	0	603
26501	2	7	567	20	0	596
26502	5	1	13	593	0	612
26503	7	4	4	588	0	603
26504	6	5	2	603	0	616
26505	2	3	580	25	0	610
26506	4	3	580	13	0	600
26507	574	4	18	5	0	601
26508	580	1	5	10	0	596
26509	17	587	4	9	0	617
26510	6	16	1	599	0	622
26511	3	5	1	628	0	637
26512	2	4	4	626	0	636
26513	606	3	3	27	0	639
26514	628	2	3	13	0	646
26515	17	3	6	617	0	643
26516	7	3	4	625	0	639
26517	1	4	3	636	0	644
26518	4	3	3	632	0	642
26519	612	3	2	22	0	639
26520	14	4	575	11	0	604
26521	5	491	9	7	0	512
26522	4	451	4	9	0	468
26523	424	7	2	7	0	440
26524	10	15	1	414	0	440
26525	4	2	414	8	0	428
26526	0	0	375	8	0	383
26527	0	362	4	6	0	372
26528	202	1	9	2	0	214
26529	1	1	205	2	0	209
26530	145	4	0	0	0	149
26531	0	0	0	168	0	168
26532	0	0	0	164	0	164
26533	0	165	0	0	0	165
26534	0	167	0	0	0	167
26535	173	0	0	1	0	174
26536	172	0	0	2	0	174
26537	0	177	0	0	0	177
26538	0	0	173	0	0	173
26539	0	0	183	0	0	183
26540	1	0	0	188	0	189
26541	191	0	0	0	0	191
26542	0	190	0	0	0	190
26543	0	0	0	209	0	209
26544	214	0	0	0	0	214
26545	1	0	0	214	0	215
26546	0	0	0	225	0	225
26547	227	0	0	1	0	228
26548	0	232	0	0	0	232
26549	0	233	0	0	0	233
26550	1	1	254	0	0	256
26551	0	0	1	266	0	267
26552	0	0	0	268	0	268
26553	0	0	277	1	0	278
26554	253	0	1	1	0	255
26555	269	0	0	0	0	269
26556	1	0	276	0	0	277
26557	250	0	1	0	0	251
26558	1	2	298	0	0	301
26559	0	320	1	0	0	321
26560	0	1	0	337	0	338
26561	0	0	0	349	0	349
26562	342	0	0	1	0	343
26563	342	1	0	0	0	343
26564	343	0	0	1	0	344
26565	341	0	0	0	0	341
26566	344	0	0	0	0	344
26567	1	0	340	0	0	341
26568	0	344	1	0	0	345
26569	0	1	0	353	0	354
26570	0	350	0	2	0	352
26571	0	352	1	0	0	353
26572	0	1	0	360	0	361
26573	0	0	0	365	0	365
26574	0	0	375	0	0	375
26575	365	0	0	0	0	365
26576	377	0	0	0	0	377
26577	1	371	1	0	0	373
26578	381	1	0	0	0	382
26579	400	0	0	0	0	400
26580	1	0	0	403	0	404
26581	0	1	430	1	0	432
26582	0	0	428	0	0	428
26583	445	0	1	1	0	447
26584	450	0	0	0	0	450
26585	1	442	0	0	0	443
26586	0	461	0	0	0	461
26587	0	1	0	475	0	476
26588	476	0	0	2	0	478
26589	1	0	486	0	0	487
26590	0	0	1	500	0	501
26591	515	0	0	3	0	518
26592	510	0	0	0	0	510
26593	1	0	0	527	0	528
26594	533	0	0	1	0	534
26595	1	0	529	0	0	530
26596	1	0	554	0	0	555
26597	1	0	1	554	0	556
26598	0	0	0	575	0	575
26599	0	0	0	570	0	570
26600	0	562	1	1	0	564
26601	1	583	0	0	0	584
26602	0	2	0	586	0	588
26603	593	0	0	2	0	595
26604	0	0	0	603	0	603
26605	0	0	0	608	0	608
26606	0	598	0	1	0	599
26607	0	613	0	0	0	613
26608	0	2	0	621	0	623
26609	0	0	0	612	0	612
26610	605	0	0	3	0	608
26611	2	592	0	0	0	594
26612	596	2	0	1	0	599
26613	2	0	0	604	0	606
26614	1	0	591	2	0	594
26615	0	0	588	0	0	588
26616	602	0	5	2	0	609
26617	2	0	0	623	0	625
26618	0	0	0	625	0	625
26619	1	0	0	627	0	628
26620	0	0	637	2	0	639
26621	0	0	1	653	0	654
26622	0	644	0	2	0	646
26623	0	2	0	667	0	669
26624	0	0	0	663	0	663
26625	0	688	0	2	0	690
26626	0	1	0	717	0	718
26627	722	0	0	5	0	727
26628	3	729	3	1	0	736
26629	762	5	0	3	0	770
26630	769	1	0	2	0	772
26631	6	0	0	752	0	758
26632	2	1	0	751	0	754
26633	2	0	0	756	0	758
26634	0	0	742	5	0	747
26635	0	721	3	2	0	726
26636	0	744	1	1	0	746
26637	0	4	0	740	0	744
26638	735	0	1	6	0	742
26639	4	1	0	725	0	730
26640	2	5	717	4	0	728
26641	0	707	4	5	0	716
26642	2	718	0	1	0	721
26643	717	5	0	2	0	724
26644	710	1	1	3	0	715
26645	4	743	2	0	0	749
26646	757	4	0	0	0	761
26647	5	0	746	1	0	752
26648	2	3	736	1	0	742
26649	756	1	5	2	0	764
26650	757	0	2	0	0	759
26651	6	0	2	751	0	759
26652	752	1	1	5	0	759
26653	6	1	744	1	0	752
26654	2	1	768	2	0	773
26655	3	1	5	912	0	921
26656	1	0	4	1006	0	1011
26657	0	0	2	1035	0	1037
26658	1	1	1	1071	0	1074
26659	3	0	0	1131	0	1134
26660	0	0	1119	21	0	1140
26661	4	1	12	1114	0	1131
26662	1110	0	4	26	0	1140
26663	13	0	2	1125	0	1140
26664	1116	0	3	24	0	1143
26665	16	0	1	1127	0	1144
26666	1125	1	4	23	0	1153
26667	1155	0	3	20	0	1178
26668	26	1	0	1160	0	1187
26669	13	1	3	1175	0	1192
26670	1165	0	1	28	0	1194
26671	1164	0	2	14	0	1180
26672	23	1	1156	13	0	1193
26673	19	1	14	1165	0	1199
26674	12	1	4	1179	0	1196
26675	1161	1	2	27	0	1191
26676	1187	1	3	11	0	1202
26677	30	0	2	1179	0	1211
26678	15	1	6	1192	0	1214
26679	13	2	2	1167	0	1184
26680	11	0	1	1165	0	1177
26681	7	1095	4	32	0	1138
26682	13	1121	0	15	0	1149
26683	9	16	3	1109	0	1137
26684	3	1105	4	30	0	1142
26685	5	16	1	1118	0	1140
26686	1	7	1096	29	0	1133
26687	4	6	1091	17	0	1118
26688	4	1098	17	12	0	1131
26689	1	20	4	1089	0	1114
26690	2	9	1079	22	0	1112
26691	3	5	20	1069	0	1097
26692	4	4	10	1084	0	1102
26693	1062	7	10	21	0	1100
26694	17	7	4	1069	0	1097
26695	9	4	1080	26	0	1119
26696	8	2	1062	16	0	1088
26697	9	1041	19	11	0	1080
26698	6	1094	11	14	0	1125
26699	1108	18	8	11	0	1145
26700	20	7	1151	13	0	1191
26701	10	4	20	1165	0	1199
26702	1165	4	13	19	0	1201
26703	1159	2	5	19	0	1185
26704	24	1156	5	11	0	1196
26705	17	15	6	1153	0	1191
26706	11	8	9	1193	0	1221
26707	9	6	3	1191	0	1209
26708	1176	5	2	27	0	1210
26709	24	5	1152	14	0	1195
26710	12	1184	12	19	0	1227
26711	10	12	8	1198	0	1228
26712	7	8	5	1212	0	1232
26713	3	6	1185	32	0	1226
26714	10	4	13	1196	0	1223
26715	7	5	9	1207	0	1228
26716	3	8	4	1206	0	1221
26717	4	3	5	1209	0	1221
26718	1	2	1167	41	0	1211
26719	5	5	18	1182	0	1210
26720	3	0	1183	31	0	1217
26721	0	1185	21	24	0	1230
26722	3	16	13	1190	0	1222
26723	3	8	4	1224	0	1239
26724	5	4	1206	30	0	1245
26725	3	1169	16	25	0	1213
26726	5	14	13	1156	0	1188
26727	6	10	1148	22	0	1186
26728	4	1125	11	28	0	1168
26729	4	13	11	1131	0	1159
26730	5	9	1125	22	0	1161
26731	5	6	17	1133	0	1161
26732	3	7	11	1138	0	1159
26733	8	4	9	1166	0	1187
26734	1152	7	4	27	0	1190
26735	14	1147	4	19	0	1184
26736	1153	12	10	14	0	1189
26737	15	11	1146	16	0	1188
26738	1179	3	11	19	0	1212
26739	1228	3	9	15	0	1255
26740	26	5	4	1227	0	1262
26741	1240	8	4	23	0	1275
26742	1259	4	4	17	0	1284
26743	1279	2	6	14	0	1301
26744	28	7	4	1272	0	1311
26745	22	2	1	1247	0	1272
26746	8	4	1215	24	0	1251
26747	13	5	1179	13	0	1210
26748	1201	2	15	10	0	1228
26749	18	8	13	1195	0	1234
26750	15	1197	7	18	0	1237
26751	1204	11	12	19	0	1246
26752	13	1206	8	11	0	1238
26753	13	1207	7	10	0	1237
26754	19	18	1178	10	0	1225
26755	9	9	1135	4	0	1157
26756	5	23	22	1071	0	1121
26757	3	2	1117	9	0	1131
26758	1	0	1015	6	0	1022
26759	969	0	4	3	0	976
26760	994	1	3	4	0	1002
26761	3	0	0	1024	0	1027
26762	4	0	0	1029	0	1033
26763	0	0	1053	4	0	1057
26764	1	1067	0	3	0	1071
26765	1	0	3	1068	0	1072
26766	1092	4	0	2	0	1098
26767	0	0	0	1104	0	1104
26768	3	1103	1	1	0	1108
26769	1	1	1114	4	0	1120
26770	0	1146	0	1	0	1147
26771	1147	2	4	5	0	1158
26772	1137	4	2	2	0	1145
26773	6	0	0	1150	0	1156
26774	4	0	1170	1	0	1175
26775	0	0	1107	5	0	1112
26776	0	1148	7	0	0	1155
26777	0	4	5	1124	0	1133
26778	1	4	1	1166	0	1172
26779	0	1	1161	8	0	1170
26780	2	0	4	1145	0	1151
26781	1	1214	3	3	0	1221
26782	0	3	1	1236	0	1240
26783	3	4	0	1235	0	1242
26784	1	3	1225	7	0	1236
26785	2	3	3	1215	0	1223
26786	1244	0	5	4	0	1253
26787	2	0	1256	7	0	1265
26788	7	0	1232	2	0	1241
26789	3	1259	8	1	0	1271
26790	2	3	7	1298	0	1310
26791	0	5	3	1348	0	1356
26792	1	4	1335	7	0	1347
26793	1284	1	6	10	0	1301
26794	3	2	5	1342	0	1352
26795	7	0	1340	3	0	1350
26796	6	0	6	1306	0	1318
26797	2	0	1347	6	0	1355
26798	0	0	1298	8	0	1306
26799	0	1334	11	3	0	1348
26800	1	3	6	1289	0	1299
26801	0	1309	5	6	0	1320
26802	1312	6	1	5	0	1324
26803	4	5	1322	2	0	1333
26804	3	1308	4	0	0	1315
26805	6	5	2	1299	0	1312
26806	1295	2	3	4	0	1304
26807	5	1306	1	3	0	1315
26808	4	4	0	1319	0	1327
26809	2	3	1	1313	0	1319
26810	1	1331	2	5	0	1339
26811	1330	5	0	9	0	1344
26812	3	2	0	1480	0	1485
26813	5	3	0	1560	0	1568
26814	3	1	1566	16	0	1586
26815	1	1626	10	16	0	1653
26816	2	11	8	1648	0	1669
26817	1	8	7	1793	0	1809
26818	0	1827	1	24	0	1852
26819	4	20	1	1824	0	1849
26820	6	8	0	1892	0	1906
26821	3	9	0	1911	0	1923
26822	0	1894	2	33	0	1929
26823	1890	17	1	20	0	1928
26824	18	7	1883	10	0	1918
26825	1829	9	18	6	0	1862
26826	26	1877	9	3	0	1915
26827	10	21	10	1872	0	1913
26828	11	9	1886	23	0	1929
26829	3	9	19	1893	0	1924
26830	3	2	7	1896	0	1908
26831	3	2	8	1929	0	1942
26832	3	0	1906	34	0	1943
26833	2	1900	22	17	0	1941
26834	1	18	1914	10	0	1943
26835	0	1931	27	12	0	1970
26836	1	27	1960	4	0	1992
26837	3	10	28	1962	0	2003
26838	1935	10	11	24	0	1980
26839	18	1957	12	11	0	1998
26840	8	20	1965	14	0	2007
26841	10	1956	22	4	0	1992
26842	0	31	1983	6	0	2020
26843	3	13	27	1936	0	1979
26844	3	10	9	1918	0	1940
26845	2	1940	14	24	0	1980
26846	5	1978	1	19	0	2003
26847	1992	32	2	11	0	2037
26848	20	16	1	2003	0	2040
26849	9	14	2010	25	0	2058
26850	13	8	20	1981	0	2022
26851	2	2	2014	37	0	2055
26852	3	0	2021	16	0	2040
26853	4	5	30	1981	0	2020
26854	0	1972	17	23	0	2012
26855	1935	20	15	16	0	1986
26856	22	11	4	1931	0	1968
26857	12	11	5	1910	0	1938
26858	10	1920	3	37	0	1970
26859	1905	22	6	24	0	1957
26860	1898	12	8	12	0	1930
26861	29	12	7	1853	0	1901
26862	18	1860	2	22	0	1902
26863	11	1939	9	13	0	1972
26864	1938	29	4	16	0	1987
26865	27	20	1923	9	0	1979
26866	1896	20	26	11	0	1953
26867	1915	8	10	7	0	1940
26868	1907	6	12	5	0	1930
26869	40	1867	7	12	0	1926
26870	20	22	7	1890	0	1939
26871	1909	11	3	29	0	1952
26872	1900	12	8	15	0	1935
26873	26	1898	5	19	0	1948
26874	1937	21	4	11	0	1973
26875	29	14	3	1955	0	2001
26876	15	9	5	1958	0	1987
26877	13	1950	3	37	0	2003
26878	6	28	5	1997	0	2036
26879	8	14	9	2011	0	2042
26880	7	2000	4	35	0	2046
26881	7	23	3	1927	0	1960
26882	6	1968	5	29	0	2008
26883	1967	28	4	12	0	2011
26884	1941	10	4	18	0	1973
26885	25	1938	4	12	0	1979
26886	14	23	1924	10	0	1971
26887	14	16	23	1902	0	1955
26888	8	10	1907	25	0	1950
26889	5	1837	25	15	0	1882
26890	5	1880	7	12	0	1904
26891	1809	27	9	8	0	1853
26892	24	1860	6	6	0	1896
26893	14	29	6	1823	0	1872
26894	13	1815	7	21	0	1856
26895	9	1857	6	13	0	1885
26896	1849	28	5	16	0	1898
26897	18	16	5	1843	0	1882
26898	13	14	1826	24	0	1877
26899	12	8	1797	13	0	1830
26900	6	1813	21	13	0	1853
26901	1811	26	15	7	0	1859
26902	23	1819	9	14	0	1865
26903	7	30	7	1882	0	1926
26904	1885	14	3	26	0	1928
26905	22	15	6	1906	0	1949
26906	12	10	3	1904	0	1929
26907	15	1873	9	31	0	1928
26908	5	25	4	1910	0	1944
26909	7	15	1925	26	0	1973
26910	1975	14	21	20	0	2030
26911	29	2015	11	17	0	2072
26912	9	1994	5	3	0	2011
26913	1906	20	6	7	0	1939
26914	28	6	1911	7	0	1952
26915	1860	6	24	8	0	1898
26916	24	2026	7	11	0	2068
26917	11	2173	3	2	0	2189
26918	7	32	2185	3	0	2227
26919	7	2226	29	1	0	2263
26920	5	37	20	2090	0	2152
26921	5	13	3	2112	0	2133
26922	1	2121	2	39	0	2163
26923	7	32	3	2141	0	2183
26924	2147	18	2	34	0	2201
26925	29	5	2127	14	0	2175
26926	2135	8	28	9	0	2180
26927	2180	8	11	9	0	2208
26928	2159	7	5	12	0	2183
26929	44	8	2123	6	0	2181
26930	23	5	29	2135	0	2192
26931	12	4	2148	31	0	2195
26932	2099	4	30	18	0	2151
26933	2098	4	18	11	0	2131
26934	48	2099	5	5	0	2157
26935	25	28	9	2077	0	2139
26936	12	2118	4	27	0	2161
26937	9	27	2122	16	0	2174
26938	12	15	29	2094	0	2150
26939	2081	8	17	33	0	2139
26940	2086	5	3	23	0	2117
26941	46	9	8	2021	0	2084
26942	22	2010	6	29	0	2067
26943	10	32	2025	17	0	2084
26944	11	21	2043	6	0	2081
26945	1989	4	45	13	0	2051
26946	31	9	2036	8	0	2084
26947	20	2016	34	10	0	2080
26948	16	29	19	1989	0	2053
26949	9	14	2016	31	0	2070
26950	10	7	34	1975	0	2026
26951	3	9	2002	34	0	2048
26952	1891	8	35	23	0	1957
26953	39	4	22	1931	0	1996
26954	14	1902	13	30	0	1959
26955	8	1922	6	19	0	1955
26956	9	41	8	1892	0	1950
26957	8	22	8	1883	0	1921
26958	5	1871	6	49	0	1931
26959	7	32	1875	15	0	1929
26960	8	16	35	1872	0	1931
26961	7	5	1890	37	0	1939
26962	10	12	1830	19	0	1871
26963	1725	11	48	14	0	1798
26964	31	1761	17	14	0	1823
26965	1750	39	12	8	0	1809
26966	34	21	12	1708	0	1775
26967	20	1736	8	35	0	1799
26968	11	42	6	1753	0	1812
26969	9	18	12	1730	0	1769
26970	6	1702	6	52	0	1766
26971	11	38	1693	22	0	1764
26972	7	21	35	1700	0	1763
26973	1683	7	17	40	0	1747
26974	40	12	5	1661	0	1718
26975	25	10	12	1656	0	1703
26976	7	6	1616	56	0	1685
26977	11	1602	36	25	0	1674
26978	11	31	24	1591	0	1657
26979	8	15	1570	43	0	1636
26980	8	13	1576	22	0	1619
26981	1539	9	46	12	0	1606
26982	34	1527	17	30	0	1608
26983	1526	33	15	17	0	1591
26984	37	1538	13	10	0	1598
26985	21	1551	8	17	0	1597
26986	1533	49	10	15	0	1607
26987	39	24	16	1487	0	1566
26988	26	1516	10	37	0	1589
26989	16	36	7	1540	0	1599
26990	1533	24	9	36	0	1602
26991	42	7	1525	22	0	1596
26992	19	17	1481	12	0	1529
26993	1477	14	50	10	0	1551
26994	44	1477	17	13	0	1551
26995	22	34	1473	11	0	1540
26996	9	1470	37	12	0	1528
26997	13	30	23	1451	0	1517
26998	15	27	1451	32	0	1525
26999	9	10	43	1441	0	1503
27000	12	10	1431	36	0	1489
27001	1390	12	39	27	0	1468
27002	34	1402	27	10	0	1473
27003	1354	32	15	13	0	1414
27004	35	24	8	1335	0	1402
27005	20	1391	17	33	0	1461
27006	1390	42	9	21	0	1462
27007	1364	18	12	21	0	1415
27008	43	7	1385	14	0	1449
27009	21	11	1356	11	0	1399
27010	1174	10	41	6	0	1231
27011	34	1172	21	10	0	1237
27012	17	1115	8	9	0	1149
27013	30	67	13	1011	0	1121
27014	12	16	1026	25	0	1079
27015	10	968	21	17	0	1016
27016	5	827	15	8	0	855
27017	28	16	8	480	0	532
27018	476	4	5	9	0	494
27019	485	1	3	5	0	494
27020	500	2	1	2	0	505
27021	12	2	486	2	0	502
27022	496	2	6	2	0	506
27023	490	2	4	2	0	498
27024	497	1	3	1	0	502
27025	11	2	2	476	0	491
27026	4	482	1	8	0	495
27027	481	6	1	6	0	494
27028	12	485	0	2	0	499
27029	4	8	2	468	0	482
27030	2	5	480	9	0	496
27031	3	2	7	486	0	498
27032	4	2	3	487	0	496
27033	3	0	485	13	0	501
27034	3	475	8	4	0	490
27035	2	8	5	453	0	468
27036	442	6	1	9	0	458
27037	10	433	1	3	0	447
27038	420	9	0	2	0	431
27039	12	4	0	415	0	431
27040	4	433	0	8	0	445
27041	431	10	0	2	0	443
27042	7	437	1	0	0	445
27043	3	7	416	2	0	428
27044	413	6	5	2	0	426
27045	421	0	2	3	0	426
27046	8	413	0	2	0	423
27047	2	6	408	1	0	417
27048	0	439	5	0	0	444
27049	5	10	3	366	0	384
27050	1	3	0	453	0	457
27051	0	1	0	454	0	455
27052	1	449	0	13	0	463
27053	1	10	0	453	0	464
27054	0	4	0	461	0	465
27055	451	0	0	13	0	464
27056	11	1	0	455	0	467
27057	3	1	1	464	0	469
27058	459	0	1	12	0	472
27059	12	459	0	3	0	474
27060	462	11	0	0	0	473
27061	464	4	1	1	0	470
27062	471	1	1	0	0	473
27063	13	1	0	455	0	469
27064	4	2	1	466	0	473
27065	1	0	450	16	0	467
27066	1	1	451	3	0	456
27067	0	1	455	1	0	457
27068	436	1	14	3	0	454
27069	13	1	439	1	0	454
27070	6	457	10	1	0	474
27071	0	9	5	461	0	475
27072	1	2	0	467	0	470
27073	2	463	1	14	0	480
27074	2	12	472	4	0	490
27075	2	482	9	1	0	494
27076	485	10	3	2	0	500
27077	12	4	502	1	0	519
27078	3	501	11	3	0	518
27079	1	11	508	1	0	521
27080	1	3	13	499	0	516
27081	2	0	497	12	0	511
27082	4	0	11	488	0	503
27083	495	1	5	12	0	513
27084	11	2	497	3	0	513
27085	4	497	11	2	0	514
27086	507	10	5	1	0	523
27087	13	4	507	1	0	525
27088	6	1	508	1	0	516
27089	0	3	15	504	0	522
27090	1	2	511	11	0	525
27091	493	3	10	3	0	509
27092	11	500	4	3	0	518
27093	3	11	3	513	0	530
27094	1	509	1	12	0	523
27095	528	12	1	5	0	546
27096	11	4	531	3	0	549
27097	4	1	561	3	0	569
27098	3	1	13	562	0	579
27099	2	1	3	578	0	584
27100	1	2	0	587	0	590
27101	4	0	1	588	0	593
27102	0	4	598	15	0	617
27103	2	595	11	6	0	614
27104	4	14	3	555	0	576
27105	4	3	535	12	0	554
27106	0	523	11	6	0	540
27107	526	12	2	5	0	545
27108	16	5	5	522	0	548
27109	517	1	2	13	0	533
27110	12	510	3	4	0	529
27111	513	11	1	3	0	528
27112	13	2	542	1	0	558
27113	3	6	12	531	0	552
27114	1	545	1	14	0	561
27115	4	12	537	4	0	557
27116	0	524	13	0	0	537
27117	4	11	4	409	0	428
27118	504	1	1	9	0	515
27119	10	502	2	1	0	515
27120	507	11	2	0	0	520
27121	10	2	500	1	0	513
27122	1	1	488	1	0	491
27123	490	1	10	0	0	501
27124	9	0	3	504	0	516
27125	2	2	0	511	0	515
27126	2	1	527	10	0	540
27127	0	0	529	1	0	530
27128	0	530	10	0	0	540
27129	536	9	3	0	0	548
27130	512	1	7	0	0	520
27131	9	504	1	0	0	514
27132	2	8	1	535	0	546
27133	542	0	1	9	0	552
27134	9	0	1	543	0	553
27135	553	1	0	8	0	562
27136	564	0	0	2	0	566
27137	586	1	1	0	0	588
27138	12	1	0	571	0	584
27139	3	0	0	590	0	593
27140	565	0	2	10	0	577
27141	568	0	1	3	0	572
27142	570	0	0	3	0	573
27143	10	554	0	0	0	564
27144	548	6	0	0	0	554
27145	9	538	0	0	0	547
27146	537	9	0	0	0	546
27147	9	1	548	0	0	558
27148	507	0	4	3	0	514
27149	4	511	1	0	0	516
27150	0	511	0	0	0	511
27151	518	4	1	0	0	523
27152	3	0	0	530	0	533
27153	0	1	0	533	0	534
27154	0	537	1	4	0	542
27155	0	574	0	0	0	574
27156	580	4	0	0	0	584
27157	5	0	607	3	0	615
27158	1	0	4	653	0	658
27159	668	1	0	6	0	675
27160	7	0	671	0	0	678
27161	0	719	7	1	0	727
27162	783	9	0	1	0	793
27163	11	0	794	0	0	805
27164	3	0	11	852	0	866
27165	1	0	868	12	0	881
27166	848	0	13	2	0	863
27167	11	884	2	1	0	898
27168	901	11	1	2	0	915
27169	910	2	0	1	0	913
27170	14	1	0	895	0	910
27171	898	0	2	14	0	914
27172	13	0	0	905	0	918
27173	3	0	0	924	0	927
27174	1	0	896	14	0	911
27175	0	912	12	3	0	927
27176	1	11	2	918	0	932
27177	1	2	1	912	0	916
27178	3	1	0	916	0	920
27179	0	0	899	14	0	913
27180	1	891	12	4	0	908
27181	1	12	2	910	0	925
27182	0	3	2	926	0	931
27183	2	1	907	14	0	924
27184	4	0	10	881	0	895
27185	903	0	3	14	0	920
27186	12	903	1	3	0	919
27187	903	11	1	1	0	916
27188	14	2	897	0	0	913
27189	2	2	13	903	0	920
27190	911	0	2	13	0	926
27191	919	0	2	3	0	924
27192	14	0	932	2	0	948
27193	7	0	11	933	0	951
27194	4	0	950	13	0	967
27195	917	1	13	5	0	936
27196	13	930	3	2	0	948
27197	934	13	2	1	0	950
27198	946	2	0	4	0	952
27199	15	938	2	1	0	956
27200	952	12	0	3	0	967
27201	15	2	937	1	0	955
27202	931	3	11	3	0	948
27203	15	1	1	938	0	955
27204	2	0	999	14	0	1015
27205	3	3	12	992	0	1010
27206	3	0	3	974	0	980
27207	3	1	6	1004	0	1014
27208	2	985	0	17	0	1004
27209	1002	13	0	7	0	1022
27210	15	3	4	1009	0	1031
27211	4	985	3	15	0	1007
27212	7	10	1	962	0	980
27213	3	963	2	15	0	983
27214	3	15	960	7	0	985
27215	5	3	12	970	0	990
27216	4	2	7	979	0	992
27217	3	3	965	19	0	990
27218	921	2	16	6	0	945
27219	19	971	3	2	0	995
27220	3	15	3	993	0	1014
27221	5	3	2	993	0	1003
27222	4	2	2	984	0	992
27223	4	974	3	18	0	999
27224	972	14	3	8	0	997
27225	13	5	974	7	0	999
27226	4	2	946	6	0	958
27227	3	1	14	967	0	985
27228	4	5	3	979	0	991
27229	972	1	3	18	0	994
27230	15	970	1	4	0	990
27231	4	11	2	976	0	993
27232	944	2	4	20	0	970
27233	14	4	3	942	0	963
27234	945	1	1	17	0	964
27235	18	1	925	8	0	952
27236	4	966	17	3	0	990
27237	971	9	5	8	0	993
27238	13	4	969	4	0	990
27239	945	5	13	7	0	970
27240	18	2	962	0	0	982
27241	968	3	12	3	0	986
27242	15	2	6	976	0	999
27243	993	1	4	16	0	1014
27244	17	1	2	992	0	1012
27245	6	1	3	998	0	1008
27246	997	2	1	21	0	1021
27247	13	995	4	6	0	1018
27248	7	12	2	1004	0	1025
27249	1020	5	0	19	0	1044
27250	1060	5	0	8	0	1073
27251	22	2	1	1056	0	1081
27252	12	5	1	1063	0	1081
27253	1079	2	2	19	0	1102
27254	17	2	4	1089	0	1112
27255	5	2	1	1080	0	1088
27256	1075	1	3	23	0	1102
27257	17	4	4	1039	0	1064
27258	4	2	987	21	0	1014
27259	962	1	11	13	0	987
27260	19	0	971	6	0	996
27261	5	4	915	4	0	928
27262	848	5	18	4	0	875
27263	12	847	5	2	0	866
27264	2	9	5	810	0	826
27265	3	1	2	825	0	831
27266	2	2	1	851	0	856
27267	1	1	0	873	0	875
27268	867	0	0	17	0	884
27269	917	1	1	6	0	925
27270	960	1	0	3	0	964
27271	14	0	1027	2	0	1043
27272	8	0	14	1087	0	1109
27273	5	0	4	1120	0	1129
27274	1	1	4	1105	0	1111
27275	1	1063	2	25	0	1091
27276	3	1087	1	12	0	1103
27277	1099	20	3	6	0	1128
27278	18	8	1	1100	0	1127
27279	7	6	1	1162	0	1176
27280	7	2	0	1197	0	1206
27281	3	2	1165	32	0	1202
27282	2	2	1138	16	0	1158
27283	1136	0	26	10	0	1172
27284	1184	0	9	7	0	1200
27285	28	0	5	1151	0	1184
27286	13	1154	4	24	0	1195
27287	12	20	1	1167	0	1200
27288	5	7	2	1173	0	1187
27289	3	4	1150	28	0	1185
27290	1138	2	17	15	0	1172
27291	20	0	9	1181	0	1210
27292	14	1	6	1156	0	1177
27293	1128	1	3	31	0	1163
27294	21	1170	0	14	0	1205
27295	1193	21	1	8	0	1223
27296	28	7	0	1185	0	1220
27297	9	1153	1	25	0	1188
27298	1173	21	1	11	0	1206
27299	24	7	2	1169	0	1202
27300	1165	6	4	23	0	1198
27301	1158	3	1	10	0	1172
27302	1169	1	0	11	0	1181
27303	30	1124	2	11	0	1167
27304	15	1094	2	6	0	1117
27305	9	27	2	1081	0	1119
27306	7	1094	1	23	0	1125
27307	1102	24	1	12	0	1139
27308	25	11	1	1105	0	1142
27309	1096	5	2	25	0	1128
27310	1109	5	0	11	0	1125
27311	33	1	1	1093	0	1128
27312	16	1	1	1128	0	1146
27313	1126	1	0	31	0	1158
27314	1133	6	2	15	0	1156
27315	1163	4	0	11	0	1178
27316	1181	2	1	9	0	1193
27317	1198	2	1	9	0	1210
27318	40	1	0	1166	0	1207
27319	18	2	1	1170	0	1191
27320	14	2	3	1173	0	1192
27321	1158	6	2	34	0	1200
27322	28	3	0	1145	0	1176
27323	13	1145	0	31	0	1189
27324	10	21	2	1167	0	1200
27325	1143	10	1	28	0	1182
27326	1159	5	2	18	0	1184
27327	34	4	1119	13	0	1170
27328	19	4	22	1109	0	1154
27329	16	1129	9	25	0	1179
27330	1142	20	5	17	0	1184
27331	29	1147	3	10	0	1189
27332	18	25	1	1161	0	1205
27333	1177	13	1	29	0	1220
27334	1183	6	2	13	0	1204
27335	32	1170	2	17	0	1221
27336	19	22	0	1176	0	1217
27337	18	9	1136	27	0	1190
27338	1125	4	21	17	0	1167
27339	30	4	1144	12	0	1190
27340	1151	5	23	9	0	1188
27341	1167	3	10	7	0	1187
27342	32	7	5	1154	0	1198
27343	1180	3	4	27	0	1214
27344	1194	1	2	15	0	1212
27345	1194	3	4	9	0	1210
27346	40	5	2	1164	0	1211
27347	1165	3	0	28	0	1196
27348	36	3	1	1151	0	1191
27349	19	5	3	1148	0	1175
27350	10	1116	3	33	0	1162
27351	9	20	1	1101	0	1131
27352	13	1092	0	27	0	1132
27353	1084	20	1	16	0	1121
27354	1067	15	2	8	0	1092
27355	34	3	1	1051	0	1089
27356	16	5	0	1059	0	1080
27357	1046	3	2	26	0	1077
27358	30	3	1012	12	0	1057
27359	1037	1	14	14	0	1066
27360	28	1	7	1024	0	1060
27361	21	3	995	18	0	1037
27362	994	1	18	11	0	1024
27363	1017	2	5	9	0	1033
27364	29	1	1008	9	0	1047
27365	979	1	11	10	0	1001
27366	20	0	962	7	0	989
27367	12	947	11	9	0	979
27368	947	10	14	8	0	979
27369	942	8	2	5	0	957
27370	22	887	5	6	0	920
27371	12	814	1	2	0	829
27372	750	3	7	3	0	763
27373	740	0	1	5	0	746
27374	9	3	0	764	0	776
27375	3	1	754	4	0	762
27376	4	3	735	2	0	744
27377	753	1	4	4	0	762
27378	6	1	770	2	0	779
27379	712	9	16	2	0	739
27380	5	1	1	707	0	714
27381	3	0	0	712	0	715
27382	0	0	727	4	0	731
27383	728	0	4	2	0	734
27384	4	0	2	746	0	752
27385	2	0	1	790	0	793
27386	795	0	1	5	0	801
27387	799	0	0	5	0	804
27388	802	0	1	2	0	805
27389	6	833	0	1	0	840
27390	4	4	818	0	0	826
27391	799	0	3	4	0	806
27392	816	0	0	0	0	816
27393	3	795	0	2	0	800
27394	773	3	0	0	0	776
27395	3	0	0	755	0	758
27396	1	0	791	4	0	796
27397	796	1	3	0	0	800
27398	807	0	0	1	0	808
27399	815	0	0	2	0	817
27400	821	0	0	1	0	822
27401	4	0	0	829	0	833
27402	2	0	0	833	0	835
27403	836	0	1	4	0	841
27404	5	0	0	838	0	843
27405	0	0	0	836	0	836
27406	0	832	1	4	0	837
27407	2	4	0	854	0	860
27408	2	0	0	857	0	859
27409	0	1	1	856	0	858
27410	2	0	1	861	0	864
27411	1	847	0	5	0	853
27412	0	4	0	844	0	848
27413	1	1	0	825	0	827
27414	1	1	815	5	0	822
27415	1	0	777	1	0	779
27416	0	792	4	0	0	796
27417	931	4	0	0	0	935
27418	9	939	1	1	0	950
27419	2	10	0	1013	0	1025
27420	0	1	1081	11	0	1093
27421	1145	0	12	2	0	1159
27422	15	0	1	1185	0	1201
27423	1167	0	0	16	0	1183
27424	1187	0	0	3	0	1190
27425	13	1174	0	4	0	1191
27426	1170	14	0	0	0	1184
27427	15	1214	0	1	0	1230
27428	3	16	0	1243	0	1262
27429	3	1223	0	15	0	1241
27430	5	15	1225	3	0	1248
27431	1	1243	14	1	0	1259
27432	3	16	3	1235	0	1257
27433	1226	2	5	19	0	1252
27434	13	1245	4	2	0	1264
27435	6	17	1	1217	0	1241
27436	1	2	2	1242	0	1247
27437	5	2	1223	19	0	1249
27438	5	1	18	1221	0	1245
27439	3	1	1224	19	0	1247
27440	1221	1	17	5	0	1244
27441	18	3	1248	3	0	1272
27442	4	1245	17	3	0	1269
27443	3	19	3	1246	0	1271
27444	3	2	2	1260	0	1267
27445	2	6	1	1262	0	1271
27446	1253	1	2	23	0	1279
27447	20	3	1	1241	0	1265
27448	4	1244	1	22	0	1271
27449	1220	21	1	6	0	1248
27450	17	1224	3	5	0	1249
27451	5	20	3	1226	0	1254
27452	1221	4	1	23	0	1249
27453	22	1212	2	4	0	1240
27454	6	1259	0	4	0	1269
27455	1240	22	4	4	0	1270
27456	1252	5	2	7	0	1266
27457	23	2	1244	4	0	1273
27458	1249	1	20	8	0	1278
27459	25	3	1260	3	0	1291
27460	8	2	21	1278	0	1309
27461	5	4	1274	27	0	1310
27462	4	4	21	1278	0	1307
27463	3	1	1279	27	0	1310
27464	6	4	23	1260	0	1293
27465	2	0	4	1284	0	1290
27466	1259	2	3	31	0	1295
27467	22	6	1240	6	0	1274
27468	1192	4	21	7	0	1224
27469	25	2	1215	4	0	1246
27470	8	5	1211	3	0	1227
27471	4	3	24	1210	0	1241
27472	1204	4	5	24	0	1237
27473	23	1199	5	6	0	1233
27474	1185	21	1	7	0	1214
27475	1189	3	6	3	0	1201
27476	27	1164	3	3	0	1197
27477	1167	23	5	3	0	1198
27478	26	6	1169	4	0	1205
27479	5	3	24	1164	0	1196
27480	1163	1	4	30	0	1198
27481	22	1160	3	9	0	1194
27482	10	24	2	1142	0	1178
27483	5	5	4	1149	0	1163
27484	3	3	2	1160	0	1168
27485	7	1	2	1155	0	1165
27486	1124	4	2	26	0	1156
27487	1129	4	2	11	0	1146
27488	1145	1	2	5	0	1153
27489	1094	2	3	3	0	1102
27490	26	4	1074	5	0	1109
27491	1075	2	22	2	0	1101
27492	1099	2	4	3	0	1108
27493	28	1071	3	2	0	1104
27494	9	1096	1	2	0	1108
27495	6	25	3	1079	0	1113
27496	5	2	3	1083	0	1093
27497	2	3	1050	28	0	1083
27498	4	1072	21	9	0	1106
27499	2	26	4	1060	0	1092
27500	2	1051	4	23	0	1080
27501	3	21	2	1079	0	1105
27502	5	4	1	1084	0	1094
27503	2	1093	3	29	0	1127
27504	6	24	2	1108	0	1140
27505	6	4	1115	26	0	1151
27506	5	4	1132	5	0	1146
27507	1120	2	27	7	0	1156
27508	1154	2	8	3	0	1167
27509	26	1128	4	4	0	1162
27510	1137	26	2	2	0	1167
27511	31	4	4	1131	0	1170
27512	1130	4	1	26	0	1161
27513	28	1121	2	20	0	1171
27514	5	25	1130	7	0	1167
27515	1120	5	25	5	0	1155
27516	27	2	1155	6	0	1190
27517	6	1	1012	4	0	1023
27518	8	3	992	2	0	1005
27519	3	931	23	1	0	958
27520	826	26	36	5	0	893
27521	805	2	5	3	0	815
27522	18	2	1	782	0	803
27523	4	0	2	784	0	790
27524	3	798	1	17	0	819
27525	819	13	1	5	0	838
27526	16	821	1	2	0	840
27527	3	793	1	2	0	799
27528	768	18	4	1	0	791
27529	16	5	1	770	0	792
27530	8	1	0	775	0	784
27531	2	1	2	780	0	785
27532	0	767	0	17	0	784
27533	753	12	1	8	0	774
27534	14	3	0	752	0	769
27535	2	725	2	15	0	744
27536	2	738	0	4	0	744
27537	4	14	3	710	0	731
27538	2	726	0	11	0	739
27539	4	11	2	722	0	739
27540	698	4	3	16	0	721
27541	12	5	684	2	0	703
27542	4	700	9	4	0	717
27543	3	13	2	711	0	729
27544	1	2	712	12	0	727
27545	704	3	11	1	0	719
27546	13	2	2	716	0	733
27547	711	3	1	12	0	727
27548	715	1	1	5	0	722
27549	11	755	0	4	0	770
27550	759	10	2	4	0	775
27551	762	4	1	4	0	771
27552	764	1	1	4	0	770
27553	15	0	1	734	0	750
27554	4	2	0	733	0	739
27555	4	0	2	745	0	751
27556	3	0	730	13	0	746
27557	5	719	7	2	0	733
27558	706	10	1	2	0	719
27559	10	704	1	1	0	716
27560	3	9	0	687	0	699
27561	1	0	683	9	0	693
27562	654	2	10	1	0	667
27563	10	685	1	2	0	698
27564	0	12	2	681	0	695
27565	4	0	1	700	0	705
27566	1	2	687	9	0	699
27567	3	677	8	2	0	690
27568	0	9	1	690	0	700
27569	1	1	2	696	0	700
27570	4	1	1	678	0	684
27571	666	1	2	10	0	679
27572	8	2	665	2	0	677
27573	2	662	10	4	0	678
27574	657	9	0	6	0	672
27575	8	666	1	2	0	677
27576	2	10	0	660	0	672
27577	1	668	1	10	0	680
27578	645	9	0	3	0	657
27579	657	0	0	5	0	662
27580	10	3	0	663	0	676
27581	2	2	2	677	0	683
27582	4	4	0	704	0	712
27583	6	3	708	9	0	726
27584	1	746	10	4	0	761
27585	4	9	0	887	0	900
27586	1	2	1	930	0	934
27587	2	2	0	939	0	943
27588	4	1	2	930	0	937
27589	0	4	908	23	0	935
27590	4	938	18	9	0	969
27591	1	23	3	997	0	1024
27592	3	5	3	1074	0	1085
27593	2	4	1046	30	0	1082
27594	2	2	23	1049	0	1076
27595	3	1028	6	29	0	1066
27596	1	1071	4	13	0	1089
27597	3	25	2	1047	0	1077
27598	1	7	1005	25	0	1038
27599	960	8	21	11	0	1000
27600	22	996	6	8	0	1032
27601	6	22	970	8	0	1006
27602	5	5	992	7	0	1009
27603	3	973	25	8	0	1009
27604	4	22	980	5	0	1011
27605	12	18	23	930	0	983
27606	922	5	8	20	0	955
27607	933	3	4	9	0	949
27608	929	1	3	11	0	944
27609	945	4	5	6	0	960
27610	24	955	2	7	0	988
27611	965	23	1	8	0	997
27612	25	972	5	7	0	1009
27613	10	24	947	8	0	989
27614	7	10	22	941	0	980
27615	4	963	9	22	0	998
27616	1	28	6	940	0	975
27617	933	11	4	26	0	974
27618	20	4	7	910	0	941
27619	10	935	3	24	0	972
27620	941	22	3	12	0	978
27621	23	9	928	8	0	968
27622	15	4	20	918	0	957
27623	9	5	6	942	0	962
27624	893	5	7	25	0	930
27625	27	891	4	11	0	933
27626	9	27	885	4	0	925
27627	6	6	25	891	0	928
27628	3	4	886	27	0	920
27629	4	863	23	10	0	900
27630	3	889	8	7	0	907
27631	872	26	5	6	0	909
27632	24	7	861	8	0	900
27633	864	8	21	7	0	900
27634	26	3	7	854	0	890
27635	10	867	5	23	0	905
27636	858	25	5	10	0	898
27637	25	8	874	14	0	921
27638	10	7	19	871	0	907
27639	7	6	7	896	0	916
27640	7	4	6	882	0	899
27641	4	865	5	30	0	904
27642	826	23	7	14	0	870
27643	19	822	3	11	0	855
27644	7	839	4	13	0	863
27645	5	28	4	838	0	875
27646	839	12	4	22	0	877
27647	840	6	6	10	0	862
27648	849	6	6	9	0	870
27649	27	784	5	9	0	825
27650	15	18	2	783	0	818
27651	7	10	783	23	0	823
27652	6	7	23	785	0	821
27653	6	5	8	783	0	802
27654	6	773	4	33	0	816
27655	782	27	4	16	0	829
27656	24	8	4	773	0	809
27657	13	790	5	20	0	828
27658	791	27	4	8	0	830
27659	24	10	776	9	0	819
27660	775	6	23	10	0	814
27661	22	794	10	9	0	835
27662	807	24	4	4	0	839
27663	815	13	4	4	0	836
27664	29	5	796	6	0	836
27665	811	4	23	10	0	848
27666	30	3	831	9	0	873
27667	12	6	842	4	0	864
27668	825	8	25	4	0	862
27669	853	5	12	2	0	872
27670	27	5	839	6	0	877
27671	12	5	24	837	0	878
27672	7	7	9	853	0	876
27673	8	847	5	39	0	899
27674	859	20	2	12	0	893
27675	887	9	5	10	0	911
27676	31	8	871	3	0	913
27677	884	9	21	3	0	917
27678	916	5	11	5	0	937
27679	32	899	7	6	0	944
27680	12	19	9	898	0	938
27681	17	6	5	882	0	910
27682	5	7	1	871	0	884
27683	833	4	4	26	0	867
27684	21	794	4	12	0	831
27685	4	17	1	645	0	667
27686	1	628	1	7	0	637
27687	1	31	1	594	0	627
27688	3	603	1	7	0	614
27689	1	611	1	5	0	618
27690	534	19	7	9	0	569
27691	541	2	11	7	0	561
27692	5	2	0	501	0	508
27693	3	0	0	498	0	501
27694	1	0	1	505	0	507
27695	0	0	0	503	0	503
27696	0	0	0	501	0	501
27697	0	489	0	11	0	500
27698	0	4	0	501	0	505
27699	1	1	0	508	0	510
27700	515	2	0	5	0	522
27701	4	1	0	515	0	520
27702	1	0	0	513	0	514
27703	2	0	513	5	0	520
27704	1	0	3	500	0	504
27705	1	0	1	530	0	532
27706	0	1	551	5	0	557
27707	0	569	3	4	0	576
27708	0	5	589	1	0	595
27709	2	0	578	1	0	581
27710	0	548	3	0	0	551
27711	566	0	1	0	0	567
27712	559	1	0	0	0	560
27713	1	0	0	554	0	555
27714	571	0	0	0	0	571
27715	0	0	592	1	0	593
27716	1	0	0	608	0	609
27717	0	1	645	1	0	647
27718	1	0	0	659	0	660
27719	2	1	1	655	0	659
27720	2	0	1	661	0	664
27721	660	0	0	3	0	663
27722	0	1	1	679	0	681
27723	685	0	0	2	0	687
27724	686	0	0	2	0	688
27725	1	675	0	1	0	677
27726	684	0	0	1	0	685
27727	0	702	1	1	0	704
27728	3	0	0	701	0	704
27729	1	1	1	711	0	714
27730	2	1	1	717	0	721
27731	1	1	724	5	0	731
27732	0	717	3	1	0	721
27733	1	2	2	711	0	716
27734	0	3	0	713	0	716
27735	1	726	0	2	0	729
27736	726	2	4	3	0	735
27737	3	701	0	1	0	705
27738	707	2	0	2	0	711
27739	2	713	1	2	0	718
27740	1	2	0	709	0	712
27741	1	719	2	5	0	727
27742	727	2	1	4	0	734
27743	732	2	1	3	0	738
27744	743	1	1	4	0	749
27745	731	1	0	7	0	739
27746	4	1	752	2	0	759
27747	758	1	2	2	0	763
27748	777	1	1	3	0	782
27749	775	1	2	2	0	780
27750	6	0	781	1	0	788
27751	771	2	2	7	0	782
27752	3	797	3	2	0	805
27753	800	4	0	4	0	808
27754	3	2	857	2	0	864
27755	857	1	4	1	0	863
27756	870	0	2	3	0	875
27757	7	0	0	869	0	876
27758	2	0	868	5	0	875
27759	882	1	3	5	0	891
27760	5	0	1	926	0	932
27761	4	1	1	936	0	942
27762	2	1	945	4	0	952
27763	913	3	2	1	0	919
27764	950	1	1	4	0	956
27765	4	947	0	2	0	953
27766	3	2	1	939	0	945
27767	3	1	0	941	0	945
27768	2	0	0	938	0	940
27769	2	952	1	5	0	960
27770	945	4	2	1	0	952
27771	5	1	0	944	0	950
27772	3	0	0	943	0	946
27773	916	1	0	7	0	924
27774	903	0	2	2	0	907
27775	6	1	0	918	0	925
27776	4	1	0	901	0	906
27777	1	2	885	4	0	892
27778	855	0	4	6	0	865
27779	4	883	1	1	0	889
27780	3	2	0	957	0	962
27781	1	2	0	987	0	990
27782	2	1039	1	8	0	1050
27783	3	9	0	1070	0	1082
27784	1185	3	1	10	0	1199
27785	16	0	0	1376	0	1392
27786	5	0	1	1426	0	1432
27787	4	1	0	1436	0	1441
27788	1	0	1428	31	0	1460
27789	3	2	21	1437	0	1463
27790	1	2	1439	25	0	1467
27791	1	1397	19	19	0	1436
27792	1	20	14	1400	0	1435
27793	1	12	3	1425	0	1441
27794	6	2	3	1448	0	1459
27795	1	1	1	1484	0	1487
27796	2	2	3	1507	0	1514
27797	1441	2	0	37	0	1480
27798	25	0	1461	18	0	1504
27799	10	1434	17	10	0	1471
27800	0	1488	13	9	0	1510
27801	1	29	2	1527	0	1559
27802	8	11	4	1534	0	1557
27803	3	5	1	1529	0	1538
27804	0	1506	4	37	0	1547
27805	2	25	0	1505	0	1532
27806	0	14	1474	26	0	1514
27807	1	1444	20	21	0	1486
27808	4	20	11	1465	0	1500
27809	1443	12	1	31	0	1487
27810	20	3	4	1466	0	1493
27811	13	3	3	1455	0	1474
27812	1	1421	7	34	0	1463
27813	4	1486	1	18	0	1509
27814	2	32	1	1471	0	1506
27815	4	12	0	1475	0	1491
27816	4	2	1455	41	0	1502
27817	2	3	19	1430	0	1454
27818	2	6	12	1430	0	1450
27819	2	2	1	1434	0	1439
27820	3	1	6	1447	0	1457
27821	1396	3	4	41	0	1444
27822	1411	4	7	23	0	1445
27823	35	3	1	1411	0	1450
27824	12	2	1	1460	0	1475
27825	1427	2	1	49	0	1479
27826	23	4	4	1473	0	1504
27827	17	2	1492	33	0	1544
27828	5	1507	24	23	0	1559
27829	4	22	15	1534	0	1575
27830	4	12	8	1560	0	1584
27831	1534	5	2	47	0	1588
27832	23	6	2	1565	0	1596
27833	15	4	3	1590	0	1612
27834	1583	5	1	49	0	1638
27835	25	4	0	1603	0	1632
27836	17	1590	0	37	0	1644
27837	9	22	2	1676	0	1709
27838	5	14	7	1715	0	1741
27839	6	5	2	1727	0	1740
27840	6	7	1	1734	0	1748
27841	3	4	1678	50	0	1735
27842	3	8	1666	27	0	1704
27843	5	4	36	1679	0	1724
27844	3	5	11	1689	0	1708
27845	7	1675	2	50	0	1734
27846	4	24	7	1652	0	1687
27847	2	1649	6	34	0	1691
27848	1639	28	7	25	0	1699
27849	26	1705	3	22	0	1756
27850	16	29	1	1733	0	1779
27851	2	17	3	1767	0	1789
27852	4	5	1713	49	0	1771
27853	1686	9	25	27	0	1747
27854	1678	3	13	21	0	1715
27855	37	1652	4	20	0	1713
27856	14	30	8	1647	0	1699
27857	6	15	1707	38	0	1766
27858	6	1744	28	24	0	1802
27859	1700	30	14	18	0	1762
27860	1716	16	0	19	0	1751
27861	40	6	1651	18	0	1715
27862	1669	2	27	15	0	1713
27863	28	5	19	1660	0	1712
27864	17	1651	5	37	0	1710
27865	1653	25	1	24	0	1703
27866	31	15	5	1653	0	1704
27867	1670	5	5	34	0	1714
27868	1738	9	2	25	0	1774
27869	39	9	2	1721	0	1771
27870	16	6	1733	34	0	1789
27871	1748	6	26	21	0	1801
27872	1776	6	12	19	0	1813
27873	1808	0	4	16	0	1828
27874	46	1804	5	8	0	1863
27875	17	25	6	1818	0	1866
27876	9	19	3	1871	0	1902
27877	9	7	1847	45	0	1908
27878	7	11	26	1830	0	1874
27879	9	1824	18	33	0	1884
27880	1761	28	2	22	0	1813
27881	26	1745	5	10	0	1786
27882	21	22	1687	9	0	1739
27883	5	1702	24	13	0	1744
27884	6	1658	16	6	0	1686
27885	20	14	9	1403	0	1446
27886	1404	6	3	10	0	1423
27887	1411	1	1	6	0	1419
27888	1383	3	1	5	0	1392
27889	15	1394	2	4	0	1415
27890	6	10	1381	3	0	1400
27891	1393	6	9	5	0	1413
27892	1422	2	5	8	0	1437
27893	13	1410	2	1	0	1426
27894	1425	9	2	4	0	1440
27895	14	5	2	1425	0	1446
27896	4	4	1492	10	0	1510
27897	1499	2	9	9	0	1519
27898	1499	1	4	5	0	1509
27899	1552	1	2	8	0	1563
27900	19	2	0	1530	0	1551
27901	8	1	1	1608	0	1618
27902	7	3	1	1692	0	1703
27903	3	1714	5	20	0	1742
27904	12	13	4	1767	0	1796
27905	4	3	1	1949	0	1957
27906	4	5	1956	22	0	1987
27907	3	2	13	1960	0	1978
27908	7	1	4	1987	0	1999
27909	6	3	3	1980	0	1992
27910	7	3	3	1978	0	1991
27911	1	1958	3	29	0	1991
27912	6	13	6	1976	0	2001
27913	4	6	1	1969	0	1980
27914	1952	6	2	24	0	1984
27915	17	2	1934	13	0	1966
27916	8	7	1885	8	0	1908
27917	1889	2	22	8	0	1921
27918	1942	6	9	6	0	1963
27919	19	6	3	1866	0	1894
27920	9	1928	0	20	0	1957
27921	1968	12	2	8	0	1990
27922	22	5	4	1931	0	1962
27923	8	1964	3	19	0	1994
27924	1946	15	2	16	0	1979
27925	15	1968	3	7	0	1993
27926	1939	15	4	9	0	1967
27927	1888	8	2	6	0	1904
27928	19	1847	3	5	0	1874
27929	11	13	1	1852	0	1877
27930	7	6	1838	16	0	1867
27931	9	6	14	1809	0	1838
27932	1822	2	8	20	0	1852
27933	17	5	1769	7	0	1798
27934	15	1759	8	5	0	1787
27935	8	17	5	1748	0	1778
27936	4	6	1740	16	0	1766
27937	3	1698	12	9	0	1722
27938	1694	9	6	12	0	1721
27939	12	6	4	1706	0	1728
27940	6	7	3	1701	0	1717
27941	5	5	4	1690	0	1704
27942	1	1681	3	22	0	1707
27943	1683	9	3	16	0	1711
27944	13	1659	2	9	0	1683
27945	8	1682	0	7	0	1697
27946	1688	13	3	10	0	1714
27947	1690	8	3	11	0	1712
27948	13	4	1662	7	0	1686
27949	1618	4	15	6	0	1643
27950	1613	5	9	3	0	1630
27951	17	7	4	1597	0	1625
27952	14	4	1583	14	0	1615
27953	11	6	9	1587	0	1613
27954	1597	7	6	16	0	1626
27955	14	4	1622	11	0	1651
27956	13	6	12	1761	0	1792
27957	17	2	4	1995	0	2018
27958	11	7	3	2139	0	2160
27959	2168	5	4	38	0	2215
27960	24	2182	3	24	0	2233
27961	2191	24	4	13	0	2232
27962	31	8	2198	11	0	2248
27963	21	6	25	2190	0	2242
27964	9	2230	11	29	0	2279
27965	2244	24	9	18	0	2295
27966	30	8	7	2249	0	2294
27967	15	15	2198	27	0	2255
27968	9	7	28	2165	0	2209
27969	2122	5	13	32	0	2172
27970	24	2104	6	23	0	2157
27971	17	21	5	1987	0	2030
27972	9	2087	3	31	0	2130
27973	2073	28	1	16	0	2118
27974	2053	9	5	15	0	2082
27975	32	2024	4	12	0	2072
27976	2029	26	3	7	0	2065
27977	35	10	4	1958	0	2007
27978	13	1990	1	24	0	2028
27979	1979	25	4	11	0	2019
27980	1999	9	4	12	0	2024
27981	30	1920	5	11	0	1966
27982	20	1937	1	8	0	1966
27983	1925	26	5	8	0	1964
27984	30	11	2	1909	0	1952
27985	1920	7	5	24	0	1956
27986	28	6	3	1911	0	1948
27987	18	6	1878	26	0	1928
27988	9	6	23	1904	0	1942
27989	1881	4	4	33	0	1922
27990	28	7	1877	14	0	1926
27991	14	6	20	1876	0	1916
27992	19	2	6	1918	0	1945
27993	9	7	1881	30	0	1927
27994	1846	5	24	16	0	1891
27995	30	4	8	1876	0	1918
27996	11	5	1789	30	0	1835
27997	1722	5	22	15	0	1764
27998	27	1774	9	9	0	1819
27999	10	1727	5	16	0	1758
28000	11	1780	9	7	0	1807
28001	7	19	1685	11	0	1722
28002	11	31	21	1588	0	1651
28003	5	10	1577	22	0	1614
28004	12	28	27	1406	0	1473
28005	2	1367	8	19	0	1396
28006	8	1348	5	10	0	1371
28007	7	17	8	1345	0	1377
28008	1345	8	3	22	0	1378
28009	22	9	0	1357	0	1388
28010	10	3	3	1355	0	1371
28011	6	1341	4	23	0	1374
28012	1326	18	2	10	0	1356
28013	19	1340	3	11	0	1373
28014	6	21	2	1355	0	1384
28015	7	10	1	1348	0	1366
28016	6	1332	3	24	0	1365
28017	7	20	2	1348	0	1377
28018	1337	5	2	31	0	1375
28019	24	9	4	1343	0	1380
28020	9	11	2	1333	0	1355
28021	14	1318	3	22	0	1357
28022	13	20	5	1328	0	1366
28023	1277	7	5	33	0	1322
28024	1298	10	5	16	0	1329
28025	1309	10	1	14	0	1334
28026	34	8	3	1294	0	1339
28027	17	6	1276	24	0	1323
28028	11	4	1276	16	0	1307
28029	14	7	23	1290	0	1334
28030	1295	10	6	25	0	1336
28031	20	9	7	1305	0	1341
28032	1312	8	4	25	0	1349
28033	30	6	2	1327	0	1365
28034	23	5	2	1337	0	1367
28035	1324	9	1	30	0	1364
28036	33	10	1296	10	0	1349
28037	1292	3	16	15	0	1326
28038	26	8	1297	9	0	1340
28039	18	11	19	1279	0	1327
28040	1294	5	7	26	0	1332
28041	33	5	1292	9	0	1339
28042	11	9	1291	10	0	1321
28043	1295	9	20	12	0	1336
28044	26	6	1286	12	0	1330
28045	14	1277	24	11	0	1326
28046	11	19	8	1331	0	1369
28047	1374	5	9	27	0	1415
28048	22	4	1373	17	0	1416
28049	1378	5	20	16	0	1419
28050	1402	3	12	12	0	1429
28051	1401	4	9	12	0	1426
28052	1399	4	11	14	0	1428
28053	28	4	8	1370	0	1410
28054	17	1364	8	23	0	1412
28055	1330	19	7	13	0	1369
28056	20	11	1166	10	0	1207
28057	2	876	8	6	0	892
28058	727	9	10	2	0	748
28059	3	666	4	2	0	675
28060	1	675	0	0	0	676
28061	15	3	12	668	0	698
28062	1	1	0	682	0	684
28063	0	0	0	678	0	678
28064	702	0	1	3	0	706
28065	748	0	1	3	0	752
28066	8	1	0	775	0	784
28067	5	1	0	850	0	856
28068	2	1	914	10	0	927
28069	911	0	6	5	0	922
28070	932	0	4	5	0	941
28071	8	0	2	941	0	951
28072	9	1	0	946	0	956
28073	3	0	935	11	0	949
28074	1	1	11	945	0	958
28075	0	1	967	10	0	978
28076	2	974	10	6	0	992
28077	2	10	974	3	0	989
28078	1	4	10	968	0	983
28079	1	3	1003	9	0	1016
28080	1	0	984	6	0	991
28081	1015	0	14	2	0	1031
28082	9	3	5	1057	0	1074
28083	4	0	1060	11	0	1075
28084	1028	1	9	6	0	1044
28085	10	1	1065	2	0	1078
28086	7	1	1149	1	0	1158
28087	4	1151	14	2	0	1171
28088	2	9	7	1164	0	1182
28089	2	5	1158	9	0	1174
28090	1	3	1106	7	0	1117
28091	4	1	15	1142	0	1162
28092	5	0	5	1138	0	1148
28093	2	1153	2	18	0	1175
28094	4	10	2	1176	0	1192
28095	1180	5	2	16	0	1203
28096	1180	3	5	9	0	1197
28097	1208	1	6	4	0	1219
28098	19	0	2	1180	0	1201
28099	8	1184	4	12	0	1208
28100	1197	10	2	12	0	1221
28101	12	1201	2	4	0	1219
28102	12	1181	3	5	0	1201
28103	5	1185	3	4	0	1197
28104	1206	15	2	6	0	1229
28105	12	6	4	1200	0	1222
28106	7	3	1	1209	0	1220
28107	4	1208	2	16	0	1230
28108	1185	9	3	11	0	1208
28109	14	8	1172	3	0	1197
28110	9	2	13	1181	0	1205
28111	1180	1	7	15	0	1203
28112	12	1215	5	7	0	1239
28113	1255	13	4	7	0	1279
28114	17	6	1	1265	0	1289
28115	4	1285	2	16	0	1307
28116	6	13	1274	4	0	1297
28117	1277	5	13	2	0	1297
28118	15	3	6	1294	0	1318
28119	1310	0	4	13	0	1327
28120	14	3	0	1304	0	1321
28121	8	1290	0	12	0	1310
28122	6	10	1339	7	0	1362
28123	2	7	1361	3	0	1373
28124	6	9	13	1374	0	1402
28125	1377	1	8	12	0	1398
28126	1385	3	2	5	0	1395
28127	16	1	0	1375	0	1392
28128	7	0	2	1387	0	1396
28129	1388	3	2	13	0	1406
28130	13	0	2	1399	0	1414
28131	1399	0	0	17	0	1416
28132	13	1386	0	11	0	1410
28133	1398	9	2	9	0	1418
28134	13	6	1379	3	0	1401
28135	7	7	9	1399	0	1422
28136	5	0	9	1439	0	1453
28137	6	2	4	1432	0	1444
28138	3	1395	4	23	0	1425
28139	6	1311	3	14	0	1334
28140	4	15	2	1414	0	1435
28141	5	8	1429	14	0	1456
28142	3	3	14	1449	0	1469
28143	4	0	9	1469	0	1482
28144	4	8	4	1475	0	1491
28145	1449	3	6	19	0	1477
28146	12	1399	3	9	0	1423
28147	7	1421	4	5	0	1437
28148	2	18	5	1404	0	1429
28149	3	11	6	1426	0	1446
28150	4	2	3	1439	0	1448
28151	3	0	6	1443	0	1452
28152	1420	4	1	19	0	1444
28153	11	1408	3	15	0	1437
28154	1442	13	3	7	0	1465
28155	1491	5	7	9	0	1512
28156	15	3	5	1493	0	1516
28157	7	1	2	1509	0	1519
28158	1501	1	2	21	0	1525
28159	1507	3	1	10	0	1521
28160	16	4	1	1485	0	1506
28161	12	5	0	1482	0	1499
28162	9	2	1457	21	0	1489
28163	5	1426	10	11	0	1452
28164	4	1462	3	11	0	1480
28165	1410	9	3	3	0	1425
28166	13	2	1426	2	0	1443
28167	7	4	1320	2	0	1333
28168	1245	0	9	3	0	1257
28169	1275	1	3	1	0	1280
28170	8	1351	0	3	0	1362
28171	3	1390	4	2	0	1399
28172	3	7	2	1407	0	1419
28173	1471	1	0	9	0	1481
28174	1472	0	0	8	0	1480
28175	1471	1	1	2	0	1475
28176	6	1	2	1471	0	1480
28177	1	3	0	1486	0	1490
28178	1	2	1482	5	0	1490
28179	2	1	1395	4	0	1402
28180	0	0	1485	1	0	1486
28181	6	11	7	1463	0	1487
28182	1476	0	1	5	0	1482
28183	4	0	1520	1	0	1525
28184	3	1	4	1519	0	1527
28185	1	1552	2	6	0	1561
28186	2	4	0	1505	0	1511
28187	2	1	0	1537	0	1540
28188	1	0	1595	7	0	1603
28189	2	0	7	1586	0	1595
28190	1733	1	2	8	0	1744
28191	12	0	1761	2	0	1775
28192	7	0	8	1763	0	1778
28193	1	0	1839	10	0	1850
28194	0	1850	8	4	0	1862
28195	1	11	1866	2	0	1880
28196	9	12	13	1778	0	1812
28197	1	2	8	1863	0	1874
28198	0	4	1901	21	0	1926
28199	3	3	12	1855	0	1873
28200	3	0	8	1850	0	1861
28201	1	1861	3	15	0	1880
28202	1	10	1874	8	0	1893
28203	1	8	11	1898	0	1918
28204	2	2	9	1902	0	1915
28205	2	1894	4	18	0	1918
28206	3	11	1	1925	0	1940
28207	1930	8	0	17	0	1955
28208	15	3	2	1936	0	1956
28209	9	1	1956	15	0	1981
28210	1938	1	12	15	0	1966
28211	2120	2	6	8	0	2136
28212	25	1	2098	2	0	2126
28213	2047	0	19	8	0	2074
28214	17	2111	9	11	0	2148
28215	13	19	3	2165	0	2200
28216	6	12	2	2412	0	2432
28217	3	4	1	2424	0	2432
28218	9	1	1	2465	0	2476
28219	6	1	0	2469	0	2476
28220	2439	3	2	41	0	2485
28221	26	1	2412	18	0	2457
28222	2341	1	23	12	0	2377
28223	27	0	2361	10	0	2398
28224	20	1	24	2344	0	2389
28225	2365	4	11	32	0	2412
28226	29	1	8	2363	0	2401
28227	15	2378	6	32	0	2431
28228	2432	19	6	23	0	2480
28229	36	12	3	2510	0	2561
28230	17	5	2382	34	0	2438
28231	2419	2	18	19	0	2458
28232	31	2549	12	12	0	2604
28233	14	27	2594	10	0	2645
28234	18	12	26	2581	0	2637
28235	19	6	14	2543	0	2582
28236	4	2574	10	42	0	2630
28237	8	22	2578	24	0	2632
28238	9	16	24	2584	0	2633
28239	2	9	2663	34	0	2708
28240	6	4	34	2645	0	2689
28241	8	2	17	2632	0	2659
28242	10	5	2615	47	0	2677
28243	11	7	32	2613	0	2663
28244	24	3	27	2312	0	2366
28245	9	4	16	2758	0	2787
28246	11	2	7	2760	0	2780
28247	2678	4	6	66	0	2754
28248	30	4	2647	33	0	2714
28249	2782	5	37	27	0	2851
28250	40	4	20	2880	0	2944
28251	23	5	18	2923	0	2969
28252	22	2	13	2912	0	2949
28253	17	2862	8	66	0	2953
28254	2893	45	15	39	0	2992
28255	44	21	11	3076	0	3152
28256	23	3067	6	62	0	3158
28257	15	28	10	3117	0	3170
28258	3112	19	14	59	0	3204
28259	3116	15	8	45	0	3184
28260	3112	10	12	28	0	3162
28261	51	3076	15	38	0	3180
28262	30	35	3099	29	0	3193
28263	3103	22	37	27	0	3189
28264	3135	12	22	31	0	3200
28265	53	3144	15	24	0	3236
28266	3154	29	11	22	0	3216
28267	3121	24	6	24	0	3175
28268	3157	12	8	30	0	3207
28269	64	3215	14	22	0	3315
28270	45	32	12	3224	0	3313
28271	3236	24	7	59	0	3326
28272	3321	13	9	41	0	3384
28273	3272	7	5	40	0	3324
28274	3307	7	7	29	0	3350
28275	70	15	6	3257	0	3348
28276	38	10	3237	52	0	3337
28277	35	6	32	3266	0	3339
28278	29	3262	19	54	0	3364
28279	27	37	11	3379	0	3454
28280	27	22	3379	48	0	3476
28281	3378	13	36	35	0	3462
28282	66	7	21	3435	0	3529
28283	3391	12	14	56	0	3473
28284	3431	17	8	35	0	3491
28285	72	13	5	3423	0	3513
28286	44	3	3428	53	0	3528
28287	39	17	3227	24	0	3307
28288	3240	11	42	23	0	3316
28289	53	3271	26	19	0	3369
28290	39	3139	14	10	0	3202
28291	30	3179	8	19	0	3236
28292	23	3267	8	17	0	3315
28293	3168	50	19	19	0	3256
28294	3180	19	9	17	0	3225
28295	3165	16	6	16	0	3203
28296	3179	15	6	12	0	3212
28297	55	15	5	3119	0	3194
28298	30	3096	10	43	0	3179
28299	3103	33	7	25	0	3168
28300	54	16	3087	18	0	3175
28301	35	3092	31	25	0	3183
28302	32	33	3075	11	0	3151
28303	3043	10	41	15	0	3109
28304	3094	9	17	20	0	3140
28305	3132	12	9	13	0	3166
28306	58	10	10	3097	0	3175
28307	31	13	3103	37	0	3184
28308	28	3096	38	10	0	3172
28309	3031	29	19	16	0	3095
28310	49	3003	11	9	0	3072
28311	26	2848	6	10	0	2890
28312	25	2837	3	15	0	2880
28313	24	2850	10	8	0	2892
28314	20	32	2757	6	0	2815
28315	28	2737	22	8	0	2795
28316	2515	24	7	13	0	2559
28317	27	10	7	2513	0	2557
28318	15	6	7	2525	0	2553
28319	2498	10	3	28	0	2539
28320	26	2473	6	13	0	2518
28321	16	22	2531	9	0	2578
28322	19	10	19	2533	0	2581
28323	18	5	6	2577	0	2606
28324	12	10	8	2593	0	2623
28325	15	5	2563	23	0	2606
28326	7	12	2510	21	0	2550
28327	16	5	24	2544	0	2589
28328	9	6	2544	20	0	2579
28329	11	7	2398	10	0	2426
28330	2303	9	22	8	0	2342
28331	21	2430	11	10	0	2472
28332	7	2356	9	8	0	2380
28333	12	2414	6	7	0	2439
28334	14	22	12	2336	0	2384
28335	8	2458	4	19	0	2489
28336	2504	18	7	14	0	2543
28337	24	11	2527	2	0	2564
28338	2590	6	15	13	0	2624
28339	26	9	11	2596	0	2642
28340	16	7	6	2651	0	2680
28341	15	2711	10	30	0	2766
28342	2705	28	6	17	0	2756
28343	2731	10	11	12	0	2764
28344	38	2932	5	9	0	2984
28345	17	45	3	2835	0	2900
28346	15	11	2877	27	0	2930
28347	13	6	2852	12	0	2883
28348	9	2936	38	6	0	2989
28349	2877	44	9	11	0	2941
28350	39	7	2854	7	0	2907
28351	16	3	37	2820	0	2876
28352	2879	7	10	39	0	2935
28353	2954	1	4	14	0	2973
28354	44	3440	6	4	0	3494
28355	12	3594	6	4	0	3616
28356	3574	71	4	8	0	3657
28357	69	18	3567	1	0	3655
28358	3570	11	64	3	0	3648
28359	3653	12	11	8	0	3684
28360	84	9	7	3582	0	3682
28361	21	8	3642	66	0	3737
28362	17	9	3611	17	0	3654
28363	3543	7	76	11	0	3637
28364	76	7	3597	5	0	3685
28365	3486	5	77	7	0	3575
28366	3592	4	17	10	0	3623
28367	77	3549	13	8	0	3647
28368	24	65	3530	8	0	3627
28369	16	3458	72	3	0	3549
28370	3422	68	19	9	0	3518
28371	72	18	3366	6	0	3462
28372	23	22	72	3265	0	3382
28373	22	8	3308	66	0	3404
28374	17	12	3342	14	0	3385
28375	19	8	3328	7	0	3362
28376	18	12	3329	3	0	3362
28377	14	3239	85	9	0	3347
28378	13	66	3241	7	0	3327
28379	15	3148	81	6	0	3250
28380	13	68	3111	7	0	3199
28381	3086	17	73	5	0	3181
28382	71	12	26	2977	0	3086
28383	26	3104	24	55	0	3209
28384	3077	66	16	19	0	3178
28385	3097	22	16	12	0	3147
28386	2972	15	15	14	0	3016
28387	3070	14	20	10	0	3114
28388	84	3025	17	8	0	3134
28389	2906	65	21	18	0	3010
28390	3057	23	18	6	0	3104
28391	88	2900	18	14	0	3020
28392	35	69	2818	9	0	2931
28393	31	21	75	2800	0	2927
28394	26	2892	32	62	0	3012
28395	20	72	2891	23	0	3006
28396	20	31	2929	9	0	2989
28397	25	2857	89	11	0	2982
28398	24	2914	37	6	0	2981
28399	25	3002	31	9	0	3067
28400	30	2935	25	7	0	2997
28401	2945	87	23	17	0	3072
28402	2993	43	26	9	0	3071
28403	95	24	2974	10	0	3103
28404	48	30	3004	2	0	3084
28405	35	25	95	2945	0	3100
28406	39	21	35	3016	0	3111
28407	37	21	29	3003	0	3090
28408	2963	20	27	90	0	3100
28409	95	2944	25	29	0	3093
28410	42	3079	24	19	0	3164
28411	37	3116	32	14	0	3199
28412	3028	104	31	15	0	3178
28413	3085	48	28	18	0	3179
28414	113	27	33	3003	0	3176
28415	3076	31	36	78	0	3221
28416	3140	28	34	24	0	3226
28417	127	28	34	3058	0	3247
28418	3072	24	31	89	0	3216
28419	108	3041	35	29	0	3213
28420	55	91	33	3042	0	3221
28421	50	41	2969	74	0	3134
28422	47	2954	101	28	0	3130
28423	48	99	2986	22	0	3155
28424	50	40	109	2873	0	3072
28425	39	3001	62	73	0	3175
28426	57	92	45	2979	0	3173
28427	48	40	39	3031	0	3158
28428	41	30	2963	104	0	3138
28429	37	36	3109	32	0	3214
28430	37	31	125	3046	0	3239
28431	42	28	63	3004	0	3137
28432	26	3063	57	92	0	3238
28433	2944	94	37	46	0	3121
28434	109	2969	43	22	0	3143
28435	54	3016	31	28	0	3129
28436	32	109	2890	21	0	3052
28437	31	2832	95	22	0	2980
28438	43	105	48	2637	0	2833
28439	26	2740	44	87	0	2897
28440	33	98	26	2610	0	2767
28441	31	2628	34	77	0	2770
28442	2605	100	29	33	0	2767
28443	90	2615	35	25	0	2765
28444	43	82	23	2290	0	2438
28445	27	2382	17	66	0	2492
28446	2338	79	32	27	0	2476
28447	2334	46	14	21	0	2415
28448	86	2306	20	11	0	2423
28449	2203	65	20	8	0	2296
28450	69	65	16	2106	0	2256
28451	33	31	2136	59	0	2259
28452	37	24	2139	25	0	2225
28453	30	2107	65	19	0	2221
28454	1428	26	37	5	0	1496
28455	1418	11	7	7	0	1443
28456	32	7	1395	8	0	1442
28457	11	5	1385	7	0	1408
28458	1338	7	23	6	0	1374
28459	1369	2	10	7	0	1388
28460	29	8	1337	4	0	1378
28461	1289	6	22	3	0	1320
28462	31	1282	9	2	0	1324
28463	6	1341	4	8	0	1359
28464	8	29	11	1300	0	1348
28465	6	14	7	1316	0	1343
28466	1299	8	4	28	0	1339
28467	1302	3	8	11	0	1324
28468	1312	5	5	10	0	1332
28469	31	5	6	1290	0	1332
28470	15	5	2	1303	0	1325
28471	12	1237	2	27	0	1278
28472	7	1263	6	9	0	1285
28473	6	1296	7	7	0	1316
28474	10	33	2	1228	0	1273
28475	6	1257	2	21	0	1286
28476	4	32	1214	9	0	1259
28477	1167	10	23	11	0	1211
28478	21	16	1190	6	0	1233
28479	10	11	1191	5	0	1217
28480	1153	8	27	4	0	1192
28481	25	1164	9	4	0	1202
28482	1171	24	7	7	0	1209
28483	1178	12	4	9	0	1203
28484	30	8	1180	4	0	1222
28485	16	4	1206	3	0	1229
28486	15	1201	27	4	0	1247
28487	8	28	1238	2	0	1276
28488	6	12	27	1249	0	1294
28489	8	5	11	1140	0	1164
28490	5	1242	13	23	0	1283
28491	6	1278	7	10	0	1301
28492	1267	32	3	9	0	1311
28493	1316	17	4	6	0	1343
28494	33	9	8	1305	0	1355
28495	16	6	8	1323	0	1353
28496	1296	4	7	32	0	1339
28497	1309	7	4	13	0	1333
28498	31	1339	3	13	0	1386
28499	1245	24	5	4	0	1278
28500	28	1196	3	4	0	1231
28501	6	1244	6	2	0	1258
28502	1240	27	5	4	0	1276
28503	1228	15	3	6	0	1252
28504	28	3	5	1212	0	1248
28505	1218	5	3	21	0	1247
28506	25	12	1191	4	0	1232
28507	15	1194	20	7	0	1236
28508	1180	24	4	9	0	1217
28509	25	5	1206	8	0	1244
28510	11	7	17	1102	0	1137
28511	9	1100	13	14	0	1136
28512	8	1126	8	5	0	1147
28513	1131	22	5	5	0	1163
28514	19	9	1108	1	0	1137
28515	1056	8	13	2	0	1079
28516	25	1	7	1071	0	1104
28517	8	5	1073	11	0	1097
28518	1099	3	15	6	0	1123
28519	18	1146	4	6	0	1174
28520	8	1210	4	1	0	1223
28521	1219	17	6	2	0	1244
28522	1214	10	0	5	0	1229
28523	1239	7	1	8	0	1255
28524	22	3	1	1231	0	1257
28525	8	5	1	1235	0	1249
28526	11	0	1216	15	0	1242
28527	6	2	1191	8	0	1207
28528	7	1220	14	8	0	1249
28529	3	13	11	1123	0	1150
28530	1116	2	4	7	0	1129
28531	5	1113	0	6	0	1124
28532	5	10	1	1129	0	1145
28533	1138	4	1	10	0	1153
28534	7	1125	1	4	0	1137
28535	5	1228	1	4	0	1238
28536	5	7	1204	1	0	1217
28537	1201	7	6	4	0	1218
28538	1230	6	3	3	0	1242
28539	7	2	1224	3	0	1236
28540	1159	0	7	1	0	1167
28541	8	3	1203	2	0	1216
28542	5	1183	8	0	0	1196
28543	5	5	2	1192	0	1204
28544	1181	1	4	9	0	1195
28545	6	1175	1	2	0	1184
28546	2	1185	2	1	0	1190
28547	1172	4	1	0	0	1177
28548	5	4	1243	1	0	1253
28549	1234	2	4	6	0	1246
28550	5	1275	3	3	0	1286
28551	1	4	1225	1	0	1231
28552	1244	0	3	1	0	1248
28553	1275	3	2	1	0	1281
28554	6	0	2	1283	0	1291
28555	3	3	1	1302	0	1309
28556	1	1302	1	3	0	1307
28557	3	3	1309	6	0	1321
28558	4	1	2	1336	0	1343
28559	1	4	1385	8	0	1398
28560	6	2	1387	0	0	1395
28561	4	1	8	1477	0	1490
28562	1	3	1515	10	0	1529
28563	3	0	1502	1	0	1506
28564	4	1	11	1499	0	1515
28565	3	1	1534	11	0	1549
28566	1472	0	12	1	0	1485
28567	13	1494	3	4	0	1514
28568	3	11	1531	2	0	1547
28569	4	3	1645	1	0	1653
28570	4	4	10	1632	0	1650
28571	1712	0	5	12	0	1729
28572	1721	0	4	0	0	1725
28573	1717	1	1	5	0	1724
28574	1731	1	2	2	0	1736
28575	12	1	3	1708	0	1724
28576	5	1	1764	11	0	1781
28577	1779	1	12	0	0	1792
28578	1815	0	3	3	0	1821
28579	1825	1	3	2	0	1831
28580	14	2	1789	1	0	1806
28581	1754	3	12	1	0	1770
28582	14	0	1	1888	0	1903
28583	1	1931	4	16	0	1952
28584	6	11	1	1902	0	1920
28585	2	1919	1	14	0	1936
28586	1957	13	0	4	0	1974
28587	14	0	1981	1	0	1996
28588	3	4	15	1936	0	1958
28589	1	1973	1	15	0	1990
28590	1	2023	5	0	0	2029
28591	2033	15	3	3	0	2054
28592	2026	4	1	2	0	2033
28593	17	1	1963	0	0	1981
28594	1974	0	19	2	0	1995
28595	18	1	0	1990	0	2009
28596	4	0	2039	17	0	2060
28597	3	2	2016	2	0	2023
28598	5	0	16	2086	0	2107
28599	2200	1	2	25	0	2228
28600	20	0	2	2207	0	2229
28601	2	2	4	2211	0	2219
28602	5	4	1	2206	0	2216
28603	4	2219	1	21	0	2245
28604	5	18	0	2237	0	2260
28605	2193	2	5	21	0	2221
28606	23	2204	1	8	0	2236
28607	3	19	2	2229	0	2253
28608	2219	5	3	23	0	2250
28609	19	2174	4	6	0	2203
28610	3	2231	3	3	0	2240
28611	8	22	3	2217	0	2250
28612	2195	3	4	27	0	2229
28613	25	5	2182	7	0	2219
28614	6	5	2162	3	0	2176
28615	2213	7	28	6	0	2254
28616	2311	0	7	5	0	2323
28617	32	2333	2	5	0	2372
28618	8	29	3	2262	0	2302
28619	9	6	2250	26	0	2291
28620	5	5	2217	10	0	2237
28621	6	1	2373	5	0	2385
28622	6	2348	35	3	0	2392
28623	2	2379	8	6	0	2395
28624	2388	31	4	3	0	2426
28625	30	6	2372	8	0	2416
28626	2341	3	33	7	0	2384
28627	2376	1	12	9	0	2398
28628	33	5	2372	19	0	2429
28629	14	2431	26	6	0	2477
28630	12	34	4	2401	0	2451
28631	5	10	2469	32	0	2516
28632	4	3	2390	14	0	2411
28633	2371	2	36	13	0	2422
28634	31	2432	11	7	0	2481
28635	7	33	7	2350	0	2397
28636	7	10	1	2365	0	2383
28637	9	2350	1	33	0	2393
28638	6	2409	7	9	0	2431
28639	6	2444	6	5	0	2461
28640	17	37	2	2504	0	2560
28641	2583	9	5	40	0	2637
28642	39	9	2	2613	0	2663
28643	9	3	2615	47	0	2674
28644	7	3	2619	8	0	2637
28645	5	5	46	2626	0	2682
28646	7	4	2617	41	0	2669
28647	3	2627	46	11	0	2687
28648	8	41	9	2685	0	2743
28649	2807	8	6	47	0	2868
28650	2839	10	9	13	0	2871
28651	50	2855	5	12	0	2922
28652	2839	51	6	10	0	2906
28653	2911	12	7	9	0	2939
28654	2912	13	2	9	0	2936
28655	63	11	2676	11	0	2761
28656	2797	2	53	9	0	2861
28657	60	2759	20	12	0	2851
28658	19	47	2741	14	0	2821
28659	13	13	2763	9	0	2798
28660	14	2710	51	13	0	2788
28661	2654	44	26	14	0	2738
28662	57	10	16	2605	0	2688
28663	18	2578	10	46	0	2652
28664	2602	51	7	23	0	2683
28665	60	16	9	2606	0	2691
28666	2634	11	9	53	0	2707
28667	64	11	6	2643	0	2724
28668	21	8	2603	55	0	2687
28669	20	15	2512	15	0	2562
28670	14	12	2540	15	0	2581
28671	21	9	56	2488	0	2574
28672	16	9	22	2559	0	2606
28673	11	11	2516	65	0	2603
28674	12	2490	57	26	0	2585
28675	2541	56	23	19	0	2639
28676	2518	22	19	9	0	2568
28677	66	2528	12	15	0	2621
28678	33	52	9	2546	0	2640
28679	24	24	2574	51	0	2673
28680	2520	15	57	30	0	2622
28681	61	17	2575	12	0	2665
28682	31	9	2458	11	0	2509
28683	17	15	2463	13	0	2508
28684	2393	8	72	12	0	2485
28685	59	14	2410	13	0	2496
28686	30	2318	62	10	0	2420
28687	24	2361	37	11	0	2433
28688	24	60	15	2294	0	2393
28689	17	31	17	2325	0	2390
28690	19	23	2289	56	0	2387
28691	2234	11	57	29	0	2331
28692	2332	11	27	16	0	2386
28693	66	12	23	2295	0	2396
28694	2295	11	19	53	0	2378
28695	58	2274	19	27	0	2378
28696	2224	48	21	19	0	2312
28697	63	2157	15	13	0	2248
28698	27	2172	17	6	0	2222
28699	2092	60	9	13	0	2174
28700	2086	21	5	20	0	2132
28701	2136	17	10	18	0	2181
28702	2154	10	11	12	0	2187
28703	66	15	2010	10	0	2101
28704	2051	12	48	10	0	2121
28705	64	8	22	2003	0	2097
28706	30	2010	14	51	0	2105
28707	2030	40	16	18	0	2104
28708	58	2020	11	10	0	2099
28709	2023	53	11	9	0	2096
28710	61	25	5	1999	0	2090
28711	29	21	9	2032	0	2091
28712	28	20	1944	52	0	2044
28713	29	10	1986	23	0	2048
28714	24	1986	47	21	0	2078
28715	1913	40	21	9	0	1983
28716	48	1869	21	12	0	1950
28717	28	1844	14	13	0	1899
28718	28	1922	13	8	0	1971
28719	18	47	1879	9	0	1953
28720	20	1894	44	11	0	1969
28721	1707	49	24	11	0	1791
28722	1737	24	13	11	0	1785
28723	49	21	11	1670	0	1751
28724	26	1657	10	37	0	1730
28725	23	1687	15	15	0	1740
28726	18	48	12	1680	0	1758
28727	23	22	1664	41	0	1750
28728	24	1636	36	18	0	1714
28729	13	41	13	1591	0	1658
28730	1562	24	13	32	0	1631
28731	1569	24	10	17	0	1620
28732	44	1593	8	12	0	1657
28733	1593	40	8	16	0	1657
28734	1605	21	13	5	0	1644
28735	52	17	9	1564	0	1642
28736	28	12	1531	36	0	1607
28737	26	1536	36	21	0	1619
28738	14	63	15	1503	0	1595
28739	25	15	1489	35	0	1564
28740	11	1434	26	14	0	1485
28741	1329	28	12	18	0	1387
28742	1322	18	12	9	0	1361
28743	39	14	6	1308	0	1367
28744	27	1302	4	35	0	1368
28745	14	25	1316	19	0	1374
28746	10	18	24	1294	0	1346
28747	15	12	1301	17	0	1345
28748	6	1152	26	15	0	1199
28749	20	27	20	997	0	1064
28750	982	15	13	11	0	1021
28751	12	967	3	9	0	991
28752	953	13	2	15	0	983
28753	950	13	4	6	0	973
28754	22	954	3	5	0	984
28755	15	12	4	948	0	979
28756	13	13	2	955	0	983
28757	9	930	2	16	0	957
28758	5	948	3	16	0	972
28759	7	18	2	921	0	948
28760	4	937	2	9	0	952
28761	919	21	3	13	0	956
28762	903	8	4	10	0	925
28763	17	14	902	2	0	935
28764	16	5	872	1	0	894
28765	841	1	19	3	0	864
28766	860	4	12	3	0	879
28767	16	894	6	0	0	916
28768	899	9	4	3	0	915
28769	880	9	3	5	0	897
28770	20	869	3	1	0	893
28771	857	14	4	4	0	879
28772	20	7	0	1036	0	1063
28773	10	5	2	1069	0	1086
28774	6	3	1135	22	0	1166
28775	4	1089	14	10	0	1117
28776	3	1155	5	3	0	1166
28777	1085	31	3	14	0	1133
28778	1093	5	2	4	0	1104
28779	1049	2	1	2	0	1054
28780	1090	0	2	4	0	1096
28781	20	1	1049	2	0	1072
28782	3	2	1088	4	0	1097
28783	0	1100	15	7	0	1122
28784	4	17	5	1102	0	1128
28785	6	6	3	1088	0	1103
28786	3	1111	1	15	0	1130
28787	7	21	2	1096	0	1126
28788	1100	3	1	18	0	1122
28789	22	1091	1	4	0	1118
28790	6	23	1125	2	0	1156
28791	3	1121	19	2	0	1145
28792	1130	18	6	3	0	1157
28793	17	10	1115	2	0	1144
28794	1101	1	17	5	0	1124
28795	1137	3	4	5	0	1149
28796	18	5	1128	3	0	1154
28797	5	2	1115	4	0	1126
28798	4	3	1100	2	0	1109
28799	1061	4	18	1	0	1084
28800	18	2	1106	1	0	1127
28801	6	1085	16	0	0	1107
28802	1098	18	4	0	0	1120
28803	17	4	1088	0	0	1109
28804	1070	1	18	2	0	1091
28805	20	2	1083	1	0	1106
28806	5	2	1127	0	0	1134
28807	3	1138	22	3	0	1166
28808	4	17	1140	1	0	1162
28809	4	3	1137	1	0	1145
28810	2	1021	27	0	0	1050
28811	1112	20	3	1	0	1136
28812	22	3	1111	0	0	1136
28813	7	1	22	1062	0	1092
28814	5	1122	4	14	0	1145
28815	1134	15	6	5	0	1160
28816	1135	5	7	3	0	1150
28817	18	6	1114	2	0	1140
28818	3	1059	23	2	0	1087
28819	2	1109	10	1	0	1122
28820	2	21	3	1071	0	1097
28821	5	1040	4	17	0	1066
28822	3	16	5	1014	0	1038
28823	6	6	3	1116	0	1131
28824	6	1109	8	19	0	1142
28825	8	20	7	1097	0	1132
28826	8	1104	6	14	0	1132
28827	5	20	1077	4	0	1106
28828	5	8	20	1098	0	1131
28829	6	6	5	1105	0	1122
28830	5	1084	2	22	0	1113
28831	4	1115	5	7	0	1131
28832	7	23	2	1067	0	1099
28833	3	1080	4	20	0	1107
28834	1081	23	6	8	0	1118
28835	18	11	0	1082	0	1111
28836	5	1094	4	23	0	1126
28837	1069	20	7	8	0	1104
28838	23	1068	2	5	0	1098
28839	5	21	1056	9	0	1091
28840	5	10	20	1063	0	1098
28841	1066	12	5	21	0	1104
28842	22	6	1079	10	0	1117
28843	6	10	20	1037	0	1073
28844	11	1074	6	18	0	1109
28845	7	20	1055	11	0	1093
28846	7	1084	21	5	0	1117
28847	1044	20	8	5	0	1077
28848	1064	8	8	4	0	1084
28849	20	1059	14	2	0	1095
28850	1051	21	6	5	0	1083
28851	22	9	1039	4	0	1074
28852	7	3	24	1021	0	1055
28853	4	10	7	1026	0	1047
28854	10	1028	4	24	0	1066
28855	1090	18	12	5	0	1125
28856	1107	9	10	3	0	1129
28857	23	9	1105	2	0	1139
28858	1111	4	29	0	0	1144
28859	1148	5	10	4	0	1167
28860	1140	7	4	3	0	1154
28861	27	4	11	1116	0	1158
28862	6	8	7	1119	0	1140
28863	9	1099	1	24	0	1133
28864	1093	25	9	4	0	1131
28865	1106	6	4	4	0	1120
28866	27	1098	2	4	0	1131
28867	8	21	10	1058	0	1097
28868	9	1059	4	15	0	1087
28869	7	1104	3	3	0	1117
28870	1084	21	6	6	0	1117
28871	16	10	1066	8	0	1100
28872	8	3	853	2	0	866
28873	3	848	11	2	0	864
28874	749	6	8	5	0	768
28875	5	2	742	2	0	751
28876	3	700	3	3	0	709
28877	686	4	0	2	0	692
28878	2	1	681	4	0	688
28879	0	2	3	682	0	687
28880	719	2	1	5	0	727
28881	6	0	723	2	0	731
28882	1	3	739	1	0	744
28883	0	3	780	0	0	783
28884	0	2	777	1	0	780
28885	764	2	3	4	0	773
28886	828	4	1	0	0	833
28887	5	839	1	0	0	845
28888	0	5	2	868	0	875
28889	0	2	1	882	0	885
28890	3	871	0	7	0	881
28891	1	8	0	884	0	893
28892	0	904	2	8	0	914
28893	2	914	0	2	0	918
28894	3	14	1	912	0	930
28895	0	2	928	13	0	943
28896	1	919	10	2	0	932
28897	2	14	2	936	0	954
28898	944	3	3	11	0	961
28899	10	1	950	3	0	964
28900	924	2	11	2	0	939
28901	959	0	2	1	0	962
28902	14	2	1	995	0	1012
28903	4	1	1023	12	0	1040
28904	1	1	1024	4	0	1030
28905	2	1083	16	2	0	1103
28906	3	15	3	1046	0	1067
28907	1	3	1061	14	0	1079
28908	2	1	1067	3	0	1073
28909	1	1086	15	2	0	1104
28910	1090	14	3	6	0	1113
28911	1112	5	3	0	0	1120
28912	17	0	0	1162	0	1179
28913	4	3	1195	17	0	1219
28914	3	2	1195	4	0	1204
28915	3	1264	17	9	0	1293
28916	2	16	1282	2	0	1302
28917	1	6	1287	1	0	1295
28918	3	3	18	1233	0	1257
28919	3	2	1303	17	0	1325
28920	1269	0	20	5	0	1294
28921	18	0	11	1314	0	1343
28922	6	2	1373	20	0	1401
28923	0	1390	19	6	0	1415
28924	4	16	6	1390	0	1416
28925	1	4	1408	19	0	1432
28926	0	1453	18	8	0	1479
28927	3	19	5	1436	0	1463
28928	3	1459	8	18	0	1488
28929	1	22	5	1470	0	1498
28930	2	9	3	1480	0	1494
28931	1	1	1466	28	0	1496
28932	1	1477	24	9	0	1511
28933	1	20	7	1498	0	1526
28934	9	10	5	1489	0	1513
28935	5	2	5	1510	0	1522
28936	2	3	1474	29	0	1508
28937	1	1473	23	9	0	1506
28938	1	22	10	1478	0	1511
28939	1	5	1476	30	0	1512
28940	1	1459	29	6	0	1495
28941	2	28	13	1461	0	1504
28942	1	10	1487	27	0	1525
28943	3	1496	24	10	0	1533
28944	3	23	8	1494	0	1528
28945	1	8	5	1518	0	1532
28946	2	3	1534	28	0	1567
28947	1466	9	22	11	0	1508
28948	19	1508	8	13	0	1548
28949	1529	21	7	9	0	1566
28950	19	11	1537	6	0	1573
28951	1563	7	23	9	0	1602
28952	22	6	10	1579	0	1617
28953	10	6	5	1617	0	1638
28954	0	7	1585	33	0	1625
28955	1492	5	23	17	0	1537
28956	1525	3	11	10	0	1549
28957	23	1517	7	8	0	1555
28958	7	1550	7	8	0	1572
28959	1536	27	3	13	0	1579
28960	20	7	1536	13	0	1576
28961	6	1622	29	5	0	1662
28962	5	24	7	1684	0	1720
28963	7	9	7	1709	0	1732
28964	4	3	1705	26	0	1738
28965	1689	8	21	11	0	1729
28966	22	2	1756	11	0	1791
28967	1766	5	29	12	0	1812
28968	25	3	1843	6	0	1877
28969	13	1843	26	6	0	1888
28970	1889	24	8	11	0	1932
28971	1898	8	7	8	0	1921
28972	1889	5	7	7	0	1908
28973	1905	7	4	1	0	1917
28974	37	4	5	1875	0	1921
28975	13	7	1886	21	0	1927
28976	10	9	23	1856	0	1898
28977	6	1875	12	30	0	1923
28978	6	22	8	1891	0	1927
28979	4	8	1875	22	0	1909
28980	6	5	1847	13	0	1871
28981	9	4	32	1839	0	1884
28982	1829	2	16	26	0	1873
28983	1797	6	7	9	0	1819
28984	1811	5	6	3	0	1825
28985	29	4	1808	6	0	1847
28986	15	4	1788	2	0	1809
28987	9	1809	27	3	0	1848
28988	8	1836	6	5	0	1855
28989	1803	20	12	6	0	1841
28990	1808	6	12	7	0	1833
28991	23	1902	3	5	0	1933
28992	1868	14	4	6	0	1892
28993	1887	6	8	7	0	1908
28994	16	1882	6	2	0	1906
28995	1913	14	4	8	0	1939
28996	1911	8	3	9	0	1931
28997	23	1915	6	2	0	1946
28998	1952	11	4	4	0	1971
28999	1949	8	6	4	0	1967
29000	23	1	1944	6	0	1974
29001	9	5	1901	4	0	1919
29002	5	1887	20	2	0	1914
29003	7	1901	4	6	0	1918
29004	1896	13	13	3	0	1925
29005	1836	6	4	5	0	1851
29006	1818	3	4	3	0	1828
29007	18	1839	5	4	0	1866
29008	7	12	4	1866	0	1889
29009	8	8	1886	12	0	1914
29010	12	10	13	1839	0	1874
29011	7	1893	8	12	0	1920
29012	1853	7	2	3	0	1865
29013	10	1810	2	1	0	1823
29014	6	10	0	1805	0	1821
29015	1874	3	1	13	0	1891
29016	1860	1	5	7	0	1873
29017	16	2	1893	0	0	1911
29018	1899	2	9	3	0	1913
29019	1994	4	5	2	0	2005
29020	2017	2	0	2	0	2021
29021	18	1	0	1953	0	1972
29022	9	1938	3	9	0	1959
29023	7	11	3	1967	0	1988
29024	5	8	2039	12	0	2064
29025	4	2070	15	5	0	2094
29026	11	12	5	2046	0	2074
29027	6	8	2042	12	0	2068
29028	8	2044	12	6	0	2070
29029	8	12	6	1999	0	2025
29030	4	6	2019	13	0	2042
29031	1861	3	20	4	0	1888
29032	17	5	2059	2	0	2083
29033	9	4	2045	2	0	2060
29034	8	2067	21	0	0	2096
29035	5	17	5	2096	0	2123
29036	8	6	2	2063	0	2079
29037	5	2046	5	17	0	2073
29038	5	14	2	2125	0	2146
29039	2135	5	5	21	0	2166
29040	2129	4	4	6	0	2143
29041	21	10	2060	5	0	2096
29042	2120	3	17	9	0	2149
29043	2166	1	5	6	0	2178
29044	24	8	2155	3	0	2190
29045	8	2161	22	5	0	2196
29046	7	2171	8	1	0	2187
29047	8	27	2	2036	0	2073
29048	6	2156	6	13	0	2181
29049	8	21	2050	5	0	2084
29050	7	10	2084	2	0	2103
29051	3	2132	26	5	0	2166
29052	2126	23	6	5	0	2160
29053	2159	6	3	5	0	2173
29054	2191	3	2	9	0	2205
29055	2189	4	2	3	0	2198
29056	2096	4	4	8	0	2112
29057	25	2137	4	4	0	2170
29058	9	24	2125	3	0	2161
29059	11	5	18	2127	0	2161
29060	2102	3	5	23	0	2133
29061	24	2050	3	3	0	2080
29062	13	23	1	2013	0	2050
29063	7	6	2017	17	0	2047
29064	5	1973	20	4	0	2002
29065	2	1990	8	3	0	2003
29066	1904	30	23	10	0	1967
29067	20	1907	1	4	0	1932
29068	5	21	1	1833	0	1860
29069	1847	3	2	21	0	1873
29070	1839	2	3	5	0	1849
29071	1833	2	2	5	0	1842
29072	22	9	1803	0	0	1834
29073	9	1820	20	2	0	1851
29074	1864	21	5	4	0	1894
29075	28	5	3	1850	0	1886
29076	1864	6	2	21	0	1893
29077	26	1848	2	8	0	1884
29078	1970	24	1	4	0	1999
29079	2148	4	4	8	0	2164
29080	35	5	2	2132	0	2174
29081	15	0	2229	28	0	2272
29082	11	5	25	2278	0	2319
29083	2280	3	8	34	0	2325
29084	2303	9	7	9	0	2328
29085	41	2245	4	11	0	2301
29086	2207	32	1	9	0	2249
29087	39	2198	4	8	0	2249
29088	2219	34	4	4	0	2261
29089	2193	8	3	11	0	2215
29090	41	6	2187	2	0	2236
29091	16	2124	34	3	0	2177
29092	13	31	12	2159	0	2215
29093	10	9	8	2195	0	2222
29094	5	10	3	2141	0	2159
29095	10	2126	1	43	0	2180
29096	6	32	2132	12	0	2182
29097	5	8	2180	9	0	2202
29098	6	2610	42	7	0	2665
29099	2618	51	11	8	0	2688
29100	51	11	2609	5	0	2676
29101	2552	11	53	15	0	2631
29102	59	2584	13	5	0	2661
29103	15	48	2624	5	0	2692
29104	21	13	51	2594	0	2679
29105	13	14	2648	47	0	2722
29106	5	14	2708	13	0	2740
29107	16	5	61	2531	0	2613
29108	8	2583	22	48	0	2661
29109	6	2681	16	9	0	2712
29110	2648	55	7	10	0	2720
29111	46	22	2644	6	0	2718
29112	2668	16	47	3	0	2734
29113	2674	6	14	9	0	2703
29114	59	2673	13	6	0	2751
29115	2605	50	5	4	0	2664
29116	2629	13	5	2	0	2649
29117	2514	13	13	5	0	2545
29118	62	2440	9	8	0	2519
29119	24	2325	6	6	0	2361
29120	18	2412	3	3	0	2436
29121	2392	62	15	6	0	2475
29122	2411	15	10	2	0	2438
29123	61	16	2313	3	0	2393
29124	28	11	2260	1	0	2300
29125	2287	7	48	2	0	2344
29126	2319	1	19	6	0	2345
29127	2342	3	12	5	0	2362
29128	60	4	7	2280	0	2351
29129	26	6	4	2338	0	2374
29130	18	5	5	2363	0	2391
29131	17	8	1	2362	0	2388
29132	9	7	2212	56	0	2284
29133	12	5	2280	18	0	2315
29134	9	7	2289	14	0	2319
29135	10	6	2269	6	0	2291
29136	2237	3	56	6	0	2302
29137	44	2233	25	8	0	2310
29138	19	2319	14	4	0	2356
29139	2302	44	8	5	0	2359
29140	50	16	2270	4	0	2340
29141	16	16	2255	6	0	2293
29142	2246	10	44	9	0	2309
29143	2288	6	21	6	0	2321
29144	42	2244	15	8	0	2309
29145	24	32	11	2245	0	2312
29146	2282	5	8	32	0	2327
29147	2310	13	10	7	0	2340
29148	46	12	4	2268	0	2330
29149	28	2322	3	36	0	2389
29150	2343	36	4	12	0	2395
29151	45	12	2291	15	0	2363
29152	2291	12	39	11	0	2353
29153	45	2303	16	8	0	2372
29154	2322	34	15	8	0	2379
29155	2307	13	12	8	0	2340
29156	50	11	2314	4	0	2379
29157	22	10	2305	3	0	2340
29158	2321	8	46	7	0	2382
29159	2341	10	22	5	0	2378
29160	47	2361	19	4	0	2431
29161	29	38	5	2380	0	2452
29162	19	8	2378	33	0	2438
29163	2355	9	45	12	0	2421
29164	44	10	13	2402	0	2469
29165	29	7	12	2420	0	2468
29166	2394	9	8	40	0	2451
29167	42	2441	4	23	0	2510
29168	2476	36	11	17	0	2540
29169	2507	10	10	8	0	2535
29170	2515	11	6	14	0	2546
29171	51	2492	6	4	0	2553
29172	2511	35	7	4	0	2557
29173	55	12	9	2480	0	2556
29174	27	15	8	2479	0	2529
29175	30	10	2434	39	0	2513
29176	15	10	2401	19	0	2445
29177	17	2423	39	13	0	2492
29178	16	2426	19	8	0	2469
29179	13	30	2285	5	0	2333
29180	12	2291	34	4	0	2341
29181	2229	43	16	12	0	2300
29182	2238	8	9	4	0	2259
29183	2242	14	2	7	0	2265
29184	41	4	5	2170	0	2220
29185	20	5	7	2220	0	2252
29186	19	4	2242	34	0	2299
29187	4	2242	29	22	0	2297
29188	2239	27	8	11	0	2285
29189	33	2248	9	3	0	2293
29190	2248	33	11	2	0	2294
29191	2274	9	4	6	0	2293
29192	42	10	6	2217	0	2275
29193	22	7	5	2262	0	2296
29194	24	7	1	2288	0	2320
29195	12	1	2208	41	0	2262
29196	9	2168	23	21	0	2221
29197	11	2131	9	16	0	2167
29198	4	1656	5	7	0	1672
29199	1	1638	4	2	0	1645
29200	3	1669	1	6	0	1679
29201	1623	10	8	4	0	1645
29202	9	6	1607	1	0	1623
29203	7	1618	7	8	0	1640
29204	7	6	1592	1	0	1606
29205	3	1625	7	1	0	1636
29206	15	9	5	1323	0	1352
29207	3	3	2	1590	0	1598
29208	2	1635	5	8	0	1650
29209	1637	10	3	5	0	1655
29210	9	5	1628	3	0	1645
29211	6	1644	6	2	0	1658
29212	4	8	1621	1	0	1634
29213	4	2	6	1633	0	1645
29214	3	4	1	1581	0	1589
29215	2	1625	3	10	0	1640
29216	3	9	2	1656	0	1670
29217	5	3	3	1678	0	1689
29218	2	1678	2	6	0	1688
29219	5	9	1657	2	0	1673
29220	7	3	1627	3	0	1640
29221	1623	5	7	5	0	1640
29222	1676	2	3	4	0	1685
29223	9	4	0	1639	0	1652
29224	7	1	1649	6	0	1663
29225	5	5	9	1610	0	1629
29226	2	1696	4	8	0	1710
29227	1	12	1698	3	0	1714
29228	2	1681	5	4	0	1692
29229	1	7	1672	5	0	1685
29230	1	1669	6	4	0	1680
29231	1679	9	4	3	0	1695
29232	7	5	4	1668	0	1684
29233	4	5	3	1632	0	1644
29234	2	2	1652	10	0	1666
29235	3	2	1585	5	0	1595
29236	2	1649	8	6	0	1665
29237	1663	10	2	6	0	1681
29238	10	4	2	1640	0	1656
29239	4	4	1684	6	0	1698
29240	3	3	1641	4	0	1651
29241	1555	5	9	5	0	1574
29242	1611	2	4	5	0	1622
29243	9	2	1635	3	0	1649
29244	5	5	6	1607	0	1623
29245	4	1636	2	8	0	1650
29246	1658	8	4	7	0	1677
29247	6	1651	2	5	0	1664
29248	1622	8	3	2	0	1635
29249	6	1619	2	3	0	1630
29250	5	1630	1	1	0	1637
29251	3	9	1	1645	0	1658
29252	2	3	3	1644	0	1652
29253	1	1636	2	12	0	1651
29254	1	12	1612	4	0	1629
29255	3	8	1574	3	0	1588
29256	0	4	1580	2	0	1586
29257	1528	4	11	5	0	1548
29258	1599	6	3	4	0	1612
29259	11	1668	5	1	0	1685
29260	2	13	1656	1	0	1672
29261	5	5	13	1666	0	1689
29262	1	3	1767	14	0	1785
29263	1	5	1828	6	0	1840
29264	3	1	18	2009	0	2031
29265	2	4	6	2135	0	2147
29266	2	3	2271	37	0	2313
29267	2307	2	27	31	0	2367
29268	27	2399	12	7	0	2445
29269	17	2506	11	3	0	2537
29270	9	45	4	2472	0	2530
29271	2534	21	4	34	0	2593
29272	35	2557	9	21	0	2622
29273	2584	41	4	16	0	2645
29274	37	2588	3	7	0	2635
29275	2706	45	3	6	0	2760
29276	43	23	2673	7	0	2746
29277	30	11	2708	4	0	2753
29278	20	18	49	2613	0	2700
29279	14	9	2622	30	0	2675
29280	11	2497	40	16	0	2564
29281	10	2507	27	6	0	2550
29282	2528	44	19	8	0	2599
29283	39	25	16	2476	0	2556
29284	23	2551	10	32	0	2616
29285	2576	38	11	20	0	2645
29286	2531	30	6	10	0	2577
29287	2605	17	6	12	0	2640
29288	67	10	6	2545	0	2628
29289	33	12	1	2585	0	2631
29290	21	14	2565	50	0	2650
29291	22	10	2552	25	0	2609
29292	2537	5	48	17	0	2607
29293	49	3	24	2527	0	2603
29294	24	2	2511	51	0	2588
29295	2462	7	41	34	0	2544
29296	40	2572	31	9	0	2652
29297	2599	34	16	12	0	2661
29298	2625	17	10	17	0	2669
29299	2636	7	11	16	0	2670
29300	65	12	2562	8	0	2647
29301	2577	9	41	2	0	2629
29302	64	11	21	2500	0	2596
29303	45	2475	8	33	0	2561
29304	28	2579	5	27	0	2639
29305	2567	45	13	13	0	2638
29306	2579	23	12	10	0	2624
29307	2604	16	7	10	0	2637
29308	76	10	2	2488	0	2576
29309	38	14	6	2520	0	2578
29310	30	12	6	2467	0	2515
29311	24	2467	8	54	0	2553
29312	2465	38	5	29	0	2537
29313	2485	23	4	25	0	2537
29314	2526	11	3	26	0	2566
29315	66	14	2448	21	0	2549
29316	2514	11	40	13	0	2578
29317	67	17	20	2400	0	2504
29318	50	2445	8	31	0	2534
29319	2431	41	6	31	0	2509
29320	2455	24	10	11	0	2500
29321	74	11	2430	13	0	2528
29322	51	11	37	2407	0	2506
29323	24	2456	20	40	0	2540
29324	2523	43	11	28	0	2605
29325	65	24	9	2510	0	2608
29326	40	9	17	2506	0	2572
29327	21	11	14	2533	0	2579
29328	22	9	10	2611	0	2652
29329	20	18	2549	73	0	2660
29330	23	2562	43	40	0	2668
29331	20	40	24	2587	0	2671
29332	14	23	2586	68	0	2691
29333	2571	14	48	48	0	2681
29334	2631	13	28	29	0	2701
29335	78	11	16	2614	0	2719
29336	2649	11	14	56	0	2730
29337	2677	14	12	42	0	2745
29338	77	9	2642	24	0	2752
29339	49	2605	43	22	0	2719
29340	2658	42	27	19	0	2746
29341	71	23	15	2641	0	2750
29342	2684	6	12	60	0	2762
29343	71	8	16	2647	0	2742
29344	42	14	14	2679	0	2749
29345	31	17	2605	68	0	2721
29346	2524	11	43	48	0	2626
29347	67	2647	24	26	0	2764
29348	45	44	2619	27	0	2735
29349	31	2607	48	24	0	2710
29350	2595	47	29	24	0	2695
29351	65	27	16	2569	0	2677
29352	2578	18	11	53	0	2660
29353	56	2579	13	31	0	2679
29354	2631	51	18	18	0	2718
29355	2675	30	10	13	0	2728
29356	2694	15	7	17	0	2733
29357	2667	8	6	24	0	2705
29358	85	2610	3	24	0	2722
29359	2564	42	11	19	0	2636
29360	72	29	3	2543	0	2647
29361	60	24	3	2474	0	2561
29362	40	2324	9	58	0	2431
29363	41	2288	6	24	0	2359
29364	25	2164	8	20	0	2217
29365	2000	34	21	17	0	2072
29366	39	1826	7	17	0	1889
29367	12	1620	5	14	0	1651
29368	1602	24	24	7	0	1657
29369	1555	10	2	10	0	1577
29370	31	1593	2	8	0	1634
29371	1545	15	6	6	0	1572
29372	23	8	1506	6	0	1543
29373	1481	9	12	2	0	1504
29374	21	6	1490	6	0	1523
29375	12	1339	13	5	0	1369
29376	8	1383	3	5	0	1399
29377	19	22	1	1346	0	1388
29378	1401	4	2	13	0	1420
29379	1403	5	2	6	0	1416
29380	1433	5	3	10	0	1451
29381	1426	4	4	10	0	1444
29382	1407	5	3	7	0	1422
29383	17	6	1364	3	0	1390
29384	3	6	1330	7	0	1346
29385	1374	5	8	1	0	1388
29386	15	1404	4	5	0	1428
29387	1375	12	2	4	0	1393
29388	1412	4	1	5	0	1422
29389	1445	1	0	5	0	1451
29390	1452	3	1	5	0	1461
29391	1455	5	5	4	0	1469
29392	16	5	1443	2	0	1466
29393	1471	3	13	3	0	1490
29394	1504	2	3	7	0	1516
29395	17	4	1442	3	0	1466
29396	1421	7	8	7	0	1443
29397	1470	5	3	5	0	1483
29398	18	0	1534	5	0	1557
29399	11	4	1512	2	0	1529
29400	11	1554	9	2	0	1576
29401	11	10	3	1544	0	1568
29402	11	7	1550	8	0	1576
29403	1574	3	8	5	0	1590
29404	11	3	4	1631	0	1649
29405	10	2	1665	11	0	1688
29406	1665	5	11	7	0	1688
29407	1688	5	2	4	0	1699
29408	1699	3	2	4	0	1708
29409	17	1736	2	2	0	1757
29410	13	14	1	1730	0	1758
29411	11	1734	3	14	0	1762
29412	1751	10	6	2	0	1769
29413	1739	3	4	3	0	1749
29414	23	5	1716	2	0	1746
29415	8	1653	12	1	0	1674
29416	2	1674	2	3	0	1681
29417	11	12	3	1676	0	1702
29418	7	5	0	1691	0	1703
29419	1695	3	3	11	0	1712
29420	16	1671	2	3	0	1692
29421	8	1658	3	1	0	1670
29422	10	11	1653	0	0	1674
29423	4	1689	12	2	0	1707
29424	1673	10	4	5	0	1692
29425	16	5	1641	3	0	1665
29426	1561	2	8	3	0	1574
29427	8	4	1593	2	0	1607
29428	1504	1	6	3	0	1514
29429	10	1621	1	0	0	1632
29430	1689	9	0	3	0	1701
29431	15	8	1739	0	0	1762
29432	1734	0	12	1	0	1747
29433	1732	1	6	6	0	1745
29434	17	1	1769	0	0	1787
29435	1769	1	9	4	0	1783
29436	1819	0	6	1	0	1826
29437	1809	2	1	4	0	1816
29438	22	1777	0	1	0	1800
29439	1828	10	1	2	0	1841
29440	17	6	1828	3	0	1854
29441	10	1930	13	5	0	1958
29442	1994	17	5	2	0	2018
29443	2001	10	3	4	0	2018
29444	2052	3	1	3	0	2059
29445	27	2010	1	2	0	2040
29446	14	16	2	2279	0	2311
29447	3	10	2269	24	0	2306
29448	6	1	27	2280	0	2314
29449	1	3	2352	27	0	2383
29450	2311	2	26	10	0	2349
29451	26	2364	8	3	0	2401
29452	14	27	2	2336	0	2379
29453	5	2371	4	26	0	2406
29454	5	24	4	2390	0	2423
29455	7	10	3	2402	0	2422
29456	5	2435	4	35	0	2479
29457	7	29	2	2470	0	2508
29458	11	10	2	2553	0	2576
29459	5	2525	3	36	0	2569
29460	4	2577	2	14	0	2597
29461	3	45	3	2562	0	2613
29462	3	12	2556	34	0	2605
29463	2	2589	36	12	0	2639
29464	11	35	7	2589	0	2642
29465	8	12	2660	31	0	2711
29466	4	2661	35	15	0	2715
29467	2648	39	7	10	0	2704
29468	38	14	2621	4	0	2677
29469	2619	7	33	9	0	2668
29470	47	5	10	2580	0	2642
29471	18	4	6	2606	0	2634
29472	12	4	2	2611	0	2629
29473	6	9	2558	49	0	2622
29474	7	8	2548	14	0	2577
29475	2529	4	43	12	0	2588
29476	46	1	20	2523	0	2590
29477	14	6	2548	42	0	2610
29478	2508	7	35	18	0	2568
29479	41	5	15	2518	0	2579
29480	16	8	6	2528	0	2558
29481	17	6	4	2510	0	2537
29482	7	2494	6	51	0	2558
29483	8	41	5	2469	0	2523
29484	8	2441	3	45	0	2497
29485	6	2521	4	19	0	2550
29486	2488	50	3	15	0	2556
29487	2370	19	7	11	0	2407
29488	2482	9	6	8	0	2505
29489	53	2414	7	9	0	2483
29490	2396	44	6	6	0	2452
29491	2417	15	5	10	0	2447
29492	48	10	5	2356	0	2419
29493	20	9	6	2389	0	2424
29494	13	7	2335	56	0	2411
29495	8	2353	42	21	0	2424
29496	2326	44	14	15	0	2399
29497	2334	16	3	16	0	2369
29498	42	2276	10	14	0	2342
29499	2270	45	7	11	0	2333
29500	2277	15	6	13	0	2311
29501	55	10	6	2214	0	2285
29502	20	2181	7	43	0	2251
29503	11	2249	7	22	0	2289
29504	2214	48	11	13	0	2286
29505	48	22	4	2169	0	2243
29506	14	8	2149	52	0	2223
29507	2115	7	45	23	0	2190
29508	41	9	2208	16	0	2274
29509	15	2149	44	10	0	2218
29510	2139	37	15	22	0	2213
29511	39	21	2143	12	0	2215
29512	22	15	36	2194	0	2267
29513	14	5	2240	41	0	2300
29514	10	2240	43	20	0	2313
29515	15	39	14	2253	0	2321
29516	11	17	2237	45	0	2310
29517	2188	9	40	23	0	2260
29518	44	2242	15	12	0	2313
29519	15	39	15	2214	0	2283
29520	12	2273	8	46	0	2339
29521	2262	42	8	27	0	2339
29522	2258	20	9	20	0	2307
29523	47	2242	6	20	0	2315
29524	21	44	11	2227	0	2303
29525	9	2261	9	42	0	2321
29526	2245	42	9	18	0	2314
29527	46	16	2230	14	0	2306
29528	18	18	2211	12	0	2259
29529	16	2143	34	10	0	2203
29530	13	2112	14	9	0	2148
29531	13	35	5	2047	0	2100
29532	2033	11	3	40	0	2087
29533	2052	10	8	16	0	2086
29534	1994	10	6	13	0	2023
29535	41	2061	8	8	0	2118
29536	19	29	8	2014	0	2070
29537	19	2028	3	33	0	2083
29538	2024	31	8	15	0	2078
29539	37	10	8	2012	0	2067
29540	14	9	1959	26	0	2008
29541	10	1906	24	16	0	1956
29542	1854	21	6	14	0	1895
29543	24	10	1835	5	0	1874
29544	1780	9	22	6	0	1817
29545	25	1788	6	12	0	1831
29546	7	1532	4	11	0	1554
29547	1513	15	6	4	0	1538
29548	16	1531	6	3	0	1556
29549	1470	14	7	5	0	1496
29550	14	1466	2	4	0	1486
29551	1492	15	2	4	0	1513
29552	1497	4	0	4	0	1505
29553	18	2	1544	1	0	1565
29554	4	6	1467	5	0	1482
29555	2	1489	14	1	0	1506
29556	1441	16	9	1	0	1467
29557	13	3	1408	4	0	1428
29558	1323	3	15	3	0	1344
29559	10	5	2	1327	0	1344
29560	3	3	1340	4	0	1350
29561	1	2	1289	4	0	1296
29562	5	1	1373	1	0	1380
29563	2	1361	4	1	0	1368
29564	8	22	11	1313	0	1354
29565	1276	1	0	0	0	1277
29566	0	0	0	1300	0	1300
29567	1310	0	1	0	0	1311
29568	0	0	0	1316	0	1316
29569	1333	0	0	2	0	1335
29570	1326	0	1	4	0	1331
29571	1573	0	0	1	0	1574
29572	6	1607	0	0	0	1613
29573	2	7	1644	0	0	1653
29574	1	2	5	1647	0	1655
29575	17	13	8	1060	0	1098
29576	2	1	0	1715	0	1718
29577	2	1	1	1681	0	1685
29578	1	1654	0	11	0	1666
29579	1	8	1647	4	0	1660
29580	0	1681	8	1	0	1690
29581	2	7	4	1632	0	1645
29582	2	8	0	1706	0	1716
29583	4	0	1	1704	0	1709
29584	0	3	1	1707	0	1711
29585	2	1667	1	11	0	1681
29586	0	1682	0	6	0	1688
29587	1	11	1661	6	0	1679
29588	1	4	9	1680	0	1694
29589	1	0	7	1690	0	1698
29590	1	4	0	1746	0	1751
29591	1769	0	2	15	0	1786
29592	12	1768	1	5	0	1786
29593	4	11	1755	4	0	1774
29594	1767	4	10	4	0	1785
29595	10	2	3	1780	0	1795
29596	1806	2	1	11	0	1820
29597	11	1	2	1819	0	1833
29598	1842	2	0	12	0	1856
29599	12	2	1	1850	0	1865
29600	1835	1	1	16	0	1853
29601	15	2	1888	6	0	1911
29602	8	1	12	1883	0	1904
29603	1	1926	5	14	0	1946
29604	5	14	0	1989	0	2008
29605	1977	5	1	19	0	2002
29606	18	1978	3	4	0	2003
29607	5	16	1	2075	0	2097
29608	6	2011	0	25	0	2042
29609	1	17	1	2058	0	2077
29610	7	6	1	2074	0	2088
29611	0	7	2035	25	0	2067
29612	5	3	15	1975	0	1998
29613	3	4	1952	20	0	1979
29614	2	1933	20	9	0	1964
29615	1940	16	8	6	0	1970
29616	17	10	1929	6	0	1962
29617	1896	3	20	7	0	1926
29618	2002	6	4	8	0	2020
29619	31	1	3	2006	0	2041
29620	8	3	2103	25	0	2139
29621	2074	1	24	14	0	2113
29622	2208	3	7	10	0	2228
29623	33	2	4	2162	0	2201
29624	12	1	3	2190	0	2206
29625	9	2187	3	32	0	2231
29626	7	27	2	2198	0	2234
29627	5	2207	2	32	0	2246
29628	2	29	2181	8	0	2220
29629	5	10	24	2173	0	2212
29630	2160	7	9	27	0	2203
29631	2182	3	5	15	0	2205
29632	31	2168	5	8	0	2212
29633	14	22	2	2213	0	2251
29634	2220	7	0	31	0	2258
29635	29	2137	1	11	0	2178
29636	2156	27	1	9	0	2193
29637	30	11	3	2278	0	2322
29638	2395	3	2	33	0	2433
29639	32	4	2567	11	0	2614
29640	15	2579	30	9	0	2633
29641	2576	33	11	11	0	2631
29642	36	2663	9	9	0	2717
29643	2714	40	2	9	0	2765
29644	2796	17	3	3	0	2819
29645	49	9	2788	7	0	2853
29646	29	3	35	2789	0	2856
29647	2827	6	14	40	0	2887
29648	49	3	2795	17	0	2864
29649	2826	6	42	11	0	2885
29650	45	7	15	2812	0	2879
29651	25	5	2783	43	0	2856
29652	14	10	37	2769	0	2830
29653	2711	0	21	46	0	2778
29654	42	6	2769	25	0	2842
29655	28	2	42	2790	0	2862
29656	14	2	19	2842	0	2877
29657	2822	3	9	52	0	2886
29658	2817	3	9	32	0	2861
29659	60	2825	7	19	0	2911
29660	29	45	6	2851	0	2931
29661	22	16	6	2844	0	2888
29662	14	9	7	2831	0	2861
29663	2785	5	6	63	0	2859
29664	2789	3	9	35	0	2836
29665	61	4	8	2753	0	2826
29666	34	2695	7	46	0	2782
29667	21	38	4	2690	0	2753
29668	14	2730	7	56	0	2807
29669	2712	48	3	29	0	2792
29670	49	2672	7	21	0	2749
29671	2461	40	5	13	0	2519
29672	52	21	5	2418	0	2496
29673	2388	13	7	45	0	2453
29674	52	7	2374	29	0	2462
29675	29	2405	35	21	0	2490
29676	2381	38	28	10	0	2457
29677	2409	15	10	15	0	2449
29678	63	14	7	2361	0	2445
29679	27	2368	11	47	0	2453
29680	28	33	4	2449	0	2514
29681	22	9	5	2467	0	2503
29682	16	10	12	2470	0	2508
29683	2437	8	6	65	0	2516
29684	2463	11	9	35	0	2518
29685	63	11	5	2410	0	2489
29686	40	2395	4	47	0	2486
29687	2443	40	7	29	0	2519
29688	47	17	2399	20	0	2483
29689	23	14	31	2415	0	2483
29690	22	10	2408	58	0	2498
29691	15	7	40	2408	0	2470
29692	19	9	2429	52	0	2509
29693	16	6	33	2437	0	2492
29694	2443	9	14	51	0	2517
29695	2452	6	9	38	0	2505
29696	55	2391	8	22	0	2476
29697	2451	36	8	16	0	2511
29698	49	20	7	2426	0	2502
29699	29	19	5	2461	0	2514
29700	2452	5	8	59	0	2524
29701	45	10	2378	34	0	2467
29702	36	6	2383	20	0	2445
29703	18	15	2389	17	0	2439
29704	2347	9	40	21	0	2417
29705	41	8	2423	20	0	2492
29706	32	10	2321	14	0	2377
29707	2267	8	41	15	0	2331
29708	44	2341	17	21	0	2423
29709	33	31	9	2401	0	2474
29710	19	19	8	2457	0	2503
29711	12	10	2463	53	0	2538
29712	2443	7	32	35	0	2517
29713	2491	8	20	20	0	2539
29714	2438	8	13	18	0	2477
29715	51	7	2469	18	0	2545
29716	2449	5	34	19	0	2507
29717	41	10	2447	16	0	2514
29718	33	2391	34	13	0	2471
29719	15	2426	17	15	0	2473
29720	2299	31	17	18	0	2365
29721	33	2252	12	16	0	2313
29722	30	2260	3	16	0	2309
29723	2262	26	10	14	0	2312
29724	26	2256	12	17	0	2311
29725	2250	25	11	14	0	2300
29726	37	12	7	2304	0	2360
29727	21	14	8	2334	0	2377
29728	29	5	6	2348	0	2388
29729	14	11	10	2333	0	2368
29730	16	2295	9	39	0	2359
29731	2347	25	9	23	0	2404
29732	30	2515	12	15	0	2572
29733	29	2576	18	13	0	2636
29734	23	41	2642	29	0	2735
29735	2607	15	42	14	0	2678
29736	45	10	2790	13	0	2858
29737	28	4	2777	16	0	2825
29738	18	2690	46	14	0	2768
29739	4	2648	16	10	0	2678
29740	2705	49	12	16	0	2782
29741	38	2864	10	10	0	2922
29742	9	49	2807	6	0	2871
29743	12	2768	37	7	0	2824
29744	5	49	2756	1	0	2811
29745	2	11	2709	4	0	2726
29746	2625	16	44	7	0	2692
29747	35	1	2700	2	0	2738
29748	14	5	44	2647	0	2710
29749	2640	4	16	35	0	2695
29750	31	2612	17	13	0	2673
29751	11	31	2653	12	0	2707
29752	2614	9	44	2	0	2669
29753	41	10	15	2573	0	2639
29754	14	2510	15	34	0	2573
29755	13	35	2548	9	0	2605
29756	2517	14	32	19	0	2582
29757	38	7	2560	0	0	2605
29758	13	5	48	2541	0	2607
29759	17	1	2531	32	0	2581
29760	5	1	47	2501	0	2554
29761	2487	2	12	53	0	2554
29762	33	2508	18	23	0	2582
29763	2544	35	6	13	0	2598
29764	48	12	2538	2	0	2600
29765	15	12	35	2573	0	2635
29766	14	1	2593	41	0	2649
29767	2544	4	47	23	0	2618
29768	2611	1	16	18	0	2646
29769	53	2587	14	6	0	2660
29770	2616	41	5	6	0	2668
29771	2651	13	5	8	0	2677
29772	54	10	9	2588	0	2661
29773	29	2	2588	43	0	2662
29774	18	2509	44	20	0	2591
29775	8	43	14	2547	0	2612
29776	2543	11	13	42	0	2609
29777	45	17	2514	12	0	2588
29778	21	2	2524	13	0	2560
29779	16	6	2468	5	0	2495
29780	2435	3	66	5	0	2509
29781	44	9	2462	3	0	2518
29782	2413	7	55	8	0	2483
29783	59	10	2345	2	0	2416
29784	23	2407	54	5	0	2489
29785	19	40	23	2398	0	2480
29786	6	16	2406	43	0	2471
29787	7	2357	52	13	0	2429
29788	11	2397	18	20	0	2446
29789	14	51	22	2363	0	2450
29790	2339	27	11	46	0	2423
29791	44	20	10	2350	0	2424
29792	2293	11	12	55	0	2371
29793	57	5	11	2295	0	2368
29794	20	7	2281	53	0	2361
29795	20	13	2270	16	0	2319
29796	2239	7	59	24	0	2329
29797	2272	5	32	13	0	2322
29798	56	2	2215	16	0	2289
29799	2187	8	48	6	0	2249
29800	61	7	2197	7	0	2272
29801	26	2110	59	7	0	2202
29802	21	2110	24	8	0	2163
29803	17	2091	22	6	0	2136
29804	17	62	10	2042	0	2131
29805	2022	26	11	44	0	2103
29806	2048	15	14	22	0	2099
29807	58	13	15	2019	0	2105
29808	31	9	1921	47	0	2008
29809	27	12	46	1905	0	1990
29810	15	14	1877	57	0	1963
29811	10	9	66	1823	0	1908
29812	1819	5	23	58	0	1905
29813	1832	3	28	18	0	1881
29814	1837	6	15	23	0	1881
29815	1819	3	24	13	0	1859
29816	75	8	14	1756	0	1853
29817	34	5	14	1786	0	1839
29818	1764	8	11	59	0	1842
29819	1792	4	12	29	0	1837
29820	66	8	8	1755	0	1837
29821	35	6	12	1780	0	1833
29822	29	6	8	1753	0	1796
29823	16	5	10	1767	0	1798
29824	1703	6	6	77	0	1792
29825	54	7	1663	38	0	1762
29826	30	4	48	1620	0	1702
29827	1605	1	23	53	0	1682
29828	50	4	1584	23	0	1661
29829	26	7	45	1589	0	1667
29830	28	2	1570	52	0	1652
29831	18	1498	56	26	0	1598
29832	24	32	22	1291	0	1369
29833	1192	13	26	34	0	1265
29834	39	17	12	1058	0	1126
29835	18	1008	11	38	0	1075
29836	14	928	10	19	0	971
29837	12	763	9	15	0	799
29838	18	696	11	6	0	731
29839	403	44	52	42	0	541
29840	31	17	15	289	0	352
29841	2	1	230	10	0	243
29842	3	1	7	208	0	219
29843	0	0	208	10	0	218
29844	204	0	7	4	0	215
29845	10	0	2	203	0	215
29846	3	1	1	209	0	214
29847	2	0	1	212	0	215
29848	3	0	1	210	0	214
29849	200	1	1	10	0	212
29850	208	2	0	4	0	214
29851	13	0	1	196	0	210
29852	190	1	0	8	0	199
29853	8	1	184	4	0	197
29854	4	182	6	4	0	196
29855	0	7	1	189	0	197
29856	1	1	2	189	0	193
29857	2	178	2	7	0	189
29858	3	7	2	175	0	187
29859	3	2	0	178	0	183
29860	169	0	2	10	0	181
29861	8	0	156	3	0	167
29862	0	0	156	3	0	159
29863	146	0	8	1	0	155
29864	7	4	135	1	0	147
29865	72	0	11	0	0	83
29866	61	0	0	1	0	62
29867	3	3	0	49	0	55
29868	0	1	46	2	0	49
29869	37	0	2	0	0	39
29870	2	36	0	0	0	38
29871	21	1	0	0	0	22
29872	33	1	1	3	0	38
29873	71	0	5	0	0	76
29874	256	0	0	0	0	256
29875	247	0	0	0	0	247
29876	265	0	0	0	0	265
29877	281	0	0	0	0	281
29878	277	0	0	0	0	277
29879	270	0	0	0	0	270
29880	279	0	0	0	0	279
29881	280	0	0	0	0	280
29882	271	0	0	0	0	271
29883	266	0	0	0	0	266
29884	182	0	0	0	0	182
29885	114	0	0	0	0	114
29886	235	0	0	0	0	235
29887	273	0	0	0	0	273
29888	270	0	0	0	0	270
29889	249	0	0	0	0	249
29890	257	0	0	0	0	257
29891	280	0	0	0	0	280
29892	282	0	0	0	0	282
29893	281	0	0	0	0	281
29894	280	0	0	0	0	280
29895	277	0	0	0	0	277
29896	281	0	0	0	0	281
29897	278	0	0	0	0	278
29898	280	0	0	0	0	280
29899	275	0	0	0	0	275
29900	263	0	2	0	0	265
29901	254	0	2	0	0	256
29902	228	0	3	0	0	231
29903	209	0	29	0	0	238
