Pos	A	C	G	T	Other	Total
1	13	0	0	0	0	13
2	0	0	0	30	0	30
3	0	0	0	32	0	32
4	47	0	0	9	0	56
5	94	0	0	1	0	95
6	94	0	0	0	0	94
7	1	0	101	0	0	102
8	1	0	123	0	0	124
9	0	0	1	128	0	129
10	0	0	1	132	0	133
11	0	0	0	148	0	148
12	252	0	0	6	0	258
13	1	2	0	503	0	506
14	1007	0	0	28	0	1035
15	0	1503	1	1	0	1505
16	1	2907	1	7	0	2916
17	47	3	2	10287	0	10339
18	42	1	1	11539	0	11583
19	11	19004	12	41	0	19068
20	5	22143	22	27	0	22197
21	14	28450	9	30	0	28503
22	33442	4	18	493	0	33957
23	16	33	35257	8	0	35314
24	30	26	35955	10	0	36021
25	78	3	13	40148	0	40242
26	44096	1	5	312	0	44414
27	44737	5	0	213	0	44955
28	8	45172	15	100	0	45295
29	52012	5	0	444	0	52461
30	56108	6	11	386	0	56511
31	57545	2	12	282	0	57841
32	13	58834	15	24	0	58886
33	5	60676	12	46	0	60739
34	63993	6	5	298	0	64302
35	65269	9	9	303	0	65590
36	36	67615	26	72	0	67749
37	15	74886	30	178	0	75109
38	75729	19	8	321	0	76077
39	75599	9	5	233	0	75846
40	27	76950	34	64	0	77075
41	82	76	5	81006	0	81169
42	67	17	18	81625	0	81727
43	85	9	21	81459	0	81574
44	17	81033	21	110	0	81181
45	47	89	80479	15	0	80630
46	73640	24	54	300	0	74018
47	69	10	7	83580	0	83666
48	24	83537	33	54	0	83648
49	51	24	12	85095	0	85182
50	17	85071	28	41	0	85157
51	71	45	4	85398	0	85518
52	84	25	16	86966	0	87091
53	50	80	88299	39	0	88468
54	117	23	38	86268	0	86446
55	87392	11	15	334	0	87752
56	67	82	87765	36	0	87950
57	83642	28	67	303	0	84040
58	105	24	15	90053	0	90197
59	23	90915	34	120	0	91092
60	59	64	9	91976	0	92108
61	35	101	92549	86	0	92771
62	184	23	71	88916	0	89194
63	96	14	29	92367	0	92506
64	23	95257	44	146	0	95470
65	96	61	16	96800	0	96973
66	48	95708	29	144	0	95929
67	70	65	8	97214	0	97357
68	96238	30	17	434	0	96719
69	93337	24	41	507	0	93909
70	94667	12	32	522	0	95233
71	258	98605	47	174	0	99084
72	145	188	97437	59	0	97829
73	91934	61	161	572	0	92728
74	100820	26	55	371	0	101272
75	262	104534	51	116	0	104963
76	273	405	13	96840	0	97531
77	265	105	12	99137	0	99519
78	300	81	34	97031	0	97446
79	94100	68	5964	1171	0	101303
80	99265	38	39	753	0	100095
81	99542	24	31	737	0	100334
82	101762	24	30	524	0	102340
83	919	295	14	101450	0	102678
84	317	102175	44	597	0	103133
85	415	495	13	104647	0	105570
86	254	296	105041	693	0	106284
87	511	95	628	105208	0	106442
88	225	152	109877	914	0	111168
89	499	78	869	107041	0	108487
90	169	157	112520	1061	0	113907
91	248	156	108993	465	0	109862
92	113	115201	1170	384	0	116868
93	418	962	427	120709	0	122516
94	198	328	127588	1037	0	129151
95	461	166	1168	123285	0	125080
96	121	127815	427	1086	0	129449
97	127468	1009	299	1113	0	129889
98	963	137272	302	307	0	138844
99	611	1182	182	135641	0	137616
100	180	140029	235	1079	0	141523
101	223	1256	135884	457	0	137820
102	216	482	133323	398	0	134419
103	141	136794	1367	377	0	138679
104	468	1182	473	139236	0	141359
105	273	569	140381	1141	0	142364
106	132	138977	1229	615	0	140953
107	137915	1218	455	967	0	140555
108	1353	433	400	139970	0	142156
109	399	423	144922	1169	0	146913
110	237	144990	1222	501	0	146950
111	516	1242	421	145861	0	148040
112	462	514	348	145926	0	147250
113	140634	345	313	2394	0	143686
114	1152	435	145974	550	0	148111
115	731	252	1219	143738	0	145940
116	268	347	145369	1275	0	147259
117	154	139615	1331	604	0	141704
118	134364	1205	543	1239	0	137351
119	1047	135403	423	479	0	137352
120	709	1308	360	131344	0	133721
121	303	130134	367	1154	0	131958
122	123407	1331	304	1131	0	126173
123	1158	126314	389	464	0	128325
124	490	1569	122502	349	0	124910
125	311	123536	1261	400	0	125508
126	117936	1464	436	916	0	120752
127	1341	671	123336	378	0	125726
128	740	464	1459	121926	0	124589
129	120046	414	532	1823	0	122815
130	1702	393	426	117369	0	119890
131	117334	392	381	2084	0	120191
132	117803	405	279	970	0	119457
133	2083	377	302	116488	0	119250
134	993	326	276	116165	0	117760
135	113495	333	248	2358	0	116434
136	111446	329	248	1191	0	113214
137	2104	339	211	108571	0	111225
138	107711	278	284	2125	0	110398
139	107701	336	272	1171	0	109480
140	2003	107849	302	711	0	110865
141	1091	1477	290	107920	0	110778
142	108063	513	281	2302	0	111159
143	109385	387	278	1120	0	111170
144	2299	340	232	108456	0	111327
145	1213	299	249	110341	0	112102
146	108225	299	244	2460	0	111228
147	1846	110260	276	1125	0	113507
148	1041	1515	233	110004	0	112793
149	816	619	110633	1861	0	113929
150	1080	400	1476	106414	0	109370
151	616	109616	527	1918	0	112677
152	636	1579	108988	968	0	112171
153	887	569	1561	105811	0	108828
154	1114	545	609	101143	0	103411
155	583	487	108921	2127	0	112118
156	97496	330	1660	1785	0	101271
157	1767	110589	668	928	0	113952
158	109563	1622	487	1332	0	113004
159	1907	719	109798	803	0	113227
160	947	523	110586	743	0	112799
161	102305	447	1840	1249	0	105841
162	1852	112576	730	760	0	115918
163	110734	1629	587	1177	0	114127
164	1915	113016	501	652	0	116084
165	980	1860	113140	583	0	116563
166	107078	737	1696	1258	0	110769
167	1934	543	116291	606	0	119374
168	1167	469	1668	113731	0	117035
169	114649	460	671	2293	0	118073
170	113947	444	484	1254	0	116129
171	1943	114250	596	651	0	117440
172	1243	2475	427	110355	0	114500
173	748	112586	498	1540	0	115372
174	684	1509	110884	704	0	113781
175	1120	1077	1373	103171	0	106741
176	588	104025	623	1333	0	106569
177	760	1251	390	105080	0	107481
178	97864	432	407	1757	0	100460
179	1444	375	301	101913	0	104033
180	641	102848	289	1307	0	105085
181	772	1044	294	103103	0	105213
182	707	473	287	102547	0	104014
183	535	102631	309	1347	0	104822
184	795	1144	283	102662	0	104884
185	610	459	101199	1218	0	103486
186	472	99827	969	714	0	101982
187	92197	790	277	1050	0	94314
188	994	396	96130	338	0	97858
189	524	328	94094	339	0	95285
190	438	93155	790	379	0	94762
191	802	904	601	90451	0	92758
192	392	318	89313	753	0	90776
193	448	71358	917	473	0	73196
194	528	612	262	79128	0	80530
195	470	330	169	81192	0	82161
196	79538	225	169	1308	0	81240
197	713	81206	204	438	0	82561
198	344	739	75088	355	0	76526
199	288	397	76755	345	0	77785
200	457	265	826	75325	0	76873
201	562	248	334	99050	0	100194
202	542	267	234	100383	0	101426
203	213	115958	288	2665	0	119124
204	321	2746	117891	1139	0	122097
205	853	1325	2669	115862	0	120709
206	258	121242	1313	2932	0	125745
207	203	130079	673	1515	0	132470
208	242	4380	132426	785	0	137833
209	856	1840	3608	127502	0	133806
210	267	881	142765	3671	0	147584
211	1060	533	4390	138543	0	144526
212	938	612	1964	144895	0	148409
213	341	520	144017	5476	0	150354
214	214	142513	4395	2566	0	149688
215	138347	3994	2025	2025	0	146391
216	3884	1916	143373	972	0	150145
217	1632	142315	4352	996	0	149295
218	808	148979	2230	903	0	152920
219	513	5818	143218	763	0	150312
220	137660	2792	4569	1103	0	146124
221	5046	1694	2247	128120	0	137107
222	1773	143860	1600	3596	0	150829
223	142651	4667	933	2284	0	150535
224	5005	2383	1055	134475	0	142918
225	1965	141574	942	4432	0	148913
226	141367	4669	867	2810	0	149713
227	4267	2411	138883	1362	0	146923
228	2020	140052	4408	1035	0	147515
229	135407	4625	2344	1422	0	143798
230	4081	139007	1447	978	0	145513
231	136041	5360	1043	1148	0	143592
232	5244	2911	1033	129985	0	139173
233	2216	134342	1345	3984	0	141887
234	2083	4651	913	135350	0	142997
235	133372	2440	982	5580	0	142374
236	4389	1883	132665	2552	0	141489
237	2499	1387	136217	1592	0	141695
238	2166	1242	5880	129286	0	138574
239	1663	1445	2901	133245	0	139254
240	1798	1328	1637	130311	0	135074
241	1025	130768	1509	5875	0	139177
242	974	4888	129147	2890	0	137899
243	1749	2773	4608	121289	0	130419
244	1029	123157	2520	4561	0	131267
245	1297	131019	1547	2568	0	136431
246	1169	5929	128739	1809	0	137646
247	1079	3512	129152	1353	0	135096
248	1131	2186	133705	1330	0	138352
249	1709	1587	6562	127462	0	137320
250	1042	1703	132564	4619	0	139928
251	1557	1600	5696	130336	0	139189
252	1091	1397	134532	5385	0	142405
253	123585	1480	5781	3485	0	134331
254	4791	135417	3017	2175	0	145400
255	2375	146820	1995	1706	0	152896
256	1620	7010	149108	1555	0	159293
257	143707	3404	5757	2184	0	155052
258	151215	2311	3081	1779	0	158386
259	152506	1823	2189	1843	0	158361
260	7683	1660	145448	1593	0	156384
261	3524	1484	150251	1782	0	157041
262	2472	1492	8077	144613	0	156654
263	146826	1640	4070	6585	0	159121
264	148753	1757	2886	3869	0	157265
265	7423	1749	143792	2625	0	155589
266	143417	1911	7055	2241	0	154624
267	7086	2034	4187	140335	0	153642
268	3282	2083	143573	6516	0	155454
269	2176	1968	145931	3594	0	153669
270	135035	1789	9149	3152	0	149125
271	6065	1658	144836	2407	0	154966
272	140561	1465	8196	2615	0	152837
273	6895	1662	144321	2238	0	155116
274	3755	135892	8628	2159	0	150434
275	2665	145267	5367	1990	0	155289
276	3054	7605	3910	136904	0	151473
277	2801	4296	3479	145549	0	156125
278	2654	2933	142512	7535	0	155634
279	2997	2314	7991	134824	0	148126
280	2821	135089	4837	6611	0	149358
281	2888	140290	3485	3860	0	150523
282	2926	146424	3268	2565	0	155183
283	3418	8509	3103	138874	0	153904
284	3053	4493	141254	6177	0	154977
285	2842	2983	143718	3606	0	153149
286	3382	2718	8904	137571	0	152575
287	3252	2473	4956	140785	0	151466
288	3586	2566	3475	131497	0	141124
289	3132	139557	2873	7692	0	153254
290	139667	6469	2712	4349	0	153197
291	140041	3825	2792	3311	0	149969
292	8383	139239	2763	2883	0	153268
293	4621	6666	140190	2660	0	154137
294	140463	4025	7024	2583	0	154095
295	7443	2851	143336	2267	0	155897
296	140121	2362	7867	2321	0	152671
297	142502	2191	4653	2774	0	152120
298	140932	2216	3508	2823	0	149479
299	137427	1886	3018	3299	0	145630
300	8498	135247	2756	3295	0	149796
301	108996	4290	1991	2534	0	117811
302	5224	109802	2036	2297	0	119359
303	92791	3792	1663	1450	0	99696
304	4121	91707	1562	1344	0	98734
305	2186	3182	86137	930	0	92435
306	1849	6466	3263	74055	0	85633
307	1500	78963	2036	2591	0	85090
308	1492	79643	1252	1452	0	83839
309	73794	3320	3159	1816	0	82089
310	68038	1105	948	824	0	70915
311	2702	69118	898	589	0	73307
312	1590	1900	908	64366	0	68764
313	1257	71945	849	1646	0	75697
314	72798	2050	782	802	0	76432
315	2696	891	73223	513	0	77323
316	1670	868	2244	69676	0	74458
317	1389	687	1140	70801	0	74017
318	1267	602	996	72119	0	74984
319	1074	740	71219	2312	0	75345
320	1101	68957	2229	1007	0	73294
321	1119	73246	1090	721	0	76176
322	1177	2333	888	72615	0	77013
323	1057	1187	74076	1928	0	78248
324	1067	1088	2212	72527	0	76894
325	981	1066	1093	74539	0	77679
326	1001	938	923	74491	0	77353
327	1092	897	754	74958	0	77701
328	72102	783	1124	2966	0	76975
329	2087	73749	937	1438	0	78211
330	73126	2257	907	1321	0	77611
331	2318	1203	73593	1101	0	78215
332	1192	1115	74542	985	0	77834
333	1230	983	2361	70799	0	75373
334	1028	839	1216	72052	0	75135
335	756	74849	1110	2626	0	79341
336	826	2057	75234	1485	0	79602
337	658	75487	2354	1469	0	79968
338	756	2265	76547	1201	0	80769
339	71217	1100	2317	1325	0	75959
340	2188	76843	1131	1056	0	81218
341	1229	2346	76960	896	0	81431
342	1256	1206	2190	75355	0	80007
343	888	1160	77146	2279	0	81473
344	833	76782	2329	1263	0	81207
345	1126	2272	1136	73242	0	77776
346	945	76519	945	2372	0	80781
347	1047	2307	76343	1206	0	80903
348	1239	1180	1999	73894	0	78312
349	74000	1071	843	2279	0	78193
350	2291	73927	783	1018	0	78019
351	1167	2249	70872	751	0	75039
352	1148	2280	1774	65971	0	71173
353	771	928	69130	1804	0	72633
354	607	661	60911	700	0	62879
355	468	55660	1502	495	0	58125
356	814	835	660	49062	0	51371
357	260	442	350	49638	0	50690
358	306	289	248	49031	0	49874
359	183	272	49552	858	0	50865
360	202	214	48845	391	0	49652
361	44057	248	801	492	0	45598
362	665	185	47878	244	0	48972
363	43710	161	701	351	0	44923
364	672	46614	321	242	0	47849
365	314	665	269	44790	0	46038
366	195	46902	243	579	0	47919
367	152	48135	236	326	0	48849
368	139	733	47297	241	0	48410
369	195	350	691	46263	0	47499
370	141	301	47468	682	0	48592
371	114	247	44797	298	0	45456
372	43478	172	725	382	0	44757
373	553	195	46251	220	0	47219
374	194	141	45417	236	0	45988
375	42587	147	711	381	0	43826
376	559	143	45195	250	0	46147
377	185	186	46273	198	0	46842
378	264	179	721	43436	0	44600
379	137	46319	365	563	0	47384
380	179	574	319	46577	0	47649
381	171	216	307	46023	0	46717
382	46420	160	273	883	0	47736
383	583	189	261	45915	0	46948
384	202	47764	238	705	0	48909
385	46847	613	256	411	0	48127
386	587	292	47401	300	0	48580
387	45443	221	703	443	0	46810
388	705	203	51670	235	0	52813
389	262	189	52830	227	0	53508
390	155	54722	971	228	0	56076
391	46877	742	425	7788	0	55832
392	606	55932	354	366	0	57258
393	258	847	55731	244	0	57080
394	410	356	835	50249	0	51850
395	180	56455	422	673	0	57730
396	57101	827	399	381	0	58708
397	56997	333	312	329	0	57971
398	936	57737	337	236	0	59246
399	59386	902	328	240	0	60856
400	1030	383	287	56704	0	58404
401	351	58200	359	858	0	59768
402	358	934	295	59799	0	61386
403	334	418	261	63667	0	64680
404	64483	326	269	1219	0	66297
405	63445	291	279	554	0	64569
406	63432	217	310	432	0	64391
407	1284	285	62946	291	0	64806
408	60927	210	992	289	0	62418
409	1257	421	439	62666	0	64783
410	489	216	62654	951	0	64310
411	383	188	59327	382	0	60280
412	261	59977	1133	311	0	61682
413	54883	788	523	261	0	56455
414	830	56707	247	182	0	57966
415	475	748	196	56203	0	57622
416	425	266	174	57169	0	58034
417	272	167	58128	920	0	59487
418	443	195	826	55441	0	56905
419	246	141	58332	834	0	59553
420	207	126	56155	347	0	56835
421	197	57864	879	239	0	59179
422	337	632	333	56215	0	57517
423	252	241	215	56418	0	57126
424	56294	176	177	832	0	57479
425	674	148	56328	336	0	57486
426	384	152	669	56889	0	58094
427	57517	96	329	845	0	58787
428	722	108	57890	378	0	59098
429	56363	112	779	343	0	57597
430	58256	116	359	277	0	59008
431	889	168	59792	198	0	61047
432	528	144	774	58070	0	59516
433	395	130	345	59235	0	60105
434	272	152	60820	880	0	62124
435	58685	104	781	568	0	60138
436	61286	120	372	403	0	62181
437	59790	132	356	345	0	60623
438	60707	135	331	321	0	61494
439	59914	188	334	329	0	60765
440	1296	404	47853	552	0	50105
441	556	247	60518	279	0	61600
442	432	61332	849	309	0	62922
443	396	737	62018	295	0	63446
444	475	368	896	60322	0	62061
445	1021	343	791	44177	0	46332
446	522	240	286	62190	0	63238
447	599	180	243	62889	0	63911
448	555	195	62761	991	0	64502
449	511	60752	787	502	0	62552
450	461	64364	413	407	0	65645
451	539	914	340	61447	0	63240
452	387	65776	278	850	0	67291
453	65658	833	279	637	0	67407
454	65380	328	269	572	0	66549
455	1235	68928	300	430	0	70893
456	770	813	322	69017	0	70922
457	620	331	317	70855	0	72123
458	472	265	71050	1234	0	73021
459	64179	233	1073	831	0	66316
460	70772	274	529	575	0	72150
461	1285	72552	464	415	0	74716
462	73307	1096	360	563	0	75326
463	1351	544	75356	430	0	77681
464	697	73845	1073	519	0	76134
465	523	76909	551	501	0	78484
466	507	78024	455	590	0	79576
467	599	1351	428	77176	0	79554
468	76773	521	468	1470	0	79232
469	1529	391	447	77931	0	80298
470	829	363	79282	1460	0	81934
471	722	356	1452	78644	0	81174
472	626	403	81827	1589	0	84445
473	734	383	1578	77821	0	80516
474	814	428	728	76297	0	78267
475	536	81398	624	1569	0	84127
476	82776	1402	574	962	0	85714
477	1686	597	499	80306	0	83088
478	845	82750	523	1583	0	85701
479	82703	1404	509	1018	0	85634
480	69903	728	660	1116	0	72407
481	82729	422	493	907	0	84551
482	1710	82940	580	753	0	85983
483	768	1342	83023	743	0	85876
484	766	651	1539	82000	0	84956
485	834	842	713	78700	0	81089
486	681	82808	525	1754	0	85768
487	746	1319	81186	852	0	84103
488	673	468	78170	614	0	79925
489	74469	377	1508	628	0	76982
490	1590	536	624	75504	0	78254
491	637	317	77487	1336	0	79777
492	539	79887	1199	673	0	82298
493	854	1310	536	75817	0	78517
494	560	81364	448	1102	0	83474
495	480	1190	80497	519	0	82686
496	74572	452	1236	717	0	76977
497	78959	307	544	649	0	80459
498	1446	79999	430	459	0	82334
499	737	1109	281	78392	0	80519
500	541	452	78857	1151	0	81001
501	479	77622	1161	510	0	79772
502	75005	1120	426	578	0	77129
503	1006	72599	268	288	0	74161
504	366	73391	197	224	0	74178
505	494	1129	211	71099	0	72933
506	234	72950	173	889	0	74246
507	72305	1022	155	471	0	73953
508	1043	434	208	72144	0	73829
509	320	305	70265	870	0	71760
510	278	243	67490	299	0	68310
511	286	286	871	67854	0	69297
512	143	69775	316	803	0	71037
513	69668	867	257	438	0	71230
514	919	320	180	68702	0	70121
515	317	278	68776	867	0	70238
516	338	250	801	67598	0	68987
517	246	249	280	68313	0	69088
518	67363	252	239	1133	0	68987
519	912	241	143	66741	0	68037
520	328	251	66120	904	0	67603
521	283	271	64774	384	0	65712
522	316	193	935	66079	0	67523
523	282	185	397	67071	0	67935
524	183	228	68667	1040	0	70118
525	58889	205	898	821	0	60813
526	942	237	67498	334	0	69011
527	318	66997	891	331	0	68537
528	305	834	353	67867	0	69359
529	217	340	68360	883	0	69800
530	235	245	66511	414	0	67405
531	305	293	945	64540	0	66083
532	65495	191	412	1107	0	67205
533	879	213	68174	353	0	69619
534	269	69322	899	377	0	70867
535	69443	841	394	577	0	71255
536	870	309	71260	321	0	72760
537	66205	187	962	518	0	67872
538	70427	171	401	472	0	71471
539	963	74644	319	330	0	76256
540	520	831	288	70780	0	72419
541	258	73179	305	737	0	74479
542	252	940	73255	348	0	74795
543	70122	344	912	488	0	71866
544	73793	258	367	435	0	74853
545	1070	251	75238	235	0	76794
546	453	227	73290	248	0	74218
547	272	76901	1053	252	0	78478
548	78299	920	430	398	0	80047
549	1137	359	300	77820	0	79616
550	546	250	285	74227	0	75308
551	309	77532	280	919	0	79040
552	75458	925	261	559	0	77203
553	970	374	78925	285	0	80554
554	471	261	920	85625	0	87277
555	85924	207	385	1841	0	88357
556	1720	87993	329	465	0	90507
557	506	1731	94569	270	0	97076
558	389	464	96793	201	0	97847
559	646	679	2464	91103	0	94892
560	186	97736	654	1927	0	100503
561	236	2198	98665	442	0	101541
562	579	545	2252	95047	0	98423
563	97003	251	551	2551	0	100356
564	2325	269	100434	494	0	103522
565	854	215	2441	98007	0	101517
566	324	201	101572	2366	0	104463
567	274	168	103942	547	0	104931
568	686	734	2869	100719	0	105008
569	331	198	105367	2435	0	108331
570	87556	135	2696	1202	0	91589
571	2245	158	103151	336	0	105890
572	93888	91	2432	584	0	96995
573	2270	101244	701	215	0	104430
574	103863	2158	434	665	0	107120
575	2263	108456	394	232	0	111345
576	878	2302	305	107276	0	110761
577	619	500	321	112632	0	114072
578	307	323	111827	2699	0	115156
579	256	253	112655	783	0	113947
580	556	153	2949	112499	0	116157
581	270	233	116201	2505	0	119209
582	617	218	2815	108247	0	111897
583	251	111670	940	2423	0	115284
584	333	117527	708	729	0	119297
585	587	2802	576	113961	0	117926
586	604	806	480	115632	0	117522
587	317	580	115108	2831	0	118836
588	562	428	2566	109929	0	113485
589	261	111379	836	2664	0	115140
590	227	112555	717	916	0	114415
591	262	115192	612	757	0	116823
592	572	2784	546	106149	0	110051
593	206	109111	743	2623	0	112683
594	107453	2559	575	1125	0	111712
595	2571	708	636	107487	0	111402
596	674	553	108029	2645	0	111901
597	729	465	2684	104866	0	108744
598	388	455	108947	2865	0	112655
599	454	518	107961	974	0	109907
600	381	445	109689	761	0	111276
601	342	109647	3162	798	0	113949
602	367	2598	111444	631	0	115040
603	107307	840	2939	967	0	112053
604	111205	686	1076	837	0	113804
605	113293	559	950	856	0	115658
606	3144	467	784	111864	0	116259
607	111366	504	818	3078	0	115766
608	2661	108776	887	1087	0	113411
609	842	116224	773	953	0	118792
610	113646	2852	840	1084	0	118422
611	2665	1050	117896	789	0	122400
612	1073	706	2862	115363	0	120004
613	640	686	120496	2796	0	124618
614	570	733	121694	1176	0	124173
615	415	123325	3299	906	0	127945
616	910	2782	1414	112441	0	117547
617	683	1005	1072	124943	0	127703
618	122474	776	856	3556	0	127662
619	2644	123603	877	1365	0	128489
620	1031	127078	807	1122	0	130038
621	986	3263	126041	997	0	131287
622	722	128499	2931	910	0	133062
623	123824	3169	1465	1225	0	129683
624	123316	1237	1355	1346	0	127254
625	3057	1045	129050	913	0	134065
626	1088	858	129991	1106	0	133043
627	1004	818	4162	120081	0	126065
628	932	831	2032	122702	0	126497
629	756	126122	1540	3361	0	131779
630	1043	3018	1320	124319	0	129700
631	1067	1042	1392	125831	0	129332
632	900	126229	1239	3626	0	131994
633	1041	2894	1258	125054	0	130247
634	945	1136	1453	120131	0	123665
635	696	119653	1386	3775	0	125510
636	812	2829	120241	1605	0	125487
637	1060	1140	3437	121268	0	126905
638	121728	1021	1601	3590	0	127940
639	119050	1017	1386	1500	0	122953
640	3561	1093	118349	1057	0	124060
641	111676	1111	3008	1504	0	117299
642	118018	1094	1133	1462	0	121707
643	3161	119214	1050	1353	0	124778
644	1249	2997	115790	1393	0	121429
645	792	1312	117368	1348	0	120820
646	867	1083	3529	123387	0	128866
647	126091	888	1775	3806	0	132560
648	131439	833	1530	1658	0	135460
649	3886	998	1210	136720	0	142814
650	144440	975	958	4209	0	150582
651	147257	1002	1021	1877	0	151157
652	141270	960	1084	1951	0	145265
653	4539	1030	138976	1258	0	145803
654	1517	706	135878	875	0	138976
655	129388	382	3042	1400	0	134212
656	2823	593	137408	786	0	141610
657	901	133094	2144	397	0	136536
658	1217	2019	1377	130486	0	135099
659	537	642	138807	1740	0	141726
660	426	393	136232	627	0	137678
661	949	734	2318	129281	0	133282
662	403	238	137170	1761	0	139572
663	421	347	134371	720	0	135859
664	378	122866	2101	590	0	125935
665	310	134691	878	278	0	136157
666	134910	1891	707	515	0	138023
667	2073	640	338	132708	0	135759
668	132889	298	419	1978	0	135584
669	1905	284	133534	483	0	136206
670	979	322	1777	128115	0	131193
671	701	320	629	133949	0	135599
672	130876	179	425	2485	0	133965
673	1774	134774	359	952	0	137859
674	860	1650	124330	471	0	127311
675	621	780	128685	316	0	130402
676	323	134389	1977	440	0	137129
677	344	1648	132612	275	0	134879
678	392	132482	1780	256	0	134910
679	296	125292	680	203	0	126471
680	411	1868	126728	219	0	129226
681	116144	594	1848	452	0	119038
682	1910	421	578	128870	0	131779
683	520	132401	478	1563	0	134962
684	598	1622	304	132236	0	134760
685	131697	557	275	2022	0	134551
686	131241	289	378	878	0	132786
687	129833	196	361	679	0	131069
688	2060	266	130413	322	0	133061
689	1022	368	1702	124692	0	127784
690	389	131394	652	1517	0	133952
691	138047	1633	377	999	0	141056
692	2074	536	318	139296	0	142224
693	1293	389	333	133718	0	135733
694	763	236	385	143110	0	144494
695	459	322	141070	2316	0	144167
696	121968	309	1726	1615	0	125618
697	2034	141592	589	598	0	144813
698	1148	1667	418	140692	0	143925
699	969	505	369	142173	0	144016
700	137278	304	491	2642	0	140715
701	2108	359	133004	824	0	136295
702	923	336	140907	466	0	142632
703	591	140755	2215	476	0	144037
704	430	1885	145011	500	0	147826
705	126888	637	2400	1147	0	131072
706	2007	143345	954	589	0	146895
707	751	2097	144491	498	0	147837
708	126786	723	2329	1081	0	130919
709	2188	708	152107	536	0	155539
710	917	153735	2440	465	0	157557
711	1122	2084	931	152807	0	156944
712	963	863	638	156418	0	158882
713	746	556	154178	2496	0	157976
714	882	426	148101	1026	0	150435
715	613	150492	2703	735	0	154543
716	146013	2183	1138	1008	0	150342
717	2235	154059	899	715	0	157908
718	1221	2336	720	152026	0	156303
719	798	950	152807	2223	0	156778
720	131221	645	2837	1392	0	136095
721	2530	697	1252	148399	0	152878
722	1051	146348	1125	2011	0	150535
723	625	153652	996	947	0	156220
724	688	2672	781	152186	0	156327
725	741	1147	919	154280	0	157087
726	151085	829	857	3046	0	155817
727	2458	734	735	155865	0	159792
728	990	842	156828	2644	0	161304
729	146366	702	2552	1675	0	151295
730	155084	550	1077	1543	0	158254
731	3026	692	159183	868	0	163769
732	150743	590	2635	1135	0	155103
733	3148	621	1083	164044	0	168896
734	1601	688	918	165950	0	169157
735	1401	719	647	167715	0	170482
736	1318	641	677	162818	0	165454
737	728	167434	821	3529	0	172512
738	169673	2754	718	1928	0	175073
739	173358	1103	744	1658	0	176863
740	3799	913	177593	1231	0	183536
741	177569	640	3025	1623	0	182857
742	190276	688	1197	1290	0	193451
743	192132	730	933	1324	0	195119
744	196717	578	825	1290	0	199410
745	6425	194426	804	897	0	202552
746	2471	3623	550	185682	0	192326
747	1341	1189	188252	3436	0	194218
748	1141	795	177253	1313	0	180502
749	159029	1571	4602	1530	0	166732
750	170030	442	1833	961	0	173266
751	3689	168016	648	551	0	172904
752	169798	2756	445	942	0	173941
753	3494	171289	470	549	0	175802
754	2144	3017	481	169791	0	175433
755	173644	992	460	3457	0	178553
756	168521	627	383	1639	0	171170
757	170338	464	342	1218	0	172362
758	4205	170076	398	616	0	175295
759	168298	2921	373	867	0	172459
760	4150	1092	415	169323	0	174980
761	173082	606	459	3446	0	177593
762	4017	615	169577	975	0	175184
763	1865	171181	2940	705	0	176691
764	170262	2892	882	951	0	174987
765	3822	1193	172578	436	0	178029
766	2349	820	2903	167775	0	173847
767	1503	630	174638	2910	0	179681
768	1348	599	171709	1062	0	174718
769	1777	498	3586	169843	0	175704
770	1347	573	176873	3027	0	181820
771	1793	486	3378	172595	0	178252
772	1673	556	1255	175676	0	179160
773	178791	446	898	4401	0	184536
774	3777	179581	923	1614	0	185895
775	1707	182495	831	1069	0	186102
776	1311	185667	920	820	0	188718
777	1213	4284	183128	771	0	189396
778	1900	1512	3672	178967	0	186051
779	1113	962	186852	3633	0	192560
780	170837	733	3974	2176	0	177720
781	182345	726	1602	1616	0	186289
782	4283	185717	1291	939	0	192230
783	2448	3520	953	179806	0	186727
784	1344	187287	953	3461	0	193045
785	185243	3802	855	1888	0	191788
786	4548	1490	763	185595	0	192396
787	1987	1227	186561	3831	0	193606
788	1461	183987	3705	1726	0	190879
789	1226	4036	187193	1167	0	193622
790	1764	1622	3951	183153	0	190490
791	1216	1177	184560	3859	0	190812
792	168181	939	4198	2435	0	175753
793	4281	1007	183155	1311	0	189754
794	1953	183719	4227	1162	0	191061
795	2052	3888	1759	181794	0	189493
796	1777	1621	1385	186989	0	191772
797	182840	1198	1181	5249	0	190468
798	183323	1045	1173	2603	0	188144
799	4914	182386	1251	1464	0	190015
800	2221	3884	181164	1278	0	188547
801	1684	1736	178696	1188	0	183304
802	171688	1279	4765	1850	0	179582
803	4531	1112	180029	1150	0	186822
804	2212	1058	175186	1149	0	179605
805	1757	1067	175105	1098	0	179027
806	1690	1120	175121	966	0	178897
807	1466	175681	5220	1154	0	183521
808	176224	3935	2568	1499	0	184226
809	4821	1750	1776	170046	0	178393
810	170863	1285	1642	4233	0	178023
811	4724	169466	1678	1677	0	177545
812	167615	4038	1604	1804	0	175061
813	4574	173925	1661	1205	0	181365
814	2934	4349	1656	169571	0	178510
815	1988	182265	1737	3701	0	189691
816	1866	4617	179854	1631	0	187968
817	1566	185927	4864	1277	0	193634
818	2031	4874	2457	196200	0	205562
819	197962	2174	1917	5104	0	207157
820	5552	1691	1653	198107	0	207003
821	2590	1701	198174	5113	0	207578
822	2734	1488	4902	188959	0	198083
823	1702	197586	2566	4797	0	206651
824	1710	5026	197448	2297	0	206481
825	191460	2345	5199	2230	0	201234
826	5813	1743	2501	200057	0	210114
827	194955	1483	2010	5778	0	204226
828	196121	1468	1829	3251	0	202669
829	5697	198032	1839	2021	0	207589
830	191615	4999	1734	2458	0	200806
831	198837	2307	1774	2115	0	205033
832	6075	197884	1718	1626	0	207303
833	3299	4812	1671	195674	0	205456
834	2510	2160	1638	195035	0	201343
835	1614	195354	1806	5594	0	204368
836	2153	4927	1469	197129	0	205678
837	1567	2302	194336	5155	0	203360
838	2308	2151	4579	188017	0	197055
839	1750	1329	188119	4965	0	196163
840	1410	1138	171481	2105	0	176134
841	1219	170937	4534	1714	0	178404
842	1159	171027	2053	1392	0	175631
843	1312	176576	1501	1138	0	180527
844	2307	4184	1459	166836	0	174786
845	872	1778	169076	3335	0	175061
846	160224	1096	3480	2054	0	166854
847	3672	972	1543	168055	0	174242
848	1336	1009	168756	3454	0	174555
849	1054	1093	166502	1402	0	170051
850	884	170377	3917	1230	0	176408
851	1282	3617	1663	165704	0	172266
852	163658	1357	1271	3950	0	170236
853	3080	164672	1129	1495	0	170376
854	1215	165616	1004	1152	0	168987
855	862	165169	1050	1050	0	168131
856	1150	4343	1037	165082	0	171612
857	625	173245	1081	3485	0	178436
858	1305	4040	941	186002	0	192288
859	1353	1600	917	191155	0	195025
860	880	1296	186498	5222	0	193896
861	164148	1081	4456	3193	0	172878
862	4341	1143	187628	1210	0	194322
863	2054	1421	4685	183493	0	191653
864	1051	1069	187983	4518	0	194621
865	738	185999	4749	1985	0	193471
866	184359	4555	2157	1872	0	192943
867	4976	1828	1324	178994	0	187122
868	2222	1092	992	185028	0	189334
869	181854	950	1012	5803	0	189619
870	179831	815	953	2856	0	184455
871	184885	886	992	2089	0	188852
872	5580	1100	181730	1174	0	189584
873	165716	837	3932	1642	0	172127
874	4452	172818	1484	1105	0	179859
875	1685	177457	889	1155	0	181186
876	1821	4769	904	167860	0	175354
877	1754	1792	601	163429	0	167576
878	1073	167081	760	4691	0	173605
879	1527	4180	744	166554	0	173005
880	164098	1515	769	5065	0	171447
881	4271	1299	164877	1922	0	172369
882	1590	164383	4000	1462	0	171435
883	155997	4230	1367	1891	0	163485
884	3808	162334	1057	1407	0	168606
885	1569	4507	161336	1254	0	168666
886	1658	1962	3991	158670	0	166281
887	1161	1378	160987	4224	0	167750
888	960	159363	4393	1847	0	166563
889	1533	4284	1626	157386	0	164829
890	1021	1827	157834	4225	0	164907
891	1039	1471	158559	1839	0	162908
892	1547	1284	4764	156009	0	163604
893	156268	1047	1981	4819	0	164115
894	158330	1080	1378	2326	0	163114
895	158865	1073	1050	1944	0	162932
896	5090	1248	157777	1340	0	165455
897	1971	157716	4272	1241	0	165200
898	1623	4219	1824	155099	0	162765
899	1510	1728	1433	152028	0	156699
900	1100	158356	1133	4787	0	165376
901	156290	4348	1061	2543	0	164242
902	4657	1842	951	157788	0	165238
903	1798	1409	157075	4633	0	164915
904	1257	156985	4430	2282	0	164954
905	150351	4264	1978	2405	0	158998
906	4024	155753	1601	1845	0	163223
907	2261	4563	1374	151276	0	159474
908	1929	1902	1412	153849	0	159092
909	1783	1444	1479	155154	0	159860
910	1351	1444	152428	5531	0	160754
911	1728	1498	4389	144645	0	152260
912	1502	145924	1997	4830	0	154253
913	1452	147244	1471	2453	0	152620
914	1628	4576	139310	2047	0	147561
915	123544	1924	3912	2507	0	131887
916	134679	1398	1754	2344	0	140175
917	4672	132150	1399	1696	0	139917
918	119327	3534	1248	1671	0	125780
919	119858	1557	860	1613	0	123888
920	4102	124043	1058	1482	0	130685
921	2291	3854	1044	123977	0	131166
922	1602	1690	127745	4000	0	135037
923	1441	1539	124838	1956	0	129774
924	122743	1474	4330	1943	0	130490
925	3930	127073	1653	1712	0	134368
926	2174	4067	1196	125572	0	133009
927	1766	1969	1001	127787	0	132523
928	1868	1384	1088	128128	0	132468
929	123795	1188	1261	5070	0	131314
930	4696	1263	1199	123517	0	130675
931	2505	1331	1069	123733	0	128638
932	1695	1382	118090	4378	0	125545
933	109120	1222	3595	2498	0	116435
934	3652	116875	1783	1694	0	124004
935	115405	3695	1286	1953	0	122339
936	3834	114914	1293	1536	0	121577
937	1968	3758	1175	114231	0	121132
938	115137	1515	1130	4287	0	122069
939	118246	1214	1190	2273	0	122923
940	4468	1205	114766	1659	0	122098
941	118341	1138	3394	1779	0	124652
942	4559	1130	120550	1366	0	127605
943	2043	1271	118119	1302	0	122735
944	1562	1288	118037	1450	0	122337
945	1424	1220	125439	1365	0	129448
946	1620	1332	4790	124585	0	132327
947	1370	1050	127237	4302	0	133959
948	1604	1176	4492	124699	0	131971
949	124852	1092	2079	4795	0	132818
950	4567	1226	1638	124196	0	131627
951	121187	999	1459	5109	0	128754
952	4342	122163	1427	2248	0	130180
953	2504	4299	1309	120497	0	128609
954	1849	1542	118433	4571	0	126395
955	1429	124162	3907	2383	0	131881
956	2004	4754	1718	113845	0	122321
957	1370	1338	115938	4093	0	122739
958	690	101786	3131	1433	0	107040
959	554	104234	1140	1151	0	107079
960	1040	3219	101235	804	0	106298
961	1089	1912	3161	94314	0	100476
962	513	695	96589	2808	0	100605
963	88326	402	3075	1129	0	92932
964	92755	409	919	950	0	95033
965	2993	92154	755	504	0	96406
966	91491	2585	496	634	0	95206
967	3190	809	482	90955	0	95436
968	912	655	90664	2693	0	94924
969	85814	371	2678	1237	0	90100
970	2805	377	88871	789	0	92842
971	836	86782	2843	482	0	90943
972	88346	2591	1123	591	0	92651
973	2987	819	715	87481	0	92002
974	865	602	88872	2507	0	92846
975	86791	356	2729	1040	0	90916
976	87256	321	982	919	0	89478
977	88922	323	754	562	0	90561
978	3721	320	445	86090	0	90576
979	1610	330	424	88518	0	90882
980	976	319	86898	3004	0	91197
981	715	86209	2639	1207	0	90770
982	1003	2411	945	84299	0	88658
983	939	724	801	88567	0	91031
984	589	609	87269	3084	0	91551
985	542	491	87889	1258	0	90180
986	828	352	3270	86386	0	90836
987	84314	386	1350	3197	0	89247
988	2561	86370	1083	1193	0	91207
989	85648	2528	754	1190	0	90120
990	3041	86226	804	808	0	90879
991	1206	2833	85949	728	0	90716
992	1009	922	87454	796	0	90181
993	82372	718	3393	972	0	87455
994	90256	569	1440	979	0	93244
995	3466	89790	1059	904	0	95219
996	1543	2881	88081	927	0	93432
997	1421	1012	3193	86553	0	92179
998	1272	868	1449	84337	0	87926
999	888	88323	1222	3365	0	93798
1000	1150	2922	866	88472	0	93410
1001	877	1263	89251	3478	0	94869
1002	86543	1112	3165	1597	0	92417
1003	90151	764	1408	1366	0	93689
1004	87726	818	1194	1166	0	90904
1005	92706	657	1026	1009	0	95398
1006	4495	617	89294	836	0	95242
1007	88698	519	3438	873	0	93528
1008	4240	591	89249	600	0	94680
1009	1913	88174	3858	718	0	94663
1010	1860	2884	1816	88975	0	95535
1011	90870	1143	1492	3363	0	96868
1012	3845	914	1208	94744	0	100711
1013	1698	778	95428	4000	0	101904
1014	94429	690	3842	1797	0	100758
1015	98413	631	1681	1538	0	102263
1016	4979	606	1286	95621	0	102492
1017	2733	560	1036	98311	0	102640
1018	1946	706	95148	4388	0	102188
1019	1515	96272	3790	2119	0	103696
1020	91534	3162	1543	1502	0	97741
1021	3908	1225	85796	1012	0	91941
1022	83908	945	3250	1048	0	89151
1023	3968	86119	1511	893	0	92491
1024	85417	3058	1259	911	0	90645
1025	4065	83184	1002	748	0	88999
1026	2021	85183	893	882	0	88979
1027	1958	3641	971	83583	0	90153
1028	1652	1629	835	87251	0	91367
1029	1508	1146	844	88272	0	91770
1030	1424	845	725	89210	0	92204
1031	1087	764	85774	4536	0	92161
1032	83593	759	3223	2319	0	89894
1033	87944	683	1387	1786	0	91800
1034	89730	599	1230	1364	0	92923
1035	4856	563	1031	86134	0	92584
1036	2806	530	894	88526	0	92756
1037	87330	609	869	4054	0	92862
1038	87819	631	771	2041	0	91262
1039	87691	736	736	1656	0	90819
1040	4753	840	755	81701	0	88049
1041	2367	831	720	80309	0	84227
1042	1688	594	76579	3689	0	82550
1043	1393	474	74728	1892	0	78487
1044	1260	75174	3125	1497	0	81056
1045	64717	2863	2646	1531	0	71757
1046	64206	796	1107	981	0	67090
1047	64755	589	571	977	0	66892
1048	2934	537	65745	779	0	69995
1049	64881	474	1913	979	0	68247
1050	67514	350	859	925	0	69648
1051	68461	351	718	896	0	70426
1052	3340	230	622	66186	0	70378
1053	2081	265	586	66564	0	69496
1054	1775	315	565	66556	0	69211
1055	1254	361	57074	2578	0	61267
1056	54105	327	1294	1443	0	57169
1057	2126	57978	648	944	0	61696
1058	53314	1268	410	710	0	55702
1059	1880	52179	336	606	0	55001
1060	1165	53455	326	559	0	55505
1061	1177	1595	408	52463	0	55643
1062	1133	857	436	51674	0	54100
1063	762	52017	339	1654	0	54772
1064	51414	1285	325	989	0	54013
1065	52005	611	338	825	0	53779
1066	1908	458	361	51019	0	53746
1067	1183	383	51100	1488	0	54154
1068	1064	293	48996	894	0	51247
1069	972	277	51730	726	0	53705
1070	929	286	52035	589	0	53839
1071	49505	425	1895	604	0	52429
1072	50651	251	806	492	0	52200
1073	1860	251	518	49176	0	51805
1074	1129	290	48648	1395	0	51462
1075	919	279	1157	48036	0	50391
1076	715	48341	604	1426	0	51086
1077	731	54566	491	836	0	56624
1078	56337	1420	365	798	0	58920
1079	56974	757	310	675	0	58716
1080	58000	514	323	687	0	59524
1081	1965	407	377	56904	0	59653
1082	1173	395	342	58526	0	60436
1083	997	384	341	58660	0	60382
1084	975	296	293	58334	0	59898
1085	837	251	57775	1945	0	60808
1086	909	225	1125	57910	0	60169
1087	60819	186	588	1841	0	63434
1088	1705	189	528	61391	0	63813
1089	1051	222	423	62292	0	63988
1090	916	379	433	61920	0	63648
1091	741	58981	425	2069	0	62216
1092	693	59239	389	1163	0	61484
1093	645	60999	324	855	0	62823
1094	726	1254	263	58012	0	60255
1095	611	500	237	59053	0	60401
1096	58542	343	204	1719	0	60808
1097	58517	274	206	958	0	59955
1098	59261	295	210	783	0	60549
1099	1698	267	228	58533	0	60726
1100	930	235	237	58357	0	59759
1101	753	57609	232	1480	0	60074
1102	714	60897	189	808	0	62608
1103	60150	1160	150	750	0	62210
1104	1475	433	148	59805	0	61861
1105	59329	252	186	1474	0	61241
1106	60707	201	207	902	0	62017
1107	1496	210	243	59426	0	61375
1108	714	63628	233	1193	0	65768
1109	64783	963	173	863	0	66782
1110	66782	356	106	815	0	68059
1111	1443	297	68650	513	0	70903
1112	62596	171	515	449	0	63731
1113	837	65803	216	241	0	67097
1114	465	600	92	67931	0	69088
1115	76899	245	66	1288	0	78498
1116	1071	190	74	77567	0	78902
1117	648	156	89	78177	0	79070
1118	371	78645	112	1045	0	80173
1119	78000	714	59	732	0	79505
1120	78435	306	52	512	0	79305
1121	1084	77883	70	327	0	79364
1122	535	83069	78	212	0	83894
1123	83248	896	92	483	0	84719
1124	82226	415	56	428	0	83125
1125	1105	300	80402	252	0	82059
1126	695	220	73951	253	0	75119
1127	456	196	82084	182	0	82918
1128	446	160	951	83084	0	84641
1129	371	162	405	85455	0	86393
1130	295	145	85330	966	0	86736
1131	80724	126	733	852	0	82435
1132	87770	162	327	569	0	88828
1133	88216	153	223	442	0	89034
1134	86714	118	148	466	0	87446
1135	1270	181	94370	234	0	96055
1136	92762	136	774	691	0	94363
1137	96902	160	583	668	0	98313
1138	97063	148	262	610	0	98083
1139	98958	126	166	556	0	99806
1140	97910	114	175	540	0	98739
1141	1297	172	100774	283	0	102526
1142	723	100676	735	252	0	102386
1143	752	751	334	98857	0	100694
1144	575	345	246	103623	0	104789
1145	496	296	102924	1035	0	104751
1146	91811	187	810	939	0	93747
1147	1205	166	344	101141	0	102856
1148	722	223	101420	878	0	103243
1149	724	211	93350	548	0	94833
1150	522	103053	970	467	0	105012
1151	609	771	457	105296	0	107133
1152	558	407	323	106448	0	107736
1153	582	333	206	105378	0	106499
1154	106709	202	188	1539	0	108638
1155	1124	163	243	106708	0	108238
1156	688	215	105539	1068	0	107510
1157	703	245	93639	718	0	95305
1158	570	228	107826	570	0	109194
1159	689	205	1185	109885	0	111964
1160	112710	161	591	1351	0	114813
1161	1139	251	114167	519	0	116076
1162	108704	159	929	869	0	110661
1163	122964	169	517	1060	0	124710
1164	1462	195	412	125707	0	127776
1165	1001	186	317	125930	0	127434
1166	685	124967	281	1313	0	127246
1167	589	847	126405	653	0	128494
1168	120173	380	1016	916	0	122485
1169	1335	320	509	129520	0	131684
1170	737	129342	442	1052	0	131573
1171	746	865	361	131249	0	133221
1172	550	486	131174	1115	0	133325
1173	723	403	1020	126811	0	128957
1174	527	129458	561	1206	0	131752
1175	597	820	402	130364	0	132183
1176	128932	342	358	1529	0	131161
1177	1206	327	358	126050	0	127941
1178	653	122839	381	1156	0	125029
1179	557	125542	340	675	0	127114
1180	117869	993	274	1107	0	120243
1181	1137	568	124748	430	0	126883
1182	915	341	962	121970	0	124188
1183	708	232	462	126691	0	128093
1184	551	257	128610	1284	0	130702
1185	417	128075	997	820	0	130309
1186	418	901	129179	542	0	131040
1187	552	599	963	125394	0	127508
1188	289	129131	497	836	0	130753
1189	130394	711	310	1177	0	132592
1190	829	130923	318	520	0	132590
1191	433	132855	262	445	0	133995
1192	133877	835	332	879	0	135923
1193	134813	397	227	928	0	136365
1194	138132	248	221	833	0	139434
1195	1191	179	214	140126	0	141710
1196	531	235	141678	801	0	143245
1197	137124	147	823	1158	0	139252
1198	149170	115	348	913	0	150546
1199	1699	129	270	154326	0	156424
1200	558	263	155025	1215	0	157061
1201	348	153123	1230	534	0	155235
1202	151106	1147	371	1009	0	153633
1203	154879	349	260	1137	0	156625
1204	1425	158130	230	277	0	160062
1205	512	163145	203	252	0	164112
1206	161648	1405	189	916	0	164158
1207	160507	473	123	829	0	161932
1208	158075	294	132	694	0	159195
1209	1909	218	138	157352	0	159617
1210	626	332	159595	1274	0	161827
1211	800	206	1170	153189	0	155365
1212	394	271	156509	1367	0	158541
1213	330	151426	1274	598	0	153628
1214	301	155188	435	359	0	156283
1215	767	1122	251	143359	0	145499
1216	639	267	171	146169	0	147246
1217	651	236	180	142815	0	143882
1218	253	146509	241	1266	0	148269
1219	143208	1144	227	972	0	145551
1220	141639	421	152	936	0	143148
1221	1344	146981	161	303	0	148789
1222	768	1148	113	141636	0	143665
1223	396	143584	132	1088	0	145200
1224	656	1288	114	142149	0	144207
1225	462	143866	139	1077	0	145544
1226	142711	1141	166	946	0	144964
1227	1494	376	135	140844	0	142849
1228	434	387	139923	1260	0	142004
1229	131432	252	1130	1215	0	134029
1230	135393	238	359	1160	0	137150
1231	1310	431	137855	416	0	140012
1232	852	383	1105	135423	0	137763
1233	384	486	139514	1300	0	141684
1234	625	314	1134	138132	0	140205
1235	378	457	133199	1418	0	135452
1236	123471	383	1139	1097	0	126090
1237	1547	420	294	129905	0	132166
1238	577	132847	265	1240	0	134929
1239	136032	1517	161	1038	0	138748
1240	1902	521	185	138817	0	141425
1241	772	438	187	138697	0	140094
1242	528	527	137659	1833	0	140547
1243	951	353	1512	145118	0	147934
1244	527	429	152108	2263	0	155327
1245	603	398	155334	782	0	157117
1246	935	301	2676	159925	0	163837
1247	535	350	173233	2553	0	176671
1248	167115	279	3059	1639	0	172092
1249	198566	299	923	1343	0	201131
1250	203735	394	600	1435	0	206164
1251	4963	214963	559	697	0	221182
1252	2879	4345	480	212208	0	219912
1253	2180	1566	455	204144	0	208345
1254	960	219569	531	4908	0	225968
1255	217379	4620	374	2580	0	224953
1256	5518	1617	366	216255	0	223756
1257	1985	1168	221538	4967	0	229658
1258	1374	874	211628	2085	0	215961
1259	763	213345	5681	1807	0	221596
1260	212945	4581	2236	1984	0	221746
1261	5030	1725	214118	1080	0	221953
1262	198416	1041	5275	1969	0	206701
1263	5430	201433	2237	1114	0	210214
1264	2196	4679	204041	904	0	211820
1265	1590	1795	189695	1054	0	194134
1266	1211	1206	203190	1011	0	206618
1267	1237	198528	6215	916	0	206896
1268	1452	4861	200687	665	0	207665
1269	193870	1670	5540	1386	0	202466
1270	6029	1432	2555	184153	0	194169
1271	2731	913	1812	200999	0	206455
1272	2091	1000	1312	203900	0	208303
1273	1948	914	1061	205336	0	209259
1274	1406	844	156931	50693	0	209874
1275	1925	751	4448	199703	0	206827
1276	1993	772	1888	204234	0	208887
1277	197590	737	1650	7368	0	207345
1278	203648	742	1537	3622	0	209549
1279	189280	768	1537	3127	0	194712
1280	6363	1082	196279	1684	0	205408
1281	2893	197548	5184	1546	0	207171
1282	1926	210203	2445	1456	0	216030
1283	194404	6209	1628	2322	0	204563
1284	5178	204529	1377	1656	0	212740
1285	3019	5898	1425	199899	0	210241
1286	2376	2349	1342	205604	0	211671
1287	1377	1691	201883	6846	0	211797
1288	1225	198227	5796	3253	0	208501
1289	1229	5503	194348	2453	0	203533
1290	189766	2111	5995	2573	0	200445
1291	201081	1509	2591	2131	0	207312
1292	7313	1116	1936	197407	0	207772
1293	3417	962	1827	196753	0	202959
1294	2493	1018	1779	196821	0	202111
1295	2355	1290	1496	198740	0	203881
1296	1632	1174	193632	7892	0	204330
1297	2216	1391	5422	187567	0	196596
1298	1510	840	188534	6813	0	197697
1299	1324	699	181732	3681	0	187436
1300	1071	182597	6722	2939	0	193329
1301	181518	5103	3237	2842	0	192700
1302	5199	187159	2238	2249	0	196845
1303	2997	5913	1972	179379	0	190261
1304	2005	2193	187039	6044	0	197281
1305	178558	1502	6135	3461	0	189656
1306	6112	1187	184515	2549	0	194363
1307	182859	1157	6813	2439	0	193268
1308	188110	1119	3159	2237	0	194625
1309	8194	1265	2372	188660	0	200491
1310	4243	1192	2175	188665	0	196275
1311	3263	1250	1975	191051	0	197539
1312	2511	1365	183961	8590	0	196427
1313	177840	1493	6629	4520	0	190482
1314	7109	181840	3005	3191	0	195145
1315	4220	6225	2257	181059	0	193761
1316	183298	2734	2084	7810	0	195926
1317	187892	2109	2219	4183	0	196403
1318	189386	1736	2009	3531	0	196662
1319	10128	1917	179086	2867	0	193998
1320	184392	2067	6831	3058	0	196348
1321	188477	2426	3218	3547	0	197668
1322	9301	1944	158508	4013	0	173766
1323	4668	2017	189083	3177	0	198945
1324	4269	1999	8620	185547	0	200435
1325	3617	1361	191019	7542	0	203539
1326	2672	179616	9716	3887	0	195891
1327	2744	191589	5865	2313	0	202511
1328	183873	8263	4199	2486	0	198821
1329	8139	191019	3328	2136	0	204622
1330	5151	7471	3477	188707	0	204806
1331	182387	3412	3473	8100	0	197372
1332	7832	190592	3053	4150	0	205627
1333	3892	7707	3293	188614	0	203506
1334	3529	3070	3490	194082	0	204171
1335	2783	2317	188118	9875	0	203093
1336	3028	2105	8060	187329	0	200522
1337	2743	2003	186689	9819	0	201254
1338	3006	1306	185708	5718	0	195738
1339	3589	1437	8022	178006	0	191054
1340	2908	1505	3524	183046	0	190983
1341	175742	1324	2452	11097	0	190615
1342	7374	185582	2364	6292	0	201612
1343	3971	6251	2015	175239	0	187476
1344	3519	4231	2004	175517	0	185271
1345	163677	1925	1419	9669	0	176690
1346	7234	156972	1506	5037	0	170749
1347	3937	147519	1383	3305	0	156144
1348	2724	138138	1397	2354	0	144613
1349	1332	118200	1057	1379	0	121968
1350	98267	4318	4045	1344	0	107974
1351	97188	1494	998	1197	0	100877
1352	95117	1023	538	1090	0	97768
1353	95637	836	415	1102	0	97990
1354	4508	799	467	92021	0	97795
1355	1773	874	90666	3315	0	96628
1356	1267	89745	3041	1354	0	95407
1357	1344	3099	1080	87469	0	92992
1358	1130	1049	88042	3286	0	93507
1359	1288	906	3173	86378	0	91745
1360	1197	700	1067	88545	0	91509
1361	841	752	86914	3953	0	92460
1362	993	668	3187	86149	0	90997
1363	1265	714	1357	82847	0	86183
1364	87079	579	926	4302	0	92886
1365	87649	545	835	2060	0	91089
1366	87497	493	688	1678	0	90356
1367	87620	538	635	1452	0	90245
1368	4512	528	645	83926	0	89611
1369	2094	573	646	85969	0	89282
1370	1728	635	596	86600	0	89559
1371	83559	558	573	4645	0	89335
1372	4030	562	683	83798	0	89073
1373	2102	504	559	85422	0	88587
1374	1657	531	81379	4405	0	87972
1375	1656	749	3060	78708	0	84173
1376	1347	77331	1073	4023	0	83774
1377	1266	83459	778	2008	0	87511
1378	78493	3293	668	1671	0	84125
1379	3638	1193	77847	1446	0	84124
1380	1561	75244	2753	1322	0	80880
1381	74255	2849	1269	1272	0	79645
1382	3337	1058	846	74439	0	79680
1383	1340	962	74169	3419	0	79890
1384	1363	1016	2801	71157	0	76337
1385	1020	76114	1076	3345	0	81555
1386	75141	2839	970	1777	0	80727
1387	3050	77129	796	1437	0	82412
1388	76595	3122	691	1292	0	81700
1389	78709	1151	584	1393	0	81837
1390	3922	998	597	76684	0	82201
1391	1862	892	526	74941	0	78221
1392	1325	76160	551	3608	0	81644
1393	76645	2909	526	1939	0	82019
1394	3383	1225	75329	1397	0	81334
1395	72512	921	2437	1288	0	77158
1396	72683	711	848	1274	0	75516
1397	3444	621	69010	1263	0	74338
1398	1590	856	2336	65679	0	70461
1399	66536	568	840	2997	0	70941
1400	2903	521	65976	1336	0	70736
1401	1335	561	64079	1082	0	67057
1402	59397	416	2595	1051	0	63459
1403	2473	59555	1185	883	0	64096
1404	1151	57931	733	724	0	60539
1405	1290	2378	593	55892	0	60153
1406	910	1065	56145	2036	0	60156
1407	52259	695	2013	1189	0	56156
1408	2217	534	54591	874	0	58216
1409	955	50246	1814	634	0	53649
1410	50404	1703	859	705	0	53671
1411	2005	796	585	50306	0	53692
1412	50464	629	467	2001	0	53561
1413	2204	471	49994	962	0	53631
1414	1207	502	1627	48018	0	51354
1415	907	50361	765	1595	0	53628
1416	923	1805	525	49737	0	52990
1417	830	886	413	51487	0	53616
1418	876	684	50863	2088	0	54511
1419	826	48582	1575	1229	0	52212
1420	745	49463	754	875	0	51837
1421	745	1623	47142	635	0	50145
1422	43344	732	1536	679	0	46291
1423	45657	455	727	676	0	47515
1424	1968	496	641	44013	0	47118
1425	42332	322	448	1464	0	44566
1426	1576	40197	454	800	0	43027
1427	724	42734	452	707	0	44617
1428	42512	1453	421	666	0	45052
1429	1744	774	404	42314	0	45236
1430	43352	450	417	1554	0	45773
1431	44739	314	286	928	0	46267
1432	1961	382	267	42414	0	45024
1433	1091	443	42334	1421	0	45289
1434	41567	358	1245	788	0	43958
1435	43003	264	577	665	0	44509
1436	2021	342	495	41357	0	44215
1437	1137	41842	385	1385	0	44749
1438	882	1376	300	41984	0	44542
1439	684	564	41480	1589	0	44317
1440	662	456	40418	829	0	42365
1441	564	40535	1459	888	0	43446
1442	721	624	528	29421	0	31294
1443	261	267	256	30212	0	30996
1444	201	205	30047	712	0	31165
1445	28255	129	618	463	0	29465
1446	30422	120	324	291	0	31157
1447	30584	123	206	250	0	31163
1448	30832	133	143	277	0	31385
1449	861	29931	145	211	0	31148
1450	433	31050	147	252	0	31882
1451	31704	699	177	267	0	32847
1452	831	331	144	32268	0	33574
1453	460	210	143	32755	0	33568
1454	303	33109	128	828	0	34368
1455	346	696	98	33572	0	34712
1456	322	339	129	32960	0	33750
1457	282	33170	140	862	0	34454
1458	294	683	33120	427	0	34524
1459	332	320	609	33217	0	34478
1460	33349	227	253	869	0	34698
1461	33037	193	182	512	0	33924
1462	931	220	32460	317	0	33928
1463	512	179	31808	243	0	32742
1464	358	155	32154	248	0	32915
1465	348	208	859	31484	0	32899
1466	287	159	32078	728	0	33252
1467	283	176	31905	423	0	32787
1468	361	322	833	31229	0	32745
1469	246	33239	441	671	0	34597
1470	280	628	33852	356	0	35116
1471	200	34286	716	311	0	35513
1472	33588	718	413	360	0	35079
1473	662	34346	296	264	0	35568
1474	405	661	248	33856	0	35170
1475	34111	318	233	762	0	35424
1476	740	221	238	33919	0	35118
1477	456	200	215	34308	0	35179
1478	306	197	34830	853	0	36186
1479	286	32970	681	466	0	34403
1480	287	34586	352	333	0	35558
1481	301	760	223	33527	0	34811
1482	240	315	194	33593	0	34342
1483	260	207	171	33280	0	33918
1484	204	169	32468	834	0	33675
1485	174	167	29857	399	0	30597
1486	27848	172	616	404	0	29040
1487	483	186	30832	212	0	31713
1488	230	169	30879	208	0	31486
1489	137	30743	648	251	0	31779
1490	246	570	335	31016	0	32167
1491	162	202	31676	611	0	32651
1492	208	162	617	30240	0	31227
1493	138	124	32113	638	0	33013
1494	202	114	669	31732	0	32717
1495	117	120	34036	672	0	34945
1496	192	106	683	33246	0	34227
1497	181	120	301	33419	0	34021
1498	114	35017	254	725	0	36110
1499	167	531	236	34917	0	35851
1500	99	35689	239	691	0	36718
1501	155	611	228	36294	0	37288
1502	147	225	223	36674	0	37269
1503	35680	182	206	888	0	36956
1504	571	159	158	35864	0	36752
1505	209	154	35707	789	0	36859
1506	221	137	604	35268	0	36230
1507	171	126	269	36011	0	36577
1508	104	133	35493	856	0	36586
1509	112	126	34781	470	0	35489
1510	214	136	704	34154	0	35208
1511	190	140	294	35472	0	36096
1512	108	171	35442	845	0	36566
1513	82	33858	628	507	0	35075
1514	70	35515	311	413	0	36309
1515	34667	634	252	424	0	35977
1516	599	261	235	35058	0	36153
1517	35177	158	227	860	0	36422
1518	34327	125	237	509	0	35198
1519	604	35198	248	350	0	36400
1520	35273	586	222	431	0	36512
1521	35539	249	206	377	0	36371
1522	680	197	35351	246	0	36474
1523	360	144	644	35093	0	36241
1524	205	118	36652	719	0	37694
1525	213	143	718	36596	0	37670
1526	133	132	36926	746	0	37937
1527	138	34922	665	313	0	36038
1528	147	36115	288	261	0	36811
1529	335	699	252	34784	0	36070
1530	34566	177	173	694	0	35610
1531	586	131	133	34453	0	35303
1532	250	97	180	34690	0	35217
1533	151	113	35201	678	0	36143
1534	127	119	34689	294	0	35229
1535	134	136	35224	242	0	35736
1536	160	112	704	34535	0	35511
1537	159	121	284	33935	0	34499
1538	86	34813	235	703	0	35837
1539	75	36336	224	361	0	36996
1540	35219	599	211	437	0	36466
1541	470	36051	223	268	0	37012
1542	151	603	35460	241	0	36455
1543	223	188	602	34594	0	35607
1544	98	157	36517	687	0	37459
1545	85	36888	654	397	0	38024
1546	160	598	278	37160	0	38196
1547	35747	163	254	797	0	36961
1548	484	163	36976	309	0	37932
1549	134	37994	588	305	0	39021
1550	130	516	38134	255	0	39035
1551	66	37837	584	229	0	38716
1552	254	648	305	35893	0	37100
1553	36499	172	203	658	0	37532
1554	35841	140	140	371	0	36492
1555	492	35994	147	223	0	36856
1556	36115	458	135	353	0	37061
1557	539	163	162	36063	0	36927
1558	36025	144	172	655	0	36996
1559	508	168	36416	266	0	37358
1560	184	128	36212	260	0	36784
1561	304	110	600	34747	0	35761
1562	189	118	247	37577	0	38131
1563	126	158	37490	632	0	38406
1564	220	126	557	36950	0	37853
1565	37176	147	220	765	0	38308
1566	36965	130	194	437	0	37726
1567	599	35991	173	258	0	37021
1568	238	36313	156	205	0	36912
1569	34962	567	153	301	0	35983
1570	614	198	147	34436	0	35395
1571	34147	138	162	714	0	35161
1572	589	34273	184	226	0	35272
1573	33930	499	180	329	0	34938
1574	583	184	33704	171	0	34642
1575	198	194	33347	188	0	33927
1576	266	196	578	33588	0	34628
1577	170	135	34558	569	0	35432
1578	219	159	564	33210	0	34152
1579	308	168	193	32121	0	32790
1580	170	143	35477	601	0	36391
1581	260	142	599	34887	0	35888
1582	262	137	212	37507	0	38118
1583	165	123	38933	776	0	39997
1584	162	104	38294	313	0	38873
1585	37135	103	781	399	0	38418
1586	706	138	39895	180	0	40919
1587	40272	143	819	301	0	41535
1588	43707	94	303	293	0	44397
1589	937	92	44484	164	0	45677
1590	344	110	45649	174	0	46277
1591	415	174	1083	43137	0	44809
1592	398	107	430	42783	0	43718
1593	152	44191	329	882	0	45554
1594	159	45977	240	380	0	46756
1595	164	945	44399	309	0	45817
1596	41850	289	959	388	0	43486
1597	43885	182	403	338	0	44808
1598	1023	139	43295	184	0	44641
1599	427	119	43078	211	0	43835
1600	448	253	1006	41136	0	42843
1601	212	43419	450	734	0	44815
1602	361	806	341	44031	0	45539
1603	347	252	278	45223	0	46100
1604	44951	177	230	1178	0	46536
1605	45033	142	216	510	0	45901
1606	1128	124	192	46280	0	47724
1607	421	151	46647	936	0	48155
1608	43465	130	895	575	0	45065
1609	894	47974	379	333	0	49580
1610	48533	811	263	395	0	50002
1611	47507	273	209	407	0	48396
1612	1052	48359	228	210	0	49849
1613	427	49853	231	255	0	50766
1614	414	1039	209	49144	0	50806
1615	395	409	168	49671	0	50643
1616	260	49981	175	1072	0	51488
1617	404	949	173	50714	0	52240
1618	411	299	192	51674	0	52576
1619	227	302	51051	1198	0	52778
1620	48890	204	981	719	0	50794
1621	51601	165	408	556	0	52730
1622	52401	135	312	415	0	53263
1623	1465	151	231	51081	0	52928
1624	50222	121	194	1168	0	51705
1625	1130	49632	234	461	0	51457
1626	616	954	220	46868	0	48658
1627	400	48344	241	866	0	49851
1628	322	51665	228	379	0	52594
1629	51903	1033	230	541	0	53707
1630	52660	363	200	438	0	53661
1631	52076	262	201	379	0	52918
1632	52227	189	190	336	0	52942
1633	51890	168	221	360	0	52639
1634	1413	217	52485	199	0	54314
1635	50978	220	901	397	0	52496
1636	1289	200	54388	210	0	56087
1637	51679	122	1030	391	0	53222
1638	53884	126	416	397	0	54823
1639	53037	146	372	388	0	53943
1640	1375	192	55983	238	0	57788
1641	882	256	872	54101	0	56111
1642	483	58733	441	783	0	60440
1643	59721	871	346	433	0	61371
1644	59571	324	240	402	0	60537
1645	1373	60212	276	207	0	62068
1646	61467	917	265	366	0	63015
1647	1380	322	289	59870	0	61861
1648	557	61731	313	986	0	63587
1649	61339	986	232	613	0	63170
1650	61708	394	215	529	0	62846
1651	1518	324	246	61461	0	63549
1652	62607	241	289	1133	0	64270
1653	1490	188	285	62803	0	64766
1654	811	205	287	63546	0	64849
1655	673	287	63068	1286	0	65314
1656	723	256	977	61621	0	63577
1657	644	292	414	63379	0	64729
1658	545	299	63528	1280	0	65652
1659	462	271	63278	643	0	64654
1660	573	263	1095	63918	0	65849
1661	436	282	65249	1114	0	67081
1662	59821	245	1103	765	0	61934
1663	1114	66441	487	447	0	68489
1664	682	952	302	68995	0	70931
1665	596	376	234	70287	0	71493
1666	551	280	234	69794	0	70859
1667	70423	213	224	1550	0	72410
1668	69659	187	206	883	0	70935
1669	70966	226	191	694	0	72077
1670	1433	71348	190	446	0	73417
1671	868	940	142	72672	0	74622
1672	753	391	135	73556	0	74835
1673	73047	306	143	1436	0	74932
1674	73116	261	121	790	0	74288
1675	1505	326	148	73159	0	75138
1676	776	313	73323	1052	0	75464
1677	71040	300	854	792	0	72986
1678	74048	273	298	739	0	75358
1679	1457	236	75332	440	0	77465
1680	68985	181	838	684	0	70688
1681	1322	177	75041	310	0	76850
1682	72966	107	871	514	0	74458
1683	1243	567	367	76082	0	78259
1684	651	80882	289	900	0	82722
1685	601	795	84283	357	0	86036
1686	480	83430	974	360	0	85244
1687	384	77266	374	292	0	78316
1688	86117	858	368	779	0	88122
1689	900	202	164	86297	0	87563
1690	373	96	100	85177	0	85746
1691	90952	73	67	1268	0	92360
1692	864	81	99	92579	0	93623
1693	395	93	121	92895	0	93504
1694	327	110	73	93023	0	93533
1695	314	94	73	92819	0	93300
1696	208	124	93597	855	0	94784
1697	165	123	89839	371	0	90498
1698	170	91914	719	269	0	93072
1699	93412	635	215	541	0	94803
1700	830	203	105	94750	0	95888
1701	268	92124	149	778	0	93319
1702	330	694	96	99159	0	100279
1703	320	200	98	99543	0	100161
1704	358	142	123	98952	0	99575
1705	306	106	119	100748	0	101279
1706	348	119	87	100357	0	100911
1707	182	98853	120	1010	0	100165
1708	259	660	81	100591	0	101591
1709	172	264	98193	874	0	99503
1710	137	98220	630	451	0	99438
1711	291	627	172	99387	0	100477
1712	269	207	122	98822	0	99420
1713	126	96916	143	881	0	98066
1714	127	98820	131	431	0	99509
1715	96929	682	85	605	0	98301
1716	599	96801	125	341	0	97866
1717	95600	615	142	531	0	96888
1718	94377	194	103	619	0	95293
1719	704	208	97551	233	0	98696
1720	532	121	594	92393	0	93640
1721	182	198	98319	683	0	99382
1722	153	99315	654	347	0	100469
1723	660	821	293	88884	0	90658
1724	366	235	111	99417	0	100129
1725	273	141	87	101143	0	101644
1726	260	118	96	102470	0	102944
1727	152	186	103435	973	0	104746
1728	283	95	711	101441	0	102530
1729	175	159	101969	877	0	103180
1730	169	170	98360	344	0	99043
1731	92095	99	872	832	0	93898
1732	100844	120	269	620	0	101853
1733	101998	96	132	619	0	102845
1734	897	99964	153	293	0	101307
1735	383	733	140	101417	0	102673
1736	231	266	102716	847	0	104060
1737	436	144	778	99927	0	101285
1738	252	135	104702	904	0	105993
1739	99855	188	847	809	0	101699
1740	102482	86	265	590	0	103423
1741	102058	94	212	550	0	102914
1742	1011	155	98847	241	0	100254
1743	397	147	97410	208	0	98162
1744	471	221	842	100317	0	101851
1745	524	87	386	95005	0	96002
1746	289	93	178	103596	0	104156
1747	191	131	103405	881	0	104608
1748	271	151	93526	387	0	94335
1749	97121	76	843	593	0	98633
1750	872	92	320	103884	0	105168
1751	379	66	220	104527	0	105192
1752	105459	52	172	1325	0	107008
1753	931	79	159	105353	0	106522
1754	110613	59	151	1587	0	112410
1755	113358	63	192	1053	0	114666
1756	112559	78	180	894	0	113711
1757	1056	151	116294	286	0	117787
1758	335	114507	808	647	0	116297
1759	119922	717	248	781	0	121668
1760	1083	177	176	120855	0	122291
1761	545	98	149	119792	0	120584
1762	250	121494	199	978	0	122921
1763	120582	771	124	789	0	122266
1764	118158	195	169	752	0	119274
1765	119232	133	127	720	0	120212
1766	1070	120330	160	253	0	121813
1767	125738	811	110	888	0	127547
1768	126264	213	113	765	0	127355
1769	126764	143	124	642	0	127673
1770	1302	144	107	124544	0	126097
1771	532	121	125	126194	0	126972
1772	368	203	129414	1079	0	131064
1773	637	106	829	124824	0	126396
1774	588	112	226	126051	0	126977
1775	321	189	128378	1046	0	129934
1776	119120	121	718	904	0	120863
1777	128285	84	209	712	0	129290
1778	1215	143	133	127068	0	128559
1779	392	124487	166	883	0	125928
1780	313	126278	152	390	0	127133
1781	493	1073	120	125313	0	126999
1782	293	311	122139	849	0	123592
1783	616	410	650	116271	0	117947
1784	240	170	116280	722	0	117412
1785	221	103	113645	281	0	114250
1786	312	55	520	116710	0	117597
1787	117771	42	175	1012	0	119000
1788	113480	50	101	571	0	114202
1789	705	54	113	116981	0	117853
1790	465	47	112	115553	0	116177
1791	288	62	107	114833	0	115290
1792	240	73	105	113439	0	113857
1793	113486	56	113	997	0	114652
1794	111398	66	108	660	0	112232
1795	110827	47	96	698	0	111668
1796	681	122	112056	175	0	113034
1797	490	59	461	110293	0	111303
1798	328	70	178	113836	0	114412
1799	113755	50	132	956	0	114893
1800	580	112467	138	322	0	113507
1801	111841	451	71	653	0	113016
1802	110747	143	76	583	0	111549
1803	110157	77	87	542	0	110863
1804	109184	75	101	567	0	109927
1805	863	112	110728	197	0	111900
1806	551	160	102687	256	0	103654
1807	112711	49	737	731	0	114228
1808	116881	75	221	556	0	117733
1809	116856	67	136	530	0	117589
1810	120376	73	117	619	0	121185
1811	1313	117	132603	235	0	134268
1812	519	138173	1614	294	0	140600
1813	960	1721	489	145672	0	148842
1814	154931	608	312	2802	0	158653
1815	157974	262	168	1547	0	159951
1816	166340	145	162	1031	0	167678
1817	168760	117	141	899	0	169917
1818	171040	98	124	771	0	172033
1819	165941	133	208	767	0	167049
1820	4624	426	144777	633	0	150460
1821	1926	231	158946	296	0	161399
1822	1710	261	2867	156121	0	160959
1823	1047	213	161174	2449	0	164883
1824	981	154945	2887	1049	0	159862
1825	904	158381	1309	633	0	161227
1826	1334	3208	712	163282	0	168536
1827	827	1248	171138	2493	0	175706
1828	757	673	162502	1121	0	165053
1829	161228	463	3793	1319	0	166803
1830	181701	351	1603	1038	0	184693
1831	4835	361	942	181925	0	188063
1832	184771	377	863	4143	0	190154
1833	4741	350	592	183482	0	189165
1834	2458	231	598	185436	0	188723
1835	1177	292	186796	4856	0	193121
1836	1019	328	179302	2027	0	182676
1837	1478	240	4781	179069	0	185568
1838	985	347	181628	4015	0	186975
1839	167364	208	4326	2691	0	174589
1840	182733	136	1790	1842	0	186501
1841	5327	185676	1180	1034	0	193217
1842	187208	3684	868	1491	0	193251
1843	5169	1342	184077	700	0	191288
1844	179697	536	4424	1145	0	185802
1845	186813	295	1889	1259	0	190256
1846	188942	277	1243	1090	0	191552
1847	6944	368	891	177440	0	185643
1848	3075	182989	891	3643	0	190598
1849	185478	3997	796	2100	0	192371
1850	188316	1452	815	1453	0	192036
1851	6916	779	830	187371	0	195896
1852	187653	443	794	5398	0	194288
1853	6057	189990	801	2232	0	199080
1854	3574	4514	662	185776	0	194526
1855	2227	1731	183197	5049	0	192204
1856	165022	951	4834	3268	0	174075
1857	5879	674	183069	1433	0	191055
1858	3544	793	5184	178822	0	188343
1859	2195	178445	2135	4924	0	187699
1860	1895	197563	1433	2061	0	202952
1861	2561	6641	1117	191890	0	202209
1862	3265	190296	1507	5657	0	200725
1863	2956	7087	1194	251171	0	262408
1864	3040	2466	1227	264178	0	270911
1865	2787	1831	1070	270206	0	275894
1866	256845	1621	833	12631	0	271930
1867	10643	1330	764	258801	0	271538
1868	4363	1369	253888	10891	0	270511
1869	3328	254254	8452	4979	0	271013
1870	255636	8636	2724	4045	0	271041
1871	11632	2942	1528	253599	0	269701
1872	6190	1844	1397	259050	0	268481
1873	4630	1593	1328	264321	0	271872
1874	3174	1637	253927	12759	0	271497
1875	2614	254334	9313	5959	0	272220
1876	254718	9135	3745	4777	0	272375
1877	10979	3665	2280	240418	0	257342
1878	4162	259443	2082	10262	0	275949
1879	256718	9996	1891	6064	0	274669
1880	10372	4027	256093	3769	0	274261
1881	251473	2714	10055	4154	0	268396
1882	11602	2497	259747	2904	0	276750
1883	5500	2391	260219	2957	0	271067
1884	3922	257912	11700	3491	0	277025
1885	4496	9735	4610	246954	0	265795
1886	3188	3805	252909	10847	0	270749
1887	2919	243244	11261	5287	0	262711
1888	3760	9808	5264	234746	0	253578
1889	2458	245996	3819	10146	0	262419
1890	2368	10720	246076	4993	0	264157
1891	3349	4537	10631	242751	0	261268
1892	2403	3394	248220	11778	0	265795
1893	3649	2832	11246	243595	0	261322
1894	3574	2498	5083	253480	0	264635
1895	2726	2512	246253	13907	0	265398
1896	3578	2268	11550	245262	0	262658
1897	236524	2106	5192	13907	0	257729
1898	10405	241888	3956	7288	0	263537
1899	5124	9934	242392	5620	0	263070
1900	236629	4081	10989	5613	0	257312
1901	12523	3168	4948	225582	0	246221
1902	5627	242167	3671	11169	0	262634
1903	244824	10422	3366	6530	0	265142
1904	252876	4832	3178	5243	0	266129
1905	14150	3643	2930	239043	0	259766
1906	7096	3127	2643	247125	0	259991
1907	5022	2862	2528	249092	0	259504
1908	4615	2948	2548	242975	0	253086
1909	3863	235018	2794	15616	0	257291
1910	5505	14056	2789	218988	0	241338
1911	3259	214077	2362	12127	0	231825
1912	2936	212032	2404	7409	0	224781
1913	2275	211644	2542	5915	0	222376
1914	2848	10863	193872	5494	0	213077
1915	2491	200453	8692	5357	0	216993
1916	185585	9837	4662	5605	0	205689
1917	8383	189645	2868	5240	0	206136
1918	4656	9685	2801	170809	0	187951
1919	3275	191614	2816	9978	0	207683
1920	3654	9944	2617	189107	0	205322
1921	3690	5152	2649	196475	0	207966
1922	2993	4275	189250	12415	0	208933
1923	180440	4281	8816	7429	0	200966
1924	188452	4000	3822	6623	0	202897
1925	186709	3618	3313	6330	0	199970
1926	10004	183476	3362	6469	0	203311
1927	5038	8967	3287	178732	0	196024
1928	3801	4552	176125	11217	0	195695
1929	3650	174468	8979	6345	0	193442
1930	4559	9355	3930	144350	0	162194
1931	3475	165098	3352	7765	0	179690
1932	163856	8666	3251	4973	0	180746
1933	166197	4932	3036	4285	0	178450
1934	169347	3645	3421	4101	0	180514
1935	169538	3237	3883	3732	0	180390
1936	10246	3055	3517	162982	0	179800
1937	5168	3229	3395	161259	0	173051
1938	3879	164000	3297	9217	0	180393
1939	4115	8306	2644	165651	0	180716
1940	3031	4328	161570	9973	0	178902
1941	2730	3524	7515	159572	0	173341
1942	2050	3723	157291	10150	0	173214
1943	1909	155396	7886	6580	0	171771
1944	1854	8181	157240	5157	0	172432
1945	2373	4208	8649	156243	0	171473
1946	2159	3261	159266	9806	0	174492
1947	2488	3260	8483	156420	0	170651
1948	2652	3149	4492	160007	0	170300
1949	2969	2965	3534	160082	0	169550
1950	2992	3023	3423	159366	0	168804
1951	150431	3027	2537	10553	0	166548
1952	7158	152860	2404	5966	0	168388
1953	148119	7453	2108	5205	0	162885
1954	7313	3859	142607	4827	0	158606
1955	141960	2908	5861	4848	0	155577
1956	147731	2784	2481	4919	0	157915
1957	9269	2804	141386	4269	0	157728
1958	5850	2472	136022	3877	0	148221
1959	4102	131731	6329	4330	0	146492
1960	2999	125362	2507	3998	0	134866
1961	3367	6109	115474	4035	0	128985
1962	2100	102981	4502	4123	0	113706
1963	2634	2834	1872	56315	0	63655
1964	54268	492	732	1334	0	56826
1965	1077	372	262	53975	0	55686
1966	53894	367	128	1295	0	55684
1967	53452	340	175	714	0	54681
1968	1115	54671	238	474	0	56498
1969	53863	858	139	538	0	55398
1970	53986	352	117	546	0	55001
1971	1201	329	147	52908	0	54585
1972	53312	249	132	1087	0	54780
1973	919	54850	112	445	0	56326
1974	538	794	100	54499	0	55931
1975	54233	351	113	1102	0	55799
1976	894	279	53777	415	0	55365
1977	52946	171	684	503	0	54304
1978	980	305	251	55010	0	56546
1979	400	155	55396	705	0	56656
1980	322	177	52888	319	0	53706
1981	51771	354	969	457	0	53551
1982	53884	92	339	340	0	54655
1983	881	80	195	53383	0	54539
1984	445	70	116	53863	0	54494
1985	368	70	124	53816	0	54378
1986	178	54696	138	753	0	55765
1987	54336	580	94	595	0	55605
1988	698	54884	77	302	0	55961
1989	53484	645	113	429	0	54671
1990	780	255	54395	191	0	55621
1991	451	150	611	54114	0	55326
1992	55599	135	246	921	0	56901
1993	816	122	218	55681	0	56837
1994	469	119	154	55019	0	55761
1995	313	53577	169	799	0	54858
1996	54164	620	142	605	0	55531
1997	764	57563	176	338	0	58841
1998	442	758	97	58158	0	59455
1999	246	326	57346	807	0	58725
2000	49206	204	758	804	0	50972
2001	843	254	56346	291	0	57734
2002	49929	149	818	522	0	51418
2003	909	55531	328	235	0	57003
2004	512	804	220	52305	0	53841
2005	330	54402	187	787	0	55706
2006	54159	873	147	523	0	55702
2007	1066	317	146	54553	0	56082
2008	511	255	139	55732	0	56637
2009	359	251	54152	1080	0	55842
2010	49124	215	834	759	0	50932
2011	1041	177	289	54990	0	56497
2012	427	202	54138	978	0	55745
2013	356	53796	891	433	0	55476
2014	347	837	373	54176	0	55733
2015	54207	308	277	1181	0	55973
2016	1074	269	205	54476	0	56024
2017	424	221	56000	1100	0	57745
2018	59733	209	946	675	0	61563
2019	1521	193	333	61064	0	63111
2020	542	210	65360	1457	0	67569
2021	579	155	1474	64899	0	67107
2022	542	140	485	64164	0	65331
2023	317	66112	393	1733	0	68555
2024	64659	1478	212	975	0	67324
2025	1575	66195	273	524	0	68567
2026	65858	1698	203	596	0	68355
2027	1929	545	247	63691	0	66412
2028	655	66018	194	1594	0	68461
2029	655	1639	147	65532	0	67973
2030	395	560	64830	1801	0	67586
2031	60778	412	1509	850	0	63549
2032	1914	259	432	62594	0	65199
2033	842	247	386	62730	0	64205
2034	677	222	256	63707	0	64862
2035	346	261	61396	2347	0	64350
2036	394	282	60814	1017	0	62507
2037	359	61672	1886	723	0	64640
2038	531	1562	603	59564	0	62260
2039	59679	554	360	1922	0	62515
2040	1609	61437	306	843	0	64195
2041	835	1676	258	62490	0	65259
2042	62901	610	273	2082	0	65866
2043	62981	438	290	1082	0	64791
2044	2074	63580	300	637	0	66591
2045	68047	1729	217	765	0	70758
2046	74506	622	215	767	0	76110
2047	2936	461	194	74831	0	78422
2048	1112	75174	316	2497	0	79099
2049	1105	2239	281	76882	0	80507
2050	76179	834	271	2950	0	80234
2051	2709	689	76629	1174	0	81201
2052	1483	486	2189	75714	0	79872
2053	1244	493	703	77865	0	80305
2054	723	587	76338	3405	0	81053
2055	974	495	2339	76612	0	80420
2056	75972	388	892	3499	0	80751
2057	71127	418	767	1938	0	74250
2058	3153	377	584	75360	0	79474
2059	1410	340	74381	3292	0	79423
2060	1070	296	72260	1740	0	75366
2061	844	71211	2867	1503	0	76425
2062	880	75399	1180	1274	0	78733
2063	1161	2728	813	72222	0	76924
2064	71291	994	680	3084	0	76049
2065	2470	72588	787	1483	0	77328
2066	71590	2541	726	1283	0	76140
2067	2901	1127	624	71231	0	75883
2068	1395	962	564	72344	0	75265
2069	68773	728	472	3589	0	73562
2070	2833	70011	376	1699	0	74919
2071	70115	2548	356	1429	0	74448
2072	3105	1149	67952	1078	0	73284
2073	1424	807	66413	1052	0	69696
2074	1368	816	2756	64442	0	69382
2075	944	727	65710	2785	0	70166
2076	982	725	65440	1329	0	68476
2077	1201	726	2890	61198	0	66015
2078	958	548	63383	2765	0	67654
2079	1014	461	2967	61451	0	65893
2080	915	446	1511	62947	0	65819
2081	727	406	63805	3496	0	68434
2082	796	457	2841	62675	0	66769
2083	924	458	1443	61327	0	64152
2084	724	61562	1139	3398	0	66823
2085	61387	2277	990	1974	0	66628
2086	2501	948	61697	1636	0	66782
2087	1211	658	2747	60900	0	65516
2088	988	579	1404	63200	0	66171
2089	704	584	60859	3637	0	65784
2090	56976	570	2700	2197	0	62443
2091	2517	60248	1291	1734	0	65790
2092	1345	2343	1086	59904	0	64678
2093	1058	937	1012	60656	0	63663
2094	738	60269	917	3684	0	65608
2095	846	2378	59673	2081	0	64978
2096	746	60632	2669	1674	0	65721
2097	57534	2710	1227	1630	0	63101
2098	2420	1335	57084	1320	0	62159
2099	1326	1007	2456	56777	0	61566
2100	1008	807	57654	2920	0	62389
2101	792	878	57706	1656	0	61032
2102	874	56741	2997	1407	0	62019
2103	1168	2339	1565	54152	0	59224
2104	55079	1039	1216	2651	0	59985
2105	55808	813	1133	1565	0	59319
2106	2608	55328	1089	1466	0	60491
2107	1286	2231	1021	55592	0	60130
2108	54813	1148	936	2877	0	59774
2109	56299	916	884	1599	0	59698
2110	2849	55708	798	1407	0	60762
2111	56962	2233	711	1246	0	61152
2112	2921	1028	790	54581	0	59320
2113	1436	56923	718	2758	0	61835
2114	1389	2243	783	58212	0	62627
2115	1325	1196	747	59061	0	62329
2116	1484	1308	672	59001	0	62465
2117	1031	831	55728	3157	0	60747
2118	889	725	48184	1569	0	51367
2119	770	49216	2015	1417	0	53418
2120	44261	1516	1088	1145	0	48010
2121	1437	43803	745	1186	0	47171
2122	832	1463	675	43862	0	46832
2123	646	732	45476	1801	0	48655
2124	618	720	1609	44151	0	47098
2125	566	663	914	45946	0	48089
2126	561	627	700	47109	0	48997
2127	45822	613	616	2208	0	49259
2128	1350	538	629	46898	0	49415
2129	625	446	50165	2091	0	53327
2130	47727	391	1513	1584	0	51215
2131	49613	375	831	1316	0	52135
2132	51225	327	662	1233	0	53447
2133	51460	348	520	1127	0	53455
2134	51424	298	545	1023	0	53290
2135	2037	50244	557	899	0	53737
2136	1318	1153	470	47650	0	50591
2137	1115	49303	460	1416	0	52294
2138	49630	1196	364	936	0	52126
2139	49049	605	356	762	0	50772
2140	47246	499	366	697	0	48808
2141	1832	45266	367	615	0	48080
2142	974	44741	337	569	0	46621
2143	863	45424	358	541	0	47186
2144	1035	1418	44147	459	0	47059
2145	1296	2604	880	35604	0	40384
2146	243	31159	187	386	0	31975
2147	75	31700	37	76	0	31888
2148	109	191	55	31814	0	32169
2149	62	81	27	31626	0	31796
2150	35	58	31751	206	0	32050
2151	30429	29	185	196	0	30839
2152	224	41	59	33185	0	33509
2153	112	40	48	33164	0	33364
2154	69	66	32865	240	0	33240
2155	71	44	30952	130	0	31197
2156	39	34263	226	90	0	34618
2157	93	204	103	34968	0	35368
2158	90	64	63	35446	0	35663
2159	64	87	34666	261	0	35078
2160	31401	50	228	234	0	31913
2161	34179	63	88	171	0	34501
2162	299	65	34743	89	0	35196
2163	33424	65	236	178	0	33903
2164	318	79	35193	88	0	35678
2165	34517	50	238	198	0	35003
2166	35778	38	101	179	0	36096
2167	366	54	37298	75	0	37793
2168	230	40	259	36777	0	37306
2169	280	65	150	35398	0	35893
2170	155	49	75	39152	0	39431
2171	38978	46	64	476	0	39564
2172	38497	57	53	268	0	38875
2173	412	60	40021	132	0	40625
2174	183	45	37957	130	0	38315
2175	40289	32	447	261	0	41029
2176	42422	37	157	222	0	42838
2177	501	51	42020	110	0	42682
2178	215	57	41739	95	0	42106
2179	263	39	500	42751	0	43553
2180	115	95	44384	459	0	45053
2181	193	34	525	42273	0	43025
2182	45180	24	193	658	0	46055
2183	693	42	48315	210	0	49260
2184	45455	28	793	301	0	46577
2185	888	44	53829	204	0	54965
2186	420	34	977	52718	0	54149
2187	334	39	291	55793	0	56457
2188	319	34	175	55819	0	56347
2189	171	57238	134	1173	0	58716
2190	526	961	140	51804	0	53431
2191	340	190	113	58357	0	59000
2192	57409	91	124	1330	0	58954
2193	1067	73	56931	365	0	58436
2194	52375	49	1016	450	0	53890
2195	1124	78	56650	184	0	58036
2196	50163	60	1047	458	0	51728
2197	1112	55881	328	170	0	57491
2198	364	902	55962	139	0	57367
2199	253	195	55659	145	0	56252
2200	474	208	1287	48896	0	50865
2201	295	61	339	56030	0	56725
2202	153	68	56832	1134	0	58187
2203	155	95	56454	393	0	57097
2204	170	81	62517	277	0	63045
2205	64082	45	1267	515	0	65909
2206	67024	54	424	374	0	67876
2207	67446	44	284	338	0	68112
2208	1365	28	226	66076	0	67695
2209	566	26	234	66989	0	67815
2210	302	77	71397	1213	0	72989
2211	405	69	1041	68465	0	69980
2212	542	61	446	65733	0	66782
2213	70868	49	260	1478	0	72655
2214	70947	55	192	722	0	71916
2215	72883	60	214	546	0	73703
2216	1448	64	225	72242	0	73979
2217	595	52	265	72669	0	73581
2218	442	47	244	73355	0	74088
2219	72408	47	223	1442	0	74120
2220	1281	70	253	70527	0	72131
2221	439	72019	278	1057	0	73793
2222	492	933	234	70421	0	72080
2223	288	70941	278	1012	0	72519
2224	70824	983	301	571	0	72679
2225	68694	254	260	633	0	69841
2226	1129	69805	305	380	0	71619
2227	467	71720	312	310	0	72809
2228	453	1121	267	70622	0	72463
2229	329	365	68094	1190	0	69978
2230	457	196	1095	65435	0	67183
2231	328	210	68128	1379	0	70045
2232	347	68292	1159	575	0	70373
2233	455	985	405	68940	0	70785
2234	405	263	335	70226	0	71229
2235	310	256	73271	1429	0	75266
2236	495	149	1163	72070	0	73877
2237	327	173	74673	1408	0	76581
2238	71554	111	1250	809	0	73724
2239	74890	126	473	609	0	76098
2240	76133	148	345	624	0	77250
2241	1581	157	310	74850	0	76898
2242	713	108	288	75817	0	76926
2243	451	188	76551	1565	0	78755
2244	586	212	1254	72645	0	74697
2245	375	73460	533	1391	0	75759
2246	409	1060	75252	627	0	77348
2247	400	328	73785	565	0	75078
2248	668	325	1346	67929	0	70268
2249	366	256	75990	1361	0	77973
2250	342	211	75032	706	0	76291
2251	69657	193	1376	939	0	72165
2252	1175	82413	517	560	0	84665
2253	85914	1048	399	906	0	88267
2254	86382	297	338	775	0	87792
2255	87933	219	344	752	0	89248
2256	1509	172	382	86806	0	88869
2257	732	167	351	88655	0	89905
2258	447	228	88378	1525	0	90578
2259	589	173	1150	85502	0	87414
2260	332	87831	548	1316	0	90027
2261	88898	974	460	832	0	91164
2262	1148	89296	427	509	0	91380
2263	457	90882	402	467	0	92208
2264	524	1201	379	90990	0	93094
2265	456	403	92313	1251	0	94423
2266	552	266	1164	90016	0	91998
2267	399	243	91207	1309	0	93158
2268	394	89978	1172	698	0	92242
2269	90668	967	440	757	0	92832
2270	91366	257	343	778	0	92744
2271	91623	215	329	835	0	93002
2272	1352	240	94681	518	0	96791
2273	669	245	86595	506	0	88015
2274	92290	145	1104	793	0	94332
2275	83845	132	13325	698	0	98000
2276	97585	147	337	682	0	98751
2277	1306	149	233	96747	0	98435
2278	657	137	183	98369	0	99346
2279	97781	100	192	1388	0	99461
2280	95601	118	188	928	0	96835
2281	1091	188	97656	441	0	99376
2282	478	189	91227	312	0	92206
2283	87333	93	508	621	0	88555
2284	619	119	93297	208	0	94243
2285	83945	50	535	465	0	84995
2286	378	91	89285	103	0	89857
2287	224	132	254	85750	0	86360
2288	105	108	91663	168	0	92044
2289	225	56	165	90365	0	90811
2290	187	35	64	92631	0	92917
2291	58	94097	95	200	0	94450
2292	95207	144	59	617	0	96027
2293	191	97	98930	58	0	99276
2294	91148	38	210	562	0	91958
2295	243	100190	97	69	0	100599
2296	105072	210	57	519	0	105858
2297	424	60	45	104906	0	105435
2298	272	57	50	105578	0	105957
2299	110	110860	77	465	0	111512
2300	231	345	45	114881	0	115502
2301	235	90	60	114629	0	115014
2302	222	90	55	115696	0	116063
2303	111993	35	44	1133	0	113205
2304	104526	26	52	746	0	105350
2305	734	133	105339	155	0	106361
2306	284	106210	555	177	0	107226
2307	320	510	171	109850	0	110851
2308	269	175	94	114262	0	114800
2309	130	167	115314	951	0	116562
2310	319	74	838	108963	0	110194
2311	111206	34	236	1479	0	112955
2312	110977	46	136	761	0	111920
2313	111791	42	78	615	0	112526
2314	1398	56	57	112374	0	113885
2315	117464	38	70	1821	0	119393
2316	116987	39	82	1014	0	118122
2317	120190	28	77	837	0	121132
2318	1590	30	75	119738	0	121433
2319	773	39	86	121398	0	122296
2320	562	59	64	122304	0	122989
2321	569	73	82	119117	0	119841
2322	501	38	49	119941	0	120529
2323	262	116	119324	1453	0	121155
2324	286	103	116125	637	0	117151
2325	273	115922	1136	453	0	117784
2326	507	922	355	119803	0	121587
2327	480	229	186	121245	0	122140
2328	439	143	109	122295	0	122986
2329	247	211	121040	1559	0	123057
2330	512	44	1066	118509	0	120131
2331	259	164	120318	1372	0	122113
2332	405	75	1121	117730	0	119331
2333	216	166	122396	1397	0	124175
2334	143	121514	1107	810	0	123574
2335	341	1038	364	120435	0	122178
2336	171	362	118798	1333	0	120664
2337	100440	170	1194	1604	0	103408
2338	1113	118507	504	495	0	120619
2339	624	1103	296	120005	0	122028
2340	219	121003	269	1260	0	122751
2341	402	1277	173	119988	0	121840
2342	121915	372	198	2035	0	124520
2343	1495	207	200	120582	0	122484
2344	416	122155	237	1511	0	124319
2345	121768	1225	190	1174	0	124357
2346	1603	377	180	127566	0	129726
2347	719	413	181	130411	0	131724
2348	131385	223	184	2988	0	134780
2349	2375	199	143	141873	0	144590
2350	1373	172	197	170030	0	171772
2351	660	259	170684	5139	0	176742
2352	481	297	165877	1934	0	168589
2353	1128	167	5422	162645	0	169362
2354	405	249	167556	4848	0	173058
2355	394	255	163298	1975	0	165922
2356	151193	140	5978	2401	0	159712
2357	4677	208	166339	994	0	172218
2358	1557	164327	5719	944	0	172547
2359	2187	4391	2065	163075	0	171718
2360	168772	1339	1553	5662	0	177326
2361	171879	970	1061	2727	0	176637
2362	170502	484	909	2649	0	174544
2363	6790	169348	1150	1332	0	178620
2364	3816	4781	1030	166270	0	175897
2365	2563	1597	997	172201	0	177358
2366	158821	1238	1229	7350	0	168638
2367	169642	613	1059	3786	0	175100
2368	171326	517	910	2872	0	175625
2369	7315	626	172206	1505	0	181652
2370	3515	168460	5594	1498	0	179067
2371	2399	198257	2443	1580	0	204679
2372	2982	7753	1803	186929	0	199467
2373	2694	3541	1069	197167	0	204471
2374	1736	2259	194953	9476	0	208424
2375	187400	1252	7226	5585	0	201463
2376	198419	929	3098	3809	0	206255
2377	10681	1024	2229	193005	0	206939
2378	6379	848	1162	197172	0	205561
2379	4719	609	926	200932	0	207186
2380	194794	673	929	11909	0	208305
2381	8655	953	190050	5612	0	205270
2382	4356	1070	194174	3839	0	203439
2383	3820	1053	9441	189015	0	203329
2384	1942	997	193368	8936	0	205243
2385	184793	865	9132	5395	0	200185
2386	190581	587	4295	4312	0	199775
2387	194969	494	3048	3448	0	201959
2388	11676	184195	2321	2506	0	200698
2389	186745	6882	1614	2947	0	198188
2390	10956	3150	1343	181531	0	196980
2391	5703	2174	1483	184331	0	193691
2392	4591	1053	1615	188524	0	195783
2393	2680	925	178605	12560	0	194770
2394	3458	941	8269	169894	0	182562
2395	2552	175684	4514	10086	0	192836
2396	168553	6742	3570	6072	0	184937
2397	8173	174730	2411	4977	0	190291
2398	4803	8385	171279	3455	0	187922
2399	4445	170814	8151	2753	0	186163
2400	163726	8725	4315	3063	0	179829
2401	8620	166709	3579	2851	0	181759
2402	5861	8975	2490	142990	0	160316
2403	3818	166375	2442	7561	0	180196
2404	164714	8736	2186	5076	0	180712
2405	168311	4253	2253	4254	0	179071
2406	153382	3253	2159	4096	0	162890
2407	11444	2743	161681	2629	0	178497
2408	6579	2251	160074	2596	0	171500
2409	4777	2421	160154	2606	0	169958
2410	155821	1946	11066	2815	0	171648
2411	9638	2378	5871	152720	0	170607
2412	5976	2000	4109	157949	0	170034
2413	4445	2378	153689	10051	0	170563
2414	3969	2227	7766	155426	0	169388
2415	145659	2252	4288	10258	0	162457
2416	9000	147382	3341	5711	0	165434
2417	150704	7455	2666	4463	0	165288
2418	10733	4156	147038	2935	0	164862
2419	149286	3288	8081	2781	0	163436
2420	153933	2375	4631	2796	0	163735
2421	155165	2194	3939	2949	0	164247
2422	12686	1962	145908	2853	0	163409
2423	8268	1604	8049	144987	0	162908
2424	6210	1408	147281	8515	0	163414
2425	5092	1473	9288	147292	0	163145
2426	3999	1662	149604	9767	0	165032
2427	4392	1624	9632	146844	0	162492
2428	4033	1730	5243	153662	0	164668
2429	148846	1467	3875	11083	0	165271
2430	151599	1403	3149	6668	0	162819
2431	155375	1136	2951	5072	0	164534
2432	13196	1169	3173	142549	0	160087
2433	7956	132151	2785	8622	0	151514
2434	5941	146240	2559	5501	0	160241
2435	144784	8335	2314	4928	0	160361
2436	9485	4603	142381	3632	0	160101
2437	143654	2926	8090	3796	0	158466
2438	10463	1998	141545	3441	0	157447
2439	146834	1828	8852	3665	0	161179
2440	134405	1850	4891	4059	0	145205
2441	11228	1520	145372	3194	0	161314
2442	148461	1281	8066	3769	0	161577
2443	151048	1515	4639	3200	0	160402
2444	151534	1604	3731	3005	0	159874
2445	13175	145790	2710	2914	0	164589
2446	7888	7978	2857	139083	0	157806
2447	5642	3655	140760	7348	0	157405
2448	4842	2735	141576	4285	0	153438
2449	4446	127169	8088	3282	0	142985
2450	2795	102323	3861	1635	0	110614
2451	3369	4167	3348	96155	0	107039
2452	94977	2352	1724	4024	0	103077
2453	4760	96984	1354	2613	0	105711
2454	3909	3554	1305	93598	0	102366
2455	3052	97816	1294	3687	0	105849
2456	96952	3889	973	2668	0	104482
2457	4740	2530	1117	96175	0	104562
2458	3159	1847	94868	3803	0	103677
2459	2529	90880	3506	2614	0	99529
2460	1874	93237	2485	1993	0	99589
2461	2208	4097	1915	84278	0	92498
2462	1926	92063	1336	2738	0	98063
2463	1978	4205	1184	90415	0	97782
2464	90271	2614	950	3962	0	97797
2465	90713	2017	1026	2564	0	96320
2466	95225	1496	950	1878	0	99549
2467	95174	1440	996	1561	0	99171
2468	5714	1303	91627	1227	0	99871
2469	3577	85009	2700	988	0	92274
2470	2561	84048	1738	1039	0	89386
2471	848	64871	399	366	0	66484
2472	671	62796	423	287	0	64177
2473	62895	1184	1286	466	0	65831
2474	61595	401	242	363	0	62601
2475	63102	208	150	350	0	63810
2476	63169	219	123	328	0	63839
2477	1087	242	63004	131	0	64464
2478	66436	186	723	470	0	67815
2479	69502	176	292	317	0	70287
2480	70909	137	159	298	0	71503
2481	1307	132	132	70020	0	71591
2482	678	155	112	70685	0	71630
2483	71654	152	98	1077	0	72981
2484	1025	190	127	70849	0	72191
2485	476	70661	127	833	0	72097
2486	435	760	85	71983	0	73263
2487	452	318	92	71864	0	72726
2488	300	73069	118	980	0	74467
2489	390	751	108	73879	0	75128
2490	444	329	111	74254	0	75138
2491	72889	222	90	1215	0	74416
2492	904	232	70564	447	0	72147
2493	67507	179	682	545	0	68913
2494	980	205	70590	328	0	72103
2495	525	227	67119	287	0	68158
2496	368	183	69325	259	0	70135
2497	67379	168	948	484	0	68979
2498	894	186	73685	225	0	74990
2499	70615	181	896	473	0	72165
2500	72869	154	363	422	0	73808
2501	73621	142	204	416	0	74383
2502	990	73969	221	164	0	75344
2503	73823	725	161	382	0	75091
2504	900	75031	150	198	0	76279
2505	581	760	144	75508	0	76993
2506	464	350	149	75470	0	76433
2507	355	74938	145	901	0	76339
2508	335	75077	172	399	0	75983
2509	318	77120	179	272	0	77889
2510	76449	918	149	401	0	77917
2511	860	78409	146	157	0	79572
2512	77900	828	130	430	0	79288
2513	922	457	76715	181	0	78275
2514	74622	316	680	415	0	76033
2515	78145	290	271	411	0	79117
2516	1157	317	77260	142	0	78876
2517	763	211	710	76156	0	77840
2518	438	266	78289	729	0	79722
2519	504	235	755	77019	0	78513
2520	452	206	345	78149	0	79152
2521	78858	185	215	1232	0	80490
2522	78488	191	168	675	0	79522
2523	1071	78752	180	368	0	80371
2524	80004	742	143	548	0	81437
2525	1132	417	80960	208	0	82717
2526	77846	200	875	577	0	79498
2527	1180	214	83854	245	0	85493
2528	747	192	82742	250	0	83931
2529	83951	155	1308	503	0	85917
2530	87080	196	526	481	0	88283
2531	1515	235	89761	245	0	91756
2532	1031	226	1184	83590	0	86031
2533	642	186	498	90255	0	91581
2534	466	255	89481	1344	0	91546
2535	719	228	1132	85879	0	87958
2536	526	82342	633	1203	0	84704
2537	645	1074	325	91205	0	93249
2538	640	508	329	90670	0	92147
2539	564	349	87718	1367	0	89998
2540	76763	235	1135	1188	0	79321
2541	85976	165	534	703	0	87378
2542	85713	172	372	611	0	86868
2543	84982	134	328	581	0	86025
2544	1801	84006	342	311	0	86460
2545	1125	950	264	80569	0	82908
2546	735	458	80180	1134	0	82507
2547	609	263	78210	658	0	79740
2548	765	284	1186	75179	0	77414
2549	507	237	77956	1233	0	79933
2550	73215	182	1030	854	0	75281
2551	1134	227	476	76899	0	78736
2552	710	176	315	77007	0	78208
2553	461	163	309	77307	0	78240
2554	75236	165	259	1725	0	77385
2555	1005	75063	286	789	0	77143
2556	73768	820	271	769	0	75628
2557	73673	356	298	650	0	74977
2558	1366	72305	336	342	0	74349
2559	702	73762	388	259	0	75111
2560	74966	986	351	474	0	76777
2561	1309	441	405	74607	0	76762
2562	893	222	390	73782	0	75287
2563	77064	167	330	1479	0	79040
2564	1384	229	76297	492	0	78402
2565	73400	167	1205	640	0	75412
2566	76371	122	514	622	0	77629
2567	1666	78273	294	391	0	80624
2568	81349	1069	228	536	0	83182
2569	80322	524	156	701	0	81703
2570	1728	91411	195	311	0	93645
2571	626	94987	168	289	0	96070
2572	846	2122	179	92403	0	95550
2573	95142	949	99	1986	0	98176
2574	1841	99471	127	743	0	102182
2575	1190	2013	85	99832	0	103120
2576	100517	796	84	2387	0	103784
2577	2277	528	99603	786	0	103194
2578	1418	328	1923	96004	0	99673
2579	651	261	98217	2194	0	101323
2580	91727	232	2314	1270	0	95543
2581	97874	190	914	941	0	99919
2582	2944	223	97450	403	0	101020
2583	1231	95923	2300	373	0	99827
2584	1213	2025	942	96220	0	100400
2585	599	843	97979	2138	0	101559
2586	917	518	2354	95224	0	99013
2587	911	342	983	98869	0	101105
2588	530	323	97616	2996	0	101465
2589	91393	267	2386	1761	0	95807
2590	97428	242	981	1178	0	99829
2591	3094	254	97734	643	0	101725
2592	1380	97210	2478	627	0	101695
2593	1315	2222	1126	91555	0	96218
2594	735	95470	779	2123	0	99107
2595	617	98305	601	1006	0	100529
2596	97329	2924	501	998	0	101752
2597	2819	1250	460	97557	0	102086
2598	1502	766	423	97671	0	100362
2599	879	605	97856	3090	0	102430
2600	686	519	97239	1496	0	99940
2601	1010	467	3079	95298	0	99854
2602	986	445	1327	98704	0	101462
2603	626	468	97636	3389	0	102119
2604	657	499	98152	1556	0	100864
2605	877	412	3401	96370	0	101060
2606	96944	418	1555	3310	0	102227
2607	2582	98234	1117	1536	0	103469
2608	97390	2696	723	1362	0	102171
2609	3083	97171	646	972	0	101872
2610	1504	100344	636	788	0	103272
2611	97080	3387	567	1068	0	102102
2612	3045	1434	99100	822	0	104401
2613	1730	929	2870	98094	0	103623
2614	1473	728	1358	100834	0	104393
2615	1250	618	992	107957	0	110817
2616	858	709	107426	4220	0	113213
2617	1064	657	3293	106526	0	111540
2618	108094	589	1585	4162	0	114430
2619	3713	543	1127	109862	0	115245
2620	1956	497	822	114289	0	117564
2621	111575	541	689	5186	0	117991
2622	110911	533	734	2743	0	114921
2623	4383	109495	800	1740	0	116418
2624	2102	3125	110178	1225	0	116630
2625	1456	1290	107875	1146	0	111767
2626	1253	856	109194	1079	0	112382
2627	1057	103277	4414	1079	0	109827
2628	1495	3109	2238	99033	0	105875
2629	1107	1260	1251	103654	0	107272
2630	101827	913	1043	4387	0	108170
2631	3619	681	957	100635	0	105892
2632	1518	650	100081	4226	0	106475
2633	1340	583	3575	99933	0	105431
2634	1237	567	1666	101802	0	105272
2635	946	649	99393	4800	0	105788
2636	1028	98051	3571	2455	0	105105
2637	1466	3151	1673	88124	0	94414
2638	862	98556	1460	3421	0	104299
2639	761	3499	98790	1835	0	104885
2640	96281	1567	3782	1759	0	103389
2641	99624	1108	1842	1502	0	104076
2642	101244	923	1319	1498	0	104984
2643	4656	836	1037	96637	0	103166
2644	2079	99476	1049	3820	0	106424
2645	98973	3311	993	2222	0	105499
2646	101488	1420	1017	1756	0	105681
2647	100828	957	1047	1719	0	104551
2648	4711	771	97601	1569	0	104652
2649	94703	624	3524	1633	0	100484
2650	4080	97164	1769	1342	0	104355
2651	96750	3239	1299	1447	0	102735
2652	3949	99059	1116	1277	0	105401
2653	99793	3619	916	1392	0	105720
2654	4276	1639	100455	1132	0	107502
2655	100633	1101	3446	1241	0	106421
2656	105296	939	1529	1187	0	108951
2657	84584	1275	1270	1927	0	89056
2658	106068	909	912	1228	0	109117
2659	5075	846	102212	1060	0	109193
2660	2939	733	3301	100761	0	107734
2661	101142	673	1598	3686	0	107099
2662	4046	100620	1337	1905	0	107908
2663	2376	2873	1025	97873	0	104147
2664	1751	1295	97582	3597	0	104225
2665	1896	1574	3159	97073	0	103702
2666	1511	806	97853	3756	0	103926
2667	1343	92559	3394	2121	0	99417
2668	1226	88869	1610	1540	0	93245
2669	1257	90599	1107	1260	0	94223
2670	1560	3049	903	77152	0	82664
2671	1213	1075	655	77272	0	80215
2672	893	609	75657	2510	0	79669
2673	731	71104	1953	1060	0	74848
2674	66175	1723	827	881	0	69606
2675	1829	64675	561	626	0	67691
2676	802	66386	464	632	0	68284
2677	1478	1939	569	63529	0	67515
2678	63142	734	495	1893	0	66264
2679	63918	547	436	984	0	65885
2680	2053	468	414	63363	0	66298
2681	62664	435	396	1888	0	65383
2682	1886	485	352	62610	0	65333
2683	785	467	61606	1908	0	64766
2684	60437	469	1523	1011	0	63440
2685	1852	431	671	61696	0	64650
2686	782	424	60554	1689	0	63449
2687	705	421	59276	808	0	61210
2688	675	482	1635	60162	0	62954
2689	61818	375	735	1842	0	64770
2690	61932	361	468	940	0	63701
2691	1905	62631	406	595	0	65537
2692	65138	1444	405	786	0	67773
2693	65378	594	384	710	0	67066
2694	66249	389	367	715	0	67720
2695	2058	67062	374	564	0	70058
2696	68205	1344	315	682	0	70546
2697	69793	546	288	591	0	71218
2698	2169	465	294	68550	0	71478
2699	66860	350	287	1489	0	68986
2700	1789	66242	350	602	0	68983
2701	931	68515	324	420	0	70190
2702	934	1374	300	68070	0	70678
2703	864	579	247	68564	0	70254
2704	735	70077	257	1373	0	72442
2705	69560	1285	217	646	0	71708
2706	1618	68778	231	392	0	71019
2707	67781	1224	200	428	0	69633
2708	1607	69575	218	314	0	71714
2709	970	1303	185	67637	0	70095
2710	726	71588	204	1097	0	73615
2711	71386	1395	635	681	0	74097
2712	70388	559	316	567	0	71830
2713	69132	467	319	564	0	70482
2714	1707	391	66041	302	0	68441
2715	606	290	60757	253	0	61906
2716	408	61485	802	244	0	62939
2717	393	783	60962	178	0	62316
2718	334	433	58684	186	0	59637
2719	397	472	695	52215	0	53779
2720	154	141	56810	440	0	57545
2721	109	57351	455	204	0	58119
2722	56661	417	151	317	0	57546
2723	453	56767	109	107	0	57436
2724	200	57735	89	101	0	58125
2725	58038	510	79	300	0	58927
2726	58610	189	74	319	0	59192
2727	513	60935	88	104	0	61640
2728	61495	443	91	309	0	62338
2729	60986	173	84	305	0	61548
2730	60749	128	76	328	0	61281
2731	662	134	59195	71	0	60062
2732	329	129	58069	102	0	58629
2733	320	111	488	59797	0	60716
2734	292	110	213	59888	0	60503
2735	62838	95	103	681	0	63717
2736	480	61095	96	206	0	61877
2737	306	507	71	62801	0	63685
2738	259	220	64	63262	0	63805
2739	296	131	72	63703	0	64202
2740	298	108	63	63823	0	64292
2741	185	119	64265	771	0	65340
2742	198	166	62125	274	0	62763
2743	300	92	614	64963	0	65969
2744	147	100	66375	609	0	67231
2745	62117	85	711	460	0	63373
2746	781	88	250	66614	0	67733
2747	272	99	67004	704	0	68079
2748	58466	67	683	656	0	59872
2749	689	66064	279	217	0	67249
2750	65866	594	156	383	0	66999
2751	695	67573	153	142	0	68563
2752	413	652	99	66566	0	67730
2753	213	261	67079	633	0	68186
2754	360	184	642	63286	0	64472
2755	178	136	63976	712	0	65002
2756	61452	123	699	458	0	62732
2757	812	98	244	65058	0	66212
2758	65390	110	197	937	0	66634
2759	818	111	64803	293	0	66025
2760	65176	79	722	478	0	66455
2761	71390	93	265	387	0	72135
2762	1192	110	72559	120	0	73981
2763	688	107	935	70497	0	72227
2764	314	112	73457	901	0	74784
2765	223	73060	1002	316	0	74601
2766	72982	899	455	509	0	74845
2767	72934	241	281	410	0	73866
2768	1229	176	73713	162	0	75280
2769	492	130	71783	141	0	72546
2770	622	111	1173	70027	0	71933
2771	438	123	442	72986	0	73989
2772	73861	106	285	1334	0	75586
2773	1027	74220	271	422	0	75940
2774	75283	862	226	543	0	76914
2775	75337	264	260	464	0	76325
2776	1252	202	73950	198	0	75602
2777	68924	115	996	571	0	70606
2778	1154	139	74686	196	0	76175
2779	726	143	1036	73636	0	75541
2780	449	149	78818	906	0	80322
2781	567	92	1074	77010	0	78743
2782	342	112	78903	986	0	80343
2783	73620	83	1162	695	0	75560
2784	77576	69	461	505	0	78611
2785	1321	69	371	77694	0	79455
2786	78549	77	337	1335	0	80298
2787	1251	103	301	78728	0	80383
2788	545	80031	279	1113	0	81968
2789	79649	804	277	764	0	81494
2790	1129	79846	303	329	0	81607
2791	686	969	248	80398	0	82301
2792	552	306	211	78878	0	79947
2793	538	194	205	78136	0	79073
2794	487	153	227	77463	0	78330
2795	302	223	75132	1325	0	76982
2796	64277	151	980	1016	0	66424
2797	71923	151	335	711	0	73120
2798	1231	72369	276	454	0	74330
2799	660	846	199	72664	0	74369
2800	530	296	210	73186	0	74222
2801	372	211	70802	1261	0	72646
2802	66248	128	1041	777	0	68194
2803	1215	143	401	70039	0	71798
2804	508	177	68991	1037	0	70713
2805	65976	162	1023	834	0	67995
2806	69413	112	396	743	0	70664
2807	69607	90	337	677	0	70711
2808	1338	111	68272	350	0	70071
2809	683	94	63798	341	0	64916
2810	63804	103	1062	486	0	65455
2811	1156	92	499	66210	0	67957
2812	649	108	304	68154	0	69215
2813	473	128	68079	1048	0	69728
2814	64713	100	901	744	0	66458
2815	1125	112	433	69813	0	71483
2816	71488	84	348	1375	0	73295
2817	71504	85	262	822	0	72673
2818	71444	71	273	727	0	72515
2819	1460	124	73101	392	0	75077
2820	806	77	1068	72460	0	74411
2821	73230	79	430	1458	0	75197
2822	1292	74792	379	544	0	77007
2823	882	962	269	76070	0	78183
2824	763	320	223	76668	0	77974
2825	75907	190	245	1716	0	78058
2826	75350	115	286	952	0	76703
2827	1725	109	251	74161	0	76246
2828	846	174	74270	1264	0	76554
2829	71206	158	1161	913	0	73438
2830	1539	149	79798	529	0	82015
2831	79283	98	1390	699	0	81470
2832	83251	84	590	601	0	84526
2833	2043	109	82327	410	0	84889
2834	1147	138	1524	83164	0	85973
2835	718	173	88178	1680	0	90749
2836	586	94014	1923	667	0	97190
2837	947	1997	671	88259	0	91874
2838	574	94984	468	1770	0	97796
2839	856	2072	320	96032	0	99280
2840	475	602	98645	2239	0	101961
2841	425	97637	2254	841	0	101157
2842	370	103051	778	531	0	104730
2843	958	3022	488	101568	0	106036
2844	102376	878	354	2678	0	106286
2845	2868	457	263	111741	0	115329
2846	112387	277	281	3524	0	116469
2847	3158	115436	334	1066	0	119994
2848	122907	3128	236	968	0	127239
2849	3724	1042	126602	508	0	131876
2850	1887	599	3362	122990	0	128838
2851	1413	391	949	125494	0	128247
2852	652	379	124894	4317	0	130242
2853	117640	338	3438	2010	0	123426
2854	124395	383	1055	1293	0	127126
2855	4324	123417	732	631	0	129104
2856	2439	3880	458	111140	0	117917
2857	1023	122228	495	3042	0	126788
2858	809	3591	120564	1175	0	126139
2859	804	1204	122999	901	0	125908
2860	1345	1709	4080	114985	0	122119
2861	115378	463	1354	3533	0	120728
2862	3344	114297	780	1190	0	119611
2863	114757	3258	490	1097	0	119602
2864	3626	1230	112704	653	0	118213
2865	111638	672	3359	877	0	116546
2866	116094	575	1213	788	0	118670
2867	4355	492	113713	524	0	119084
2868	2179	498	3475	110525	0	116677
2869	113785	506	1188	3710	0	119189
2870	114837	470	789	1531	0	117627
2871	115502	504	694	1037	0	117737
2872	5100	389	638	111459	0	117586
2873	1933	406	111154	3438	0	116931
2874	108452	390	3440	1602	0	113884
2875	4175	445	112228	873	0	117721
2876	2262	446	3746	107549	0	114003
2877	1826	414	1378	107983	0	111601
2878	1285	111071	972	3797	0	117125
2879	1219	3317	110681	1560	0	116777
2880	1155	105311	3647	1062	0	111175
2881	1031	109667	1497	1004	0	113199
2882	1368	4018	1038	107069	0	113493
2883	1171	1468	107870	3673	0	114182
2884	1436	903	3710	107083	0	113132
2885	1053	722	108456	4095	0	114326
2886	1282	685	4035	106567	0	112569
2887	1318	754	1605	108878	0	112555
2888	948	784	104215	4678	0	110625
2889	1190	712	3974	103172	0	109048
2890	943	717	104468	4428	0	110556
2891	945	749	103427	2056	0	107177
2892	921	101895	4785	1553	0	109154
2893	102148	3649	2045	1524	0	109366
2894	3905	1517	102603	1266	0	109291
2895	99395	1002	4195	1424	0	106016
2896	4354	877	1962	102810	0	110003
2897	1831	823	102372	4209	0	109235
2898	1236	101811	4325	2042	0	109414
2899	1391	3789	1988	101280	0	108448
2900	1152	1556	102793	4213	0	109714
2901	1600	1167	4288	94448	0	101503
2902	1300	101757	2007	3879	0	108943
2903	102697	3820	1579	2003	0	110099
2904	4465	1572	1395	102837	0	110269
2905	100628	1164	1298	4602	0	107692
2906	103678	997	1238	2333	0	108246
2907	103294	823	1304	1853	0	107274
2908	105115	797	1280	1683	0	108875
2909	103398	839	1231	1677	0	107145
2910	5340	99726	1264	1409	0	107739
2911	2737	3704	1190	99732	0	107363
2912	2337	1475	1099	102132	0	107043
2913	2057	971	1192	102294	0	106514
2914	1824	788	96794	5190	0	104596
2915	1704	96056	3892	2451	0	104103
2916	97782	3633	1759	1766	0	104940
2917	97842	1556	1408	1709	0	102515
2918	5162	94272	1313	1605	0	102352
2919	2308	97954	1337	1526	0	103125
2920	95952	4354	1223	1699	0	103228
2921	4534	1885	93801	1370	0	101590
2922	2477	1507	4252	91051	0	99287
2923	91543	1101	1893	4201	0	98738
2924	4674	1031	1406	87804	0	94915
2925	2118	89378	1265	4229	0	96990
2926	1939	3644	1205	90026	0	96814
2927	1514	1654	89930	4310	0	97408
2928	86420	1160	4179	2151	0	93910
2929	91451	870	1885	1711	0	95917
2930	5173	739	1299	82906	0	90117
2931	2877	674	1068	84359	0	88978
2932	78685	721	1007	4414	0	84827
2933	4011	77862	1009	2211	0	85093
2934	2395	2830	1064	75990	0	82279
2935	2083	1115	882	76682	0	80762
2936	67414	627	773	3769	0	72583
2937	3165	68675	813	1990	0	74643
2938	67089	2458	640	1510	0	71697
2939	3444	65509	602	1125	0	70680
2940	1588	66521	600	1013	0	69722
2941	61975	2746	669	947	0	66337
2942	2724	62526	578	947	0	66775
2943	1642	3715	981	58025	0	64363
2944	1082	1008	58380	2440	0	62910
2945	671	583	47869	899	0	50022
2946	448	433	45857	632	0	47370
2947	456	44905	1922	471	0	47754
2948	36112	1146	1663	320	0	39241
2949	1112	416	327	33819	0	35674
2950	537	296	168	34704	0	35705
2951	346	153	33941	1277	0	35717
2952	33386	169	997	687	0	35239
2953	1114	138	418	34807	0	36477
2954	580	130	282	35448	0	36440
2955	434	164	183	35673	0	36454
2956	34224	152	156	1569	0	36101
2957	1112	158	33460	728	0	35458
2958	33512	134	1003	524	0	35173
2959	1323	168	398	33680	0	35569
2960	583	194	33555	1100	0	35432
2961	32489	180	1012	652	0	34333
2962	1180	222	33831	453	0	35686
2963	689	346	1111	32827	0	34973
2964	455	198	34006	1070	0	35729
2965	332	158	33097	538	0	34125
2966	31140	138	1343	496	0	33117
2967	1059	121	32517	333	0	34030
2968	601	135	1280	31629	0	33645
2969	31848	115	629	1109	0	33701
2970	1144	136	483	32141	0	33904
2971	548	153	31801	1221	0	33723
2972	450	125	32180	644	0	33399
2973	324	32267	1308	536	0	34435
2974	356	892	678	31665	0	33591
2975	30893	345	463	1164	0	32865
2976	1028	30968	301	605	0	32902
2977	31283	926	271	557	0	33037
2978	1227	419	263	30915	0	32824
2979	30800	321	273	1177	0	32571
2980	1255	30447	323	578	0	32603
2981	691	985	274	30409	0	32359
2982	30659	449	266	1163	0	32537
2983	1147	31104	303	623	0	33177
2984	656	1023	299	30977	0	32955
2985	588	464	317	31393	0	32762
2986	31540	335	347	1407	0	33629
2987	1203	228	334	31720	0	33485
2988	640	230	364	32189	0	33423
2989	604	198	336	33004	0	34142
2990	480	209	31234	1618	0	33541
2991	30854	182	1142	1001	0	33179
2992	1269	184	539	35695	0	37687
2993	676	185	36341	1629	0	38831
2994	35110	166	1470	929	0	37675
2995	1571	209	36845	682	0	39307
2996	789	228	1579	34986	0	37582
2997	598	36058	656	1532	0	38844
2998	568	1248	516	37019	0	39351
2999	494	501	37127	1727	0	39849
3000	474	402	38501	815	0	40192
3001	592	236	1793	38270	0	40891
3002	440	258	38386	1719	0	40803
3003	36600	238	1740	934	0	39512
3004	1553	260	38355	731	0	40899
3005	788	255	1729	37222	0	39994
3006	701	227	782	38525	0	40235
3007	521	244	688	38771	0	40224
3008	37566	194	481	2264	0	40505
3009	37986	208	511	1200	0	39905
3010	39010	166	450	978	0	40604
3011	2149	205	433	37730	0	40517
3012	1019	211	443	38448	0	40121
3013	669	112	36543	2121	0	39445
3014	554	126	37132	1098	0	38910
3015	542	36161	1743	904	0	39350
3016	573	1250	747	32287	0	34857
3017	589	325	456	31870	0	33240
3018	442	32537	428	1419	0	34826
3019	32542	995	385	911	0	34833
3020	1208	32820	378	688	0	35094
3021	32910	1137	407	655	0	35109
3022	1422	439	372	32808	0	35041
3023	33200	286	373	1458	0	35317
3024	1412	193	366	33348	0	35319
3025	573	241	32524	1515	0	34853
3026	557	219	1209	33031	0	35016
3027	32484	197	556	1567	0	34804
3028	1358	176	463	32812	0	34809
3029	654	209	299	33394	0	34556
3030	496	187	32854	1762	0	35299
3031	519	126	1158	33274	0	35077
3032	525	229	480	32479	0	33713
3033	484	32021	404	1602	0	34511
3034	475	972	272	32243	0	33962
3035	571	284	285	32659	0	33799
3036	524	217	284	31648	0	32673
3037	318	28393	246	1449	0	30406
3038	323	698	158	27415	0	28594
3039	26090	200	202	1160	0	27652
3040	756	25360	180	626	0	26922
3041	326	24379	152	463	0	25320
3042	243	24672	143	418	0	25476
3043	263	943	198	23162	0	24566
3044	220	22726	345	875	0	24166
3045	264	24050	322	506	0	25142
3046	23341	648	376	459	0	24824
3047	681	321	22848	381	0	24231
3048	22124	261	708	430	0	23523
3049	690	224	302	22928	0	24144
3050	189	200	22701	907	0	23997
3051	21724	187	898	483	0	23292
3052	619	153	22219	488	0	23479
3053	290	121	22191	426	0	23028
3054	22719	158	975	426	0	24278
3055	863	187	557	23278	0	24885
3056	367	161	23640	1020	0	25188
3057	23109	105	869	729	0	24812
3058	24239	120	347	708	0	25414
3059	1015	148	24150	573	0	25886
3060	24850	95	773	524	0	26242
3061	25904	75	339	492	0	26810
3062	1144	80	24660	510	0	26394
3063	24692	103	800	631	0	26226
3064	25270	109	489	559	0	26427
3065	964	132	24095	475	0	25666
3066	463	219	26965	397	0	28044
3067	373	248	995	27144	0	28760
3068	341	247	27394	1109	0	29091
3069	27245	274	849	621	0	28989
3070	1085	292	324	27233	0	28934
3071	657	332	261	27773	0	29023
3072	628	291	26816	1042	0	28777
3073	570	216	824	26437	0	28047
3074	527	161	26802	1115	0	28605
3075	26880	139	882	659	0	28560
3076	27747	142	442	607	0	28938
3077	1104	122	27242	583	0	29051
3078	27084	123	900	588	0	28695
3079	28154	104	369	669	0	29296
3080	1080	118	27572	676	0	29446
3081	28065	98	936	776	0	29875
3082	28286	120	458	784	0	29648
3083	978	116	28314	680	0	30088
3084	27683	185	870	725	0	29463
3085	930	228	28975	737	0	30870
3086	386	182	872	28758	0	30198
3087	402	157	311	29249	0	30119
3088	375	228	276	29885	0	30764
3089	343	222	28589	1277	0	30431
3090	25971	217	703	725	0	27616
3091	964	287	27359	444	0	29054
3092	286	22758	458	231	0	23733
3093	187	23132	198	150	0	23667
3094	23042	344	218	191	0	23795
3095	442	115	116	22430	0	23103
3096	182	22993	127	383	0	23685
3097	22882	269	95	151	0	23397
3098	22832	74	104	157	0	23167
3099	391	24084	89	97	0	24661
3100	240	306	99	22414	0	23059
3101	132	23519	76	282	0	24009
3102	24064	318	88	159	0	24629
3103	24330	108	69	126	0	24633
3104	459	71	75	23550	0	24155
3105	23757	46	57	386	0	24246
3106	456	61	78	23729	0	24324
3107	177	73	23670	401	0	24321
3108	22830	72	381	186	0	23469
3109	479	70	23762	89	0	24400
3110	223	37	379	23287	0	23926
3111	23707	51	134	425	0	24317
3112	473	50	89	23781	0	24393
3113	207	45	23684	412	0	24348
3114	141	63	22966	149	0	23319
3115	215	251	427	23092	0	23985
3116	23338	40	191	438	0	24007
3117	437	23626	114	153	0	24330
3118	228	333	100	23658	0	24319
3119	183	90	23990	371	0	24634
3120	23281	53	402	217	0	23953
3121	24715	28	182	144	0	25069
3122	522	36	24263	86	0	24907
3123	24249	20	386	138	0	24793
3124	500	55	154	25261	0	25970
3125	194	40	25581	398	0	26213
3126	25020	28	410	190	0	25648
3127	490	27	185	25254	0	25956
3128	242	29	122	25005	0	25398
3129	25438	37	119	502	0	26096
3130	433	24542	111	171	0	25257
3131	229	25291	88	132	0	25740
3132	25204	380	140	169	0	25893
3133	24615	115	102	161	0	24993
3134	529	64	25506	108	0	26207
3135	213	49	25260	111	0	25633
3136	220	37	457	25916	0	26630
3137	26701	44	175	477	0	27397
3138	26214	47	120	234	0	26615
3139	26748	30	109	181	0	27068
3140	515	26260	105	147	0	27027
3141	243	27184	113	109	0	27649
3142	214	409	107	27968	0	28698
3143	219	132	91	27572	0	28014
3144	256	67	101	28818	0	29242
3145	196	68	29249	489	0	30002
3146	213	75	26349	225	0	26862
3147	28556	59	507	185	0	29307
3148	30311	66	195	198	0	30770
3149	612	53	119	30129	0	30913
3150	303	53	136	29931	0	30423
3151	246	59	100	30796	0	31201
3152	191	57	29804	544	0	30596
3153	150	73	29282	247	0	29752
3154	166	73	402	29507	0	30148
3155	125	47	30408	422	0	31002
3156	115	29221	392	238	0	29966
3157	120	30370	173	166	0	30829
3158	29929	373	138	195	0	30635
3159	388	29670	116	113	0	30287
3160	215	12595	96	17666	0	30572
3161	171	270	81	29884	0	30406
3162	127	31017	86	441	0	31671
3163	174	368	97	31351	0	31990
3164	128	137	30958	443	0	31666
3165	111	30777	388	228	0	31504
3166	165	335	150	29209	0	29859
3167	102	138	29504	346	0	30090
3168	100	28964	335	166	0	29565
3169	158	332	156	28323	0	28969
3170	115	29320	89	318	0	29842
3171	131	322	79	29390	0	29922
3172	166	137	78	28469	0	28850
3173	104	29013	83	388	0	29588
3174	28093	301	96	251	0	28741
3175	27495	132	87	212	0	27926
3176	408	27775	85	132	0	28400
3177	186	28545	91	157	0	28979
3178	182	377	89	28575	0	29223
3179	118	165	28286	361	0	28930
3180	26785	88	335	281	0	27489
3181	27409	96	157	187	0	27849
3182	436	91	27248	126	0	27901
3183	26402	69	343	208	0	27022
3184	27444	86	161	146	0	27837
3185	465	89	26836	126	0	27516
3186	25324	80	358	202	0	25964
3187	403	112	27420	116	0	28051
3188	205	27916	349	119	0	28589
3189	28180	326	159	181	0	28846
3190	28297	148	110	162	0	28717
3191	461	115	28286	110	0	28972
3192	28051	97	351	185	0	28684
3193	29483	95	169	233	0	29980
3194	493	85	29028	114	0	29720
3195	29335	86	320	217	0	29958
3196	30249	88	166	192	0	30695
3197	481	80	29917	118	0	30596
3198	30127	91	359	186	0	30763
3199	426	120	160	29484	0	30190
3200	242	94	86	29477	0	29899
3201	134	101	29295	408	0	29938
3202	135	88	28168	192	0	28583
3203	178	92	372	29182	0	29824
3204	170	92	178	29767	0	30207
3205	31670	48	106	417	0	32241
3206	434	62	31157	167	0	31820
3207	31089	69	367	155	0	31680
3208	483	70	150	32230	0	32933
3209	172	72	32330	382	0	32956
3210	33211	64	389	257	0	33921
3211	521	43	153	35599	0	36316
3212	189	68	36161	453	0	36871
3213	35025	73	496	256	0	35850
3214	504	39	169	36638	0	37350
3215	37332	33	139	562	0	38066
3216	519	52	39713	152	0	40436
3217	333	54	477	36995	0	37859
3218	158	40981	195	407	0	41741
3219	41568	451	134	311	0	42464
3220	41077	152	129	269	0	41627
3221	604	42824	114	99	0	43641
3222	43620	467	103	222	0	44412
3223	43270	134	105	197	0	43706
3224	42899	86	104	194	0	43283
3225	698	42606	114	88	0	43506
3226	344	462	89	42900	0	43795
3227	218	168	43591	501	0	44478
3228	276	77	541	42118	0	43012
3229	269	60	190	42959	0	43478
3230	139	81	43753	662	0	44635
3231	180	73	42037	262	0	42552
3232	320	85	628	40441	0	41474
3233	165	43776	231	456	0	44628
3234	43860	510	150	300	0	44820
3235	43080	180	102	241	0	43603
3236	691	44698	101	151	0	45641
3237	45203	533	72	245	0	46053
3238	44884	172	101	241	0	45398
3239	750	148	44901	113	0	45912
3240	43068	89	551	311	0	44019
3241	690	46808	188	171	0	47857
3242	285	533	46302	171	0	47291
3243	266	182	44021	142	0	44611
3244	189	45659	645	143	0	46636
3245	44952	528	281	229	0	45990
3246	651	160	45886	112	0	46809
3247	351	124	547	45251	0	46273
3248	247	112	45681	525	0	46565
3249	41987	106	612	326	0	43031
3250	678	142	53471	164	0	54455
3251	349	111	51994	127	0	52581
3252	51619	82	637	304	0	52642
3253	636	55056	264	129	0	56085
3254	56658	532	195	281	0	57666
3255	57139	188	197	281	0	57805
3256	789	134	178	56416	0	57517
3257	349	62621	169	489	0	63628
3258	63514	545	164	487	0	64710
3259	700	225	64308	135	0	65368
3260	61602	138	515	383	0	62638
3261	664	65614	252	182	0	66712
3262	65163	485	176	294	0	66118
3263	65213	137	176	265	0	65791
3264	641	66753	203	143	0	67740
3265	337	506	174	67531	0	68548
3266	68394	188	163	675	0	69420
3267	692	68098	175	172	0	69137
3268	402	586	145	68603	0	69736
3269	70049	200	113	796	0	71158
3270	748	194	128	71897	0	72967
3271	497	137	125	71149	0	71908
3272	317	72187	162	707	0	73373
3273	71805	632	155	523	0	73115
3274	72320	273	140	426	0	73159
3275	73935	185	120	362	0	74602
3276	943	76602	173	155	0	77873
3277	77783	665	114	442	0	79004
3278	78151	278	119	363	0	78911
3279	1048	191	122	77264	0	78625
3280	547	184	127	77675	0	78533
3281	372	249	78085	795	0	79501
3282	483	151	663	75334	0	76631
3283	615	159	251	72430	0	73455
3284	295	223	77874	851	0	79243
3285	67241	195	674	885	0	68995
3286	900	198	77569	221	0	78888
3287	495	185	77678	190	0	78548
3288	513	159	765	77078	0	78515
3289	462	190	297	77892	0	78841
3290	331	80059	235	671	0	81296
3291	79737	669	161	539	0	81106
3292	77883	235	147	511	0	78776
3293	904	79069	211	248	0	80432
3294	414	84192	188	282	0	85076
3295	510	943	183	82294	0	83930
3296	261	85833	194	748	0	87036
3297	85662	917	158	600	0	87337
3298	85322	319	192	421	0	86254
3299	1277	218	198	84616	0	86309
3300	675	195	178	85159	0	86207
3301	85041	156	173	1345	0	86715
3302	1065	244	82487	462	0	84258
3303	79873	177	868	622	0	81540
3304	1152	218	82050	218	0	83638
3305	79832	120	772	397	0	81121
3306	1080	226	263	81776	0	83345
3307	428	165	83421	796	0	84810
3308	390	190	80259	334	0	81173
3309	78561	296	1211	561	0	80629
3310	81048	110	371	516	0	82045
3311	967	83839	205	152	0	85163
3312	582	714	123	86037	0	87456
3313	421	233	109	87946	0	88709
3314	87192	137	104	1431	0	88864
3315	1001	86678	150	426	0	88255
3316	83822	828	108	556	0	85314
3317	969	83263	110	207	0	84549
3318	371	83554	96	155	0	84176
3319	82639	953	88	522	0	84202
3320	947	381	81825	147	0	83300
3321	566	202	848	80339	0	81955
3322	439	142	268	81804	0	82653
3323	269	170	82450	1040	0	83929
3324	437	130	864	80139	0	81570
3325	847	185	398	69255	0	70685
3326	172	82328	177	1085	0	83762
3327	80853	871	136	801	0	82661
3328	992	349	82452	242	0	84035
3329	75526	204	857	648	0	77235
3330	997	81992	299	237	0	83525
3331	581	897	134	82738	0	84350
3332	84580	318	135	1341	0	86374
3333	1192	211	128	84608	0	86139
3334	653	133	113	85004	0	85903
3335	291	183	84587	1254	0	86315
3336	76191	123	936	1062	0	78312
3337	82388	113	343	749	0	83593
3338	1270	153	83297	316	0	85036
3339	726	137	949	81825	0	83637
3340	340	178	83066	1033	0	84617
3341	77904	79	1035	895	0	79913
3342	83313	93	429	693	0	84528
3343	1413	111	218	83051	0	84793
3344	82549	101	213	1415	0	84278
3345	1225	149	89012	461	0	90847
3346	822	107	978	87568	0	89475
3347	677	100	450	87004	0	88231
3348	505	86	237	91668	0	92496
3349	467	101	209	91207	0	91984
3350	82028	81	150	1802	0	84061
3351	1155	120	81718	612	0	83605
3352	638	75	987	82176	0	83876
3353	387	122	81324	1177	0	83010
3354	345	133	79020	570	0	80068
3355	440	95	1223	78963	0	80721
3356	425	79	500	80876	0	81880
3357	76477	63	295	1631	0	78466
3358	1206	94	243	76613	0	78156
3359	645	90	188	76925	0	77848
3360	444	84	210	78475	0	79213
3361	77107	66	178	2023	0	79374
3362	77224	77	172	1072	0	78545
3363	78252	86	223	735	0	79296
3364	76749	88	169	722	0	77728
3365	1512	84867	200	452	0	87031
3366	875	1322	172	84643	0	87012
3367	612	511	174	87038	0	88335
3368	89365	221	149	2387	0	92122
3369	1833	95996	187	1050	0	99066
3370	1116	2061	113	100592	0	103882
3371	492	781	107319	2439	0	111031
3372	107447	281	2610	1619	0	111957
3373	3327	116934	914	631	0	121806
3374	122061	3282	467	786	0	126596
3375	126762	1066	244	751	0	128823
3376	5579	414	181	122952	0	129126
3377	1803	360	123684	3996	0	129843
3378	1533	229	3707	125774	0	131243
3379	127091	223	1187	4805	0	133306
3380	4744	222	551	127376	0	132893
3381	128024	208	354	4752	0	133338
3382	4540	126576	289	1789	0	133194
3383	132106	3897	306	1323	0	137632
3384	5259	1240	297	131367	0	138163
3385	2597	602	321	143552	0	147072
3386	145641	501	252	5908	0	152302
3387	147709	346	198	2645	0	150898
3388	149081	304	175	1676	0	151236
3389	149143	349	251	1274	0	151017
3390	149110	283	275	1166	0	150834
3391	6936	299	359	143006	0	150600
3392	2763	362	139126	4659	0	146910
3393	1777	141169	3554	2057	0	148557
3394	136898	3933	1182	1598	0	143611
3395	5070	1427	135282	873	0	142652
3396	132539	704	3861	1147	0	138251
3397	5278	135625	1347	885	0	143135
3398	138610	3881	703	1180	0	144374
3399	5811	1360	489	136294	0	143954
3400	3215	693	360	139536	0	143804
3401	1965	630	136586	5398	0	144579
3402	2400	440	4019	134133	0	140992
3403	1701	487	138726	4911	0	145825
3404	1672	499	138181	2289	0	142641
3405	137767	486	5177	1956	0	145386
3406	145760	628	1942	1785	0	150115
3407	6262	642	141259	1358	0	149521
3408	137921	497	4310	1770	0	144498
3409	144100	485	1673	1578	0	147836
3410	6656	628	139433	1141	0	147858
3411	3244	137555	4283	1321	0	146403
3412	3345	3941	1856	141976	0	151118
3413	147301	1439	1145	5015	0	154900
3414	151591	1003	948	2618	0	156160
3415	152397	753	904	1875	0	155929
3416	153088	640	1033	1764	0	156525
3417	152735	635	1110	1547	0	156027
3418	7268	744	146969	1168	0	156149
3419	4163	761	150947	1233	0	157104
3420	3749	985	5074	150502	0	160310
3421	154133	783	2186	5322	0	162424
3422	157973	697	1391	2788	0	162849
3423	157284	749	1209	2409	0	161651
3424	148083	777	1252	2767	0	152879
3425	6923	147653	1288	2162	0	158026
3426	4260	158136	1173	2286	0	165855
3427	158028	4679	1223	2569	0	166499
3428	160778	1790	1110	2455	0	166133
3429	7670	158512	1044	1875	0	169101
3430	162109	4199	947	2156	0	169411
3431	7618	1981	158848	1686	0	170133
3432	5016	1162	4341	157417	0	167936
3433	4124	1123	160253	4929	0	170429
3434	4187	977	157677	4089	0	166930
3435	4428	808	5272	158850	0	169358
3436	4544	727	2234	165828	0	173333
3437	4210	858	169796	5539	0	180403
3438	4270	998	4696	162301	0	172265
3439	3922	1024	2313	171576	0	178835
3440	171035	1020	1824	6405	0	180284
3441	172421	947	1727	3221	0	178316
3442	7910	1046	1722	169601	0	180279
3443	4496	1289	168964	5198	0	179947
3444	3720	168826	4885	2799	0	180230
3445	164694	4191	2656	2666	0	174207
3446	6718	1740	171694	2061	0	182213
3447	4156	164764	5258	2063	0	176241
3448	3361	176248	2867	2084	0	184560
3449	177018	4679	2187	2536	0	186420
3450	180660	1819	2092	2394	0	186965
3451	7680	1181	2244	176005	0	187110
3452	4343	1166	183877	5108	0	194494
3453	4205	871	5497	181469	0	192042
3454	4132	872	2961	185075	0	193040
3455	4014	812	2276	188385	0	195487
3456	185091	835	1926	6701	0	194553
3457	7062	179670	1972	2986	0	191690
3458	4476	188919	1920	2074	0	197389
3459	3989	5145	1749	183268	0	194151
3460	3711	2052	1709	190613	0	198085
3461	187785	1443	1559	6882	0	197669
3462	185545	1129	1451	3654	0	191779
3463	187517	853	1397	2749	0	192516
3464	8320	183416	1590	1836	0	195162
3465	178670	3577	1401	1975	0	185623
3466	6930	2251	1495	174613	0	185289
3467	4078	975	172405	4604	0	182062
3468	3488	784	157443	2343	0	164058
3469	150631	564	3987	2196	0	157378
3470	4296	561	152169	1205	0	158231
3471	2331	537	141622	880	0	145370
3472	126824	312	2063	1290	0	130489
3473	2297	312	134066	534	0	137209
3474	1002	311	128833	325	0	130471
3475	1219	969	1367	121538	0	125093
3476	540	187	130095	881	0	131703
3477	740	153	996	122435	0	124324
3478	809	187	445	121397	0	122838
3479	414	205	130313	955	0	131887
3480	324	130646	976	511	0	132457
3481	128481	670	437	1006	0	130594
3482	983	334	134287	251	0	135855
3483	441	253	130986	233	0	131913
3484	108806	133	1058	1145	0	111142
3485	845	181	124069	147	0	125242
3486	300	118225	806	172	0	119503
3487	453	102230	684	287	0	103654
3488	381	664	284	121479	0	122808
3489	364	265	220	119481	0	120330
3490	123381	159	127	1426	0	125093
3491	121076	108	169	975	0	122328
3492	121941	117	136	769	0	122963
3493	1010	195	118	122279	0	123602
3494	122555	83	140	1346	0	124124
3495	120029	100	140	952	0	121221
3496	951	164	122794	248	0	124157
3497	518	169	116793	239	0	117719
3498	318	123595	804	178	0	124895
3499	368	617	313	124750	0	126048
3500	125097	222	238	1259	0	126816
3501	750	124878	235	329	0	126192
3502	444	669	178	127239	0	128530
3503	124607	220	173	1426	0	126426
3504	121091	188	146	988	0	122413
3505	868	123754	161	364	0	125147
3506	121838	663	124	802	0	123427
3507	121678	242	165	777	0	122862
3508	1188	195	142	121902	0	123427
3509	500	236	124337	719	0	125792
3510	426	120331	736	392	0	121885
3511	253	123313	292	335	0	124193
3512	117709	750	230	692	0	119381
3513	972	339	179	116109	0	117599
3514	372	297	117792	706	0	119167
3515	266	117572	774	294	0	118906
3516	116941	738	250	884	0	118813
3517	117288	270	192	890	0	118640
3518	1045	285	120757	190	0	122277
3519	798	157	848	115368	0	117171
3520	572	124	304	126064	0	127064
3521	318	229	144589	1219	0	146355
3522	140653	142	1852	1373	0	144020
3523	176593	138	641	949	0	178321
3524	4760	161	508	191494	0	196923
3525	1482	196341	525	4277	0	202625
3526	2019	4355	243	203453	0	210070
3527	788	1571	203094	5355	0	210808
3528	196316	860	4787	2846	0	204809
3529	6200	656	1662	208031	0	216549
3530	2110	626	208005	5655	0	216396
3531	196490	504	5354	3073	0	205421
3532	6564	393	2051	204918	0	213926
3533	3305	493	1487	206072	0	211357
3534	203177	242	1142	7739	0	212300
3535	5871	205166	1281	3158	0	215476
3536	202757	4909	906	2798	0	211370
3537	7625	1665	704	199318	0	209312
3538	199649	1134	724	6950	0	208457
3539	7225	1060	198781	2956	0	210022
3540	3300	199178	5357	2474	0	210309
3541	3308	5594	2007	201271	0	212180
3542	203037	2181	1346	7278	0	213842
3543	6585	204034	1455	3138	0	215212
3544	4500	5944	1284	204119	0	215847
3545	206547	2243	1139	7728	0	217657
3546	204848	1571	1056	4119	0	211594
3547	9591	1280	978	197558	0	209407
3548	4324	1533	195558	7561	0	208976
3549	3219	1327	194010	3997	0	202553
3550	189027	1072	7102	3832	0	201033
3551	7685	190709	3010	2627	0	204031
3552	3958	192119	2154	2284	0	200515
3553	185903	6936	1865	2726	0	197430
3554	7530	191264	1697	2017	0	202508
3555	4862	6806	1600	188261	0	201529
3556	4069	3289	1390	195208	0	203956
3557	191870	2582	1236	8814	0	204502
3558	190809	2251	915	4689	0	198664
3559	192343	2050	699	3648	0	198740
3560	9825	2018	183853	2888	0	198584
3561	6384	1409	5867	184019	0	197679
3562	4536	1423	185964	7391	0	199314
3563	3954	1180	184531	4004	0	193669
3564	3546	1235	190956	3117	0	198854
3565	3874	1399	8979	182877	0	197129
3566	3035	1578	189458	7338	0	201409
3567	2998	1627	193644	3656	0	201925
3568	3103	1621	9572	186872	0	201168
3569	189180	1351	4692	8792	0	204015
3570	7938	1377	191834	4146	0	205295
3571	4784	1244	8551	184779	0	199358
3572	4188	1117	4255	192887	0	202447
3573	3299	1172	192334	9685	0	206490
3574	3934	1256	8110	189317	0	202617
3575	3284	1335	194133	9133	0	207885
3576	3688	1316	8534	188087	0	201625
3577	3572	1215	4451	192711	0	201949
3578	3064	1014	3780	195242	0	203100
3579	2776	1039	3437	194770	0	202022
3580	183795	917	3415	12068	0	200195
3581	185087	923	3216	6906	0	196132
3582	9298	1135	180546	5228	0	196207
3583	4759	175730	8086	4723	0	193298
3584	3695	5995	182748	4304	0	196742
3585	3381	2306	183645	4092	0	193424
3586	173900	1457	9958	4290	0	189605
3587	8131	179047	5694	3767	0	196639
3588	179540	6429	4691	3802	0	194462
3589	8544	181715	4508	3220	0	197987
3590	181333	7368	4136	3662	0	196499
3591	186171	3307	3759	3571	0	196808
3592	10682	2329	3280	176896	0	193187
3593	5301	180887	3042	8674	0	197904
3594	5040	7215	2469	182290	0	197014
3595	4201	3432	2428	187613	0	197674
3596	3687	2285	182385	11064	0	199421
3597	3441	183863	8085	6035	0	201424
3598	3865	7140	4302	185737	0	201044
3599	181359	3138	3572	10500	0	198569
3600	191249	2340	3282	6227	0	203098
3601	193176	2177	3065	5185	0	203603
3602	10590	189208	3036	4532	0	207366
3603	193684	7832	2792	4221	0	208529
3604	10727	200637	2839	3353	0	217556
3605	6494	8999	2487	202902	0	220882
3606	4939	4049	202423	9428	0	220839
3607	5046	2843	8840	195945	0	212674
3608	4011	200817	4275	9824	0	218927
3609	4209	8673	3340	199766	0	215988
3610	3782	4343	2775	202281	0	213181
3611	2938	203214	2613	11813	0	220578
3612	203063	9337	2444	6643	0	221487
3613	10081	4232	2357	203549	0	220219
3614	4776	3246	198585	10951	0	217558
3615	4622	2723	8486	200027	0	215858
3616	4446	2624	3706	208233	0	219009
3617	3403	2484	201317	13055	0	220259
3618	4342	2698	8881	186975	0	202896
3619	3046	196644	4176	11337	0	215203
3620	3474	8561	193048	6094	0	211177
3621	3740	3309	176997	4345	0	188391
3622	1976	163061	8915	3759	0	177711
3623	1352	139600	3242	2728	0	146922
3624	997	125326	2049	1686	0	130058
3625	114816	5061	3502	1846	0	125225
3626	110790	1663	1236	1463	0	115152
3627	110818	921	890	1378	0	114007
3628	4927	751	903	108001	0	114582
3629	1619	870	105939	4008	0	112436
3630	1481	876	3710	104146	0	110213
3631	1357	808	1416	106783	0	110364
3632	104005	761	1004	4977	0	110747
3633	104805	812	840	2194	0	108651
3634	4435	104852	803	1409	0	111499
3635	104225	3571	776	1536	0	110108
3636	106318	1390	787	1388	0	109883
3637	108537	1039	636	1469	0	111681
3638	4871	852	103970	1215	0	110908
3639	2030	681	104104	977	0	107792
3640	1965	916	3850	99945	0	106676
3641	1172	769	101449	3659	0	107049
3642	95913	619	3493	1784	0	101809
3643	99834	517	1252	1393	0	102996
3644	4289	597	96131	824	0	101841
3645	92942	436	3181	1131	0	97690
3646	3681	95233	1261	809	0	100984
3647	96225	3050	874	943	0	101092
3648	4064	1114	707	93920	0	99805
3649	2169	803	606	90547	0	94125
3650	1487	94457	643	3279	0	99866
3651	93713	3128	670	1544	0	99055
3652	94693	1228	637	1232	0	97790
3653	3932	94342	760	765	0	99799
3654	2117	3151	583	90906	0	96757
3655	1608	1236	573	91201	0	94618
3656	1106	91730	661	3747	0	97244
3657	1499	3273	538	90618	0	95928
3658	1420	1338	577	93952	0	97287
3659	90757	930	474	4222	0	96383
3660	91747	864	414	2022	0	95047
3661	4081	774	89157	1302	0	95314
3662	87579	657	2870	1541	0	92647
3663	3584	784	88708	1172	0	94248
3664	1802	962	3001	86217	0	91982
3665	1222	675	86703	3396	0	91996
3666	1152	85457	3115	1545	0	91269
3667	1514	2949	1327	81931	0	87721
3668	1203	1112	834	84399	0	87548
3669	82321	718	658	3641	0	87338
3670	3245	619	645	81844	0	86353
3671	1335	680	79428	3207	0	84650
3672	80260	612	2623	1784	0	85279
3673	83533	648	1073	1292	0	86546
3674	84807	622	728	1189	0	87346
3675	83977	527	649	1127	0	86280
3676	4310	469	587	85622	0	90988
3677	2137	443	636	88528	0	91744
3678	1577	464	641	91510	0	94192
3679	1502	427	602	92617	0	95148
3680	88731	442	565	4643	0	94381
3681	90584	411	521	2143	0	93659
3682	4629	378	471	83064	0	88542
3683	1972	86278	575	3477	0	92302
3684	86964	2923	539	1908	0	92334
3685	3841	1141	85973	1338	0	92293
3686	1924	86280	3121	1136	0	92461
3687	82933	2893	1078	1154	0	88058
3688	3654	84485	760	883	0	89782
3689	1771	3035	84158	858	0	89822
3690	83855	1182	2912	1075	0	89024
3691	86858	737	1100	1007	0	89702
3692	4371	619	84284	826	0	90100
3693	2420	559	3025	84542	0	90546
3694	1987	514	1133	84579	0	88213
3695	1439	85360	795	3681	0	91275
3696	1664	2997	642	84373	0	89676
3697	80876	1078	561	3705	0	86220
3698	3558	81360	556	1601	0	87075
3699	1835	2677	565	75302	0	80379
3700	1475	1008	410	76838	0	79731
3701	1085	707	73550	3388	0	78730
3702	929	73523	2403	1496	0	78351
3703	66937	2522	828	1211	0	71498
3704	2307	58605	431	712	0	62055
3705	974	58267	322	554	0	60117
3706	56684	2220	507	755	0	60166
3707	2230	742	335	55674	0	58981
3708	1062	484	330	57313	0	59189
3709	56264	471	264	2552	0	59551
3710	2386	352	222	56939	0	59899
3711	1300	375	197	58145	0	60017
3712	58101	407	186	2695	0	61389
3713	2464	375	173	56056	0	59068
3714	978	56484	211	2277	0	59950
3715	55904	1794	180	1224	0	59102
3716	2146	786	53709	743	0	57384
3717	955	51417	1627	809	0	54808
3718	727	1910	524	49300	0	52461
3719	529	667	48954	1765	0	51915
3720	484	393	49194	895	0	50966
3721	741	1638	1779	45299	0	49457
3722	45733	238	692	1729	0	48392
3723	1601	201	380	45262	0	47444
3724	814	242	243	46041	0	47340
3725	546	239	198	46626	0	47609
3726	522	240	233	46580	0	47575
3727	505	215	258	46902	0	47880
3728	378	302	44280	2057	0	47017
3729	394	248	44256	980	0	45878
3730	474	245	1599	44050	0	46368
3731	327	276	44137	1713	0	46453
3732	325	44233	1491	908	0	46957
3733	472	1331	642	44417	0	46862
3734	327	518	43649	1685	0	46179
3735	39179	329	1461	1103	0	42072
3736	1361	41661	625	720	0	44367
3737	531	40142	371	662	0	41706
3738	370	41734	296	611	0	43011
3739	498	1579	261	40313	0	42651
3740	40249	660	218	1641	0	42768
3741	1396	366	224	40660	0	42646
3742	39291	318	292	1730	0	41631
3743	1345	38675	295	811	0	41126
3744	39353	1378	213	684	0	41628
3745	1553	680	242	39175	0	41650
3746	785	497	206	39255	0	40743
3747	458	38754	209	1753	0	41174
3748	547	1320	213	39202	0	41282
3749	522	558	227	40093	0	41400
3750	501	437	194	40076	0	41208
3751	38240	383	189	2065	0	40877
3752	35938	363	211	1296	0	37808
3753	1516	342	37731	836	0	40425
3754	37561	269	1201	807	0	39838
3755	1517	321	38218	702	0	40758
3756	814	304	1292	37897	0	40307
3757	623	307	538	38979	0	40447
3758	531	270	387	39660	0	40848
3759	384	263	37975	1997	0	40619
3760	446	261	1341	38265	0	40313
3761	330	281	38451	1764	0	40826
3762	393	258	1427	38726	0	40804
3763	37896	263	616	1916	0	40691
3764	1341	268	38101	1081	0	40791
3765	37657	234	1320	927	0	40138
3766	1564	192	558	38558	0	40872
3767	38037	219	449	1811	0	40516
3768	1411	37823	373	997	0	40604
3769	755	1166	357	38531	0	40809
3770	466	456	39193	1679	0	41794
3771	554	412	1284	38623	0	40873
3772	489	820	562	37492	0	39363
3773	373	37492	414	1813	0	40092
3774	355	1199	36833	917	0	39304
3775	308	36487	1176	743	0	38714
3776	30860	969	475	572	0	32876
3777	834	31755	294	420	0	33303
3778	29179	820	389	363	0	30751
3779	29534	263	179	357	0	30333
3780	29696	174	143	325	0	30338
3781	1106	142	137	29325	0	30710
3782	397	156	28861	922	0	30336
3783	351	154	734	27602	0	28841
3784	205	28840	305	896	0	30246
3785	259	730	181	29129	0	30299
3786	28379	258	164	1033	0	29834
3787	737	28440	190	463	0	29830
3788	342	726	154	27177	0	28399
3789	281	282	137	27587	0	28287
3790	26955	194	138	1064	0	28351
3791	826	179	26680	487	0	28172
3792	361	25969	736	347	0	27413
3793	267	624	206	24059	0	25156
3794	182	190	23831	645	0	24848
3795	198	140	564	22658	0	23560
3796	131	22811	238	631	0	23811
3797	187	562	155	24204	0	25108
3798	142	204	107	23998	0	24451
3799	149	125	133	23853	0	24260
3800	119	123	23320	768	0	24330
3801	22437	135	538	398	0	23508
3802	603	105	190	25044	0	25942
3803	27215	77	118	829	0	28239
3804	27838	117	101	365	0	28421
3805	28362	78	106	315	0	28861
3806	27841	125	71	306	0	28343
3807	28730	71	98	290	0	29189
3808	1070	81	102	27380	0	28633
3809	393	26745	77	770	0	27985
3810	359	600	61	25581	0	26601
3811	203	25639	65	707	0	26614
3812	234	567	29	23993	0	24823
3813	24010	150	34	644	0	24838
3814	607	95	51	23928	0	24681
3815	239	69	23668	562	0	24538
3816	22142	57	433	327	0	22959
3817	534	23856	127	157	0	24674
3818	24054	453	94	217	0	24818
3819	24132	139	80	181	0	24532
3820	23354	85	49	156	0	23644
3821	621	24207	46	115	0	24989
3822	285	456	39	24094	0	24874
3823	239	157	24	24393	0	24813
3824	160	95	24310	578	0	25143
3825	233	100	439	23079	0	23851
3826	237	64	129	23028	0	23458
3827	227	58	74	23983	0	24342
3828	142	24318	66	615	0	25141
3829	24523	469	71	295	0	25358
3830	23619	167	42	239	0	24067
3831	572	146	24533	158	0	25409
3832	260	24518	435	176	0	25389
3833	286	472	124	25098	0	25980
3834	249	172	74	25672	0	26167
3835	214	127	61	25677	0	26079
3836	236	89	71	26062	0	26458
3837	209	106	41	26695	0	27051
3838	159	95	25859	771	0	26884
3839	155	113	24190	389	0	24847
3840	25753	90	579	380	0	26802
3841	27688	122	198	289	0	28297
3842	27994	114	110	273	0	28491
3843	858	73	97	27877	0	28905
3844	351	66	27390	674	0	28481
3845	26696	69	601	359	0	27725
3846	28010	113	201	332	0	28656
3847	784	83	27004	258	0	28129
3848	26521	61	596	255	0	27433
3849	837	82	29244	206	0	30369
3850	454	67	661	29358	0	30540
3851	291	74	29826	740	0	30931
3852	28539	88	712	380	0	29719
3853	29944	80	292	299	0	30615
3854	30206	52	205	269	0	30732
3855	29649	55	138	294	0	30136
3856	929	75	30560	225	0	31789
3857	411	30642	632	253	0	31938
3858	31225	587	324	261	0	32397
3859	31590	191	187	227	0	32195
3860	972	151	31407	170	0	32700
3861	545	98	682	30584	0	31909
3862	414	97	262	32104	0	32877
3863	275	76	31491	842	0	32684
3864	29166	74	683	507	0	30430
3865	31831	80	272	360	0	32543
3866	906	31662	225	261	0	33054
3867	32874	610	166	290	0	33940
3868	32544	183	179	308	0	33214
3869	33229	119	214	209	0	33771
3870	32302	97	191	214	0	32804
3871	1079	120	30961	185	0	32345
3872	30136	63	607	220	0	31026
3873	1020	178	261	30159	0	31618
3874	516	30786	214	642	0	32158
3875	396	574	30097	293	0	31360
3876	357	30569	639	228	0	31793
3877	388	645	281	28979	0	30293
3878	291	184	29781	506	0	30762
3879	27342	102	571	267	0	28282
3880	666	83	29486	178	0	30413
3881	29102	59	596	193	0	29950
3882	731	62	225	29557	0	30575
3883	412	57	161	29557	0	30187
3884	307	28920	149	615	0	29991
3885	280	30301	144	254	0	30979
3886	288	567	117	31099	0	32071
3887	30805	210	137	614	0	31766
3888	30765	119	148	233	0	31265
3889	30623	76	125	205	0	31029
3890	792	70	30573	151	0	31586
3891	29435	67	493	242	0	30237
3892	686	64	31914	163	0	32827
3893	345	63	30085	157	0	30650
3894	30681	75	644	161	0	31561
3895	32239	74	251	166	0	32730
3896	727	108	32026	94	0	32955
3897	443	77	532	31016	0	32068
3898	347	83	202	32793	0	33425
3899	32795	46	180	636	0	33657
3900	31899	39	184	328	0	32450
3901	735	47	34317	172	0	35271
3902	353	32781	434	141	0	33709
3903	197	31921	163	114	0	32395
3904	31882	314	212	143	0	32551
3905	451	112	96	31805	0	32464
3906	291	72	97	32415	0	32875
3907	235	47	95	33293	0	33670
3908	32510	38	101	461	0	33110
3909	492	51	101	33318	0	33962
3910	33754	47	91	401	0	34293
3911	34855	34	107	219	0	35215
3912	562	37108	116	126	0	37912
3913	349	362	106	40102	0	40919
3914	256	165	40313	451	0	41185
3915	38474	103	487	342	0	39406
3916	40361	71	219	271	0	40922
3917	40756	54	163	259	0	41232
3918	787	67	42093	136	0	43083
3919	453	52	526	42120	0	43151
3920	43056	47	241	642	0	43986
3921	41164	68	173	319	0	41724
3922	41172	82	112	253	0	41619
3923	833	40861	116	165	0	41975
3924	435	42915	107	164	0	43621
3925	403	583	83	43833	0	44902
3926	339	229	108	43449	0	44125
3927	293	43527	84	666	0	44570
3928	43437	538	110	386	0	44471
3929	717	237	44370	193	0	45517
3930	436	134	513	44202	0	45285
3931	325	135	209	44658	0	45327
3932	265	128	44034	712	0	45139
3933	40642	105	634	457	0	41838
3934	44785	99	246	302	0	45432
3935	817	44098	170	200	0	45285
3936	44122	463	136	235	0	44956
3937	751	265	45553	142	0	46711
3938	45448	114	542	378	0	46482
3939	787	116	47341	133	0	48377
3940	46300	147	594	230	0	47271
3941	48112	100	256	250	0	48718
3942	48170	69	161	226	0	48626
3943	47734	59	167	229	0	48189
3944	797	47602	110	124	0	48633
3945	48862	416	115	199	0	49592
3946	49874	178	89	215	0	50356
3947	807	119	49445	126	0	50497
3948	49055	87	436	229	0	49807
3949	721	97	173	49064	0	50055
3950	434	80	48465	457	0	49436
3951	47982	76	478	299	0	48835
3952	696	96	203	49448	0	50443
3953	50523	77	128	668	0	51396
3954	54323	76	140	631	0	55170
3955	796	82	58281	172	0	59331
3956	57416	46	502	417	0	58381
3957	59842	63	241	299	0	60445
3958	60069	61	147	265	0	60542
3959	61158	55	127	271	0	61611
3960	932	72	146	59735	0	60885
3961	503	60151	162	535	0	61351
3962	57818	494	131	517	0	58960
3963	61139	206	112	284	0	61741
3964	61088	118	110	283	0	61599
3965	996	125	60884	150	0	62155
3966	531	61129	583	188	0	62431
3967	552	466	270	61845	0	63133
3968	556	180	168	62828	0	63732
3969	500	134	64838	667	0	66139
3970	575	95	694	63940	0	65304
3971	433	147	65471	798	0	66849
3972	499	112	785	64835	0	66231
3973	505	105	309	66136	0	67055
3974	421	163	66570	982	0	68136
3975	62835	150	800	660	0	64445
3976	67575	136	332	556	0	68599
3977	1088	167	68957	305	0	70517
3978	66777	138	759	548	0	68222
3979	69474	97	363	476	0	70410
3980	1215	145	73226	218	0	74804
3981	820	101	819	71445	0	73185
3982	578	69	406	73282	0	74335
3983	74326	64	307	1163	0	75860
3984	1069	76625	265	510	0	78469
3985	70564	785	300	801	0	72450
3986	76402	275	234	474	0	77385
3987	1230	78773	198	281	0	80482
3988	79801	761	227	430	0	81219
3989	79875	326	189	401	0	80791
3990	1317	79155	223	227	0	80922
3991	914	784	212	79550	0	81460
3992	647	80689	214	784	0	82334
3993	700	852	180	81144	0	82876
3994	610	404	80991	894	0	82899
3995	538	337	79217	430	0	80522
3996	78027	196	996	641	0	79860
3997	81288	177	461	558	0	82484
3998	1336	203	82365	261	0	84165
3999	79938	130	975	504	0	81547
4000	83242	109	472	491	0	84314
4001	81113	112	342	503	0	82070
4002	1449	83034	320	267	0	85070
4003	888	763	264	84767	0	86682
4004	84613	312	225	1155	0	86305
4005	83291	186	200	692	0	84369
4006	1466	208	85809	305	0	87788
4007	1001	138	867	83444	0	85450
4008	841	137	398	85270	0	86646
4009	634	85803	317	1002	0	87756
4010	588	91645	230	499	0	92962
4011	701	1564	171	87581	0	90017
4012	456	90407	206	1085	0	92154
4013	87895	1077	149	561	0	89682
4014	1297	91953	148	266	0	93664
4015	93079	1292	126	555	0	95052
4016	1600	423	93865	181	0	96069
4017	95090	241	1281	562	0	97174
4018	100634	132	347	483	0	101596
4019	100400	122	223	462	0	101207
4020	99372	129	165	566	0	100232
4021	2062	98890	193	216	0	101361
4022	1054	1453	112	100279	0	102898
4023	843	472	149	99288	0	100752
4024	438	345	100066	1849	0	102698
4025	706	251	1449	96627	0	99033
4026	640	179	429	100052	0	101300
4027	101310	162	288	2211	0	103971
4028	1836	103012	246	749	0	105843
4029	1083	1607	207	103379	0	106276
4030	931	487	220	105670	0	107308
4031	793	379	191	106865	0	108228
4032	105600	317	219	2654	0	108790
4033	2105	263	204	106318	0	108890
4034	106687	203	219	2564	0	109673
4035	2312	199	321	106793	0	109625
4036	1101	176	224	108652	0	110153
4037	766	211	103921	2410	0	107308
4038	93543	227	1702	1549	0	97021
4039	2121	103106	567	714	0	106508
4040	105828	1674	350	1022	0	108874
4041	2337	524	260	105046	0	108167
4042	1184	354	209	106920	0	108667
4043	108699	256	176	2796	0	111927
4044	110275	252	201	1480	0	112208
4045	3095	233	159	115332	0	118819
4046	1124	264	116941	2615	0	120944
4047	879	278	114821	1131	0	117109
4048	665	121560	2345	825	0	125395
4049	122817	2237	800	1091	0	126945
4050	123826	781	458	966	0	126031
4051	3437	485	263	123507	0	127692
4052	1220	127795	256	2719	0	131990
4053	1294	2468	197	127419	0	131378
4054	1161	783	316	123226	0	125486
4055	765	118116	378	3178	0	122437
4056	118859	2512	328	1639	0	123338
4057	3229	1009	368	118522	0	123128
4058	1271	121777	434	2750	0	126232
4059	1008	128907	376	1104	0	131395
4060	127395	2929	316	1189	0	131829
4061	3163	1122	126925	787	0	131997
4062	126918	790	2424	1069	0	131201
4063	3631	729	731	128604	0	133695
4064	1835	555	453	128435	0	131278
4065	1146	129856	396	3364	0	134762
4066	1435	3038	338	129574	0	134385
4067	1126	1092	130042	3350	0	135610
4068	978	126753	2440	1554	0	131725
4069	869	130461	808	1078	0	133216
4070	127034	3000	502	1423	0	131959
4071	2795	129855	401	1024	0	134075
4072	1466	2911	394	128285	0	133056
4073	1058	130639	355	2905	0	134957
4074	1211	2785	342	131281	0	135619
4075	1204	1080	327	132539	0	135150
4076	832	1071	128462	3675	0	134040
4077	1130	761	2417	125903	0	130211
4078	1066	792	863	129577	0	132298
4079	126240	805	569	4090	0	131704
4080	3071	840	125780	1825	0	131516
4081	1839	784	2477	127286	0	132386
4082	1167	826	127559	3621	0	133173
4083	122094	730	2862	2329	0	128015
4084	3064	128499	1107	1639	0	134309
4085	134263	2997	727	2057	0	140044
4086	3883	1150	592	137380	0	143005
4087	1947	995	567	138398	0	141907
4088	1326	903	135747	4512	0	142488
4089	122342	814	2974	3102	0	129232
4090	3510	136956	1046	1934	0	143446
4091	134319	3241	835	2022	0	140417
4092	4183	1270	654	134575	0	140682
4093	1776	136686	766	3804	0	143032
4094	135460	3288	603	2442	0	141793
4095	3628	139477	668	1766	0	145539
4096	2034	3649	594	138842	0	145119
4097	1760	1518	551	141241	0	145070
4098	1712	1203	642	139675	0	143232
4099	1345	138338	694	4665	0	145042
4100	1519	3477	525	139515	0	145036
4101	1507	1624	503	142456	0	146090
4102	137001	1255	520	5174	0	143950
4103	137677	1282	478	2826	0	142263
4104	137969	1253	546	2183	0	141951
4105	4715	1164	137029	1872	0	144780
4106	135423	1270	2939	2159	0	141791
4107	139830	1174	1022	2041	0	144067
4108	134022	1144	815	2351	0	138332
4109	4412	1296	127452	1783	0	134943
4110	128912	1055	2163	1738	0	133868
4111	4209	829	808	132422	0	138268
4112	1881	878	129935	3691	0	136385
4113	1576	128866	2761	1905	0	135108
4114	1773	3678	943	122311	0	128705
4115	1321	122683	866	3025	0	127895
4116	1213	125491	781	1619	0	129104
4117	119099	2716	956	1466	0	124237
4118	2927	1134	525	119041	0	123627
4119	119531	810	594	3046	0	123981
4120	3121	750	477	119414	0	123762
4121	119261	787	451	3059	0	123558
4122	3063	716	415	119332	0	123526
4123	118603	773	405	3280	0	123061
4124	2894	763	114976	1423	0	120056
4125	1629	819	2125	115142	0	119715
4126	1272	784	116636	2748	0	121440
4127	1207	745	109532	1526	0	113010
4128	984	678	115167	1303	0	118132
4129	1309	871	2505	111867	0	116552
4130	890	666	114294	2716	0	118566
4131	111258	550	2224	1651	0	115683
4132	2527	553	871	113886	0	117837
4133	1201	513	117016	2775	0	121505
4134	1309	450	2144	115317	0	119220
4135	1114	446	879	117668	0	120107
4136	907	508	125330	2931	0	129676
4137	1273	390	2217	123805	0	127685
4138	1237	406	1048	123239	0	125930
4139	1275	128559	813	2620	0	133267
4140	128201	1772	743	1894	0	132610
4141	128485	627	717	1596	0	131425
4142	2660	583	127090	1164	0	131497
4143	118533	398	1853	1458	0	122242
4144	2326	403	120738	845	0	124312
4145	1090	321	115121	730	0	117262
4146	842	345	113887	731	0	115805
4147	1147	1583	2113	107925	0	112768
4148	592	299	112849	1597	0	115337
4149	682	387	1431	109011	0	111511
4150	716	191	712	109574	0	111193
4151	717	202	511	110248	0	111678
4152	705	206	426	109760	0	111097
4153	107557	246	367	2219	0	110389
4154	107504	193	449	1415	0	109561
4155	1674	111126	456	831	0	114087
4156	882	1116	407	111488	0	113893
4157	669	485	112697	1500	0	115351
4158	527	110809	1540	860	0	113736
4159	750	1634	665	112555	0	115604
4160	472	561	114082	1879	0	116994
4161	691	333	1707	110198	0	112929
4162	368	354	112969	1926	0	115617
4163	423	311	110631	876	0	112241
4164	627	234	1979	111168	0	114008
4165	614	224	804	111409	0	113051
4166	111287	151	593	2627	0	114658
4167	1814	168	479	111100	0	113561
4168	109380	180	397	2540	0	112497
4169	1650	109206	433	1096	0	112385
4170	673	112946	414	865	0	114898
4171	778	1728	391	113210	0	116107
4172	113120	657	398	2254	0	116429
4173	1720	114016	446	981	0	117163
4174	971	1603	461	117024	0	120059
4175	121493	513	397	2729	0	125132
4176	123077	346	418	1473	0	125314
4177	121247	297	479	1291	0	123314
4178	120678	263	392	1290	0	122623
4179	125818	212	329	1168	0	127527
4180	2517	285	122138	528	0	125468
4181	1051	357	119757	566	0	121731
4182	753	121173	1889	435	0	124250
4183	909	1902	766	120444	0	124021
4184	487	582	126890	1571	0	129530
4185	385	569	122052	616	0	123622
4186	837	594	1912	119601	0	122944
4187	310	328	130275	1697	0	132610
4188	310	257	128966	696	0	130229
4189	333	161490	2230	443	0	164496
4190	158937	3115	813	1025	0	163890
4191	3070	172231	562	400	0	176263
4192	1798	3702	411	172066	0	177977
4193	177310	818	344	4063	0	182535
4194	3636	183657	562	895	0	188750
4195	1872	3753	435	177900	0	183960
4196	640	1052	183289	3609	0	188590
4197	180121	593	3744	1659	0	186117
4198	187398	524	923	1333	0	190178
4199	190650	269	683	1262	0	192864
4200	5718	314	476	188021	0	194529
4201	1527	584	190304	4117	0	196532
4202	914	188526	4143	1216	0	194799
4203	1865	4064	997	187470	0	194396
4204	188172	915	640	4897	0	194624
4205	4474	840	188721	1084	0	195119
4206	1317	183133	4185	1097	0	189732
4207	1063	4012	186892	777	0	192744
4208	182065	1164	4400	1353	0	188982
4209	192379	793	1298	1280	0	195750
4210	192218	539	913	1318	0	194988
4211	5659	474	188119	547	0	194799
4212	1945	185107	4435	633	0	192120
4213	2350	4174	1297	182966	0	190787
4214	1892	1002	1081	188517	0	192492
4215	1872	732	943	188994	0	192541
4216	1056	823	185810	5239	0	192928
4217	177357	467	4424	2712	0	184960
4218	4873	647	187299	1233	0	194052
4219	185845	705	4784	1655	0	192989
4220	192834	718	1535	1578	0	196665
4221	193827	581	1036	1538	0	196982
4222	189546	599	871	1571	0	192587
4223	6148	802	189143	708	0	196801
4224	3393	646	4582	186276	0	194897
4225	1869	919	187609	4484	0	194881
4226	1739	181561	4676	1614	0	189590
4227	1611	191897	1532	1401	0	196441
4228	188225	5138	1160	1845	0	196368
4229	182859	1837	1177	1955	0	187828
4230	5547	191225	1524	1160	0	199456
4231	191620	5022	1099	1652	0	199393
4232	6408	2131	161749	1298	0	171586
4233	183287	1334	3617	1641	0	189879
4234	6221	192166	1705	1028	0	201120
4235	195490	5149	1210	1525	0	203374
4236	191056	1753	1181	1441	0	195431
4237	7757	1424	1270	183950	0	194401
4238	3769	1239	1257	187879	0	194144
4239	183973	1237	1559	6335	0	193104
4240	7030	1477	1158	183111	0	192776
4241	183788	1319	1251	6378	0	192736
4242	7818	1044	1259	183578	0	193699
4243	181811	1058	1361	6264	0	190494
4244	181506	1185	1245	2811	0	186747
4245	7266	175982	1697	1761	0	186706
4246	3668	183780	1596	1569	0	190613
4247	177610	5701	1393	2069	0	186773
4248	6628	180484	1457	1438	0	190007
4249	3688	5983	1464	176866	0	188001
4250	3688	2151	1512	180997	0	188348
4251	174140	1869	1454	7110	0	184573
4252	6256	175250	1573	3088	0	186167
4253	3636	171947	1533	2372	0	179488
4254	3313	176839	1766	1957	0	183875
4255	3899	6204	169745	1892	0	181740
4256	3284	2378	169274	1896	0	176832
4257	3384	2058	171853	1716	0	179011
4258	4021	3056	5757	148345	0	161179
4259	2944	165325	2372	4447	0	175088
4260	165448	5295	1558	2568	0	174869
4261	6389	2165	163830	1949	0	174333
4262	3478	1714	162613	1889	0	169694
4263	3094	1541	167820	1717	0	174172
4264	3521	1472	6066	162350	0	173409
4265	3521	1386	2653	166844	0	174404
4266	3659	1610	1881	168928	0	176078
4267	166990	1421	1721	5990	0	176122
4268	166629	1644	1856	2529	0	172658
4269	168606	1383	1938	2150	0	174077
4270	7431	1396	2001	161866	0	172694
4271	3412	1378	158937	5044	0	168771
4272	2977	1839	162508	2094	0	169418
4273	3511	1286	5345	160199	0	170341
4274	3597	1164	2191	160412	0	167364
4275	155639	1213	1832	5924	0	164608
4276	6260	153635	1737	2607	0	164239
4277	153405	4333	1337	2558	0	161633
4278	6426	151830	1525	2265	0	162046
4279	3993	4530	1257	151373	0	161153
4280	3048	1684	150525	5492	0	160749
4281	3527	1560	4515	148734	0	158336
4282	150615	1195	1560	5789	0	159159
4283	6187	1187	148010	2652	0	158036
4284	139029	1025	4225	2446	0	146725
4285	6371	1010	139713	1630	0	148724
4286	3622	1224	135939	1534	0	142319
4287	124416	969	4382	1938	0	131705
4288	5535	882	127852	1613	0	135882
4289	1689	551	94051	686	0	96977
4290	1973	93456	3306	708	0	99443
4291	84133	2144	3689	1138	0	91104
4292	80320	536	886	599	0	82341
4293	79679	293	377	638	0	80987
4294	1642	278	76338	290	0	78548
4295	71105	247	1238	559	0	73149
4296	1385	75142	502	306	0	77335
4297	72114	1055	340	463	0	73972
4298	1320	365	72616	248	0	74549
4299	871	970	1041	68012	0	70894
4300	453	171	68685	810	0	70119
4301	293	68573	981	338	0	70185
4302	590	682	495	66994	0	68761
4303	416	276	285	68409	0	69386
4304	69996	160	191	1142	0	71489
4305	69381	135	235	559	0	70310
4306	69649	105	178	462	0	70394
4307	69731	94	210	401	0	70436
4308	68475	129	173	405	0	69182
4309	1093	148	69120	178	0	70539
4310	651	103	781	67383	0	68918
4311	358	167	71760	741	0	73026
4312	445	118	851	70972	0	72386
4313	71632	102	363	1106	0	73203
4314	72632	106	234	648	0	73620
4315	73066	127	195	507	0	73895
4316	73166	116	209	428	0	73919
4317	1265	155	75642	267	0	77329
4318	742	97	938	74438	0	76215
4319	443	122	75275	987	0	76827
4320	410	75232	1018	575	0	77235
4321	407	74492	462	316	0	75677
4322	843	1140	331	71787	0	74101
4323	551	353	248	80937	0	82089
4324	711	175	323	78880	0	80089
4325	537	128	260	84968	0	85893
4326	83744	115	238	1963	0	86060
4327	1403	83814	246	761	0	86224
4328	81532	1181	152	590	0	83455
4329	1655	396	158	81009	0	83218
4330	942	229	148	79165	0	80484
4331	486	81629	211	1427	0	83753
4332	592	1186	160	82376	0	84314
4333	81836	398	159	1637	0	84030
4334	1363	77685	211	615	0	79874
4335	500	77220	147	400	0	78267
4336	76513	1394	116	484	0	78507
4337	1510	478	150	76571	0	78709
4338	547	76808	164	1295	0	78814
4339	629	1242	149	77705	0	79725
4340	77600	456	134	1647	0	79837
4341	1598	334	93	76930	0	78955
4342	754	214	106	78032	0	79106
4343	77218	182	81	1928	0	79409
4344	1575	180	103	76684	0	78542
4345	626	77467	116	1534	0	79743
4346	644	1211	82	76774	0	78711
4347	390	77606	126	1498	0	79620
4348	515	1329	87	78088	0	80019
4349	77071	510	99	1843	0	79523
4350	77792	326	92	935	0	79145
4351	1877	212	98	78317	0	80504
4352	737	287	76831	1438	0	79293
4353	72438	178	1146	1057	0	74819
4354	1504	265	76553	476	0	78798
4355	75126	167	1280	690	0	77263
4356	76487	162	410	772	0	77831
4357	1827	214	75368	378	0	77787
4358	728	74592	1239	423	0	76982
4359	74455	1299	528	610	0	76892
4360	74024	490	249	777	0	75540
4361	1673	347	77168	347	0	79535
4362	75146	239	1228	740	0	77353
4363	76221	206	425	717	0	77569
4364	77363	184	252	601	0	78400
4365	2067	206	149	76198	0	78620
4366	1062	182	191	76390	0	77825
4367	632	77336	186	1688	0	79842
4368	710	1191	171	79490	0	81562
4369	647	469	152	80014	0	81282
4370	457	388	78086	1820	0	80751
4371	466	269	74019	900	0	75654
4372	69442	280	1526	894	0	72142
4373	74771	258	567	739	0	76335
4374	1843	75044	337	470	0	77694
4375	1046	1327	218	75485	0	78076
4376	601	622	76709	1573	0	79505
4377	770	386	1391	76629	0	79176
4378	849	265	556	76505	0	78175
4379	702	266	274	80368	0	81610
4380	419	80704	240	2259	0	83622
4381	671	1613	188	81916	0	84388
4382	671	640	175	84483	0	85969
4383	464	453	83044	2379	0	86340
4384	459	369	83076	1128	0	85032
4385	77843	304	1976	1180	0	81303
4386	83401	283	751	957	0	85392
4387	2491	290	384	88216	0	91381
4388	1260	325	289	86607	0	88481
4389	891	300	298	88704	0	90193
4390	575	352	84075	3196	0	88198
4391	519	82255	2189	1424	0	86387
4392	529	2234	82713	976	0	86452
4393	79555	766	2368	1091	0	83780
4394	2507	554	83129	764	0	86954
4395	81275	383	2534	989	0	85181
4396	80498	358	857	1047	0	82760
4397	84319	321	582	836	0	86058
4398	3443	321	451	83023	0	87238
4399	1370	328	83290	2647	0	87635
4400	952	84968	2348	1164	0	89432
4401	1126	2338	793	83388	0	87645
4402	1014	774	539	87215	0	89542
4403	653	507	89634	3315	0	94109
4404	579	87895	2789	1511	0	92774
4405	89813	2789	1029	1196	0	94827
4406	3137	93171	726	735	0	97769
4407	98893	3271	533	924	0	103621
4408	4421	1043	525	98439	0	104428
4409	1548	662	101335	3607	0	107152
4410	1205	102097	3575	1327	0	108204
4411	102589	3556	1191	1240	0	108576
4412	4064	1113	102840	787	0	108804
4413	102058	764	3927	910	0	107659
4414	105228	521	1299	900	0	107948
4415	4797	472	103361	718	0	109348
4416	101041	363	3845	876	0	106125
4417	103174	391	1346	751	0	105662
4418	101229	375	1010	767	0	103381
4419	5178	98418	756	548	0	104900
4420	95452	3492	577	695	0	100216
4421	4485	96581	582	514	0	102162
4422	1699	3671	96310	543	0	102223
4423	1240	96636	3445	534	0	101855
4424	93407	3747	1422	622	0	99198
4425	95155	1153	728	694	0	97730
4426	96614	798	586	586	0	98584
4427	5052	557	458	91612	0	97679
4428	2253	468	515	95355	0	98591
4429	89977	454	588	4183	0	95202
4430	95068	421	458	1447	0	97394
4431	4984	368	376	91346	0	97074
4432	1970	348	90831	3383	0	96532
4433	1301	86108	3167	1135	0	91711
4434	978	92087	973	893	0	94931
4435	1313	3612	767	89186	0	94878
4436	887	1272	90399	3155	0	95713
4437	1350	944	3180	84516	0	89990
4438	886	88477	1043	3198	0	93604
4439	1274	3193	791	88146	0	93404
4440	908	1165	88719	3478	0	94270
4441	1188	771	3181	88405	0	93545
4442	813	579	92669	3805	0	97866
4443	1243	552	3532	91693	0	97020
4444	906	603	95654	3821	0	100984
4445	835	575	95917	1380	0	98707
4446	90732	570	4093	1255	0	96650
4447	95689	584	1522	1005	0	98800
4448	96370	596	1066	988	0	99020
4449	4511	93762	919	764	0	99956
4450	2256	3156	814	94981	0	101207
4451	91207	1064	811	3823	0	96905
4452	97213	871	695	1438	0	100217
4453	96720	643	642	1320	0	99325
4454	4778	610	94503	824	0	100715
4455	2088	88380	3333	815	0	94616
4456	1536	96669	1300	810	0	100315
4457	95170	3684	1120	935	0	100909
4458	4261	1394	834	94536	0	101025
4459	95047	996	920	3454	0	100417
4460	4501	829	93759	1124	0	100213
4461	2339	750	3452	90948	0	97489
4462	2088	743	1234	93362	0	97427
4463	1885	773	950	90101	0	93709
4464	1465	92064	863	4016	0	98408
4465	91595	3306	769	1836	0	97506
4466	93179	1136	776	1312	0	96403
4467	4583	90893	808	956	0	97240
4468	2349	3429	752	89352	0	95882
4469	90301	1368	727	3640	0	96036
4470	4436	1199	678	89466	0	95779
4471	89708	903	623	3902	0	95136
4472	4548	89067	711	1456	0	95782
4473	88702	3535	628	1260	0	94125
4474	4501	1389	87125	906	0	93921
4475	2071	88023	3162	1105	0	94361
4476	1827	3323	88077	983	0	94210
4477	2087	2154	3613	85869	0	93723
4478	86218	1044	1362	3587	0	92211
4479	87979	805	1044	1367	0	91195
4480	87542	710	734	1138	0	90124
4481	4911	665	761	83322	0	89659
4482	83995	578	734	3546	0	88853
4483	4446	557	608	82407	0	88018
4484	82420	578	658	3807	0	87463
4485	84372	607	602	1630	0	87211
4486	4472	700	81870	1192	0	88234
4487	1875	535	76151	853	0	79414
4488	1406	598	76268	750	0	79022
4489	1152	698	2810	73542	0	78202
4490	75020	470	1510	2710	0	79710
4491	2918	437	878	76216	0	80449
4492	1538	384	723	78354	0	80999
4493	81335	389	618	3392	0	85734
4494	82287	302	609	1681	0	84879
4495	82967	307	564	1385	0	85223
4496	84333	321	506	1147	0	86307
4497	3682	290	509	82035	0	86516
4498	80514	279	468	2789	0	84050
4499	3079	79758	537	1024	0	84398
4500	78684	1865	512	1155	0	82216
4501	78675	602	638	995	0	80910
4502	2745	550	74288	601	0	78184
4503	68402	350	1587	743	0	71082
4504	2350	274	69208	535	0	72367
4505	916	175	64359	450	0	65900
4506	876	217	64979	384	0	66456
4507	928	1243	1315	55950	0	59436
4508	489	147	57891	785	0	59312
4509	500	372	710	53489	0	55071
4510	334	88	55462	637	0	56521
4511	258	98	57425	298	0	58079
4512	413	101	608	55712	0	56834
4513	358	77	249	60162	0	60846
4514	237	81	62470	565	0	63353
4515	58787	56	524	442	0	59809
4516	709	47	229	62078	0	63063
4517	379	44	137	62787	0	63347
4518	62904	52	131	796	0	63883
4519	642	51	142	63537	0	64372
4520	289	80	63431	535	0	64335
4521	240	67	59252	280	0	59839
4522	213	147	404	58997	0	59761
4523	132	76	60712	382	0	61302
4524	85	62638	425	183	0	63331
4525	271	279	240	61366	0	62156
4526	62537	84	112	579	0	63312
4527	330	97	62838	176	0	63441
4528	59842	45	351	369	0	60607
4529	437	36	162	64354	0	64989
4530	323	32	102	64647	0	65104
4531	225	26	108	65084	0	65443
4532	219	23	89	64730	0	65061
4533	64612	19	91	746	0	65468
4534	374	67802	113	273	0	68562
4535	253	488	89	68723	0	69553
4536	226	154	92	68690	0	69162
4537	243	99	73	68780	0	69195
4538	210	67	82	68792	0	69151
4539	68253	41	63	1007	0	69364
4540	489	68339	115	442	0	69385
4541	66997	381	87	484	0	67949
4542	507	64017	106	268	0	64898
4543	220	64873	105	211	0	65409
4544	62541	545	68	349	0	63503
4545	598	249	63997	166	0	65010
4546	400	134	510	63787	0	64831
4547	65232	95	185	801	0	66313
4548	65676	58	137	535	0	66406
4549	58115	418	203	850	0	59586
4550	66434	54	91	462	0	67041
4551	773	70774	86	270	0	71903
4552	70808	708	81	454	0	72051
4553	72581	250	68	434	0	73333
4554	1050	76687	103	183	0	78023
4555	639	1038	66	78112	0	79855
4556	290	390	78538	1103	0	80321
4557	472	181	1069	77573	0	79295
4558	76581	152	364	1606	0	78703
4559	1115	142	80592	506	0	82355
4560	409	79071	1209	382	0	81071
4561	283	1187	81346	275	0	83091
4562	573	404	1239	75503	0	77719
4563	233	77869	510	978	0	79590
4564	79959	1202	257	689	0	82107
4565	1149	81531	231	336	0	83247
4566	657	1275	162	80697	0	82791
4567	486	495	116	83113	0	84210
4568	81602	262	128	1780	0	83772
4569	1463	217	140	80101	0	81921
4570	475	81763	203	1309	0	83750
4571	81305	1196	146	900	0	83547
4572	82028	438	135	712	0	83313
4573	1504	83452	161	358	0	85475
4574	82966	1342	103	534	0	84945
4575	1406	82343	159	347	0	84255
4576	80855	1373	100	572	0	82900
4577	1398	82004	145	311	0	83858
4578	962	1399	135	77764	0	80260
4579	657	594	127	82690	0	84068
4580	81412	382	128	1859	0	83781
4581	82567	312	130	1024	0	84033
4582	1646	82654	150	585	0	85035
4583	774	1396	81092	365	0	83627
4584	81212	553	1192	546	0	83503
4585	1759	399	372	82945	0	85475
4586	673	83541	254	1326	0	85794
4587	714	1350	180	84344	0	86588
4588	84008	524	140	1807	0	86479
4589	84149	406	99	1082	0	85736
4590	84715	349	109	842	0	86015
4591	2097	335	99	82855	0	85386
4592	925	347	82821	1492	0	85585
4593	75895	322	1216	953	0	78386
4594	78571	296	416	825	0	80108
4595	81824	309	282	735	0	83150
4596	1980	80502	279	444	0	83205
4597	1137	1445	187	80965	0	83734
4598	747	83492	179	1531	0	85949
4599	922	1710	147	83073	0	85852
4600	849	715	149	85549	0	87262
4601	578	539	91253	2160	0	94530
4602	885	405	1849	96495	0	99634
4603	868	332	591	100491	0	102282
4604	98933	336	335	3369	0	102973
4605	2562	100624	332	1210	0	104728
4606	99772	2515	247	1053	0	103587
4607	104401	981	177	883	0	106442
4608	3745	661	174	102737	0	107317
4609	1501	587	104428	2687	0	109203
4610	928	100810	2391	1175	0	105304
4611	744	102197	778	902	0	104621
4612	98465	3106	540	1099	0	103210
4613	2808	100905	391	775	0	104879
4614	1583	2940	271	97755	0	102549
4615	1306	1102	276	101400	0	104084
4616	814	824	98878	3414	0	103930
4617	822	647	97650	1314	0	100433
4618	709	98615	3080	860	0	103264
4619	972	2974	1021	98060	0	103027
4620	98321	1183	582	3080	0	103166
4621	3197	899	465	99397	0	103958
4622	1151	797	100992	3205	0	106145
4623	1151	688	2676	99737	0	104252
4624	96237	596	964	3575	0	101372
4625	97117	610	643	1715	0	100085
4626	3418	97173	509	1084	0	102184
4627	96582	2929	388	1219	0	101118
4628	3269	97302	421	904	0	101896
4629	96747	3063	384	1054	0	101248
4630	3725	1286	417	94967	0	100395
4631	1536	894	94597	3087	0	100114
4632	1273	744	92530	1328	0	95875
4633	1089	95960	3144	961	0	101154
4634	1367	2771	1133	92272	0	97543
4635	1257	1092	580	96637	0	99566
4636	95528	775	446	3649	0	100398
4637	96840	692	375	1719	0	99626
4638	98669	622	343	1355	0	100989
4639	4167	663	443	96178	0	101451
4640	2050	637	469	98425	0	101581
4641	1523	730	400	99716	0	102369
4642	993	719	97472	3766	0	102950
4643	941	657	95743	1743	0	99084
4644	93375	607	3045	1573	0	98600
4645	95119	551	1174	1324	0	98168
4646	3573	664	95623	976	0	100836
4647	92484	547	2721	1369	0	97121
4648	91429	505	1035	1532	0	94501
4649	3533	473	91987	1183	0	97176
4650	1662	92499	2904	1040	0	98105
4651	1604	2704	1272	88903	0	94483
4652	1174	935	92535	2871	0	97515
4653	1104	95968	2632	1456	0	101160
4654	1458	2812	1036	86336	0	91642
4655	956	91633	739	2438	0	95766
4656	1028	2585	89924	1138	0	94675
4657	1012	988	91500	827	0	94327
4658	1184	909	3049	90209	0	95351
4659	91088	675	1248	2961	0	95972
4660	3029	652	827	91287	0	95795
4661	90842	784	611	3050	0	95287
4662	3248	656	618	90884	0	95406
4663	1314	790	89957	3060	0	95121
4664	86032	647	2838	1763	0	91280
4665	2811	613	89791	1117	0	94332
4666	89003	594	3008	1218	0	93823
4667	3261	615	1287	87089	0	92252
4668	1428	89440	930	2984	0	94782
4669	1438	2567	804	88050	0	92859
4670	1088	91962	854	3058	0	96962
4671	1451	2618	857	85397	0	90323
4672	1160	92506	861	2823	0	97350
4673	90829	2714	836	1790	0	96169
4674	92608	1080	659	1453	0	95800
4675	92309	788	739	1379	0	95215
4676	3761	822	90771	1061	0	96415
4677	2140	652	2710	90462	0	95964
4678	1390	818	92439	2980	0	97627
4679	1269	88044	3006	1530	0	93849
4680	1152	92880	1332	1174	0	96538
4681	89116	3197	1030	1148	0	94491
4682	3224	1397	90460	895	0	95976
4683	1643	89674	2796	955	0	95068
4684	1677	2756	1388	90149	0	95970
4685	89110	1226	1001	3381	0	94718
4686	2942	91594	985	1433	0	96954
4687	92227	2953	775	1275	0	97230
4688	3368	1493	92586	974	0	98421
4689	1974	838	2881	93210	0	98903
4690	1479	664	1496	96280	0	99919
4691	1316	717	1096	98005	0	101134
4692	1090	96760	983	4014	0	102847
4693	1845	3056	889	90632	0	96422
4694	1318	1337	97669	3519	0	103843
4695	1560	785	3052	93936	0	99333
4696	1332	684	1558	96859	0	100433
4697	1339	556	981	94669	0	97545
4698	1065	92896	868	3816	0	98645
4699	1290	2643	777	91725	0	96435
4700	1422	1288	690	91223	0	94623
4701	663	83269	674	3364	0	87970
4702	74946	1849	528	1430	0	78753
4703	1843	75709	405	1032	0	78989
4704	714	76545	418	887	0	78564
4705	834	2496	435	74712	0	78477
4706	472	958	74718	2075	0	78223
4707	67398	539	1734	1309	0	70980
4708	1793	439	629	73045	0	75906
4709	634	460	71417	2058	0	74569
4710	457	71458	1723	1020	0	74658
4711	559	1861	680	71594	0	74694
4712	368	801	72350	2011	0	75530
4713	587	568	1810	69114	0	72079
4714	651	423	703	70480	0	72257
4715	68303	342	485	2515	0	71645
4716	1680	68584	428	1117	0	71809
4717	67192	1727	395	921	0	70235
4718	1871	773	68634	670	0	71948
4719	762	68450	1739	615	0	71566
4720	598	1726	68824	539	0	71687
4721	594	944	1827	69648	0	73013
4722	69359	478	841	2083	0	72761
4723	1917	454	477	69323	0	72171
4724	69646	386	391	2178	0	72601
4725	71331	349	397	1130	0	73207
4726	2357	365	369	72092	0	75183
4727	990	404	74500	2092	0	77986
4728	735	399	75961	967	0	78062
4729	763	410	2147	76999	0	80319
4730	746	330	919	79377	0	81372
4731	78250	342	606	2652	0	81850
4732	2150	387	437	77651	0	80625
4733	945	76290	491	2224	0	79950
4734	828	1799	417	77800	0	80844
4735	695	760	445	78990	0	80890
4736	76177	503	387	2919	0	79986
4737	1945	77085	385	1391	0	80806
4738	1105	1853	314	77756	0	81028
4739	847	783	360	77597	0	79587
4740	550	76611	427	2642	0	80230
4741	616	1963	396	77748	0	80723
4742	603	844	314	77241	0	79002
4743	442	75726	384	2863	0	79415
4744	661	1922	295	76553	0	79431
4745	530	897	310	75903	0	77640
4746	341	75057	331	2883	0	78612
4747	452	1971	275	76440	0	79138
4748	74679	907	237	2947	0	78770
4749	75362	698	227	1757	0	78044
4750	73470	655	232	1488	0	75845
4751	73479	533	212	1302	0	75526
4752	2358	70461	257	1103	0	74179
4753	64391	1665	184	959	0	67199
4754	1713	63175	196	868	0	65952
4755	723	63949	197	725	0	65594
4756	800	1871	359	62969	0	65999
4757	461	698	63192	1793	0	66144
4758	59253	520	1375	1075	0	62223
4759	62669	417	439	915	0	64440
4760	1803	385	63516	672	0	66376
4761	62269	328	1349	833	0	64779
4762	65961	342	417	768	0	67488
4763	1910	64371	319	660	0	67260
4764	71793	1484	299	1046	0	74622
4765	2072	603	217	71588	0	74480
4766	1030	455	222	72803	0	74510
4767	817	444	229	73312	0	74802
4768	721	389	223	73460	0	74793
4769	72608	369	247	2419	0	75643
4770	1859	389	236	71572	0	74056
4771	987	368	223	72777	0	74355
4772	729	363	70568	2175	0	73835
4773	62296	380	1412	1579	0	65667
4774	70259	310	492	1145	0	72206
4775	70626	320	346	1082	0	72374
4776	2093	68995	330	787	0	72205
4777	1006	71229	251	796	0	73282
4778	69918	1658	240	1031	0	72847
4779	1935	713	263	70263	0	73174
4780	895	71971	235	1944	0	75045
4781	884	1558	171	70975	0	73588
4782	691	72588	192	1963	0	75434
4783	72007	1750	145	1278	0	75180
4784	1805	73723	197	922	0	76647
4785	990	1724	191	73047	0	75952
4786	884	729	170	75108	0	76891
4787	726	554	76099	2220	0	79599
4788	637	79567	1553	1105	0	82862
4789	820	2246	481	81287	0	84834
4790	672	885	81994	2298	0	85849
4791	539	616	81313	1085	0	83553
4792	728	455	2246	81272	0	84701
4793	702	372	954	81330	0	83358
4794	506	78549	518	2683	0	82256
4795	470	82897	339	1332	0	85038
4796	600	2494	241	82586	0	85921
4797	82033	1107	247	2600	0	85987
4798	2381	678	203	85625	0	88887
4799	85775	499	169	3097	0	89540
4800	89022	460	187	1694	0	91363
4801	89752	509	171	1227	0	91659
4802	3203	485	88867	835	0	93390
4803	87422	379	2038	890	0	90729
4804	2972	327	910	88279	0	92488
4805	1675	318	495	89217	0	91705
4806	944	419	87348	2968	0	91679
4807	744	426	86945	1507	0	89622
4808	920	629	2451	83498	0	87498
4809	599	82332	1150	2247	0	86328
4810	592	86898	584	1235	0	89309
4811	813	2378	418	86350	0	89959
4812	85420	1073	296	2582	0	89371
4813	2396	638	296	86053	0	89383
4814	1418	450	311	85587	0	87766
4815	819	85595	321	2925	0	89660
4816	833	2011	277	87119	0	90240
4817	568	1029	88218	2628	0	92443
4818	598	575	83845	1539	0	86557
4819	81460	425	2467	1310	0	85662
4820	1984	86693	1193	864	0	90734
4821	85584	1898	611	929	0	89022
4822	86326	997	417	825	0	88565
4823	2809	625	356	81522	0	85312
4824	1235	84655	388	1889	0	88167
4825	987	1925	281	84716	0	87909
4826	83323	903	214	2416	0	86856
4827	1936	81130	282	1271	0	84619
4828	78962	1786	159	1028	0	81935
4829	1981	79424	224	673	0	82302
4830	79888	1936	259	761	0	82844
4831	80267	1041	234	683	0	82225
4832	2503	78945	291	548	0	82287
4833	1444	1848	270	78973	0	82535
4834	79236	913	266	2064	0	82479
4835	2132	520	76532	1024	0	80208
4836	1086	538	76470	651	0	78745
4837	972	800	2097	75540	0	79409
4838	77433	372	926	2007	0	80738
4839	1882	366	497	77763	0	80508
4840	77766	306	314	2336	0	80722
4841	2081	414	78581	1099	0	82175
4842	78669	353	1601	991	0	81614
4843	84203	327	738	837	0	86105
4844	2737	340	456	82441	0	85974
4845	1581	293	344	83746	0	85964
4846	1067	318	247	84115	0	85747
4847	730	83824	317	2564	0	87435
4848	824	1545	385	83590	0	86344
4849	721	760	379	85972	0	87832
4850	83941	425	363	2783	0	87512
4851	83916	336	344	1764	0	86360
4852	2377	377	82401	983	0	86138
4853	80051	323	1606	1105	0	83085
4854	2192	412	82664	710	0	85978
4855	76431	264	1805	1092	0	79592
4856	2150	327	81494	672	0	84643
4857	1329	343	79921	604	0	82197
4858	1044	412	2139	78439	0	82034
4859	658	283	79904	1945	0	82790
4860	76146	285	1817	1408	0	79656
4861	1803	317	985	81461	0	84566
4862	82291	259	533	2154	0	85237
4863	82786	306	486	1442	0	85020
4864	77399	280	405	904	0	78988
4865	76325	209	331	868	0	77733
4866	2748	250	75398	549	0	78945
4867	1777	161	1555	74742	0	78235
4868	1090	216	76608	1707	0	79621
4869	1051	221	1745	75302	0	78319
4870	75272	207	987	2051	0	78517
4871	1988	217	636	76673	0	79514
4872	77193	232	539	2141	0	80105
4873	2084	223	478	77772	0	80557
4874	1322	248	352	79012	0	80934
4875	77912	279	365	2555	0	81111
4876	1943	77157	329	1420	0	80849
4877	77006	1382	260	1025	0	79673
4878	1955	77025	311	706	0	79997
4879	1299	1494	256	77376	0	80425
4880	76312	761	302	1882	0	79257
4881	1770	448	76962	1149	0	80329
4882	1276	305	1317	77355	0	80253
4883	77765	300	746	1936	0	80747
4884	80479	197	460	1182	0	82318
4885	2641	279	328	79089	0	82337
4886	1435	79332	317	1809	0	82893
4887	885	78376	253	989	0	80503
4888	774	2717	205	71796	0	75492
4889	72120	635	173	1457	0	74385
4890	1280	70382	116	649	0	72427
4891	516	69274	91	329	0	70210
4892	67516	1157	118	446	0	69237
4893	955	68107	71	208	0	69341
4894	69070	1011	131	371	0	70583
4895	1387	438	119	68612	0	70556
4896	722	248	46	68465	0	69481
4897	326	67789	63	1244	0	69422
4898	250	67793	67	563	0	68673
4899	63642	1115	53	470	0	65280
4900	905	66437	51	184	0	67577
4901	341	73818	79	156	0	74394
4902	499	1534	57	73457	0	75547
4903	75155	679	23	1621	0	77478
4904	1476	454	79067	585	0	81582
4905	77938	231	1576	531	0	80276
4906	2172	170	741	83759	0	86842
4907	943	231	85517	1838	0	88529
4908	520	189	87368	966	0	89043
4909	613	125	2628	87849	0	91215
4910	260	175	92490	2038	0	94963
4911	88331	190	2310	1414	0	92245
4912	92482	191	1153	833	0	94659
4913	2923	189	93241	355	0	96708
4914	1665	209	2212	91012	0	95098
4915	987	239	1173	91495	0	93894
4916	94420	122	631	3271	0	98444
4917	2567	223	433	88901	0	92124
4918	1271	90863	479	2264	0	94877
4919	91589	1927	310	1485	0	95311
4920	2246	90762	354	833	0	94195
4921	1196	95675	424	601	0	97896
4922	955	2832	376	93929	0	98092
4923	795	1315	249	95525	0	97884
4924	850	690	285	96740	0	98565
4925	625	548	93597	3299	0	98069
4926	85131	437	2048	2057	0	89673
4927	2165	92720	1095	1070	0	97050
4928	94233	2201	499	1140	0	98073
4929	95241	1112	310	992	0	97655
4930	3557	666	253	94191	0	98667
4931	1645	95116	309	2465	0	99535
4932	1293	2407	239	97828	0	101767
4933	1136	1243	203	99612	0	102194
4934	99361	850	217	3597	0	104025
4935	97784	715	198	2171	0	100868
4936	3288	653	93963	1250	0	99154
4937	96614	471	1786	1351	0	100222
4938	2900	100660	861	892	0	105313
4939	100721	2490	555	957	0	104723
4940	3120	105471	313	670	0	109574
4941	2072	2983	237	102690	0	107982
4942	1573	1434	275	102509	0	105791
4943	1034	102739	291	3497	0	107561
4944	1074	2724	248	106096	0	110142
4945	1003	1586	221	106606	0	109416
4946	989	946	234	104782	0	106951
4947	757	103194	291	4214	0	108456
4948	1077	2851	263	105119	0	109310
4949	1060	1551	281	106323	0	109215
4950	866	1025	384	107608	0	109883
4951	761	819	102887	4539	0	109006
4952	95948	831	2493	2919	0	102191
4953	3082	736	103157	1620	0	108595
4954	100146	734	2925	1611	0	105416
4955	3348	663	103633	1388	0	109032
4956	100948	614	3040	1505	0	106107
4957	104431	683	1576	1377	0	108067
4958	4155	621	103365	1210	0	109351
4959	2477	600	2885	101551	0	107513
4960	1511	736	96792	3234	0	102273
4961	95022	686	2708	2213	0	100629
4962	3416	640	104124	1548	0	109728
4963	2047	546	101927	1390	0	105910
4964	99055	503	3896	1692	0	105146
4965	3326	102808	2272	1073	0	109479
4966	2336	2635	1343	103855	0	110169
4967	105608	1439	1166	3434	0	111647
4968	3785	880	1109	105494	0	111268
4969	2432	652	1140	107990	0	112214
4970	105785	612	942	4493	0	111832
4971	105394	546	970	2776	0	109686
4972	4556	496	104234	1797	0	111083
4973	2608	488	104585	1726	0	109407
4974	1949	445	4035	104299	0	110728
4975	1634	482	107361	3657	0	113134
4976	1573	525	3656	105429	0	111183
4977	1739	506	2210	104697	0	109152
4978	1694	580	1317	109672	0	113263
4979	105259	682	941	5146	0	112028
4980	3323	106069	1026	2969	0	113387
4981	105613	2736	699	2412	0	111460
4982	105385	1489	688	2305	0	109867
4983	4125	104540	683	1982	0	111330
4984	101334	2563	482	1879	0	106258
4985	3566	1540	100100	1338	0	106544
4986	2328	1123	2287	99371	0	105109
4987	101105	903	1267	3261	0	106536
4988	3162	887	97024	1978	0	103051
4989	97760	657	2168	1855	0	102440
4990	3034	105390	1231	1467	0	111122
4991	118512	2338	800	1723	0	123373
4992	119977	1168	702	1555	0	123402
4993	4986	121228	728	1149	0	128091
4994	125725	3267	644	1354	0	130990
4995	5193	1619	649	125817	0	133278
4996	3231	1240	479	129203	0	134153
4997	126456	843	528	4928	0	132755
4998	122202	724	487	2961	0	126374
4999	4955	124610	593	1877	0	132035
5000	2794	125249	530	1485	0	130058
5001	1929	3801	374	112990	0	119094
5002	1218	115544	482	2733	0	119977
5003	1157	120062	440	1459	0	123118
5004	111176	3058	515	1267	0	116016
5005	2553	113479	334	731	0	117097
5006	108260	2594	239	817	0	111910
5007	2699	111827	240	474	0	115240
5008	1341	2587	109511	453	0	113892
5009	963	111861	1821	559	0	115204
5010	108237	2744	985	911	0	112877
5011	107561	948	570	725	0	109804
5012	2663	834	107597	324	0	111418
5013	1822	503	1960	101878	0	106163
5014	1247	382	773	109061	0	111463
5015	661	440	108389	2477	0	111967
5016	964	327	2018	104205	0	107514
5017	545	347	107800	2536	0	111228
5018	516	353	103936	1189	0	105994
5019	100481	252	2436	1272	0	104441
5020	2063	106322	1237	617	0	110239
5021	104944	1903	842	676	0	108365
5022	2765	843	505	104702	0	108815
5023	1204	751	105725	1986	0	109666
5024	1415	483	1866	99854	0	103618
5025	740	105267	877	2050	0	108934
5026	106022	1845	700	1268	0	109835
5027	106825	848	417	1085	0	109175
5028	2899	715	372	106273	0	110259
5029	1524	471	104405	2109	0	108509
5030	97115	409	1784	1338	0	100646
5031	2300	103103	786	761	0	106950
5032	102725	1894	623	753	0	105995
5033	2909	940	336	101645	0	105830
5034	101808	791	292	2111	0	105002
5035	3070	587	184	100632	0	104473
5036	1455	703	100142	2399	0	104699
5037	1382	423	95173	1265	0	98243
5038	91962	392	2085	1745	0	96184
5039	2141	99524	1112	825	0	103602
5040	96847	1762	920	736	0	100265
5041	97253	921	351	778	0	99303
5042	2209	98756	293	335	0	101593
5043	95881	2065	204	706	0	98856
5044	2391	1113	100123	429	0	104056
5045	1442	1099	1514	99505	0	103560
5046	1323	872	666	101123	0	103984
5047	1123	642	540	103271	0	105576
5048	775	742	101351	2493	0	105361
5049	892	596	101117	1286	0	103891
5050	875	639	2185	99293	0	102992
5051	631	98780	1355	1752	0	102518
5052	632	104584	846	843	0	106905
5053	103065	2277	501	1081	0	106924
5054	103246	1183	526	1006	0	105961
5055	2303	106467	645	762	0	110177
5056	1477	2033	406	107543	0	111459
5057	1135	992	443	109407	0	111977
5058	109520	824	636	2904	0	113884
5059	2395	514	536	112270	0	115715
5060	1619	508	673	112061	0	114861
5061	1334	539	562	113381	0	115816
5062	1008	675	106493	2892	0	111068
5063	966	684	99558	1683	0	102891
5064	105633	404	2430	1680	0	110147
5065	2504	363	1288	114601	0	118756
5066	1172	456	114801	2658	0	119087
5067	1078	540	110928	1344	0	113890
5068	109749	640	2949	1626	0	114964
5069	3056	505	124979	813	0	129353
5070	1401	126681	3143	821	0	132046
5071	1419	2634	1338	134152	0	139543
5072	970	1148	134164	2960	0	139242
5073	130412	990	3099	1575	0	136076
5074	3799	752	1245	139567	0	145363
5075	1750	523	138856	3479	0	144608
5076	1634	412	3395	137974	0	143415
5077	1357	415	1496	141096	0	144364
5078	140714	356	1174	4664	0	146908
5079	3524	142781	1092	2030	0	149427
5080	2032	3012	860	142215	0	148119
5081	143515	1164	730	3944	0	149353
5082	144811	951	653	2050	0	148465
5083	145632	538	592	1730	0	148492
5084	147813	564	636	1359	0	150372
5085	5362	547	635	143988	0	150532
5086	141368	402	698	3919	0	146387
5087	142783	350	743	2176	0	146052
5088	134398	362	568	2178	0	137506
5089	137226	391	649	1730	0	139996
5090	4757	128627	635	1251	0	135270
5091	1198	117095	265	468	0	119026
5092	1156	2446	253	114306	0	118161
5093	713	113946	257	1913	0	116829
5094	113440	2047	333	1045	0	116865
5095	2667	760	186	111899	0	115512
5096	111546	324	186	2376	0	114432
5097	112985	261	177	1142	0	114565
5098	2861	274	181	115079	0	118395
5099	1379	237	252	113969	0	115837
5100	766	114392	240	2489	0	117887
5101	114435	1812	195	1330	0	117772
5102	2309	114454	253	678	0	117694
5103	115272	1967	200	827	0	118266
5104	2650	705	208	116152	0	119715
5105	1164	522	114773	2141	0	118600
5106	111675	361	1816	1303	0	115155
5107	109765	323	618	1070	0	111776
5108	2834	393	108767	608	0	112602
5109	1341	400	108683	534	0	110958
5110	1281	368	2221	105296	0	109166
5111	114550	327	757	2602	0	118236
5112	118777	322	409	1436	0	120944
5113	120496	341	338	1237	0	122412
5114	122164	363	344	1064	0	123935
5115	3472	120845	359	639	0	125315
5116	124917	2336	327	1041	0	128621
5117	3502	769	392	123167	0	127830
5118	1867	460	363	124393	0	127083
5119	1567	366	365	129329	0	131627
5120	1415	336	381	132087	0	134219
5121	129429	407	351	3951	0	134138
5122	3614	329	359	135656	0	139958
5123	1602	410	133774	3463	0	139249
5124	1623	319	2789	134764	0	139495
5125	1511	272	979	137502	0	140264
5126	1461	280	582	137451	0	139774
5127	1406	291	502	137091	0	139290
5128	132901	295	410	4646	0	138252
5129	3518	131514	464	1947	0	137443
5130	1642	134814	453	1417	0	138326
5131	1569	3421	442	132530	0	137962
5132	130668	1197	459	3995	0	136319
5133	135862	679	425	2130	0	139096
5134	4564	498	382	135501	0	140945
5135	2079	491	131156	3884	0	137610
5136	131393	454	2832	2287	0	136966
5137	4291	443	1015	138127	0	143876
5138	1989	534	137499	4026	0	144048
5139	129459	447	3141	2555	0	135602
5140	4241	137379	1046	1658	0	144324
5141	151087	3218	592	1740	0	156637
5142	5354	154904	506	1208	0	161972
5143	3337	4545	308	152582	0	160772
5144	1958	154008	434	4922	0	161322
5145	2066	5391	336	157566	0	165359
5146	151400	2311	315	6264	0	160290
5147	5123	153971	416	3186	0	162696
5148	2873	4638	152210	1904	0	161625
5149	2397	2384	4172	152866	0	161819
5150	1668	1441	154586	5143	0	162838
5151	1950	929	4860	150310	0	158049
5152	1826	772	2262	157043	0	161903
5153	1390	856	151949	6707	0	160902
5154	136361	733	4570	4652	0	146316
5155	5330	796	149841	2386	0	158353
5156	2908	849	148063	1732	0	153552
5157	1921	149225	5894	1693	0	158733
5158	1831	4625	2773	148007	0	157236
5159	1589	2321	1624	151633	0	157167
5160	1991	1499	1062	146054	0	150606
5161	1638	1052	875	153994	0	157559
5162	1080	803	145675	7778	0	155336
5163	133558	624	4490	5068	0	143740
5164	4848	621	145842	2739	0	154050
5165	2931	482	4812	139519	0	147744
5166	137419	460	2545	5542	0	145966
5167	4527	138439	1778	3306	0	148050
5168	2923	4597	1216	133615	0	142351
5169	127571	1905	944	5017	0	135437
5170	4263	122477	955	2854	0	130549
5171	2156	124301	629	1822	0	128908
5172	121049	4729	579	1804	0	128161
5173	3864	122737	590	1276	0	128467
5174	118366	4193	606	1599	0	124764
5175	4252	120123	548	1220	0	126143
5176	120373	4188	647	1310	0	126518
5177	122132	2150	444	1312	0	126038
5178	5315	122215	626	982	0	129138
5179	3133	3914	483	119220	0	126750
5180	2035	2116	117383	4001	0	125535
5181	114699	1567	3382	2493	0	122141
5182	4317	1081	1754	115882	0	123034
5183	2582	111700	1104	4096	0	119482
5184	1580	118151	783	2317	0	122831
5185	1411	4736	573	117654	0	124374
5186	116238	2477	597	4473	0	123785
5187	3962	1704	115492	2501	0	123659
5188	2677	1040	3449	116908	0	124074
5189	1831	1023	1838	119773	0	124465
5190	1570	859	1168	121937	0	125534
5191	1408	780	857	119055	0	122100
5192	1032	115648	694	6247	0	123621
5193	1116	3712	681	119487	0	124996
5194	905	2111	115513	5296	0	123825
5195	1083	1505	113845	3095	0	119528
5196	876	1211	116902	2310	0	121299
5197	1081	1112	5383	113940	0	121516
5198	110901	1122	2858	4554	0	119435
5199	3922	878	112167	2901	0	119868
5200	2573	837	113567	1989	0	118966
5201	1892	886	5341	109868	0	117987
5202	111030	831	2936	4960	0	119757
5203	3898	111270	1907	3098	0	120173
5204	111476	3913	1287	2581	0	119257
5205	4920	2241	1147	111094	0	119402
5206	2761	1848	112541	4422	0	121572
5207	2230	1814	4010	106540	0	114594
5208	1417	112953	2586	4619	0	121575
5209	118891	4064	1933	3007	0	127895
5210	4334	2319	119461	2228	0	128342
5211	2242	115504	3832	1887	0	123465
5212	113849	4068	2539	1869	0	122325
5213	4779	2246	1902	113211	0	122138
5214	2854	1493	1441	116335	0	122123
5215	115333	962	1151	5979	0	123425
5216	116194	922	1163	3741	0	122020
5217	120525	1073	1039	2490	0	125127
5218	7042	995	895	113318	0	122250
5219	3524	111513	837	4756	0	120630
5220	112276	3718	908	3318	0	120220
5221	4556	112935	856	2342	0	120689
5222	107246	4275	752	1658	0	113931
5223	4891	105786	875	1215	0	112767
5224	3286	4220	775	103265	0	111546
5225	105424	2607	683	4176	0	112890
5226	107331	1725	502	2849	0	112407
5227	108981	1219	483	2295	0	112978
5228	110085	977	506	1871	0	113439
5229	110197	973	515	1533	0	113218
5230	6900	1081	104113	1149	0	113243
5231	4586	975	3229	103778	0	112568
5232	2740	1049	105340	3812	0	112941
5233	2221	1036	104707	2414	0	110378
5234	103038	1056	4878	1729	0	110701
5235	105998	993	2582	1406	0	110979
5236	107358	927	1475	1070	0	110830
5237	6757	1087	892	101121	0	109857
5238	101993	872	836	3969	0	107670
5239	5271	99638	815	2558	0	108282
5240	3725	100339	744	1726	0	106534
5241	1906	92462	471	914	0	95753
5242	85665	2809	661	880	0	90015
5243	2909	87300	472	694	0	91375
5244	86715	2271	583	803	0	90372
5245	86396	1047	359	796	0	88598
5246	3478	653	84710	559	0	89400
5247	2195	620	2159	82339	0	87313
5248	1724	567	891	87389	0	90571
5249	87468	542	606	3028	0	91644
5250	88608	512	427	1492	0	91039
5251	3895	542	354	86793	0	91584
5252	1999	578	85730	2597	0	90904
5253	1638	556	86838	1237	0	90269
5254	1576	525	2718	87359	0	92178
5255	1598	542	1083	88143	0	91366
5256	1486	523	578	91067	0	93654
5257	86917	549	447	3472	0	91385
5258	88082	543	437	1697	0	90759
5259	3656	87044	552	1051	0	92303
5260	2256	2390	547	86290	0	91483
5261	1827	1037	549	86686	0	90099
5262	1426	87975	503	3154	0	93058
5263	1621	2406	471	88341	0	92839
5264	88872	1072	482	3231	0	93657
5265	3520	686	536	87799	0	92541
5266	2264	536	549	89420	0	92769
5267	87442	566	440	3669	0	92117
5268	87612	563	456	2075	0	90706
5269	88518	510	507	1639	0	91174
5270	4346	856	609	85399	0	91210
5271	2146	533	81661	2791	0	87131
5272	1737	551	80622	1546	0	84456
5273	1596	541	81151	1190	0	84478
5274	1492	79563	2563	1100	0	84718
5275	78234	2153	1438	1237	0	83062
5276	3031	1056	77296	893	0	82276
5277	75324	618	1960	1092	0	78994
5278	3018	537	1033	75726	0	80314
5279	70163	621	793	2823	0	74400
5280	77718	494	680	1737	0	80629
5281	3180	78686	584	1158	0	83608
5282	80718	1916	437	1253	0	84324
5283	80915	928	508	1258	0	83609
5284	3424	80924	615	1111	0	86074
5285	2367	1880	590	83078	0	87915
5286	1729	1042	83753	2366	0	88890
5287	1651	675	2018	82279	0	86623
5288	1530	697	988	84688	0	87903
5289	84300	727	671	3070	0	88768
5290	3140	652	570	82841	0	87203
5291	1975	84710	562	2483	0	89730
5292	1768	2184	521	84394	0	88867
5293	1494	1101	542	86563	0	89700
5294	1439	740	84103	3368	0	89650
5295	1518	81548	2051	1943	0	87060
5296	1593	85550	969	1422	0	89534
5297	82956	2515	693	1436	0	87600
5298	2828	86235	586	1232	0	90881
5299	1982	2391	633	85299	0	90305
5300	1416	1257	85404	2710	0	90787
5301	1240	85852	2267	1787	0	91146
5302	85665	2219	1272	1465	0	90621
5303	2812	1244	922	85360	0	90338
5304	1950	807	633	87398	0	90788
5305	1417	718	85577	3236	0	90948
5306	1536	663	2074	82594	0	86867
5307	1481	645	1005	85968	0	89099
5308	83020	713	724	3390	0	87847
5309	75659	556	452	1890	0	78557
5310	2846	74478	417	1326	0	79067
5311	70353	1584	369	1226	0	73532
5312	2039	69223	393	1048	0	72703
5313	1232	2051	425	65090	0	68798
5314	855	65725	416	1872	0	68868
5315	806	68255	376	1192	0	70629
5316	65329	1775	656	1152	0	68912
5317	64200	649	353	935	0	66137
5318	1791	63631	282	649	0	66353
5319	64150	1328	332	793	0	66603
5320	64096	590	302	867	0	65855
5321	66072	455	330	864	0	67721
5322	1903	477	302	66321	0	69003
5323	66602	492	240	1723	0	69057
5324	1726	517	63704	763	0	66710
5325	62198	412	1120	828	0	64558
5326	1755	467	66404	590	0	69216
5327	1097	436	1228	67326	0	70087
5328	917	426	475	69407	0	71225
5329	852	449	68309	1631	0	71241
5330	63734	374	1162	1237	0	66507
5331	67508	374	507	931	0	69320
5332	1814	353	71514	631	0	74312
5333	1088	272	1272	69821	0	72453
5334	862	317	588	70610	0	72377
5335	774	280	382	73259	0	74695
5336	71686	247	357	2021	0	74311
5337	71891	271	340	1076	0	73578
5338	1902	299	311	68250	0	70762
5339	778	64523	256	1124	0	66681
5340	478	63537	230	573	0	64818
5341	60359	939	196	625	0	62119
5342	985	60633	175	370	0	62163
5343	448	60313	167	324	0	61252
5344	452	695	141	57130	0	58418
5345	281	256	57290	556	0	58383
5346	193	56391	454	291	0	57329
5347	331	649	194	56126	0	57300
5348	208	56807	134	482	0	57631
5349	275	491	89	56232	0	57087
5350	56135	163	64	761	0	57123
5351	464	56725	102	265	0	57556
5352	56613	434	68	485	0	57600
5353	54791	152	80	438	0	55461
5354	532	182	53920	171	0	54805
5355	52039	115	329	388	0	52871
5356	515	136	108	54952	0	55711
5357	187	147	56625	391	0	57350
5358	139	56410	334	208	0	57091
5359	316	438	142	56053	0	56949
5360	184	142	79	56978	0	57383
5361	56745	90	59	634	0	57528
5362	471	92	58	56870	0	57491
5363	269	94	56	57135	0	57554
5364	57163	78	41	699	0	57981
5365	371	57004	74	273	0	57722
5366	55402	344	70	423	0	56239
5367	437	176	56128	130	0	56871
5368	49827	100	312	559	0	50798
5369	457	127	57647	112	0	58343
5370	236	58385	345	106	0	59072
5371	58402	401	103	367	0	59273
5372	55829	158	97	420	0	56504
5373	465	154	57785	128	0	58532
5374	258	154	57470	133	0	58015
5375	226	124	58560	148	0	59058
5376	157	62613	577	158	0	63505
5377	242	519	189	63607	0	64557
5378	191	212	70034	521	0	70958
5379	204	168	67481	194	0	68047
5380	364	106	974	68777	0	70221
5381	180	112	70360	770	0	71422
5382	66730	113	922	713	0	68478
5383	77752	96	415	479	0	78742
5384	1541	132	77077	147	0	78897
5385	703	76469	1219	170	0	78561
5386	622	1136	645	75611	0	78014
5387	286	569	77947	1177	0	79979
5388	210	76471	1298	637	0	78616
5389	501	1275	650	76048	0	78474
5390	76962	548	379	1485	0	79374
5391	76315	299	300	955	0	77869
5392	1555	78788	285	442	0	81070
5393	1022	1225	203	78941	0	81391
5394	634	599	214	79670	0	81117
5395	600	352	180	78687	0	79819
5396	528	226	190	80220	0	81164
5397	244	256	78664	1978	0	81142
5398	449	188	1109	77156	0	78902
5399	201	214	77100	1543	0	79058
5400	158	75774	1285	834	0	78051
5401	74701	1128	611	844	0	77284
5402	1056	78550	373	422	0	80401
5403	849	1283	190	79054	0	81376
5404	596	614	192	79573	0	80975
5405	78245	386	158	1984	0	80773
5406	1288	216	138	79077	0	80719
5407	599	77310	171	1530	0	79610
5408	542	1085	125	79867	0	81619
5409	423	622	131	80170	0	81346
5410	78340	352	166	2098	0	80956
5411	1164	284	76787	1035	0	79270
5412	620	75778	936	633	0	77967
5413	376	79320	455	457	0	80608
5414	396	1352	229	78659	0	80636
5415	76912	746	119	1536	0	79313
5416	1009	77619	138	801	0	79567
5417	722	1110	92	78633	0	80557
5418	374	670	77661	1246	0	79951
5419	436	380	984	77196	0	78996
5420	77605	290	526	1657	0	80078
5421	76613	242	341	1096	0	78292
5422	1628	204	164	76671	0	78667
5423	77598	203	146	1500	0	79447
5424	76131	186	154	1128	0	77599
5425	1649	249	76103	514	0	78515
5426	71814	204	1024	667	0	73709
5427	1376	75469	604	412	0	77861
5428	76047	1088	325	541	0	78001
5429	1526	661	74906	293	0	77386
5430	1011	364	1136	75688	0	78199
5431	77630	219	656	1502	0	80007
5432	1483	211	73242	780	0	75716
5433	962	167	73669	457	0	75255
5434	807	189	1778	72832	0	75606
5435	443	179	76062	1391	0	78075
5436	73207	135	1665	954	0	75961
5437	1549	190	77356	504	0	79599
5438	1124	143	1726	78778	0	81771
5439	757	149	899	81790	0	83595
5440	84456	157	632	2479	0	87724
5441	2030	182	85453	1227	0	88892
5442	1019	165	89147	661	0	90992
5443	930	98	2768	92300	0	96096
5444	452	141	94850	2411	0	97854
5445	90968	123	2937	1379	0	95407
5446	2639	113	1422	93596	0	97770
5447	1165	141	94570	2596	0	98472
5448	1017	122	2789	92732	0	96660
5449	937	122	1336	95542	0	97937
5450	94568	158	813	3629	0	99168
5451	2660	165	94728	1617	0	99170
5452	89849	214	2706	1310	0	94079
5453	2934	286	97045	855	0	101120
5454	93835	163	3061	1034	0	98093
5455	96685	253	1444	932	0	99314
5456	97048	212	882	1113	0	99255
5457	3682	92808	719	772	0	97981
5458	94613	2247	591	883	0	98334
5459	95122	934	518	864	0	97438
5460	3826	506	572	93208	0	98112
5461	1778	258	92148	2985	0	97169
5462	88056	221	2630	1940	0	92847
5463	3076	189	93563	1196	0	98024
5464	1841	226	2957	90921	0	95945
5465	1384	210	1476	95344	0	98414
5466	94356	202	973	3712	0	99243
5467	2899	96327	807	1681	0	101714
5468	2038	2386	593	95153	0	100170
5469	1592	1036	527	97644	0	100799
5470	987	690	96699	3554	0	101930
5471	1213	335	2613	95658	0	99819
5472	1213	282	1187	98813	0	101495
5473	1339	229	750	95731	0	98049
5474	736	94779	659	3775	0	99949
5475	92620	2354	575	2058	0	97607
5476	94194	912	539	1680	0	97325
5477	3484	94866	580	1089	0	100019
5478	88849	2236	420	1005	0	92510
5479	3170	870	427	91403	0	95870
5480	1382	498	94710	2800	0	99390
5481	845	93798	2582	1350	0	98575
5482	725	98382	1075	1000	0	101182
5483	94744	2584	795	871	0	98994
5484	99902	791	501	812	0	102006
5485	3643	442	378	99632	0	104095
5486	1676	304	392	101798	0	104170
5487	1195	243	395	102521	0	104354
5488	98623	297	385	4034	0	103339
5489	3182	336	97115	1482	0	102115
5490	97328	275	2673	1232	0	101508
5491	3620	315	991	98224	0	103150
5492	1792	274	633	96673	0	99372
5493	1016	97007	633	3535	0	102191
5494	1332	2515	576	99135	0	103558
5495	1163	861	552	101686	0	104262
5496	961	599	100178	3839	0	105577
5497	946	100653	2719	1753	0	106071
5498	102496	2682	997	1701	0	107876
5499	99885	983	639	1635	0	103142
5500	105122	591	602	1362	0	107677
5501	104042	457	552	1405	0	106456
5502	4022	448	99831	924	0	105225
5503	98002	379	2955	1155	0	102491
5504	3873	409	101084	955	0	106321
5505	2191	400	3040	96990	0	102621
5506	1459	100876	1202	3105	0	106642
5507	1626	2799	784	101634	0	106843
5508	1465	1005	745	104166	0	107381
5509	1154	692	101779	4120	0	107745
5510	95950	565	3174	2283	0	101972
5511	100568	535	1246	1841	0	104190
5512	3876	98965	988	1513	0	105342
5513	1976	2839	100126	1295	0	106236
5514	1839	1050	3015	100190	0	106094
5515	1498	785	101379	3508	0	107170
5516	1343	770	100409	1713	0	104235
5517	1720	615	3589	99472	0	105396
5518	1472	681	100824	3555	0	106532
5519	1643	565	3354	100040	0	105602
5520	1410	600	102633	3930	0	108573
5521	1549	599	3385	102000	0	107533
5522	102049	532	1521	4422	0	108524
5523	103482	556	1128	2490	0	107656
5524	103233	566	921	2036	0	106756
5525	101592	566	850	1925	0	104933
5526	4395	101111	938	1549	0	107993
5527	2384	2865	896	100574	0	106719
5528	1919	1043	788	103433	0	107183
5529	1518	891	100141	4322	0	106872
5530	1588	752	3033	98993	0	104366
5531	1312	730	99176	4073	0	105291
5532	1214	695	95757	2170	0	99836
5533	91904	590	3469	2103	0	98066
5534	3310	97963	1586	1702	0	104561
5535	98043	2786	1136	1715	0	103680
5536	98269	1052	950	1716	0	101987
5537	4230	98362	928	1343	0	104863
5538	96248	2538	916	1520	0	101222
5539	3789	985	95905	1092	0	101771
5540	1675	94672	2495	946	0	99788
5541	93846	2303	1161	1410	0	98720
5542	2969	978	88732	1050	0	93729
5543	83920	671	1930	1193	0	87714
5544	2344	88010	967	1028	0	92349
5545	87746	1846	793	1176	0	91561
5546	87408	794	740	1192	0	90134
5547	2706	85869	745	776	0	90096
5548	1327	85151	756	715	0	87949
5549	1124	88226	702	676	0	90728
5550	1081	2198	759	87952	0	91990
5551	1005	857	676	89484	0	92022
5552	89373	583	742	2670	0	93368
5553	87330	526	729	1592	0	90177
5554	2549	483	87381	1023	0	91436
5555	1231	472	84668	1022	0	87393
5556	1056	447	87663	906	0	90072
5557	1229	358	2569	87149	0	91305
5558	1161	377	89767	2279	0	93584
5559	1321	360	2370	88688	0	92739
5560	89356	403	1071	2699	0	93529
5561	2557	453	89714	1125	0	93849
5562	87585	440	2313	1189	0	91527
5563	89779	497	1023	1190	0	92489
5564	2805	484	91688	872	0	95849
5565	1289	92465	2424	840	0	97018
5566	1406	1947	1165	91527	0	96045
5567	1017	782	93372	2322	0	97493
5568	1364	547	2720	89480	0	94111
5569	1280	450	1245	98305	0	101280
5570	95167	491	1000	3067	0	99725
5571	3041	557	751	95009	0	99358
5572	1354	496	94703	2638	0	99191
5573	1397	487	2517	94015	0	98416
5574	94734	490	1002	3012	0	99238
5575	2803	95084	862	1188	0	99937
5576	93654	2160	800	1082	0	97696
5577	3083	1150	742	92303	0	97278
5578	1418	643	92851	2175	0	97087
5579	1253	462	88205	877	0	90797
5580	1152	446	86642	646	0	88886
5581	641	82749	2126	490	0	86006
5582	79073	1964	1584	781	0	83402
5583	1613	76237	480	315	0	78645
5584	71382	1223	301	509	0	73415
5585	1314	71857	219	206	0	73596
5586	700	1294	252	72351	0	74597
5587	518	370	178	73712	0	74778
5588	464	248	174	73618	0	74504
5589	226	74284	208	1554	0	76272
5590	487	1375	159	79299	0	81320
5591	580	375	171	92246	0	93372
5592	95157	254	199	2712	0	98322
5593	2818	204	191	97417	0	100630
5594	624	293	100327	2680	0	103924
5595	96624	216	2512	1215	0	100567
5596	100550	222	603	880	0	102255
5597	3004	100794	408	555	0	104761
5598	100622	2652	265	715	0	104254
5599	103413	654	213	750	0	105030
5600	3892	378	250	100616	0	105136
5601	1708	259	273	102966	0	105206
5602	1286	263	265	105838	0	107652
5603	103730	284	222	3992	0	108228
5604	105415	269	212	1548	0	107444
5605	3721	324	102389	834	0	107268
5606	101108	220	2687	983	0	104998
5607	104130	228	664	970	0	105992
5608	104332	198	444	1020	0	105994
5609	4040	246	100164	659	0	105109
5610	1583	227	101931	605	0	104346
5611	1615	219	3378	100912	0	106124
5612	1040	258	104516	3217	0	109031
5613	1476	197	3322	100494	0	105489
5614	1860	317	1052	92665	0	95894
5615	970	104609	783	3213	0	109575
5616	104484	2877	706	1623	0	109690
5617	3661	794	106400	987	0	111842
5618	107037	498	3274	1094	0	111903
5619	4429	438	1087	109379	0	115333
5620	106941	332	786	4024	0	112083
5621	4206	104337	663	1510	0	110716
5622	1694	110939	644	1211	0	114488
5623	1806	3771	598	107646	0	113821
5624	1630	1052	666	111529	0	114877
5625	1218	669	108993	4446	0	115326
5626	1627	486	3531	108345	0	113989
5627	104640	450	1224	4672	0	110986
5628	3948	106707	894	1701	0	113250
5629	1732	3459	106517	1176	0	112884
5630	1844	1169	3559	105381	0	111953
5631	1199	709	107904	3980	0	113792
5632	1578	519	3927	105862	0	111886
5633	1019	516	108388	4312	0	114235
5634	987	554	106592	1848	0	109981
5635	1294	646	4181	105132	0	111253
5636	106441	592	1656	4307	0	112996
5637	106808	556	1186	1944	0	110494
5638	104244	473	974	1722	0	107413
5639	4535	102976	939	1355	0	109805
5640	104073	3299	863	1412	0	109647
5641	103662	1084	829	1431	0	107006
5642	4725	802	100799	1134	0	107460
5643	1979	100159	3538	1195	0	106871
5644	1969	3444	1285	99090	0	105788
5645	99593	1123	942	4106	0	105764
5646	4027	100331	920	1717	0	106995
5647	103305	3528	832	1708	0	109373
5648	105404	1211	850	1406	0	108871
5649	104877	829	833	1370	0	107909
5650	104743	744	851	1339	0	107677
5651	5362	706	784	100826	0	107678
5652	101391	618	749	4119	0	106877
5653	4839	668	764	98531	0	104802
5654	2114	97791	894	3941	0	104740
5655	2035	2923	815	100088	0	105861
5656	99967	864	866	4219	0	105916
5657	4347	708	99599	1779	0	106433
5658	2378	549	3297	99800	0	106024
5659	98697	516	1308	4030	0	104551
5660	4250	98600	955	1723	0	105528
5661	99660	3154	838	1538	0	105190
5662	102107	1085	837	1368	0	105397
5663	4770	102396	839	1239	0	109244
5664	101449	3175	788	1178	0	106590
5665	4463	1122	96820	1049	0	103454
5666	2251	829	96583	1013	0	100676
5667	93670	800	3411	1203	0	99084
5668	4212	778	96387	999	0	102376
5669	2394	727	2823	88496	0	94440
5670	1837	91156	1104	2663	0	96760
5671	93596	2803	834	1269	0	98502
5672	3656	91731	790	1044	0	97221
5673	2153	87867	815	1022	0	91857
5674	1935	3122	786	97246	0	103089
5675	1654	1121	717	99020	0	102512
5676	1576	808	643	98259	0	101286
5677	1533	756	634	99319	0	102242
5678	1272	777	96218	3688	0	101955
5679	1325	670	2652	93817	0	98464
5680	1333	652	1039	97007	0	100031
5681	94792	647	766	3676	0	99881
5682	3377	643	727	94877	0	99624
5683	1616	567	92658	3301	0	98142
5684	88798	620	2523	1709	0	93650
5685	3561	672	943	92396	0	97572
5686	1693	605	94315	2807	0	99420
5687	1612	761	2588	90837	0	95798
5688	1278	94476	1040	2669	0	99463
5689	93569	2289	869	1476	0	98203
5690	2830	788	89535	916	0	94069
5691	989	76735	1574	650	0	79948
5692	72451	1227	819	668	0	75165
5693	1308	69540	421	472	0	71741
5694	604	67532	291	387	0	68814
5695	66351	1054	524	439	0	68368
5696	1069	65274	257	345	0	66945
5697	540	66479	222	303	0	67544
5698	808	1079	403	65119	0	67409
5699	391	390	65283	881	0	66945
5700	338	66887	697	476	0	68398
5701	422	780	278	66000	0	67480
5702	289	66026	208	701	0	67224
5703	64310	664	175	492	0	65641
5704	740	343	65010	313	0	66406
5705	467	232	564	64839	0	66102
5706	67093	156	229	898	0	68376
5707	755	173	163	68364	0	69455
5708	390	199	68131	748	0	69468
5709	62504	178	607	600	0	63889
5710	67756	158	258	413	0	68585
5711	840	71790	170	229	0	73029
5712	419	643	171	71466	0	72699
5713	368	262	129	73103	0	73862
5714	73406	179	159	968	0	74712
5715	71141	181	157	477	0	71956
5716	905	187	73118	230	0	74440
5717	334	71469	524	177	0	72504
5718	71290	413	146	234	0	72083
5719	574	182	119	71343	0	72218
5720	216	147	73487	465	0	74315
5721	174	108	70130	237	0	70649
5722	268	430	471	71154	0	72323
5723	72822	43	173	507	0	73545
5724	345	72258	104	176	0	72883
5725	78638	330	60	485	0	79513
5726	481	127	46	79592	0	80246
5727	208	81	54	80555	0	80898
5728	168	57	60	81520	0	81805
5729	81404	40	46	705	0	82195
5730	325	83062	78	302	0	83767
5731	194	300	56	84536	0	85086
5732	154	117	36	84518	0	84825
5733	104	106	85421	399	0	86030
5734	193	49	311	83300	0	83853
5735	72	113	86389	417	0	86991
5736	81	84873	337	221	0	85512
5737	112	283	113	86071	0	86579
5738	84373	90	85	543	0	85091
5739	317	114	85057	132	0	85620
5740	198	47	274	84672	0	85191
5741	111	63	85224	322	0	85720
5742	77380	42	325	451	0	78198
5743	302	129	86024	118	0	86573
5744	241	70	335	81428	0	82074
5745	83686	26	123	507	0	84342
5746	376	71706	209	191	0	72482
5747	79079	274	62	318	0	79733
5748	441	69462	176	139	0	70218
5749	245	330	85	81116	0	81776
5750	117	137	79195	337	0	79786
5751	177	134	76147	203	0	76661
5752	232	59	404	79099	0	79794
5753	81924	45	149	633	0	82751
5754	80174	48	126	342	0	80690
5755	517	48	73	81327	0	81965
5756	268	50	67	82839	0	83224
5757	80768	40	59	688	0	81555
5758	377	77692	76	232	0	78377
5759	141	82234	66	192	0	82633
5760	81242	417	44	361	0	82064
5761	479	204	80156	99	0	80938
5762	338	112	407	77925	0	78782
5763	173	120	78671	488	0	79452
5764	281	56	411	77839	0	78587
5765	208	87	79260	512	0	80067
5766	183	171	77152	230	0	77736
5767	288	80	513	79513	0	80394
5768	132	75594	257	436	0	76419
5769	81065	410	142	382	0	81999
5770	468	80611	137	193	0	81409
5771	312	459	116	80733	0	81620
5772	81292	160	119	681	0	82252
5773	604	148	114	82586	0	83452
5774	82314	96	124	883	0	83417
5775	81286	113	97	538	0	82034
5776	82073	74	114	433	0	82694
5777	623	81281	135	264	0	82303
5778	84785	457	109	374	0	85725
5779	704	376	108	89181	0	90369
5780	92658	147	105	971	0	93881
5781	953	124	105	95660	0	96842
5782	95162	99	110	1421	0	96792
5783	97276	112	106	682	0	98176
5784	1247	96508	148	395	0	98298
5785	678	1007	102	104960	0	106747
5786	543	356	94	104723	0	105716
5787	268	108360	118	1644	0	110390
5788	464	1448	113	111019	0	113044
5789	109595	448	163	2081	0	112287
5790	113636	247	140	1021	0	115044
5791	110615	174	143	908	0	111840
5792	2189	200	115550	387	0	118326
5793	117431	169	1543	801	0	119944
5794	125477	137	534	644	0	126792
5795	127003	123	251	708	0	128085
5796	2618	125796	225	402	0	129041
5797	1398	1822	132	127508	0	130860
5798	924	691	157	130481	0	132253
5799	743	363	137	129744	0	130987
5800	492	283	126248	2782	0	129805
5801	725	238	1818	127368	0	130149
5802	128235	185	721	2760	0	131901
5803	2473	158	350	130029	0	133010
5804	1433	155	240	134416	0	136244
5805	809	231	131444	3042	0	135526
5806	586	129043	2273	1321	0	133223
5807	133183	2111	782	1081	0	137157
5808	2813	759	367	133277	0	137216
5809	132732	396	279	2931	0	136338
5810	2708	409	130613	1177	0	134907
5811	120930	213	2252	1429	0	124824
5812	2628	133380	848	953	0	137809
5813	1254	2170	131993	673	0	136090
5814	758	794	133143	583	0	135278
5815	1213	523	2813	125410	0	129959
5816	666	375	136635	2399	0	140075
5817	570	135747	2385	1262	0	139964
5818	918	2166	918	133272	0	137274
5819	798	815	611	138235	0	140459
5820	741	586	453	139364	0	141144
5821	135832	383	304	3541	0	140060
5822	2382	136456	359	1627	0	140824
5823	1437	2147	302	138290	0	142176
5824	958	872	441	140755	0	143026
5825	134550	499	386	3444	0	138879
5826	2455	134993	343	1634	0	139425
5827	135898	2248	437	1462	0	140045
5828	135244	970	475	1246	0	137935
5829	134227	534	413	1414	0	136588
5830	3519	476	132197	864	0	137056
5831	2090	514	2209	127441	0	132254
5832	1258	130560	959	2676	0	135453
5833	1026	133767	624	1511	0	136928
5834	1285	2918	375	130501	0	135079
5835	1022	130217	458	2604	0	134301
5836	138237	2751	384	2103	0	143475
5837	2815	1308	138029	1260	0	143412
5838	133231	698	2312	1688	0	137929
5839	142303	612	895	1427	0	145237
5840	3896	628	628	142708	0	147860
5841	143586	590	580	3331	0	148087
5842	3443	151351	523	1712	0	157029
5843	153269	2561	527	1842	0	158199
5844	154261	1185	593	1700	0	157739
5845	165732	832	515	1703	0	168782
5846	4580	882	167271	1137	0	173870
5847	2453	886	168521	1183	0	173043
5848	2204	682	3874	167666	0	174426
5849	1618	165694	1764	3799	0	172875
5850	1643	174157	1136	1833	0	178769
5851	1706	3961	914	171119	0	177700
5852	172335	1862	752	4535	0	179484
5853	4332	1185	767	171959	0	178243
5854	2371	901	777	174846	0	178895
5855	171586	860	694	5585	0	178725
5856	4125	171573	723	2857	0	179278
5857	2436	3354	170170	1997	0	177957
5858	2134	1539	168450	1727	0	173850
5859	171343	1058	4144	1956	0	178501
5860	4233	947	2047	171608	0	178835
5861	2235	938	177400	3908	0	184481
5862	2138	851	3618	172191	0	178798
5863	1881	955	1751	173091	0	177678
5864	1546	924	1346	179338	0	183154
5865	1670	885	949	175744	0	179248
5866	1410	172041	910	5221	0	179582
5867	1418	3416	908	175179	0	180921
5868	172543	1543	936	5194	0	180216
5869	3857	172166	983	2973	0	179979
5870	175168	3643	949	2482	0	182242
5871	177492	1754	944	2277	0	182467
5872	177963	1329	972	2183	0	182447
5873	5211	1235	171942	1607	0	179995
5874	170389	924	3329	2251	0	176893
5875	178073	935	1673	1922	0	182603
5876	173528	1038	1077	2057	0	177700
5877	176948	786	778	2062	0	180574
5878	5297	174375	817	1672	0	182161
5879	169572	3242	550	1797	0	175161
5880	4430	1750	167025	1141	0	174346
5881	2599	1131	2629	161190	0	167549
5882	2431	809	1072	165517	0	169829
5883	167360	704	746	4204	0	173014
5884	3768	165680	667	2041	0	172156
5885	159487	2543	398	1717	0	164145
5886	3527	160484	521	805	0	165337
5887	157330	2560	377	1176	0	161443
5888	156901	993	356	1230	0	159480
5889	3522	172060	394	548	0	176524
5890	171473	2916	323	994	0	175706
5891	175492	1149	481	983	0	178105
5892	4398	163066	425	508	0	168397
5893	1741	168607	392	471	0	171211
5894	173243	3572	855	957	0	178627
5895	4614	1375	331	174216	0	180536
5896	174886	1011	240	4263	0	180400
5897	179442	629	210	1858	0	182139
5898	180218	548	195	1581	0	182542
5899	179909	595	203	1361	0	182068
5900	5681	172744	356	685	0	179466
5901	2453	178357	368	619	0	181797
5902	177996	4107	343	1179	0	183625
5903	4639	1757	177579	423	0	184398
5904	2684	1168	3376	170934	0	178162
5905	1932	614	1284	178609	0	182439
5906	176383	598	693	5219	0	182893
5907	3948	176225	442	2195	0	182810
5908	2518	3707	344	174417	0	180986
5909	2012	1463	283	182269	0	186027
5910	179865	951	358	5864	0	187038
5911	4974	737	292	181162	0	187165
5912	179871	639	297	5692	0	186499
5913	180871	752	280	2701	0	184604
5914	181815	753	261	2026	0	184855
5915	6843	554	283	178565	0	186245
5916	3628	553	334	180374	0	184889
5917	2342	569	193854	5454	0	202219
5918	1914	663	189958	2647	0	195182
5919	191308	573	6540	2167	0	200588
5920	6901	888	2695	199162	0	209646
5921	3334	661	211328	6001	0	221324
5922	2225	578	212514	3112	0	218429
5923	2391	522	8346	210990	0	222249
5924	1800	682	213228	6995	0	222705
5925	2511	699	7418	209585	0	220213
5926	2734	594	3217	212837	0	219382
5927	1714	591	212651	9456	0	224412
5928	2523	518	6969	212844	0	222854
5929	2842	621	3675	205659	0	212797
5930	2449	476	1954	221996	0	226875
5931	1758	654	214442	10699	0	227553
5932	2746	542	6714	219355	0	229357
5933	217251	642	3164	9792	0	230849
5934	7614	218205	2140	4896	0	232855
5935	220963	6534	1487	3831	0	232815
5936	8825	3164	215872	2586	0	230447
5937	216546	1536	7314	2888	0	228284
5938	221689	1047	3625	2867	0	229228
5939	221291	1027	2193	2557	0	227068
5940	12059	1108	1563	212932	0	227662
5941	6674	1018	1520	218413	0	227625
5942	3768	858	201001	10474	0	216101
5943	189117	660	7147	6112	0	203036
5944	8879	193308	3748	3482	0	209417
5945	4465	182984	1973	2573	0	191995
5946	3058	190131	1446	2438	0	197073
5947	3379	8547	1485	180019	0	193430
5948	178661	3496	1466	8073	0	191696
5949	181457	1674	1607	4819	0	189557
5950	9845	1242	174759	2977	0	188823
5951	5689	1317	6580	173792	0	187378
5952	3824	1399	3006	179046	0	187275
5953	2654	1364	173549	9841	0	187408
5954	2589	1173	168463	5390	0	177615
5955	167625	748	8459	4119	0	180951
5956	7890	171224	4108	3003	0	186225
5957	174675	6081	2399	3158	0	186313
5958	177023	3009	1789	3134	0	184955
5959	10472	1682	1699	170674	0	184527
5960	5941	1092	1808	176192	0	185033
5961	169404	1059	1696	10016	0	182175
5962	8990	1077	1683	169983	0	181733
5963	5431	1177	1888	172946	0	181442
5964	169363	984	1820	10549	0	182716
5965	8908	820	1747	171411	0	182886
5966	171310	754	1836	9847	0	183747
5967	174444	674	2007	6159	0	183284
5968	10265	792	166950	4199	0	182206
5969	167997	921	7272	4084	0	180274
5970	172048	885	3959	3993	0	180885
5971	172561	835	2692	3938	0	180026
5972	11416	1538	121594	4062	0	138610
5973	161964	826	5051	3873	0	171714
5974	9236	159046	3114	3560	0	174956
5975	164939	5737	2199	3917	0	176792
5976	168557	2601	1995	3822	0	176975
5977	11271	1227	1904	162996	0	177398
5978	6886	721	1818	163703	0	173128
5979	4533	161841	1838	10401	0	178613
5980	4568	6114	1590	166093	0	178365
5981	4456	3204	1764	170733	0	180157
5982	166273	1728	1798	10860	0	180659
5983	9857	1161	1670	164975	0	177663
5984	6920	981	1361	167118	0	176380
5985	5115	1124	1582	165101	0	172922
5986	3930	156226	1732	11268	0	173156
5987	154473	6089	1754	6822	0	169138
5988	8994	155026	1770	4671	0	170461
5989	139833	5845	1287	3729	0	150694
5990	8227	2834	133050	3362	0	147473
5991	128578	1630	5367	3467	0	139042
5992	7362	1438	129769	3190	0	141759
5993	4706	125608	5723	2933	0	138970
5994	121392	5003	4131	2639	0	133165
5995	119100	2757	2075	2554	0	126486
5996	7750	112512	1339	2333	0	123934
5997	4704	115952	1284	2160	0	124100
5998	114153	5688	1399	2381	0	123621
5999	116988	2859	1158	2209	0	123214
6000	8074	1524	1077	112785	0	123460
6001	4992	1406	968	117220	0	124586
6002	3500	1305	111795	6745	0	123345
6003	110058	1323	4144	3898	0	119423
6004	6475	1252	2220	109544	0	119491
6005	4273	110098	1492	5184	0	121047
6006	3470	4147	843	111129	0	119589
6007	3018	2267	677	112954	0	118916
6008	2455	1434	107091	6978	0	117958
6009	2717	1155	3822	109013	0	116707
6010	105948	1069	2063	6172	0	115252
6011	5240	102502	1132	3859	0	112733
6012	3501	104672	696	2527	0	111396
6013	103716	5142	831	2238	0	111927
6014	105789	2675	923	2100	0	111487
6015	104958	1399	908	2027	0	109292
6016	7307	98089	932	1603	0	107931
6017	2510	85479	517	976	0	89482
6018	89256	3190	659	973	0	94078
6019	89973	1565	698	1099	0	93335
6020	4480	84024	529	853	0	89886
6021	1130	73206	180	506	0	75022
6022	71730	2127	342	622	0	74821
6023	2423	822	140	70994	0	74379
6024	73689	520	110	2150	0	76469
6025	2652	446	115	72295	0	75508
6026	1095	73549	145	1968	0	76757
6027	820	76290	141	752	0	78003
6028	77515	2390	263	723	0	80891
6029	76049	965	241	737	0	77992
6030	79067	614	132	574	0	80387
6031	3021	77274	139	354	0	80788
6032	1006	2140	71452	231	0	74829
6033	562	72373	1640	287	0	74862
6034	69653	2140	631	433	0	72857
6035	67173	649	195	509	0	68526
6036	2244	451	67219	174	0	70088
6037	752	66246	1631	200	0	68829
6038	791	1875	506	65618	0	68790
6039	763	666	222	63896	0	65547
6040	611	57292	258	1871	0	60032
6041	529	1858	64107	476	0	66970
6042	65383	626	1731	471	0	68211
6043	2167	517	468	66581	0	69733
6044	67102	380	250	2002	0	69734
6045	68741	373	238	805	0	70157
6046	2589	438	229	71005	0	74261
6047	1284	425	219	74400	0	76328
6048	1050	329	179	76193	0	77751
6049	887	374	161	77017	0	78439
6050	74401	414	195	3339	0	78349
6051	75750	353	186	1429	0	77718
6052	3104	352	74807	834	0	79097
6053	1531	342	2091	74742	0	78706
6054	1125	347	690	77106	0	79268
6055	975	277	415	78131	0	79798
6056	771	344	75030	3271	0	79416
6057	974	269	2175	74597	0	78015
6058	73971	302	791	3097	0	78161
6059	2781	283	470	74972	0	78506
6060	1192	369	74206	3032	0	78799
6061	1072	291	2272	74492	0	78127
6062	695	376	74834	3002	0	78907
6063	74903	286	2491	1635	0	79315
6064	2956	287	867	76838	0	80948
6065	77073	259	637	3120	0	81089
6066	77425	298	459	1660	0	79842
6067	3485	273	407	77074	0	81239
6068	78709	296	373	3340	0	82718
6069	3408	344	415	76378	0	80545
6070	1498	81904	414	2969	0	86785
6071	84959	2425	349	1610	0	89343
6072	86080	828	359	1223	0	88490
6073	87306	488	336	1146	0	89276
6074	4121	382	329	84965	0	89797
6075	2010	335	318	86428	0	89091
6076	1445	381	287	87656	0	89769
6077	1165	384	82641	3951	0	88141
6078	1109	81477	2477	1798	0	86861
6079	1272	2464	734	80120	0	84590
6080	956	847	79532	3128	0	84463
6081	78331	470	2509	1681	0	82991
6082	3218	344	863	79840	0	84265
6083	1393	338	78892	3193	0	83816
6084	80862	354	2455	1825	0	85496
6085	3278	284	875	82919	0	87356
6086	1670	245	612	84739	0	87266
6087	1299	235	479	86285	0	88298
6088	84044	262	382	4289	0	88977
6089	85294	260	493	2204	0	88251
6090	84606	254	498	1624	0	86982
6091	3652	79543	565	1212	0	84972
6092	1602	83112	470	1165	0	86349
6093	83140	2633	448	1308	0	87529
6094	3175	876	81870	1110	0	87031
6095	1753	536	2290	81236	0	85815
6096	1379	343	888	84523	0	87133
6097	82384	351	600	3670	0	87005
6098	81228	334	401	1982	0	83945
6099	3472	80811	421	1343	0	86047
6100	1935	2229	407	81492	0	86063
6101	1247	808	79966	3138	0	85159
6102	1165	501	80931	1685	0	84282
6103	1320	361	2858	81476	0	86015
6104	1243	342	1055	85129	0	87769
6105	82757	405	684	3944	0	87790
6106	3143	366	527	84881	0	88917
6107	87368	280	541	3741	0	91930
6108	86748	276	588	2074	0	89686
6109	3454	352	84189	1518	0	89513
6110	86972	254	2113	1616	0	90955
6111	89467	264	930	1414	0	92075
6112	89476	246	649	1501	0	91872
6113	3686	86140	559	1370	0	91755
6114	1777	87902	526	1293	0	91498
6115	1582	2679	524	86830	0	91615
6116	1266	798	86134	3012	0	91210
6117	1117	82636	2070	1558	0	87381
6118	1285	1897	794	77943	0	81919
6119	1075	651	533	76763	0	79022
6120	912	77343	448	2290	0	80993
6121	77798	1651	350	1415	0	81214
6122	78587	605	410	1163	0	80765
6123	2691	425	78730	859	0	82705
6124	74636	292	1493	1123	0	77544
6125	2257	319	75832	818	0	79226
6126	68956	301	1593	958	0	71808
6127	2120	419	73274	665	0	76478
6128	1081	73184	1388	555	0	76208
6129	1184	1029	903	71535	0	74651
6130	787	427	494	72401	0	74109
6131	73176	290	316	1858	0	75640
6132	73172	193	311	1182	0	74858
6133	72165	232	239	913	0	73549
6134	1819	267	73261	655	0	76002
6135	1219	226	1132	72589	0	75166
6136	875	220	549	74924	0	76568
6137	74962	172	389	1895	0	77418
6138	1530	74733	336	942	0	77541
6139	78792	1068	271	953	0	81084
6140	1663	535	284	79991	0	82473
6141	1032	367	335	81980	0	83714
6142	804	279	257	82434	0	83774
6143	694	259	261	82873	0	84087
6144	759	283	223	82545	0	83810
6145	638	79310	210	1979	0	82137
6146	456	75969	169	778	0	77372
6147	363	74805	161	343	0	75672
6148	387	746	161	76055	0	77349
6149	338	296	74941	731	0	76306
6150	66688	151	651	698	0	68188
6151	792	77391	288	256	0	78727
6152	522	610	192	77984	0	79308
6153	401	241	179	78720	0	79541
6154	78811	169	125	1155	0	80260
6155	76870	138	138	752	0	77898
6156	77415	114	116	638	0	78283
6157	1164	117	105	81188	0	82574
6158	550	127	81959	870	0	83506
6159	424	170	82543	441	0	83578
6160	465	139	880	84838	0	86322
6161	298	164	85932	971	0	87365
6162	81104	103	874	730	0	82811
6163	1023	104	323	84881	0	86331
6164	449	146	85589	868	0	87052
6165	567	132	761	82696	0	84156
6166	316	152	87718	1011	0	89197
6167	286	155	90043	493	0	90977
6168	644	258	1003	94408	0	96313
6169	232	123	98668	1138	0	100161
6170	218	153	91802	459	0	92632
6171	136	86065	1482	365	0	88048
6172	689	1178	742	92419	0	95028
6173	98129	407	351	1546	0	100433
6174	1323	232	170	96539	0	98264
6175	742	104	136	101004	0	101986
6176	314	114	100338	1560	0	102326
6177	90322	69	1168	1188	0	92747
6178	1313	34	484	101908	0	103739
6179	711	46	302	104435	0	105494
6180	102561	47	198	1970	0	104776
6181	1359	67	142	104511	0	106079
6182	103879	57	171	2015	0	106122
6183	103690	71	168	1167	0	105096
6184	103084	74	153	927	0	104238
6185	1731	101268	181	354	0	103534
6186	103094	1067	122	655	0	104938
6187	1436	102970	152	303	0	104861
6188	867	1282	114	103945	0	106208
6189	104521	505	143	1667	0	106836
6190	1305	104590	183	641	0	106719
6191	105027	1235	118	824	0	107204
6192	1500	104577	187	363	0	106627
6193	103079	1412	110	646	0	105247
6194	1543	102094	161	297	0	104095
6195	722	104075	177	286	0	105260
6196	557	110390	136	253	0	111336
6197	652	1887	112	106122	0	108773
6198	327	112105	146	1183	0	113761
6199	621	1694	90	112197	0	114602
6200	515	794	117	114232	0	115658
6201	543	489	118	114496	0	115646
6202	496	318	97	115525	0	116436
6203	113121	238	95	2593	0	116047
6204	113639	267	106	1479	0	115491
6205	2105	303	113007	650	0	116065
6206	114491	243	1460	985	0	117179
6207	123347	203	602	892	0	125044
6208	126041	271	370	886	0	127568
6209	2920	334	121626	383	0	125263
6210	1238	339	121222	374	0	123173
6211	116679	280	2493	952	0	120404
6212	2521	304	125343	408	0	128576
6213	1048	130245	2368	477	0	134138
6214	1255	2169	810	131239	0	135473
6215	134699	725	549	2930	0	138903
6216	134992	456	441	1559	0	137448
6217	136253	304	394	1142	0	138093
6218	3723	258	433	134279	0	138693
6219	1937	266	398	137460	0	140061
6220	1060	371	138020	3127	0	142578
6221	1485	261	2414	136207	0	140367
6222	1278	278	892	141294	0	143742
6223	139851	219	650	3755	0	144475
6224	2894	141292	579	1436	0	146201
6225	143240	2419	394	1458	0	147511
6226	3449	963	476	143472	0	148360
6227	141066	631	369	3460	0	145526
6228	138763	383	402	1911	0	141459
6229	134017	384	419	1668	0	136488
6230	3611	133998	384	908	0	138901
6231	1698	138747	428	785	0	141658
6232	1498	2892	346	138842	0	143578
6233	139430	1097	425	3400	0	144352
6234	3334	667	421	137443	0	141865
6235	1846	504	337	139971	0	142658
6236	1271	609	138319	3533	0	143732
6237	1606	536	2445	135812	0	140399
6238	1493	560	863	137672	0	140588
6239	1427	429	563	138406	0	140825
6240	1029	476	136306	3936	0	141747
6241	1130	430	131327	2007	0	134894
6242	1042	133536	3024	1378	0	138980
6243	133858	2531	1149	1567	0	139105
6244	3389	1056	672	134950	0	140067
6245	1524	822	134438	3080	0	139864
6246	1754	458	2559	131517	0	136288
6247	1569	441	954	141260	0	144224
6248	138484	380	718	4433	0	144015
6249	138239	452	672	2430	0	141793
6250	3637	138519	754	1292	0	144202
6251	137115	2539	643	1608	0	141905
6252	137127	1010	612	1406	0	140155
6253	4005	787	619	136707	0	142118
6254	1826	746	136292	3024	0	141888
6255	1423	136432	2570	1506	0	141931
6256	136578	2676	924	1787	0	141965
6257	140531	1044	586	1621	0	143782
6258	3948	145546	548	1109	0	151151
6259	2338	2726	502	149621	0	155187
6260	154031	934	448	4491	0	159904
6261	156161	630	492	2359	0	159642
6262	4895	547	502	156062	0	162006
6263	153406	689	526	4681	0	159302
6264	166296	645	421	2352	0	169714
6265	168583	559	460	2052	0	171654
6266	5521	565	168258	1221	0	175565
6267	2425	161922	3290	1307	0	168944
6268	1779	167040	1052	1102	0	170973
6269	160269	3652	714	1595	0	166230
6270	4260	161942	555	854	0	167611
6271	1897	3741	161677	742	0	168057
6272	2212	1222	3283	159763	0	166480
6273	160267	815	967	4220	0	166269
6274	4701	732	664	159741	0	165838
6275	159937	720	475	4714	0	165846
6276	160793	670	439	2185	0	164087
6277	159931	633	450	1797	0	162811
6278	5022	153358	644	1189	0	160213
6279	1976	163054	722	1184	0	166936
6280	161267	3952	561	1766	0	167546
6281	158427	1413	487	1790	0	162117
6282	163386	919	488	1549	0	166342
6283	5644	795	457	159717	0	166613
6284	158419	732	498	4514	0	164163
6285	4664	154490	600	1643	0	161397
6286	2118	161767	469	1375	0	165729
6287	2347	4044	398	158296	0	165085
6288	1776	1350	156800	4030	0	163956
6289	1841	939	154941	1523	0	159244
6290	2304	729	3790	155001	0	161824
6291	1697	885	157092	3938	0	163612
6292	2069	1004	3564	156096	0	162733
6293	157624	993	1029	4421	0	164067
6294	4852	873	762	157134	0	163621
6295	155746	741	774	4752	0	162013
6296	4459	151846	861	1704	0	158870
6297	2088	3686	152224	1307	0	159305
6298	2339	1345	3567	145615	0	152866
6299	1999	1112	1135	151102	0	155348
6300	1522	1079	150989	4612	0	158202
6301	2123	825	3577	143648	0	150173
6302	1584	151581	1285	4113	0	158563
6303	2119	3744	866	153786	0	160515
6304	2204	1204	781	156806	0	160995
6305	2385	817	699	161427	0	165328
6306	1667	699	158874	5566	0	166806
6307	1308	595	146799	2089	0	150791
6308	135908	530	4295	1932	0	142665
6309	4226	676	143433	1026	0	149361
6310	1582	143133	3833	944	0	149492
6311	142882	3466	1384	1392	0	149124
6312	3988	144030	955	1010	0	149983
6313	139109	3711	1003	1250	0	145073
6314	140248	1239	1137	1154	0	143778
6315	138581	860	745	1216	0	141402
6316	138145	800	630	1259	0	140834
6317	4809	132308	671	1006	0	138794
6318	2093	137116	568	879	0	140656
6319	136831	3940	507	1146	0	142424
6320	4440	1511	133701	752	0	140404
6321	2472	1050	3317	129844	0	136683
6322	2154	712	1158	134988	0	139012
6323	1556	745	133598	4100	0	139999
6324	123742	814	3487	1984	0	130027
6325	132918	806	1182	1440	0	136346
6326	132257	837	890	1252	0	135236
6327	5074	130019	815	935	0	136843
6328	135478	3536	817	1202	0	141033
6329	5074	1367	814	128502	0	135757
6330	2176	140473	879	3531	0	147059
6331	143240	4076	794	1728	0	149838
6332	145382	1665	733	1460	0	149240
6333	152265	1224	701	1321	0	155511
6334	6792	1065	706	147185	0	155748
6335	3620	1007	646	147522	0	152795
6336	2289	144106	693	5473	0	152561
6337	1978	4296	146012	2411	0	154697
6338	2434	1786	4109	143994	0	152323
6339	2551	1137	1753	143278	0	148719
6340	2313	915	1104	151500	0	155832
6341	1720	942	147400	6191	0	156253
6342	143409	838	4348	3290	0	151885
6343	5560	941	1643	149793	0	157937
6344	2611	967	151137	5178	0	159893
6345	2471	819	4628	150103	0	158021
6346	152186	742	1890	6012	0	160830
6347	5367	149579	1377	2837	0	159160
6348	2947	4645	1172	151097	0	159861
6349	1950	1886	151671	5510	0	161017
6350	144565	1299	4889	3105	0	153858
6351	151863	973	2214	2400	0	157450
6352	6552	867	150370	1904	0	159693
6353	3784	1198	4974	136459	0	146415
6354	2230	147574	2175	4747	0	156726
6355	149479	4646	1606	2595	0	158326
6356	5710	1852	145733	1894	0	155189
6357	140596	1108	4874	2063	0	148641
6358	6241	917	136987	1296	0	145441
6359	3133	805	128683	1277	0	133898
6360	121222	731	5390	1595	0	128938
6361	4714	125720	2467	1345	0	134246
6362	2853	3875	123728	1237	0	131693
6363	1933	119162	4342	1143	0	126580
6364	2000	3869	115214	1058	0	122141
6365	1359	113429	3884	914	0	119586
6366	104898	3629	2360	1149	0	112036
6367	3601	1540	103298	884	0	109323
6368	1969	1021	101739	777	0	105506
6369	1407	762	100331	770	0	103270
6370	95662	709	4528	825	0	101724
6371	98672	492	2158	808	0	102130
6372	4219	561	1313	95779	0	101872
6373	2114	540	99441	2850	0	104945
6374	1539	490	100000	1502	0	103531
6375	98356	559	4098	1071	0	104084
6376	3606	571	2144	100291	0	106612
6377	100915	545	1458	3080	0	105998
6378	102686	462	1300	1539	0	105987
6379	4553	633	944	95383	0	101513
6380	2434	96250	1078	2924	0	102686
6381	1940	2713	1139	97061	0	102853
6382	1682	1332	1018	99311	0	103343
6383	1362	961	97244	3906	0	103473
6384	1265	93409	3264	2072	0	100010
6385	1224	97990	1881	1300	0	102395
6386	1352	3519	1352	93623	0	99846
6387	1006	1774	96067	3035	0	101882
6388	999	95359	3486	1719	0	101563
6389	1151	2981	96551	1291	0	101974
6390	92342	1449	3805	1390	0	98986
6391	97488	975	2088	1150	0	101701
6392	4219	800	96156	894	0	102069
6393	94974	690	3608	1065	0	100337
6394	4136	753	1943	94382	0	101214
6395	2226	98897	1597	2945	0	105665
6396	1893	2930	1350	100832	0	107005
6397	98961	1441	1223	3580	0	105205
6398	100764	954	1246	1955	0	104919
6399	100547	847	1215	1372	0	103981
6400	98038	663	1067	1263	0	101031
6401	4707	94282	1202	1017	0	101208
6402	2328	94304	1052	845	0	98529
6403	93040	3094	1132	1001	0	98267
6404	3558	1564	93506	818	0	99446
6405	2184	2790	2657	85381	0	93012
6406	1287	91577	1619	2093	0	96576
6407	1456	2387	1143	88474	0	93460
6408	895	93905	992	2485	0	98277
6409	1154	2936	881	93282	0	98253
6410	892	1582	93980	2807	0	99261
6411	90742	977	2858	1716	0	96293
6412	94483	795	1686	1149	0	98113
6413	3649	830	93744	701	0	98924
6414	92217	755	2982	834	0	96788
6415	94912	694	1775	855	0	98236
6416	3966	740	93171	577	0	98454
6417	2512	570	3050	89898	0	96030
6418	92543	453	1915	2741	0	97652
6419	3458	537	92212	1444	0	97651
6420	2305	625	2963	88629	0	94522
6421	1552	555	94274	2725	0	99106
6422	1381	602	92818	1565	0	96366
6423	91295	577	3777	1255	0	96904
6424	95832	577	1994	982	0	99385
6425	96916	441	1178	952	0	99487
6426	100327	539	1016	812	0	102694
6427	4818	641	889	94804	0	101152
6428	2365	89855	866	2623	0	95709
6429	1623	92860	880	1436	0	96799
6430	1261	2745	679	86048	0	90733
6431	86154	1017	669	2389	0	90229
6432	2713	83302	607	971	0	87593
6433	1011	82291	467	566	0	84335
6434	81641	2256	469	596	0	84962
6435	2512	911	478	80865	0	84766
6436	81843	519	440	2238	0	85040
6437	2464	81660	411	877	0	85412
6438	83518	2006	356	732	0	86612
6439	2793	744	87034	404	0	90975
6440	93353	567	2194	614	0	96728
6441	97424	422	746	694	0	99286
6442	98853	452	501	618	0	100424
6443	3919	658	82149	590	0	87316
6444	92452	406	1694	724	0	95276
6445	3231	94239	694	421	0	98585
6446	1433	2327	93555	294	0	97609
6447	1580	1165	2443	88714	0	93902
6448	1211	512	878	87154	0	89755
6449	779	91193	584	2615	0	95171
6450	1030	2256	407	91768	0	95461
6451	930	805	425	93995	0	96155
6452	745	519	90826	2927	0	95017
6453	83587	364	2412	1677	0	88040
6454	2767	356	91470	846	0	95439
6455	1514	303	2679	89921	0	94417
6456	885	318	92961	2579	0	96743
6457	921	292	2810	92388	0	96411
6458	93747	266	1199	3082	0	98294
6459	96630	301	812	1371	0	99114
6460	3589	275	674	96643	0	101181
6461	1528	295	99329	3042	0	104194
6462	1426	271	2752	99080	0	103529
6463	943	353	98721	3240	0	103257
6464	94562	334	2930	1809	0	99635
6465	100146	306	1199	1250	0	102901
6466	97509	345	826	1183	0	99863
6467	98548	356	685	1031	0	100620
6468	3907	94391	652	828	0	99778
6469	2135	2593	585	95293	0	100606
6470	93749	962	579	3163	0	98453
6471	3445	92187	594	1375	0	97601
6472	1798	95610	548	1013	0	98969
6473	1544	3066	90104	767	0	95481
6474	89199	1155	2858	844	0	94056
6475	93264	698	1239	776	0	95977
6476	4143	543	90042	610	0	95338
6477	2427	445	3014	87749	0	93635
6478	1978	388	1258	91837	0	95461
6479	1539	350	90972	3400	0	96261
6480	1546	365	3147	89199	0	94257
6481	89807	394	1365	3516	0	95082
6482	3549	438	86929	1511	0	92427
6483	1760	378	90420	1184	0	93742
6484	88092	404	3508	1270	0	93274
6485	3655	532	91046	823	0	96056
6486	88477	509	3383	1008	0	93377
6487	3784	89284	1530	868	0	95466
6488	91208	2717	1080	967	0	95972
6489	4002	1078	899	89542	0	95521
6490	2078	811	796	92290	0	95975
6491	91102	776	741	3939	0	96558
6492	3738	675	718	91290	0	96421
6493	91362	586	727	3764	0	96439
6494	3815	92547	709	1733	0	98804
6495	2245	2815	653	87979	0	93692
6496	1810	1162	714	91616	0	95302
6497	89655	797	709	3882	0	95043
6498	89895	620	670	2006	0	93191
6499	90280	490	654	1531	0	92955
6500	4549	85105	652	1127	0	91433
6501	2462	87400	592	912	0	91366
6502	86325	2941	613	1000	0	90879
6503	3940	1138	83977	873	0	89928
6504	2015	82788	2552	893	0	88248
6505	77332	2435	1759	900	0	82426
6506	75578	840	892	725	0	78035
6507	75417	612	550	649	0	77228
6508	3502	519	501	72106	0	76628
6509	73760	389	460	2402	0	77011
6510	74237	381	376	1078	0	76072
6511	3520	355	357	70659	0	74891
6512	72158	403	376	2477	0	75414
6513	3060	434	69497	1050	0	74041
6514	1763	432	1988	69959	0	74142
6515	1384	454	824	71861	0	74523
6516	1286	310	706	74737	0	77039
6517	72950	274	570	3256	0	77050
6518	75121	319	445	1712	0	77597
6519	75739	354	447	1292	0	77832
6520	75558	176	406	1276	0	77416
6521	72960	177	438	963	0	74538
6522	3636	199	509	68832	0	73176
6523	2162	184	396	70538	0	73280
6524	69030	171	495	2791	0	72487
6525	2819	67578	439	1436	0	72272
6526	67395	1637	431	1072	0	70535
6527	2735	551	64395	926	0	68607
6528	68837	406	1683	802	0	71728
6529	72721	401	591	861	0	74574
6530	3273	317	74750	678	0	79018
6531	77483	250	2349	634	0	80716
6532	3556	231	78013	640	0	82440
6533	2129	237	81782	439	0	84587
6534	1951	350	3328	77921	0	83550
6535	1725	289	1697	83523	0	87234
6536	1277	254	84136	3249	0	88916
6537	1234	263	85222	1830	0	88549
6538	800	80990	3166	1391	0	86347
6539	733	79861	1565	987	0	83146
6540	69408	2240	1284	649	0	73581
6541	1860	77375	687	447	0	80369
6542	75692	2111	525	606	0	78934
6543	2128	76016	417	426	0	78987
6544	75376	2047	413	414	0	78250
6545	2309	1119	72874	301	0	76603
6546	72566	728	1777	362	0	75433
6547	2534	569	900	72157	0	76160
6548	1363	74607	639	1545	0	78154
6549	1231	1701	420	75175	0	78527
6550	74956	930	344	2086	0	78316
6551	76319	649	232	1124	0	78324
6552	2917	538	226	74559	0	78240
6553	1562	367	73861	1868	0	77658
6554	1185	319	71098	1049	0	73651
6555	822	74833	2171	711	0	78537
6556	866	2015	1156	73949	0	77986
6557	579	863	74724	1726	0	77892
6558	470	69748	1705	893	0	72816
6559	735	1683	1014	70962	0	74394
6560	535	780	573	72787	0	74675
6561	68693	517	425	2187	0	71822
6562	1664	348	344	68655	0	71011
6563	877	314	67569	2019	0	70779
6564	792	238	1488	67182	0	69700
6565	64992	213	855	2120	0	68180
6566	1603	275	66132	1152	0	69162
6567	63155	179	1553	1024	0	65911
6568	1867	67529	907	684	0	70987
6569	69410	1402	588	626	0	72026
6570	70339	749	479	557	0	72124
6571	2493	520	420	67921	0	71354
6572	1580	330	315	68703	0	70928
6573	948	67790	287	2212	0	71237
6574	802	1432	304	70166	0	72704
6575	67728	783	262	2242	0	71015
6576	1734	637	67824	1186	0	71381
6577	1227	419	1436	67034	0	70116
6578	880	67588	814	1658	0	70940
6579	837	1459	573	69279	0	72148
6580	699	867	426	70489	0	72481
6581	68644	658	318	2438	0	72058
6582	1639	68305	283	1532	0	71759
6583	1220	1509	259	68981	0	71969
6584	67586	840	364	2065	0	70855
6585	1968	597	291	68001	0	70857
6586	1173	503	308	69436	0	71420
6587	69220	392	270	2848	0	72730
6588	68397	293	251	1923	0	70864
6589	2410	325	69028	1174	0	72937
6590	66552	310	1433	1055	0	69350
6591	69700	323	832	847	0	71702
6592	70260	341	602	752	0	71955
6593	2699	66760	461	692	0	70612
6594	1690	66949	358	556	0	69553
6595	1274	1978	270	66900	0	70422
6596	67261	1123	308	1759	0	70451
6597	68128	748	301	1165	0	70342
6598	2573	494	262	66935	0	70264
6599	1646	395	67511	1876	0	71428
6600	66984	304	1413	1352	0	70053
6601	72516	357	783	1082	0	74738
6602	2621	354	596	70561	0	74132
6603	1702	411	437	71733	0	74283
6604	71718	262	339	2468	0	74787
6605	2284	307	282	71116	0	73989
6606	1395	72327	319	2238	0	76279
6607	1119	1438	318	75006	0	77881
6608	74293	816	236	2385	0	77730
6609	1991	622	74024	1366	0	78003
6610	68745	392	1359	1426	0	71922
6611	2153	381	74019	894	0	77447
6612	1522	295	1704	73801	0	77322
6613	75421	252	1001	2051	0	78725
6614	2136	251	667	74728	0	77782
6615	1392	251	450	75492	0	77585
6616	72729	227	400	2823	0	76179
6617	1995	267	72656	1659	0	76577
6618	1406	239	74975	1241	0	77861
6619	1176	205	2010	76460	0	79851
6620	921	208	1175	79926	0	82230
6621	905	217	739	81323	0	83184
6622	658	233	79734	2789	0	83414
6623	74355	183	1506	2190	0	78234
6624	81234	150	860	1560	0	83804
6625	81902	165	636	1243	0	83946
6626	81418	152	490	1039	0	83099
6627	2838	78034	401	785	0	82058
6628	1725	77292	332	765	0	80114
6629	1026	76075	252	600	0	77953
6630	735	1047	276	66323	0	68381
6631	678	218	264	70133	0	71293
6632	445	128	69074	785	0	70432
6633	279	64876	465	352	0	65972
6634	471	365	193	64325	0	65354
6635	62635	146	165	708	0	63654
6636	403	62930	102	256	0	63691
6637	312	400	77	61766	0	62555
6638	160	63324	88	490	0	64062
6639	64582	400	90	446	0	65518
6640	671	139	85	64451	0	65346
6641	232	123	62514	514	0	63383
6642	196	111	61817	243	0	62367
6643	275	170	739	63622	0	64806
6644	261	71	213	63594	0	64139
6645	182	47	108	66519	0	66856
6646	65326	72	77	1105	0	66580
6647	725	86	65033	316	0	66160
6648	219	63776	653	233	0	64881
6649	277	605	197	63557	0	64636
6650	128	188	64188	642	0	65146
6651	80	64005	625	283	0	64993
6652	245	649	229	65636	0	66759
6653	134	178	66051	655	0	67018
6654	244	105	614	64289	0	65252
6655	164	65	211	66144	0	66584
6656	66533	41	114	1002	0	67690
6657	66375	41	97	488	0	67001
6658	867	47	79	66339	0	67332
6659	66290	42	117	994	0	67443
6660	782	55	67143	283	0	68263
6661	390	49	736	67302	0	68477
6662	173	95	69473	817	0	70558
6663	311	128	797	71134	0	72370
6664	134	70444	272	1017	0	71867
6665	115	71637	158	406	0	72316
6666	98	75005	142	209	0	75454
6667	489	1165	154	74082	0	75890
6668	295	340	87	85475	0	86197
6669	120	202	84457	1709	0	86488
6670	163	182	83332	605	0	84282
6671	150	153	87578	313	0	88194
6672	88650	114	1996	447	0	91207
6673	2040	110	497	92830	0	95477
6674	94093	81	233	2254	0	96661
6675	1923	95487	241	572	0	98223
6676	811	1982	246	96280	0	99319
6677	97799	518	231	2396	0	100944
6678	2417	314	186	98063	0	100980
6679	97427	231	140	2675	0	100473
6680	2344	289	98288	803	0	101724
6681	697	99779	2073	602	0	103151
6682	685	2094	588	101107	0	104474
6683	101062	554	426	2666	0	104708
6684	103503	310	382	1166	0	105361
6685	2932	211	385	103250	0	106778
6686	1203	186	377	105535	0	107301
6687	102358	219	427	3234	0	106238
6688	2804	251	417	101434	0	104906
6689	945	296	101203	2718	0	105162
6690	741	101054	2335	1103	0	105233
6691	932	2164	756	102813	0	106665
6692	102931	668	463	3143	0	107205
6693	103207	426	359	1648	0	105640
6694	3252	393	104346	894	0	108885
6695	1224	99894	2531	927	0	104576
6696	841	106951	826	964	0	109582
6697	1135	3037	533	104993	0	109698
6698	1237	979	441	106365	0	109022
6699	1073	575	389	106730	0	108767
6700	1056	472	399	106445	0	108372
6701	766	103576	492	3719	0	108553
6702	1022	2705	384	104801	0	108912
6703	1014	923	374	107699	0	110010
6704	103801	560	351	4312	0	109024
6705	103790	437	324	2330	0	106881
6706	3443	102999	370	1531	0	108343
6707	104126	2748	370	1605	0	108849
6708	105435	1019	449	1397	0	108300
6709	105316	749	418	1447	0	107930
6710	3804	658	102042	1133	0	107637
6711	1951	534	2665	101329	0	106479
6712	1372	502	912	105665	0	108451
6713	981	616	102829	3809	0	108235
6714	1145	599	2740	101598	0	106082
6715	1410	654	1064	96125	0	99253
6716	100856	532	630	4412	0	106430
6717	3053	540	101020	2125	0	106738
6718	1505	480	2755	98461	0	103201
6719	96385	516	966	4071	0	101938
6720	3098	96321	699	1990	0	102108
6721	95875	2757	488	1874	0	100994
6722	95833	937	412	1674	0	98856
6723	3922	93596	475	1288	0	99281
6724	2008	2864	483	93959	0	99314
6725	94350	1033	364	3700	0	99447
6726	3611	94063	419	1732	0	99825
6727	2009	2882	468	94854	0	100213
6728	93505	1010	534	3670	0	98719
6729	92757	707	504	1976	0	95944
6730	3822	90899	585	1555	0	96861
6731	91933	2745	563	1613	0	96854
6732	3749	966	505	91736	0	96956
6733	91608	740	465	3862	0	96675
6734	3703	687	89603	1856	0	95849
6735	2110	539	2736	89457	0	94842
6736	1841	534	939	91249	0	94563
6737	88230	628	705	4271	0	93834
6738	3474	86718	654	1983	0	92829
6739	84851	2822	599	1670	0	89942
6740	3655	84936	530	1297	0	90418
6741	1800	2878	81348	1213	0	87239
6742	1572	1126	80575	1274	0	84547
6743	1828	1424	2933	78589	0	84774
6744	1368	955	79622	3189	0	85134
6745	1440	895	2588	79655	0	84578
6746	1564	631	858	79268	0	82321
6747	1463	663	572	83502	0	86200
6748	82723	599	562	4110	0	87994
6749	82640	611	538	2050	0	85839
6750	84998	629	453	1768	0	87848
6751	4296	82062	445	1408	0	88211
6752	2060	90212	443	1286	0	94001
6753	1729	3509	92950	1228	0	99416
6754	1677	1401	3306	94547	0	100931
6755	1336	1044	94775	4180	0	101335
6756	1502	818	3828	93952	0	100100
6757	1563	702	1501	96985	0	100751
6758	1365	718	1153	97761	0	100997
6759	998	776	92708	5400	0	99882
6760	1217	625	3688	92864	0	98394
6761	90821	467	1587	5330	0	98205
6762	3787	88576	1225	2709	0	96297
6763	1763	3038	926	87793	0	93520
6764	86397	1123	741	4685	0	92946
6765	87534	896	643	2496	0	91569
6766	4720	736	672	83687	0	89815
6767	2536	514	549	81323	0	84922
6768	72889	403	414	4149	0	77855
6769	3620	403	403	72830	0	77256
6770	67703	291	334	3757	0	72085
6771	3425	276	280	66609	0	70590
6772	1610	254	61813	3349	0	67026
6773	1155	57006	1970	1901	0	62032
6774	968	60858	797	1479	0	64102
6775	1345	2195	1089	58988	0	63617
6776	1057	928	766	60545	0	63296
6777	58397	640	345	3040	0	62422
6778	2249	451	321	59488	0	62509
6779	1127	414	270	60316	0	62127
6780	869	395	252	56763	0	58279
6781	743	53888	203	3293	0	58127
6782	819	1701	207	56306	0	59033
6783	737	658	216	57084	0	58695
6784	752	479	209	56831	0	58271
6785	52007	394	244	3533	0	56178
6786	1844	52072	316	2054	0	56286
6787	925	1828	252	53704	0	56709
6788	795	814	213	54645	0	56467
6789	700	584	169	55202	0	56655
6790	51582	410	164	3490	0	55646
6791	2244	328	128	52785	0	55485
6792	1086	303	117	52456	0	53962
6793	670	277	47751	3153	0	51851
6794	511	46441	1306	1951	0	50209
6795	543	1513	483	48763	0	51302
6796	46782	583	414	2570	0	50349
6797	1586	47544	317	1490	0	50937
6798	47082	1555	250	1337	0	50224
6799	47846	685	272	1110	0	49913
6800	2169	589	212	46897	0	49867
6801	1214	433	167	48574	0	50388
6802	919	317	46781	2518	0	50535
6803	813	312	1324	49022	0	51471
6804	670	275	48184	2535	0	51664
6805	615	227	1616	49593	0	52051
6806	46357	213	724	2668	0	49962
6807	1632	47755	584	1592	0	51563
6808	829	1570	514	51403	0	54316
6809	715	715	406	52359	0	54195
6810	674	510	404	52475	0	54063
6811	545	479	345	52978	0	54347
6812	50120	352	295	3172	0	53939
6813	1759	49769	299	1953	0	53780
6814	898	1459	245	52967	0	55569
6815	51820	593	264	2970	0	55647
6816	1902	436	50843	1833	0	55014
6817	50390	361	1498	1671	0	53920
6818	53034	341	716	1317	0	55408
6819	2459	426	550	52539	0	55974
6820	1429	349	425	54459	0	56662
6821	53419	370	353	2860	0	57002
6822	2183	54896	358	1802	0	59239
6823	57072	1572	288	1691	0	60623
6824	58079	648	198	1538	0	60463
6825	58770	481	151	1486	0	60888
6826	2964	375	152	57442	0	60933
6827	1739	380	198	59609	0	61926
6828	1320	61403	195	2836	0	65754
6829	1327	1857	182	63512	0	66878
6830	62741	833	188	2883	0	66645
6831	2492	597	61158	1608	0	65855
6832	59777	448	1693	1529	0	63447
6833	64434	396	650	1391	0	66871
6834	2957	376	421	63527	0	67281
6835	1693	312	323	65086	0	67414
6836	63893	314	250	3292	0	67749
6837	64398	257	262	1904	0	66821
6838	59828	305	231	1723	0	62087
6839	3028	277	61625	1287	0	66217
6840	1626	61085	1486	1177	0	65374
6841	62381	1671	582	1198	0	65832
6842	2489	791	399	61336	0	65015
6843	1355	61946	318	2203	0	65822
6844	1291	1761	241	62462	0	65755
6845	61856	765	289	2449	0	65359
6846	2318	686	262	61982	0	65248
6847	1614	492	59499	2523	0	64128
6848	948	57999	1223	1513	0	61683
6849	802	61030	535	1276	0	63643
6850	818	1611	56550	985	0	59964
6851	48705	1286	1624	1072	0	52687
6852	1211	49634	555	741	0	52141
6853	774	764	354	43785	0	45677
6854	43448	224	130	737	0	44539
6855	658	42875	102	312	0	43947
6856	376	615	93	43587	0	44671
6857	43620	252	94	765	0	44731
6858	779	155	95	43525	0	44554
6859	43477	107	68	878	0	44530
6860	780	137	43525	395	0	44837
6861	368	43943	532	324	0	45167
6862	46395	613	213	430	0	47651
6863	46149	251	131	401	0	46932
6864	45948	159	115	381	0	46603
6865	938	167	43427	250	0	44782
6866	43453	131	516	326	0	44426
6867	46119	126	185	297	0	46727
6868	972	164	127	45685	0	46948
6869	45918	133	97	831	0	46979
6870	881	45022	101	385	0	46389
6871	548	592	71	45724	0	46935
6872	397	245	45286	715	0	46643
6873	398	205	585	44606	0	45794
6874	387	189	210	46109	0	46895
6875	45534	168	136	975	0	46813
6876	45077	149	102	585	0	45913
6877	975	178	44524	292	0	45969
6878	42835	146	608	400	0	43989
6879	965	132	44459	249	0	45805
6880	619	116	660	44517	0	45912
6881	430	150	44858	785	0	46223
6882	450	132	641	44254	0	45477
6883	420	44477	268	749	0	45914
6884	407	612	44689	378	0	46086
6885	400	262	45597	295	0	46554
6886	676	224	1008	37322	0	39230
6887	46470	153	330	910	0	47863
6888	46551	155	216	540	0	47462
6889	46976	143	196	477	0	47792
6890	1201	153	195	46004	0	47553
6891	727	139	140	46940	0	47946
6892	569	131	193	47131	0	48024
6893	499	108	184	47184	0	47975
6894	397	152	46324	1131	0	48004
6895	477	154	718	45519	0	46868
6896	370	45064	299	918	0	46651
6897	392	710	220	46468	0	47790
6898	46745	293	192	1165	0	48395
6899	1008	203	46692	540	0	48443
6900	42816	126	822	624	0	44388
6901	1096	139	47697	345	0	49277
6902	504	115	47524	294	0	48437
6903	363	47075	1167	301	0	48906
6904	722	1014	562	41182	0	43480
6905	441	346	281	46336	0	47404
6906	422	38336	546	1282	0	40586
6907	49341	1073	250	534	0	51198
6908	1432	471	209	50483	0	52595
6909	863	226	220	54319	0	55628
6910	548	186	210	57231	0	58175
6911	61494	186	177	2536	0	64393
6912	65236	126	178	1294	0	66834
6913	2841	146	177	63768	0	66932
6914	1337	147	177	64852	0	66513
6915	62788	114	184	3046	0	66132
6916	2494	132	156	63159	0	65941
6917	1258	144	168	64464	0	66034
6918	1096	126	168	65194	0	66584
6919	830	156	60962	3326	0	65274
6920	57742	102	1827	2040	0	61711
6921	60983	103	684	1609	0	63379
6922	3105	83	57283	1237	0	61708
6923	1733	435	1940	52398	0	56506
6924	1032	56104	838	2516	0	60490
6925	55397	1727	515	1680	0	59319
6926	2232	55389	563	1350	0	59534
6927	1210	52881	421	1041	0	55553
6928	1233	2144	347	50880	0	54604
6929	50532	847	425	2302	0	54106
6930	53045	545	306	1384	0	55280
6931	2716	530	256	51800	0	55302
6932	1566	444	285	52854	0	55149
6933	1182	520	185	52902	0	54789
6934	1036	624	167	52769	0	54596
6935	946	439	168	51264	0	52817
6936	790	49329	168	3091	0	53378
6937	980	1784	132	51213	0	54109
6938	49796	734	98	3100	0	53728
6939	51015	480	109	2003	0	53607
6940	50917	395	139	1689	0	53140
6941	2728	48401	138	1892	0	53159
6942	1609	1751	119	49205	0	52684
6943	1110	816	48301	2696	0	52923
6944	47446	572	1650	1829	0	51497
6945	2537	561	628	48920	0	52646
6946	48893	409	392	2710	0	52404
6947	48107	380	320	1624	0	50431
6948	48495	501	205	1238	0	50439
6949	3207	494	241	46084	0	50026
6950	46753	400	372	2483	0	50008
6951	3042	382	328	46376	0	50128
6952	1906	298	252	48024	0	50480
6953	46971	242	291	3089	0	50593
6954	3007	316	190	47387	0	50900
6955	46936	303	142	3024	0	50405
6956	48102	295	161	1935	0	50493
6957	3444	275	124	47023	0	50866
6958	2050	254	97	48569	0	50970
6959	1594	219	87	49491	0	51391
6960	1529	181	44123	3573	0	49406
6961	1403	182	45127	2254	0	48966
6962	1463	137	2024	44575	0	48199
6963	1432	158	818	45623	0	48031
6964	1207	174	512	46642	0	48535
6965	1097	171	394	46600	0	48262
6966	1090	221	365	47233	0	48909
6967	43610	190	460	3993	0	48253
6968	2350	42833	596	2353	0	48132
6969	1531	1600	478	44958	0	48567
6970	44440	650	449	3270	0	48809
6971	2591	438	397	45171	0	48597
6972	1469	351	286	46372	0	48478
6973	43865	327	311	3943	0	48446
6974	44881	275	297	2463	0	47916
6975	3074	414	42578	1957	0	48023
6976	1893	370	1595	44350	0	48208
6977	1620	318	43646	3186	0	48770
6978	1452	299	1805	45137	0	48693
6979	1271	180	787	45867	0	48105
6980	1430	161	462	46581	0	48634
6981	1317	196	43062	3806	0	48381
6982	1041	40937	1940	2493	0	46411
6983	979	43954	1021	2145	0	48099
6984	982	1915	766	44354	0	48017
6985	43016	760	698	3204	0	47678
6986	2212	502	42524	2357	0	47595
6987	1323	382	44559	1922	0	48186
6988	1016	322	2507	44626	0	48471
6989	900	437	1260	44337	0	46934
6990	724	45197	853	3215	0	49989
6991	859	1910	747	45573	0	49089
6992	898	936	611	48268	0	50713
6993	844	646	656	49336	0	51482
6994	45947	436	673	3698	0	50754
6995	46779	383	552	2332	0	50046
6996	2763	407	516	46824	0	50510
6997	1452	45267	436	3120	0	50275
6998	1191	1685	331	46019	0	49226
6999	43922	768	327	3258	0	48275
7000	2051	44553	382	2288	0	49274
7001	1398	1561	256	41633	0	44848
7002	1094	41971	247	2628	0	45940
7003	41621	1688	210	1944	0	45463
7004	39729	952	301	1524	0	42506
7005	2251	40900	289	1389	0	44829
7006	1260	41428	310	1207	0	44205
7007	870	1803	37537	977	0	41187
7008	589	35944	1130	960	0	38623
7009	776	1631	651	31209	0	34267
7010	509	573	30715	1379	0	33176
7011	126	23599	500	351	0	24576
7012	192	473	204	21462	0	22331
7013	119	155	75	22182	0	22531
7014	102	87	52	22441	0	22682
7015	21617	61	34	656	0	22368
7016	391	86	21171	278	0	21926
7017	189	65	21194	156	0	21604
7018	150	88	466	21305	0	22009
7019	60	87	22803	467	0	23417
7020	113	71	411	22873	0	23468
7021	121	73	187	21573	0	21954
7022	129	54	93	23626	0	23902
7023	109	54	73	23863	0	24099
7024	23118	65	80	652	0	23915
7025	23154	70	60	337	0	23621
7026	499	54	67	23562	0	24182
7027	202	71	24615	499	0	25387
7028	144	56	373	24480	0	25053
7029	72	24330	175	493	0	25070
7030	105	372	118	24447	0	25042
7031	24133	151	83	543	0	24910
7032	24563	100	69	339	0	25071
7033	527	67	69	24667	0	25330
7034	244	64	79	24806	0	25193
7035	149	70	62	25124	0	25405
7036	24195	64	62	716	0	25037
7037	415	84	24113	334	0	24946
7038	203	53	23724	208	0	24188
7039	125	23587	433	159	0	24304
7040	23950	336	181	213	0	24680
7041	384	148	100	24200	0	24832
7042	166	73	24777	451	0	25467
7043	118	24116	346	225	0	24805
7044	93	25206	154	183	0	25636
7045	105	391	89	25202	0	25787
7046	118	202	50	25699	0	26069
7047	88	25249	63	505	0	25905
7048	110	352	42	26167	0	26671
7049	110	157	53	26354	0	26674
7050	25727	100	68	560	0	26455
7051	352	25649	79	261	0	26341
7052	172	337	57	25648	0	26214
7053	105	175	25266	399	0	25945
7054	120	121	317	25074	0	25632
7055	25036	86	142	494	0	25758
7056	318	25125	110	234	0	25787
7057	164	345	62	25400	0	25971
7058	103	178	25162	413	0	25856
7059	103	102	26432	261	0	26898
7060	136	83	498	27202	0	27919
7061	103	97	204	28269	0	28673
7062	28288	78	108	646	0	29120
7063	422	28732	84	263	0	29501
7064	28929	443	89	271	0	29732
7065	491	193	29156	152	0	29992
7066	27614	142	482	245	0	28483
7067	516	97	29616	173	0	30402
7068	28604	87	517	262	0	29470
7069	29761	87	182	241	0	30271
7070	603	125	31120	172	0	32020
7071	269	96	30705	198	0	31268
7072	157	30142	622	189	0	31110
7073	180	487	232	32349	0	33248
7074	33111	192	153	656	0	34112
7075	576	131	106	33499	0	34312
7076	296	93	116	34218	0	34723
7077	198	67	138	34443	0	34846
7078	139	87	34030	780	0	35036
7079	30790	83	566	499	0	31938
7080	34296	57	229	335	0	34917
7081	709	35181	176	224	0	36290
7082	347	526	114	34610	0	35597
7083	176	36108	123	621	0	37028
7084	215	603	109	36657	0	37584
7085	36204	183	145	814	0	37346
7086	659	35940	121	330	0	37050
7087	277	577	87	34946	0	35887
7088	34739	194	88	717	0	35738
7089	35023	123	82	365	0	35593
7090	800	97	74	33732	0	34703
7091	279	101	33762	671	0	34813
7092	299	271	507	31781	0	32858
7093	168	33737	182	558	0	34645
7094	33652	536	130	313	0	34631
7095	572	33871	88	201	0	34732
7096	318	606	62	33694	0	34680
7097	34122	182	57	703	0	35064
7098	666	144	69	35170	0	36049
7099	307	93	61	35560	0	36021
7100	167	107	35004	732	0	36010
7101	146	34616	509	310	0	35581
7102	33879	501	184	270	0	34834
7103	30390	246	112	418	0	31166
7104	480	33319	67	144	0	34010
7105	163	33863	61	133	0	34220
7106	253	492	55	33376	0	34176
7107	32872	173	72	544	0	33661
7108	435	32647	54	174	0	33310
7109	241	438	41	33412	0	34132
7110	149	160	33243	456	0	34008
7111	158	135	390	32934	0	33617
7112	33378	86	102	609	0	34175
7113	416	33609	95	224	0	34344
7114	207	430	60	34968	0	35665
7115	125	177	34466	471	0	35239
7116	132	139	33875	199	0	34345
7117	184	93	508	34629	0	35414
7118	179	81	164	35377	0	35801
7119	111	34703	115	613	0	35542
7120	171	502	56	34654	0	35383
7121	34830	153	59	672	0	35714
7122	544	139	80	35444	0	36207
7123	35247	94	109	709	0	36159
7124	554	34710	120	247	0	35631
7125	205	35774	108	227	0	36314
7126	261	596	72	36697	0	37626
7127	185	203	82	36097	0	36567
7128	159	174	35741	678	0	36752
7129	180	111	528	34970	0	35789
7130	35248	87	175	746	0	36256
7131	585	165	35330	265	0	36345
7132	286	152	525	36025	0	36988
7133	181	168	37532	711	0	38592
7134	199	93	624	37816	0	38732
7135	227	100	236	37812	0	38375
7136	192	91	163	39045	0	39491
7137	201	118	38507	823	0	39649
7138	202	126	616	37361	0	38305
7139	137	38237	217	766	0	39357
7140	149	591	219	39345	0	40304
7141	141	201	113	39664	0	40119
7142	38556	179	96	966	0	39797
7143	644	148	37884	479	0	39155
7144	275	112	619	38187	0	39193
7145	233	113	37808	824	0	38978
7146	165	164	35918	380	0	36627
7147	201	120	724	38044	0	39089
7148	261	131	282	36829	0	37503
7149	210	145	173	39924	0	40452
7150	38975	123	134	1084	0	40316
7151	673	149	38352	496	0	39670
7152	38664	117	682	512	0	39975
7153	779	128	244	41249	0	42400
7154	336	115	192	42282	0	42925
7155	228	43772	146	968	0	45114
7156	223	664	134	45684	0	46705
7157	263	193	148	45665	0	46269
7158	311	158	171	45625	0	46265
7159	41666	75	124	961	0	42826
7160	564	99	39870	448	0	40981
7161	36817	87	467	492	0	37863
7162	614	40573	166	311	0	41664
7163	40343	498	116	325	0	41282
7164	592	39946	88	256	0	40882
7165	217	40262	104	272	0	40855
7166	346	660	135	41034	0	42175
7167	41283	234	174	716	0	42407
7168	620	134	71	41767	0	42592
7169	206	40033	89	772	0	41100
7170	181	41880	92	346	0	42499
7171	161	710	69	42336	0	43276
7172	168	283	89	42229	0	42769
7173	122	41560	81	862	0	42625
7174	165	649	75	43685	0	44574
7175	193	241	77	44017	0	44528
7176	159	176	85	44431	0	44851
7177	43216	122	56	1066	0	44460
7178	627	134	42564	478	0	43803
7179	41390	116	579	477	0	42562
7180	44229	115	189	344	0	44877
7181	43515	67	132	324	0	44038
7182	807	42522	79	227	0	43635
7183	356	552	70	42358	0	43336
7184	42472	187	61	692	0	43412
7185	614	130	58	42867	0	43669
7186	42715	66	45	772	0	43598
7187	629	44437	73	325	0	45464
7188	46780	524	52	396	0	47752
7189	47580	205	49	300	0	48134
7190	48273	131	47	292	0	48743
7191	869	87	52	47673	0	48681
7192	393	92	45	49403	0	49933
7193	49320	83	41	867	0	50311
7194	587	48313	49	375	0	49324
7195	263	48081	60	275	0	48679
7196	50668	586	76	321	0	51651
7197	644	226	61	51143	0	52074
7198	370	123	45	51458	0	51996
7199	265	88	55	52471	0	52879
7200	191	50978	51	939	0	52159
7201	51645	649	55	524	0	52873
7202	776	256	39	52331	0	53402
7203	304	52431	50	814	0	53599
7204	278	676	28	56284	0	57266
7205	255	299	28	56837	0	57419
7206	241	165	37	56784	0	57227
7207	201	122	43	57522	0	57888
7208	56652	120	37	1168	0	57977
7209	56127	99	56	639	0	56921
7210	57324	97	47	500	0	57968
7211	1064	99	34	57543	0	58740
7212	451	129	56058	875	0	57513
7213	359	113	49698	499	0	50669
7214	270	131	52379	400	0	53180
7215	57210	107	838	449	0	58604
7216	800	96	312	58548	0	59756
7217	419	104	158	58328	0	59009
7218	329	109	87	59274	0	59799
7219	58150	101	85	1160	0	59496
7220	57644	103	79	691	0	58517
7221	900	60793	88	447	0	62228
7222	503	600	58	62023	0	63184
7223	336	256	60697	804	0	62093
7224	270	61544	599	425	0	62838
7225	290	701	187	63906	0	65084
7226	288	273	157	64462	0	65180
7227	300	171	93	63752	0	64316
7228	280	141	65	62556	0	63042
7229	252	138	61981	1027	0	63398
7230	229	141	57063	600	0	58033
7231	220	61627	671	475	0	62993
7232	265	551	251	63177	0	64244
7233	265	215	142	62102	0	62724
7234	60652	147	112	991	0	61902
7235	664	167	60887	427	0	62145
7236	369	119	551	60666	0	61705
7237	290	78	238	63033	0	63639
7238	229	155	63808	875	0	65067
7239	181	63148	548	499	0	64376
7240	63738	541	217	566	0	65062
7241	668	240	63418	324	0	64650
7242	60560	138	544	506	0	61748
7243	709	176	65931	301	0	67117
7244	395	118	598	66895	0	68006
7245	267	130	66813	703	0	67913
7246	253	133	67033	400	0	67819
7247	295	98	720	69415	0	70528
7248	790	193	760	53639	0	55382
7249	203	85	187	72999	0	73474
7250	263	63	173	70902	0	71401
7251	262	82	161	70992	0	71497
7252	207	126	71095	946	0	72374
7253	176	147	64953	588	0	65864
7254	151	71153	736	402	0	72442
7255	71331	623	321	458	0	72733
7256	810	266	199	71916	0	73191
7257	72136	129	159	1091	0	73515
7258	898	74	148	72206	0	73326
7259	73483	74	155	1269	0	74981
7260	940	84	139	74304	0	75467
7261	427	101	146	74768	0	75442
7262	260	75747	169	1157	0	77333
7263	293	741	146	79176	0	80356
7264	287	295	131	79225	0	79938
7265	268	157	128	79040	0	79593
7266	264	99	115	78353	0	78831
7267	122	76110	129	1179	0	77540
7268	76076	602	104	788	0	77570
7269	663	75874	125	468	0	77130
7270	245	635	80	75396	0	76356
7271	73874	210	67	980	0	75131
7272	698	182	70867	378	0	72125
7273	251	147	70340	346	0	71084
7274	372	152	776	69395	0	70695
7275	193	72	341	73312	0	73918
7276	157	73	202	73662	0	74094
7277	281	64	183	68295	0	68823
7278	169	51	113	71966	0	72299
7279	103	70360	114	947	0	71524
7280	141	528	97	72811	0	73577
7281	72408	156	89	1152	0	73805
7282	700	123	102	73679	0	74604
7283	228	140	75601	920	0	76889
7284	277	70	777	74773	0	75897
7285	74512	61	291	1306	0	76170
7286	753	77439	212	516	0	78920
7287	436	779	104	84832	0	86151
7288	372	266	72	89290	0	90000
7289	181	190	87015	2040	0	89426
7290	198	194	103432	724	0	104548
7291	115838	129	3025	835	0	119827
7292	3678	114	977	117413	0	122182
7293	1757	118	944	121685	0	124504
7294	1368	159	125364	4677	0	131568
7295	856	315	124534	2710	0	128415
7296	455	125558	4988	2196	0	133197
7297	872	3662	2585	123658	0	130777
7298	260	1382	126355	4012	0	132009
7299	159	125750	4755	1747	0	132411
7300	125223	4279	2143	1905	0	133550
7301	130919	1780	1876	1348	0	135923
7302	5603	1653	1148	124455	0	132859
7303	2756	127936	948	4186	0	135826
7304	127501	4430	814	2131	0	134876
7305	5886	1955	588	116803	0	125232
7306	2501	1768	123474	4230	0	131973
7307	2151	125522	4100	2133	0	133906
7308	124498	4504	1786	2274	0	133062
7309	128788	1991	1575	1642	0	133996
7310	6000	1800	1048	125727	0	134575
7311	3536	1146	816	129482	0	134980
7312	2530	1015	124922	5808	0	134275
7313	2217	813	4210	126499	0	133739
7314	2141	637	1814	120850	0	125442
7315	1659	566	1595	128464	0	132284
7316	1399	529	1010	129212	0	132150
7317	1390	532	858	123546	0	126326
7318	858	122253	866	8065	0	132042
7319	121354	4040	680	5243	0	131317
7320	4501	1746	121435	3897	0	131579
7321	1989	119236	4317	2943	0	128485
7322	2372	4516	1881	122285	0	131054
7323	121468	2001	1735	6162	0	131366
7324	5214	1841	1275	122577	0	130907
7325	2681	1145	1116	125009	0	129951
7326	2362	935	1032	126090	0	130419
7327	1698	885	877	127241	0	130701
7328	1375	776	118678	9015	0	129844
7329	1158	118489	4536	5712	0	129895
7330	119015	4538	1888	4893	0	130334
7331	4855	2053	119714	3422	0	130044
7332	2544	1915	5278	120265	0	130002
7333	119808	1471	2548	6381	0	130208
7334	5378	119794	2365	3430	0	130967
7335	121381	5034	1632	3479	0	131526
7336	7195	2381	1514	111593	0	122683
7337	3606	2186	1159	124758	0	131709
7338	3359	1524	940	124204	0	130027
7339	2510	1206	808	125713	0	130237
7340	117856	1162	906	9560	0	129484
7341	5663	1100	829	121805	0	129397
7342	3147	892	852	125303	0	130194
7343	115593	867	854	8985	0	126299
7344	6029	901	113237	5634	0	125801
7345	3384	833	4566	117258	0	126041
7346	111567	765	1918	7855	0	122105
7347	114092	645	1885	4760	0	121382
7348	7089	746	1352	111158	0	120345
7349	4508	684	1210	110565	0	116967
7350	3450	103882	1114	8141	0	116587
7351	2685	4190	909	109810	0	117594
7352	2266	1807	719	111603	0	116395
7353	1886	1665	102044	9107	0	114702
7354	1582	1108	100531	6172	0	109393
7355	1315	100151	5655	5227	0	112348
7356	1624	4449	3206	101087	0	110366
7357	1635	2045	2701	106422	0	112803
7358	101463	1955	2092	8071	0	113581
7359	5143	1411	1795	103558	0	111907
7360	2798	1306	99082	8178	0	111364
7361	2947	1104	4748	102659	0	111458
7362	1939	1055	95955	8573	0	107522
7363	1706	1051	97719	5287	0	105763
7364	1750	1144	6572	95386	0	104852
7365	1554	1027	3920	101001	0	107502
7366	95944	1118	3010	8259	0	108331
7367	99573	875	2274	5465	0	108187
7368	6569	931	2034	99469	0	109003
7369	99929	980	1542	7556	0	110007
7370	104004	706	1197	4895	0	110802
7371	7933	851	1031	101499	0	111314
7372	5000	784	1069	105034	0	111887
7373	100973	751	1024	8508	0	111256
7374	102256	457	1091	5932	0	109736
7375	7403	465	1011	100313	0	109192
7376	4654	96221	1163	7880	0	109918
7377	4163	4140	826	100918	0	110047
7378	3294	1633	760	105259	0	110946
7379	2551	1496	96298	9218	0	109563
7380	2468	1000	4124	102893	0	110485
7381	93651	774	2035	9188	0	105648
7382	5006	95956	2017	5681	0	108660
7383	95675	4095	1164	5075	0	106009
7384	97142	1776	900	4220	0	104038
7385	98796	1757	792	3764	0	105109
7386	8335	1824	783	91849	0	102791
7387	5241	1032	78406	5851	0	90530
7388	4252	979	75180	3366	0	83777
7389	2783	74289	4246	3608	0	84926
7390	1447	55412	1433	1844	0	60136
7391	850	43477	638	842	0	45807
7392	769	42379	716	872	0	44736
7393	1155	1266	40753	815	0	43989
7394	33543	884	1552	531	0	36510
7395	781	192	219	34378	0	35570
7396	386	156	126	34164	0	34832
7397	362	112	95	34009	0	34578
7398	242	33958	130	794	0	35124
7399	32874	543	143	486	0	34046
7400	626	170	33020	333	0	34149
7401	192	31181	431	195	0	31999
7402	229	401	185	31819	0	32634
7403	31752	124	128	580	0	32584
7404	501	97	90	31830	0	32518
7405	216	95	31089	531	0	31931
7406	190	94	30708	262	0	31254
7407	228	67	457	32103	0	32855
7408	182	47	177	32517	0	32923
7409	32208	34	114	702	0	33058
7410	484	61	32192	282	0	33019
7411	30957	51	402	312	0	31722
7412	31859	51	140	262	0	32312
7413	582	44	137	32156	0	32919
7414	230	113	32654	500	0	33497
7415	220	48	411	32702	0	33381
7416	32870	34	149	650	0	33703
7417	460	32614	144	257	0	33475
7418	33595	400	95	297	0	34387
7419	598	155	85	33844	0	34682
7420	222	35818	77	574	0	36691
7421	229	515	84	36235	0	37063
7422	227	163	82	36769	0	37241
7423	139	37033	94	760	0	38026
7424	244	555	72	37927	0	38798
7425	238	173	68	38682	0	39161
7426	207	123	81	39755	0	40166
7427	115	105	39426	937	0	40583
7428	91	39192	682	391	0	40356
7429	39988	670	187	365	0	41210
7430	836	213	136	40865	0	42050
7431	258	43696	106	806	0	44866
7432	46520	843	66	444	0	47873
7433	1100	262	71	46953	0	48386
7434	444	186	53	47497	0	48180
7435	422	122	71	47092	0	47707
7436	309	118	51	46555	0	47033
7437	45820	105	52	1565	0	47542
7438	1147	79	57	46637	0	47920
7439	470	101	54	47514	0	48139
7440	46595	94	53	1590	0	48332
7441	1204	89	55	46993	0	48341
7442	408	120	46305	1425	0	48258
7443	436	91	957	46644	0	48128
7444	45429	98	284	1518	0	47329
7445	1206	112	181	46016	0	47515
7446	451	109	45971	1418	0	47949
7447	341	101	44553	687	0	45682
7448	45360	89	1286	674	0	47409
7449	48290	82	446	622	0	49440
7450	48687	77	279	523	0	49566
7451	48836	93	189	507	0	49625
7452	1637	90	48016	365	0	50108
7453	814	63	1086	47304	0	49267
7454	642	65	379	49061	0	50147
7455	48434	67	265	1636	0	50402
7456	1380	65	225	49169	0	50839
7457	515	68	48708	1483	0	50774
7458	534	86	1108	49166	0	50894
7459	330	103	49963	1505	0	51901
7460	286	50209	1259	649	0	52403
7461	51297	1021	489	666	0	53473
7462	1418	272	322	51651	0	53663
7463	559	216	51299	1406	0	53480
7464	605	118	1217	51331	0	53271
7465	497	99	432	54152	0	55180
7466	310	140	53750	1775	0	55975
7467	482	99	1355	53768	0	55704
7468	53174	117	500	1985	0	55776
7469	1471	157	49163	869	0	51660
7470	48983	101	1095	922	0	51101
7471	1483	50286	495	610	0	52874
7472	610	1142	50250	537	0	52539
7473	500	482	51233	488	0	52703
7474	924	682	1762	41404	0	44772
7475	531	182	621	48427	0	49761
7476	345	170	48990	1651	0	51156
7477	396	149	1360	48802	0	50707
7478	49075	115	562	1848	0	51600
7479	49760	101	458	1039	0	51358
7480	1606	112	394	48580	0	50692
7481	824	109	347	48283	0	49563
7482	604	48735	303	1757	0	51399
7483	49920	1125	323	1129	0	52497
7484	1625	326	314	49882	0	52147
7485	656	51315	283	1698	0	53952
7486	51842	1210	309	1069	0	54430
7487	52222	410	347	1026	0	54005
7488	1740	53070	312	772	0	55894
7489	995	1319	263	52597	0	55174
7490	779	432	306	53062	0	54579
7491	597	346	50831	2059	0	53833
7492	704	269	1402	50617	0	52992
7493	50593	224	549	2097	0	53463
7494	1819	218	429	50416	0	52882
7495	807	194	49341	2103	0	52445
7496	48655	203	1527	1169	0	51554
7497	1852	174	620	49847	0	52493
7498	870	190	49233	2003	0	52296
7499	823	183	1552	49451	0	52009
7500	693	202	49481	2057	0	52433
7501	808	132	1647	49310	0	51897
7502	675	164	725	50939	0	52503
7503	49382	136	638	2362	0	52518
7504	1622	49414	581	1339	0	52956
7505	50268	1295	547	1156	0	53266
7506	50117	420	485	1091	0	52113
7507	50120	263	474	1017	0	51874
7508	2147	48955	503	832	0	52437
7509	1108	1424	49093	681	0	52306
7510	1051	492	1576	48828	0	51947
7511	49919	355	729	1940	0	52943
7512	50784	308	650	1046	0	52788
7513	2231	246	505	49327	0	52309
7514	49211	232	561	2063	0	52067
7515	1978	224	48461	1159	0	51822
7516	47643	228	1605	1121	0	50597
7517	2100	219	48318	851	0	51488
7518	1100	47031	1683	795	0	50609
7519	47356	1235	720	818	0	50129
7520	45791	481	624	781	0	47677
7521	2003	45183	593	689	0	48468
7522	45338	1361	532	769	0	48000
7523	44334	495	512	741	0	46082
7524	2019	358	42709	666	0	45752
7525	41025	276	1299	770	0	43370
7526	1716	253	40701	592	0	43262
7527	1040	503	1242	37516	0	40301
7528	843	39292	569	1212	0	41916
7529	789	973	39274	653	0	41689
7530	35538	1009	1445	896	0	38888
7531	34967	354	621	611	0	36553
7532	1275	215	336	32644	0	34470
7533	655	213	32343	861	0	34072
7534	621	200	843	32161	0	33825
7535	32130	173	395	1033	0	33731
7536	1031	32344	333	489	0	34197
7537	31862	701	259	441	0	33263
7538	32322	243	235	374	0	33174
7539	1128	31661	247	313	0	33349
7540	667	694	236	31987	0	33584
7541	32650	289	238	923	0	34100
7542	1111	220	217	32952	0	34500
7543	654	204	235	34635	0	35728
7544	535	217	34526	1035	0	36313
7545	613	182	772	33936	0	35503
7546	558	166	310	34461	0	35495
7547	33505	165	233	1161	0	35064
7548	33933	145	216	603	0	34897
7549	1305	162	234	33494	0	35195
7550	617	156	32515	1020	0	34308
7551	559	143	31923	464	0	33089
7552	535	177	966	31968	0	33646
7553	498	183	32948	979	0	34608
7554	477	172	911	32230	0	33790
7555	457	122	415	32255	0	33249
7556	32412	125	298	1131	0	33966
7557	990	102	31865	539	0	33496
7558	30871	87	863	481	0	32302
7559	31083	102	352	470	0	32007
7560	1092	95	29761	378	0	31326
7561	559	96	29727	290	0	30672
7562	513	1115	841	27542	0	30011
7563	461	27250	375	695	0	28781
7564	432	28357	260	321	0	29370
7565	534	653	236	25957	0	27380
7566	356	162	179	25282	0	25979
7567	295	105	168	26493	0	27061
7568	258	73	177	26884	0	27392
7569	25847	62	165	822	0	26896
7570	702	76	168	26015	0	26961
7571	285	97	25464	702	0	26548
7572	318	74	532	24588	0	25512
7573	270	24532	215	597	0	25614
7574	300	447	163	24723	0	25633
7575	24583	122	165	676	0	25546
7576	668	92	174	24756	0	25690
7577	266	83	24598	631	0	25578
7578	174	23914	547	295	0	24930
7579	219	453	219	24412	0	25303
7580	24305	140	125	703	0	25273
7581	24613	108	137	345	0	25203
7582	771	65	114	24551	0	25501
7583	312	76	22909	564	0	23861
7584	225	77	21317	258	0	21877
7585	21412	48	543	259	0	22262
7586	568	54	22193	177	0	22992
7587	195	42	21855	162	0	22254
7588	202	90	420	20372	0	21084
7589	21536	26	158	490	0	22210
7590	20910	31	122	264	0	21327
7591	21149	34	99	224	0	21506
7592	507	72	21824	137	0	22540
7593	196	37	22659	161	0	23053
7594	133	24461	438	168	0	25200
7595	173	328	181	24279	0	24961
7596	136	64	154	25035	0	25389
7597	170	51	146	23965	0	24332
7598	184	24	128	25294	0	25630
7599	155	39	25312	559	0	26065
7600	162	25980	426	246	0	26814
7601	28122	343	194	268	0	28927
7602	30654	84	166	290	0	31194
7603	31548	45	157	258	0	32008
7604	827	31568	158	205	0	32758
7605	308	655	141	31060	0	32164
7606	32225	128	126	862	0	33341
7607	771	33771	120	290	0	34952
7608	33347	742	103	331	0	34523
7609	866	33636	137	167	0	34806
7610	33828	797	116	245	0	34986
7611	34390	215	144	211	0	34960
7612	1074	163	122	34652	0	36011
7613	457	95	126	36404	0	37082
7614	274	185	35727	1039	0	37225
7615	233	154	34620	409	0	35416
7616	34943	146	1014	370	0	36473
7617	36755	132	307	305	0	37499
7618	1264	134	183	35789	0	37370
7619	564	86	141	36633	0	37424
7620	354	90	35777	1262	0	37483
7621	364	141	925	35154	0	36584
7622	257	145	35479	1182	0	37063
7623	414	142	981	35255	0	36792
7624	382	132	311	36897	0	37722
7625	36122	122	209	1405	0	37858
7626	36334	126	150	674	0	37284
7627	1297	122	191	36092	0	37702
7628	611	93	191	36673	0	37568
7629	373	128	35834	1314	0	37649
7630	420	96	987	35948	0	37451
7631	334	111	36148	1294	0	37887
7632	35509	119	1066	654	0	37348
7633	1307	80	376	36647	0	38410
7634	36145	89	288	1317	0	37839
7635	1182	36080	266	623	0	38151
7636	36714	892	289	550	0	38445
7637	1274	263	315	36569	0	38421
7638	592	169	256	36291	0	37308
7639	482	36274	281	1226	0	38263
7640	522	935	209	36772	0	38438
7641	360	283	36272	1274	0	38189
7642	481	183	958	35898	0	37520
7643	318	132	34933	1185	0	36568
7644	265	33929	989	588	0	35771
7645	307	789	424	34391	0	35911
7646	264	243	34391	1097	0	35995
7647	255	198	33784	524	0	34761
7648	384	141	1076	33414	0	35015
7649	33317	103	508	1149	0	35077
7650	967	114	33265	551	0	34897
7651	480	96	946	32851	0	34373
7652	33309	126	357	1230	0	35022
7653	950	32513	302	558	0	34323
7654	33995	834	276	583	0	35688
7655	1082	255	218	34020	0	35575
7656	541	205	190	34693	0	35629
7657	451	163	183	35387	0	36184
7658	34596	146	224	1486	0	36452
7659	1075	120	202	35195	0	36592
7660	496	118	260	36125	0	36999
7661	34453	139	226	1395	0	36213
7662	1051	150	34399	709	0	36309
7663	567	112	950	34643	0	36272
7664	366	146	34597	1216	0	36325
7665	33563	124	1028	697	0	35412
7666	1207	159	371	34656	0	36393
7667	567	172	35096	1188	0	37023
7668	33395	165	963	728	0	35251
7669	35187	148	389	631	0	36355
7670	1274	181	36144	559	0	38158
7671	662	155	957	35846	0	37620
7672	566	133	464	37032	0	38195
7673	384	158	37709	1422	0	39673
7674	385	37119	1028	801	0	39333
7675	452	845	38320	569	0	40186
7676	35861	285	1065	692	0	37903
7677	1086	177	39259	566	0	41088
7678	36851	124	1140	691	0	38806
7679	1173	90	39431	543	0	41237
7680	37332	70	1147	668	0	39217
7681	1115	39834	623	489	0	42061
7682	610	810	402	39530	0	41352
7683	602	228	382	41205	0	42417
7684	424	182	41050	1343	0	42999
7685	506	122	1034	38983	0	40645
7686	413	39974	477	1200	0	42064
7687	39608	761	412	743	0	41524
7688	975	40153	335	666	0	42129
7689	496	870	349	40953	0	42668
7690	41119	252	323	1365	0	43059
7691	1098	41433	338	738	0	43607
7692	40285	918	361	583	0	42147
7693	1231	348	40927	498	0	43004
7694	657	225	1082	40198	0	42162
7695	580	174	519	40909	0	42182
7696	463	193	419	42420	0	43495
7697	41669	165	316	1634	0	43784
7698	41919	181	358	801	0	43259
7699	41961	179	299	627	0	43066
7700	40892	181	304	559	0	41936
7701	1308	132	37656	407	0	39503
7702	32690	83	567	358	0	33698
7703	767	33839	280	246	0	35132
7704	350	34530	219	226	0	35325
7705	35236	588	633	371	0	36828
7706	35955	147	302	306	0	36710
7707	678	69	103	34726	0	35576
7708	35443	63	101	621	0	36228
7709	35545	65	98	277	0	35985
7710	38696	63	98	241	0	39098
7711	875	56	90	38171	0	39192
7712	301	37138	93	581	0	38113
7713	134	38021	70	199	0	38424
7714	226	606	58	37971	0	38861
7715	37610	145	90	625	0	38470
7716	536	38255	65	188	0	39044
7717	222	493	49	38258	0	39022
7718	171	145	38561	480	0	39357
7719	34241	86	470	381	0	35178
7720	526	38293	136	154	0	39109
7721	193	39527	92	95	0	39907
7722	38501	557	58	211	0	39327
7723	541	182	39633	116	0	40472
7724	290	82	467	38275	0	39114
7725	167	39708	125	455	0	40455
7726	193	499	76	40228	0	40996
7727	208	156	53	39908	0	40325
7728	208	33709	164	640	0	34721
7729	206	489	63	41523	0	42281
7730	189	170	48	41919	0	42326
7731	41323	136	54	727	0	42240
7732	530	41104	69	233	0	41936
7733	41326	527	64	274	0	42191
7734	656	198	37	41107	0	41998
7735	210	41748	57	577	0	42592
7736	189	536	41844	189	0	42758
7737	305	222	545	41932	0	43004
7738	263	131	134	43985	0	44513
7739	134	128	44680	698	0	45640
7740	41202	101	631	406	0	42340
7741	795	112	164	47605	0	48676
7742	47337	103	114	1007	0	48561
7743	898	107	46378	297	0	47680
7744	404	115	786	46428	0	47733
7745	218	120	48892	927	0	50157
7746	325	116	881	48773	0	50095
7747	254	139	252	50642	0	51287
7748	50184	93	151	1200	0	51628
7749	849	50451	134	412	0	51846
7750	50490	861	72	428	0	51851
7751	1009	276	50755	184	0	52224
7752	468	186	859	50406	0	51919
7753	214	158	52402	973	0	53747
7754	44340	110	1012	671	0	46133
7755	51037	113	294	458	0	51902
7756	1144	119	51703	233	0	53199
7757	49869	92	975	385	0	51321
7758	52815	105	302	376	0	53598
7759	1233	91	230	52154	0	53708
7760	487	97	51249	1032	0	52865
7761	371	140	52844	429	0	53784
7762	380	112	1113	53171	0	54776
7763	422	107	411	53061	0	54001
7764	320	52442	287	1097	0	54146
7765	241	54593	232	568	0	55634
7766	54259	1021	210	496	0	55986
7767	1161	372	228	53411	0	55172
7768	456	52621	205	1038	0	54320
7769	334	54903	227	476	0	55940
7770	51851	1091	223	447	0	53612
7771	1187	437	190	52819	0	54633
7772	506	53450	192	1065	0	55213
7773	490	972	200	53347	0	55009
7774	420	377	196	53391	0	54384
7775	397	232	219	53145	0	53993
7776	51770	158	154	1565	0	53647
7777	1021	51485	213	618	0	53337
7778	540	1032	208	51729	0	53509
7779	492	368	178	52191	0	53229
7780	437	243	158	52515	0	53353
7781	236	260	50100	1447	0	52043
7782	46694	213	984	803	0	48694
7783	1142	219	379	50222	0	51962
7784	49119	176	239	1387	0	50921
7785	49253	179	242	693	0	50367
7786	49012	238	182	584	0	50016
7787	1353	232	48368	448	0	50401
7788	587	48028	957	430	0	50002
7789	463	926	318	47641	0	49348
7790	313	405	47612	1046	0	49376
7791	341	304	45650	512	0	46807
7792	425	300	982	44589	0	46296
7793	228	44942	419	980	0	46569
7794	45483	863	287	696	0	47329
7795	45733	298	206	681	0	46918
7796	45901	252	184	586	0	46923
7797	45388	183	164	563	0	46298
7798	1265	214	44215	384	0	46078
7799	42845	174	850	521	0	44390
7800	1110	45076	393	384	0	46963
7801	605	806	267	45909	0	47587
7802	465	330	249	46843	0	47887
7803	46378	218	255	1330	0	48181
7804	1143	128	240	46466	0	47977
7805	516	156	44801	1143	0	46616
7806	41844	162	907	655	0	43568
7807	44012	161	363	574	0	45110
7808	43594	139	295	531	0	44559
7809	1282	155	42408	323	0	44168
7810	38183	121	752	439	0	39495
7811	931	39563	375	304	0	41173
7812	40392	656	335	406	0	41789
7813	1019	332	252	39422	0	41025
7814	516	237	148	39810	0	40711
7815	398	39323	223	886	0	40830
7816	441	675	149	39461	0	40726
7817	324	39589	183	848	0	40944
7818	399	815	153	39112	0	40479
7819	345	39155	163	855	0	40518
7820	421	733	152	39378	0	40684
7821	340	39946	171	865	0	41322
7822	418	836	141	42072	0	43467
7823	311	42998	186	960	0	44455
7824	45678	922	132	632	0	47364
7825	1312	377	98	46345	0	48132
7826	595	327	120	47097	0	48139
7827	529	199	124	48822	0	49674
7828	435	180	112	48988	0	49715
7829	316	244	48559	1832	0	50951
7830	436	198	1176	48822	0	50632
7831	428	187	407	50064	0	51086
7832	48681	189	189	1838	0	50897
7833	48374	179	142	946	0	49641
7834	1569	49483	156	555	0	51763
7835	837	1209	123	49388	0	51557
7836	628	460	101	52671	0	53860
7837	52856	274	132	2043	0	55305
7838	1707	269	48228	834	0	51038
7839	48608	156	1081	699	0	50544
7840	1605	51030	381	474	0	53490
7841	48143	1181	156	397	0	49877
7842	48236	416	96	356	0	49104
7843	1664	47029	129	224	0	49046
7844	609	49413	122	210	0	50354
7845	679	1615	128	46278	0	48700
7846	290	553	46084	1244	0	48171
7847	44406	255	1153	643	0	46457
7848	1300	213	45987	255	0	47755
7849	44252	180	1257	358	0	46047
7850	1365	142	45763	221	0	47491
7851	627	45221	1253	210	0	47311
7852	494	1166	499	45343	0	47502
7853	44290	435	233	1266	0	46224
7854	45515	279	164	581	0	46539
7855	1800	171	131	45362	0	47464
7856	47015	136	116	1394	0	48661
7857	47099	174	95	613	0	47981
7858	1839	46161	118	278	0	48396
7859	46665	1302	86	385	0	48438
7860	1617	46995	159	234	0	49005
7861	891	1400	116	46156	0	48563
7862	45480	506	152	1540	0	47678
7863	47352	308	110	599	0	48369
7864	47283	220	120	411	0	48034
7865	1970	222	46412	243	0	48847
7866	825	204	47460	233	0	48722
7867	689	160	1695	47955	0	50499
7868	680	152	592	50166	0	51590
7869	428	53111	301	1848	0	55688
7870	53593	1636	209	822	0	56260
7871	2041	662	182	53468	0	56353
7872	1042	418	139	54582	0	56181
7873	626	278	53486	2308	0	56698
7874	464	51046	1617	1038	0	54165
7875	413	54608	613	652	0	56286
7876	602	2035	252	54386	0	57275
7877	54033	793	199	2073	0	57098
7878	2023	441	252	53898	0	56614
7879	964	329	272	56303	0	57868
7880	54907	295	267	2677	0	58146
7881	56310	267	212	1345	0	58134
7882	2675	265	171	55651	0	58762
7883	1240	377	54814	2142	0	58573
7884	926	277	1678	55836	0	58717
7885	738	221	707	57352	0	59018
7886	56077	208	369	2948	0	59602
7887	2225	226	290	56980	0	59721
7888	56905	264	259	2646	0	60074
7889	2390	321	56797	1320	0	60828
7890	1353	260	1821	58349	0	61783
7891	1002	222	743	60687	0	62654
7892	833	295	414	61644	0	63186
7893	852	296	286	61056	0	62490
7894	895	308	267	60279	0	61749
7895	715	336	57794	3218	0	62063
7896	57096	249	1940	1816	0	61101
7897	2347	255	910	58587	0	62099
7898	1222	260	57489	2660	0	61631
7899	888	288	58139	1557	0	60872
7900	962	321	2438	57719	0	61440
7901	57477	299	1077	2666	0	61519
7902	58224	310	638	1526	0	60698
7903	59250	363	531	1194	0	61338
7904	3321	343	457	54637	0	58758
7905	1646	56817	470	2489	0	61422
7906	58728	1947	442	1604	0	62721
7907	59976	890	468	1220	0	62554
7908	60322	561	480	1120	0	62483
7909	60586	440	471	937	0	62434
7910	3509	387	433	58216	0	62545
7911	1824	400	57576	2650	0	62450
7912	1419	322	2073	58045	0	61859
7913	1175	370	57943	2782	0	62270
7914	57451	321	2120	1692	0	61584
7915	59404	246	1003	1341	0	61994
7916	3330	193	56935	1153	0	61611
7917	56813	213	2086	1271	0	60383
7918	59678	240	1033	1250	0	62201
7919	3465	301	658	56959	0	61383
7920	1914	56996	547	2460	0	61917
7921	57854	1798	493	1485	0	61630
7922	2848	1135	467	53290	0	57740
7923	1590	52482	409	2364	0	56845
7924	1154	1527	373	51971	0	55025
7925	961	624	52384	2198	0	56167
7926	901	52929	1513	1343	0	56686
7927	51866	1512	861	1088	0	55327
7928	52063	673	605	1098	0	54439
7929	50959	339	467	860	0	52625
7930	51421	229	443	903	0	52996
7931	2424	445	415	48918	0	52202
7932	1370	48787	401	1747	0	52305
7933	45457	1248	445	1216	0	48366
7934	1867	595	47609	771	0	50842
7935	1186	45821	1301	711	0	49019
7936	884	1055	44013	619	0	46571
7937	772	420	1096	40657	0	42945
7938	733	35433	682	1191	0	38039
7939	730	911	393	42668	0	44702
7940	758	496	44382	1242	0	46878
7941	836	320	979	42678	0	44813
7942	789	228	545	45037	0	46599
7943	727	215	370	46026	0	47338
7944	44239	217	343	1653	0	46452
7945	1342	44093	300	1043	0	46778
7946	952	876	318	44649	0	46795
7947	43716	393	370	1433	0	45912
7948	1256	43943	427	908	0	46534
7949	44016	923	350	812	0	46101
7950	1431	467	44480	670	0	47048
7951	1078	351	967	42626	0	45022
7952	876	44286	534	1079	0	46775
7953	44572	901	386	774	0	46633
7954	1443	487	43530	563	0	46023
7955	1013	39991	981	607	0	42592
7956	766	813	434	41763	0	43776
7957	596	455	333	42639	0	44023
7958	41770	335	291	1266	0	43662
7959	1152	259	270	41562	0	43243
7960	743	295	40702	1084	0	42824
7961	739	275	721	39882	0	41617
7962	619	247	41595	972	0	43433
7963	668	370	804	39024	0	40866
7964	582	41017	443	869	0	42911
7965	40897	647	293	633	0	42470
7966	39789	361	251	491	0	40892
7967	1094	37526	206	330	0	39156
7968	425	35854	200	245	0	36724
7969	569	397	183	34627	0	35776
7970	34239	160	124	470	0	34993
7971	526	157	109	34061	0	34853
7972	33971	111	101	483	0	34666
7973	464	33187	94	201	0	33946
7974	312	310	84	34316	0	35022
7975	233	201	34946	355	0	35735
7976	284	150	324	34093	0	34851
7977	267	108	137	35260	0	35772
7978	35919	103	112	551	0	36685
7979	381	36536	86	256	0	37259
7980	248	320	85	37072	0	37725
7981	36661	149	82	506	0	37398
7982	400	149	37023	172	0	37744
7983	35638	95	301	332	0	36366
7984	469	174	126	37405	0	38174
7985	233	38553	109	321	0	39216
7986	38216	299	67	309	0	38891
7987	408	147	39371	122	0	40048
7988	211	127	37896	110	0	38344
7989	163	38905	340	74	0	39482
7990	38163	199	288	142	0	38792
7991	245	74	41	38507	0	38867
7992	144	40	27	38331	0	38542
7993	38631	17	31	459	0	39138
7994	322	45	38758	160	0	39285
7995	190	44	281	39164	0	39679
7996	108	49	41196	338	0	41691
7997	134	23	367	40539	0	41063
7998	53	41067	168	372	0	41660
7999	123	324	91	42472	0	43010
8000	51	138	41995	410	0	42594
8001	40155	86	355	283	0	40879
8002	442	40	150	43062	0	43694
8003	159	72	43023	413	0	43667
8004	189	44	393	41684	0	42310
8005	144	31	160	42316	0	42651
8006	72	51	41424	533	0	42080
8007	85	61	40630	273	0	41049
8008	148	48	500	42048	0	42744
8009	77	34	42644	464	0	43219
8010	40746	32	511	318	0	41607
8011	465	32	203	42893	0	43593
8012	42361	42	161	574	0	43138
8013	489	53	42062	227	0	42831
8014	274	31	436	42083	0	42824
8015	148	49	45345	475	0	46017
8016	111	44423	524	227	0	45285
8017	89	412	45386	180	0	46067
8018	94	148	43221	173	0	43636
8019	41929	92	612	272	0	42905
8020	44417	45	269	247	0	44978
8021	594	69	45572	120	0	46355
8022	441	45	530	42280	0	43296
8023	293	58	280	43801	0	44432
8024	137	47	45703	571	0	46458
8025	89	42798	521	365	0	43773
8026	41714	413	249	328	0	42704
8027	485	151	44168	129	0	44933
8028	299	111	509	43683	0	44602
8029	283	60	241	45020	0	45604
8030	46030	38	223	785	0	47076
8031	46571	56	147	482	0	47256
8032	46921	51	141	371	0	47484
8033	47327	37	153	282	0	47799
8034	785	39	167	47061	0	48052
8035	354	86	49874	589	0	50903
8036	356	29	642	49258	0	50285
8037	289	50	289	50260	0	50888
8038	277	36	200	52687	0	53200
8039	172	68	51648	932	0	52820
8040	47729	36	709	538	0	49012
8041	822	35	287	51248	0	52392
8042	315	76	52374	821	0	53586
8043	258	52623	786	388	0	54055
8044	281	619	313	53852	0	55065
8045	318	208	281	54631	0	55438
8046	53581	151	179	1122	0	55033
8047	774	54952	186	499	0	56411
8048	326	697	55550	342	0	56915
8049	440	211	806	54276	0	55733
8050	311	166	308	55327	0	56112
8051	54738	66	283	1203	0	56290
8052	54425	78	207	648	0	55358
8053	1058	102	165	55553	0	56878
8054	55098	54	202	1066	0	56420
8055	895	54173	212	472	0	55752
8056	411	720	57431	367	0	58929
8057	499	245	837	56927	0	58508
8058	352	161	355	59488	0	60356
8059	327	102	260	59778	0	60467
8060	346	90	168	58702	0	59306
8061	216	57663	219	1196	0	59294
8062	56924	765	191	726	0	58606
8063	972	249	196	56656	0	58073
8064	393	58390	171	998	0	59952
8065	58944	781	191	670	0	60586
8066	58879	276	150	592	0	59897
8067	1056	60507	176	360	0	62099
8068	644	849	150	62286	0	63929
8069	469	301	174	63314	0	64258
8070	428	241	160	61844	0	62673
8071	411	149	148	63802	0	64510
8072	65650	101	147	1553	0	67451
8073	66273	146	155	890	0	67464
8074	1422	67102	161	542	0	69227
8075	563	1203	66686	430	0	68882
8076	550	343	1215	66833	0	68941
8077	67790	268	352	1623	0	70033
8078	1421	65560	278	703	0	67962
8079	523	67093	197	502	0	68315
8080	68340	1511	138	562	0	70551
8081	69582	518	143	472	0	70715
8082	2009	323	166	67961	0	70459
8083	726	250	68268	1611	0	70855
8084	605	232	67325	703	0	68865
8085	70537	229	1723	730	0	73219
8086	74635	221	589	598	0	76043
8087	74185	176	337	521	0	75219
8088	73597	166	246	498	0	74507
8089	73290	158	220	520	0	74188
8090	2005	72247	223	445	0	74920
8091	1083	1438	176	68919	0	71616
8092	603	74671	175	1227	0	76676
8093	76445	1439	154	731	0	78769
8094	75176	499	180	634	0	76489
8095	75226	302	132	545	0	76205
8096	75559	217	139	439	0	76354
8097	1796	74110	171	328	0	76405
8098	74161	1267	136	458	0	76022
8099	1630	74147	155	332	0	76264
8100	910	1427	120	74771	0	77228
8101	74330	381	94	1485	0	76290
8102	1652	362	75616	420	0	78050
8103	881	272	1141	73990	0	76284
8104	696	274	319	77050	0	78339
8105	512	327	77511	1464	0	79814
8106	442	77427	1200	692	0	79761
8107	78021	1274	341	602	0	80238
8108	77732	425	255	531	0	78943
8109	1695	77156	210	468	0	79529
8110	894	1327	173	76999	0	79393
8111	693	544	78599	1288	0	81124
8112	561	81278	1190	524	0	83553
8113	80749	1377	351	705	0	83182
8114	1557	577	81384	353	0	83871
8115	73105	369	1157	576	0	75207
8116	79040	288	354	505	0	80187
8117	1755	266	81837	351	0	84209
8118	750	81356	1287	343	0	83736
8119	856	1296	420	79851	0	82423
8120	594	491	84193	1197	0	86475
8121	77192	359	1261	697	0	79509
8122	82485	292	368	535	0	83680
8123	1709	82602	294	326	0	84931
8124	889	1244	249	82546	0	84928
8125	709	538	206	84594	0	86047
8126	555	441	84173	1355	0	86524
8127	511	84119	1197	553	0	86380
8128	87840	1272	360	753	0	90225
8129	88524	445	264	603	0	89836
8130	89449	346	232	561	0	90588
8131	1778	347	87690	299	0	90114
8132	84092	248	1119	539	0	85998
8133	89312	280	422	424	0	90438
8134	1842	275	299	88973	0	91389
8135	789	272	86269	1062	0	88392
8136	862	258	1040	84756	0	86916
8137	614	252	86574	1180	0	88620
8138	637	365	1043	82295	0	84340
8139	438	83519	450	1051	0	85458
8140	409	87788	288	423	0	88908
8141	545	1198	286	89002	0	91031
8142	639	453	227	85427	0	86746
8143	86358	301	208	1453	0	88320
8144	1245	307	86186	450	0	88188
8145	79948	203	1012	655	0	81818
8146	1209	86872	363	331	0	88775
8147	86770	1021	233	471	0	88495
8148	86901	388	270	408	0	87967
8149	1529	249	228	86351	0	88357
8150	736	258	88542	996	0	90532
8151	785	219	1019	87181	0	89204
8152	495	91836	422	1013	0	93766
8153	550	1158	273	93097	0	95078
8154	545	398	241	94412	0	95596
8155	92775	250	192	1644	0	94861
8156	1491	247	180	90685	0	92603
8157	629	88899	204	1293	0	91025
8158	594	1142	165	91207	0	93108
8159	91945	429	137	1587	0	94098
8160	1382	92262	212	631	0	94487
8161	687	1399	188	95497	0	97771
8162	634	482	182	96127	0	97425
8163	627	316	187	101295	0	102425
8164	591	278	165	100692	0	101726
8165	100290	227	166	2546	0	103229
8166	2082	210	181	101582	0	104055
8167	923	288	178	102346	0	103735
8168	713	302	139	102343	0	103497
8169	362	103049	192	2449	0	106052
8170	100094	1894	193	1409	0	103590
8171	2145	624	101976	722	0	105467
8172	642	98460	1661	521	0	101284
8173	94369	1622	478	687	0	97156
8174	1801	572	97678	303	0	100354
8175	559	97087	1570	302	0	99518
8176	747	2034	555	94353	0	97689
8177	346	97791	313	1352	0	99802
8178	262	1607	95794	487	0	98150
8179	291	626	94780	369	0	96066
8180	145	95699	1655	370	0	97869
8181	95177	1468	610	598	0	97853
8182	94906	497	337	623	0	96363
8183	1643	366	92518	232	0	94759
8184	654	256	84321	218	0	85449
8185	379	239	88684	156	0	89458
8186	542	174	1891	86662	0	89269
8187	492	162	694	86296	0	87644
8188	399	160	403	90837	0	91799
8189	233	194	92372	1930	0	94729
8190	530	125	1653	86847	0	89155
8191	374	183	558	92100	0	93215
8192	170	175	89869	2100	0	92314
8193	82735	146	1737	1232	0	85850
8194	1815	182	590	91052	0	93639
8195	847	154	410	89732	0	91143
8196	386	91713	371	2024	0	94494
8197	90886	1601	401	1175	0	94063
8198	1797	599	91260	581	0	94237
8199	88594	341	1753	729	0	91417
8200	2129	260	640	91135	0	94164
8201	766	357	92195	1921	0	95239
8202	711	231	1860	90185	0	92987
8203	90450	236	745	2441	0	93872
8204	1897	210	90188	891	0	93186
8205	85948	166	1972	994	0	89080
8206	89079	208	810	840	0	90937
8207	90159	157	557	735	0	91608
8208	2458	88689	570	488	0	92205
8209	1206	1722	421	90945	0	94294
8210	93651	570	344	2317	0	96882
8211	93927	376	413	1104	0	95820
8212	95392	312	364	931	0	96999
8213	2984	304	91374	587	0	95249
8214	96225	258	2013	781	0	99277
8215	3211	234	887	103427	0	107759
8216	1353	237	102895	3042	0	107527
8217	1215	181	2992	104019	0	108407
8218	1048	198	1047	106246	0	108539
8219	763	250	105499	4137	0	110649
8220	956	180	3463	104569	0	109168
8221	943	177	1309	108224	0	110653
8222	600	263	120004	4601	0	125468
8223	122798	238	4196	2528	0	129760
8224	135224	216	1814	1692	0	138946
8225	6371	180	1388	136543	0	144482
8226	3008	274	135887	5163	0	144332
8227	2928	216	5309	129500	0	137953
8228	2273	130794	2095	5774	0	140936
8229	2565	4335	1661	130932	0	139493
8230	1953	1524	1415	136931	0	141823
8231	132449	1193	1420	8151	0	143213
8232	132905	913	1269	5007	0	140094
8233	137170	1031	1156	3874	0	143231
8234	8144	838	937	133151	0	143070
8235	4684	684	774	137299	0	143441
8236	3693	637	130783	8083	0	143196
8237	3997	521	4997	125169	0	134684
8238	3170	129259	2180	7228	0	141837
8239	130571	4550	1714	4706	0	141541
8240	6178	128151	1596	4288	0	140213
8241	129668	5572	1695	3685	0	140620
8242	7316	2593	1421	120529	0	131859
8243	3537	127027	1248	6535	0	138347
8244	127454	5928	1146	3974	0	138502
8245	130390	3086	1107	3295	0	137878
8246	8693	2342	875	124747	0	136657
8247	4797	126297	1066	6668	0	138828
8248	4284	5993	911	127012	0	138200
8249	3590	2709	124798	7500	0	138597
8250	121473	2196	5274	4407	0	133350
8251	7033	124247	2323	3732	0	137335
8252	122022	5890	1727	3274	0	132913
8253	7594	2813	1440	122114	0	133961
8254	124080	2397	1604	7105	0	135186
8255	8176	1875	124273	3792	0	138116
8256	128294	1784	5574	3561	0	139213
8257	130620	1680	2515	3082	0	137897
8258	9804	1426	126492	3068	0	140790
8259	6855	1135	6025	123664	0	137679
8260	5773	878	3145	127641	0	137437
8261	123532	1219	2590	8540	0	135881
8262	8210	121008	2368	5095	0	136681
8263	4941	5633	2222	117021	0	129817
8264	4217	2418	114633	7660	0	128928
8265	3546	2062	114505	5031	0	125144
8266	3581	112318	6051	4387	0	126337
8267	3740	5316	113199	3808	0	126063
8268	108713	2921	6614	3650	0	121898
8269	6791	2302	3904	105825	0	118822
8270	109813	1736	3371	6771	0	121691
8271	6820	1971	108748	3973	0	121512
8272	4508	1704	6457	107686	0	120355
8273	4252	1696	3382	111352	0	120682
8274	3650	1601	107686	7864	0	120801
8275	4068	1415	5900	108952	0	120335
8276	105882	1681	3259	8006	0	118828
8277	110048	1314	2934	5351	0	119647
8278	7956	1129	2588	108134	0	119807
8279	107357	1188	2460	7820	0	118825
8280	108925	1204	2059	5258	0	117446
8281	9038	103171	2062	4476	0	118747
8282	6700	4548	1806	105311	0	118365
8283	107317	2135	1601	7646	0	118699
8284	8689	1954	1727	106663	0	119033
8285	106847	1625	1786	7988	0	118246
8286	8609	1899	1650	105399	0	117557
8287	5635	1787	102630	8347	0	118399
8288	4971	102223	5079	5651	0	117924
8289	5316	5005	2610	88706	0	101637
8290	4831	101412	2360	6854	0	115457
8291	100700	5549	2349	4884	0	113482
8292	7123	97588	2403	4296	0	111410
8293	4754	100427	2192	3709	0	111082
8294	4480	6797	1958	97122	0	110357
8295	97377	4519	1883	7017	0	110796
8296	7123	3622	1493	97997	0	110235
8297	97265	3282	1489	7810	0	109846
8298	97709	3200	1457	5089	0	107455
8299	8040	96564	1556	4564	0	110724
8300	99798	5726	1730	4092	0	111346
8301	101686	3144	1801	3922	0	110553
8302	102284	2827	1750	3428	0	110289
8303	10471	2416	92729	3145	0	108761
8304	7272	2346	4718	93720	0	108056
8305	6918	2027	2407	97727	0	109079
8306	5801	1989	89313	7409	0	104512
8307	95830	1765	4941	4952	0	107488
8308	99362	1466	3119	4699	0	108646
8309	98663	1387	2581	4443	0	107074
8310	94475	1267	2256	4420	0	102418
8311	9659	87618	2040	3998	0	103315
8312	89913	4114	1469	3278	0	98774
8313	10016	2205	1397	84827	0	98445
8314	6989	1880	71564	5406	0	85839
8315	75863	1407	2881	3279	0	83430
8316	7650	74376	1660	2772	0	86458
8317	71571	3539	1529	2477	0	79116
8318	6595	67902	1164	2665	0	78326
8319	4587	65311	1087	2700	0	73685
8320	4290	64871	1261	2484	0	72906
8321	3885	65785	1416	2349	0	73435
8322	3024	3440	51172	1695	0	59331
8323	2445	3620	2341	40662	0	49068
8324	1234	830	37879	1763	0	41706
8325	31638	598	1171	940	0	34347
8326	1400	32316	608	747	0	35071
8327	843	33047	391	734	0	35015
8328	890	1356	377	31537	0	34160
8329	919	885	237	32122	0	34163
8330	686	775	31136	1365	0	33962
8331	647	697	31007	780	0	33131
8332	752	607	1055	31048	0	33462
8333	670	475	31521	1268	0	33934
8334	786	31535	1081	756	0	34158
8335	978	995	545	30283	0	32801
8336	900	590	392	33440	0	35322
8337	918	428	32678	1340	0	35364
8338	992	324	946	32245	0	34507
8339	32849	298	530	1319	0	34996
8340	1464	323	455	32478	0	34720
8341	867	268	440	32846	0	34421
8342	612	310	31743	1758	0	34423
8343	29805	235	1069	1072	0	32181
8344	1481	31903	591	695	0	34670
8345	1197	874	280	31718	0	34069
8346	1084	436	31592	1108	0	34220
8347	1058	416	860	31358	0	33692
8348	31816	458	398	1211	0	33883
8349	1555	419	31668	712	0	34354
8350	1047	457	938	31281	0	33723
8351	745	369	32266	1222	0	34602
8352	795	31869	999	790	0	34453
8353	737	967	31472	562	0	33738
8354	617	30583	944	529	0	32673
8355	357	677	26476	239	0	27749
8356	339	574	570	23007	0	24490
8357	158	24476	293	454	0	25381
8358	24086	495	135	290	0	25006
8359	495	254	127	24322	0	25198
8360	24753	184	119	529	0	25585
8361	596	150	108	25334	0	26188
8362	336	145	108	25997	0	26586
8363	25670	119	116	695	0	26600
8364	26088	100	107	365	0	26660
8365	758	110	104	26809	0	27781
8366	371	105	27554	541	0	28571
8367	270	27139	501	289	0	28199
8368	221	514	27595	203	0	28533
8369	222	28117	525	164	0	29028
8370	27702	493	222	248	0	28665
8371	579	225	27553	157	0	28514
8372	297	134	27363	160	0	27954
8373	248	98	625	26402	0	27373
8374	27149	93	270	602	0	28114
8375	587	98	28282	279	0	29246
8376	346	29966	524	174	0	31010
8377	31142	479	230	241	0	32092
8378	31735	205	146	241	0	32327
8379	32114	129	145	243	0	32631
8380	32273	138	135	182	0	32728
8381	31918	147	117	179	0	32361
8382	747	132	31643	140	0	32662
8383	387	194	494	30043	0	31118
8384	241	30512	258	403	0	31414
8385	31641	447	180	281	0	32549
8386	507	31919	142	122	0	32690
8387	30498	417	99	183	0	31197
8388	30340	167	107	166	0	30780
8389	523	30188	121	124	0	30956
8390	30751	412	90	167	0	31420
8391	551	176	91	30620	0	31438
8392	316	117	84	31046	0	31563
8393	216	92	30417	516	0	31241
8394	173	31031	428	245	0	31877
8395	192	429	196	31281	0	32098
8396	197	190	133	31865	0	32385
8397	179	128	90	32083	0	32480
8398	139	105	31109	574	0	31927
8399	28781	100	427	347	0	29655
8400	524	93	188	31301	0	32106
8401	31429	66	131	523	0	32149
8402	580	74	90	31357	0	32101
8403	286	84	31555	517	0	32442
8404	205	85	30902	275	0	31467
8405	29447	82	561	304	0	30394
8406	31586	75	244	232	0	32137
8407	589	30979	173	129	0	31870
8408	287	428	31100	113	0	31928
8409	252	190	433	30096	0	30971
8410	518	211	432	22735	0	23896
8411	32174	87	149	659	0	33069
8412	32231	75	97	335	0	32738
8413	32170	62	88	263	0	32583
8414	635	76	31700	165	0	32576
8415	31832	59	420	244	0	32555
8416	583	66	204	32369	0	33222
8417	336	67	157	32427	0	32987
8418	275	72	122	32531	0	33000
8419	183	32145	123	589	0	33040
8420	31699	380	105	333	0	32517
8421	512	198	110	31721	0	32541
8422	277	131	31147	467	0	32022
8423	270	84	411	30403	0	31168
8424	190	31017	221	495	0	31923
8425	31310	395	167	342	0	32214
8426	564	175	116	31185	0	32040
8427	355	111	106	31017	0	31589
8428	252	99	31058	580	0	31989
8429	239	93	406	30443	0	31181
8430	196	31059	197	530	0	31982
8431	231	398	139	31773	0	32541
8432	196	204	31579	510	0	32489
8433	27299	110	389	423	0	28221
8434	30085	69	181	299	0	30634
8435	522	30708	160	178	0	31568
8436	29948	310	109	226	0	30593
8437	31148	151	88	218	0	31605
8438	561	31182	86	150	0	31979
8439	316	417	72	31349	0	32154
8440	31973	146	86	567	0	32772
8441	481	32778	84	228	0	33571
8442	206	441	32985	171	0	33803
8443	32235	158	449	241	0	33083
8444	34129	110	161	247	0	34647
8445	34217	71	122	209	0	34619
8446	34224	73	77	199	0	34573
8447	670	35081	82	102	0	35935
8448	35680	410	43	227	0	36360
8449	36881	162	60	195	0	37298
8450	37462	104	55	179	0	37800
8451	816	66	64	37281	0	38227
8452	36891	80	45	700	0	37716
8453	619	38292	67	251	0	39229
8454	266	599	40036	154	0	41055
8455	338	206	628	40723	0	41895
8456	41228	112	205	848	0	42393
8457	851	87	41764	236	0	42938
8458	439	67	727	41480	0	42713
8459	263	78	41800	779	0	42920
8460	184	41645	767	294	0	42890
8461	279	735	244	40639	0	41897
8462	182	226	41067	784	0	42259
8463	148	40732	731	271	0	41882
8464	313	747	236	40332	0	41628
8465	41070	202	186	901	0	42359
8466	41356	111	126	379	0	41972
8467	41766	112	96	270	0	42244
8468	41569	65	92	304	0	42030
8469	41435	65	95	227	0	41822
8470	982	99	41666	98	0	42845
8471	41397	56	679	259	0	42391
8472	43632	69	217	227	0	44145
8473	1053	83	135	43238	0	44509
8474	43506	89	96	813	0	44504
8475	42016	61	101	341	0	42519
8476	931	40252	114	157	0	41454
8477	501	683	87	40558	0	41829
8478	426	165	73	41312	0	41976
8479	40987	96	71	989	0	42143
8480	909	40571	80	324	0	41884
8481	395	42343	83	217	0	43038
8482	448	891	64	43114	0	44517
8483	376	293	94	43766	0	44529
8484	377	170	92	43170	0	43809
8485	347	119	61	44214	0	44741
8486	42793	105	50	1304	0	44252
8487	42653	109	47	578	0	43387
8488	1192	136	43040	284	0	44652
8489	602	127	791	42084	0	43604
8490	413	102	208	43730	0	44453
8491	270	100	42889	1147	0	44406
8492	40590	81	865	592	0	42128
8493	993	42677	242	337	0	44249
8494	42552	867	141	322	0	43882
8495	1143	260	116	42301	0	43820
8496	426	175	42463	1018	0	44082
8497	390	159	844	42660	0	44053
8498	274	139	44446	1051	0	45910
8499	270	44806	894	433	0	46403
8500	44225	825	365	424	0	45839
8501	44768	234	188	339	0	45529
8502	1066	44691	170	226	0	46153
8503	503	843	127	44428	0	45901
8504	43970	240	136	1046	0	45392
8505	962	43742	180	353	0	45237
8506	481	890	122	44246	0	45739
8507	44400	284	95	1040	0	45819
8508	1069	216	43613	346	0	45244
8509	42393	171	820	438	0	43822
8510	1028	44360	301	271	0	45960
8511	44548	867	194	333	0	45942
8512	44649	299	172	333	0	45453
8513	1211	234	44020	217	0	45682
8514	666	188	825	42284	0	43963
8515	484	156	277	44753	0	45670
8516	378	169	44363	1080	0	45990
8517	419	149	886	43161	0	44615
8518	537	173	366	40280	0	41356
8519	44914	134	183	1245	0	46476
8520	45259	116	200	545	0	46120
8521	1234	114	174	44635	0	46157
8522	541	139	44749	1029	0	46458
8523	467	154	854	44616	0	46091
8524	446	126	289	45651	0	46512
8525	346	121	45866	1209	0	47542
8526	412	104	900	46361	0	47777
8527	45971	95	316	1254	0	47636
8528	46317	94	201	657	0	47269
8529	1116	45983	234	412	0	47745
8530	46966	842	165	497	0	48470
8531	46917	254	151	470	0	47792
8532	1214	47260	160	353	0	48987
8533	48215	877	128	457	0	49677
8534	48675	262	138	402	0	49477
8535	50239	170	131	408	0	50948
8536	1443	173	48300	286	0	50202
8537	47496	123	848	374	0	48841
8538	1277	150	271	49061	0	50759
8539	49098	109	181	1143	0	50531
8540	1222	134	48163	395	0	49914
8541	597	46928	888	290	0	48703
8542	47145	894	284	319	0	48642
8543	1140	48247	202	215	0	49804
8544	614	946	165	47907	0	49632
8545	441	340	119	49512	0	50412
8546	49131	180	117	1280	0	50708
8547	48239	137	171	587	0	49134
8548	1334	150	47368	332	0	49184
8549	576	121	42816	277	0	43790
8550	378	112	44747	196	0	45433
8551	419	365	1017	43802	0	45603
8552	266	82	44581	876	0	45805
8553	252	128	42674	310	0	43364
8554	583	772	883	40213	0	42451
8555	43037	90	344	946	0	44417
8556	43580	64	181	359	0	44184
8557	43724	45	121	323	0	44213
8558	44033	38	106	259	0	44436
8559	958	40	112	43751	0	44861
8560	422	43	125	44509	0	45099
8561	271	62	45664	766	0	46763
8562	297	55	711	44500	0	45563
8563	384	75	364	42079	0	42902
8564	46762	35	191	1044	0	48032
8565	46427	39	174	459	0	47099
8566	1041	35	113	45986	0	47175
8567	46396	42	114	890	0	47442
8568	46844	48	146	435	0	47473
8569	1138	42	115	46554	0	47849
8570	594	39	93	45960	0	46686
8571	345	57	44744	1018	0	46164
8572	304	91	43082	430	0	43907
8573	309	89	872	44441	0	45711
8574	305	60	358	45975	0	46698
8575	237	54	45860	970	0	47121
8576	42809	41	767	577	0	44194
8577	44281	22	288	451	0	45042
8578	1035	47	44116	264	0	45462
8579	475	43481	709	224	0	44889
8580	43619	512	337	322	0	44790
8581	759	182	45883	215	0	47039
8582	464	114	670	44832	0	46080
8583	353	94	326	46741	0	47514
8584	49029	36	231	1020	0	50316
8585	53338	28	196	727	0	54289
8586	986	34	164	54337	0	55521
8587	575	28	162	57863	0	58628
8588	57542	29	146	1147	0	58864
8589	57754	37	122	640	0	58553
8590	57258	31	186	492	0	57967
8591	1182	72	58519	230	0	60003
8592	657	29	795	57967	0	59448
8593	421	26	342	60175	0	60964
8594	59791	32	248	1272	0	61343
8595	951	60127	199	569	0	61846
8596	64764	706	183	579	0	66232
8597	1430	65638	198	350	0	67616
8598	748	1210	169	66547	0	68674
8599	589	326	144	67748	0	68807
8600	411	184	66519	1766	0	68880
8601	543	88	1362	66132	0	68125
8602	343	129	66574	1742	0	68788
8603	564	69	1486	66901	0	69020
8604	483	114	539	67099	0	68235
8605	341	64084	326	1941	0	66692
8606	366	68377	285	848	0	69876
8607	575	1568	255	65540	0	67938
8608	507	481	223	69492	0	70703
8609	536	260	246	69993	0	71035
8610	473	169	223	70371	0	71236
8611	475	140	233	71608	0	72456
8612	349	190	69414	2339	0	72292
8613	478	148	1534	68434	0	70594
8614	443	123	548	71113	0	72227
8615	351	180	68157	2297	0	70985
8616	341	67280	1589	1100	0	70310
8617	417	1432	537	68413	0	70799
8618	338	457	67927	2022	0	70744
8619	322	68030	1637	999	0	70988
8620	487	1513	540	69045	0	71585
8621	70475	447	340	2293	0	73555
8622	1799	260	358	70841	0	73258
8623	785	286	265	71897	0	73233
8624	566	192	258	73090	0	74106
8625	516	225	284	71134	0	72159
8626	340	68764	316	2571	0	71991
8627	471	1472	277	71348	0	73568
8628	72248	489	270	2651	0	75658
8629	1801	305	266	73437	0	75809
8630	756	269	262	73374	0	74661
8631	540	203	283	74879	0	75905
8632	70907	211	277	2840	0	74235
8633	71045	226	249	1588	0	73108
8634	2172	200	241	72085	0	74698
8635	67252	228	191	2340	0	70011
8636	68652	210	185	1364	0	70411
8637	1793	69029	224	970	0	72016
8638	68076	1335	199	1140	0	70750
8639	1626	68031	233	865	0	70755
8640	675	69299	211	799	0	70984
8641	590	1566	254	69904	0	72314
8642	439	569	70991	1853	0	73852
8643	562	426	1335	68502	0	70825
8644	469	326	433	70112	0	71340
8645	372	69846	306	2001	0	72525
8646	69101	1421	249	1217	0	71988
8647	1551	531	179	70163	0	72424
8648	574	384	72837	1913	0	75708
8649	507	348	1230	71733	0	73818
8650	351	74785	417	1893	0	77446
8651	74694	1376	281	1366	0	77717
8652	1596	499	255	76248	0	78598
8653	584	412	77341	2063	0	80400
8654	621	350	1339	77163	0	79473
8655	421	77080	458	1943	0	79902
8656	441	1494	322	79393	0	81650
8657	82087	581	283	2535	0	85486
8658	82935	385	292	1560	0	85172
8659	83192	339	282	1454	0	85267
8660	2194	84625	319	1085	0	88223
8661	84258	1691	302	1162	0	87413
8662	2150	666	244	85465	0	88525
8663	84115	448	239	2669	0	87471
8664	2082	85328	263	1278	0	88951
8665	1022	1930	185	86631	0	89768
8666	544	801	86498	2424	0	90267
8667	78416	528	1681	1783	0	82408
8668	1900	87128	569	1127	0	90724
8669	935	1903	332	87654	0	90824
8670	701	705	291	90360	0	92057
8671	721	464	238	88845	0	90268
8672	728	373	234	86673	0	88008
8673	443	87798	300	2825	0	91366
8674	87865	1891	207	1763	0	91726
8675	88145	744	200	1381	0	90470
8676	2462	540	89048	950	0	93000
8677	1273	452	1760	89231	0	92716
8678	726	425	89868	2491	0	93510
8679	85899	367	1958	1640	0	89864
8680	89650	406	692	1318	0	92066
8681	87972	347	370	1182	0	89871
8682	2860	367	291	84961	0	88479
8683	1097	85532	234	2394	0	89257
8684	85832	1881	202	1388	0	89303
8685	2482	704	204	83060	0	86450
8686	82502	458	241	2693	0	85894
8687	2402	432	79424	1059	0	83317
8688	1123	325	78499	830	0	80777
8689	80471	264	1991	908	0	83634
8690	2502	267	734	81334	0	84837
8691	80225	271	411	2458	0	83365
8692	2326	80472	300	1073	0	84171
8693	80726	1813	234	1039	0	83812
8694	81697	719	239	909	0	83564
8695	2787	537	79601	551	0	83476
8696	991	328	72481	356	0	74156
8697	681	73731	1614	367	0	76393
8698	969	1361	866	72830	0	76026
8699	73463	484	549	1641	0	76137
8700	1682	305	241	73090	0	75318
8701	996	265	210	75415	0	76886
8702	670	220	73712	1773	0	76375
8703	70202	212	1252	1108	0	72774
8704	1743	291	533	75219	0	77786
8705	881	285	74485	1501	0	77152
8706	713	327	72648	688	0	74376
8707	782	406	1575	73213	0	75976
8708	550	261	74295	1504	0	76610
8709	530	247	73798	724	0	75299
8710	785	268	1712	68047	0	70812
8711	419	288	75246	1445	0	77398
8712	655	209	1398	71755	0	74017
8713	406	71822	677	1486	0	74391
8714	75935	1201	417	1219	0	78772
8715	1448	78765	419	661	0	81293
8716	972	1585	310	76870	0	79737
8717	571	80997	349	1620	0	83537
8718	529	1732	84138	762	0	87161
8719	897	674	1974	93482	0	97027
8720	480	437	104544	2743	0	108204
8721	98778	286	3090	1600	0	103754
8722	3036	107316	1262	692	0	112306
8723	107648	2920	795	821	0	112184
8724	3894	1134	551	105627	0	111206
8725	106967	697	473	3497	0	111634
8726	3822	526	106420	1353	0	112121
8727	1694	106887	3108	909	0	112598
8728	105540	3018	1230	981	0	110769
8729	4008	1275	793	100455	0	106531
8730	1689	106111	677	2927	0	111404
8731	1577	3272	541	106773	0	112163
8732	106990	1344	605	4162	0	113101
8733	3565	114433	638	1793	0	120429
8734	114212	3785	581	1562	0	120140
8735	4622	1665	112436	751	0	119474
8736	111380	1055	3532	1109	0	117076
8737	5103	752	1387	112777	0	120019
8738	112476	583	1007	4362	0	118428
8739	4506	112575	800	1639	0	119520
8740	2598	3670	699	112155	0	119122
8741	1915	1548	529	115646	0	119638
8742	1301	1057	110197	4825	0	117380
8743	1581	744	3520	108758	0	114603
8744	1384	709	1399	112966	0	116458
8745	1430	646	973	113611	0	116660
8746	1473	607	701	114437	0	117218
8747	897	606	111099	5757	0	118359
8748	1049	106477	3880	2761	0	114167
8749	1249	3558	1715	107806	0	114328
8750	105153	1305	1041	4802	0	112301
8751	106081	918	853	2708	0	110560
8752	4768	106420	832	1888	0	113908
8753	104914	3829	709	1862	0	111314
8754	105168	1480	851	1580	0	109079
8755	104158	1025	688	1729	0	107600
8756	5337	100500	727	1428	0	107992
8757	96675	3443	513	1348	0	101979
8758	4822	1524	479	93529	0	100354
8759	1946	1053	92431	3895	0	99325
8760	1465	92890	3150	1818	0	99323
8761	1676	3468	1455	91987	0	98586
8762	1126	1536	91372	3646	0	97680
8763	89007	1030	3252	1919	0	95208
8764	4018	780	1246	90999	0	97043
8765	2212	701	798	92528	0	96239
8766	1737	692	671	92374	0	95474
8767	1651	653	503	92917	0	95724
8768	1187	709	88006	4868	0	94770
8769	81644	514	3158	2801	0	88117
8770	3632	86859	1215	1817	0	93523
8771	85925	3175	927	1557	0	91584
8772	3755	86857	670	1350	0	92632
8773	87240	3583	655	1386	0	92864
8774	4210	1508	618	86398	0	92734
8775	1873	971	85879	3837	0	92560
8776	1461	746	86780	1821	0	90808
8777	1431	799	3830	85350	0	91410
8778	1258	626	1556	87841	0	91281
8779	1217	622	1006	89298	0	92143
8780	85148	560	820	5313	0	91841
8781	3691	606	85506	2608	0	92411
8782	1717	83115	3368	1879	0	90079
8783	1579	87882	1315	1414	0	92190
8784	83446	3950	818	1516	0	89730
8785	3890	1679	84039	1181	0	90789
8786	1802	83456	3230	1254	0	89742
8787	1533	3289	82612	1018	0	88452
8788	1368	1511	3558	81534	0	87971
8789	1118	1162	82015	3533	0	87828
8790	1015	892	82439	1869	0	86215
8791	1132	780	3926	81268	0	87106
8792	1031	726	81786	3728	0	87271
8793	932	753	82804	1968	0	86457
8794	1171	709	4028	79533	0	85441
8795	79809	710	1908	3850	0	86277
8796	3355	725	80660	1896	0	86636
8797	1727	717	3638	78894	0	84976
8798	1416	687	1598	82074	0	85775
8799	79750	666	1470	4405	0	86291
8800	3495	656	1104	80750	0	86005
8801	78867	538	1085	4315	0	84805
8802	3626	78060	1056	2208	0	84950
8803	1821	2881	1055	79644	0	85401
8804	79335	1113	1002	3979	0	85429
8805	80953	782	937	2312	0	84984
8806	4321	591	874	79388	0	85174
8807	2030	588	79361	3903	0	85882
8808	76051	527	3202	2254	0	82034
8809	3508	79693	1431	1745	0	86377
8810	75372	2895	1099	1856	0	81222
8811	80243	1120	749	1558	0	83670
8812	80630	851	708	1544	0	83733
8813	4656	651	77313	1211	0	83831
8814	2234	75898	2846	1200	0	82178
8815	2005	3164	1140	74224	0	80533
8816	1782	1834	905	76064	0	80585
8817	1382	883	72935	3617	0	78817
8818	1209	67091	2389	1891	0	72580
8819	702	55498	821	1028	0	58049
8820	504	48878	461	494	0	50337
8821	46320	1323	1424	551	0	49618
8822	1373	423	315	45318	0	47429
8823	586	265	264	46212	0	47327
8824	446	284	46063	1223	0	48016
8825	43199	288	922	611	0	45020
8826	1158	257	350	45960	0	47725
8827	670	502	280	46514	0	47966
8828	488	174	45962	1232	0	47856
8829	319	45370	954	601	0	47244
8830	446	1201	386	45196	0	47229
8831	279	333	45162	1012	0	46786
8832	182	41307	704	426	0	42619
8833	36403	459	163	313	0	37338
8834	558	167	38973	152	0	39850
8835	233	112	437	37450	0	38232
8836	131	38827	170	413	0	39541
8837	38738	428	160	254	0	39580
8838	496	140	83	38951	0	39670
8839	39092	87	77	560	0	39816
8840	38900	79	69	298	0	39346
8841	510	39213	92	157	0	39972
8842	39165	419	99	239	0	39922
8843	40443	122	65	330	0	40960
8844	538	121	40946	116	0	41721
8845	39237	58	397	277	0	39969
8846	488	79	40757	101	0	41425
8847	39207	38	322	209	0	39776
8848	40466	48	136	195	0	40845
8849	459	90	42423	76	0	43048
8850	293	70	308	42195	0	42866
8851	122	54	43612	319	0	44107
8852	122	56	39872	145	0	40195
8853	108	72	44872	95	0	45147
8854	211	73	413	44581	0	45278
8855	140	62	107	49991	0	50300
8856	130	21	58	50684	0	50893
8857	121	35	55	51348	0	51559
8858	56	53	52092	661	0	52862
8859	246	32	551	48695	0	49524
8860	76	46148	166	612	0	47002
8861	73	543	52574	151	0	53341
8862	189	137	604	50862	0	51792
8863	75	82	53719	626	0	54502
8864	60	51820	629	231	0	52740
8865	56	53644	209	110	0	54019
8866	134	682	100	53533	0	54449
8867	66	227	53576	631	0	54500
8868	81	116	53120	208	0	53525
8869	182	75	759	53243	0	54259
8870	173	42	257	54543	0	55015
8871	156	58	117	55987	0	56318
8872	69	104	55789	808	0	56770
8873	57	55074	692	310	0	56133
8874	56	58140	253	148	0	58597
8875	149	819	148	57591	0	58707
8876	50	238	57144	750	0	58182
8877	58	133	56105	271	0	56567
8878	37	59291	865	190	0	60383
8879	59212	760	268	384	0	60624
8880	728	60541	173	152	0	61594
8881	215	858	63125	106	0	64304
8882	61494	228	936	315	0	62973
8883	1045	134	289	64745	0	66213
8884	65846	90	181	1228	0	67345
8885	1156	113	123	65483	0	66875
8886	436	81	124	66838	0	67479
8887	65963	136	93	1455	0	67647
8888	1057	68111	171	425	0	69764
8889	361	1116	67747	200	0	69424
8890	158	69377	1059	206	0	70800
8891	68330	1158	302	370	0	70160
8892	1072	69381	180	199	0	70832
8893	68752	1170	141	368	0	70431
8894	68961	344	153	392	0	69850
8895	1346	69628	146	193	0	71313
8896	564	1144	140	68830	0	70678
8897	68525	353	123	1369	0	70370
8898	69318	177	133	570	0	70198
8899	1493	207	115	68318	0	70133
8900	528	164	66774	1179	0	68645
8901	326	166	66831	384	0	67707
8902	334	209	1333	67723	0	69599
8903	192	174	66828	1203	0	68397
8904	62107	166	1143	681	0	64097
8905	1186	65706	365	313	0	67570
8906	514	1132	197	67417	0	69260
8907	379	391	197	67826	0	68793
8908	359	215	183	66803	0	67560
8909	328	168	154	65942	0	66592
8910	329	123	207	67167	0	67826
8911	239	157	65898	1522	0	67816
8912	168	65829	1142	544	0	67683
8913	66240	1121	388	537	0	68286
8914	1303	360	241	65892	0	67796
8915	498	191	212	66546	0	67447
8916	355	171	187	66396	0	67109
8917	195	65919	195	1664	0	67973
8918	320	1174	194	66941	0	68629
8919	304	431	162	67830	0	68727
8920	65272	218	153	1774	0	67417
8921	1185	63730	162	716	0	65793
8922	371	65131	180	513	0	66195
8923	334	1331	127	65298	0	67090
8924	63591	480	170	1617	0	65858
8925	1226	321	64459	610	0	66616
8926	58543	244	1172	869	0	60828
8927	1355	238	65685	384	0	67662
8928	640	245	1219	64795	0	66899
8929	413	267	375	66870	0	67925
8930	367	252	220	66024	0	66863
8931	344	220	184	66328	0	67076
8932	388	196	225	65065	0	65874
8933	65322	175	202	1834	0	67533
8934	1269	214	64482	659	0	66624
8935	567	205	1189	65251	0	67212
8936	328	198	67469	1466	0	69461
8937	247	67435	1259	764	0	69705
8938	66172	1148	416	839	0	68575
8939	1328	423	69968	500	0	72219
8940	672	278	1289	70446	0	72685
8941	555	194	443	73007	0	74199
8942	239	227	72950	1907	0	75323
8943	287	219	72340	775	0	73621
8944	565	258	1706	66334	0	68863
8945	71955	208	563	1913	0	74639
8946	72468	194	416	901	0	73979
8947	1710	72197	310	596	0	74813
8948	72626	1351	230	716	0	74923
8949	1713	466	250	69065	0	71494
8950	639	72012	307	1550	0	74508
8951	545	1396	263	72711	0	74915
8952	420	496	74134	1737	0	76787
8953	638	267	1388	69358	0	71651
8954	603	321	440	71797	0	73161
8955	67820	184	288	1776	0	70068
8956	1251	67966	270	773	0	70260
8957	67009	1193	204	658	0	69064
8958	1296	66922	216	484	0	68918
8959	64860	1203	199	546	0	66808
8960	1287	64703	230	393	0	66613
8961	507	65690	165	441	0	66803
8962	65638	1355	244	548	0	67785
8963	1425	522	193	62653	0	64793
8964	494	64903	184	1236	0	66817
8965	65665	1146	234	757	0	67802
8966	65895	421	198	626	0	67140
8967	66651	293	193	563	0	67700
8968	65560	266	167	589	0	66582
8969	1495	65626	200	415	0	67736
8970	741	1096	147	65668	0	67652
8971	550	497	153	66928	0	68128
8972	66716	295	141	1650	0	68802
8973	1406	251	139	65548	0	67344
8974	64657	225	131	1461	0	66474
8975	1240	217	63407	557	0	65421
8976	60425	219	864	774	0	62282
8977	1210	264	63178	413	0	65065
8978	707	507	942	61573	0	63729
8979	61670	218	386	1227	0	63501
8980	1138	60995	181	552	0	62866
8981	57354	769	146	488	0	58757
8982	946	55087	140	295	0	56468
8983	531	953	121	60162	0	61767
8984	314	342	58915	805	0	60376
8985	52468	337	828	627	0	54260
8986	736	58566	223	314	0	59839
8987	533	770	130	58234	0	59667
8988	347	283	114	57218	0	57962
8989	349	176	87	56574	0	57186
8990	208	224	56339	819	0	57590
8991	211	55865	581	443	0	57100
8992	54910	623	230	474	0	56237
8993	55363	229	126	459	0	56177
8994	759	55714	154	206	0	56833
8995	56284	622	73	436	0	57415
8996	819	271	91	56125	0	57306
8997	368	56275	110	649	0	57402
8998	55683	643	113	498	0	56937
8999	757	302	55019	215	0	56293
9000	369	55826	565	236	0	56996
9001	393	702	206	55968	0	57269
9002	291	286	126	57181	0	57884
9003	233	209	56158	775	0	57375
9004	333	233	583	54379	0	55528
9005	217	211	56115	732	0	57275
9006	337	149	629	55207	0	56322
9007	297	166	270	56573	0	57306
9008	331	152	117	57255	0	57855
9009	289	164	148	59037	0	59638
9010	229	210	58567	1097	0	60103
9011	229	186	62797	502	0	63714
9012	184	69800	1243	371	0	71598
9013	400	1352	441	73010	0	75203
9014	236	551	75832	1457	0	78076
9015	187	75279	1549	627	0	77642
9016	449	1651	526	77591	0	80217
9017	228	642	81092	1659	0	83621
9018	75266	268	1855	1031	0	78420
9019	83803	277	642	574	0	85296
9020	2555	195	279	83524	0	86553
9021	848	222	83404	2005	0	86479
9022	744	252	1903	82146	0	85045
9023	82243	200	686	2537	0	85666
9024	1924	84171	417	955	0	87467
9025	85886	1877	298	800	0	88861
9026	87756	682	253	703	0	89394
9027	2889	316	226	84148	0	87579
9028	1307	249	277	85582	0	87415
9029	829	247	200	86158	0	87434
9030	730	201	201	85684	0	86816
9031	702	246	213	85075	0	86236
9032	83722	218	206	3195	0	87341
9033	84346	180	191	1532	0	86249
9034	84345	152	224	1102	0	85823
9035	2793	256	78542	717	0	82308
9036	79445	195	1632	925	0	82197
9037	2530	273	669	79991	0	83463
9038	1066	260	79429	2323	0	83078
9039	672	77304	1976	1085	0	81037
9040	934	2144	848	75235	0	79161
9041	867	656	443	75354	0	77320
9042	545	76083	425	2340	0	79393
9043	755	1752	337	77482	0	80326
9044	489	719	76894	2353	0	80455
9045	481	360	77681	1215	0	79737
9046	672	322	2526	77853	0	81373
9047	76988	282	958	2700	0	80928
9048	76981	260	526	1500	0	79267
9049	2753	354	76756	857	0	80720
9050	1247	70741	2019	832	0	74839
9051	721	75254	931	811	0	77717
9052	70571	2214	577	978	0	74340
9053	2205	909	72032	805	0	75951
9054	1357	455	1889	70848	0	74549
9055	70767	325	828	2550	0	74470
9056	2298	69303	519	1272	0	73392
9057	1142	72537	416	906	0	75001
9058	71047	2371	380	895	0	74693
9059	2591	939	342	72394	0	76266
9060	78083	459	390	2598	0	81530
9061	3044	320	364	85809	0	89537
9062	1856	344	390	87879	0	90469
9063	1065	491	85532	3990	0	91078
9064	1148	447	2644	86430	0	90669
9065	972	444	1290	88560	0	91266
9066	86767	366	788	4613	0	92534
9067	3294	346	539	88710	0	92889
9068	1588	381	86974	4090	0	93033
9069	85439	326	2912	2537	0	91214
9070	3344	336	1528	87748	0	92956
9071	87196	346	980	3935	0	92457
9072	3624	81877	706	2237	0	88444
9073	1922	87913	665	1526	0	92026
9074	86316	3599	619	1382	0	91916
9075	87599	1761	645	1191	0	91196
9076	4598	1000	603	85628	0	91829
9077	2435	683	84773	3465	0	91356
9078	1809	592	2989	86329	0	91719
9079	84130	690	1521	4058	0	90399
9080	3455	84768	1052	2169	0	91444
9081	2306	3028	737	85153	0	91224
9082	85251	1613	629	3822	0	91315
9083	3732	1020	80762	2351	0	87865
9084	82293	669	2972	1943	0	87877
9085	76886	698	1455	1973	0	81012
9086	4424	591	81897	1455	0	88367
9087	2583	624	83470	1279	0	87956
9088	2039	513	4040	79763	0	86355
9089	1892	385	2038	81267	0	85582
9090	1358	83425	1298	4472	0	90553
9091	1473	2949	908	85201	0	90531
9092	1294	1543	84698	4330	0	91865
9093	1432	989	3290	85663	0	91374
9094	1451	586	1752	89961	0	93750
9095	1258	490	85957	5229	0	92934
9096	1134	84843	3419	3099	0	92495
9097	1321	3041	1737	85925	0	92024
9098	1285	1540	1161	89565	0	93551
9099	86831	998	903	5179	0	93911
9100	3905	697	815	87458	0	92875
9101	2118	660	85201	4785	0	92764
9102	83920	592	3379	2825	0	90716
9103	87886	727	1713	2079	0	92405
9104	88877	623	1192	1814	0	92506
9105	5296	587	84021	1458	0	91362
9106	3077	544	3393	82703	0	89717
9107	2063	442	1945	85335	0	89785
9108	1749	465	1442	86125	0	89781
9109	80120	550	956	5306	0	86932
9110	3673	79538	921	3144	0	87276
9111	1992	2497	70799	1935	0	77223
9112	1258	67069	2412	1655	0	72394
9113	930	64415	1340	1458	0	68143
9114	885	64555	1089	1266	0	67795
9115	1601	3534	1229	60875	0	67239
9116	907	1569	60129	2672	0	65277
9117	52520	1061	2097	1956	0	57634
9118	2087	56956	1252	1463	0	61758
9119	54405	1753	859	1253	0	58270
9120	2331	56484	556	1054	0	60425
9121	56902	2138	516	1132	0	60688
9122	2570	58164	461	816	0	62011
9123	1682	2378	58729	700	0	63489
9124	1482	1273	1886	57806	0	62447
9125	1059	908	1073	61390	0	64430
9126	60369	563	856	3207	0	64995
9127	2406	524	551	64724	0	68205
9128	1452	514	63783	3152	0	68901
9129	1348	514	2175	64808	0	68845
9130	984	561	64470	3104	0	69119
9131	803	63866	2624	1833	0	69126
9132	1063	2274	1338	59703	0	64378
9133	835	65112	1105	2323	0	69375
9134	64723	2653	727	1616	0	69719
9135	2663	1310	742	64593	0	69308
9136	1542	960	64370	2595	0	69467
9137	1153	656	63457	1661	0	66927
9138	62289	682	2978	1461	0	67410
9139	2616	667	1569	63188	0	68040
9140	1488	706	62664	2600	0	67458
9141	1135	688	60453	1586	0	63862
9142	662	61029	3101	1414	0	66206
9143	813	2199	1868	55511	0	60391
9144	550	60607	1214	2409	0	64780
9145	749	2409	771	59819	0	63748
9146	60288	1217	734	2984	0	65223
9147	2201	919	733	61319	0	65172
9148	1311	571	629	63099	0	65610
9149	61439	539	686	3494	0	66158
9150	2387	550	639	63476	0	67052
9151	1518	585	644	61345	0	64092
9152	1184	62600	581	3202	0	67567
9153	63089	2085	567	2066	0	67807
9154	64725	1109	590	1531	0	67955
9155	3186	812	652	63680	0	68330
9156	1819	536	694	64379	0	67428
9157	1368	550	602	63806	0	66326
9158	923	59063	530	3830	0	64346
9159	859	61881	597	2245	0	65582
9160	1004	2229	451	55769	0	59453
9161	45651	551	294	1601	0	48097
9162	45898	426	270	909	0	47503
9163	1335	45459	257	674	0	47725
9164	43320	1149	231	650	0	45350
9165	1232	43057	240	496	0	45025
9166	532	43521	202	542	0	44797
9167	995	1313	359	42349	0	45016
9168	41645	509	312	1353	0	43819
9169	1088	40624	203	618	0	42533
9170	461	42170	206	541	0	43378
9171	472	1125	205	41998	0	43800
9172	430	483	205	43044	0	44162
9173	332	460	41795	1315	0	43902
9174	40285	322	924	827	0	42358
9175	40493	325	305	766	0	41889
9176	1177	332	42435	531	0	44475
9177	513	372	42583	541	0	44009
9178	507	322	1124	42863	0	44816
9179	448	350	408	44118	0	45324
9180	362	43628	324	1446	0	45760
9181	435	1174	255	44229	0	46093
9182	381	493	43829	1549	0	46252
9183	476	448	1074	43342	0	45340
9184	430	402	381	44353	0	45566
9185	42946	339	357	1760	0	45402
9186	1246	344	42726	862	0	45178
9187	40086	322	1204	818	0	42430
9188	1319	362	41706	676	0	44063
9189	621	289	1204	40225	0	42339
9190	410	365	40234	1380	0	42389
9191	362	332	40096	761	0	41551
9192	433	481	1295	39400	0	41609
9193	37455	375	761	1589	0	40180
9194	37451	319	510	859	0	39139
9195	1223	38505	447	659	0	40834
9196	38226	973	463	747	0	40409
9197	38368	458	439	666	0	39931
9198	1228	38478	438	577	0	40721
9199	678	1121	351	39233	0	41383
9200	543	468	378	40305	0	41694
9201	471	473	326	39967	0	41237
9202	462	346	328	40433	0	41569
9203	416	370	39230	1666	0	41682
9204	37280	264	1090	1028	0	39662
9205	1256	256	484	39578	0	41574
9206	671	259	417	39207	0	40554
9207	544	39579	368	1527	0	42018
9208	580	1121	272	40612	0	42585
9209	395	528	39184	1600	0	41707
9210	37717	384	954	1108	0	40163
9211	1244	399	40766	845	0	43254
9212	640	338	965	40147	0	42090
9213	39930	308	325	1578	0	42141
9214	1220	40810	251	873	0	43154
9215	743	1052	177	42233	0	44205
9216	506	486	42073	1539	0	44604
9217	546	383	1036	42302	0	44267
9218	41662	324	365	1666	0	44017
9219	1288	337	42268	798	0	44691
9220	584	325	41091	694	0	42694
9221	507	41212	1173	607	0	43499
9222	39506	1073	494	581	0	41654
9223	1127	39163	376	505	0	41171
9224	498	1040	38223	429	0	40190
9225	362	349	36194	312	0	37217
9226	261	35939	931	352	0	37483
9227	31487	614	447	258	0	32806
9228	595	31707	240	168	0	32710
9229	301	598	142	31080	0	32121
9230	241	195	144	31736	0	32316
9231	147	156	31736	693	0	32732
9232	192	122	656	31102	0	32072
9233	116	135	32492	666	0	33409
9234	31212	96	671	361	0	32340
9235	32496	123	243	257	0	33119
9236	32640	99	179	258	0	33176
9237	727	112	31991	180	0	33010
9238	31682	104	624	238	0	32648
9239	753	105	217	31061	0	32136
9240	240	32156	183	606	0	33185
9241	31908	560	158	377	0	33003
9242	685	179	30698	219	0	31781
9243	30682	109	573	284	0	31648
9244	31301	87	238	258	0	31884
9245	765	102	30912	159	0	31938
9246	293	31252	620	196	0	32361
9247	309	654	234	30913	0	32110
9248	238	168	31389	611	0	32406
9249	185	127	30686	248	0	31246
9250	238	201	625	29266	0	30330
9251	152	73	30479	537	0	31241
9252	182	73	590	29436	0	30281
9253	254	92	283	27651	0	28280
9254	163	75	171	30549	0	30958
9255	153	77	30552	628	0	31410
9256	178	91	610	30351	0	31230
9257	153	79	31057	631	0	31920
9258	156	89	643	31090	0	31978
9259	32151	81	250	747	0	33229
9260	700	107	197	31944	0	32948
9261	195	33217	179	688	0	34279
9262	221	616	174	34005	0	35016
9263	33908	191	146	872	0	35117
9264	716	34413	170	301	0	35600
9265	276	687	158	34424	0	35545
9266	34238	171	151	867	0	35427
9267	783	126	34490	311	0	35710
9268	324	129	761	34070	0	35284
9269	197	103	34975	819	0	36094
9270	181	105	34614	297	0	35197
9271	252	124	871	34109	0	35356
9272	34429	93	303	888	0	35713
9273	780	80	33934	316	0	35110
9274	33246	96	778	272	0	34392
9275	843	133	270	34409	0	35655
9276	282	93	34317	726	0	35418
9277	214	91	33220	253	0	33778
9278	206	100	33963	192	0	34461
9279	248	239	847	32560	0	33894
9280	33542	71	504	772	0	34889
9281	635	33993	266	243	0	35137
9282	292	585	197	33640	0	34714
9283	226	178	216	34481	0	35101
9284	34257	113	206	883	0	35459
9285	34395	88	182	396	0	35061
9286	744	34279	207	237	0	35467
9287	34546	618	176	309	0	35649
9288	34658	181	172	251	0	35262
9289	861	109	185	34245	0	35400
9290	274	121	34535	695	0	35625
9291	33859	108	696	337	0	35000
9292	830	89	253	35030	0	36202
9293	343	119	168	35321	0	35951
9294	35048	83	167	887	0	36185
9295	784	92	155	33636	0	34667
9296	357	88	142	34171	0	34758
9297	33460	62	145	956	0	34623
9298	759	34310	147	348	0	35564
9299	34193	591	126	398	0	35308
9300	793	169	34300	244	0	35506
9301	33587	79	697	291	0	34654
9302	843	77	231	34041	0	35192
9303	299	35005	206	711	0	36221
9304	305	599	177	35636	0	36717
9305	317	161	143	35814	0	36435
9306	290	87	159	35893	0	36429
9307	35066	75	144	928	0	36213
9308	686	34235	139	344	0	35404
9309	193	34211	110	259	0	34773
9310	33285	610	97	295	0	34287
9311	649	184	34905	177	0	35915
9312	265	115	34085	173	0	34638
9313	33291	152	886	315	0	34644
9314	666	87	35818	154	0	36725
9315	282	44	516	34562	0	35404
9316	375	104	278	31002	0	31759
9317	179	58	109	35856	0	36202
9318	218	59	87	35420	0	35784
9319	119	32904	126	694	0	33843
9320	164	509	83	35594	0	36350
9321	137	189	34882	674	0	35882
9322	164	103	546	34450	0	35263
9323	124	91	33934	666	0	34815
9324	138	75	33492	242	0	33947
9325	160	71	677	33968	0	34876
9326	136	78	34496	631	0	35341
9327	180	55	630	34065	0	34930
9328	34034	56	235	771	0	35096
9329	617	60	34411	289	0	35377
9330	32753	55	617	323	0	33748
9331	683	62	211	34124	0	35080
9332	253	75	34044	657	0	35029
9333	146	33361	606	299	0	34412
9334	188	516	238	33898	0	34840
9335	140	151	36047	684	0	37022
9336	209	86	671	35798	0	36764
9337	36949	86	248	843	0	38126
9338	37264	92	167	415	0	37938
9339	37928	85	138	351	0	38502
9340	866	64	140	38052	0	39122
9341	377	72	119	38750	0	39318
9342	282	56	151	39487	0	39976
9343	39418	48	138	988	0	40592
9344	761	40257	137	396	0	41551
9345	359	667	118	40562	0	41706
9346	259	212	133	41535	0	42139
9347	40666	138	107	1153	0	42064
9348	811	41573	112	488	0	42984
9349	397	761	108	42984	0	44250
9350	42932	240	97	1118	0	44387
9351	42793	141	95	514	0	43543
9352	1228	210	110	42151	0	43699
9353	42172	79	79	1108	0	43438
9354	1126	78	115	41948	0	43267
9355	379	108	42109	1037	0	43633
9356	413	74	801	41750	0	43038
9357	369	67	284	42797	0	43517
9358	390	64	185	43323	0	43962
9359	41135	59	98	1227	0	42519
9360	789	41319	106	556	0	42770
9361	40002	728	100	450	0	41280
9362	816	39741	80	292	0	40929
9363	265	41239	94	238	0	41836
9364	40597	834	70	363	0	41864
9365	766	41747	86	230	0	42829
9366	395	812	82	41717	0	43006
9367	41385	249	61	922	0	42617
9368	41886	175	89	434	0	42584
9369	997	124	93	41569	0	42783
9370	501	131	78	41220	0	41930
9371	235	41991	82	961	0	43269
9372	42610	704	61	597	0	43972
9373	41579	253	65	495	0	42392
9374	934	43586	77	307	0	44904
9375	390	44429	70	232	0	45121
9376	322	979	51	44494	0	45846
9377	44302	368	53	1064	0	45787
9378	1048	225	65	44039	0	45377
9379	496	166	64	45114	0	45840
9380	300	154	43586	1145	0	45185
9381	274	159	43020	486	0	43939
9382	328	131	946	43426	0	44831
9383	233	117	43949	1037	0	45336
9384	186	43980	922	458	0	45546
9385	300	892	263	43782	0	45237
9386	298	287	180	45137	0	45902
9387	306	201	123	45534	0	46164
9388	205	205	44800	1252	0	46462
9389	196	205	43375	569	0	44345
9390	41840	158	968	610	0	43576
9391	926	44323	359	370	0	45978
9392	44118	849	178	434	0	45579
9393	1052	304	121	44028	0	45505
9394	44379	197	157	1142	0	45875
9395	1107	199	170	43389	0	44865
9396	400	44826	150	996	0	46372
9397	44579	879	117	620	0	46195
9398	1026	330	43858	355	0	45569
9399	373	43391	806	333	0	44903
9400	43343	840	290	466	0	44939
9401	1042	320	157	42903	0	44422
9402	397	42441	174	927	0	43939
9403	439	847	144	44149	0	45579
9404	43768	340	139	1146	0	45393
9405	1056	289	104	44000	0	45449
9406	43926	188	98	1255	0	45467
9407	1108	231	43298	550	0	45187
9408	606	195	808	43286	0	44895
9409	43213	179	274	1278	0	44944
9410	1027	261	42771	544	0	44603
9411	482	40951	878	467	0	42778
9412	524	894	339	39672	0	41429
9413	309	420	40288	988	0	42005
9414	291	304	39135	514	0	40244
9415	406	313	1024	39239	0	40982
9416	271	216	39296	1027	0	40810
9417	272	203	38746	528	0	39749
9418	344	188	1000	38252	0	39784
9419	38645	132	463	1103	0	40343
9420	994	170	279	38525	0	39968
9421	504	154	223	39399	0	40280
9422	327	154	39670	1185	0	41336
9423	360	144	897	40083	0	41484
9424	40614	152	425	1253	0	42444
9425	979	205	40982	540	0	42706
9426	430	41574	900	506	0	43410
9427	390	891	397	42585	0	44263
9428	42841	364	333	1193	0	44731
9429	1076	276	235	42822	0	44409
9430	474	43260	252	1168	0	45154
9431	351	945	45744	527	0	47567
9432	353	430	1035	46702	0	48520
9433	49470	277	441	1368	0	51556
9434	1288	187	49308	638	0	51421
9435	659	175	1199	49335	0	51368
9436	50206	156	501	1556	0	52419
9437	51433	126	361	821	0	52741
9438	1709	51655	300	521	0	54185
9439	51353	1318	322	462	0	53455
9440	1725	536	265	50777	0	53303
9441	679	336	51687	1495	0	54197
9442	454	49315	1389	707	0	51865
9443	331	52386	534	482	0	53733
9444	479	1658	392	50301	0	52830
9445	420	564	329	51665	0	52978
9446	265	288	50216	1611	0	52380
9447	268	48632	1316	707	0	50923
9448	211	50047	546	497	0	51301
9449	370	1477	359	47985	0	50191
9450	47541	489	241	1371	0	49642
9451	1131	47741	177	574	0	49623
9452	566	1174	169	48494	0	50403
9453	50194	437	162	1470	0	52263
9454	1313	272	190	50658	0	52433
9455	581	263	201	50603	0	51648
9456	430	265	182	51201	0	52078
9457	387	252	168	51291	0	52098
9458	49736	209	180	1813	0	51938
9459	1289	195	175	50251	0	51910
9460	476	212	48609	1441	0	50738
9461	46721	231	1111	807	0	48870
9462	1207	259	47922	540	0	49928
9463	524	202	49398	493	0	50617
9464	520	164	1393	49076	0	51153
9465	431	184	535	49986	0	51136
9466	426	170	331	51116	0	52043
9467	49967	164	226	1777	0	52134
9468	1273	191	49347	802	0	51613
9469	48037	142	1151	736	0	50066
9470	49553	149	480	623	0	50805
9471	1505	173	48371	455	0	50504
9472	46766	157	1052	683	0	48658
9473	1260	171	48925	496	0	50852
9474	540	49729	1122	420	0	51811
9475	552	1121	754	49469	0	51896
9476	370	368	363	51420	0	52521
9477	394	197	278	51163	0	52032
9478	358	166	286	51100	0	51910
9479	248	162	50978	1547	0	52935
9480	299	184	50588	714	0	51785
9481	340	166	1275	50160	0	51941
9482	250	174	51002	1233	0	52659
9483	48043	130	1098	812	0	50083
9484	51201	114	502	642	0	52459
9485	1423	146	305	50766	0	52640
9486	50352	113	288	1329	0	52082
9487	1162	51646	316	637	0	53761
9488	51393	947	232	638	0	53210
9489	1189	373	52345	512	0	54419
9490	663	228	1043	51042	0	52976
9491	381	52726	514	1200	0	54821
9492	53684	932	357	775	0	55748
9493	1195	366	344	54384	0	56289
9494	604	242	54321	1282	0	56449
9495	479	170	1128	53886	0	55663
9496	53521	148	552	1460	0	55681
9497	1300	211	54202	707	0	56420
9498	743	202	1149	54083	0	56177
9499	659	177	501	54922	0	56259
9500	449	226	54630	1534	0	56839
9501	452	52506	1122	756	0	54836
9502	701	38694	823	891	0	41109
9503	483	1205	376	54652	0	56716
9504	450	494	309	55409	0	56662
9505	407	353	308	56485	0	57553
9506	54530	267	278	1790	0	56865
9507	55412	273	318	973	0	56976
9508	1411	322	303	55495	0	57531
9509	54970	287	241	1608	0	57106
9510	1254	54520	292	852	0	56918
9511	600	1110	302	56609	0	58621
9512	448	464	243	57551	0	58706
9513	455	278	279	58114	0	59126
9514	54298	217	259	1935	0	56709
9515	1235	54209	251	962	0	56657
9516	616	1045	259	55570	0	57490
9517	54418	436	189	1700	0	56743
9518	1285	273	225	55478	0	57261
9519	709	206	211	55418	0	56544
9520	577	51756	232	1690	0	54255
9521	484	55343	256	941	0	57024
9522	513	1105	260	54647	0	56525
9523	485	383	259	54996	0	56123
9524	51980	223	246	1738	0	54187
9525	1278	172	250	52686	0	54386
9526	536	180	50748	1518	0	52982
9527	515	143	1023	49638	0	51319
9528	384	49174	441	1309	0	51308
9529	49986	908	296	856	0	52046
9530	1286	316	281	50198	0	52081
9531	642	219	199	48505	0	49565
9532	389	47865	230	1285	0	49769
9533	44959	673	138	650	0	46420
9534	833	47860	139	391	0	49223
9535	410	851	95	47743	0	49099
9536	252	209	46513	865	0	47839
9537	363	401	673	43666	0	45103
9538	43986	84	191	912	0	45173
9539	580	44275	104	313	0	45272
9540	290	587	72	44419	0	45368
9541	143	43005	66	647	0	43861
9542	205	666	64	44701	0	45636
9543	131	244	43893	763	0	45031
9544	217	178	592	42502	0	43489
9545	168	110	167	43911	0	44356
9546	170	112	93	44531	0	44906
9547	41958	122	61	1006	0	43147
9548	42579	114	60	556	0	43309
9549	667	43086	73	286	0	44112
9550	42635	637	66	402	0	43740
9551	654	42250	92	237	0	43233
9552	196	43834	81	250	0	44361
9553	41395	735	57	430	0	42617
9554	690	265	40848	290	0	42093
9555	329	139	570	40620	0	41658
9556	281	101	148	42225	0	42755
9557	206	131	95	43712	0	44144
9558	42096	121	62	1055	0	43334
9559	689	41931	65	412	0	43097
9560	363	764	45	42671	0	43843
9561	220	42891	93	881	0	44085
9562	45793	856	71	419	0	47139
9563	960	267	68	46297	0	47592
9564	424	207	52	54642	0	55325
9565	199	58539	74	1490	0	60302
9566	373	1316	46	60905	0	62640
9567	279	515	53	62252	0	63099
9568	59302	268	64	2216	0	61850
9569	1378	58107	80	948	0	60513
9570	504	60927	61	548	0	62040
9571	481	1701	36	60216	0	62434
9572	246	677	58644	1684	0	61251
9573	232	429	57944	774	0	59379
9574	349	353	1655	57123	0	59480
9575	223	280	56825	1771	0	59099
9576	391	291	1513	56565	0	58760
9577	479	332	650	53676	0	55137
9578	284	329	289	59022	0	59924
9579	56433	237	256	2518	0	59444
9580	1580	188	262	57273	0	59303
9581	742	183	233	56866	0	58024
9582	319	56227	192	2234	0	58972
9583	374	1563	198	58714	0	60849
9584	195	642	57462	2202	0	60501
9585	351	315	1533	58309	0	60508
9586	361	246	601	60113	0	61321
9587	56664	226	405	2569	0	59864
9588	1644	244	300	57750	0	59938
9589	646	225	212	57556	0	58639
9590	412	255	199	58303	0	59169
9591	53282	190	173	2860	0	56505
9592	1521	54631	220	1350	0	57722
9593	746	1529	160	55099	0	57534
9594	468	622	127	56481	0	57698
9595	328	405	54048	2533	0	57314
9596	410	345	1459	54586	0	56800
9597	51504	234	583	2492	0	54813
9598	1471	52775	354	1321	0	55921
9599	805	1560	228	52316	0	54909
9600	528	658	179	53691	0	55056
9601	340	407	51467	2594	0	54808
9602	48183	292	1474	1567	0	51516
9603	1505	50196	615	1154	0	53470
9604	50634	1565	308	1012	0	53519
9605	1780	750	241	51242	0	54013
9606	816	515	233	52242	0	53806
9607	551	369	266	52974	0	54160
9608	454	327	291	53366	0	54438
9609	50844	333	330	2716	0	54223
9610	1736	340	259	50282	0	52617
9611	720	48931	298	2306	0	52255
9612	570	1452	326	50351	0	52699
9613	462	575	309	52106	0	53452
9614	49719	356	300	2849	0	53224
9615	1648	49395	264	1569	0	52876
9616	931	1552	196	51112	0	53791
9617	49816	652	158	2547	0	53173
9618	51213	422	178	1610	0	53423
9619	2081	424	176	51240	0	53921
9620	893	395	49193	2544	0	53025
9621	49327	371	1357	1635	0	52690
9622	1913	348	540	50947	0	53748
9623	889	401	50355	2386	0	54031
9624	630	337	1558	51874	0	54399
9625	698	265	630	51413	0	53006
9626	695	296	357	51776	0	53124
9627	545	52390	310	2834	0	56079
9628	603	1522	288	54087	0	56500
9629	587	679	263	55392	0	56921
9630	582	387	229	55465	0	56663
9631	593	359	251	55083	0	56286
9632	548	379	246	54303	0	55476
9633	574	379	252	54274	0	55479
9634	48147	310	306	2916	0	51679
9635	1450	294	47080	1748	0	50572
9636	731	46689	1316	1474	0	50210
9637	47079	1262	586	1347	0	50274
9638	1444	47272	356	1233	0	50305
9639	47068	1406	306	1251	0	50031
9640	1770	744	336	47109	0	49959
9641	47253	380	291	2175	0	50099
9642	1650	358	283	47358	0	49649
9643	1002	315	240	45971	0	47528
9644	577	45880	167	2479	0	49103
9645	46332	1282	161	1645	0	49420
9646	1549	593	46879	1366	0	50387
9647	964	341	1167	48489	0	50961
9648	622	354	48353	2122	0	51451
9649	598	375	46237	1387	0	48597
9650	47706	390	1469	1194	0	50759
9651	1533	368	677	49349	0	51927
9652	880	367	48402	1955	0	51604
9653	684	283	49351	1360	0	51678
9654	701	240	1569	49248	0	51758
9655	652	257	660	51295	0	52864
9656	50435	237	460	2343	0	53475
9657	1633	239	397	50817	0	53086
9658	906	224	51520	2003	0	54653
9659	729	234	1243	51678	0	53884
9660	641	365	685	50962	0	52653
9661	394	51628	460	1974	0	54456
9662	49671	942	388	1356	0	52357
9663	1089	48657	320	1068	0	51134
9664	39718	473	189	577	0	40957
9665	437	34931	88	260	0	35716
9666	170	34509	84	209	0	34972
9667	236	391	199	34535	0	35361
9668	172	124	153	34374	0	34823
9669	141	134	59	34083	0	34417
9670	32964	60	45	474	0	33543
9671	281	79	33142	176	0	33678
9672	146	97	194	32741	0	33178
9673	32055	54	74	416	0	32599
9674	242	32008	72	184	0	32506
9675	121	32210	47	154	0	32532
9676	186	296	85	32215	0	32782
9677	100	101	55	32862	0	33118
9678	100	46	36	32878	0	33060
9679	73	33677	52	329	0	34131
9680	94	191	42	34183	0	34510
9681	50	109	34019	274	0	34452
9682	54	71	30805	138	0	31068
9683	31645	27	147	202	0	32021
9684	179	34	78	33575	0	33866
9685	33640	31	54	274	0	33999
9686	33234	21	34	226	0	33515
9687	149	33526	46	87	0	33808
9688	33826	104	38	204	0	34172
9689	34612	53	40	197	0	34902
9690	182	40	24	34639	0	34885
9691	133	26	40	35131	0	35330
9692	76	57	36555	177	0	36865
9693	54	37589	124	141	0	37908
9694	332	152	109	32425	0	33018
9695	92	50	40	39046	0	39228
9696	39125	32	16	341	0	39514
9697	171	22	24	39419	0	39636
9698	40114	26	37	331	0	40508
9699	267	77	33	41084	0	41461
9700	72	41595	41	323	0	42031
9701	42984	287	54	303	0	43628
9702	423	113	34	47401	0	47971
9703	272	59	25	50473	0	50829
9704	202	36	22	53214	0	53474
9705	69	62	52728	1035	0	53894
9706	185	30	794	52909	0	53918
9707	54055	33	230	1241	0	55559
9708	995	24	129	56928	0	58076
9709	443	46	73	62381	0	62943
9710	324	40	67	62015	0	62446
9711	131	60655	83	1689	0	62558
9712	114	63826	72	609	0	64621
9713	62824	1469	39	598	0	64930
9714	1278	63943	66	315	0	65602
9715	63636	1444	44	440	0	65564
9716	63706	434	48	418	0	64606
9717	63486	236	48	519	0	64289
9718	1774	178	62960	245	0	65157
9719	605	64401	1270	271	0	66547
9720	66259	1377	343	484	0	68463
9721	1672	431	160	66895	0	69158
9722	785	272	111	67373	0	68541
9723	548	217	89	68048	0	68902
9724	293	66628	91	1783	0	68795
9725	444	1349	54	67539	0	69386
9726	66985	435	46	1882	0	69348
9727	1633	267	53	65593	0	67546
9728	673	218	64	66773	0	67728
9729	378	219	65094	1936	0	67627
9730	319	232	66141	786	0	67478
9731	499	154	1549	66690	0	68892
9732	489	148	513	67520	0	68670
9733	238	68168	338	1928	0	70672
9734	460	1387	217	68224	0	70288
9735	457	440	146	70147	0	71190
9736	417	277	122	70629	0	71445
9737	68139	244	117	2468	0	70968
9738	1494	278	68920	1014	0	71706
9739	686	261	1332	70084	0	72363
9740	70336	227	418	2026	0	73007
9741	70882	228	254	1073	0	72437
9742	2004	238	191	70139	0	72572
9743	911	226	183	71654	0	72974
9744	69761	248	166	2351	0	72526
9745	1661	68813	223	1005	0	71702
9746	692	70374	222	759	0	72047
9747	677	1733	178	70567	0	73155
9748	70410	595	166	2072	0	73243
9749	71096	386	141	1167	0	72790
9750	69461	293	123	1077	0	70954
9751	1990	320	70379	707	0	73396
9752	65859	281	1386	1006	0	68532
9753	1966	282	68614	696	0	71558
9754	65797	231	1507	969	0	68504
9755	1825	67994	531	784	0	71134
9756	834	1490	68687	734	0	71745
9757	740	599	1554	68603	0	71496
9758	574	415	67894	2052	0	70935
9759	668	341	1580	67812	0	70401
9760	67034	320	579	2356	0	70289
9761	1751	345	67623	1123	0	70842
9762	936	296	1592	66937	0	69761
9763	674	71182	709	1941	0	74506
9764	777	1541	467	76206	0	78991
9765	739	533	430	76462	0	78164
9766	711	430	396	73532	0	75069
9767	75209	328	354	2620	0	78511
9768	75987	302	321	1420	0	78030
9769	2226	325	317	76105	0	78973
9770	1008	350	74064	2281	0	77703
9771	824	399	71722	1236	0	74181
9772	799	359	1836	75403	0	78397
9773	711	444	77446	2212	0	80813
9774	808	384	1687	77470	0	80349
9775	964	357	692	73708	0	75721
9776	850	302	453	79145	0	80750
9777	780	74951	472	2528	0	78731
9778	769	69871	514	1398	0	72552
9779	764	1833	411	79078	0	82086
9780	697	690	444	79563	0	81394
9781	761	481	417	79183	0	80842
9782	77013	395	363	2765	0	80536
9783	1937	413	78452	1376	0	82178
9784	964	331	1665	79317	0	82277
9785	78961	258	768	2541	0	82528
9786	1825	78857	665	1363	0	82710
9787	984	1569	487	82031	0	85071
9788	695	602	506	83451	0	85254
9789	600	442	505	82947	0	84494
9790	593	349	415	83077	0	84434
9791	526	355	79963	2854	0	83698
9792	73062	282	1586	1948	0	76878
9793	77374	301	625	1601	0	79901
9794	2061	324	77738	1176	0	81299
9795	74587	239	1620	1341	0	77787
9796	78128	283	632	1225	0	80268
9797	2192	297	78224	1033	0	81746
9798	953	80475	1710	1036	0	84174
9799	1013	1568	753	81199	0	84533
9800	723	493	85233	1903	0	88352
9801	668	81727	1500	1157	0	85052
9802	633	1064	79044	830	0	81571
9803	345	76654	1078	582	0	78659
9804	440	820	596	75608	0	77464
9805	328	260	75438	901	0	76927
9806	486	261	855	73027	0	74629
9807	315	184	76084	975	0	77558
9808	249	73679	745	500	0	75173
9809	68896	232	262	359	0	69749
9810	233	67696	113	120	0	68162
9811	100	73250	92	252	0	73694
9812	417	321	153	74722	0	75613
9813	146	133	66	76223	0	76568
9814	132	52	26	75951	0	76161
9815	141	35	40	74727	0	74943
9816	99	33	30	77556	0	77718
9817	75	66	82908	273	0	83322
9818	208	21	269	80477	0	80975
9819	116	32	69	84480	0	84697
9820	85058	13	45	819	0	85935
9821	85458	27	43	438	0	85966
9822	86688	41	26	392	0	87147
9823	627	22	27	87454	0	88130
9824	95910	37	14	886	0	96847
9825	102133	25	23	683	0	102864
9826	104080	25	33	500	0	104638
9827	1203	86	103545	103	0	104937
9828	100279	14	1009	453	0	101755
9829	106630	25	168	480	0	107303
9830	106984	18	109	364	0	107475
9831	1658	32	83	106487	0	108260
9832	455	129	108244	1106	0	109934
9833	570	18	1111	106274	0	107973
9834	110116	17	217	1624	0	111974
9835	1548	35	139	111141	0	112863
9836	377	116264	142	1128	0	117911
9837	533	1048	48	120594	0	122223
9838	120533	164	84	1741	0	122522
9839	121432	102	94	779	0	122407
9840	120033	87	86	728	0	120934
9841	1661	127	123607	191	0	125586
9842	920	56	1322	120363	0	122661
9843	640	81	269	126958	0	127948
9844	310	126	127415	1646	0	129497
9845	269	122755	1418	563	0	125005
9846	318	1327	124615	346	0	126606
9847	544	269	1453	126426	0	128692
9848	127648	142	408	1910	0	130108
9849	1573	192	130195	507	0	132467
9850	754	103	1466	129875	0	132198
9851	412	173	131558	1568	0	133711
9852	125525	97	1637	911	0	128170
9853	1872	78	453	132791	0	135194
9854	605	183	137717	1667	0	140172
9855	774	60	1594	135498	0	137926
9856	390	160	138932	1848	0	141330
9857	363	139086	1682	715	0	141846
9858	655	1399	531	140669	0	143254
9859	141869	317	381	2127	0	144694
9860	2029	195	337	142218	0	144779
9861	910	98	353	141504	0	142865
9862	140584	69	320	2505	0	143478
9863	1877	131660	332	802	0	134671
9864	671	135420	314	660	0	137065
9865	728	1734	260	135236	0	137958
9866	490	136043	321	1784	0	138638
9867	668	1589	253	137170	0	139680
9868	655	419	223	138409	0	139706
9869	136852	293	231	2608	0	139984
9870	1794	135697	271	906	0	138668
9871	713	1735	133787	707	0	136942
9872	597	138591	1563	611	0	141362
9873	136826	1736	463	1075	0	140100
9874	140612	469	366	993	0	142440
9875	2496	311	354	139009	0	142170
9876	140874	282	296	2559	0	144011
9877	2363	327	329	140629	0	143648
9878	139366	304	348	2759	0	142777
9879	141239	310	340	1379	0	143268
9880	2760	263	351	144543	0	147917
9881	144812	201	313	2962	0	148288
9882	2547	235	145261	971	0	149014
9883	140537	195	1909	1266	0	143907
9884	2741	222	655	145303	0	148921
9885	146620	197	541	2705	0	150063
9886	2704	147829	509	927	0	151969
9887	1671	1755	423	148235	0	152084
9888	1420	454	492	149948	0	152314
9889	147711	321	574	3210	0	151816
9890	2942	471	146918	1264	0	151595
9891	1314	146134	2019	1147	0	150614
9892	1506	1880	641	147955	0	151982
9893	1058	148188	593	2401	0	152240
9894	1221	1988	489	151131	0	154829
9895	1298	721	506	148533	0	151058
9896	1297	504	448	153013	0	155262
9897	150717	548	440	3543	0	155248
9898	2614	574	384	148245	0	151817
9899	147697	560	365	3499	0	152121
9900	144823	524	457	2050	0	147854
9901	3020	454	417	145738	0	149629
9902	144351	375	521	3344	0	148591
9903	141869	387	546	2085	0	144887
9904	2950	593	143325	1276	0	148144
9905	1665	475	2186	139300	0	143626
9906	143738	525	809	3164	0	148236
9907	2575	143257	705	1384	0	147921
9908	144769	2016	613	1826	0	149224
9909	145332	601	492	1735	0	148160
9910	3174	487	141711	1073	0	146445
9911	1824	370	2250	135305	0	139749
9912	148842	337	827	3570	0	153576
9913	3324	377	726	152799	0	157226
9914	1968	402	514	161080	0	163964
9915	1670	352	583	163214	0	165819
9916	1619	345	599	173611	0	176174
9917	171203	282	572	5345	0	177402
9918	4343	488	177338	1990	0	184159
9919	2431	619	3691	179629	0	186370
9920	1266	549	192145	4675	0	198635
9921	1076	458	191448	2292	0	195274
9922	185827	322	6328	2536	0	195013
9923	5776	385	200327	1366	0	207854
9924	2409	191275	5456	1028	0	200168
9925	190088	4574	2980	1440	0	199082
9926	193004	1861	1268	1279	0	197412
9927	7392	779	721	186624	0	195516
9928	3091	428	191267	4833	0	199619
9929	1581	412	186601	2360	0	190954
9930	190461	311	6580	1860	0	199212
9931	6191	416	2991	196233	0	205831
9932	198905	378	1350	5816	0	206449
9933	6051	204348	1087	2571	0	214057
9934	204514	4927	990	2070	0	212501
9935	203898	2185	929	1747	0	208759
9936	7591	201419	1075	968	0	211053
9937	4348	5298	862	199093	0	209601
9938	199803	2365	715	6021	0	208904
9939	6455	1214	199675	2729	0	210073
9940	3521	200761	5640	1533	0	211455
9941	2935	5399	2688	198177	0	209199
9942	199861	2416	1527	6092	0	209896
9943	6299	203411	1006	2870	0	213586
9944	205465	5791	871	2229	0	214356
9945	7310	2972	202466	1287	0	214035
9946	199141	1508	5806	1756	0	208211
9947	7536	1140	205198	1056	0	214930
9948	200081	1009	6583	1630	0	209303
9949	199292	904	3071	1858	0	205125
9950	8865	987	198424	1178	0	209454
9951	4543	199580	6091	1411	0	211625
9952	3833	5684	3256	190074	0	202847
9953	2455	2827	202038	6038	0	213358
9954	2351	198307	6455	3323	0	210436
9955	3138	5960	3482	191295	0	203875
9956	3117	2987	2228	201743	0	210075
9957	2449	1848	198209	8134	0	210640
9958	3182	1232	6999	191041	0	202454
9959	2972	1167	4271	199473	0	207883
9960	2301	1243	197765	8627	0	209936
9961	3177	1186	7494	184351	0	196208
9962	2359	195240	4548	6932	0	209079
9963	196713	6222	3067	4364	0	210366
9964	7853	3237	2770	191720	0	205580
9965	4515	198106	2945	6922	0	212488
9966	4475	6540	2792	180847	0	194654
9967	3205	202327	2929	6748	0	215209
9968	3328	7226	199874	3918	0	214346
9969	3044	204123	7524	3221	0	217912
9970	200981	7493	4471	3413	0	216358
9971	203580	3778	3321	3218	0	213897
9972	208532	2791	2713	3523	0	217559
9973	10929	2365	208004	2838	0	224136
9974	6089	2359	205391	2787	0	216626
9975	4517	210726	9784	2562	0	227589
9976	4994	7843	5205	194097	0	212139
9977	4128	216766	3381	6883	0	231158
9978	5591	8874	2811	187817	0	205093
9979	4063	217626	2793	7188	0	231670
9980	215210	9136	2609	4844	0	231799
9981	230320	5120	2795	3739	0	241974
9982	12582	3850	2835	230438	0	249705
9983	7345	3211	229171	9148	0	248875
9984	221819	3026	9024	5943	0	239812
9985	11189	233075	5236	3735	0	253235
9986	7611	9100	4089	226467	0	247267
9987	6609	5292	3401	221489	0	236791
9988	5047	233538	3575	10317	0	252477
9989	233444	9736	3316	6359	0	252855
9990	11314	5851	232053	3879	0	253097
9991	7701	4402	9488	230383	0	251974
9992	232748	3652	5397	10079	0	251876
9993	233277	3568	4094	6392	0	247331
9994	13355	232741	3397	4563	0	254056
9995	8612	9492	3458	221983	0	243545
9996	5408	236372	3515	9544	0	254839
9997	238438	10378	3223	6853	0	258892
9998	11034	6060	237640	4793	0	259527
9999	6988	4916	238848	4134	0	254886
10000	6009	3817	11682	234674	0	256182
10001	5101	3761	6369	231932	0	247163
10002	4402	238769	4541	11897	0	259609
10003	4871	9969	3716	239556	0	258112
10004	4135	5895	238067	11700	0	259797
10005	231336	4320	9932	7635	0	253223
10006	10646	3992	5646	240401	0	260685
10007	6123	4029	238404	11202	0	259758
10008	5220	3928	9782	237608	0	256538
10009	4514	3726	5869	232620	0	246729
10010	3647	239726	4455	12593	0	260421
10011	4795	9841	3441	237610	0	255687
10012	4430	5528	3632	233075	0	246665
10013	4644	4127	3502	232807	0	245080
10014	211079	2789	2958	13611	0	230437
10015	8698	206484	3123	7606	0	225911
10016	5079	205951	2578	5084	0	218692
10017	194629	8482	2289	4333	0	209733
10018	185827	4400	2263	4013	0	196503
10019	8484	178967	2140	2972	0	192563
10020	3742	172217	1456	2349	0	179764
10021	157696	5722	1329	2425	0	167172
10022	4863	157946	1029	2026	0	165864
10023	2350	162648	933	1922	0	167853
10024	157505	5897	1545	2382	0	167329
10025	4846	161208	909	1871	0	168834
10026	158803	5416	961	2373	0	167553
10027	156936	2756	941	2190	0	162823
10028	156400	2320	890	2073	0	161683
10029	6456	158299	902	1478	0	167135
10030	3221	159092	700	1486	0	164499
10031	2899	5500	556	149398	0	158353
10032	2145	151380	676	4018	0	158219
10033	2470	5400	664	154225	0	162759
10034	155123	2687	763	5320	0	163893
10035	5147	2236	637	151730	0	159750
10036	2565	151920	730	5003	0	160218
10037	149167	4696	690	2864	0	157417
10038	4874	147732	640	2791	0	156037
10039	2578	154187	604	1854	0	159223
10040	2854	6637	609	142121	0	152221
10041	1824	149254	680	3855	0	155613
10042	145845	4939	957	2470	0	154211
10043	4421	2626	144070	1794	0	152911
10044	2150	143240	3611	1770	0	150771
10045	2147	4360	1615	143355	0	151477
10046	1613	2603	143702	4469	0	152387
10047	2021	2001	3674	139820	0	147516
10048	1817	1743	1857	143111	0	148528
10049	1912	1595	1383	145497	0	150387
10050	1659	1518	1161	144392	0	148730
10051	1461	1465	140409	6161	0	149496
10052	1243	139156	3977	3838	0	148214
10053	136346	4137	1892	3442	0	145817
10054	3972	2489	135775	2566	0	144802
10055	131945	2010	3783	2943	0	140681
10056	4625	1722	137284	2250	0	145881
10057	2796	1546	4332	136137	0	144811
10058	2253	1588	136690	4589	0	145120
10059	1898	1539	139069	2599	0	145105
10060	1973	1450	5119	136536	0	145078
10061	2322	1458	3008	127094	0	133882
10062	1904	1438	1759	141827	0	146928
10063	1752	1615	1386	140630	0	145383
10064	137338	1668	1251	6730	0	146987
10065	4208	1528	138417	3806	0	147959
10066	137213	1495	3754	3552	0	146014
10067	139905	1513	1790	2943	0	146151
10068	139711	1530	1438	2532	0	145211
10069	138866	1640	1030	2309	0	143845
10070	139907	1550	873	2232	0	144562
10071	7237	1418	758	134649	0	144062
10072	3852	1456	125745	4113	0	135166
10073	2653	1407	122677	2418	0	129155
10074	2097	126524	3423	2021	0	134065
10075	121242	3537	2011	1964	0	128754
10076	3774	2406	1199	118567	0	125946
10077	2473	2495	774	115761	0	121503
10078	2030	116577	658	3939	0	123204
10079	1841	115940	666	2319	0	120766
10080	1803	115246	525	1598	0	119172
10081	100282	3220	841	1376	0	105719
10082	2257	1723	310	94388	0	98678
10083	967	94550	275	1893	0	97685
10084	911	1935	237	94935	0	98018
10085	608	1082	94899	2019	0	98608
10086	713	819	99815	1005	0	102352
10087	1019	665	2093	107893	0	111670
10088	110615	685	836	2827	0	114963
10089	115340	651	430	1491	0	117912
10090	115649	618	326	1237	0	117830
10091	3548	756	115305	743	0	120352
10092	1897	769	2439	112738	0	117843
10093	1325	685	1046	118714	0	121770
10094	932	785	114431	3385	0	119533
10095	105802	633	2572	2125	0	111132
10096	3056	611	116060	1204	0	120931
10097	1261	533	113385	805	0	115984
10098	821	439	116030	757	0	118047
10099	1032	393	3480	110001	0	114906
10100	919	356	1501	114202	0	116978
10101	562	367	117319	3329	0	121577
10102	974	310	2871	116069	0	120224
10103	118449	258	1472	3599	0	123778
10104	3064	276	1036	121609	0	125985
10105	1256	350	123536	3381	0	128523
10106	817	304	128703	1759	0	131583
10107	1016	287	3801	125948	0	131052
10108	131540	293	1756	3858	0	137447
10109	3292	138936	1296	1751	0	145275
10110	141508	3218	1053	1690	0	147469
10111	143447	1294	1077	1533	0	147351
10112	5095	640	146401	1097	0	153233
10113	2850	319	4140	144632	0	151941
10114	147483	291	2110	4845	0	154729
10115	145889	270	1463	2893	0	150515
10116	5033	148289	1123	1634	0	156079
10117	3210	3377	1030	146976	0	154593
10118	2149	1379	1011	153436	0	157975
10119	1284	737	150855	5250	0	158126
10120	1742	371	4158	147022	0	153293
10121	1243	426	150999	4863	0	157531
10122	1465	400	149025	2392	0	153282
10123	1775	389	4924	144380	0	151468
10124	144191	314	2471	4609	0	151585
10125	4021	142037	1613	2478	0	150149
10126	140790	3262	1340	2020	0	147412
10127	140916	1473	1083	1820	0	145292
10128	5170	140774	1056	1243	0	148243
10129	3104	3237	936	133332	0	140609
10130	134211	1538	748	3806	0	140303
10131	4029	135317	806	1871	0	142023
10132	132807	3213	665	1826	0	138511
10133	3994	131606	768	999	0	137367
10134	2458	3216	692	127753	0	134119
10135	1861	1474	672	132073	0	136080
10136	128145	894	690	4671	0	134400
10137	125570	731	584	2808	0	129693
10138	4284	129596	725	1660	0	136265
10139	2143	3021	127554	1272	0	133990
10140	1479	1405	126504	1181	0	130569
10141	1696	857	4108	120487	0	127148
10142	1083	129278	2156	3242	0	135759
10143	1503	2877	1444	131363	0	137187
10144	1471	1431	1076	130735	0	134713
10145	1607	975	965	131413	0	134960
10146	1140	853	130498	4629	0	137120
10147	1132	814	127344	2471	0	131761
10148	1191	131892	4112	1872	0	139067
10149	1513	3134	1948	131514	0	138109
10150	1605	1585	1247	138199	0	142636
10151	1446	1176	135173	4483	0	142278
10152	122352	1037	3456	3170	0	130015
10153	3933	791	1963	136667	0	143354
10154	2102	815	137134	3872	0	143923
10155	125704	750	3655	3256	0	133365
10156	3790	137022	1929	2095	0	144836
10157	2335	3355	141044	1725	0	148459
10158	2185	1676	3765	139314	0	146940
10159	139002	1169	2147	4613	0	146931
10160	3908	893	144931	2540	0	152272
10161	2406	807	4248	143212	0	150673
10162	2049	826	2417	144477	0	149769
10163	1543	857	1616	159070	0	163086
10164	157283	735	1486	6334	0	165838
10165	4134	154805	1455	3490	0	163884
10166	2610	3773	1275	156504	0	164162
10167	1664	1872	159783	4939	0	168258
10168	1831	1258	4487	151298	0	158874
10169	1448	153759	2293	4947	0	162447
10170	1310	164119	1630	2918	0	169977
10171	160051	4748	1261	2874	0	168934
10172	161552	2277	1238	2502	0	167569
10173	5786	1585	160224	1804	0	169399
10174	153397	1202	4269	2252	0	161120
10175	4946	160469	2351	1753	0	169519
10176	162176	4281	1434	2278	0	170169
10177	5539	2259	1075	161651	0	170524
10178	3196	1706	166810	4645	0	176357
10179	2859	1357	4299	164913	0	173428
10180	1993	1223	167786	5278	0	176280
10181	162116	1020	4914	3493	0	171543
10182	4895	1097	2489	167888	0	176369
10183	2550	173393	1539	5119	0	182601
10184	2347	4665	1227	174927	0	183166
10185	1753	2203	174240	5566	0	183762
10186	1373	168436	4442	3260	0	177511
10187	155587	3821	2140	2779	0	164327
10188	3622	154958	1608	1655	0	161843
10189	1662	155639	1203	1374	0	159878
10190	1730	4413	977	148929	0	156049
10191	994	154647	960	3537	0	160138
10192	1621	3856	881	155626	0	161984
10193	1164	1997	153792	3916	0	160869
10194	138954	1351	3200	2654	0	146159
10195	149837	1009	1430	1962	0	154238
10196	4293	1204	150672	1145	0	157314
10197	140389	924	3063	1833	0	146209
10198	3604	148074	1473	1169	0	154320
10199	149289	3117	1075	1453	0	154934
10200	4058	1563	821	147135	0	153577
10201	1846	1186	149669	3218	0	155919
10202	1322	154384	2976	1853	0	160535
10203	1517	2937	1501	152635	0	158590
10204	1322	1342	884	154532	0	158080
10205	147701	940	588	4271	0	153500
10206	140392	680	673	2465	0	144210
10207	3364	140876	761	1230	0	146231
10208	1283	133882	541	764	0	136470
10209	579	132223	412	500	0	133714
10210	1066	2032	550	129204	0	132852
10211	127730	562	515	2211	0	131018
10212	125566	365	200	1070	0	127201
10213	2060	330	191	124944	0	127525
10214	888	357	187	125372	0	126804
10215	123720	359	180	2276	0	126535
10216	1808	348	192	126331	0	128679
10217	630	406	126648	1767	0	129451
10218	120512	324	1269	1498	0	123603
10219	125281	332	380	1134	0	127127
10220	1994	400	129585	423	0	132402
10221	128915	338	1375	1118	0	131746
10222	2045	364	455	135390	0	138254
10223	1065	327	321	135111	0	136824
10224	740	305	340	137370	0	138755
10225	134567	318	313	2579	0	137777
10226	1758	140198	299	890	0	143145
10227	970	1532	335	140191	0	143028
10228	602	138650	356	1780	0	141388
10229	137894	1625	343	1293	0	141155
10230	2078	589	329	139917	0	142913
10231	1097	420	303	141295	0	143115
10232	728	142227	322	2184	0	145461
10233	656	2046	140696	849	0	144247
10234	818	661	1741	141580	0	144800
10235	141575	522	574	2709	0	145380
10236	153708	437	416	1560	0	156121
10237	3413	530	161043	683	0	165669
10238	1890	430	2981	159827	0	165128
10239	778	167148	1022	3062	0	172010
10240	991	3292	549	170472	0	175304
10241	168782	1185	419	4323	0	174709
10242	169187	675	402	2033	0	172297
10243	4780	561	360	166245	0	171946
10244	1693	166022	455	3498	0	171668
10245	175384	3422	316	2101	0	181223
10246	4341	1339	313	179431	0	185424
10247	178037	819	297	4738	0	183891
10248	186260	578	337	2510	0	189685
10249	5595	546	280	186261	0	192682
10250	2679	479	373	186213	0	189744
10251	1801	528	436	190511	0	193276
10252	1104	190328	379	5228	0	197039
10253	1666	3928	264	191810	0	197668
10254	1785	1316	253	193396	0	196750
10255	1194	839	187048	5169	0	194250
10256	1146	694	180097	2253	0	184190
10257	1366	596	4246	182119	0	188327
10258	181078	544	1399	5326	0	188347
10259	3876	183126	783	2131	0	189916
10260	175825	3628	530	2211	0	182194
10261	4611	1320	177514	1296	0	184741
10262	1892	837	167482	1313	0	171524
10263	1041	170516	4085	1215	0	176857
10264	1583	3391	1767	169878	0	176619
10265	736	1274	170894	3682	0	176586
10266	666	927	174242	1566	0	177401
10267	1216	769	3942	171827	0	177754
10268	171959	384	1554	4417	0	178314
10269	172844	293	1039	2161	0	176337
10270	4414	418	763	171280	0	176875
10271	1778	518	182312	3683	0	188291
10272	1827	429	3218	182300	0	187774
10273	1570	516	1338	180142	0	183566
10274	790	185481	984	3799	0	191054
10275	183070	3028	822	2551	0	189471
10276	183083	1121	787	1938	0	186929
10277	4004	187266	641	1433	0	193344
10278	2286	3212	626	175436	0	181560
10279	1084	182808	818	3415	0	188125
10280	179655	3331	752	2312	0	186050
10281	3800	1418	178000	1322	0	184540
10282	1913	870	167279	1095	0	171157
10283	1275	653	170614	966	0	173508
10284	1331	492	3983	168713	0	174519
10285	1127	461	1710	171574	0	174872
10286	170111	509	912	4772	0	176304
10287	3629	464	638	170038	0	174769
10288	1986	637	625	172957	0	176205
10289	1254	569	182410	4164	0	188397
10290	1047	593	174567	2047	0	178254
10291	169667	551	3791	2549	0	176558
10292	3137	180148	1646	1326	0	186257
10293	183115	3051	946	1829	0	188941
10294	4085	1178	897	182712	0	188872
10295	2136	693	998	181100	0	184927
10296	1142	182132	1033	4013	0	188320
10297	1264	3012	973	183824	0	189073
10298	180502	1184	751	4776	0	187213
10299	3727	881	659	182417	0	187684
10300	1849	778	183520	4069	0	190216
10301	1239	178764	3207	2441	0	185651
10302	173802	2966	1456	2484	0	180708
10303	176783	1332	1117	2231	0	181463
10304	176616	918	906	2170	0	180610
10305	178815	800	750	1863	0	182228
10306	5077	756	626	176082	0	182541
10307	2722	690	744	179475	0	183631
10308	1699	786	177155	4671	0	184311
10309	1873	642	3067	176556	0	182138
10310	1406	896	177188	4432	0	183922
10311	1704	588	3347	176220	0	181859
10312	174527	625	1461	5225	0	181838
10313	3576	179941	1217	2636	0	187370
10314	2201	3108	1004	181209	0	187522
10315	1725	1470	1060	185987	0	190242
10316	181169	822	928	5711	0	188630
10317	174906	597	914	3498	0	179915
10318	4706	726	177182	1963	0	184577
10319	2212	177901	3536	1807	0	185456
10320	1779	3188	1603	176008	0	182578
10321	1616	1328	1277	177532	0	181753
10322	173297	854	1248	5588	0	180987
10323	171184	689	1154	3425	0	176452
10324	4683	870	175048	1759	0	182360
10325	2301	799	172076	1560	0	176736
10326	1997	847	4400	166580	0	173824
10327	1706	715	1878	173066	0	177365
10328	1372	775	171143	4872	0	178162
10329	161716	562	3713	3221	0	169212
10330	4518	606	1708	170916	0	177748
10331	167505	430	1395	4777	0	174107
10332	3706	167031	1295	2338	0	174370
10333	167553	3106	951	2782	0	174392
10334	4291	1399	179824	1703	0	187217
10335	2215	175566	3515	1651	0	182947
10336	1208	168020	1155	952	0	171335
10337	157446	2357	2280	1806	0	163889
10338	154852	716	502	1361	0	157431
10339	2896	496	407	153539	0	157338
10340	1037	153742	446	2036	0	157261
10341	634	161281	500	976	0	163391
10342	992	2374	381	163962	0	167709
10343	163315	920	371	3168	0	167774
10344	166206	556	275	2004	0	169041
10345	3107	521	156398	550	0	160576
10346	148670	254	1753	1402	0	152079
10347	2369	173167	583	492	0	176611
10348	177206	3089	285	1180	0	181760
10349	4132	212486	335	503	0	217456
10350	1276	232030	378	501	0	234185
10351	2507	8032	394	243464	0	254397
10352	259558	2876	403	8295	0	271132
10353	267364	1774	219	3736	0	273093
10354	10712	1204	261148	1732	0	274796
10355	5921	669	7799	259614	0	274003
10356	264135	535	2529	9626	0	276825
10357	11190	540	1678	264878	0	278286
10358	267238	524	1222	10817	0	279801
10359	271153	426	1001	5270	0	277850
10360	12375	547	266155	2836	0	281913
10361	7471	450	8095	258020	0	274036
10362	5333	518	2877	268285	0	277013
10363	4099	514	1830	272835	0	279278
10364	2464	650	262729	12377	0	278220
10365	3205	400	8763	258606	0	270974
10366	3328	523	3214	247933	0	254998
10367	1561	254547	2358	11837	0	270303
10368	1363	8265	250701	5798	0	266127
10369	1103	257522	8740	4529	0	271894
10370	253603	9718	3091	4132	0	270544
10371	10105	3890	2093	240858	0	256946
10372	5418	2801	1803	232969	0	242991
10373	3001	245033	1548	10363	0	259945
10374	241016	9135	1236	5884	0	257271
10375	246316	3601	811	4905	0	255633
10376	11742	236501	1095	3465	0	252803
10377	5354	248817	958	2815	0	257944
10378	243720	10993	934	2837	0	258484
10379	10931	5048	239700	2106	0	257785
10380	5111	3611	240265	1990	0	250977
10381	228553	3075	10537	2818	0	244983
10382	10015	241320	4867	1573	0	257775
10383	241903	9490	3254	2469	0	257116
10384	11421	4217	236732	1853	0	254223
10385	235419	3126	8995	3194	0	250734
10386	11789	248316	3770	2066	0	265941
10387	7079	9868	2704	246073	0	265724
10388	6099	3978	2272	252703	0	265052
10389	5840	3010	1928	233992	0	244770
10390	4793	2593	1500	244490	0	253376
10391	4393	2226	1451	234108	0	242178
10392	3023	236919	1688	14714	0	256344
10393	235925	9130	1520	8450	0	255025
10394	10603	4081	235009	6002	0	255695
10395	5968	3066	8967	238084	0	256085
10396	4311	2830	238364	11800	0	257305
10397	4410	2268	10874	236863	0	254415
10398	3955	1871	5175	244530	0	255531
10399	235879	1875	3880	15037	0	256671
10400	10360	2213	232890	8015	0	253478
10401	5028	231030	10272	6241	0	252571
10402	4793	9370	4625	232120	0	250908
10403	4208	4280	3337	242540	0	254365
10404	3404	3742	235852	13600	0	256598
10405	3933	3120	10040	234625	0	251718
10406	3558	3066	4167	245116	0	255907
10407	228566	2384	3136	15819	0	249905
10408	10007	234831	2960	8594	0	256392
10409	234589	10145	2328	7163	0	254225
10410	241793	4851	2010	6059	0	254713
10411	14596	3896	1691	235185	0	255368
10412	7871	3406	231390	11524	0	254191
10413	6293	3067	234235	5791	0	249386
10414	5751	2768	12253	226820	0	247592
10415	5699	2505	6012	220211	0	234427
10416	3853	229225	4995	13034	0	251107
10417	226760	9489	4019	7989	0	248257
10418	11318	224504	3731	6086	0	245639
10419	5962	235269	2867	5738	0	249836
10420	228677	12732	2427	5662	0	249498
10421	12780	6315	2410	223187	0	244692
10422	6592	234737	2306	11945	0	255580
10423	5928	11349	2076	236035	0	255388
10424	4124	5657	229921	14253	0	253955
10425	3773	4104	232330	8572	0	248779
10426	3760	3413	12130	233111	0	252414
10427	2898	3212	234423	13897	0	254430
10428	3590	2589	12325	232212	0	250716
10429	3288	2481	6493	235706	0	247968
10430	3139	2586	5256	242847	0	253828
10431	226154	2481	4025	17306	0	249966
10432	9680	219875	3768	10008	0	243331
10433	4598	231971	3284	7753	0	247606
10434	214789	11473	2418	7047	0	235727
10435	222249	5882	2132	6121	0	236384
10436	13259	4954	2043	216468	0	236724
10437	6635	4306	214756	11566	0	237263
10438	5778	3683	9259	216459	0	235179
10439	4729	3006	215736	12591	0	236062
10440	3815	214264	10632	7327	0	236038
10441	3915	9449	5156	214542	0	233062
10442	208814	4406	4015	12192	0	229427
10443	11011	3521	3256	210876	0	228664
10444	5414	2905	199843	11535	0	219697
10445	192533	2777	9301	6995	0	211606
10446	10891	2560	199832	5322	0	218605
10447	6308	2079	187377	3900	0	199664
10448	4114	172290	9180	3898	0	189482
10449	2168	134338	3549	2170	0	142225
10450	2058	125260	3266	1832	0	132416
10451	95342	3114	4884	2331	0	105671
10452	86643	364	819	860	0	88686
10453	1102	253	241	89007	0	90603
10454	540	178	252	89149	0	90119
10455	419	183	281	91526	0	92409
10456	233	91336	252	1072	0	92893
10457	90846	778	222	884	0	92730
10458	797	91510	236	368	0	92911
10459	448	834	218	92372	0	93872
10460	89693	343	217	1260	0	91513
10461	963	276	193	89672	0	91104
10462	471	280	161	91311	0	92223
10463	90744	224	172	1583	0	92723
10464	88196	236	197	1036	0	89665
10465	1068	318	89950	380	0	91716
10466	491	312	87193	375	0	88371
10467	332	310	91227	386	0	92255
10468	549	206	1023	90118	0	91896
10469	458	243	362	92384	0	93447
10470	263	93298	273	1159	0	94993
10471	95676	898	223	999	0	97796
10472	1260	315	216	97503	0	99294
10473	591	260	240	99127	0	100218
10474	359	98469	288	1461	0	100577
10475	287	103814	284	679	0	105064
10476	469	1282	211	105438	0	107400
10477	533	445	213	116008	0	117199
10478	115194	321	201	2713	0	118429
10479	114950	250	235	1304	0	116739
10480	2345	237	211	115318	0	118111
10481	856	279	114484	2049	0	117668
10482	603	363	109684	917	0	111567
10483	669	305	1993	112182	0	115149
10484	776	215	755	110865	0	112611
10485	374	111104	459	2392	0	114329
10486	105521	1616	294	1439	0	108870
10487	2044	575	282	106333	0	109234
10488	637	444	105381	2006	0	108468
10489	714	287	1669	105173	0	107843
10490	345	286	104738	2217	0	107586
10491	482	294	103243	962	0	104981
10492	745	572	2099	104646	0	108062
10493	104072	251	929	2514	0	107766
10494	1727	214	104423	909	0	107273
10495	906	151	1805	102057	0	104919
10496	492	229	108687	1959	0	111367
10497	643	150	1882	107373	0	110048
10498	648	190	783	108111	0	109732
10499	404	204	107455	2357	0	110420
10500	396	228	102703	1212	0	104539
10501	1098	182	2407	94607	0	98294
10502	528	138	991	106713	0	108370
10503	510	116	796	107793	0	109215
10504	494	134	709	106208	0	107545
10505	104063	117	568	3221	0	107969
10506	104252	117	535	1905	0	106809
10507	1959	104775	662	1062	0	108458
10508	104337	1528	503	1367	0	107735
10509	2052	484	583	105027	0	108146
10510	105533	293	482	2839	0	109147
10511	2074	254	106951	1263	0	110542
10512	106949	184	2132	1421	0	110686
10513	2547	215	933	111253	0	114948
10514	1182	172	667	116716	0	118737
10515	114830	186	506	3599	0	119121
10516	2847	159	478	124076	0	127560
10517	937	242	127694	3533	0	132406
10518	122049	182	2857	2242	0	127330
10519	3072	129483	1077	1299	0	134931
10520	1544	2653	603	133597	0	138397
10521	996	849	142657	3568	0	148070
10522	1163	517	3264	139816	0	144760
10523	807	513	141292	4175	0	146787
10524	1203	320	3689	139334	0	144546
10525	721	142048	1374	4130	0	148273
10526	1271	3270	881	140802	0	146224
10527	758	147594	735	4235	0	153322
10528	1730	3970	722	137235	0	143657
10529	1293	1214	713	154629	0	157849
10530	1250	727	774	155737	0	158488
10531	1324	518	779	156022	0	158643
10532	1342	501	795	157544	0	160182
10533	778	681	152158	6308	0	159925
10534	1127	528	4124	151812	0	157591
10535	923	444	1683	155996	0	159046
10536	152087	393	1336	6809	0	160625
10537	3870	152866	956	3448	0	161140
10538	152713	4112	840	2976	0	160641
10539	4979	1455	721	154311	0	161466
10540	1569	1179	153454	5702	0	161904
10541	995	153666	4449	3073	0	162183
10542	149729	4300	1685	3055	0	158769
10543	4238	150171	1187	2473	0	158069
10544	1520	158005	1003	2138	0	162666
10545	154107	5300	856	2571	0	162834
10546	5169	1935	767	163183	0	171054
10547	162301	1144	845	6582	0	170872
10548	5901	804	914	158972	0	166591
10549	2059	932	158435	6654	0	168080
10550	1553	872	157792	3225	0	163442
10551	151252	858	5821	2990	0	160921
10552	159976	885	2363	2416	0	165640
10553	6918	719	1486	153371	0	162494
10554	3185	739	1172	157301	0	162397
10555	147514	924	1012	7411	0	156861
10556	5432	147011	882	3411	0	156736
10557	2469	153981	895	2514	0	159859
10558	150113	5899	824	2344	0	159180
10559	152368	2261	800	2196	0	157625
10560	6803	151071	879	1919	0	160672
10561	3689	5154	769	149611	0	159223
10562	2302	2047	148778	5864	0	158991
10563	1904	1462	150161	2812	0	156339
10564	144903	1125	6189	2417	0	154634
10565	6050	1059	149499	1926	0	158534
10566	3533	888	5380	142994	0	152795
10567	2765	889	2140	141071	0	146865
10568	1798	144505	1579	6563	0	154445
10569	144573	4976	1259	3434	0	154242
10570	6368	2112	1177	143386	0	153043
10571	2699	1747	139947	5779	0	150172
10572	2190	139600	4729	3116	0	149635
10573	2395	5374	1967	137352	0	147088
10574	1659	2224	137486	5731	0	147100
10575	1605	1649	134156	3034	0	140444
10576	1315	131768	5726	2487	0	141296
10577	119481	4289	2519	1940	0	128229
10578	4343	122655	1626	1781	0	130405
10579	122012	4488	1379	1900	0	129779
10580	4676	1882	120660	1767	0	128985
10581	116332	1299	4278	2285	0	124194
10582	4527	120885	2002	1914	0	129328
10583	2502	4356	1555	120323	0	128736
10584	1815	1956	1213	126306	0	131290
10585	123141	1468	1284	5828	0	131721
10586	4548	1462	122501	2833	0	131344
10587	121148	1394	4214	2535	0	129291
10588	124817	1221	1970	2279	0	130287
10589	5457	1198	119664	1906	0	128225
10590	2513	1358	123104	1838	0	128813
10591	2314	1379	5136	120023	0	128852
10592	121680	1285	2283	5177	0	130425
10593	123169	1383	1589	2701	0	128842
10594	5572	123044	1573	2048	0	132237
10595	3208	4351	1295	124076	0	132930
10596	2655	2067	1119	123132	0	128973
10597	2315	1461	1192	125071	0	130039
10598	2235	1089	1160	127387	0	131871
10599	123376	1068	1222	6452	0	132118
10600	5594	1105	1330	124866	0	132895
10601	2843	1192	122534	5522	0	132091
10602	2604	1116	121190	2642	0	127552
10603	117227	1074	5283	2506	0	126090
10604	5342	118655	2501	2009	0	128507
10605	2826	124853	1817	1849	0	131345
10606	2687	5063	1500	123052	0	132302
10607	2587	2117	1347	126579	0	132630
10608	2337	1585	1323	125496	0	130741
10609	2273	1248	1311	128562	0	133394
10610	1728	1315	122990	6689	0	132722
10611	2217	1062	4162	120990	0	128431
10612	2160	957	1849	121554	0	126520
10613	1706	1005	113662	5788	0	122161
10614	104348	784	4193	3470	0	112795
10615	4211	109784	2121	2619	0	118735
10616	100896	3083	1498	2019	0	107496
10617	3830	1223	98258	1679	0	104990
10618	1889	924	95820	1438	0	100071
10619	1364	95378	3635	1290	0	101667
10620	88375	3804	5014	1780	0	98973
10621	82687	1137	1212	1357	0	86393
10622	83318	759	779	1159	0	86015
10623	3103	81202	700	1126	0	86131
10624	78613	2168	731	1009	0	82521
10625	2712	913	78623	929	0	83177
10626	1252	78251	2180	920	0	82603
10627	74457	1997	1111	959	0	78524
10628	2330	76487	730	739	0	80286
10629	73968	2094	571	718	0	77351
10630	71101	844	558	756	0	73259
10631	2515	576	73185	516	0	76792
10632	1242	73394	1966	476	0	77078
10633	72114	1838	882	640	0	75474
10634	2172	805	71646	431	0	75054
10635	1126	71359	1847	504	0	74836
10636	1098	1799	798	68962	0	72657
10637	697	752	69227	1552	0	72228
10638	619	600	66897	689	0	68805
10639	796	581	1722	66353	0	69452
10640	65318	335	757	1635	0	68045
10641	1500	65422	540	740	0	68202
10642	824	1346	64445	522	0	67137
10643	780	571	62881	378	0	64610
10644	58478	442	1532	470	0	60922
10645	1338	62880	703	286	0	65207
10646	54633	693	443	247	0	56016
10647	792	54842	180	115	0	55929
10648	55516	754	299	277	0	56846
10649	54127	290	197	247	0	54861
10650	991	53677	187	111	0	54966
10651	521	837	156	54105	0	55619
10652	56931	320	158	903	0	58312
10653	1082	250	134	57942	0	59408
10654	554	172	135	60738	0	61599
10655	60209	134	165	1447	0	61955
10656	1113	60235	177	436	0	61961
10657	60686	1072	132	572	0	62462
10658	1304	390	60595	170	0	62459
10659	634	271	1076	60315	0	62296
10660	476	204	342	60872	0	61894
10661	60240	150	218	1470	0	62078
10662	60488	192	163	657	0	61500
10663	1566	178	128	60195	0	62067
10664	629	245	60765	1216	0	62855
10665	603	193	1065	59970	0	61831
10666	475	185	398	61356	0	62414
10667	486	126	271	61956	0	62839
10668	432	158	199	62187	0	62976
10669	60799	181	168	1798	0	62946
10670	1377	178	60641	674	0	62870
10671	591	60868	1155	502	0	63116
10672	545	1102	417	60396	0	62460
10673	475	402	268	63315	0	64460
10674	358	293	62469	1674	0	64794
10675	383	258	61244	787	0	62672
10676	514	154	1450	62110	0	64228
10677	442	161	537	63262	0	64402
10678	367	225	61965	1737	0	64294
10679	487	186	1330	61076	0	63079
10680	61431	189	513	1902	0	64035
10681	1398	62661	431	813	0	65303
10682	576	1290	61896	651	0	64413
10683	486	61759	1384	501	0	64130
10684	502	1437	556	61532	0	64027
10685	375	551	62217	1529	0	64672
10686	406	61756	1432	737	0	64331
10687	484	1360	554	62460	0	64858
10688	368	517	63695	1518	0	66098
10689	554	378	1460	62292	0	64684
10690	482	297	546	63190	0	64515
10691	62850	259	465	2102	0	65676
10692	1586	257	408	63231	0	65482
10693	62954	260	319	2006	0	65539
10694	60884	253	337	1035	0	62509
10695	60710	293	356	853	0	62212
10696	1988	255	363	59461	0	62067
10697	753	220	57355	1630	0	59958
10698	489	222	55762	879	0	57352
10699	56314	197	1573	885	0	58969
10700	1471	217	58674	560	0	60922
10701	55890	157	1431	801	0	58279
10702	1516	58307	624	554	0	61001
10703	58792	1179	408	743	0	61122
10704	1620	395	60210	575	0	62800
10705	690	325	62339	510	0	63864
10706	685	229	1729	62975	0	65618
10707	431	186	66018	1759	0	68394
10708	426	189	67540	754	0	68909
10709	669	190	2063	67728	0	70650
10710	598	190	789	71226	0	72803
10711	599	232	528	73321	0	74680
10712	361	73757	516	2516	0	77150
10713	714	1869	461	70382	0	73426
10714	327	76012	462	2154	0	78955
10715	75389	2120	455	1186	0	79150
10716	77792	725	450	970	0	79937
10717	2777	416	455	73924	0	77572
10718	997	74639	476	2484	0	78596
10719	616	2073	76114	1059	0	79862
10720	75562	658	2356	1063	0	79639
10721	2594	456	917	75747	0	79714
10722	1216	349	648	76990	0	79203
10723	1005	396	452	78806	0	80659
10724	75556	268	452	3482	0	79758
10725	2500	72505	489	1484	0	76978
10726	939	75660	515	1048	0	78162
10727	72109	2545	499	945	0	76098
10728	2390	73696	480	756	0	77322
10729	73586	2442	466	915	0	77409
10730	74146	819	488	1038	0	76491
10731	2886	73279	495	869	0	77529
10732	1426	2396	468	70631	0	74921
10733	806	73489	532	2456	0	77283
10734	929	2509	404	72961	0	76803
10735	940	952	338	77442	0	79672
10736	75391	728	365	3594	0	80078
10737	78696	575	381	1658	0	81310
10738	3670	551	388	77416	0	82025
10739	1464	647	75840	2986	0	80937
10740	73118	555	2509	1648	0	77830
10741	2930	75912	1010	1129	0	80981
10742	1503	2695	700	75344	0	80242
10743	1272	1020	470	77899	0	80661
10744	1118	794	418	79011	0	81341
10745	74688	663	410	3945	0	79706
10746	75071	579	376	2186	0	78212
10747	3346	71184	459	1411	0	76400
10748	1544	73718	421	1123	0	76806
10749	1329	2938	390	72284	0	76941
10750	1230	1286	402	74341	0	77259
10751	945	870	72504	3430	0	77749
10752	991	762	2243	70035	0	74031
10753	742	511	69030	3113	0	73396
10754	767	460	65230	1426	0	67883
10755	620	65762	2515	1148	0	70045
10756	995	2246	1099	65746	0	70086
10757	66312	904	637	2871	0	70724
10758	2612	687	441	66219	0	69959
10759	1191	608	65680	2791	0	70270
10760	63647	606	2165	1485	0	67903
10761	66037	580	899	1206	0	68722
10762	3030	641	65401	897	0	69969
10763	1606	510	2154	67271	0	71541
10764	66321	468	942	2944	0	70675
10765	2709	68192	777	1454	0	73132
10766	69301	2372	540	1433	0	73646
10767	71831	1019	563	1231	0	74644
10768	3479	734	557	70099	0	74869
10769	1802	663	411	73092	0	75968
10770	71842	559	504	3581	0	76486
10771	3213	542	402	72465	0	76622
10772	1546	581	71265	3365	0	76757
10773	68031	553	2427	1811	0	72822
10774	70527	585	931	1468	0	73511
10775	3370	68197	622	1259	0	73448
10776	1559	71452	569	1168	0	74748
10777	1396	2928	438	67641	0	72403
10778	1106	70884	440	2733	0	75163
10779	1143	2820	429	71610	0	76002
10780	70687	1094	481	3215	0	75477
10781	70230	826	445	1730	0	73231
10782	3158	69173	454	1367	0	74152
10783	69084	2425	461	1318	0	73288
10784	3095	69385	462	1033	0	73975
10785	69500	2620	477	1164	0	73761
10786	70826	1181	489	1093	0	73589
10787	3507	898	67954	1035	0	73394
10788	66857	697	2237	1095	0	70886
10789	3225	66174	915	892	0	71206
10790	1694	69554	554	972	0	72774
10791	69210	2815	519	955	0	73499
10792	3287	1368	367	69122	0	74144
10793	1746	964	69337	2724	0	74771
10794	1647	792	2181	69720	0	74340
10795	1457	796	862	72241	0	75356
10796	1241	750	69714	3284	0	74989
10797	66150	680	2296	1776	0	70902
10798	2928	68963	952	1384	0	74227
10799	68315	2234	647	1141	0	72337
10800	3249	987	517	66267	0	71020
10801	65978	810	504	2658	0	69950
10802	3021	65514	399	1397	0	70331
10803	1701	2460	413	65546	0	70120
10804	64493	967	431	2764	0	68655
10805	2813	729	60741	1363	0	65646
10806	1384	554	55410	1105	0	58453
10807	52868	557	2277	996	0	56698
10808	2269	52982	904	840	0	56995
10809	1053	49481	459	589	0	51582
10810	1612	1919	662	45661	0	49854
10811	789	46255	334	1511	0	48889
10812	889	1503	410	46488	0	49290
10813	815	719	350	48588	0	50472
10814	714	467	369	47860	0	49410
10815	714	46819	342	1692	0	49567
10816	728	1281	327	45891	0	48227
10817	580	629	45016	1457	0	47682
10818	643	44146	998	753	0	46540
10819	583	1230	426	41556	0	43795
10820	551	42861	368	989	0	44769
10821	42646	1033	285	685	0	44649
10822	42588	529	263	609	0	43989
10823	42702	363	297	579	0	43941
10824	1415	43422	277	469	0	45583
10825	892	1034	207	43524	0	45657
10826	673	547	43066	1014	0	45300
10827	615	456	41323	608	0	43002
10828	40403	528	1027	653	0	42611
10829	42323	387	462	577	0	43749
10830	1280	334	278	44156	0	46048
10831	814	320	249	45213	0	46596
10832	584	389	45141	1459	0	47573
10833	498	44054	996	849	0	46397
10834	540	43150	503	557	0	44750
10835	394	965	42508	329	0	44196
10836	423	607	822	40807	0	42659
10837	534	339	426	34352	0	35651
10838	363	208	149	41827	0	42547
10839	367	217	150	41897	0	42631
10840	41430	215	132	1025	0	42802
10841	830	250	40040	374	0	41494
10842	39478	200	667	358	0	40703
10843	904	201	261	40336	0	41702
10844	40358	198	182	832	0	41570
10845	899	173	161	40470	0	41703
10846	432	217	40423	784	0	41856
10847	371	205	665	40591	0	41832
10848	256	214	41475	815	0	42760
10849	273	198	680	40431	0	41582
10850	230	183	42485	818	0	43716
10851	191	43571	682	423	0	44867
10852	274	639	310	43910	0	45133
10853	285	253	178	43674	0	44390
10854	186	44517	163	813	0	45679
10855	45275	672	149	501	0	46597
10856	780	242	140	45322	0	46484
10857	375	219	149	45278	0	46021
10858	45801	178	138	1066	0	47183
10859	46402	156	151	591	0	47300
10860	47839	135	147	475	0	48596
10861	47980	156	137	399	0	48672
10862	972	137	46280	288	0	47677
10863	44458	98	585	395	0	45536
10864	47013	102	276	341	0	47732
10865	914	102	190	44592	0	45798
10866	460	123	140	44333	0	45056
10867	43046	74	100	804	0	44024
10868	586	42886	107	390	0	43969
10869	347	471	73	42097	0	42988
10870	159	197	44078	567	0	45001
10871	109	43858	413	278	0	44658
10872	44120	441	293	320	0	45174
10873	44787	175	167	283	0	45412
10874	45026	105	75	243	0	45449
10875	45912	62	76	238	0	46288
10876	734	58	70	45134	0	45996
10877	299	79	44928	531	0	45837
10878	187	78	46917	268	0	47450
10879	227	98	769	49846	0	50940
10880	52520	43	301	866	0	53730
10881	985	47	136	52921	0	54089
10882	375	74	53405	954	0	54808
10883	52568	37	870	576	0	54051
10884	53613	38	326	371	0	54348
10885	1328	48	173	54171	0	55720
10886	493	81	56416	941	0	57931
10887	307	50	57061	407	0	57825
10888	54175	48	1150	461	0	55834
10889	981	56442	421	281	0	58125
10890	465	821	57683	216	0	59185
10891	406	244	949	57004	0	58603
10892	57543	105	416	1175	0	59239
10893	1021	55788	257	443	0	57509
10894	493	57003	208	278	0	57982
10895	56932	1056	180	377	0	58545
10896	1172	357	234	56728	0	58491
10897	60438	175	210	1188	0	62011
10898	1393	141	199	61207	0	62940
10899	670	165	185	62083	0	63103
10900	352	176	61560	1468	0	63556
10901	346	157	57706	654	0	58863
10902	384	168	61643	344	0	62539
10903	436	158	1490	61480	0	63564
10904	62080	152	576	1413	0	64221
10905	1414	142	62461	604	0	64621
10906	781	112	1252	62018	0	64163
10907	478	289	63191	1380	0	65338
10908	388	63988	1352	661	0	66389
10909	556	1160	558	64749	0	67023
10910	504	343	412	65330	0	66589
10911	475	163	383	66265	0	67286
10912	65158	132	436	1892	0	67618
10913	1498	123	357	64958	0	66936
10914	762	149	378	65780	0	67069
10915	64760	162	390	1951	0	67263
10916	1421	176	64149	835	0	66581
10917	63169	139	1368	736	0	65412
10918	64178	161	536	632	0	65507
10919	1749	201	63256	475	0	65681
10920	61725	167	1322	692	0	63906
10921	1659	130	560	64458	0	66807
10922	776	154	65615	1483	0	68028
10923	64070	103	1345	1035	0	66553
10924	66037	88	551	784	0	67460
10925	1925	68	395	65504	0	67892
10926	957	77	419	66154	0	67607
10927	770	63	414	66712	0	67959
10928	64804	71	390	2092	0	67357
10929	1575	64965	387	957	0	67884
10930	62978	970	400	781	0	65129
10931	1403	60623	451	534	0	63011
10932	722	60836	462	482	0	62502
10933	702	1243	404	61657	0	64006
10934	696	396	341	62545	0	63978
10935	626	199	328	61890	0	63043
10936	561	191	373	62293	0	63418
10937	533	207	60627	1748	0	63115
10938	58520	215	1168	1031	0	60934
10939	1443	254	495	61530	0	63722
10940	728	245	61393	1552	0	63918
10941	663	237	1173	61179	0	63252
10942	649	262	477	62521	0	63909
10943	547	332	64895	1719	0	67493
10944	635	262	1217	64473	0	66587
10945	665	234	543	64250	0	65692
10946	65611	203	406	2102	0	68322
10947	1376	165	66967	1042	0	69550
10948	63087	110	1256	1115	0	65568
10949	1399	67805	643	829	0	70676
10950	67050	1060	523	914	0	69547
10951	65690	338	600	891	0	67519
10952	1726	203	465	65454	0	67848
10953	794	184	65276	1680	0	67934
10954	577	68281	1399	953	0	71210
10955	740	1261	595	65464	0	68060
10956	462	71128	442	1570	0	73602
10957	70406	1447	433	1073	0	73359
10958	1659	524	69557	752	0	72492
10959	687	375	68696	754	0	70512
10960	739	276	1633	67966	0	70614
10961	595	302	71128	1790	0	73815
10962	757	239	1561	71567	0	74124
10963	669	295	645	70605	0	72214
10964	72517	237	446	2338	0	75538
10965	1716	73207	478	1029	0	76430
10966	823	1411	473	74290	0	76997
10967	734	413	485	76101	0	77733
10968	694	290	527	74912	0	76423
10969	559	73404	541	2135	0	76639
10970	479	75198	517	1089	0	77283
10971	73461	1527	463	1066	0	76517
10972	73623	503	486	922	0	75534
10973	73034	304	415	935	0	74688
10974	2021	291	71764	769	0	74845
10975	938	557	1441	70519	0	73455
10976	630	333	70798	1865	0	73626
10977	519	70675	1341	1003	0	73538
10978	66891	1256	575	833	0	69555
10979	1393	417	66108	478	0	68396
10980	661	354	978	63373	0	65366
10981	416	216	65107	1111	0	66850
10982	61939	139	1016	853	0	63947
10983	65597	147	387	710	0	66841
10984	65840	194	292	541	0	66867
10985	64477	166	250	543	0	65436
10986	1296	183	66226	308	0	68013
10987	63223	146	912	578	0	64859
10988	65618	136	403	470	0	66627
10989	1185	65316	318	291	0	67110
10990	64771	828	258	450	0	66307
10991	65982	235	239	467	0	66923
10992	1400	184	253	63460	0	65297
10993	503	68034	246	931	0	69714
10994	71813	932	195	619	0	73559
10995	77635	299	193	558	0	78685
10996	1840	320	85427	332	0	87919
10997	660	205	84257	201	0	85323
10998	457	166	86921	191	0	87735
10999	664	251	2349	84473	0	87737
11000	84868	156	905	2029	0	87958
11001	1900	85679	517	764	0	88860
11002	84685	1763	287	635	0	87370
11003	2064	85662	285	254	0	88265
11004	84015	1966	253	447	0	86681
11005	2057	83306	249	251	0	85863
11006	819	85973	241	198	0	87231
11007	81852	2242	207	500	0	84801
11008	1845	84716	207	158	0	86926
11009	1071	2019	162	83687	0	86939
11010	557	795	85716	1645	0	88713
11011	402	537	85969	583	0	87491
11012	648	311	2261	83972	0	87192
11013	612	277	840	87034	0	88763
11014	324	297	87133	2318	0	90072
11015	586	241	1963	84335	0	87125
11016	606	224	760	86548	0	88138
11017	86341	221	469	2727	0	89758
11018	1950	86933	399	1089	0	90371
11019	1122	1982	358	81053	0	84515
11020	552	87781	363	1727	0	90423
11021	86052	2131	344	1091	0	89618
11022	2028	87815	337	547	0	90727
11023	87319	2243	295	650	0	90507
11024	88166	890	259	633	0	89948
11025	2879	609	237	86361	0	90086
11026	1439	466	290	87161	0	89356
11027	1017	427	318	88578	0	90340
11028	820	423	350	88790	0	90383
11029	571	423	85197	2939	0	89130
11030	77672	406	1943	1770	0	81791
11031	2188	84760	721	807	0	88476
11032	1282	2098	475	86473	0	90328
11033	961	878	376	86768	0	88983
11034	592	87258	407	2647	0	90904
11035	87046	2208	423	1421	0	91098
11036	2231	88603	435	818	0	92087
11037	1230	2403	352	88858	0	92843
11038	964	1074	311	91312	0	93661
11039	848	747	312	92064	0	93971
11040	860	557	284	92215	0	93916
11041	89363	498	325	3519	0	93705
11042	2556	505	89794	1430	0	94285
11043	1297	508	2209	86804	0	90818
11044	997	485	1022	88187	0	90691
11045	820	468	784	89192	0	91264
11046	894	416	601	88476	0	90387
11047	83889	477	504	3747	0	88617
11048	2648	516	84345	1700	0	89209
11049	1464	632	2090	79077	0	83263
11050	938	79104	823	2462	0	83327
11051	749	84450	544	1330	0	87073
11052	81892	2795	331	1266	0	86284
11053	2619	1334	81360	802	0	86115
11054	74739	950	1839	1019	0	78547
11055	2611	745	78156	734	0	82246
11056	1299	555	2051	75387	0	79292
11057	76610	466	909	2610	0	80595
11058	1957	77872	765	1391	0	81985
11059	1227	1964	686	72845	0	76722
11060	771	71971	771	2092	0	75605
11061	76651	2128	553	1503	0	80835
11062	77478	940	523	1370	0	80311
11063	2746	674	466	77065	0	80951
11064	1295	618	75622	2614	0	80149
11065	1025	648	74811	1401	0	77885
11066	1037	753	2292	72970	0	77052
11067	713	73962	1007	2212	0	77894
11068	800	2384	525	78629	0	82338
11069	918	1272	364	75038	0	77592
11070	1051	870	308	74697	0	76926
11071	726	783	75815	3145	0	80469
11072	892	573	1994	74938	0	78397
11073	734	482	909	76040	0	78165
11074	460	74475	684	3628	0	79247
11075	536	2074	542	74447	0	77599
11076	562	841	539	78924	0	80866
11077	590	512	550	80390	0	82042
11078	646	391	569	80285	0	81891
11079	711	461	428	79414	0	81014
11080	575	576	411	79582	0	81144
11081	659	572	278	78420	0	79929
11082	653	675	301	77205	0	78834
11083	657	720	68962	6486	0	76825
11084	779	616	1748	73934	0	77077
11085	72319	567	718	3260	0	76864
11086	2346	411	472	71668	0	74897
11087	1173	429	71541	3139	0	76282
11088	68743	382	2007	2082	0	73214
11089	72863	397	869	1746	0	75875
11090	72876	403	591	1520	0	75390
11091	73483	346	480	1498	0	75807
11092	3333	368	371	73269	0	77341
11093	1407	279	71251	2988	0	75925
11094	843	66613	1824	1747	0	71027
11095	713	59599	859	1231	0	62402
11096	946	1478	1492	51832	0	55748
11097	333	292	366	55788	0	56779
11098	332	166	122	55455	0	56075
11099	277	113	100	58430	0	58920
11100	289	113	97	65320	0	65819
11101	67422	123	102	2415	0	70062
11102	1762	67572	130	946	0	70410
11103	661	70829	101	555	0	72146
11104	600	2408	119	71688	0	74815
11105	468	797	113	74157	0	75535
11106	432	367	105	74229	0	75133
11107	411	256	72	74524	0	75263
11108	218	235	70186	3203	0	73842
11109	248	68902	1886	1466	0	72502
11110	408	1926	574	69055	0	71963
11111	67570	797	271	2525	0	71163
11112	2023	443	178	68775	0	71419
11113	717	321	68253	2657	0	71948
11114	417	327	65996	1419	0	68159
11115	283	332	69239	989	0	70843
11116	419	353	2627	67356	0	70755
11117	69595	264	1077	2643	0	73579
11118	2063	248	510	70739	0	73560
11119	965	210	365	74270	0	75810
11120	72427	191	371	3340	0	76329
11121	2308	156	430	74531	0	77425
11122	1054	174	453	75969	0	77650
11123	524	177	78455	3078	0	82234
11124	430	78259	2216	1543	0	82448
11125	600	1919	881	81469	0	84869
11126	80271	617	574	2972	0	84434
11127	2333	302	454	81793	0	84882
11128	939	279	82009	2989	0	86216
11129	851	319	2148	80668	0	83986
11130	472	82442	836	2971	0	86721
11131	678	2152	491	84105	0	87426
11132	415	840	82963	3019	0	87237
11133	368	87434	2216	1616	0	91634
11134	684	2627	840	89379	0	93530
11135	643	1001	557	96250	0	98451
11136	587	576	478	97262	0	98903
11137	547	436	459	97819	0	99261
11138	284	412	93896	4540	0	99132
11139	229	93746	2851	2311	0	99137
11140	93788	2745	1128	1846	0	99507
11141	96396	1081	750	1484	0	99711
11142	3616	680	527	95100	0	99923
11143	1311	527	94077	3674	0	99589
11144	91272	345	2933	2155	0	96705
11145	3167	347	1212	95519	0	100245
11146	1174	414	97397	3773	0	102758
11147	1063	368	3069	97589	0	102089
11148	1014	343	1185	98888	0	101430
11149	917	290	754	100855	0	102816
11150	665	352	101584	4821	0	107422
11151	1133	378	3107	95193	0	99811
11152	635	101646	1369	3723	0	107373
11153	102042	2818	864	2287	0	108011
11154	103385	1066	754	1914	0	107119
11155	103873	675	657	1833	0	107038
11156	3974	102218	681	1524	0	108397
11157	102852	2911	618	1647	0	108028
11158	3754	1129	639	101481	0	107003
11159	101134	667	725	4225	0	106751
11160	101972	628	575	2490	0	105665
11161	4123	606	98660	1737	0	105126
11162	1890	97946	3041	1521	0	104398
11163	98120	2924	1346	1418	0	103808
11164	3672	1342	823	98133	0	103970
11165	1829	942	97410	3629	0	103810
11166	1457	97545	2949	1977	0	103928
11167	96864	2981	1286	1739	0	102870
11168	3845	1282	793	97584	0	103504
11169	2125	917	679	99509	0	103230
11170	1597	791	605	99135	0	102128
11171	1251	96992	592	4747	0	103582
11172	1365	2958	602	97843	0	102768
11173	975	96050	742	4152	0	101919
11174	1059	3280	760	98561	0	103660
11175	984	1557	97633	4217	0	104391
11176	1170	992	3054	98412	0	103628
11177	1002	745	1427	100620	0	103794
11178	966	660	1048	102570	0	105244
11179	783	795	98507	5265	0	105350
11180	1041	731	3132	98142	0	103046
11181	1031	613	1463	101742	0	104849
11182	902	652	1052	103135	0	105741
11183	929	671	887	102820	0	105307
11184	1088	642	763	103879	0	106372
11185	912	736	99633	5604	0	106885
11186	1096	622	2991	100209	0	104918
11187	1029	637	1487	101597	0	104750
11188	95718	515	1072	5594	0	102899
11189	3219	93956	873	3304	0	101352
11190	1663	97792	792	2638	0	102885
11191	1376	3404	748	97826	0	103354
11192	1144	1433	841	97060	0	100478
11193	862	92164	856	4816	0	98698
11194	1128	2880	619	92734	0	97361
11195	844	91937	629	4551	0	97961
11196	1247	2916	644	91600	0	96407
11197	1147	1394	548	90235	0	93324
11198	794	927	85442	3963	0	91126
11199	746	81883	2317	2509	0	87455
11200	647	79205	821	1682	0	82355
11201	70420	1959	804	1330	0	74513
11202	1661	71986	442	907	0	74996
11203	967	1871	325	71172	0	74335
11204	730	868	68987	1969	0	72554
11205	700	674	1382	68430	0	71186
11206	67336	537	621	2400	0	70894
11207	1607	563	68690	1254	0	72114
11208	736	70299	1495	1098	0	73628
11209	1252	1660	808	58932	0	62652
11210	589	690	513	73497	0	75289
11211	73210	524	440	2714	0	76888
11212	1601	518	399	74445	0	76963
11213	797	460	336	75226	0	76819
11214	658	509	300	75257	0	76724
11215	553	481	286	75013	0	76333
11216	72294	420	341	2899	0	75954
11217	71867	402	328	1889	0	74486
11218	1884	343	290	72763	0	75280
11219	70030	282	329	2303	0	72944
11220	1704	317	351	69245	0	71617
11221	739	335	66842	2210	0	70126
11222	596	357	64190	1451	0	66594
11223	696	555	1467	59586	0	62304
11224	418	60428	623	1886	0	63355
11225	460	1104	423	60654	0	62641
11226	59252	513	306	2128	0	62199
11227	1160	417	244	60701	0	62522
11228	58657	315	229	2217	0	61418
11229	1455	292	240	59757	0	61744
11230	712	321	59126	1830	0	61989
11231	471	57227	1039	1187	0	59924
11232	400	59817	429	1073	0	61719
11233	475	1345	261	53058	0	55139
11234	219	359	53766	1112	0	55456
11235	77	48166	345	307	0	48895
11236	161	380	171	48192	0	48904
11237	47310	111	151	558	0	48130
11238	264	116	48924	216	0	49520
11239	154	81	275	48923	0	49433
11240	139	60	84	51351	0	51634
11241	70	69	51196	505	0	51840
11242	99	72	47234	323	0	47728
11243	77	87	51632	211	0	52007
11244	148	94	494	52262	0	52998
11245	55	84	54128	480	0	54747
11246	49865	50	525	391	0	50831
11247	618	49	144	55336	0	56147
11248	253	79	63467	632	0	64431
11249	113	64122	700	311	0	65246
11250	99	662	63810	158	0	64729
11251	215	267	842	62953	0	64277
11252	65450	104	366	1072	0	66992
11253	859	58	166	67116	0	68199
11254	381	54	112	68177	0	68724
11255	71754	59	101	1307	0	73221
11256	1137	57	102	73064	0	74360
11257	312	68	74184	1175	0	75739
11258	70445	39	1075	717	0	72276
11259	1098	74555	386	295	0	76334
11260	75559	983	186	398	0	77126
11261	1333	293	117	75685	0	77428
11262	446	189	75239	1138	0	77012
11263	283	109	75067	421	0	75880
11264	403	161	1369	75692	0	77625
11265	319	74	509	75993	0	76895
11266	179	101	76853	1360	0	78493
11267	214	101	72055	554	0	72924
11268	74562	69	1462	522	0	76615
11269	1305	54	586	76845	0	78790
11270	77694	52	352	1449	0	79547
11271	1484	63	226	77023	0	78796
11272	487	95	79565	1458	0	81605
11273	334	108	81655	549	0	82646
11274	436	67	1705	83296	0	85504
11275	414	40	642	86416	0	87512
11276	193	72	88796	1869	0	90930
11277	85144	46	1823	969	0	87982
11278	2003	67	563	90986	0	93619
11279	93879	41	437	2241	0	96598
11280	2069	102976	420	721	0	106186
11281	889	2291	302	104976	0	108458
11282	105469	526	267	2931	0	109193
11283	2720	280	106584	900	0	110484
11284	1166	181	2628	105933	0	109908
11285	822	136	838	106824	0	108620
11286	691	195	470	110558	0	111914
11287	362	210	108485	3642	0	112699
11288	741	119	2770	104168	0	107798
11289	336	107386	992	3023	0	111737
11290	552	2445	592	109309	0	112898
11291	336	634	108775	3216	0	112961
11292	352	339	108989	1346	0	111026
11293	634	260	3466	108108	0	112468
11294	633	208	1141	110263	0	112245
11295	625	253	739	112149	0	113766
11296	578	196	603	113038	0	114415
11297	110013	143	607	4239	0	115002
11298	109620	144	619	1926	0	112309
11299	3428	183	108271	1202	0	113084
11300	1127	108484	2883	1120	0	113614
11301	918	2514	962	111584	0	115978
11302	114993	679	638	3881	0	120191
11303	99698	644	707	2526	0	103575
11304	116913	293	571	1370	0	119147
11305	117657	212	656	1238	0	119763
11306	3827	319	115367	891	0	120404
11307	109440	247	3050	1384	0	114121
11308	3455	111749	1107	986	0	117297
11309	1688	2668	734	113417	0	118507
11310	1081	802	114658	3338	0	119879
11311	1327	393	3167	112609	0	117496
11312	822	379	113863	3668	0	118732
11313	1049	292	3460	112679	0	117480
11314	920	356	1353	116917	0	119546
11315	114856	303	878	4623	0	120660
11316	3577	260	868	115798	0	120503
11317	1321	304	116442	4075	0	122142
11318	1174	288	3413	118644	0	123519
11319	118414	245	1368	4461	0	124488
11320	3637	240	1008	120036	0	124921
11321	1514	288	119754	4032	0	125588
11322	948	117607	3363	2202	0	124120
11323	122569	2838	1469	2068	0	128944
11324	3769	824	1096	117565	0	123254
11325	1477	126329	1090	3529	0	132425
11326	125326	3044	861	2272	0	131503
11327	3636	1000	125909	1567	0	132112
11328	1457	124557	3495	1511	0	131020
11329	1312	3095	1457	127889	0	133753
11330	1008	1035	127617	3922	0	133582
11331	1269	675	3559	123180	0	128683
11332	124344	497	1497	4581	0	130919
11333	3571	501	123823	2147	0	130042
11334	1678	481	3532	123293	0	128984
11335	1124	480	124221	4242	0	130067
11336	1362	438	3711	122304	0	127815
11337	1234	428	1524	126440	0	129626
11338	121916	398	1099	5017	0	128430
11339	3491	122147	1187	2328	0	129153
11340	1667	2792	974	123573	0	129006
11341	121608	903	1005	4413	0	127929
11342	121904	551	906	2479	0	125840
11343	4084	557	856	119415	0	124912
11344	1690	116668	836	3869	0	123063
11345	1227	121791	795	1981	0	125794
11346	1254	3156	794	118500	0	123704
11347	1257	1060	760	119429	0	122506
11348	109687	578	690	4125	0	115080
11349	3109	481	684	109161	0	113435
11350	1027	496	105239	3493	0	110255
11351	96302	424	2514	2209	0	101449
11352	2758	101806	946	1503	0	107013
11353	100540	2253	657	1598	0	105048
11354	2992	739	102495	1191	0	107417
11355	1157	104748	2382	1076	0	109363
11356	103783	2364	1306	1230	0	108683
11357	104818	773	749	1138	0	107478
11358	3045	624	104569	742	0	108980
11359	101087	517	2519	1009	0	105132
11360	104987	384	966	980	0	107317
11361	3110	105089	627	714	0	109540
11362	1508	2265	518	107268	0	111559
11363	1075	792	106345	2681	0	110893
11364	1198	480	2538	108824	0	113040
11365	838	499	111119	3060	0	115516
11366	932	399	2760	108991	0	113082
11367	110868	418	1066	3367	0	115719
11368	3054	365	653	114283	0	118355
11369	1054	313	121861	3261	0	126489
11370	120422	278	3160	1702	0	125562
11371	3943	246	1150	125086	0	130425
11372	1302	249	122047	3590	0	127188
11373	114718	227	3286	1732	0	119963
11374	3853	386	1104	118823	0	124166
11375	1347	328	115844	3463	0	120982
11376	949	325	111758	1363	0	114395
11377	1149	1124	3180	110522	0	115975
11378	626	340	114497	2978	0	118441
11379	640	110388	2904	1271	0	115203
11380	960	1940	991	101319	0	105210
11381	101565	449	651	2294	0	104959
11382	1905	289	103470	763	0	106427
11383	717	208	101793	672	0	103390
11384	94642	91	2451	930	0	98114
11385	1965	181	103609	389	0	106144
11386	95155	94	2316	877	0	98442
11387	2115	157	102316	353	0	104941
11388	1074	97	2240	99792	0	103203
11389	539	174	103927	1863	0	106503
11390	782	122	2228	100850	0	103982
11391	411	203	105303	2079	0	107996
11392	410	198	100750	939	0	102297
11393	93216	140	2484	1079	0	96919
11394	1763	102629	1179	571	0	106142
11395	104160	1550	920	706	0	107336
11396	2053	105014	763	382	0	108212
11397	1215	1784	684	105490	0	109173
11398	1021	601	680	108525	0	110827
11399	107902	346	678	2501	0	111427
11400	2160	277	670	107314	0	110421
11401	1016	243	107585	2169	0	111013
11402	99806	184	2099	1414	0	103503
11403	104178	157	1072	1051	0	106458
11404	2557	193	864	104322	0	107936
11405	1160	277	105561	2052	0	109050
11406	1062	275	2143	102740	0	106220
11407	651	104619	1064	2185	0	108519
11408	841	1778	715	105380	0	108714
11409	855	612	630	108006	0	110103
11410	645	469	105179	2633	0	108926
11411	90188	352	2127	2056	0	94723
11412	2049	103194	996	1092	0	107331
11413	102787	1780	800	1143	0	106510
11414	2191	104762	692	902	0	108547
11415	1336	1908	624	102363	0	106231
11416	861	104749	735	2188	0	108533
11417	766	1964	102525	1218	0	106473
11418	953	795	2262	97169	0	101179
11419	986	518	1090	98543	0	101137
11420	793	377	871	103834	0	105875
11421	100729	299	784	3317	0	105129
11422	2307	404	809	101373	0	104893
11423	97270	361	853	3013	0	101497
11424	97930	477	735	1796	0	100938
11425	94904	418	782	1596	0	97700
11426	2867	480	94655	1158	0	99160
11427	1769	382	2349	94870	0	99370
11428	1307	408	1256	102003	0	104974
11429	1124	417	1128	104670	0	107339
11430	107865	356	1018	3954	0	113193
11431	3443	398	965	108274	0	113080
11432	1628	330	1070	113017	0	116045
11433	115496	371	1029	4590	0	121486
11434	3947	316	1051	119205	0	124519
11435	1772	343	121389	4307	0	127811
11436	1422	402	122273	2089	0	126186
11437	1526	282	4443	123443	0	129694
11438	121963	271	1932	4835	0	129001
11439	119825	235	1602	2410	0	124072
11440	5024	261	1208	120289	0	126782
11441	2136	337	120254	4233	0	126960
11442	1614	118456	4016	2023	0	126109
11443	1642	3181	1756	120840	0	127419
11444	1423	1001	1347	123950	0	127721
11445	1565	686	1153	125026	0	128430
11446	122696	452	1087	5803	0	130038
11447	4225	438	124061	2613	0	131337
11448	122744	504	4100	2314	0	129662
11449	4945	447	1602	120987	0	127981
11450	2066	124501	1344	4270	0	132181
11451	124894	3421	1018	2653	0	131986
11452	123708	1047	991	2385	0	128131
11453	5020	820	128707	1569	0	136116
11454	2342	120141	3987	1713	0	128183
11455	1513	122987	1507	1538	0	127545
11456	120649	3956	1022	1853	0	127480
11457	4621	1299	810	120768	0	127498
11458	2239	947	728	121407	0	125321
11459	1904	729	849	120506	0	123988
11460	1324	114768	719	5163	0	121974
11461	1145	121940	699	2349	0	126133
11462	118026	4218	521	2108	0	124873
11463	4617	1405	506	117904	0	124432
11464	1579	881	128324	4098	0	134882
11465	1762	623	4404	132083	0	138872
11466	1068	742	143151	5614	0	150575
11467	1082	761	143153	2344	0	147340
11468	1127	753	143568	1561	0	147009
11469	539	129214	6398	924	0	137075
11470	1581	4408	3553	119710	0	129252
11471	560	128689	1943	4192	0	135384
11472	1517	5099	1446	117760	0	125822
11473	923	1939	1019	131456	0	135337
11474	128208	1343	880	6631	0	137062
11475	4904	904	754	130503	0	137065
11476	127643	743	655	6564	0	135605
11477	130446	611	534	3335	0	134926
11478	6528	533	484	123636	0	131181
11479	2937	123661	624	5543	0	132765
11480	2536	4303	615	120283	0	127737
11481	1548	124180	618	5569	0	131915
11482	1634	5173	525	122692	0	130024
11483	1078	2261	121780	6152	0	131271
11484	1329	1517	4497	122440	0	129783
11485	1161	1047	1715	127258	0	131181
11486	118500	851	1307	7641	0	128299
11487	4638	120891	1013	3846	0	130388
11488	2468	4637	799	121476	0	129380
11489	2166	1839	659	121008	0	125672
11490	1394	118627	833	6903	0	127757
11491	1536	4950	702	120106	0	127294
11492	108688	2202	624	7494	0	119008
11493	118590	1669	537	3823	0	124619
11494	6063	116238	558	2934	0	125793
11495	3183	5043	548	116564	0	125338
11496	112499	2125	618	6404	0	121646
11497	5386	116021	726	3179	0	125312
11498	3031	5277	600	108029	0	116937
11499	2185	114863	688	5413	0	123149
11500	113891	5736	570	3091	0	123288
11501	5539	2732	111964	2427	0	122662
11502	2479	2084	113251	2186	0	120000
11503	2296	1629	5938	111431	0	121294
11504	2131	1360	113090	5740	0	122321
11505	1585	1122	6186	111411	0	120304
11506	109999	1160	2933	6605	0	120697
11507	5239	1147	112422	3438	0	122246
11508	2696	1105	5550	111904	0	121255
11509	2167	1033	2618	116278	0	122096
11510	112063	1062	1859	7555	0	122539
11511	5217	114503	1418	4205	0	125343
11512	114995	4919	1051	3563	0	124528
11513	116861	2227	875	2871	0	122834
11514	7084	112230	1033	2201	0	122548
11515	4013	5128	990	113192	0	123323
11516	2770	2632	111806	5798	0	123006
11517	2448	2080	4651	109445	0	118624
11518	1820	111775	2086	6068	0	121749
11519	113688	5485	1609	3553	0	124335
11520	5495	2563	1379	115394	0	124831
11521	2418	2204	115524	6559	0	126705
11522	2115	1709	4918	117487	0	126229
11523	1820	1483	2286	121814	0	127403
11524	1738	1330	1752	123502	0	128322
11525	1729	1283	1281	124154	0	128447
11526	1766	1224	1127	121834	0	125951
11527	1313	1199	113444	9179	0	125135
11528	1543	1078	107775	5259	0	115655
11529	1063	100048	5462	4060	0	110633
11530	973	103597	2523	3003	0	110096
11531	99897	4721	1916	2496	0	109030
11532	4365	2325	99636	2095	0	108421
11533	91569	1835	4493	2018	0	99915
11534	4443	1309	90225	1582	0	97559
11535	2201	1042	87758	1347	0	92348
11536	1767	1006	4784	84104	0	91661
11537	86221	985	2609	4051	0	93866
11538	3852	801	1801	87331	0	93785
11539	2021	763	1441	88957	0	93182
11540	1435	610	93302	5585	0	100932
11541	1281	579	3649	95290	0	100799
11542	1197	497	1898	95990	0	99582
11543	1159	562	1262	97510	0	100493
11544	1361	496	970	97112	0	99939
11545	1282	430	831	97674	0	100217
11546	91296	459	657	6579	0	98991
11547	3520	521	642	92771	0	97454
11548	1697	598	87606	5483	0	95384
11549	1578	752	2783	89814	0	94927
11550	1269	584	87896	4940	0	94689
11551	1199	687	3492	89081	0	94459
11552	791	445	90284	5011	0	96531
11553	729	572	3930	84970	0	90201
11554	644	386	2056	88843	0	91929
11555	514	497	85690	5042	0	91743
11556	78281	436	3255	3517	0	85489
11557	2798	456	86040	2527	0	91821
11558	1745	481	3548	86438	0	92212
11559	86695	291	2046	4073	0	93105
11560	3338	310	1481	87843	0	92972
11561	2148	413	999	89461	0	93021
11562	1529	338	87323	4788	0	93978
11563	1116	82598	2685	3394	0	89793
11564	570	69701	1198	1998	0	73467
11565	388	67891	856	1445	0	70580
11566	1278	584	975	54618	0	57455
11567	55911	173	244	733	0	57061
11568	402	105	84	56381	0	56972
11569	221	58	91	57203	0	57573
11570	162	35	115	57909	0	58221
11571	124	48	103	57612	0	57887
11572	53	57018	79	655	0	57805
11573	110	353	60	58503	0	59026
11574	129	155	72	58268	0	58624
11575	60	57307	99	628	0	58094
11576	57765	367	74	490	0	58696
11577	404	166	63	58279	0	58912
11578	57640	130	60	654	0	58484
11579	56781	67	58	508	0	57414
11580	492	58030	90	256	0	58868
11581	291	390	60	62044	0	62785
11582	182	173	61524	507	0	62386
11583	122	140	59572	280	0	60114
11584	171	230	466	60549	0	61416
11585	61983	49	251	688	0	62971
11586	63549	45	147	502	0	64243
11587	559	45	108	64722	0	65434
11588	64881	61	92	750	0	65784
11589	507	64402	114	309	0	65332
11590	64333	406	102	408	0	65249
11591	489	69145	105	198	0	69937
11592	385	464	93	70901	0	71843
11593	277	223	87	70881	0	71468
11594	159	71371	118	633	0	72281
11595	69590	439	126	615	0	70770
11596	494	231	71316	228	0	72269
11597	358	124	451	69749	0	70682
11598	286	150	71902	551	0	72889
11599	290	87	497	70717	0	71591
11600	72299	63	247	860	0	73469
11601	558	72	139	72617	0	73386
11602	71744	64	127	947	0	72882
11603	71214	67	88	648	0	72017
11604	697	75	96	71949	0	72817
11605	323	114	70878	671	0	71986
11606	236	72496	459	436	0	73627
11607	232	425	206	72706	0	73569
11608	71020	176	151	897	0	72244
11609	555	177	70921	357	0	72010
11610	435	111	484	70628	0	71658
11611	310	63	264	70208	0	70845
11612	245	88	187	72339	0	72859
11613	71774	82	142	1093	0	73091
11614	601	74	162	70572	0	71409
11615	323	79	148	72641	0	73191
11616	257	102	71364	809	0	72532
11617	300	65	539	70770	0	71674
11618	316	55	281	72548	0	73200
11619	260	78	178	74342	0	74858
11620	191	73471	142	921	0	74725
11621	298	418	93	71602	0	72411
11622	246	210	91	72055	0	72602
11623	68756	111	84	1064	0	70015
11624	531	159	68505	443	0	69638
11625	298	127	63305	435	0	64165
11626	191	68434	535	294	0	69454
11627	268	409	269	70847	0	71793
11628	70447	188	181	854	0	71670
11629	546	103	137	69642	0	70428
11630	358	88	105	71358	0	71909
11631	235	73	105	72315	0	72728
11632	246	75	82	71617	0	72020
11633	232	67	91	71882	0	72272
11634	143	140	71300	862	0	72445
11635	242	86	422	70847	0	71597
11636	71016	67	192	1007	0	72282
11637	459	70095	156	462	0	71172
11638	317	415	115	71267	0	72114
11639	227	195	99	71598	0	72119
11640	160	173	67346	795	0	68474
11641	316	120	475	65150	0	66061
11642	206	72	241	70809	0	71328
11643	70941	55	148	1335	0	72479
11644	693	74095	144	605	0	75537
11645	431	724	83	75464	0	76702
11646	358	271	111	76436	0	77176
11647	308	208	92	76503	0	77111
11648	172	159	77163	1361	0	78855
11649	198	107	72459	811	0	73575
11650	146	74715	1157	559	0	76577
11651	152	77493	438	443	0	78526
11652	255	1094	258	76859	0	78466
11653	177	69849	395	1208	0	71629
11654	309	1375	116	84589	0	86389
11655	279	587	139	93463	0	94468
11656	326	242	137	97542	0	98247
11657	294	234	97	105647	0	106272
11658	123	202	104174	3306	0	107805
11659	383	166	1943	103692	0	106184
11660	321	158	966	105507	0	106952
11661	277	126	578	108418	0	109399
11662	102639	132	414	4442	0	107627
11663	1930	105620	466	2508	0	110524
11664	1426	2107	334	99152	0	103019
11665	571	106145	383	3013	0	110112
11666	101326	2606	238	2459	0	106629
11667	90543	1612	213	2468	0	94836
11668	2632	103678	207	1496	0	108013
11669	1451	108173	211	1302	0	111137
11670	1023	3673	104204	1118	0	110018
11671	752	108926	2191	1163	0	113032
11672	1067	3411	1160	105099	0	110737
11673	106527	1926	745	3391	0	112589
11674	2588	110295	504	1939	0	115326
11675	1620	3451	435	111261	0	116767
11676	1219	2055	420	113614	0	117308
11677	1041	1498	438	116271	0	119248
11678	112309	1201	340	5003	0	118853
11679	2939	1199	111742	2843	0	118723
11680	105684	942	2416	2438	0	111480
11681	3362	110321	1200	1618	0	116501
11682	1961	3160	734	110575	0	116430
11683	1233	1842	109771	3411	0	116257
11684	101963	1277	2833	2497	0	108570
11685	3218	109924	1462	1415	0	116019
11686	2107	3163	966	105842	0	112078
11687	1321	109820	711	3118	0	114970
11688	1190	3604	638	110188	0	115620
11689	1112	1927	597	113358	0	116994
11690	820	1382	110007	4613	0	116822
11691	856	1112	104785	2831	0	109584
11692	1005	1100	3508	106296	0	111909
11693	667	974	108194	4067	0	113902
11694	896	864	3416	107158	0	112334
11695	953	756	1995	104595	0	108299
11696	720	662	1471	111825	0	114678
11697	107582	572	1353	5382	0	114889
11698	3052	595	1221	109949	0	114817
11699	1509	745	107754	4835	0	114843
11700	105598	671	3016	3605	0	112890
11701	3080	706	1687	110144	0	115617
11702	1910	573	1269	112302	0	116054
11703	108085	558	1058	5637	0	115338
11704	3182	111099	1146	3552	0	118979
11705	2038	2767	1113	114031	0	119949
11706	1462	1446	976	114756	0	118640
11707	110645	1058	920	5802	0	118425
11708	3260	924	111127	3904	0	119215
11709	2143	852	2872	111261	0	117128
11710	1669	821	1649	112916	0	117055
11711	1578	858	1151	110328	0	113915
11712	1158	109659	1013	5710	0	117540
11713	1256	2839	1036	112501	0	117632
11714	109072	1590	871	5462	0	116995
11715	3142	109439	876	3807	0	117264
11716	107576	3167	712	3486	0	114941
11717	3531	110176	675	2793	0	117175
11718	109641	3721	609	2782	0	116753
11719	3891	2239	107626	2448	0	116204
11720	2466	1737	106205	2427	0	112835
11721	105650	1370	3592	2427	0	113039
11722	3883	1383	111068	2062	0	118396
11723	2628	1232	3582	110000	0	117442
11724	2552	1207	2467	97011	0	103237
11725	1820	961	1676	114647	0	119104
11726	111421	988	1533	5514	0	119456
11727	3647	994	110106	3407	0	118154
11728	108993	977	3368	3022	0	116360
11729	4139	1022	1981	117665	0	124807
11730	117311	1007	1406	5221	0	124945
11731	4880	985	1136	118618	0	125619
11732	121041	977	1160	5312	0	128490
11733	5348	915	1241	127354	0	134858
11734	2921	924	128230	5505	0	137580
11735	127271	804	4058	3727	0	135860
11736	134333	674	2113	3080	0	140200
11737	6318	688	1598	133072	0	141676
11738	3731	731	1385	130324	0	136171
11739	2475	132514	1451	6075	0	142515
11740	129586	3494	1368	4037	0	138485
11741	4977	131419	1276	3088	0	140760
11742	126051	3758	1065	2954	0	133828
11743	5190	1783	126363	2631	0	135967
11744	2968	1320	125322	2439	0	132049
11745	2369	1003	122147	2284	0	127803
11746	120349	927	4843	2282	0	128401
11747	4854	124954	2492	1907	0	134207
11748	3139	3411	1878	122316	0	130744
11749	121997	1592	1570	4456	0	129615
11750	4526	125028	1413	2675	0	133642
11751	2928	4855	1248	118467	0	127498
11752	2097	120810	1176	4254	0	128337
11753	1780	117887	1081	2582	0	123330
11754	1678	117852	843	1848	0	122221
11755	104805	3538	1078	1761	0	111182
11756	2944	104861	601	1194	0	109600
11757	1056	95099	464	821	0	97440
11758	788	97562	479	703	0	99532
11759	95456	2476	652	870	0	99454
11760	96206	859	437	775	0	98277
11761	2693	638	93708	539	0	97578
11762	89577	446	1844	803	0	92670
11763	94798	396	610	684	0	96488
11764	2730	421	380	93596	0	97127
11765	94782	387	298	2334	0	97801
11766	2435	435	94060	740	0	97670
11767	905	99323	1838	562	0	102628
11768	100018	2048	604	692	0	103362
11769	2641	745	340	101191	0	104917
11770	101284	439	231	2412	0	104366
11771	2557	425	96852	743	0	100577
11772	97702	338	1791	677	0	100508
11773	2677	432	553	100478	0	104140
11774	1004	325	100945	2076	0	104350
11775	629	95734	2028	802	0	99193
11776	559	101581	639	482	0	103261
11777	851	2527	452	98357	0	102187
11778	849	776	261	96558	0	98444
11779	444	100952	237	2047	0	103680
11780	100813	2001	262	872	0	103948
11781	100437	639	201	718	0	101995
11782	99524	393	215	643	0	100775
11783	2649	101798	228	405	0	105080
11784	1367	1991	147	95621	0	99126
11785	641	102734	193	1663	0	105231
11786	101860	2061	194	847	0	104962
11787	101471	698	166	739	0	103074
11788	2548	100182	218	553	0	103501
11789	101771	2053	161	584	0	104569
11790	2599	668	157	101617	0	105041
11791	1132	450	243	103111	0	104936
11792	103738	353	292	2741	0	107124
11793	101365	336	248	1118	0	103067
11794	103200	393	213	739	0	104545
11795	2965	380	203	101402	0	104950
11796	1284	363	207	103603	0	105457
11797	740	546	102294	2538	0	106118
11798	927	446	1928	100147	0	103448
11799	871	455	565	102120	0	104011
11800	702	510	100164	2496	0	103872
11801	744	506	95470	955	0	97675
11802	598	465	101206	577	0	102846
11803	802	434	2584	99158	0	102978
11804	653	568	99140	2222	0	102583
11805	772	535	2174	96978	0	100459
11806	819	531	737	99930	0	102017
11807	679	550	99076	2652	0	102957
11808	676	563	98551	1008	0	100798
11809	842	508	2453	96030	0	99833
11810	630	563	104191	2303	0	107687
11811	684	600	102926	910	0	105120
11812	651	103057	2487	727	0	106922
11813	104957	2240	942	807	0	108946
11814	106061	873	609	775	0	108318
11815	106311	682	467	830	0	108290
11816	2887	104656	462	554	0	108559
11817	1296	107655	454	578	0	109983
11818	1116	2527	434	107006	0	111083
11819	1012	879	480	107295	0	109666
11820	897	590	105879	2735	0	110101
11821	1026	492	2229	104232	0	107979
11822	105137	441	836	2826	0	109240
11823	2743	448	546	99722	0	103459
11824	1080	104914	508	2309	0	108811
11825	107551	2224	481	1254	0	111510
11826	109355	837	459	1005	0	111656
11827	110889	539	490	1036	0	112954
11828	3432	472	108723	657	0	113284
11829	1478	645	1874	108880	0	112877
11830	112163	378	810	3048	0	116399
11831	2809	343	118309	1016	0	122477
11832	1082	113075	2511	774	0	117442
11833	682	111701	787	527	0	113697
11834	105165	2365	748	695	0	108973
11835	2160	106760	421	461	0	109802
11836	1132	2144	332	103464	0	107072
11837	522	692	106311	2061	0	109586
11838	767	474	2052	104492	0	107785
11839	105192	273	627	2552	0	108644
11840	2078	104968	465	820	0	108331
11841	103755	1997	348	752	0	106852
11842	2243	650	104072	478	0	107443
11843	1156	516	2056	98049	0	101777
11844	469	106870	736	1907	0	109982
11845	735	2081	467	107936	0	111219
11846	108781	605	358	2573	0	112317
11847	109859	387	317	1039	0	111602
11848	109966	310	336	767	0	111379
11849	110968	295	326	668	0	112257
11850	2928	269	310	106587	0	110094
11851	993	345	108883	2151	0	112372
11852	1059	384	2009	102821	0	106273
11853	601	108286	666	2015	0	111568
11854	108226	1936	452	1029	0	111643
11855	2246	639	108402	509	0	111796
11856	103712	348	2008	720	0	106788
11857	2363	305	657	106974	0	110299
11858	877	323	109733	2104	0	113037
11859	921	221	2010	108273	0	111425
11860	109554	256	677	2634	0	113121
11861	110418	235	442	1174	0	112269
11862	110181	217	412	911	0	111721
11863	2625	319	110015	497	0	113456
11864	1301	451	1895	108184	0	111831
11865	699	375	112965	2027	0	116066
11866	636	112017	2015	821	0	115489
11867	106465	1789	754	762	0	109770
11868	1909	105412	472	448	0	108241
11869	103270	1585	459	595	0	105909
11870	2045	489	295	99791	0	102620
11871	663	102867	330	1456	0	105316
11872	102269	1566	310	862	0	105007
11873	1876	526	104109	378	0	106889
11874	933	312	1570	101794	0	104609
11875	102827	260	519	1989	0	105595
11876	1881	315	103875	623	0	106694
11877	1026	301	1578	98732	0	101637
11878	666	97635	657	1595	0	100553
11879	769	1673	423	104146	0	107011
11880	740	637	324	105486	0	107187
11881	102945	457	280	2278	0	105960
11882	1848	103826	316	758	0	106748
11883	995	1695	298	99965	0	102953
11884	583	103390	340	1715	0	106028
11885	854	1796	368	100473	0	103491
11886	601	105132	363	1711	0	107807
11887	103119	1826	315	981	0	106241
11888	2053	701	105893	551	0	109198
11889	1098	435	1790	103330	0	106653
11890	835	359	647	104226	0	106067
11891	760	377	369	105121	0	106627
11892	868	397	292	103483	0	105040
11893	707	393	102520	2359	0	105979
11894	702	103177	1723	889	0	106491
11895	102267	1682	563	979	0	105491
11896	103067	572	411	982	0	105032
11897	2092	103081	356	666	0	106195
11898	103184	1772	337	869	0	106162
11899	102859	619	389	863	0	104730
11900	2249	104809	346	568	0	107972
11901	1268	1832	371	100562	0	104033
11902	761	106117	417	1618	0	108913
11903	103693	1843	355	1124	0	107015
11904	2098	663	104444	651	0	107856
11905	94432	415	1774	1213	0	97834
11906	2132	439	105305	590	0	108466
11907	1142	378	1794	103933	0	107247
11908	104408	356	619	2280	0	107663
11909	2247	415	103679	744	0	107085
11910	95088	386	1781	974	0	98229
11911	99946	347	656	866	0	101815
11912	2457	396	482	97664	0	100999
11913	987	99031	462	1731	0	102211
11914	99780	1859	291	1003	0	102933
11915	2313	709	285	98649	0	101956
11916	983	96957	372	1827	0	100139
11917	97680	1733	358	1010	0	100781
11918	2147	640	312	97778	0	100877
11919	860	100743	395	1830	0	103828
11920	827	1730	389	103703	0	106649
11921	104805	574	387	2414	0	108180
11922	104157	440	323	1244	0	106164
11923	105281	367	349	949	0	106946
11924	2588	361	357	102160	0	105466
11925	1190	369	263	102329	0	104151
11926	649	426	103262	2061	0	106398
11927	1135	639	1688	102409	0	105871
11928	659	390	106758	2033	0	109840
11929	503	248	95632	696	0	97079
11930	254	179	93158	329	0	93920
11931	175	96306	1484	511	0	98476
11932	745	1303	889	89363	0	92300
11933	197	103064	354	937	0	104552
11934	104130	1583	260	800	0	106773
11935	105044	484	209	663	0	106400
11936	2157	280	249	107833	0	110519
11937	672	235	110934	1801	0	113642
11938	706	168	2018	109046	0	111938
11939	295	348	113551	2155	0	116349
11940	768	268	2083	107105	0	110224
11941	340	110547	644	2004	0	113535
11942	305	115924	365	717	0	117311
11943	112186	2354	321	779	0	115640
11944	2211	785	111863	464	0	115323
11945	1116	409	2160	108279	0	111964
11946	763	295	652	111284	0	112994
11947	110549	290	407	2952	0	114198
11948	2109	112127	352	1056	0	115644
11949	111144	2137	295	977	0	114553
11950	2249	113889	370	510	0	117018
11951	110729	2279	334	697	0	114039
11952	112574	752	348	891	0	114565
11953	3046	471	288	112297	0	116102
11954	1006	484	112538	2368	0	116396
11955	105656	353	2215	1327	0	109551
11956	2432	113440	794	561	0	117227
11957	113848	2295	457	738	0	117338
11958	2905	853	380	109773	0	113911
11959	1355	508	292	109428	0	111583
11960	768	109890	363	2707	0	113728
11961	1099	2303	264	106335	0	110001
11962	624	110973	334	2331	0	114262
11963	1059	2386	247	108422	0	112114
11964	861	906	280	108081	0	110128
11965	103323	538	268	3227	0	107356
11966	2530	551	103688	1164	0	107933
11967	981	102491	2139	934	0	106545
11968	1020	2353	712	103612	0	107697
11969	104875	825	454	2902	0	109056
11970	106952	655	374	1431	0	109412
11971	105168	474	377	1199	0	107218
11972	3114	505	104047	771	0	108437
11973	103234	483	2336	931	0	106984
11974	3055	478	849	104895	0	109277
11975	103665	478	523	2983	0	107649
11976	2846	102529	468	1194	0	107037
11977	1586	2493	381	103519	0	107979
11978	101601	877	449	2989	0	105916
11979	2979	104879	450	1157	0	109465
11980	1556	2758	431	104349	0	109094
11981	1097	1135	99803	2969	0	105004
11982	102089	767	2284	1680	0	106820
11983	108877	603	738	1289	0	111507
11984	3961	666	107215	814	0	112656
11985	1679	102153	2745	866	0	107443
11986	1297	107892	1074	1101	0	111364
11987	1333	3328	764	106518	0	111943
11988	1427	1278	695	102090	0	105490
11989	1244	848	557	108341	0	110990
11990	922	864	108809	3846	0	114441
11991	106253	799	2909	2095	0	112056
11992	115214	702	1125	1460	0	118501
11993	117726	759	747	1409	0	120641
11994	119173	719	652	1366	0	121910
11995	119489	688	623	1467	0	122267
11996	121678	649	747	1317	0	124391
11997	5231	688	704	123697	0	130320
11998	2324	782	121072	4018	0	128196
11999	1741	835	125388	1705	0	129669
12000	1896	825	4171	122520	0	129412
12001	1920	809	1413	122144	0	126286
12002	2044	706	831	121403	0	124984
12003	1530	123970	795	4733	0	131028
12004	125291	3761	753	2402	0	132207
12005	4599	129352	704	1630	0	136285
12006	2546	4068	722	127203	0	134539
12007	125652	1536	724	4941	0	132853
12008	4664	127148	634	2205	0	134651
12009	2542	4418	589	127344	0	134893
12010	2190	1771	528	131385	0	135874
12011	1868	1280	548	132068	0	135764
12012	1449	131446	720	5795	0	139410
12013	1801	4405	690	134567	0	141463
12014	1449	1697	134194	5739	0	143079
12015	1751	1286	4345	136339	0	143721
12016	1762	1141	1295	140416	0	144614
12017	1854	1181	726	148618	0	152379
12018	1904	1102	630	151306	0	154942
12019	1584	1149	143880	7486	0	154099
12020	1394	143481	4912	3868	0	153655
12021	1899	5100	1727	143354	0	152080
12022	1709	2006	1141	150030	0	154886
12023	1773	1313	949	145501	0	149536
12024	1428	138775	963	7923	0	149089
12025	1252	149403	837	4205	0	155697
12026	142357	6178	687	3225	0	152447
12027	5942	2388	617	139006	0	147953
12028	2100	1581	135885	6274	0	145840
12029	1428	136175	4497	3356	0	145456
12030	132364	4958	1772	2891	0	141985
12031	5136	2060	130564	2284	0	140044
12032	2174	1420	129731	2105	0	135430
12033	1354	1082	128852	1680	0	132968
12034	1682	2212	5812	122409	0	132115
12035	1003	953	125292	5263	0	132511
12036	739	119407	5074	2773	0	127993
12037	1127	4053	2134	114484	0	121798
12038	684	1800	117951	4589	0	125024
12039	1074	1406	4470	114880	0	121830
12040	113256	960	2003	5414	0	121633
12041	3911	892	113909	2854	0	121566
12042	109784	866	4523	2383	0	117556
12043	4364	116408	2022	1734	0	124528
12044	117557	4167	1494	1730	0	124948
12045	5049	1683	1486	117041	0	125259
12046	118266	1112	1493	4906	0	125777
12047	119755	986	1390	2582	0	124713
12048	116648	1056	1236	2189	0	121129
12049	5540	118103	1338	1604	0	126585
12050	118508	4069	1253	1776	0	125606
12051	120315	1587	1350	1799	0	125051
12052	5754	1184	117656	1565	0	126159
12053	2890	117226	4206	1611	0	125933
12054	2616	4206	2066	116310	0	125198
12055	2206	1926	1503	119964	0	125599
12056	2031	1432	1246	121466	0	126175
12057	1608	1243	117884	5896	0	126631
12058	1894	980	4229	118574	0	125677
12059	1681	993	118773	5615	0	127062
12060	117243	905	4761	3143	0	126052
12061	121943	945	2132	2566	0	127586
12062	5771	1061	120086	2144	0	129062
12063	119269	1030	4416	2165	0	126880
12064	123678	869	2177	2069	0	128793
12065	125623	829	1720	1868	0	130040
12066	6646	911	1558	120387	0	129502
12067	3484	1075	121448	4780	0	130787
12068	2544	122118	4291	2703	0	131656
12069	2601	3973	2039	121747	0	130360
12070	2102	1756	124570	4929	0	133357
12071	1843	1355	119134	2698	0	125030
12072	115937	1256	4945	2584	0	124722
12073	4323	123809	2584	2231	0	132947
12074	125299	3781	1954	2370	0	133404
12075	126495	1715	1817	2185	0	132212
12076	5349	125604	1887	1779	0	134619
12077	125514	3902	1702	1873	0	132991
12078	5503	1823	128278	1643	0	137247
12079	3267	1267	125280	1507	0	131321
12080	2797	1104	126399	1465	0	131765
12081	2198	124776	5161	1331	0	133466
12082	123227	3491	3116	1417	0	131251
12083	124001	1606	2082	1529	0	129218
12084	4986	119629	2013	1271	0	127899
12085	2811	124918	1730	1414	0	130873
12086	2482	4161	1700	122336	0	130679
12087	2129	2331	1491	124879	0	130830
12088	124107	1637	1340	4554	0	131638
12089	4286	125359	1469	2189	0	133303
12090	123339	3693	1296	1840	0	130168
12091	120996	1808	1241	1596	0	125641
12092	4865	1637	118472	1118	0	126092
12093	2983	116328	3331	1047	0	123689
12094	2918	3390	1879	115209	0	123396
12095	114316	1723	1328	2926	0	120293
12096	4438	1229	1265	112063	0	118995
12097	108521	1006	1302	2930	0	113759
12098	3616	1107	106175	1402	0	112300
12099	2276	102203	2840	1301	0	108620
12100	1873	108180	1535	1215	0	112803
12101	2168	3612	1393	101224	0	108397
12102	1792	108515	1105	2200	0	113612
12103	107900	3092	1037	1589	0	113618
12104	3140	1703	105923	1170	0	111936
12105	100172	1337	2346	1354	0	105209
12106	3157	1170	108219	1048	0	113594
12107	2252	1016	2422	106424	0	112114
12108	2088	998	1340	107563	0	111989
12109	2106	820	1049	109263	0	113238
12110	107910	684	1050	3139	0	112783
12111	3039	727	107448	1607	0	112821
12112	1866	756	1998	104496	0	109116
12113	1682	824	1042	104029	0	107577
12114	1414	100895	872	2501	0	105682
12115	1261	99959	667	1666	0	103553
12116	1284	101243	730	1214	0	104471
12117	943	1677	524	95043	0	98187
12118	758	664	416	91686	0	93524
12119	372	89086	253	870	0	90581
12120	344	90196	250	525	0	91315
12121	89666	600	495	649	0	91410
12122	723	481	204	89529	0	90937
12123	279	88597	148	460	0	89484
12124	90307	379	181	434	0	91301
12125	602	185	145	91648	0	92580
12126	97357	122	111	784	0	98374
12127	932	137	110	99040	0	100219
12128	336	179	102629	792	0	103936
12129	223	102728	661	312	0	103924
12130	99853	705	211	608	0	101377
12131	775	270	104331	171	0	105547
12132	227	104359	689	179	0	105454
12133	387	637	190	105962	0	107176
12134	240	158	147	106965	0	107510
12135	248	129	70	103529	0	103976
12136	379	74	63	101188	0	101704
12137	102	116	105617	754	0	106589
12138	60	103801	576	321	0	104758
12139	227	567	120	104319	0	105233
12140	102212	155	81	934	0	103382
12141	542	104463	86	293	0	105384
12142	355	615	41	110060	0	111071
12143	147	222	108617	892	0	109878
12144	75	107967	966	372	0	109380
12145	758	1048	271	99009	0	101086
12146	103	110874	184	609	0	111770
12147	110932	1204	64	545	0	112745
12148	110714	332	58	543	0	111647
12149	1439	252	108215	169	0	110075
12150	104926	118	1034	500	0	106578
12151	108975	98	293	491	0	109857
12152	1497	175	106508	116	0	108296
12153	555	107308	1145	147	0	109155
12154	691	1145	327	105440	0	107603
12155	462	322	225	110978	0	111987
12156	110358	233	138	1787	0	112516
12157	1494	115	97	110066	0	111772
12158	426	179	110788	1359	0	112752
12159	102587	139	1209	865	0	104800
12160	1412	157	108286	346	0	110201
12161	454	108790	1410	228	0	110882
12162	105137	1253	412	469	0	107271
12163	1443	400	107792	172	0	109807
12164	566	325	102245	172	0	103308
12165	362	106037	1486	166	0	108051
12166	399	1280	553	107670	0	109902
12167	207	498	105788	1298	0	107791
12168	772	321	1505	90853	0	93451
12169	435	119	439	103389	0	104382
12170	190	170	101135	1596	0	103091
12171	172	100007	1380	619	0	102178
12172	351	1262	472	100951	0	103036
12173	99392	379	366	1653	0	101790
12174	98606	291	203	748	0	99848
12175	1770	179	185	99436	0	101570
12176	631	240	98464	1457	0	100792
12177	399	250	100480	494	0	101623
12178	440	177	1741	99313	0	101671
12179	261	204	98253	1553	0	100271
12180	94362	172	1701	820	0	97055
12181	1798	138	556	98879	0	101371
12182	766	109	448	99592	0	100915
12183	407	99605	382	1883	0	102277
12184	437	1602	259	101544	0	103842
12185	292	536	99026	1889	0	101743
12186	92034	317	1704	1011	0	95066
12187	98347	157	583	819	0	99906
12188	2079	209	100154	475	0	102917
12189	1069	194	1838	109294	0	112395
12190	828	214	635	113978	0	115655
12191	362	192	113844	3526	0	117924
12192	709	173	2872	113964	0	117718
12193	996	196	1045	110474	0	112711
12194	331	118040	671	3573	0	122615
12195	746	2960	385	119435	0	123526
12196	753	894	368	123686	0	125701
12197	123729	452	392	4622	0	129195
12198	127700	305	415	2092	0	130512
12199	130694	220	396	1400	0	132710
12200	129776	254	407	1016	0	131453
12201	128814	238	346	1084	0	130482
12202	4988	295	122809	807	0	128899
12203	2432	226	3551	120590	0	126799
12204	1684	181	1177	125289	0	128331
12205	959	246	123501	4653	0	129359
12206	116212	255	3723	2141	0	122331
12207	122483	273	1257	1475	0	125488
12208	4874	369	111182	955	0	117380
12209	119158	206	3146	1171	0	123681
12210	124262	200	1154	1050	0	126666
12211	5316	229	120537	680	0	126762
12212	2930	269	3891	113079	0	120169
12213	1647	121069	1587	3567	0	127870
12214	1652	3674	999	129846	0	136171
12215	1550	1090	700	132779	0	136119
12216	1429	577	668	132512	0	135186
12217	895	373	129833	5587	0	136688
12218	124494	317	4092	2568	0	131471
12219	131764	274	1512	1652	0	135202
12220	5685	268	1049	128679	0	135681
12221	2268	323	127158	4541	0	134290
12222	1872	305	4241	125850	0	132268
12223	1090	233	128995	4857	0	135175
12224	1041	244	128840	2002	0	132127
12225	784	129611	5136	1548	0	137079
12226	1446	3408	2011	124145	0	131010
12227	124361	1051	1135	4431	0	130978
12228	120648	579	823	2131	0	124181
12229	124686	327	785	1621	0	127419
12230	5834	290	726	118826	0	125676
12231	2160	125669	728	4306	0	132863
12232	1834	3978	604	127751	0	134167
12233	1118	1265	130455	5133	0	137971
12234	133147	729	4598	2485	0	140959
12235	145508	361	1623	1931	0	149423
12236	6792	342	1162	142665	0	150961
12237	3262	374	878	146289	0	150803
12238	2516	319	865	148755	0	152455
12239	1491	406	143090	7254	0	152241
12240	127883	281	5129	3989	0	137282
12241	5688	137548	1966	2203	0	147405
12242	2052	138271	1308	1597	0	143228
12243	1625	4971	137688	1389	0	145673
12244	1851	1866	4807	134306	0	142830
12245	1093	1121	138241	5356	0	145811
12246	131266	698	5185	2476	0	139625
12247	5871	532	1831	132797	0	141031
12248	2406	502	133549	5001	0	141458
12249	1854	138421	4773	2246	0	147294
12250	137764	4380	1709	2250	0	146103
12251	5362	1336	143054	1520	0	151272
12252	2110	136734	5238	1528	0	145610
12253	1579	145759	2055	1397	0	150790
12254	143965	5511	1591	1507	0	152574
12255	5769	2066	1147	143053	0	152035
12256	2208	1421	148019	5353	0	157001
12257	1692	147561	5367	2277	0	156897
12258	146868	4919	2002	2025	0	155814
12259	149505	1645	1544	1795	0	154489
12260	6322	147925	1333	1265	0	156845
12261	2700	5329	150051	1292	0	159372
12262	2419	1933	5357	149786	0	159495
12263	150797	1361	2059	5890	0	160107
12264	154010	984	1684	2487	0	159165
12265	7003	1000	150983	1697	0	160683
12266	3768	965	5343	146616	0	156692
12267	2881	863	2093	154141	0	159978
12268	2021	931	153850	6399	0	163201
12269	1822	895	151823	2871	0	157411
12270	152013	809	6636	2331	0	161789
12271	158651	885	2753	1886	0	164175
12272	160434	884	1998	1753	0	165069
12273	161196	854	1612	1719	0	165381
12274	7711	901	152573	1549	0	162734
12275	153816	662	5432	1847	0	161757
12276	7589	631	2243	152407	0	162870
12277	3559	705	154607	5616	0	164487
12278	2829	734	154583	2585	0	160731
12279	2125	153610	6452	2257	0	164444
12280	2175	4865	2871	149970	0	159881
12281	1797	1768	154432	5442	0	163439
12282	146709	1275	5947	2738	0	156669
12283	6627	1159	2750	135315	0	145851
12284	2891	152983	2261	4320	0	162455
12285	154645	4805	1867	2548	0	163865
12286	156824	1588	1814	2342	0	162568
12287	7017	1215	153939	1656	0	163827
12288	3403	151377	5593	1621	0	161994
12289	2722	3672	1924	140405	0	148723
12290	140502	1446	1613	4334	0	147895
12291	5146	1410	1411	138816	0	146783
12292	2222	1058	135587	4193	0	143060
12293	120861	885	3870	2274	0	127890
12294	4243	130981	1785	1546	0	138555
12295	2045	126585	1484	1260	0	131374
12296	1767	136365	1346	1212	0	140690
12297	132221	3929	2335	1483	0	139968
12298	131273	1584	1272	1146	0	135275
12299	132382	1162	1067	994	0	135605
12300	4837	857	978	129449	0	136121
12301	2337	915	131132	3244	0	137628
12302	2019	872	3323	130886	0	137100
12303	132387	753	1429	3901	0	138470
12304	4226	681	1178	132946	0	139031
12305	135557	608	1103	3983	0	141251
12306	135847	719	1089	1870	0	139525
12307	132756	722	1128	1684	0	136290
12308	4170	133650	1094	1294	0	140208
12309	133042	3028	1040	1231	0	138341
12310	4380	1192	130911	822	0	137305
12311	2437	907	131942	768	0	136054
12312	2124	130968	3440	660	0	137192
12313	2359	2647	1713	124462	0	131181
12314	123686	963	1144	2987	0	128780
12315	3633	789	122594	1122	0	128138
12316	118393	608	3063	1301	0	123365
12317	3967	571	1343	119289	0	125170
12318	1775	122429	1330	2752	0	128286
12319	1712	2615	1126	124352	0	129805
12320	1505	1090	124242	2981	0	129818
12321	114969	846	2900	1842	0	120557
12322	3612	796	125899	1034	0	131341
12323	1890	590	121592	805	0	124877
12324	116231	511	3141	1184	0	121067
12325	3337	119863	1530	778	0	125508
12326	123067	2618	1130	1030	0	127845
12327	124334	978	928	1043	0	127283
12328	4133	742	120901	731	0	126507
12329	114385	618	2894	1021	0	118918
12330	3517	539	116661	851	0	121568
12331	1673	422	109232	715	0	112042
12332	1475	421	110900	722	0	113518
12333	1075	107524	2638	655	0	111892
12334	99501	1909	2699	819	0	104928
12335	97710	472	775	725	0	99682
12336	97650	278	432	528	0	98888
12337	96886	215	398	562	0	98061
12338	1996	263	96591	228	0	99078
12339	1160	210	1402	94481	0	97253
12340	989	228	577	95571	0	97365
12341	96967	222	487	1795	0	99471
12342	1616	96479	499	566	0	99160
12343	926	1208	380	95175	0	97689
12344	94398	431	424	1576	0	96829
12345	1583	344	96166	447	0	98540
12346	1092	314	1345	94603	0	97354
12347	656	276	98135	1407	0	100474
12348	626	96972	1488	537	0	99623
12349	904	1363	683	91172	0	94122
12350	90328	384	420	1568	0	92700
12351	1513	265	334	91345	0	93457
12352	677	292	92057	1334	0	94360
12353	430	91372	1310	529	0	93641
12354	88261	1165	509	689	0	90624
12355	1482	426	89949	254	0	92111
12356	82745	208	1322	609	0	84884
12357	1423	88907	523	422	0	91275
12358	90700	1256	546	527	0	93029
12359	91910	468	270	450	0	93098
12360	2127	229	226	93210	0	95792
12361	789	232	93538	1502	0	96061
12362	476	94654	1631	604	0	97365
12363	728	1598	616	98103	0	101045
12364	663	582	392	100506	0	102143
12365	832	254	325	106561	0	107972
12366	934	258	290	109490	0	110972
12367	462	120210	331	3004	0	124007
12368	120563	2823	289	1338	0	125013
12369	3206	121722	349	549	0	125826
12370	1658	3178	290	123712	0	128838
12371	125965	1018	287	3628	0	130898
12372	4038	488	260	125882	0	130668
12373	1359	547	125228	3704	0	130838
12374	756	125249	3205	1453	0	130663
12375	1334	3282	996	123139	0	128751
12376	1076	1153	540	129129	0	131898
12377	123196	622	401	4728	0	128947
12378	3582	640	122184	1764	0	128170
12379	119636	474	3265	1645	0	125020
12380	122861	439	1100	1340	0	125740
12381	123519	571	605	1252	0	125947
12382	4892	602	121165	848	0	127507
12383	2635	689	3448	118261	0	125033
12384	1752	587	1215	122459	0	126013
12385	1113	580	123922	4734	0	130349
12386	946	560	125722	2114	0	129342
12387	124419	478	4677	1704	0	131278
12388	4782	567	1735	127720	0	134804
12389	130375	474	1053	4758	0	136660
12390	134416	459	798	2433	0	138106
12391	6107	462	690	131873	0	139132
12392	2505	457	137937	4870	0	145769
12393	132906	421	4635	2673	0	140635
12394	5897	472	1786	137678	0	145833
12395	2529	568	138374	5108	0	146579
12396	1870	136519	4663	2391	0	145443
12397	135919	4458	1846	2172	0	144395
12398	5260	139697	1305	1620	0	147882
12399	3647	5045	1137	123110	0	132939
12400	1987	141699	1123	4523	0	149332
12401	136915	4933	1089	2773	0	145710
12402	140420	1847	1139	2477	0	145883
12403	6441	139274	1188	2010	0	148913
12404	139782	4795	1113	2083	0	147773
12405	139436	1974	1011	2404	0	144825
12406	6818	136241	1249	1941	0	146249
12407	138308	4788	1183	1948	0	146227
12408	7148	1796	1224	135323	0	145491
12409	4197	1209	1303	139074	0	145783
12410	137320	1144	1202	6454	0	146120
12411	7262	1013	1183	125018	0	134476
12412	3517	133146	1250	5296	0	143209
12413	132643	4826	1183	3246	0	141898
12414	132717	2149	1222	2641	0	138729
12415	6671	133439	1402	2090	0	143602
12416	134733	5000	1288	2138	0	143159
12417	137715	2199	1185	1923	0	143022
12418	8254	1457	1000	131741	0	142452
12419	4486	1338	131090	5609	0	142523
12420	3578	130925	4680	3027	0	142210
12421	133390	4989	1903	2559	0	142841
12422	134847	2210	1390	2447	0	140894
12423	7813	1700	129233	2090	0	140836
12424	129707	1377	4813	2469	0	138366
12425	7064	1465	125169	2142	0	135840
12426	127018	1726	4899	1943	0	135586
12427	7468	1798	1997	126112	0	137375
12428	4150	1862	125352	5418	0	136782
12429	3444	2013	127607	2614	0	135678
12430	3673	2119	5591	123520	0	134903
12431	3610	1787	2278	126637	0	134312
12432	3335	1723	121876	6291	0	133225
12433	3790	1603	4929	121470	0	131792
12434	3448	1809	124035	5801	0	135093
12435	3898	1639	5379	122787	0	133703
12436	4108	1778	2353	121597	0	129836
12437	3764	117918	1814	6446	0	129942
12438	3827	118222	1540	3707	0	127296
12439	3421	126976	1649	3196	0	135242
12440	3859	5763	1500	124659	0	135781
12441	3594	2541	1617	128808	0	136560
12442	3060	1925	123710	7283	0	135978
12443	118358	1651	5314	4146	0	129469
12444	126529	1600	2570	3172	0	133871
12445	7785	122576	2015	2715	0	135091
12446	123952	5131	1764	2410	0	133257
12447	7671	2398	1713	120519	0	132301
12448	123462	1794	1938	6137	0	133331
12449	125870	1637	1892	3567	0	132966
12450	8266	1700	1751	120943	0	132660
12451	117500	1763	1742	5794	0	126799
12452	6734	114119	1798	3036	0	125687
12453	4313	119262	1783	2286	0	127644
12454	4086	5790	1894	109581	0	121351
12455	3512	119357	1864	4893	0	129626
12456	3874	5095	1717	115513	0	126199
12457	3951	2419	1522	119483	0	127375
12458	115338	1596	1577	6371	0	124882
12459	6030	113684	1768	3479	0	124961
12460	110689	4253	1515	2991	0	119448
12461	108758	2075	1550	3013	0	115396
12462	6123	107943	1592	2587	0	118245
12463	104629	4069	1298	2651	0	112647
12464	5554	1891	100440	2492	0	110377
12465	2809	94262	3330	2025	0	102426
12466	89053	3165	1414	2040	0	95672
12467	3602	1395	84793	1373	0	91163
12468	1877	78975	2275	1218	0	84345
12469	1672	82542	1433	1178	0	86825
12470	78720	2432	1534	1007	0	83693
12471	78281	1249	630	935	0	81095
12472	78768	907	514	881	0	81070
12473	3219	77327	550	800	0	81896
12474	1838	1953	637	78585	0	83013
12475	78865	938	697	2258	0	82758
12476	79404	831	661	1279	0	82175
12477	3105	687	603	77913	0	82308
12478	1728	625	79157	2083	0	83593
12479	1374	736	78549	1046	0	81705
12480	1429	588	2317	78480	0	82814
12481	1278	497	1240	80514	0	83529
12482	1124	479	80971	2598	0	85172
12483	1220	425	2041	76636	0	80322
12484	959	78417	1174	2262	0	82812
12485	76277	1557	853	1197	0	79884
12486	2151	778	654	75043	0	78626
12487	71562	422	544	1905	0	74433
12488	1600	71613	597	1107	0	74917
12489	881	73770	578	885	0	76114
12490	71832	1153	492	986	0	74463
12491	1336	522	70988	651	0	73497
12492	60781	390	896	606	0	62673
12493	786	64911	538	372	0	66607
12494	405	525	263	62764	0	63957
12495	62229	228	130	819	0	63406
12496	640	163	164	61729	0	62696
12497	62491	106	144	901	0	63642
12498	60798	131	150	588	0	61667
12499	662	63673	140	277	0	64752
12500	62219	337	57	358	0	62971
12501	429	61619	78	128	0	62254
12502	61937	398	83	278	0	62696
12503	571	211	60	62161	0	63003
12504	63697	118	69	566	0	64450
12505	528	91	48	65273	0	65940
12506	67921	84	43	759	0	68807
12507	69757	119	38	479	0	70393
12508	70386	98	32	407	0	70923
12509	70894	77	32	314	0	71317
12510	71384	73	38	284	0	71779
12511	696	94	35	72424	0	73249
12512	70937	62	41	643	0	71683
12513	534	69719	76	239	0	70568
12514	301	443	69836	104	0	70684
12515	353	162	375	69333	0	70223
12516	178	133	72891	427	0	73629
12517	317	73	412	74167	0	74969
12518	206	130	76095	541	0	76972
12519	72723	55	498	474	0	73750
12520	692	93	159	76522	0	77466
12521	273	97	76309	524	0	77203
12522	214	138	77043	221	0	77616
12523	304	179	638	78371	0	79492
12524	86724	61	253	996	0	88034
12525	780	92053	168	331	0	93332
12526	93171	844	92	570	0	94677
12527	93878	346	70	428	0	94722
12528	1180	94761	105	181	0	96227
12529	100024	879	70	662	0	101635
12530	1199	359	87	101483	0	103128
12531	687	172	91	101684	0	102634
12532	480	118	74	103094	0	103766
12533	102537	97	75	1592	0	104301
12534	996	105227	88	593	0	106904
12535	685	1114	61	106564	0	108424
12536	473	430	75	108185	0	109163
12537	107178	197	58	1919	0	109352
12538	1478	161	59	107109	0	108807
12539	574	175	108856	1397	0	111002
12540	315	111185	1265	635	0	113400
12541	112180	1457	452	655	0	114744
12542	1990	590	210	109392	0	112182
12543	674	114425	156	1341	0	116596
12544	112892	1565	95	963	0	115515
12545	1803	685	112666	427	0	115581
12546	715	113460	1496	371	0	116042
12547	114823	1654	547	602	0	117626
12548	1969	630	283	113903	0	116785
12549	1055	355	215	114827	0	116452
12550	482	346	114054	2116	0	116998
12551	782	228	1553	111478	0	114041
12552	348	219	120096	1971	0	122634
12553	349	225	112296	964	0	113834
12554	341	225	117977	515	0	119058
12555	115751	198	2290	805	0	119044
12556	118916	159	964	672	0	120711
12557	121474	172	575	593	0	122814
12558	2606	209	374	118078	0	121267
12559	1100	118272	328	1505	0	121205
12560	684	121154	304	735	0	122877
12561	121339	1934	239	898	0	124410
12562	120397	823	222	944	0	122386
12563	1984	122587	230	385	0	125186
12564	121388	1637	241	673	0	123939
12565	1994	741	119571	328	0	122634
12566	991	475	118088	290	0	119844
12567	1094	324	2048	110685	0	114151
12568	785	218	874	119682	0	121559
12569	475	235	119672	1967	0	122349
12570	730	211	1760	115560	0	118261
12571	117712	181	809	2322	0	121024
12572	1707	249	118271	883	0	121110
12573	113538	214	1770	923	0	116445
12574	2230	208	746	118510	0	121694
12575	1018	251	121527	1710	0	124506
12576	698	122572	1770	789	0	125829
12577	123383	1541	778	939	0	126641
12578	1904	703	121628	436	0	124671
12579	118500	406	1865	687	0	121458
12580	2203	319	825	121464	0	124811
12581	122298	253	559	2129	0	125239
12582	2211	257	126959	864	0	130291
12583	1311	236	1860	127111	0	130518
12584	132695	194	793	2440	0	136122
12585	135212	193	611	1414	0	137430
12586	139672	190	502	1077	0	141441
12587	141476	211	391	952	0	143030
12588	3279	214	359	136527	0	140379
12589	1788	215	388	137193	0	139584
12590	1055	329	136844	2693	0	140921
12591	1258	235	2067	135244	0	138804
12592	1377	263	886	131502	0	134028
12593	731	140504	581	2798	0	144614
12594	141508	2212	458	1593	0	145771
12595	143806	780	404	1378	0	146368
12596	3230	146861	467	775	0	151333
12597	1820	2672	368	145598	0	150458
12598	1450	884	327	148968	0	151629
12599	142586	495	370	4068	0	147519
12600	3243	445	147639	1579	0	152906
12601	1769	264	2757	148801	0	153591
12602	1010	353	151342	3301	0	156006
12603	144074	304	3114	1952	0	149444
12604	150431	248	1193	1461	0	153333
12605	151689	255	723	1204	0	153871
12606	4521	298	570	145949	0	151338
12607	2279	264	455	146314	0	149312
12608	145248	275	417	4148	0	150088
12609	3533	410	143331	1633	0	148907
12610	1942	286	2753	143436	0	148417
12611	144035	246	1048	3616	0	148945
12612	3705	270	650	144050	0	148675
12613	1602	341	150011	3444	0	155398
12614	1228	298	142666	1654	0	145846
12615	139856	212	3426	1732	0	145226
12616	3197	147673	1427	999	0	153296
12617	148478	2519	827	1352	0	153176
12618	150597	815	604	1183	0	153199
12619	4148	451	585	148776	0	153960
12620	2107	437	531	147679	0	150754
12621	1287	147975	562	3508	0	153332
12622	145859	2527	436	1955	0	150777
12623	3233	147850	474	1142	0	152699
12624	1450	146365	393	867	0	149075
12625	1375	2699	377	140457	0	144908
12626	139907	895	424	3073	0	144299
12627	142822	595	407	1603	0	145427
12628	3642	419	379	139832	0	144272
12629	1890	370	340	135892	0	138492
12630	1521	353	300	135704	0	137878
12631	132466	255	328	3820	0	136869
12632	3033	363	132660	1554	0	137610
12633	1406	132313	2356	1335	0	137410
12634	129162	1940	722	1302	0	133126
12635	3028	781	565	128358	0	132732
12636	1360	510	127962	2599	0	132431
12637	1162	416	124385	1328	0	127291
12638	907	124888	2531	1098	0	129424
12639	842	128130	955	881	0	130808
12640	1280	2216	869	121699	0	126064
12641	846	110629	555	1959	0	113989
12642	1080	1835	354	121412	0	124681
12643	922	611	342	125236	0	127111
12644	124767	456	325	2798	0	128346
12645	2239	428	370	125009	0	128046
12646	1211	353	323	126850	0	128737
12647	920	501	125298	2452	0	129171
12648	1109	398	1735	126962	0	130204
12649	127185	393	710	2965	0	131253
12650	128536	382	488	1667	0	131073
12651	2622	134300	450	1052	0	138424
12652	128582	2088	321	1419	0	132410
12653	2875	785	127747	916	0	132323
12654	1271	129324	2111	1037	0	133743
12655	1256	2268	718	130789	0	135031
12656	1163	748	552	134088	0	136551
12657	1147	627	471	135551	0	137796
12658	133550	497	472	3674	0	138193
12659	124027	500	618	2160	0	127305
12660	2913	549	131144	1182	0	135788
12661	1413	478	128512	1171	0	131574
12662	1224	545	129896	993	0	132658
12663	1121	128836	2751	990	0	133698
12664	1079	134485	976	993	0	137533
12665	132424	2745	599	1494	0	137262
12666	133071	916	528	1507	0	136022
12667	3379	638	562	133828	0	138407
12668	1657	508	605	131049	0	133819
12669	1031	133063	630	3212	0	137936
12670	1300	2529	513	134968	0	139310
12671	1055	995	134938	3049	0	140037
12672	941	135592	2575	1451	0	140559
12673	1180	2586	896	136521	0	141183
12674	976	1039	142192	3078	0	147285
12675	1535	849	2581	129646	0	134611
12676	933	140145	843	2987	0	144908
12677	143416	2893	586	1931	0	148826
12678	143978	1036	498	1678	0	147190
12679	149538	762	484	1627	0	152411
12680	4258	682	476	148934	0	154350
12681	1981	630	471	152313	0	155395
12682	149129	702	432	4519	0	154782
12683	3661	149684	526	1636	0	155507
12684	148375	3235	444	1631	0	153685
12685	3848	1043	150693	905	0	156489
12686	149051	621	3293	1247	0	154212
12687	154444	511	1083	1334	0	157372
12688	5140	454	593	151260	0	157447
12689	154439	500	464	4251	0	159654
12690	157078	512	435	1977	0	160002
12691	5191	540	455	154741	0	160927
12692	1811	491	153390	3642	0	159334
12693	144310	444	3264	2106	0	150124
12694	3837	435	155476	997	0	160745
12695	1482	158557	3483	837	0	164359
12696	1639	3112	1515	157476	0	163742
12697	1251	978	485	164084	0	166798
12698	172109	426	462	4723	0	177720
12699	4083	477	174214	1457	0	180231
12700	1959	564	3815	159331	0	165669
12701	972	170076	1216	3663	0	175927
12702	696	171992	763	1349	0	174800
12703	1216	4572	518	170870	0	177176
12704	751	1406	170617	4218	0	176992
12705	1212	757	3913	170068	0	175950
12706	1254	537	1269	169092	0	172152
12707	709	599	166655	4854	0	172817
12708	579	170532	3875	1756	0	176742
12709	163189	4192	1135	1759	0	170275
12710	3883	171399	748	1108	0	177138
12711	1903	4129	612	167568	0	174212
12712	160613	1456	601	4835	0	167505
12713	3788	162217	756	1718	0	168479
12714	1354	4163	162135	1130	0	168782
12715	154438	1596	3840	1552	0	161426
12716	4166	166404	1325	849	0	172744
12717	165553	4124	760	1440	0	171877
12718	4645	1464	161139	875	0	168123
12719	159605	824	3935	1412	0	165776
12720	4877	752	1352	160909	0	167890
12721	1808	828	162255	4194	0	169085
12722	1718	808	4066	152649	0	159241
12723	1180	156285	1426	4157	0	163048
12724	1458	4117	825	158382	0	164782
12725	1506	1392	683	160891	0	164472
12726	1214	974	156027	5253	0	163468
12727	1533	882	4093	155944	0	162452
12728	1385	1135	131536	5106	0	139162
12729	1313	157518	3274	2033	0	164138
12730	1586	4472	1221	156095	0	163374
12731	1388	1634	158766	4763	0	166551
12732	1194	155432	4542	2154	0	163322
12733	1315	163970	1619	1602	0	168506
12734	1288	5265	161095	1423	0	169071
12735	1385	1866	161545	1226	0	166022
12736	1817	1117	5394	157768	0	166096
12737	157431	1083	1977	5481	0	165972
12738	5155	158932	1192	2371	0	167650
12739	2642	4824	989	155267	0	163722
12740	155387	1724	967	5405	0	163483
12741	5471	156582	1107	2323	0	165483
12742	153750	4832	1112	2015	0	161709
12743	5638	158760	1088	1671	0	167157
12744	158773	5066	1022	1904	0	166765
12745	158599	2000	1153	1942	0	163694
12746	160580	1480	964	1965	0	164989
12747	7061	165151	1060	1753	0	175025
12748	3659	5396	1165	163771	0	173991
12749	2580	1986	161652	5673	0	171891
12750	2169	161260	5208	2832	0	171469
12751	2868	5434	1960	154049	0	164311
12752	2844	2274	1445	157509	0	164072
12753	1961	1620	152407	6288	0	162276
12754	2109	149783	5100	2830	0	159822
12755	146850	5100	2197	2434	0	156581
12756	5722	148255	1470	2030	0	157477
12757	2978	5285	1232	145622	0	155117
12758	1989	2165	146591	5646	0	156391
12759	141291	1526	5182	2867	0	150866
12760	5925	1447	2048	147383	0	156803
12761	2087	1527	146175	5737	0	155526
12762	136320	1526	5366	3038	0	146250
12763	5150	142849	2296	2196	0	152491
12764	142540	5439	1747	2323	0	152049
12765	144906	2407	1229	2470	0	151012
12766	6405	1590	1237	142593	0	151825
12767	2538	1655	142380	5630	0	152203
12768	2057	141773	5201	2550	0	151581
12769	1579	5497	141659	1946	0	150681
12770	1808	2815	5110	134604	0	144337
12771	1669	2166	2182	142557	0	148574
12772	137613	1637	1664	6472	0	147386
12773	4989	1346	136582	3203	0	146120
12774	1979	131562	5184	2156	0	140881
12775	1961	4897	2130	129244	0	138232
12776	1930	2122	1339	132235	0	137626
12777	125817	1671	1262	5619	0	134369
12778	4815	127957	969	2420	0	136161
12779	2557	4335	875	120627	0	128394
12780	114995	2013	822	4940	0	122770
12781	3871	116449	948	2229	0	123497
12782	111661	4023	690	1414	0	117788
12783	112273	1629	883	1376	0	116161
12784	4587	109825	926	1180	0	116518
12785	99316	3356	547	1074	0	104293
12786	3700	100339	609	818	0	105466
12787	99024	3308	666	873	0	103871
12788	98759	1273	623	1039	0	101694
12789	3842	97561	512	936	0	102851
12790	92374	3065	394	941	0	96774
12791	94524	1095	430	867	0	96916
12792	94366	969	388	900	0	96623
12793	3874	874	90246	764	0	95758
12794	1618	654	81844	607	0	84723
12795	1120	634	80938	540	0	83232
12796	78272	859	3242	679	0	83052
12797	2824	499	77187	536	0	81046
12798	1127	506	67616	310	0	69559
12799	1083	625	2224	61293	0	65225
12800	62449	352	960	1747	0	65508
12801	1969	338	63145	648	0	66100
12802	961	364	66232	497	0	68054
12803	932	387	2174	64303	0	67796
12804	851	345	925	66391	0	68512
12805	829	332	607	67848	0	69616
12806	662	344	66586	2244	0	69836
12807	788	343	1884	66069	0	69084
12808	65467	341	879	2230	0	68917
12809	1927	66504	602	977	0	70010
12810	1091	1717	483	66679	0	69970
12811	902	713	458	68645	0	70718
12812	641	590	69263	2221	0	72715
12813	618	68139	1919	1036	0	71712
12814	67315	1883	699	898	0	70795
12815	2003	68470	606	648	0	71727
12816	1083	2030	492	67852	0	71457
12817	750	806	68434	2060	0	72050
12818	829	608	2064	71011	0	74512
12819	782	508	896	73372	0	75558
12820	73095	455	698	2767	0	77015
12821	2516	406	575	70497	0	73994
12822	945	71530	600	2503	0	75578
12823	781	75479	633	1085	0	77978
12824	655	2405	74945	873	0	78878
12825	73853	903	2249	920	0	77925
12826	2729	581	827	75332	0	79469
12827	1211	449	650	75090	0	77400
12828	982	530	579	76016	0	78107
12829	73712	409	484	2982	0	77587
12830	2286	75581	527	1339	0	79733
12831	74651	2013	485	1146	0	78295
12832	2392	725	71440	817	0	75374
12833	990	584	70322	749	0	72645
12834	72329	417	2343	837	0	75926
12835	2534	457	1211	73012	0	77214
12836	1152	460	696	75102	0	77410
12837	956	353	663	76090	0	78062
12838	643	409	75339	2722	0	79113
12839	73462	330	2128	1406	0	77326
12840	76321	336	862	1122	0	78641
12841	75143	362	695	1045	0	77245
12842	2891	484	608	73098	0	77081
12843	1203	365	71630	2369	0	75567
12844	1056	329	68846	1137	0	71368
12845	883	364	72950	965	0	75162
12846	708	70261	2172	839	0	73980
12847	1130	1307	1281	63702	0	67420
12848	63195	425	520	1669	0	65809
12849	1403	312	63933	785	0	66433
12850	63785	210	1416	840	0	66251
12851	1619	222	645	65402	0	67888
12852	815	279	538	64743	0	66375
12853	592	63340	446	1717	0	66095
12854	541	64630	451	880	0	66502
12855	500	68495	498	726	0	70219
12856	599	1446	484	68658	0	71187
12857	67910	491	457	1709	0	70567
12858	68237	346	411	970	0	69964
12859	1685	304	68064	710	0	70763
12860	64785	298	1406	812	0	67301
12861	1833	310	67674	700	0	70517
12862	827	293	1490	67464	0	70074
12863	632	285	68271	1562	0	70750
12864	67037	269	1516	921	0	69743
12865	1624	310	668	70433	0	73035
12866	735	296	73849	1613	0	76493
12867	606	306	69542	831	0	71285
12868	68712	267	1606	956	0	71541
12869	72909	288	739	803	0	74739
12870	1640	75835	527	687	0	78689
12871	890	1153	482	77561	0	80086
12872	637	521	77634	1499	0	80291
12873	595	445	76249	751	0	78040
12874	778	511	1551	76583	0	79423
12875	78638	308	786	1719	0	81451
12876	1384	78523	568	843	0	81318
12877	814	1157	481	80058	0	82510
12878	80066	453	460	1728	0	82707
12879	1558	329	455	80202	0	82544
12880	831	80866	494	1604	0	83795
12881	754	1143	474	82272	0	84643
12882	81522	504	522	1705	0	84253
12883	1648	372	492	82155	0	84667
12884	82732	287	520	1804	0	85343
12885	1569	85726	521	1030	0	88846
12886	85394	1174	521	1145	0	88234
12887	1670	511	84889	748	0	87818
12888	79918	407	1444	971	0	82740
12889	85988	390	735	821	0	87934
12890	1813	87850	617	634	0	90914
12891	1010	1334	530	87046	0	89920
12892	814	522	86677	1423	0	89436
12893	680	354	83106	868	0	85008
12894	79676	476	1495	1016	0	82663
12895	80811	303	652	931	0	82697
12896	1371	83127	438	681	0	85617
12897	781	84679	385	576	0	86421
12898	83089	1120	509	651	0	85369
12899	1376	83121	483	431	0	85411
12900	793	85655	444	452	0	87344
12901	756	996	422	85369	0	87543
12902	614	366	364	83739	0	85083
12903	531	302	84537	1438	0	86808
12904	644	247	1125	82935	0	84951
12905	82486	242	554	1541	0	84823
12906	1377	277	83614	570	0	85838
12907	826	280	83100	489	0	84695
12908	971	226	1212	81564	0	83973
12909	707	244	618	86338	0	87907
12910	663	242	524	86710	0	88139
12911	459	297	85728	1292	0	87776
12912	523	250	1059	80945	0	82777
12913	505	281	509	85208	0	86503
12914	84397	224	365	1261	0	86247
12915	926	84370	333	569	0	86198
12916	82787	694	318	642	0	84441
12917	1022	292	84196	322	0	85832
12918	72107	131	543	596	0	73377
12919	626	83027	242	215	0	84110
12920	80445	321	164	393	0	81323
12921	401	81164	114	132	0	81811
12922	77689	366	147	359	0	78561
12923	345	78370	84	93	0	78892
12924	141	78938	142	129	0	79350
12925	320	410	202	79668	0	80600
12926	79861	114	75	543	0	80593
12927	79373	74	31	387	0	79865
12928	79310	51	31	339	0	79731
12929	437	111	78314	56	0	78918
12930	244	78	76486	60	0	76868
12931	226	72	395	78474	0	79167
12932	104	79270	158	352	0	79884
12933	81	82560	87	159	0	82887
12934	173	456	64	80908	0	81601
12935	80333	160	40	613	0	81146
12936	79384	78	37	419	0	79918
12937	79440	68	36	385	0	79929
12938	567	106	80012	40	0	80725
12939	340	67	388	80396	0	81191
12940	156	98	82623	439	0	83316
12941	79462	70	479	496	0	80507
12942	82155	54	187	473	0	82869
12943	690	92	84410	80	0	85272
12944	394	55	490	83329	0	84268
12945	84806	58	184	868	0	85916
12946	730	56	122	87213	0	88121
12947	439	65	71	87935	0	88510
12948	518	81	167	90397	0	91163
12949	99947	60	74	1668	0	101749
12950	1482	58	71	105456	0	107067
12951	107242	84	75	2026	0	109427
12952	1699	113766	120	686	0	116271
12953	904	1678	78	116900	0	119560
12954	634	560	93	117958	0	119245
12955	561	239	80	117069	0	117949
12956	115973	133	66	2843	0	119015
12957	2151	135	81	115238	0	117605
12958	1036	112	63	116058	0	117269
12959	116955	67	62	2874	0	119958
12960	117730	105	83	1419	0	119337
12961	117403	92	65	979	0	118539
12962	2804	130	113734	514	0	117182
12963	1306	162	107522	520	0	109510
12964	114074	68	2192	639	0	116973
12965	2475	70	784	113762	0	117091
12966	1304	127	363	110402	0	112196
12967	113022	89	227	2928	0	116266
12968	109680	93	210	1524	0	111507
12969	110190	131	148	1087	0	111556
12970	2744	108587	175	543	0	112049
12971	108696	1690	130	694	0	111210
12972	106482	577	133	767	0	107959
12973	2715	105899	159	404	0	109177
12974	1281	108511	152	367	0	110311
12975	1122	2068	134	108765	0	112089
12976	111655	709	166	2116	0	114646
12977	111643	355	190	1049	0	113237
12978	111589	249	132	826	0	112796
12979	3198	203	81	109616	0	113098
12980	109997	160	91	2479	0	112727
12981	2689	229	107484	949	0	111351
12982	104636	226	1753	968	0	107583
12983	2671	223	107871	491	0	111256
12984	1246	283	105072	472	0	107073
12985	1158	227	2176	102456	0	106017
12986	104159	144	973	2287	0	107563
12987	2373	176	434	104043	0	107026
12988	1103	258	104590	2378	0	108329
12989	842	198	103501	1185	0	105726
12990	969	122	2261	101848	0	105200
12991	101743	145	929	2581	0	105398
12992	2314	104019	611	1085	0	108029
12993	1406	1702	423	105597	0	109128
12994	1290	619	373	108188	0	110470
12995	802	391	109011	2801	0	113005
12996	900	263	106957	1372	0	109492
12997	1015	223	2513	108274	0	112025
12998	108460	190	1107	2934	0	112691
12999	2453	248	109506	1447	0	113654
13000	1655	256	2023	107644	0	111578
13001	1402	209	841	108872	0	111324
13002	1142	199	557	111528	0	113426
13003	107276	246	506	3561	0	111589
13004	2612	416	98476	1922	0	103426
13005	1551	106494	1535	1391	0	110971
13006	1460	1940	743	107616	0	111759
13007	1122	830	106714	2721	0	111387
13008	1176	103324	2171	1682	0	108353
13009	1156	108099	1052	1330	0	111637
13010	106935	2421	698	1342	0	111396
13011	2778	108207	592	1249	0	112826
13012	108731	2278	525	1441	0	112975
13013	3204	1033	108232	1112	0	113581
13014	1961	662	2293	108830	0	113746
13015	108693	467	967	3337	0	113464
13016	3095	110585	694	1828	0	116202
13017	1884	2388	110596	1406	0	116274
13018	2176	990	2415	99891	0	105472
13019	1489	111892	1133	2378	0	116892
13020	1619	2537	712	116163	0	121031
13021	114805	1063	742	3566	0	120176
13022	3259	119893	716	1723	0	125591
13023	121190	2818	561	1676	0	126245
13024	123554	1167	582	1522	0	126825
13025	4562	823	122886	1099	0	129370
13026	2490	127545	3165	1074	0	134274
13027	2338	3359	1334	132956	0	139987
13028	1654	1245	138592	3871	0	145362
13029	1683	768	148064	1553	0	152068
13030	2016	929	5246	149079	0	157270
13031	152905	533	2128	5067	0	160633
13032	154427	467	1360	2334	0	158588
13033	6679	528	953	151657	0	159817
13034	2711	610	152784	5194	0	161299
13035	1916	152894	4547	2333	0	161690
13036	154861	4444	1705	2026	0	163036
13037	157163	1576	1163	1762	0	161664
13038	6255	158013	968	1083	0	166319
13039	159103	4748	917	1333	0	166101
13040	5949	1828	155488	850	0	164115
13041	153692	1132	4685	1297	0	160806
13042	148487	842	1997	1603	0	152929
13043	5844	760	155465	870	0	162939
13044	3285	597	4875	150890	0	159647
13045	2073	531	153035	4770	0	160409
13046	1601	145051	5016	1979	0	153647
13047	1301	149117	2215	1564	0	154197
13048	1827	5445	1252	136145	0	144669
13049	905	1519	139441	3631	0	145496
13050	720	129672	3474	1321	0	135187
13051	575	133142	1242	766	0	135725
13052	120545	3882	1160	1118	0	126705
13053	122983	1211	558	750	0	125502
13054	3953	749	461	122426	0	127589
13055	1848	552	371	119403	0	122174
13056	923	124025	408	3286	0	128642
13057	122159	2969	431	1626	0	127185
13058	123499	987	384	1335	0	126205
13059	3613	123890	418	698	0	128619
13060	1830	3101	257	124270	0	129458
13061	932	1159	124766	3067	0	129924
13062	1177	643	2874	124004	0	128698
13063	125268	579	983	3844	0	130674
13064	3591	576	609	126296	0	131072
13065	1696	540	430	130315	0	132981
13066	129226	434	398	4470	0	134528
13067	3893	410	357	125034	0	129694
13068	1334	127581	464	3570	0	132949
13069	1230	3073	368	129480	0	134151
13070	1244	1078	340	132105	0	134767
13071	1142	672	408	127954	0	130176
13072	747	129805	466	4100	0	135118
13073	950	3251	414	128538	0	133153
13074	666	1224	127008	3949	0	132847
13075	1028	813	3234	125296	0	130371
13076	730	783	125781	3928	0	131222
13077	730	124409	3407	1771	0	130317
13078	1063	3158	1324	126571	0	132116
13079	1039	1214	789	128875	0	131917
13080	1218	785	703	129312	0	132018
13081	1171	742	674	129094	0	131681
13082	795	881	125802	4760	0	132238
13083	757	124468	3376	2270	0	130871
13084	1080	3328	1263	127305	0	132976
13085	858	1366	128835	4116	0	135175
13086	1227	979	3699	128793	0	134698
13087	129109	831	1510	4861	0	136311
13088	3942	815	125297	2087	0	132141
13089	125550	660	3600	1878	0	131688
13090	4593	753	1453	129330	0	136129
13091	2101	924	129586	4178	0	136789
13092	1552	127628	3978	2070	0	135228
13093	1689	3658	1608	126877	0	133832
13094	1393	1537	131591	4312	0	138833
13095	1243	130161	4199	2076	0	137679
13096	1549	4035	1746	130532	0	137862
13097	130320	1721	1280	4962	0	138283
13098	133985	1198	1332	2467	0	138982
13099	135380	1107	1097	1981	0	139565
13100	5533	1069	132587	1602	0	140791
13101	2721	134656	4093	1313	0	142783
13102	2301	4284	1700	133735	0	142020
13103	1940	1774	1250	142130	0	147094
13104	142165	1270	1178	5841	0	150454
13105	4740	146439	1087	2361	0	154627
13106	146470	4893	846	2313	0	154522
13107	146247	1990	957	2234	0	151428
13108	149330	1524	944	2077	0	153875
13109	6215	1479	145431	1590	0	154715
13110	146288	1119	4565	1914	0	153886
13111	6401	1102	1616	147296	0	156415
13112	3167	1053	1045	149787	0	155052
13113	146402	872	1050	6516	0	154840
13114	5810	964	874	143932	0	151580
13115	2378	144634	838	5682	0	153532
13116	2259	4645	610	143496	0	151010
13117	139144	1685	632	6357	0	147818
13118	5090	1307	137464	3084	0	146945
13119	2082	136345	4200	2406	0	145033
13120	2137	4169	1231	132818	0	140355
13121	131978	1561	836	5311	0	139686
13122	4747	1052	128891	2447	0	137137
13123	2627	2812	4201	124546	0	134186
13124	2037	786	124565	4855	0	132243
13125	1726	642	119628	2540	0	124536
13126	1396	617	116182	1816	0	120011
13127	1248	497	113250	1566	0	116561
13128	1076	506	108865	1305	0	111752
13129	92040	1131	4306	1178	0	98655
13130	2060	94597	1179	749	0	98585
13131	91861	1636	787	796	0	95080
13132	91463	567	651	787	0	93468
13133	2206	90587	637	482	0	93912
13134	855	93209	591	462	0	95117
13135	92029	1845	523	783	0	95180
13136	92411	666	479	650	0	94206
13137	2476	495	421	88360	0	91752
13138	1031	90762	462	1648	0	93903
13139	91776	1607	418	1057	0	94858
13140	1903	91859	496	490	0	94748
13141	1183	1782	459	91937	0	95361
13142	92981	694	421	1987	0	96083
13143	93341	480	382	1038	0	95241
13144	2528	460	339	92392	0	95719
13145	1359	408	324	93563	0	95654
13146	948	474	92426	2040	0	95888
13147	1021	469	1634	90644	0	93768
13148	711	513	92320	2025	0	95569
13149	981	350	1794	87948	0	91073
13150	949	294	720	90989	0	92952
13151	89919	277	553	2642	0	93391
13152	89473	413	476	1369	0	91731
13153	2338	367	89169	787	0	92661
13154	86697	347	1815	910	0	89769
13155	2438	279	777	88968	0	92462
13156	1142	326	89658	2047	0	93173
13157	1217	297	1930	88478	0	91922
13158	1122	291	745	95997	0	98155
13159	772	336	96090	2659	0	99857
13160	1034	275	2185	96960	0	100454
13161	745	315	101718	2645	0	105423
13162	974	335	2462	104855	0	108626
13163	109246	289	1050	3310	0	113895
13164	2731	112176	750	1521	0	117178
13165	111568	2494	613	1423	0	116098
13166	3126	114806	611	905	0	119448
13167	112691	2852	571	1099	0	117213
13168	3224	114395	624	803	0	119046
13169	112143	2941	573	1190	0	116847
13170	3245	115436	577	836	0	120094
13171	2068	3086	481	114503	0	120138
13172	1297	1403	115693	2918	0	121311
13173	1147	1039	114753	1379	0	118318
13174	1521	839	3437	113935	0	119732
13175	114498	718	1588	3351	0	120155
13176	3363	117458	982	1556	0	123359
13177	2160	3101	735	116730	0	122726
13178	1266	1548	117839	3301	0	123954
13179	1136	1011	118528	1626	0	122301
13180	1556	1120	3825	108630	0	115131
13181	853	118594	1874	2975	0	124296
13182	117206	3049	1147	1894	0	123296
13183	3335	1469	120847	1143	0	126794
13184	1579	1061	117229	1030	0	120899
13185	1002	119867	3870	969	0	125708
13186	118501	3012	2286	1217	0	125016
13187	120772	1329	1374	1043	0	124518
13188	4094	920	1072	118792	0	124878
13189	120179	752	890	3288	0	125109
13190	118595	704	927	1852	0	122078
13191	3876	118918	1000	1086	0	124880
13192	118735	2841	1005	1071	0	123652
13193	3636	1403	120310	713	0	126062
13194	2292	877	2962	115255	0	121386
13195	1802	841	1412	116381	0	120436
13196	114645	645	1006	3664	0	119960
13197	3173	114474	905	1735	0	120287
13198	112793	2718	727	1334	0	117572
13199	3341	115064	579	874	0	119858
13200	1900	116049	571	739	0	119259
13201	1548	3305	111943	742	0	117538
13202	1333	1706	108530	779	0	112348
13203	101717	1342	2895	888	0	106842
13204	105103	803	1351	827	0	108084
13205	2914	843	101906	435	0	106098
13206	1603	96283	1902	442	0	100230
13207	1036	100375	1094	367	0	102872
13208	99563	2461	764	654	0	103442
13209	99862	1373	587	609	0	102431
13210	2890	939	546	99024	0	103399
13211	100959	706	589	2070	0	104324
13212	2615	528	611	99643	0	103397
13213	1382	650	100167	1966	0	104165
13214	1096	606	94559	1090	0	97351
13215	96621	631	2459	1035	0	100746
13216	2505	630	1271	95608	0	100014
13217	1381	105108	859	1652	0	109000
13218	107214	1900	732	1309	0	111155
13219	107414	1021	711	1094	0	110240
13220	2838	815	106952	685	0	111290
13221	106351	615	1992	914	0	109872
13222	111301	522	1199	753	0	113775
13223	3222	588	860	108547	0	113217
13224	1814	105992	760	1936	0	110502
13225	1391	107467	727	1083	0	110668
13226	1458	2632	541	113150	0	117781
13227	1506	1367	585	109536	0	112994
13228	1443	867	595	113517	0	116422
13229	1240	772	111778	3048	0	116838
13230	1197	786	107659	1591	0	111233
13231	1373	761	2772	108564	0	113470
13232	1157	746	111213	2395	0	115511
13233	1075	793	109459	1379	0	112706
13234	1107	782	3003	107536	0	112428
13235	1033	716	115323	2517	0	119589
13236	909	114193	2897	1471	0	119470
13237	118045	2424	1525	1565	0	123559
13238	2973	1334	1142	115819	0	121268
13239	1556	117626	996	2478	0	122656
13240	1102	2637	121228	1327	0	126294
13241	1242	1286	2971	119609	0	125108
13242	940	939	125178	2785	0	129842
13243	1284	674	3312	122444	0	127714
13244	1229	660	1647	127519	0	131055
13245	1078	731	130777	3643	0	136229
13246	1325	726	3151	124733	0	129935
13247	939	125892	1747	3067	0	131645
13248	1219	2890	1159	133064	0	138332
13249	995	1444	133324	3296	0	139059
13250	1281	939	3020	130891	0	136131
13251	129538	677	1554	3878	0	135647
13252	2993	131380	1239	2070	0	137682
13253	1911	2800	1031	131100	0	136842
13254	1189	1361	134713	3072	0	140335
13255	1000	129235	3044	1857	0	135136
13256	953	134328	1578	1294	0	138153
13257	1025	3363	131465	1191	0	137044
13258	1168	1544	2567	122969	0	128248
13259	1370	1241	1422	122863	0	126896
13260	900	631	123665	3147	0	128343
13261	694	114462	2366	1672	0	119194
13262	574	116404	1175	1014	0	119167
13263	107978	1928	671	815	0	111392
13264	1553	108373	476	609	0	111011
13265	107829	1683	374	773	0	110659
13266	1832	699	361	104810	0	107702
13267	110082	448	370	2213	0	113113
13268	1745	372	110112	823	0	113052
13269	106445	318	1675	889	0	109327
13270	2019	387	758	109672	0	112836
13271	696	111961	575	1661	0	114893
13272	113021	1536	394	1009	0	115960
13273	1882	1157	414	111035	0	114488
13274	712	111832	406	1611	0	114561
13275	488	119153	405	763	0	120809
13276	116389	1756	403	913	0	119461
13277	117963	667	257	770	0	119657
13278	119606	418	254	650	0	120928
13279	2067	335	256	115123	0	117781
13280	702	112157	329	1547	0	114735
13281	448	116699	316	664	0	118127
13282	515	1727	283	116521	0	119046
13283	114477	633	321	1968	0	117399
13284	107020	511	267	1469	0	109267
13285	112167	349	283	1000	0	113799
13286	1966	447	107479	465	0	110357
13287	938	451	108022	493	0	109904
13288	116447	438	1657	806	0	119348
13289	1910	414	645	117314	0	120283
13290	964	390	461	119044	0	120859
13291	868	351	367	117187	0	118773
13292	680	397	409	119394	0	120880
13293	436	506	117063	2331	0	120336
13294	611	370	1665	115114	0	117760
13295	416	423	116200	2128	0	119167
13296	104970	382	1828	1658	0	108838
13297	1630	115693	830	971	0	119124
13298	888	1646	679	118976	0	122189
13299	732	772	537	117669	0	119710
13300	115719	584	512	2696	0	119511
13301	114638	452	582	1595	0	117267
13302	114759	489	490	1304	0	117042
13303	114228	494	406	1171	0	116299
13304	2288	587	115128	839	0	118842
13305	1067	571	112047	846	0	114531
13306	957	514	2058	113845	0	117374
13307	115563	485	933	2407	0	119388
13308	114009	509	747	1539	0	116804
13309	2103	569	114403	1069	0	118144
13310	1278	371	1831	112014	0	115494
13311	113328	462	899	2499	0	117188
13312	1990	595	693	113928	0	117206
13313	1051	654	115011	2197	0	118913
13314	1162	562	1740	112229	0	115693
13315	114032	591	760	2588	0	117971
13316	1889	126277	658	1194	0	130018
13317	124141	1757	503	1554	0	127955
13318	125866	811	509	1501	0	128687
13319	128242	574	573	1168	0	130557
13320	2892	496	488	127445	0	131321
13321	124740	574	389	2364	0	128067
13322	2158	131227	478	1027	0	134890
13323	1115	136549	470	919	0	139053
13324	1241	2825	396	133856	0	138318
13325	134744	1212	344	2709	0	139009
13326	2666	141489	324	1153	0	145632
13327	160766	2615	300	1336	0	165017
13328	168745	1286	322	1370	0	171723
13329	5169	176509	343	747	0	182768
13330	2935	4190	311	176307	0	183743
13331	2215	1852	244	181749	0	186060
13332	1563	1225	181574	5260	0	189622
13333	2342	872	3867	177417	0	184498
13334	1604	901	180852	5041	0	188398
13335	1317	175621	4203	2527	0	183668
13336	1666	4265	1738	178293	0	185962
13337	170718	1808	1110	5714	0	179350
13338	174254	973	942	3352	0	179521
13339	5786	901	1057	173553	0	181297
13340	2255	902	169881	4966	0	178004
13341	154854	801	4045	3350	0	163050
13342	4431	163166	1792	1786	0	171175
13343	2355	162236	999	1722	0	167312
13344	1927	168334	794	1465	0	172520
13345	2294	4997	910	159313	0	167514
13346	1400	2158	164756	4166	0	172480
13347	1644	1375	3868	161649	0	168536
13348	1184	1367	165360	4252	0	172163
13349	931	1486	161961	2052	0	166430
13350	868	1388	167802	1436	0	171494
13351	1550	1176	5320	156093	0	164139
13352	1241	921	2468	167379	0	172009
13353	1008	729	1929	170581	0	174247
13354	1089	608	1720	166742	0	170159
13355	165927	497	1717	6457	0	174598
13356	3469	166068	1772	3092	0	174401
13357	164555	3547	1428	2914	0	172444
13358	3871	168713	1144	2381	0	176109
13359	2282	3948	857	168356	0	175443
13360	1754	1747	699	176309	0	180509
13361	172482	1158	559	6654	0	180853
13362	174753	1087	539	3650	0	180029
13363	177103	1199	537	2590	0	181429
13364	177001	1074	510	2426	0	181011
13365	175813	1085	372	2365	0	179635
13366	5990	173821	389	1740	0	181940
13367	166491	3792	306	2317	0	172906
13368	5405	168493	385	1381	0	175664
13369	166668	3961	311	1567	0	172507
13370	5847	1874	165861	887	0	174469
13371	3910	1435	3235	158964	0	167544
13372	2587	167919	1444	3284	0	175234
13373	2423	4220	856	167054	0	174553
13374	2125	2276	165976	3907	0	174284
13375	2282	1697	3696	157638	0	165313
13376	154298	1333	1705	5392	0	162728
13377	4007	158396	1380	2734	0	166517
13378	2067	162970	1063	2340	0	168440
13379	1617	5059	163291	1984	0	171951
13380	1841	2534	3921	156901	0	165197
13381	1570	165471	2216	4429	0	173686
13382	1497	4325	1421	169372	0	176615
13383	1370	2517	171234	4711	0	179832
13384	1156	166811	4114	3013	0	175094
13385	1242	4719	168531	2048	0	176540
13386	1327	2715	167997	1801	0	173840
13387	1631	1861	5039	165179	0	173710
13388	168078	1726	2573	5185	0	177562
13389	4460	1561	1925	171077	0	179023
13390	2108	1697	172169	4948	0	180922
13391	1772	1731	4931	172630	0	181064
13392	1258	1690	178503	5222	0	186673
13393	1282	1381	175232	3252	0	181147
13394	171955	1144	6374	3621	0	183094
13395	185119	1028	3352	3274	0	192773
13396	186135	932	2591	3396	0	193054
13397	5776	899	184868	2387	0	193930
13398	2807	909	185555	2334	0	191605
13399	2466	714	6849	178443	0	188472
13400	2503	674	3707	184109	0	190993
13401	183983	810	2421	6794	0	194008
13402	5951	821	2010	184319	0	193101
13403	3172	941	185612	5861	0	195586
13404	2343	899	179392	3499	0	186133
13405	1941	182861	6114	2849	0	193765
13406	2381	4287	2892	185989	0	195549
13407	2084	2136	189722	5701	0	199643
13408	2572	1341	5376	185247	0	194536
13409	185592	1163	2956	6919	0	196630
13410	5211	1228	191879	3410	0	201728
13411	3316	1074	5731	188656	0	198777
13412	2716	1180	2927	193676	0	200499
13413	2092	1153	191032	6895	0	201172
13414	2707	866	5509	186804	0	195886
13415	2024	1033	189593	6348	0	198998
13416	170973	876	5674	4303	0	181826
13417	5518	943	3202	173562	0	183225
13418	2644	173867	2353	5623	0	184487
13419	172074	4164	1792	4162	0	182192
13420	171539	1833	1965	3418	0	178755
13421	5879	172172	1913	2636	0	182600
13422	4401	11471	1919	149751	0	167542
13423	2238	158988	1258	4068	0	166552
13424	1977	161970	1152	2424	0	167523
13425	3212	4922	153431	1813	0	163378
13426	1966	150651	3517	1734	0	157868
13427	1507	3044	128189	963	0	133703
13428	104369	991	1759	1210	0	108329
13429	108383	298	595	933	0	110209
13430	1388	113290	351	357	0	115386
13431	492	113792	315	355	0	114954
13432	295	119804	275	286	0	120660
13433	122485	1681	237	758	0	125161
13434	2244	520	263	127140	0	130167
13435	560	440	138165	1820	0	140985
13436	316	139079	2267	684	0	142346
13437	819	2374	539	141180	0	144912
13438	891	683	332	137506	0	139412
13439	230	157843	395	2441	0	160909
13440	165237	3127	297	1505	0	170166
13441	3673	825	170136	482	0	175116
13442	2420	524	3750	186837	0	193531
13443	477	213638	1024	4149	0	219288
13444	210681	5410	464	1945	0	218500
13445	5532	1448	211388	791	0	219159
13446	1291	206975	5442	753	0	214461
13447	2231	5682	1260	205291	0	214464
13448	758	1476	207456	5313	0	215003
13449	198176	876	5934	2111	0	207097
13450	6678	888	1417	201435	0	210418
13451	1696	758	204041	5868	0	212363
13452	925	202776	6066	1695	0	211462
13453	196641	5743	1590	1947	0	205921
13454	5436	203698	1206	1127	0	211467
13455	201662	6062	1072	1525	0	210321
13456	205554	1822	722	1504	0	209602
13457	7724	1335	677	195273	0	205009
13458	2343	195328	927	5587	0	204185
13459	1585	5606	197846	1504	0	206541
13460	2381	1675	5843	193111	0	203010
13461	3393	1627	2612	168776	0	176408
13462	2171	869	1338	197058	0	201436
13463	2279	781	1068	197287	0	201415
13464	2013	821	810	199141	0	202785
13465	193675	826	947	8511	0	203959
13466	186911	954	997	3798	0	192660
13467	187122	872	793	3117	0	191904
13468	6784	189024	774	2004	0	198586
13469	2616	5673	192205	1464	0	201958
13470	1905	1662	192917	1438	0	197922
13471	1414	1299	196957	1423	0	201093
13472	2343	1334	7462	184701	0	195840
13473	2042	923	2726	192339	0	198030
13474	1998	874	1665	193845	0	198382
13475	1008	985	190348	8077	0	200418
13476	913	186177	6604	3583	0	197277
13477	1010	5979	189013	2385	0	198387
13478	1059	1827	192576	2069	0	197531
13479	2118	1269	7529	183903	0	194819
13480	1275	1415	190517	6817	0	200024
13481	2046	1109	7163	183879	0	194197
13482	183030	1281	2818	7607	0	194736
13483	184252	1205	2067	3161	0	190685
13484	7553	1137	181748	1968	0	192406
13485	3408	1105	7004	177645	0	189162
13486	2153	1264	181611	7110	0	192138
13487	1606	181070	7181	2946	0	192803
13488	179364	6487	2764	2687	0	191302
13489	7001	2358	180755	1761	0	191875
13490	2565	172436	7215	1713	0	183929
13491	1716	174851	3005	1787	0	181359
13492	1619	176215	2317	1912	0	182063
13493	1650	7651	166791	1788	0	177880
13494	2602	3725	6907	151680	0	164914
13495	1659	163348	2616	5954	0	173577
13496	2292	6851	2057	160141	0	171341
13497	2400	2692	1976	165700	0	172768
13498	158204	1968	1854	8021	0	170047
13499	6288	160204	1849	3635	0	171976
13500	156416	6431	1916	3121	0	167884
13501	6684	155454	1728	2658	0	166524
13502	2950	162753	1732	2199	0	169634
13503	2247	7614	157342	2287	0	169490
13504	2498	3336	6479	153799	0	166112
13505	1835	2739	156981	6825	0	168380
13506	1834	154422	6692	3521	0	166469
13507	1897	6534	154540	2723	0	165694
13508	1981	2666	156431	2559	0	163637
13509	1811	154951	7527	2422	0	166711
13510	148436	6567	3288	2825	0	161116
13511	6068	152529	2736	2791	0	164124
13512	152058	6926	2574	2647	0	164205
13513	6760	3074	152694	2536	0	165064
13514	2974	2006	154610	2485	0	162075
13515	1971	151493	7850	2568	0	163882
13516	148992	6596	3281	2643	0	161512
13517	6467	151298	3032	2455	0	163252
13518	3234	6649	2768	150048	0	162699
13519	152388	2775	2660	6525	0	164348
13520	6695	2436	152494	2688	0	164313
13521	2824	2146	7590	151902	0	164462
13522	150110	2005	3288	7237	0	162640
13523	6729	151082	2858	3246	0	163915
13524	3181	6490	2523	150110	0	162304
13525	2213	2486	150380	7378	0	162457
13526	147718	1911	7112	3415	0	160156
13527	6565	1830	3391	149993	0	161779
13528	2187	1696	149361	7233	0	160477
13529	2290	1687	7154	141698	0	152829
13530	1809	146789	3093	7163	0	158854
13531	1790	6078	147064	3499	0	158431
13532	2534	2139	6438	138693	0	149804
13533	132051	1529	2752	6272	0	142604
13534	6427	1398	2247	127219	0	137291
13535	115163	1182	1873	5501	0	123719
13536	5226	115297	1623	2340	0	124486
13537	111406	4787	1950	1725	0	119868
13538	4867	2044	109518	1681	0	118110
13539	2288	1453	96038	1216	0	100995
13540	1399	1213	84529	823	0	87964
13541	1244	80383	5352	1102	0	88081
13542	1893	948	4098	37825	0	44764
13543	285	293	560	36934	0	38072
13544	255	195	227	36255	0	36932
13545	205	178	175	37457	0	38015
13546	150	146	37352	822	0	38470
13547	33568	141	658	488	0	34855
13548	578	37380	291	268	0	38517
13549	36681	569	183	247	0	37680
13550	686	269	151	36648	0	37754
13551	270	37160	168	601	0	38199
13552	245	606	153	37533	0	38537
13553	37156	258	166	686	0	38266
13554	540	38884	151	316	0	39891
13555	38904	581	142	309	0	39936
13556	39077	247	156	238	0	39718
13557	712	223	118	39676	0	40729
13558	296	158	39870	593	0	40917
13559	38789	149	584	389	0	39911
13560	625	159	220	41911	0	42915
13561	42434	135	159	742	0	43470
13562	43345	123	154	351	0	43973
13563	43019	130	108	326	0	43583
13564	850	142	43094	166	0	44252
13565	414	172	583	41730	0	42899
13566	42202	124	264	721	0	43311
13567	707	125	44251	274	0	45357
13568	302	44694	572	200	0	45768
13569	448	638	269	40494	0	41849
13570	204	208	44939	508	0	45859
13571	188	171	44948	250	0	45557
13572	312	186	647	44223	0	45368
13573	250	68	312	46860	0	47490
13574	185	106	179	47282	0	47752
13575	209	85	125	46704	0	47123
13576	140	94	46813	684	0	47731
13577	145	46707	529	345	0	47726
13578	227	473	198	47840	0	48738
13579	48616	152	149	683	0	49600
13580	47337	115	128	373	0	47953
13581	48110	79	86	328	0	48603
13582	704	83	126	47926	0	48839
13583	369	152	108	47327	0	47956
13584	182	44844	111	570	0	45707
13585	144	47352	112	258	0	47866
13586	306	530	121	46898	0	47855
13587	46596	205	143	675	0	47619
13588	46102	93	86	332	0	46613
13589	45657	43	70	304	0	46074
13590	45589	51	73	261	0	45974
13591	45937	83	65	255	0	46340
13592	447	46263	86	153	0	46949
13593	241	330	64	47404	0	48039
13594	48682	107	61	595	0	49445
13595	49213	66	67	310	0	49656
13596	533	83	53	48768	0	49437
13597	289	50	61	49442	0	49842
13598	195	112	50746	448	0	51501
13599	279	64	329	48363	0	49035
13600	239	58	108	50119	0	50524
13601	170	90	54269	459	0	54988
13602	264	93	271	53049	0	53677
13603	125	54771	112	419	0	55427
13604	172	342	54535	187	0	55236
13605	120	55126	323	171	0	55740
13606	253	308	114	53299	0	53974
13607	171	98	90	55112	0	55471
13608	122	54636	84	375	0	55217
13609	83	55725	74	213	0	56095
13610	56500	300	99	316	0	57215
13611	55651	114	58	324	0	56147
13612	384	107	55136	127	0	55754
13613	54821	39	267	450	0	55577
13614	59715	45	112	420	0	60292
13615	59960	53	77	345	0	60435
13616	59267	42	190	330	0	59829
13617	457	81	57745	155	0	58438
13618	276	98	53151	169	0	53694
13619	58387	65	305	366	0	59123
13620	378	62413	128	178	0	63097
13621	225	262	63387	92	0	63966
13622	62586	77	290	307	0	63260
13623	63713	61	129	291	0	64194
13624	400	78	63275	117	0	63870
13625	61426	45	355	283	0	62109
13626	500	60	175	69965	0	70700
13627	185	131	71577	394	0	72287
13628	64145	50	388	579	0	65162
13629	383	71602	186	202	0	72373
13630	73650	321	129	468	0	74568
13631	83615	85	133	885	0	84718
13632	589	96	94	84573	0	85352
13633	339	58	95	84242	0	84734
13634	257	65	62	87063	0	87447
13635	87056	41	65	900	0	88062
13636	91351	81	61	616	0	92109
13637	735	48	70	92115	0	92968
13638	430	53	38	91350	0	91871
13639	249	134	90212	727	0	91322
13640	83840	86	499	658	0	85083
13641	672	83	165	91783	0	92703
13642	406	62	69	91261	0	91798
13643	215	90353	84	798	0	91450
13644	326	535	35	91774	0	92670
13645	306	223	42	91482	0	92053
13646	90177	87	41	1089	0	91394
13647	676	91511	56	416	0	92659
13648	464	565	42	93229	0	94300
13649	440	209	32	92564	0	93245
13650	399	124	29	93779	0	94331
13651	209	200	93462	937	0	94808
13652	349	83	561	90923	0	91916
13653	90670	69	243	1211	0	92193
13654	758	105	91523	463	0	92849
13655	511	53	623	92263	0	93450
13656	331	58	258	95023	0	95670
13657	94783	51	181	1434	0	96449
13658	91727	88	159	1002	0	92976
13659	944	145	93474	406	0	94969
13660	83199	90	637	880	0	84806
13661	862	174	91379	237	0	92652
13662	87793	87	677	699	0	89256
13663	912	98290	282	348	0	99832
13664	100565	823	142	688	0	102218
13665	1040	101429	147	352	0	102968
13666	103585	1010	118	706	0	105419
13667	1083	104988	152	310	0	106533
13668	623	1112	139	107607	0	109481
13669	511	345	122	107488	0	108466
13670	458	198	106	107381	0	108143
13671	220	105031	134	1497	0	106882
13672	427	1033	114	105308	0	106882
13673	261	106382	137	1281	0	108061
13674	365	1186	113	107973	0	109637
13675	107701	370	107	1740	0	109918
13676	105696	266	104	987	0	107053
13677	1453	106331	141	460	0	108385
13678	817	1199	96	106997	0	109109
13679	105495	448	99	1639	0	107681
13680	1302	106007	142	532	0	107983
13681	568	107276	130	501	0	108475
13682	107110	1517	70	723	0	109420
13683	107559	634	84	745	0	109022
13684	1551	107874	120	417	0	109962
13685	107206	1363	73	670	0	109312
13686	1760	602	60	107454	0	109876
13687	654	592	109674	1458	0	112378
13688	106620	338	1192	1249	0	109399
13689	109387	279	367	1000	0	111033
13690	1898	391	111404	400	0	114093
13691	109531	319	1311	1040	0	112201
13692	114289	294	402	983	0	115968
13693	119292	296	280	994	0	120862
13694	2104	118414	273	518	0	121309
13695	120399	1534	121	877	0	122931
13696	121861	654	175	796	0	123486
13697	2467	510	172	121250	0	124399
13698	1551	376	135	122990	0	125052
13699	1138	369	144	125942	0	127593
13700	125863	377	167	2683	0	129090
13701	2249	361	158	122817	0	125585
13702	124529	300	138	2645	0	127612
13703	126717	354	174	1558	0	128803
13704	2898	321	168	126371	0	129758
13705	1622	335	191	131480	0	133628
13706	1303	285	206	133938	0	135732
13707	132818	350	127	3291	0	136586
13708	2437	133048	174	1361	0	137020
13709	1506	2002	149	136708	0	140365
13710	1345	796	122	140109	0	142372
13711	137753	537	123	3537	0	141950
13712	137953	452	125	2170	0	140700
13713	3199	493	134576	1165	0	139433
13714	1642	499	132937	1045	0	136123
13715	142293	403	2670	1341	0	146707
13716	3681	382	886	146292	0	151241
13717	2184	387	473	165542	0	168586
13718	1334	592	164952	5244	0	172122
13719	1725	473	3872	158257	0	164327
13720	1055	160835	1150	4715	0	167755
13721	1120	169094	707	1874	0	172795
13722	162035	4837	454	1902	0	169228
13723	4679	1573	162169	1403	0	169824
13724	1810	167929	3612	1174	0	174525
13725	2054	4337	1021	170599	0	178011
13726	1423	1441	169200	4609	0	176673
13727	1803	1014	4385	162505	0	169707
13728	1788	786	1253	167931	0	171758
13729	1297	654	169157	5554	0	176662
13730	1155	169803	4395	2237	0	177590
13731	1625	4289	1296	161873	0	169083
13732	162236	1273	1099	5358	0	169966
13733	163254	908	836	2428	0	167426
13734	163251	810	542	2087	0	166690
13735	5752	160031	761	1476	0	168020
13736	157528	4216	622	1495	0	163861
13737	5611	1344	625	157366	0	164946
13738	2002	1075	155218	4832	0	163127
13739	150276	820	3913	2501	0	157510
13740	5029	157917	1301	1522	0	165769
13741	2250	4132	882	157655	0	164919
13742	1960	1311	758	158480	0	162509
13743	1365	156122	801	5438	0	163726
13744	1654	4637	666	161219	0	168176
13745	1782	1453	701	163813	0	167749
13746	1785	1139	637	167971	0	171532
13747	162026	1066	746	6694	0	170532
13748	161414	860	761	3453	0	166488
13749	5658	1226	162506	2237	0	171627
13750	2837	1128	4238	160812	0	169015
13751	2458	854	1343	168493	0	173148
13752	2029	874	1237	170162	0	174302
13753	165067	950	999	6768	0	173784
13754	5183	1090	161124	3031	0	170428
13755	155417	793	4417	3106	0	163733
13756	166404	718	1484	2783	0	171389
13757	6218	771	1068	164887	0	172944
13758	164328	671	1069	6206	0	172274
13759	5833	956	157012	2828	0	166629
13760	153498	762	3779	3292	0	161331
13761	5905	172918	1410	2226	0	182459
13762	2940	4405	169316	1728	0	178389
13763	2310	1589	173124	1851	0	178874
13764	2606	1682	5211	168159	0	177658
13765	1843	1037	173141	5470	0	181491
13766	162287	853	4928	3257	0	171325
13767	5061	167719	1875	2218	0	176873
13768	167400	4309	1375	2499	0	175583
13769	5729	1540	1145	168713	0	177127
13770	2374	1206	168586	5555	0	177721
13771	1856	1046	167427	2969	0	173298
13772	2177	1098	5065	168311	0	176651
13773	169762	824	1996	6285	0	178867
13774	5041	166446	1503	3054	0	176044
13775	2135	174966	1211	2872	0	181184
13776	171277	5706	1452	2813	0	181248
13777	5342	175100	1392	2213	0	184047
13778	175731	4894	1208	2343	0	184176
13779	6000	2009	1294	174833	0	184136
13780	175323	1191	1120	5634	0	183268
13781	5960	1218	1287	175189	0	183654
13782	176017	1003	1141	6050	0	184211
13783	5944	821	1266	174326	0	182357
13784	2662	173536	1641	5377	0	183216
13785	173440	4198	1224	3151	0	182013
13786	5245	173624	1138	2699	0	182706
13787	2633	4620	167563	1892	0	176708
13788	2751	2039	4476	158186	0	167452
13789	1919	171205	1745	4440	0	179309
13790	162988	4675	1264	2407	0	171334
13791	164778	1971	1189	2230	0	170168
13792	5942	164067	1362	1573	0	172944
13793	2472	4746	161219	1695	0	170132
13794	2671	1682	4431	153462	0	162246
13795	1923	153400	1905	4754	0	161982
13796	2147	4456	1466	160749	0	168818
13797	2532	1590	1215	162947	0	168284
13798	157319	1718	892	6038	0	165967
13799	5152	156715	1068	2678	0	165613
13800	2517	4307	988	157836	0	165648
13801	156857	1853	937	5648	0	165295
13802	156640	1393	794	3041	0	161868
13803	155293	1413	826	2541	0	160073
13804	6595	1387	856	151391	0	160229
13805	146675	1008	756	4881	0	153320
13806	5261	145942	930	1929	0	154062
13807	143867	3823	981	2193	0	150864
13808	4681	144400	835	2007	0	151923
13809	142974	4008	685	2177	0	149844
13810	142550	1451	568	2324	0	146893
13811	5835	1825	691	139128	0	147479
13812	2651	1006	141231	4021	0	148909
13813	2318	1171	135901	1756	0	141146
13814	1966	138869	3318	1373	0	145526
13815	132490	3343	1639	1920	0	139392
13816	4086	1329	131604	775	0	137794
13817	100883	580	1250	1002	0	103715
13818	1713	107123	446	468	0	109750
13819	982	111512	362	385	0	113241
13820	1043	1752	285	116957	0	120037
13821	735	121806	288	1447	0	124276
13822	681	2271	124951	694	0	128597
13823	1364	1051	1996	117755	0	122166
13824	714	126433	697	2028	0	129872
13825	881	2528	469	127046	0	130924
13826	125868	928	355	3207	0	130358
13827	2875	878	371	126477	0	130601
13828	1075	743	127949	2886	0	132653
13829	890	127913	2523	1211	0	132537
13830	1100	3171	1012	125627	0	130910
13831	1036	1100	739	128250	0	131125
13832	1046	946	535	130876	0	133403
13833	126478	805	437	4469	0	132189
13834	125014	575	456	2445	0	128490
13835	3635	754	125872	1240	0	131501
13836	1705	715	123732	1013	0	127165
13837	1082	126477	3275	1087	0	131921
13838	127918	2918	1286	1418	0	133540
13839	3603	1144	885	127891	0	133523
13840	1842	919	620	128966	0	132347
13841	1565	693	468	130162	0	132888
13842	1464	618	396	130807	0	133285
13843	1049	756	124825	4444	0	131074
13844	119190	567	2805	2608	0	125170
13845	3960	512	991	140297	0	145760
13846	1690	562	139872	4326	0	146450
13847	138697	567	3858	2521	0	145643
13848	153471	459	1428	2034	0	157392
13849	5876	630	168001	1123	0	175630
13850	3059	546	175075	1005	0	179685
13851	2765	583	6469	169447	0	179264
13852	173076	533	2574	6263	0	182446
13853	177864	424	1686	2712	0	182686
13854	7887	469	1273	169684	0	179313
13855	3873	446	1303	176222	0	181844
13856	2079	518	174212	7153	0	183962
13857	2562	839	5923	169289	0	178613
13858	1810	465	171985	7069	0	181329
13859	161237	449	6253	3693	0	171632
13860	6046	171705	2721	2467	0	182939
13861	162265	4850	1471	2336	0	170922
13862	6220	162578	1413	1523	0	171734
13863	160782	5675	1396	1644	0	169497
13864	7358	2013	1052	155347	0	165770
13865	3807	1250	964	160047	0	166068
13866	158838	1068	749	7495	0	168150
13867	162026	850	652	3464	0	166992
13868	163788	720	689	2646	0	167843
13869	165691	743	680	2064	0	169178
13870	8938	653	158432	1594	0	169617
13871	157302	531	5385	2179	0	165397
13872	164610	547	1940	1949	0	169046
13873	165332	441	1457	1560	0	168790
13874	10068	468	1100	157638	0	169274
13875	153333	475	961	6710	0	161479
13876	8204	152278	1273	2626	0	164381
13877	5118	5143	1118	153077	0	164456
13878	4414	1741	965	158237	0	165357
13879	3340	1282	153096	7809	0	165527
13880	3588	887	5791	147017	0	157283
13881	2677	152563	2474	7533	0	165247
13882	151441	5517	1778	4239	0	162975
13883	7173	153859	1673	3208	0	165913
13884	155264	6215	1382	3340	0	166201
13885	8638	2582	1381	153962	0	166563
13886	152238	1761	1276	7770	0	163045
13887	7902	151012	1290	3840	0	164044
13888	153481	6166	1162	3352	0	164161
13889	157079	2715	1195	2814	0	163803
13890	10039	2060	1110	151123	0	164332
13891	5692	1695	960	156516	0	164863
13892	4420	1429	150820	8541	0	165210
13893	4426	1453	5599	152528	0	164006
13894	4089	1358	2208	156147	0	163802
13895	3685	1000	151585	9192	0	165462
13896	3774	950	6172	153804	0	164700
13897	3207	905	151545	8794	0	164451
13898	149890	808	6925	4827	0	162450
13899	8495	770	3135	151550	0	163950
13900	4747	900	148340	8070	0	162057
13901	148713	885	6660	4319	0	160577
13902	8976	848	2934	150408	0	163166
13903	4727	919	150931	8096	0	164673
13904	151584	739	6707	4703	0	163733
13905	8713	876	2873	153749	0	166211
13906	4892	774	2441	158280	0	166387
13907	156856	903	1908	9650	0	169317
13908	8869	869	1626	156835	0	168199
13909	4977	803	1782	160391	0	167953
13910	4498	1084	1717	152445	0	159744
13911	3832	151686	1523	9735	0	166776
13912	149345	5780	1301	5991	0	162417
13913	153483	2300	1368	4447	0	161598
13914	10039	1786	1183	148946	0	161954
13915	150458	1383	1153	8683	0	161677
13916	152044	1109	1135	5286	0	159574
13917	153614	1289	1150	4229	0	160282
13918	114967	1918	1778	5310	0	123973
13919	149428	957	1458	3863	0	155706
13920	10251	805	129888	3378	0	144322
13921	5467	944	125575	3225	0	135211
13922	124239	672	5921	3017	0	133849
13923	7794	122149	2943	3033	0	135919
13924	4249	4306	2171	119822	0	130548
13925	3486	1689	119461	6240	0	130876
13926	3305	1196	120713	3308	0	128522
13927	3299	1982	6219	116954	0	128454
13928	116726	1156	4101	6583	0	128566
13929	6640	922	1975	116640	0	126177
13930	3450	1009	115714	6341	0	126514
13931	119656	594	4916	4075	0	129241
13932	6556	613	2478	121372	0	131019
13933	3898	474	1876	124552	0	130800
13934	3470	356	1558	126623	0	132007
13935	3412	411	1270	125529	0	130622
13936	2897	491	119515	7927	0	130830
13937	3081	427	4551	121103	0	129162
13938	120380	465	2031	7086	0	129962
13939	5875	511	115326	4506	0	126218
13940	116059	555	4337	4008	0	124959
13941	122503	508	1836	3455	0	128302
13942	121823	606	1568	3183	0	127180
13943	120129	496	1455	2961	0	125041
13944	7587	113900	1240	2790	0	125517
13945	3482	98333	861	1816	0	104492
13946	2904	101150	1038	1687	0	106779
13947	94818	4192	2697	2227	0	103934
13948	4475	1036	87678	1516	0	94705
13949	65769	869	2276	843	0	69757
13950	2332	240	698	63780	0	67050
13951	63826	181	389	1717	0	66113
13952	1671	162	327	63559	0	65719
13953	63321	151	307	1786	0	65565
13954	1842	116	279	62886	0	65123
13955	1136	84	224	64076	0	65520
13956	58444	103	271	1895	0	60713
13957	1604	68196	254	956	0	71010
13958	934	973	68235	655	0	70797
13959	861	66969	994	559	0	69383
13960	550	835	64584	378	0	66347
13961	634	661	927	60528	0	62750
13962	62762	189	598	875	0	64424
13963	859	120	216	61969	0	63164
13964	61358	105	149	962	0	62574
13965	858	65459	167	445	0	66929
13966	566	576	66689	331	0	68162
13967	447	65694	587	291	0	67019
13968	351	66646	303	313	0	67613
13969	63528	509	299	366	0	64702
13970	61402	200	146	326	0	62074
13971	609	62448	140	186	0	63383
13972	361	443	106	63141	0	64051
13973	266	210	100	63463	0	64039
13974	63068	118	135	826	0	64147
13975	580	139	64020	326	0	65065
13976	308	134	61456	269	0	62167
13977	368	104	566	62785	0	63823
13978	234	151	64389	616	0	65390
13979	58565	114	591	571	0	59841
13980	63019	82	238	454	0	63793
13981	705	63796	207	194	0	64902
13982	426	516	64958	160	0	66060
13983	415	212	581	63866	0	65074
13984	277	170	67470	588	0	68505
13985	387	122	614	66183	0	67306
13986	67182	119	268	857	0	68426
13987	714	69277	205	346	0	70542
13988	406	667	72181	242	0	73496
13989	273	71860	709	249	0	73091
13990	253	75270	360	278	0	76161
13991	75149	745	258	497	0	76649
13992	72312	287	186	493	0	73278
13993	980	195	74503	464	0	76142
13994	457	76189	745	336	0	77727
13995	412	764	326	76965	0	78467
13996	369	297	218	77020	0	77904
13997	416	208	184	76023	0	76831
13998	325	199	77741	1016	0	79281
13999	497	144	736	75566	0	76943
14000	438	188	354	79129	0	80109
14001	79496	165	253	1220	0	81134
14002	78900	199	192	783	0	80074
14003	78491	178	176	619	0	79464
14004	77012	148	169	591	0	77920
14005	76710	139	173	515	0	77537
14006	1052	76428	227	267	0	77974
14007	73675	674	123	403	0	74875
14008	908	321	73812	204	0	75245
14009	643	317	613	72486	0	74059
14010	74381	137	243	850	0	75611
14011	799	74047	207	315	0	75368
14012	75029	623	134	488	0	76274
14013	76139	272	106	522	0	77039
14014	968	197	113	76253	0	77531
14015	598	164	147	76964	0	77873
14016	329	80961	201	920	0	82411
14017	439	729	133	82924	0	84225
14018	353	410	85766	887	0	87416
14019	510	230	811	85576	0	87127
14020	323	178	86549	978	0	88028
14021	80226	139	944	808	0	82117
14022	1140	132	393	87363	0	89028
14023	534	192	88419	994	0	90139
14024	322	84458	981	579	0	86340
14025	222	87755	466	328	0	88771
14026	86192	1051	316	495	0	88054
14027	1128	438	227	86293	0	88086
14028	475	256	89938	850	0	91519
14029	270	87188	817	501	0	88776
14030	229	903	88090	260	0	89482
14031	82149	385	953	556	0	84043
14032	84251	225	389	484	0	85349
14033	85201	143	270	409	0	86023
14034	1311	144	168	85366	0	86989
14035	524	192	85295	880	0	86891
14036	306	84437	895	432	0	86070
14037	406	809	437	85876	0	87528
14038	288	389	84660	881	0	86218
14039	343	263	80297	423	0	81326
14040	438	160	1148	83714	0	85460
14041	85765	143	543	1210	0	87661
14042	1018	167	365	85478	0	87028
14043	622	180	257	86747	0	87806
14044	334	192	87323	1238	0	89087
14045	502	127	997	85348	0	86974
14046	400	142	489	86394	0	87425
14047	230	180	87450	1282	0	89142
14048	306	189	84478	617	0	85590
14049	446	143	1188	85939	0	87716
14050	279	161	88559	1084	0	90083
14051	420	126	1130	87317	0	88993
14052	87804	113	553	1515	0	89985
14053	893	90168	443	708	0	92212
14054	592	871	328	91750	0	93541
14055	330	408	90733	1103	0	92574
14056	77457	201	1092	1326	0	80076
14057	955	83272	614	503	0	85344
14058	84284	905	372	691	0	86252
14059	1218	423	278	84441	0	86360
14060	691	271	325	84226	0	85513
14061	85852	163	323	1848	0	88186
14062	1096	199	86912	764	0	88971
14063	83555	153	1134	796	0	85638
14064	1314	166	552	88311	0	90343
14065	85647	139	406	1510	0	87702
14066	85374	153	373	951	0	86851
14067	1739	178	320	84466	0	86703
14068	795	87828	315	1382	0	90320
14069	89975	1179	334	954	0	92442
14070	90287	453	282	851	0	91873
14071	1930	352	90772	443	0	93497
14072	88454	227	1420	658	0	90759
14073	1976	235	649	89409	0	92269
14074	954	91397	492	1446	0	94289
14075	1055	1442	339	87512	0	90348
14076	608	91328	372	1431	0	93739
14077	91115	1499	298	1026	0	93938
14078	93274	608	355	803	0	95040
14079	2338	437	258	98650	0	101683
14080	1041	343	97180	1954	0	100518
14081	764	332	96397	956	0	98449
14082	773	264	2251	101087	0	104375
14083	101699	216	1141	2446	0	105502
14084	109021	213	622	1459	0	111315
14085	3000	110652	519	838	0	115009
14086	1706	2302	400	110383	0	114791
14087	947	967	112418	2631	0	116963
14088	715	661	113889	1317	0	116582
14089	1030	710	3787	118786	0	124313
14090	124974	309	1899	4142	0	131324
14091	4212	203	925	126741	0	132081
14092	1690	294	125216	4479	0	131679
14093	123754	265	3978	2375	0	130372
14094	4464	240	1759	124653	0	131116
14095	2150	248	1238	127379	0	131015
14096	1723	259	828	124473	0	127283
14097	971	124051	682	5621	0	131325
14098	915	3516	124234	2687	0	131352
14099	741	1455	127564	1802	0	131562
14100	1120	810	5169	126601	0	133700
14101	771	565	128780	4453	0	134569
14102	124075	347	4925	2570	0	131917
14103	4559	349	2054	126538	0	133500
14104	2351	422	1354	127747	0	131874
14105	1754	395	1102	126334	0	129585
14106	952	126698	1201	5847	0	134698
14107	128376	3763	972	3307	0	136418
14108	4635	1439	841	128671	0	135586
14109	126914	922	756	5555	0	134147
14110	4848	127835	738	2668	0	136089
14111	127714	4122	751	2222	0	134809
14112	124195	1666	772	2173	0	128806
14113	128052	1031	739	1979	0	131801
14114	6170	123207	713	1531	0	131621
14115	3052	123642	690	1269	0	128653
14116	118935	4746	550	1552	0	125783
14117	4761	121119	628	1316	0	127824
14118	2322	4615	116281	1122	0	124340
14119	1784	111194	3648	1132	0	117758
14120	1498	118502	1611	964	0	122575
14121	115253	4820	1118	1157	0	122348
14122	4379	2297	113722	935	0	121333
14123	2243	1681	113504	818	0	118246
14124	2075	1295	4716	110239	0	118325
14125	113226	936	2278	4224	0	120664
14126	4536	841	113901	1849	0	121127
14127	2547	901	4111	112752	0	120311
14128	1663	1023	109338	4280	0	116304
14129	1468	1013	108532	2061	0	113074
14130	104605	778	5075	1869	0	112327
14131	4465	869	110676	1091	0	117101
14132	2506	812	4872	106714	0	114904
14133	2026	925	2346	106354	0	111651
14134	1466	106111	1786	4873	0	114236
14135	1436	111447	1500	2561	0	116944
14136	1567	4609	1437	107184	0	114797
14137	1121	2232	109153	4621	0	117127
14138	1505	1549	4289	108114	0	115457
14139	1394	1092	2257	112036	0	116779
14140	1157	840	112171	5839	0	120007
14141	1229	745	4655	113067	0	119696
14142	112749	775	2496	5905	0	121925
14143	4360	925	113551	3015	0	121851
14144	111946	789	4846	2690	0	120271
14145	5274	691	2793	112948	0	121706
14146	2883	653	1973	115417	0	120926
14147	1915	116129	1759	6255	0	126058
14148	1849	4307	1599	116620	0	124375
14149	1592	1924	1506	123124	0	128146
14150	118996	1355	1651	7106	0	129108
14151	5088	989	1611	120947	0	128635
14152	2758	963	1332	124050	0	129103
14153	116963	1041	1333	7729	0	127066
14154	5273	1054	1591	119217	0	127135
14155	2967	1054	1547	113379	0	118947
14156	2080	116476	1559	7071	0	127186
14157	117266	4216	1523	4512	0	127517
14158	5413	1882	1200	119078	0	127573
14159	2986	1498	1070	122329	0	127883
14160	2457	1247	116763	7276	0	127743
14161	2109	1086	4440	116634	0	124269
14162	1830	911	2289	121116	0	126146
14163	113978	1017	1510	7715	0	124220
14164	115837	1105	1262	4498	0	122702
14165	6336	1048	1105	114756	0	123245
14166	3219	1052	109421	6043	0	119735
14167	2389	104176	4213	3417	0	114195
14168	1837	109320	2283	2905	0	116345
14169	2333	5030	1917	107747	0	117027
14170	107210	2366	1281	5678	0	116535
14171	5010	1613	885	109048	0	116556
14172	109006	1217	663	6241	0	117127
14173	5285	1164	859	110826	0	118134
14174	2939	1016	1082	112400	0	117437
14175	107392	1123	896	6778	0	116189
14176	106844	1253	842	3875	0	112814
14177	6152	105496	834	2715	0	115197
14178	3350	110199	784	2264	0	116597
14179	2213	4435	814	99256	0	106718
14180	1808	2207	797	102727	0	107539
14181	1524	1428	97792	5144	0	105888
14182	87177	964	3355	3435	0	94931
14183	4094	93442	1540	2221	0	101297
14184	1436	87729	899	1577	0	91641
14185	83224	3093	942	1391	0	88650
14186	3285	1251	83525	1066	0	89127
14187	1545	887	79740	1129	0	83301
14188	1179	646	73002	936	0	75763
14189	666	68900	1799	510	0	71875
14190	595	1120	895	63567	0	66177
14191	336	469	308	63931	0	65044
14192	383	344	209	64817	0	65753
14193	62335	195	235	1751	0	64516
14194	61658	159	262	1001	0	63080
14195	1265	62321	299	520	0	64405
14196	649	1060	217	63137	0	65063
14197	456	518	63542	1189	0	65705
14198	309	63861	987	650	0	65807
14199	61226	1000	395	857	0	63478
14200	1125	421	62593	435	0	64574
14201	54798	300	982	819	0	56899
14202	1110	290	61973	417	0	63790
14203	568	375	980	59549	0	61472
14204	372	62057	375	1114	0	63918
14205	62264	947	287	846	0	64344
14206	1065	64045	198	568	0	65876
14207	62951	1054	222	651	0	64878
14208	1300	409	191	62762	0	64662
14209	586	408	64464	1193	0	66651
14210	618	229	979	66392	0	68218
14211	509	281	349	72295	0	73434
14212	438	325	71437	1839	0	74039
14213	65919	241	1445	1229	0	68834
14214	1633	72851	529	649	0	75662
14215	72149	1487	325	809	0	74770
14216	1703	74433	305	585	0	77026
14217	851	1702	222	78838	0	81613
14218	528	622	77904	2098	0	81152
14219	90169	387	1888	1147	0	93591
14220	2837	96364	572	658	0	100431
14221	1472	2848	312	94301	0	98933
14222	1153	903	308	99808	0	102172
14223	102718	719	216	3875	0	107528
14224	107101	417	271	1909	0	109698
14225	3958	108969	352	1027	0	114306
14226	112167	3470	296	918	0	116851
14227	113671	1180	244	972	0	116067
14228	114453	822	211	1010	0	116496
14229	5346	738	111819	643	0	118546
14230	2380	107434	3335	731	0	113880
14231	1402	115768	1212	663	0	119045
14232	1779	4412	706	106097	0	112994
14233	1632	1836	399	112507	0	116374
14234	111901	1132	323	4740	0	118096
14235	4094	111727	461	1927	0	118209
14236	112586	3924	341	1444	0	118295
14237	4966	1708	366	110007	0	117047
14238	2312	1177	311	113939	0	117739
14239	110479	817	317	5268	0	116881
14240	109963	667	321	2490	0	113441
14241	5255	803	105820	1404	0	113282
14242	2999	896	3365	104137	0	111397
14243	1652	598	103418	3896	0	109564
14244	1167	692	102453	1828	0	106140
14245	1197	639	104362	1188	0	107386
14246	99078	629	4748	1102	0	105557
14247	4239	463	1936	97783	0	104421
14248	2283	462	1055	98724	0	102524
14249	1745	499	796	101888	0	104928
14250	1059	499	99587	4932	0	106077
14251	1433	390	3660	98600	0	104083
14252	1579	442	1498	102546	0	106065
14253	99659	443	944	5118	0	106164
14254	101450	483	738	2605	0	105276
14255	103139	400	620	1889	0	106048
14256	103398	520	685	1544	0	106147
14257	6008	572	655	98933	0	106168
14258	100247	576	625	4614	0	106062
14259	5419	646	542	99311	0	105918
14260	2860	654	92022	4645	0	100181
14261	95572	614	2966	2566	0	101718
14262	5033	96301	1242	1698	0	104274
14263	3054	3562	844	94693	0	102153
14264	2703	1697	666	95140	0	100206
14265	1950	96706	615	4930	0	104201
14266	96017	3798	674	2825	0	103314
14267	4917	95494	612	1896	0	102919
14268	2710	4113	93993	1464	0	102280
14269	2098	1748	95459	1534	0	100839
14270	92770	1164	4472	1768	0	100174
14271	96954	1098	2022	1677	0	101751
14272	5542	842	93669	1393	0	101446
14273	92701	876	3910	1651	0	99138
14274	5245	788	93228	1474	0	100735
14275	92565	760	4350	1660	0	99335
14276	5400	822	92890	1599	0	100711
14277	3095	705	95147	1669	0	100616
14278	2673	733	5036	85865	0	94307
14279	2586	737	2583	90090	0	95996
14280	92550	677	1836	5486	0	100549
14281	91671	669	1463	3152	0	96955
14282	93556	640	1438	2239	0	97873
14283	95719	616	1353	2057	0	99745
14284	6505	90524	1304	1901	0	100234
14285	4087	3408	1163	88369	0	97027
14286	3083	91450	1347	4368	0	100248
14287	3023	3836	1243	92672	0	100774
14288	2792	1699	1250	93458	0	99199
14289	2923	1261	1063	94025	0	99272
14290	2458	1234	88545	6051	0	98288
14291	85520	888	3845	3901	0	94154
14292	5136	83738	1845	2874	0	93593
14293	3178	89422	1420	2567	0	96587
14294	2798	4485	88745	2265	0	98293
14295	2744	2006	3897	88649	0	97296
14296	2510	1307	2306	90643	0	96766
14297	89263	913	1703	5906	0	97785
14298	5444	1003	1490	88582	0	96519
14299	3394	1047	1425	90842	0	96708
14300	2795	853	1655	91764	0	97067
14301	2480	853	1583	93310	0	98226
14302	88390	707	1694	6482	0	97273
14303	90720	696	1783	3513	0	96712
14304	91974	596	1733	2823	0	97126
14305	6487	624	1620	90313	0	99044
14306	90599	572	1430	5488	0	98089
14307	5889	524	1316	91579	0	99308
14308	3852	592	1472	94484	0	100400
14309	3187	454	88018	6152	0	97811
14310	2723	481	84412	3468	0	91084
14311	2521	450	82619	2456	0	88046
14312	80899	473	4902	2111	0	88385
14313	5079	643	2607	74978	0	83307
14314	3026	78354	1717	4160	0	87257
14315	81035	2756	1428	2635	0	87854
14316	4726	1189	77284	2318	0	85517
14317	71725	793	3284	1826	0	77628
14318	4427	68475	1918	1594	0	76414
14319	53491	1366	769	847	0	56473
14320	2626	826	562	52849	0	56863
14321	52666	443	509	1949	0	55567
14322	2326	49573	539	1277	0	53715
14323	1421	49237	556	892	0	52106
14324	43796	1332	528	652	0	46308
14325	1385	44913	423	576	0	47297
14326	686	40202	227	316	0	41431
14327	605	41584	365	337	0	42891
14328	40284	1107	826	373	0	42590
14329	39395	536	156	246	0	40333
14330	39784	392	108	227	0	40511
14331	1177	289	113	38733	0	40312
14332	653	293	105	39429	0	40480
14333	471	297	38806	847	0	40421
14334	463	241	628	38701	0	40033
14335	433	205	39806	824	0	41268
14336	499	184	684	39739	0	41106
14337	450	166	321	40942	0	41879
14338	40384	167	229	1129	0	41909
14339	39999	172	187	689	0	41047
14340	933	40127	221	456	0	41737
14341	580	712	185	40334	0	41811
14342	403	429	41657	802	0	43291
14343	450	303	624	41562	0	42939
14344	451	212	339	42241	0	43243
14345	459	195	221	43089	0	43964
14346	391	191	42147	1127	0	43856
14347	344	173	39286	685	0	40488
14348	40654	115	860	617	0	42246
14349	730	129	483	42780	0	44122
14350	422	111	42117	975	0	43625
14351	39043	92	729	802	0	40666
14352	682	42198	437	578	0	43895
14353	42647	523	394	511	0	44075
14354	896	327	44121	350	0	45694
14355	42923	231	655	487	0	44296
14356	891	198	389	44669	0	46147
14357	564	210	46082	691	0	47547
14358	416	45623	614	538	0	47191
14359	46614	607	415	500	0	48136
14360	773	360	349	46727	0	48209
14361	541	240	297	46912	0	47990
14362	400	47841	276	841	0	49358
14363	406	536	236	48471	0	49649
14364	320	379	48025	791	0	49515
14365	284	47640	622	536	0	49082
14366	48165	557	360	496	0	49578
14367	704	397	265	48104	0	49470
14368	527	299	209	47863	0	48898
14369	411	298	47401	826	0	48936
14370	414	281	540	47201	0	48436
14371	381	270	50034	758	0	51443
14372	313	50125	665	511	0	51614
14373	49990	564	380	558	0	51492
14374	49721	345	281	503	0	50850
14375	49714	228	253	522	0	50717
14376	814	52846	263	387	0	54310
14377	582	610	216	53099	0	54507
14378	406	337	238	53252	0	54233
14379	586	381	360	43947	0	45274
14380	52747	222	184	1040	0	54193
14381	52433	210	170	721	0	53534
14382	949	198	152	52769	0	54068
14383	584	241	57619	809	0	59253
14384	524	176	538	57250	0	58488
14385	377	163	324	58259	0	59123
14386	360	126	284	58310	0	59080
14387	413	149	221	58750	0	59533
14388	59137	149	204	1291	0	60781
14389	809	144	185	60389	0	61527
14390	536	159	203	60357	0	61255
14391	374	59940	188	1149	0	61651
14392	404	609	127	61813	0	62953
14393	310	62918	131	1138	0	64497
14394	353	837	116	63714	0	65020
14395	63008	361	126	1347	0	64842
14396	873	63453	143	784	0	65253
14397	62137	835	112	819	0	63903
14398	1078	458	63343	481	0	65360
14399	659	286	781	62963	0	64689
14400	384	271	65172	1151	0	66978
14401	400	175	928	64649	0	66152
14402	406	248	430	64705	0	65789
14403	321	63316	304	1355	0	65296
14404	322	64736	214	784	0	66056
14405	205	64998	165	481	0	65849
14406	64025	734	168	576	0	65503
14407	626	62241	147	330	0	63344
14408	224	62606	96	280	0	63206
14409	566	693	114	62937	0	64310
14410	62913	241	57	891	0	64102
14411	542	66166	60	318	0	67086
14412	67076	641	79	470	0	68266
14413	66702	219	58	430	0	67409
14414	742	216	69789	167	0	70914
14415	450	192	553	67356	0	68551
14416	252	135	180	71195	0	71762
14417	214	135	106	71754	0	72209
14418	256	151	102	70444	0	70953
14419	166	207	68264	777	0	69414
14420	215	176	59636	331	0	60358
14421	61600	122	584	471	0	62777
14422	553	66467	166	189	0	67375
14423	171	67461	127	185	0	67944
14424	67513	605	63	380	0	68561
14425	548	65874	79	191	0	66692
14426	266	608	77	66170	0	67121
14427	65809	218	94	805	0	66926
14428	634	197	65005	269	0	66105
14429	337	139	543	65551	0	66570
14430	173	180	65839	668	0	66860
14431	62134	145	591	537	0	63407
14432	661	189	72667	232	0	73749
14433	73095	133	666	614	0	74508
14434	77910	132	238	529	0	78809
14435	77734	119	145	450	0	78448
14436	77961	153	122	409	0	78645
14437	78262	128	110	363	0	78863
14438	991	127	127	78130	0	79375
14439	80794	126	120	1052	0	82092
14440	831	130	121	81042	0	82124
14441	484	115	109	80850	0	81558
14442	360	128	112	81985	0	82585
14443	265	191	81626	891	0	82973
14444	394	121	647	79154	0	80316
14445	331	135	223	83378	0	84067
14446	254	187	81456	858	0	82755
14447	72169	134	691	853	0	73847
14448	836	120	213	83135	0	84304
14449	353	146	83428	797	0	84724
14450	314	143	80202	350	0	81009
14451	361	109	806	80921	0	82197
14452	248	216	83491	856	0	84811
14453	347	156	753	83057	0	84313
14454	372	98	291	82517	0	83278
14455	191	82246	213	924	0	83574
14456	185	84015	181	451	0	84832
14457	84303	715	177	609	0	85804
14458	806	244	141	85279	0	86470
14459	386	153	169	83442	0	84150
14460	313	129	155	86381	0	86978
14461	268	174	86479	976	0	87897
14462	335	129	720	83887	0	85071
14463	84522	150	303	1186	0	86161
14464	861	216	87111	421	0	88609
14465	496	107	767	89343	0	90713
14466	393	108	291	90099	0	90891
14467	343	96	198	91938	0	92575
14468	190	97136	263	1085	0	98674
14469	96877	1111	155	844	0	98987
14470	101655	349	180	686	0	102870
14471	1797	103099	192	357	0	105445
14472	816	1427	138	107847	0	110228
14473	383	454	108455	1723	0	111015
14474	397	296	103851	694	0	105238
14475	107874	195	2146	748	0	110963
14476	2326	126	739	111418	0	114609
14477	115133	132	493	2372	0	118130
14478	2453	115945	366	921	0	119685
14479	948	119738	313	632	0	121631
14480	117755	2836	276	998	0	121865
14481	2477	122271	327	478	0	125553
14482	1404	2679	255	122256	0	126594
14483	1232	1018	245	116637	0	119132
14484	668	127386	247	2716	0	131017
14485	127946	2828	186	1536	0	132496
14486	2879	1287	129270	757	0	134193
14487	122405	760	2538	1029	0	126732
14488	3251	620	131072	456	0	135399
14489	118927	456	2893	1167	0	123443
14490	3353	477	131245	554	0	135629
14491	1478	128833	3083	530	0	133924
14492	1449	2827	1363	129385	0	135024
14493	128615	1065	806	3113	0	133599
14494	3073	657	127799	1013	0	132542
14495	1412	548	127494	612	0	130066
14496	1321	455	3512	123846	0	129134
14497	857	438	128144	2688	0	132127
14498	1060	428	3243	124198	0	128929
14499	1246	401	1513	121277	0	124437
14500	699	381	125957	3599	0	130636
14501	1097	245	3212	123180	0	127734
14502	126015	228	1603	3701	0	131547
14503	2755	124810	1200	1598	0	130363
14504	126434	2597	903	1397	0	131331
14505	3423	1065	795	125009	0	130292
14506	125546	601	722	3530	0	130399
14507	127430	471	754	1969	0	130624
14508	4320	484	748	123555	0	129107
14509	1851	126516	775	3008	0	132150
14510	128112	2652	677	1920	0	133361
14511	3467	1236	123788	1163	0	129654
14512	1775	759	122300	1081	0	125915
14513	120351	550	3598	1377	0	125876
14514	3674	426	1674	120750	0	126524
14515	1760	537	122165	3114	0	127576
14516	1598	527	3203	121091	0	126419
14517	121790	520	1499	3745	0	127554
14518	123362	488	1137	2106	0	127093
14519	122537	459	997	1626	0	125619
14520	4353	124289	875	1152	0	130669
14521	2690	2780	722	125001	0	131193
14522	1903	1259	696	127040	0	130898
14523	125707	812	694	4232	0	131445
14524	3574	125427	737	1946	0	131684
14525	126033	2843	668	1625	0	131169
14526	4218	1349	687	124892	0	131146
14527	124970	979	634	3644	0	130227
14528	3890	967	120893	1750	0	127500
14529	2257	121082	2939	1422	0	127700
14530	2267	2925	1407	114906	0	121505
14531	1713	124460	1035	2576	0	129784
14532	1735	3182	815	118418	0	124150
14533	116754	1528	715	3707	0	122704
14534	3688	1054	112593	1836	0	119171
14535	108443	864	3041	1752	0	114100
14536	3696	114982	1635	1270	0	121583
14537	2385	3036	1109	117058	0	123588
14538	1861	1494	943	120113	0	124411
14539	115639	1053	857	4468	0	122017
14540	3709	972	115115	2216	0	122012
14541	2405	798	3044	115604	0	121851
14542	1926	747	1601	116222	0	120496
14543	1762	806	1189	116310	0	120067
14544	1594	809	1024	117851	0	121278
14545	113613	739	912	5171	0	120435
14546	113461	648	908	2993	0	118010
14547	4423	692	111868	1967	0	118950
14548	2474	711	107503	1848	0	112536
14549	111181	652	3720	2100	0	117653
14550	116612	627	1726	2090	0	121055
14551	4637	594	1239	114723	0	121193
14552	2826	549	1118	115822	0	120315
14553	113239	526	1092	4584	0	119441
14554	3924	111877	1212	2416	0	119429
14555	2488	2530	1122	113143	0	119283
14556	2076	1032	1023	115923	0	120054
14557	1759	775	111939	4603	0	119076
14558	1890	618	3009	111566	0	117083
14559	1708	645	112472	4327	0	119152
14560	1794	586	3295	112268	0	117943
14561	110772	555	1767	4449	0	117543
14562	3864	541	1196	111699	0	117300
14563	2264	550	109875	4267	0	116956
14564	1742	104171	3118	2687	0	111718
14565	1844	2696	1593	107483	0	113616
14566	1548	1194	106676	3903	0	113321
14567	1563	106840	2946	2376	0	113725
14568	1805	2711	1301	103253	0	109070
14569	1319	1213	102368	3344	0	108244
14570	83127	726	2418	2644	0	88915
14571	2507	94976	1374	1670	0	100527
14572	1394	90670	907	1369	0	94340
14573	1038	93732	782	1189	0	96741
14574	1545	2941	732	88585	0	93803
14575	864	1126	92372	2405	0	96767
14576	786	91420	2121	1449	0	95776
14577	1229	3396	1078	88841	0	94544
14578	94614	864	623	2439	0	98540
14579	2620	617	396	123832	0	127465
14580	1330	554	138809	4309	0	145002
14581	833	139342	4339	1895	0	146409
14582	133354	4458	1487	1860	0	141159
14583	4509	138094	1098	1407	0	145108
14584	1673	5051	128999	1086	0	136809
14585	1031	130689	4625	1169	0	137514
14586	1896	5928	2112	123310	0	133246
14587	972	2912	126304	3990	0	134178
14588	1054	125533	4997	1453	0	133037
14589	2084	5917	1985	119212	0	129198
14590	1404	3266	1726	120392	0	126788
14591	391	124300	1993	5273	0	131957
14592	990	5950	1491	123244	0	131675
14593	365	2881	123486	6163	0	132895
14594	380	2238	126309	3103	0	132030
14595	918	2436	5591	124290	0	133235
14596	121750	1845	2343	7091	0	133029
14597	124598	1651	1934	4021	0	132204
14598	5437	1868	1851	120046	0	129202
14599	1981	122790	2129	6248	0	133148
14600	2211	4628	2408	123433	0	132680
14601	122224	1933	2059	6491	0	132707
14602	5998	1430	1232	122399	0	131059
14603	3812	1467	850	125788	0	131917
14604	121687	1494	750	7623	0	131554
14605	5341	120922	813	4539	0	131615
14606	2956	5475	794	121264	0	130489
14607	120731	2264	676	7553	0	131224
14608	6179	1520	117598	4184	0	129481
14609	117685	1501	4281	4113	0	127580
14610	6675	1397	1550	120286	0	129908
14611	120363	1516	1175	6780	0	129834
14612	121763	1764	1193	3926	0	128646
14613	113396	1265	1223	3929	0	119813
14614	7539	116314	1426	2741	0	128020
14615	4556	4433	115628	2268	0	126885
14616	4216	117323	4646	2301	0	128486
14617	116509	5078	1765	2697	0	126049
14618	7399	117031	1340	1970	0	127740
14619	5014	5729	1185	115376	0	127304
14620	113667	3254	1259	5355	0	123535
14621	6223	115193	1291	2366	0	125073
14622	3334	6522	113781	2012	0	125649
14623	3262	3821	4729	112851	0	124663
14624	3170	3049	113942	5679	0	125840
14625	2471	115354	5144	3796	0	126765
14626	2686	6253	2351	111654	0	122944
14627	2839	3251	2095	116219	0	124404
14628	2170	2970	2247	116716	0	124103
14629	2001	2405	2512	111561	0	118479
14630	1467	112923	2114	8081	0	124585
14631	110061	6042	1986	5131	0	123220
14632	5290	3518	110863	4533	0	124204
14633	2779	2599	5182	113506	0	124066
14634	110468	2482	2291	8607	0	123848
14635	6103	2408	110859	5035	0	124405
14636	3121	109175	5698	3915	0	121909
14637	3068	6647	3150	106112	0	118977
14638	3003	3372	108913	6496	0	121784
14639	2331	109041	6736	4229	0	122337
14640	103796	6314	3472	4144	0	117726
14641	6108	108933	2823	3432	0	121296
14642	3115	7116	2882	106440	0	119553
14643	2395	4513	2359	112052	0	121319
14644	105818	3774	2253	8452	0	120297
14645	5849	107884	2766	4866	0	121365
14646	3542	7386	2427	108564	0	121919
14647	105467	4209	2259	7826	0	119761
14648	105574	3862	1817	5481	0	116734
14649	7467	104948	1517	5089	0	119021
14650	105355	6865	1444	4771	0	118435
14651	108485	4357	1244	4092	0	118178
14652	8724	4010	1341	104014	0	118089
14653	5234	3270	101325	7857	0	117686
14654	5500	2803	5178	101481	0	114962
14655	5137	2598	2383	104908	0	115026
14656	4301	2847	99092	8619	0	114859
14657	4420	98030	5569	5209	0	113228
14658	4041	5947	2672	99474	0	112134
14659	3037	2886	2681	104779	0	113383
14660	2974	2375	3046	105260	0	113655
14661	2805	2209	2639	100860	0	108513
14662	2841	98157	2271	9971	0	113240
14663	99350	5824	2038	6488	0	113700
14664	101084	3360	1291	5985	0	111720
14665	100228	2642	976	6095	0	109941
14666	7924	94596	1110	5784	0	109414
14667	4741	6315	993	95750	0	107799
14668	4076	3476	93028	8174	0	108754
14669	4802	3733	4567	90193	0	103295
14670	5101	95055	1894	6932	0	108982
14671	93847	5990	1385	4304	0	105526
14672	94308	3524	1301	4132	0	103265
14673	93023	3094	1557	3960	0	101634
14674	7500	88406	1897	3712	0	101515
14675	4335	83237	2418	3121	0	93111
14676	3984	86996	1808	3190	0	95978
14677	4462	6405	81803	2472	0	95142
14678	4500	4424	73832	2374	0	85130
14679	3399	8314	2824	33694	0	48231
14680	26775	284	1116	877	0	29052
14681	26710	169	125	431	0	27435
14682	833	173	111	27288	0	28405
14683	411	182	105	26757	0	27455
14684	274	183	117	27861	0	28435
14685	266	176	102	28046	0	28590
14686	27648	166	94	922	0	28830
14687	28016	198	96	439	0	28749
14688	826	28553	124	319	0	29822
14689	28804	728	105	362	0	29999
14690	29304	305	116	309	0	30034
14691	29579	216	138	296	0	30229
14692	993	266	23895	296	0	25450
14693	27975	159	367	305	0	28806
14694	869	29187	162	254	0	30472
14695	456	712	133	29940	0	31241
14696	365	298	97	30178	0	30938
14697	283	28804	111	995	0	30193
14698	305	750	121	30853	0	32029
14699	30472	299	119	1014	0	31904
14700	937	192	104	31183	0	32416
14701	447	208	30561	973	0	32189
14702	29077	192	700	549	0	30518
14703	949	31524	213	361	0	33047
14704	518	771	121	31807	0	33217
14705	421	314	100	32376	0	33211
14706	399	230	79	32620	0	33328
14707	366	197	31554	1122	0	33239
14708	355	31156	667	504	0	32682
14709	371	783	206	31203	0	32563
14710	320	306	30719	865	0	32210
14711	339	214	647	30201	0	31401
14712	246	212	30271	927	0	31656
14713	314	225	711	28968	0	30218
14714	254	29522	310	837	0	30923
14715	239	720	178	29674	0	30811
14716	29407	270	151	967	0	30795
14717	29350	193	131	548	0	30222
14718	907	174	28964	380	0	30425
14719	340	152	27009	300	0	27801
14720	241	161	30872	281	0	31555
14721	240	142	800	30997	0	32179
14722	210	115	331	32591	0	33247
14723	220	122	193	32854	0	33389
14724	174	33383	169	1045	0	34771
14725	247	751	162	32779	0	33939
14726	255	301	136	34475	0	35167
14727	253	188	140	35568	0	36149
14728	34801	169	140	1241	0	36351
14729	34897	136	151	628	0	35812
14730	1001	177	34997	407	0	36582
14731	443	174	34447	360	0	35424
14732	34375	147	922	395	0	35839
14733	36089	130	407	387	0	37013
14734	1098	130	36666	306	0	38200
14735	483	115	35605	308	0	36511
14736	35299	128	967	360	0	36754
14737	36669	123	411	380	0	37583
14738	1112	129	37369	314	0	38924
14739	531	135	867	36584	0	38117
14740	352	108	400	37552	0	38412
14741	293	38638	305	1135	0	40371
14742	373	873	198	39706	0	41150
14743	311	275	41892	1170	0	43648
14744	376	170	1064	41768	0	43378
14745	362	121	407	42772	0	43662
14746	310	122	41737	1326	0	43495
14747	39691	113	1074	730	0	41608
14748	42641	98	458	548	0	43745
14749	1373	95	373	41781	0	43622
14750	675	103	267	42953	0	43998
14751	42387	114	292	1450	0	44243
14752	42152	112	326	737	0	43327
14753	39050	156	268	700	0	40174
14754	42855	139	245	540	0	43779
14755	1281	41701	272	493	0	43747
14756	41381	896	252	528	0	43057
14757	1189	41590	231	481	0	43491
14758	584	974	234	41696	0	43488
14759	491	315	245	41505	0	42556
14760	427	41102	237	1300	0	43066
14761	449	915	235	41667	0	43266
14762	455	291	235	41307	0	42288
14763	352	40996	260	1391	0	42999
14764	441	924	234	41349	0	42948
14765	459	323	219	41943	0	42944
14766	463	258	219	42014	0	42954
14767	401	185	40523	1483	0	42592
14768	398	39069	952	739	0	41158
14769	509	1100	360	36904	0	38873
14770	345	39070	289	1047	0	40751
14771	38301	914	258	682	0	40155
14772	1030	358	38153	530	0	40071
14773	481	283	36776	460	0	38000
14774	35824	216	923	474	0	37437
14775	962	264	442	37331	0	38999
14776	389	200	36659	918	0	38166
14777	358	164	35871	495	0	36888
14778	362	342	883	35392	0	36979
14779	35098	115	429	1021	0	36663
14780	35315	131	277	553	0	36276
14781	948	124	209	34853	0	36134
14782	421	156	34136	926	0	35639
14783	321	35801	725	494	0	37341
14784	368	690	265	36002	0	37325
14785	361	283	35957	874	0	37475
14786	300	35824	751	484	0	37359
14787	347	684	369	35621	0	37021
14788	35653	209	307	922	0	37091
14789	792	225	210	34691	0	35918
14790	352	35611	245	849	0	37057
14791	35035	606	261	604	0	36506
14792	744	307	37368	411	0	38830
14793	409	36694	637	429	0	38169
14794	413	597	36781	357	0	38148
14795	35298	220	702	470	0	36690
14796	761	223	326	34547	0	35857
14797	412	155	262	36812	0	37641
14798	36666	127	287	860	0	37940
14799	713	177	242	36777	0	37909
14800	338	160	36013	793	0	37304
14801	33475	141	609	605	0	34830
14802	709	36248	288	457	0	37702
14803	419	551	211	35782	0	36963
14804	35490	219	209	815	0	36733
14805	701	35293	214	444	0	36652
14806	420	615	217	36376	0	37628
14807	36412	248	189	914	0	37763
14808	750	240	215	36414	0	37619
14809	331	36465	180	830	0	37806
14810	337	601	37331	491	0	38760
14811	393	270	547	38368	0	39578
14812	471	205	267	35464	0	36407
14813	38888	189	202	960	0	40239
14814	739	154	182	39269	0	40344
14815	39174	203	153	914	0	40444
14816	39300	172	170	514	0	40156
14817	892	160	132	38662	0	39846
14818	356	39190	136	770	0	40452
14819	388	622	107	39068	0	40185
14820	35873	246	107	918	0	37144
14821	719	36506	101	416	0	37742
14822	253	38458	99	269	0	39079
14823	38588	590	107	396	0	39681
14824	38691	234	111	341	0	39377
14825	654	39157	114	282	0	40207
14826	39217	598	198	310	0	40323
14827	39160	200	113	296	0	39769
14828	819	193	77	39333	0	40422
14829	333	138	40637	659	0	41767
14830	364	154	615	40398	0	41531
14831	215	144	42168	757	0	43284
14832	302	181	636	41693	0	42812
14833	187	129	42316	759	0	43391
14834	39993	69	638	433	0	41133
14835	698	75	262	41286	0	42321
14836	42198	69	142	752	0	43161
14837	826	172	126	41174	0	42298
14838	300	42649	85	724	0	43758
14839	43342	593	114	467	0	44516
14840	764	250	41537	165	0	42716
14841	39600	164	450	304	0	40518
14842	639	41927	186	120	0	42872
14843	39761	464	80	234	0	40539
14844	40180	167	66	229	0	40642
14845	678	40785	88	113	0	41664
14846	377	537	64	41988	0	42966
14847	41987	188	76	717	0	42968
14848	669	42201	66	248	0	43184
14849	384	607	68	42405	0	43464
14850	42766	222	46	770	0	43804
14851	795	140	49	42668	0	43652
14852	454	106	45	43037	0	43642
14853	307	127	34	43816	0	44284
14854	193	132	42809	925	0	44059
14855	302	92	606	42433	0	43433
14856	43101	117	197	895	0	44310
14857	786	109	43535	357	0	44787
14858	452	90	624	43581	0	44747
14859	324	104	211	44592	0	45231
14860	166	116	43848	950	0	45080
14861	41326	86	646	601	0	42659
14862	44772	101	255	403	0	45531
14863	946	96	45193	271	0	46506
14864	501	64	716	43985	0	45266
14865	327	66	274	46024	0	46691
14866	209	75	48869	1034	0	50187
14867	348	62	773	48744	0	49927
14868	380	57	339	47766	0	48542
14869	228	95	50436	1131	0	51890
14870	47958	73	883	628	0	49542
14871	995	68	351	51364	0	52778
14872	50768	63	216	1210	0	52257
14873	50932	77	169	659	0	51837
14874	1156	102	51733	370	0	53361
14875	624	50	894	50511	0	52079
14876	51480	56	345	1225	0	53106
14877	1042	53032	251	543	0	54868
14878	556	878	181	55314	0	56929
14879	519	236	209	55284	0	56248
14880	424	121	204	57377	0	58126
14881	278	114	56682	1478	0	58552
14882	50625	90	1087	870	0	52672
14883	1192	79	388	54935	0	56594
14884	601	82	240	55436	0	56359
14885	359	109	54804	1452	0	56724
14886	449	72	1039	53694	0	55254
14887	406	90	375	55675	0	56546
14888	53976	70	311	1638	0	55995
14889	1141	54005	227	747	0	56120
14890	499	957	53731	535	0	55722
14891	52726	292	1090	596	0	54704
14892	1204	157	381	52700	0	54442
14893	456	114	53747	1338	0	55655
14894	354	122	53994	654	0	55124
14895	404	154	1260	54579	0	56397
14896	340	114	56692	1255	0	58401
14897	320	97	57128	663	0	58208
14898	298	56118	1316	607	0	58339
14899	379	953	557	60842	0	62731
14900	281	283	62159	1298	0	64021
14901	382	161	1188	60046	0	61777
14902	65668	112	504	1656	0	67940
14903	1248	142	394	66402	0	68186
14904	553	107	346	68289	0	69295
14905	66538	128	314	1717	0	68697
14906	67601	104	310	969	0	68984
14907	1508	107	342	71251	0	73208
14908	545	136	72949	1480	0	75110
14909	377	72175	1280	751	0	74583
14910	431	1043	539	72703	0	74716
14911	71947	296	393	1639	0	74275
14912	72134	208	290	902	0	73534
14913	1549	71379	326	614	0	73868
14914	616	73912	347	559	0	75434
14915	73710	1294	299	686	0	75989
14916	73378	414	279	705	0	74776
14917	1668	258	77591	517	0	80034
14918	934	229	1253	74718	0	77134
14919	509	79239	518	1349	0	81615
14920	81010	1219	382	869	0	83480
14921	1624	485	306	80309	0	82724
14922	630	79785	339	1453	0	82207
14923	523	1297	81909	629	0	84358
14924	696	651	1273	77295	0	79915
14925	370	85368	491	1470	0	87699
14926	86246	1240	374	789	0	88649
14927	86784	459	266	693	0	88202
14928	1461	87169	235	481	0	89346
14929	85111	1151	202	572	0	87036
14930	84573	372	229	546	0	85720
14931	1408	83817	265	413	0	85903
14932	548	85933	224	428	0	87133
14933	658	1368	209	84849	0	87084
14934	84117	425	234	1477	0	86253
14935	1293	360	87943	530	0	90126
14936	81535	282	1081	727	0	83625
14937	1232	90021	380	419	0	92052
14938	89981	1115	278	605	0	91979
14939	90204	415	229	487	0	91335
14940	90624	276	186	503	0	91589
14941	1665	267	213	88479	0	90624
14942	640	89577	235	1103	0	91555
14943	89117	1080	170	648	0	91015
14944	1325	464	90721	353	0	92863
14945	533	90135	1111	332	0	92111
14946	572	1043	345	94072	0	96032
14947	414	359	92052	1055	0	93880
14948	388	328	92170	408	0	93294
14949	605	274	1276	89464	0	91619
14950	515	230	404	96555	0	97704
14951	511	224	284	98003	0	99022
14952	527	205	251	95579	0	96562
14953	353	93347	232	1358	0	95290
14954	292	97775	237	577	0	98881
14955	97796	1212	204	627	0	99839
14956	1297	443	191	97909	0	99840
14957	624	312	201	97834	0	98971
14958	472	253	204	99651	0	100580
14959	97867	237	193	1754	0	100051
14960	98654	230	205	805	0	99894
14961	1483	235	192	99009	0	100919
14962	100151	186	156	1523	0	102016
14963	99766	189	155	897	0	101007
14964	101338	199	141	738	0	102416
14965	1544	211	127	100011	0	101893
14966	596	251	95267	1045	0	97159
14967	525	237	88439	562	0	89763
14968	456	213	93914	362	0	94945
14969	407	184	99301	318	0	100210
14970	505	257	1075	98693	0	100530
14971	100092	162	380	1197	0	101831
14972	98481	135	232	694	0	99542
14973	1171	171	99644	292	0	101278
14974	563	198	97343	296	0	98400
14975	391	106785	958	272	0	108406
14976	540	793	392	107742	0	109467
14977	107981	266	279	1185	0	109711
14978	930	223	108366	361	0	109880
14979	100892	153	829	709	0	102583
14980	898	112850	351	270	0	114369
14981	552	800	214	116251	0	117817
14982	430	270	195	119796	0	120691
14983	519	213	216	116183	0	117131
14984	120452	165	142	1758	0	122517
14985	1320	130	158	121085	0	122693
14986	656	128	157	122535	0	123476
14987	122153	127	156	1731	0	124167
14988	1375	140	134	121483	0	123132
14989	534	193	123279	1302	0	125308
14990	117540	134	1049	1045	0	119768
14991	1382	128	382	123978	0	125870
14992	800	135	271	121899	0	123105
14993	407	123119	219	1303	0	125048
14994	123778	1048	159	999	0	125984
14995	124814	347	137	821	0	126119
14996	1727	229	140	122597	0	124693
14997	647	230	122302	1281	0	124460
14998	108545	127	1211	1214	0	111097
14999	1409	190	121469	468	0	123536
15000	864	116	1360	117786	0	120126
15001	675	132	430	122922	0	124159
15002	120013	88	308	2040	0	122449
15003	1752	77	183	122711	0	124723
15004	608	184	122802	1673	0	125267
15005	114551	100	1368	1175	0	117194
15006	1592	152	128271	524	0	130539
15007	663	161	124568	407	0	125799
15008	123785	80	1966	728	0	126559
15009	2364	179	707	127797	0	131047
15010	675	134315	488	1492	0	136970
15011	134251	1497	334	989	0	137071
15012	133071	411	301	938	0	134721
15013	2194	294	134241	384	0	137113
15014	129568	144	1784	698	0	132194
15015	2298	210	616	132492	0	135616
15016	851	196	135023	1676	0	137746
15017	585	131089	1778	885	0	134337
15018	128912	1486	715	966	0	132079
15019	1782	131771	438	402	0	134393
15020	1027	1651	481	129488	0	132647
15021	862	604	341	130843	0	132650
15022	794	293	289	130110	0	131486
15023	807	252	256	125632	0	126947
15024	361	125911	308	2125	0	128705
15025	551	1506	120876	866	0	123799
15026	369	122326	1503	767	0	124965
15027	121484	1623	587	832	0	124526
15028	1840	624	345	122469	0	125278
15029	122977	356	279	2080	0	125692
15030	1977	334	312	123149	0	125772
15031	125243	290	243	2338	0	128114
15032	1842	127295	316	887	0	130340
15033	128997	1640	286	1128	0	132051
15034	130013	543	255	1059	0	131870
15035	126026	418	202	926	0	127572
15036	126767	249	242	961	0	128219
15037	2245	126441	208	572	0	129466
15038	1134	1627	127560	370	0	130691
15039	1035	571	1609	126925	0	130140
15040	128280	435	553	2103	0	131371
15041	132594	299	369	1021	0	134283
15042	2752	238	259	135638	0	138887
15043	1210	308	139526	2074	0	143118
15044	1275	267	1939	132810	0	136291
15045	770	138592	758	2154	0	142274
15046	138380	2118	460	1221	0	142179
15047	2842	747	360	138101	0	142050
15048	1151	135918	369	2330	0	139768
15049	873	143108	378	1024	0	145383
15050	705	146693	325	804	0	148527
15051	909	2860	322	147457	0	151548
15052	147769	1067	353	2910	0	152099
15053	2654	150349	313	1187	0	154503
15054	1404	2567	271	152295	0	156537
15055	151452	951	238	3120	0	155761
15056	3050	708	271	152419	0	156448
15057	151294	557	292	3313	0	155456
15058	152008	483	251	1734	0	154476
15059	3332	156908	291	867	0	161398
15060	2320	2661	244	145959	0	151184
15061	1109	158613	298	2210	0	162230
15062	155693	2910	272	1394	0	160269
15063	155644	1087	286	1238	0	158255
15064	158691	783	279	1086	0	160839
15065	4105	530	362	157699	0	162696
15066	1824	594	156080	2794	0	161292
15067	147708	581	2559	1679	0	152527
15068	155450	584	814	1274	0	158122
15069	4089	563	516	150462	0	155630
15070	1835	155768	399	2743	0	160745
15071	1853	2728	313	156055	0	160949
15072	1512	1174	381	159960	0	163027
15073	158201	904	384	3845	0	163334
15074	156360	662	386	2033	0	159441
15075	3829	777	149678	1067	0	155351
15076	2192	646	2559	148147	0	153544
15077	151532	637	825	3388	0	156382
15078	3946	692	525	152145	0	157308
15079	1575	680	152359	3740	0	158354
15080	1307	141647	2828	1791	0	147573
15081	1218	151329	865	1319	0	154731
15082	165530	3159	556	1367	0	170612
15083	4450	1234	372	173339	0	179395
15084	2288	966	349	190775	0	194378
15085	188088	759	371	6245	0	195463
15086	5686	788	187796	2633	0	196903
15087	3065	656	4440	187374	0	195535
15088	2121	764	189352	5723	0	197960
15089	1684	190289	5184	2603	0	199760
15090	194423	4806	2132	2439	0	203800
15091	199747	1863	1300	2166	0	205076
15092	202206	1372	1142	1751	0	206471
15093	7530	1260	195901	1523	0	206214
15094	194917	1108	4827	1640	0	202492
15095	203367	977	2040	1457	0	207841
15096	8444	1026	1309	198042	0	208821
15097	152736	1503	2263	7212	0	163714
15098	5694	1050	193304	2529	0	202577
15099	189555	749	4558	2334	0	197196
15100	7039	760	194519	1582	0	203900
15101	3916	196401	5069	1684	0	207070
15102	3622	5752	2772	180009	0	192155
15103	2790	197317	1672	4351	0	206130
15104	2818	5144	194192	1817	0	203971
15105	2273	197270	4809	1809	0	206161
15106	184991	5044	1941	1751	0	193727
15107	4921	183405	1801	1076	0	191203
15108	2698	185284	1264	1093	0	190339
15109	2353	5718	179875	945	0	188891
15110	2300	2981	4389	176662	0	186332
15111	178957	2183	1856	4786	0	187782
15112	4934	1959	179089	1943	0	187925
15113	2651	179288	4950	1646	0	188535
15114	2743	4877	2116	176279	0	186015
15115	2117	2419	181532	4694	0	190762
15116	1818	1840	179248	2418	0	185324
15117	2038	1866	5714	178136	0	187754
15118	1751	1271	181599	5069	0	189690
15119	2196	1333	5861	163828	0	173218
15120	1798	172175	2969	4726	0	181668
15121	2023	4637	2329	172596	0	181585
15122	1586	177966	2102	4853	0	186507
15123	2008	5009	1685	178198	0	186900
15124	175458	2334	1722	6000	0	185514
15125	5431	1817	1607	174784	0	183639
15126	2599	175347	1478	5754	0	185178
15127	2429	4837	1377	179285	0	187928
15128	2050	2189	177206	6080	0	187525
15129	2059	1954	4823	177673	0	186509
15130	176614	1576	2490	6326	0	187006
15131	5164	1575	173485	3341	0	183565
15132	2802	1476	5314	172509	0	182101
15133	169243	1346	2380	6254	0	179223
15134	5458	168753	2074	3243	0	179528
15135	3238	4870	1924	169410	0	179442
15136	171160	2303	1533	6110	0	181106
15137	6155	1769	1820	170187	0	179931
15138	3210	1733	166293	5963	0	177199
15139	158626	1556	4637	3821	0	168640
15140	5697	162576	2713	2573	0	173559
15141	2806	165426	2127	2848	0	173207
15142	162036	4845	2098	2447	0	171426
15143	158938	2527	1635	2065	0	165165
15144	6088	2211	1559	155931	0	165789
15145	156584	1790	1672	4658	0	164704
15146	5793	1694	150384	2887	0	160758
15147	149399	1540	4292	2815	0	158046
15148	5537	150442	2336	2294	0	160609
15149	150299	4135	2095	2342	0	158871
15150	5760	2257	149139	1895	0	159051
15151	4105	2002	4391	146549	0	157047
15152	3297	1808	2696	148046	0	155847
15153	3010	1670	2196	138065	0	144941
15154	2628	145423	1983	5046	0	155080
15155	146586	3890	1726	3381	0	155583
15156	5606	2018	1771	135669	0	145064
15157	3297	138256	1650	4698	0	147901
15158	149762	4042	1631	3238	0	158673
15159	145633	2185	1814	2786	0	152418
15160	149201	1907	1535	2918	0	155561
15161	148816	1811	1417	2753	0	154797
15162	147018	1599	1504	2391	0	152512
15163	6659	1794	1604	144153	0	154210
15164	4818	1720	1552	144450	0	152540
15165	143403	1524	1373	5773	0	152073
15166	5448	2083	1236	143346	0	152113
15167	3704	1887	1300	144150	0	151041
15168	3039	1882	133717	6004	0	144642
15169	137198	1791	3824	3991	0	146804
15170	141308	1724	2267	3630	0	148929
15171	142801	2148	1727	2989	0	149665
15172	6404	1874	1858	129138	0	139274
15173	3853	137105	1633	4996	0	147587
15174	149016	3693	1776	3224	0	157709
15175	142270	2071	1684	3476	0	149501
15176	6696	1798	1489	151709	0	161692
15177	150412	1765	1721	5462	0	159360
15178	7257	2760	115893	4178	0	130088
15179	4186	148800	3627	3171	0	159784
15180	4041	154048	2160	3429	0	163678
15181	4302	4761	149638	2819	0	161520
15182	1912	127747	3467	2173	0	135299
15183	2083	120962	1733	2100	0	126878
15184	105899	1913	1618	1489	0	110919
15185	1743	105703	779	1331	0	109556
15186	1545	1838	699	105640	0	109722
15187	106951	1058	575	2404	0	110988
15188	2060	919	104489	1390	0	108858
15189	100370	876	1199	1692	0	104137
15190	2173	871	100820	1157	0	105021
15191	1377	527	99327	1163	0	102394
15192	95883	565	1620	1419	0	99487
15193	1870	506	101944	990	0	105310
15194	1157	100228	1531	678	0	103594
15195	1301	1207	1017	98890	0	102415
15196	100071	799	600	1662	0	103132
15197	1692	97607	439	981	0	100719
15198	1346	1282	459	98597	0	101684
15199	1028	827	98608	1539	0	102002
15200	1238	615	1091	97705	0	100649
15201	95664	406	772	1863	0	98705
15202	1841	408	94516	965	0	97730
15203	1567	430	1214	92851	0	96062
15204	93692	542	725	1666	0	96625
15205	95687	380	568	1226	0	97861
15206	2482	356	406	94883	0	98127
15207	1760	407	344	95072	0	97583
15208	1171	396	97202	1847	0	100616
15209	1056	282	93596	1114	0	96048
15210	93716	302	1522	1063	0	96603
15211	98971	323	791	881	0	100966
15212	1905	98661	618	618	0	101802
15213	98619	1091	474	567	0	100751
15214	100076	506	362	743	0	101687
15215	2069	473	107459	447	0	110448
15216	1109	110274	1360	489	0	113232
15217	111566	1355	767	729	0	114417
15218	111932	607	429	466	0	113434
15219	114378	404	266	499	0	115547
15220	2478	299	222	111794	0	114793
15221	1457	305	205	111840	0	113807
15222	891	112190	243	1756	0	115080
15223	856	1370	176	114304	0	116706
15224	113717	558	159	2068	0	116502
15225	1967	452	110	114138	0	116667
15226	957	387	112844	1904	0	116092
15227	828	278	109404	979	0	111489
15228	832	169	1822	111143	0	113966
15229	511	264	113726	1792	0	116293
15230	516	282	110931	996	0	112725
15231	867	173	2153	108938	0	112131
15232	711	228	1079	113735	0	115753
15233	489	177	115422	2082	0	118170
15234	465	271	113874	1138	0	115748
15235	404	115652	2112	849	0	119017
15236	114959	1521	1085	929	0	118494
15237	1607	119113	767	543	0	122030
15238	118926	1690	522	802	0	121940
15239	120517	777	458	763	0	122515
15240	2102	121301	516	340	0	124259
15241	121984	1765	389	573	0	124711
15242	2312	810	348	120535	0	124005
15243	1093	637	124252	1630	0	127612
15244	1138	458	1754	120430	0	123780
15245	825	340	699	126194	0	128058
15246	120327	248	522	2780	0	123877
15247	120791	252	479	1508	0	123030
15248	121698	230	415	1089	0	123432
15249	121306	249	317	970	0	122842
15250	117145	226	311	834	0	118516
15251	2796	114300	359	462	0	117917
15252	1658	1518	303	116396	0	119875
15253	1112	703	118490	1822	0	122127
15254	1158	498	1780	116800	0	120236
15255	1150	335	830	117498	0	119813
15256	889	279	638	125886	0	127692
15257	132205	239	521	3287	0	136252
15258	2975	250	473	132400	0	136098
15259	133965	272	355	3570	0	138162
15260	3382	335	134849	1438	0	140004
15261	1973	240	2642	148343	0	153198
15262	1198	292	152963	3681	0	158134
15263	150337	210	3663	1998	0	156208
15264	4183	273	1351	153732	0	159539
15265	1641	393	156420	3832	0	162286
15266	1592	259	3661	155636	0	161148
15267	156283	173	1614	4748	0	162818
15268	3871	294	157431	2013	0	163609
15269	156175	211	3601	2182	0	162169
15270	163391	189	1631	1707	0	166918
15271	162502	200	1108	1641	0	165451
15272	158819	206	1025	1641	0	161691
15273	5231	154661	980	1106	0	161978
15274	2332	146032	798	1035	0	150197
15275	1906	140581	909	927	0	144323
15276	2196	4862	1156	131555	0	139769
15277	1277	137888	863	2692	0	142720
15278	134909	2969	695	1586	0	140159
15279	3323	132550	686	970	0	137529
15280	1575	136427	672	819	0	139493
15281	1627	3508	608	134601	0	140344
15282	1544	1451	615	138173	0	141783
15283	136101	967	624	4144	0	141836
15284	3907	751	523	136639	0	141820
15285	1912	774	133842	3495	0	140023
15286	1652	816	125802	1697	0	129967
15287	1447	848	133941	1226	0	137462
15288	1952	667	3596	131638	0	137853
15289	1819	561	1339	143044	0	146763
15290	1456	752	139291	4158	0	145657
15291	1416	798	134187	1900	0	138301
15292	1204	886	139106	1261	0	142457
15293	136896	865	4473	1478	0	143712
15294	3955	884	1902	139430	0	146171
15295	1978	805	1169	142232	0	146184
15296	140300	759	968	5152	0	147179
15297	4100	777	1025	139084	0	144986
15298	1752	138174	1134	4321	0	145381
15299	1270	145452	1143	2311	0	150176
15300	1658	3787	904	144657	0	151006
15301	144120	1427	805	5005	0	151357
15302	144674	833	929	3046	0	149482
15303	147170	599	1110	2252	0	151131
15304	5073	547	1171	145422	0	152213
15305	2243	696	143690	4322	0	150951
15306	1973	588	3926	142986	0	149473
15307	1496	566	143511	4637	0	150210
15308	135849	402	4215	2810	0	143276
15309	4659	416	2088	139608	0	146771
15310	134779	371	1552	4908	0	141610
15311	4216	507	137987	2456	0	145166
15312	126594	435	4028	2676	0	133733
15313	4752	518	140262	1750	0	147282
15314	2689	131346	3736	1740	0	139511
15315	2125	133092	1708	1443	0	138368
15316	129428	3667	1222	1701	0	136018
15317	4595	1594	794	128417	0	135400
15318	2311	1101	130550	3671	0	137633
15319	1828	126888	3335	1887	0	133938
15320	1587	133252	1634	1410	0	137883
15321	1850	4013	1128	131076	0	138067
15322	131511	1734	1008	4180	0	138433
15323	131859	1137	930	2452	0	136378
15324	4436	131584	1163	1846	0	139029
15325	132346	3378	1193	1899	0	138816
15326	4481	1509	1186	131519	0	138695
15327	2308	1246	130955	3944	0	138453
15328	1732	131888	3766	2161	0	139547
15329	2253	3349	1810	132334	0	139746
15330	1984	1422	1468	134927	0	139801
15331	132737	1097	1279	4930	0	140043
15332	4175	1141	131850	2166	0	139332
15333	128701	1013	3744	2134	0	135592
15334	132762	960	1864	1907	0	137493
15335	4914	1068	1466	130310	0	137758
15336	2648	1068	1146	133716	0	138578
15337	128784	1098	996	5059	0	135937
15338	4541	1030	976	130491	0	137038
15339	2284	1045	127613	4471	0	135413
15340	1788	986	126733	2211	0	131718
15341	1738	124643	4020	1840	0	132241
15342	1602	134932	1671	1893	0	140098
15343	1994	4060	1046	122836	0	129936
15344	1674	125846	1021	3810	0	132351
15345	127835	3805	1003	2612	0	135255
15346	3910	130535	1114	1861	0	137420
15347	2254	3804	1094	129821	0	136973
15348	1709	1891	994	133441	0	138035
15349	1440	1472	131021	4919	0	138852
15350	1863	1009	3691	129446	0	136009
15351	1929	786	1759	132921	0	137395
15352	1632	134815	1444	4929	0	142820
15353	1814	3486	1233	133443	0	139976
15354	1922	1480	1129	137110	0	141641
15355	1578	1044	132847	5510	0	140979
15356	1188	129022	3918	2903	0	137031
15357	1395	6682	1432	111989	0	121498
15358	1032	120254	941	3311	0	125538
15359	937	2949	115882	1802	0	121570
15360	781	114160	2777	1451	0	119169
15361	97612	2541	1710	1264	0	103127
15362	95424	916	654	876	0	97870
15363	95521	689	446	838	0	97494
15364	2348	95757	339	604	0	99048
15365	94597	1932	283	780	0	97592
15366	2359	910	346	93207	0	96822
15367	90829	642	274	2247	0	93992
15368	2010	90049	333	939	0	93331
15369	88866	1905	321	961	0	92053
15370	91417	862	249	1085	0	93613
15371	2467	94968	289	598	0	98322
15372	1226	2238	94971	514	0	98949
15373	1143	982	2002	101197	0	105324
15374	711	717	107377	2587	0	111392
15375	945	626	2782	107618	0	111971
15376	922	493	1043	113639	0	116097
15377	553	570	114383	3783	0	119289
15378	832	509	2960	113913	0	118214
15379	114515	427	1113	3909	0	119964
15380	3070	459	115852	1586	0	120967
15381	1193	115404	3121	1047	0	120765
15382	1327	2909	1112	111298	0	116646
15383	1078	1065	673	117470	0	120286
15384	625	759	115662	3848	0	120894
15385	1114	718	2832	107883	0	112547
15386	544	113506	1108	3335	0	118493
15387	109353	2848	773	1962	0	114936
15388	2569	110848	655	1041	0	115113
15389	102132	2784	320	1104	0	106340
15390	2475	103685	444	660	0	107264
15391	908	108987	392	618	0	110905
15392	660	3190	105456	565	0	109871
15393	972	1398	2771	103842	0	108983
15394	855	856	964	102318	0	104993
15395	752	621	544	106515	0	108432
15396	374	111269	593	3519	0	115755
15397	731	3059	382	111811	0	115983
15398	110511	1110	456	3919	0	115996
15399	3378	719	414	111104	0	115615
15400	110059	631	363	4099	0	115152
15401	3529	507	109965	1673	0	115674
15402	108900	525	3151	1378	0	113954
15403	3879	629	1053	108610	0	114171
15404	1725	574	734	114021	0	117054
15405	113314	571	623	4587	0	119095
15406	3598	632	114077	1903	0	120210
15407	1281	113229	3338	1484	0	119332
15408	1334	3281	1208	114110	0	119933
15409	114153	1229	786	3962	0	120130
15410	116680	995	581	1872	0	120128
15411	4536	801	456	114970	0	120763
15412	1762	670	114709	3990	0	121131
15413	109151	654	3390	1982	0	115177
15414	3760	716	113100	1329	0	118905
15415	1995	676	3561	110682	0	116914
15416	1169	584	112895	3896	0	118544
15417	1272	666	3492	110624	0	116054
15418	793	541	109171	4294	0	114799
15419	858	108402	3612	2016	0	114888
15420	1652	3237	1549	95356	0	101794
15421	806	110417	999	3156	0	115378
15422	110526	3382	781	1732	0	116421
15423	112385	1292	721	1523	0	115921
15424	4237	858	109966	1125	0	116186
15425	2127	743	3310	108432	0	114612
15426	110474	617	1386	3866	0	116343
15427	3980	560	940	110008	0	115488
15428	1927	601	889	110742	0	114159
15429	1401	560	107328	4567	0	113856
15430	100602	504	3478	2531	0	107115
15431	3670	551	107812	1690	0	113723
15432	1989	487	3707	105898	0	112081
15433	1330	536	107902	3945	0	113713
15434	105337	458	3805	2319	0	111919
15435	107454	435	1828	1923	0	111640
15436	108255	514	1392	1561	0	111722
15437	4816	519	1182	105414	0	111931
15438	2098	521	103843	3722	0	110184
15439	1523	608	105169	2028	0	109328
15440	1706	911	4134	94678	0	101429
15441	1180	103434	2072	3401	0	110087
15442	100555	2966	1380	2020	0	106921
15443	3864	1235	1153	100749	0	107001
15444	1935	894	101222	3865	0	107916
15445	1750	731	3463	101702	0	107646
15446	1401	601	104129	4142	0	110273
15447	1523	683	3724	104362	0	110292
15448	1377	559	106074	4122	0	112132
15449	1404	464	105276	2316	0	109460
15450	1170	102767	4301	1974	0	110212
15451	1195	2779	103030	1592	0	108596
15452	1277	1089	103387	1475	0	107228
15453	2017	988	4453	81009	0	88467
15454	1532	570	2048	91453	0	95603
15455	1176	98435	1634	3452	0	104697
15456	98570	2612	1410	1985	0	104577
15457	3246	98599	1339	1587	0	104771
15458	1884	2905	1364	97449	0	103602
15459	98200	1190	1247	3580	0	104217
15460	3497	766	1220	97903	0	103386
15461	98079	651	1289	3886	0	103905
15462	3696	514	1224	99233	0	104667
15463	1831	620	100421	3805	0	106677
15464	1545	645	3323	99923	0	105436
15465	1480	509	1787	103077	0	106853
15466	101277	488	1554	4436	0	107755
15467	101795	434	1471	2564	0	106264
15468	99854	401	1433	2020	0	103708
15469	3926	96559	1481	1627	0	103593
15470	1762	96123	1313	1401	0	100599
15471	93581	2672	1298	1577	0	99128
15472	3052	1106	94754	1350	0	100262
15473	1516	736	89563	1011	0	92826
15474	1554	2126	2982	80357	0	87019
15475	969	430	82545	2132	0	86076
15476	813	368	78699	1267	0	81147
15477	72301	398	2556	1263	0	76518
15478	75609	322	1324	1066	0	78321
15479	2329	75817	904	894	0	79944
15480	1255	77760	815	814	0	80644
15481	1318	1900	732	66403	0	70353
15482	782	76332	888	1558	0	79560
15483	77595	1736	847	1161	0	81339
15484	2145	764	713	73599	0	77221
15485	1119	78189	735	1767	0	81810
15486	79626	1628	763	1176	0	83193
15487	1930	809	80658	848	0	84245
15488	1017	494	79272	787	0	81570
15489	77451	454	2349	942	0	81196
15490	1964	348	79133	724	0	82169
15491	74856	242	1795	865	0	77758
15492	1969	392	969	77467	0	80797
15493	949	386	78188	1616	0	81139
15494	659	75869	1840	916	0	79284
15495	587	77871	1061	675	0	80194
15496	70767	1205	613	591	0	73176
15497	1053	72398	495	395	0	74341
15498	69737	954	482	556	0	71729
15499	69755	400	423	506	0	71084
15500	1186	70379	403	305	0	72273
15501	638	960	398	69815	0	71811
15502	364	405	72104	898	0	73771
15503	300	75140	1077	461	0	76978
15504	627	2059	566	72032	0	75284
15505	485	516	324	78070	0	79395
15506	76332	221	180	1506	0	78239
15507	1224	179	184	76310	0	77897
15508	419	193	76102	1283	0	77997
15509	270	76132	1125	561	0	78088
15510	415	1166	427	76950	0	78958
15511	78375	408	285	1528	0	80596
15512	80947	256	202	759	0	82164
15513	1775	212	194	81092	0	83273
15514	82981	176	213	1686	0	85056
15515	1703	219	83733	615	0	86270
15516	933	174	1505	82745	0	85357
15517	473	235	85185	1628	0	87521
15518	678	166	1626	89327	0	91797
15519	636	151	688	88803	0	90278
15520	618	168	353	89485	0	90624
15521	609	122	300	89024	0	90055
15522	562	164	281	88772	0	89779
15523	87429	153	238	3089	0	90909
15524	88605	143	193	1526	0	90467
15525	2427	89097	249	859	0	92632
15526	90299	1832	199	985	0	93315
15527	2456	625	215	90270	0	93566
15528	1259	365	221	91917	0	93762
15529	970	262	229	91880	0	93341
15530	627	232	92162	2958	0	95979
15531	924	210	2016	85263	0	88413
15532	480	90971	729	2398	0	94578
15533	90489	1952	425	1436	0	94302
15534	90649	651	358	1244	0	92902
15535	2619	383	89554	893	0	93449
15536	1076	89449	2043	908	0	93476
15537	944	2011	715	89211	0	92881
15538	700	746	90981	2465	0	94892
15539	952	495	2065	83066	0	86578
15540	612	88779	818	2465	0	92674
15541	85374	2070	505	1545	0	89494
15542	2228	87986	454	1037	0	91705
15543	1016	2251	87419	820	0	91506
15544	740	955	86576	785	0	89056
15545	581	84344	2497	833	0	88255
15546	507	86762	936	840	0	89045
15547	83203	2434	618	1047	0	87302
15548	83975	943	463	971	0	86352
15549	2798	634	467	83113	0	87012
15550	1066	625	83427	2391	0	87509
15551	1061	519	2119	81905	0	85604
15552	924	499	810	84029	0	86262
15553	82843	484	528	3174	0	87029
15554	81984	487	481	1560	0	84512
15555	2972	424	453	87347	0	91196
15556	1179	503	88193	2823	0	92698
15557	755	88844	2457	1390	0	93446
15558	88187	2453	1009	1184	0	92833
15559	2613	92156	651	906	0	96326
15560	1495	2821	485	92905	0	97706
15561	1223	1144	495	96820	0	99682
15562	1059	752	602	96875	0	99288
15563	864	608	563	95377	0	97412
15564	92036	650	556	4059	0	97301
15565	3159	595	395	91126	0	95275
15566	1402	90110	425	3470	0	95407
15567	1250	2494	414	90875	0	95033
15568	87843	998	468	3789	0	93098
15569	2677	88727	540	2031	0	93975
15570	1408	2667	517	88921	0	93513
15571	973	1122	87312	3474	0	92881
15572	85437	805	2480	1936	0	90658
15573	3324	705	879	86909	0	91817
15574	1462	687	85931	3276	0	91356
15575	1100	608	85086	1775	0	88569
15576	1235	813	3151	84942	0	90141
15577	84472	631	1453	3590	0	90146
15578	84982	543	826	2067	0	88418
15579	3283	87038	613	1762	0	92696
15580	86851	2450	529	1871	0	91701
15581	88287	1001	554	1779	0	91621
15582	88035	673	610	1607	0	90925
15583	87534	665	523	1553	0	90275
15584	4054	629	554	84982	0	90219
15585	2072	699	527	85815	0	89113
15586	1456	646	80901	3824	0	86827
15587	1178	75857	2379	2136	0	81550
15588	1005	79557	1014	1771	0	83347
15589	978	2777	78562	1549	0	83866
15590	76746	1053	2533	1464	0	81796
15591	3048	792	1032	78125	0	82997
15592	78514	664	708	3199	0	83085
15593	78690	675	643	1713	0	81721
15594	3517	708	76090	1267	0	81582
15595	1962	712	2427	75282	0	80383
15596	76625	522	993	3063	0	81203
15597	3232	617	704	75858	0	80411
15598	1711	639	74983	3139	0	80472
15599	1463	2228	2462	68592	0	74745
15600	1225	75224	1183	2621	0	80253
15601	1084	78434	809	1456	0	81783
15602	1159	2702	74685	1104	0	79650
15603	940	71786	2264	973	0	75963
15604	68046	2336	1142	1222	0	72746
15605	67548	812	636	856	0	69852
15606	2680	543	471	66262	0	69956
15607	1449	439	504	67083	0	69475
15608	1161	416	417	68345	0	70339
15609	65518	382	338	2769	0	69007
15610	2235	65862	353	1260	0	69710
15611	63521	1675	301	992	0	66489
15612	62456	600	326	840	0	64222
15613	2267	62259	351	685	0	65562
15614	58341	1450	278	670	0	60739
15615	1781	59392	302	547	0	62022
15616	59549	1561	253	773	0	62136
15617	1878	572	58379	679	0	61508
15618	51271	439	1413	617	0	53740
15619	1412	54101	430	470	0	56413
15620	958	1199	462	54282	0	56901
15621	674	400	157	57443	0	58674
15622	632	313	154	57920	0	59019
15623	58333	229	191	2088	0	60841
15624	1692	259	198	58886	0	61035
15625	757	319	57069	1791	0	59936
15626	54847	343	1292	914	0	57396
15627	1571	415	56479	637	0	59102
15628	854	380	1398	56071	0	58703
15629	583	375	57000	1646	0	59604
15630	669	328	1417	53523	0	55937
15631	477	55802	594	1596	0	58469
15632	633	1220	432	53987	0	56272
15633	486	55829	371	1544	0	58230
15634	694	1331	288	56351	0	58664
15635	56369	582	273	1779	0	59003
15636	1640	433	272	58098	0	60443
15637	58090	280	266	1861	0	60497
15638	1788	353	55741	736	0	58618
15639	56034	347	1224	738	0	58343
15640	57805	269	528	665	0	59267
15641	58190	306	411	546	0	59453
15642	2149	238	296	57372	0	60055
15643	56854	228	338	1678	0	59098
15644	1811	298	54854	690	0	57653
15645	54369	305	1314	761	0	56749
15646	1773	274	54400	590	0	57037
15647	55044	254	1265	540	0	57103
15648	1948	245	524	56070	0	58787
15649	1025	310	57095	1447	0	59877
15650	1040	181	1296	56173	0	58690
15651	892	180	616	57779	0	59467
15652	726	174	56887	1780	0	59567
15653	51272	134	1332	1170	0	53908
15654	1496	56751	627	803	0	59677
15655	53087	915	356	645	0	55003
15656	1189	52848	319	440	0	54796
15657	51387	900	281	529	0	53097
15658	1132	318	51013	358	0	52821
15659	45518	411	1134	484	0	47547
15660	924	47366	395	252	0	48937
15661	598	624	287	46802	0	48311
15662	358	249	161	48857	0	49625
15663	363	167	124	49169	0	49823
15664	295	167	49459	989	0	50910
15665	374	109	738	48799	0	50020
15666	273	143	52783	945	0	54144
15667	53180	94	885	579	0	54738
15668	57447	95	343	469	0	58354
15669	1422	87	234	58243	0	59986
15670	529	90	58764	1205	0	60588
15671	55301	66	1097	718	0	57182
15672	1310	84	69198	360	0	70952
15673	704	70	1525	67663	0	69962
15674	582	86	499	70884	0	72051
15675	548	88	313	72719	0	73668
15676	474	96	267	74255	0	75092
15677	71055	75	238	2277	0	73645
15678	1555	72385	300	779	0	75019
15679	628	1376	69376	501	0	71881
15680	411	70211	1505	428	0	72555
15681	70704	1554	448	581	0	73287
15682	1851	466	310	70888	0	73515
15683	71453	253	307	1961	0	73974
15684	1960	204	261	71446	0	73871
15685	849	162	285	71986	0	73282
15686	614	192	282	73031	0	74119
15687	411	217	71008	2248	0	73884
15688	388	69127	1575	1004	0	72094
15689	510	1492	71562	762	0	74326
15690	571	393	1716	71946	0	74626
15691	72964	306	556	2113	0	75939
15692	72069	272	406	1129	0	73876
15693	73080	211	379	1004	0	74674
15694	2016	72987	349	645	0	75997
15695	74691	1539	330	793	0	77353
15696	2087	476	344	74652	0	77559
15697	917	332	309	75526	0	77084
15698	785	223	313	75760	0	77081
15699	602	75916	292	2247	0	79057
15700	882	1554	284	70445	0	73165
15701	552	73778	340	1767	0	76437
15702	72757	1721	304	1030	0	75812
15703	73771	560	283	915	0	75529
15704	2300	329	260	73995	0	76884
15705	931	372	72424	2009	0	75736
15706	71025	289	1507	1106	0	73927
15707	2038	351	463	74457	0	77309
15708	809	341	73695	2029	0	76874
15709	70028	284	1546	1117	0	72975
15710	2036	316	482	74399	0	77233
15711	73548	256	379	2219	0	76402
15712	1884	73058	333	955	0	76230
15713	1027	1615	302	71568	0	74512
15714	703	74102	313	1882	0	77000
15715	853	1834	310	74059	0	77056
15716	632	75222	339	1879	0	78072
15717	848	1605	282	76996	0	79731
15718	559	589	75547	1896	0	78591
15719	58612	396	1422	1683	0	62113
15720	1625	73985	508	849	0	76967
15721	691	1238	72229	651	0	74809
15722	69529	400	1294	862	0	72085
15723	1684	345	388	73134	0	75551
15724	645	343	72717	1603	0	75308
15725	568	72887	1306	778	0	75539
15726	615	1303	432	74629	0	76979
15727	472	544	76036	1550	0	78602
15728	583	448	1305	75010	0	77346
15729	519	396	421	78112	0	79448
15730	474	380	79219	1892	0	81965
15731	593	364	1411	78799	0	81167
15732	455	446	80987	1835	0	83723
15733	609	380	1526	80977	0	83492
15734	505	411	85747	1989	0	88652
15735	691	330	1594	85503	0	88118
15736	709	303	653	86900	0	88565
15737	758	366	525	85709	0	87358
15738	483	86125	617	2080	0	89305
15739	85786	1414	555	1450	0	89205
15740	86710	501	526	1254	0	88991
15741	1911	374	561	87614	0	90460
15742	87116	320	509	2394	0	90339
15743	1683	401	87126	1146	0	90356
15744	680	87975	1472	1168	0	91295
15745	88291	1374	593	1437	0	91695
15746	1643	90252	552	951	0	93398
15747	893	1556	457	91243	0	94149
15748	634	688	477	92438	0	94237
15749	88939	516	461	2364	0	92280
15750	1780	477	372	89746	0	92375
15751	889	418	88989	2052	0	92348
15752	778	88203	1391	1082	0	91454
15753	88779	1483	501	1154	0	91917
15754	1837	578	416	88203	0	91034
15755	819	90171	393	1995	0	93378
15756	897	1537	434	88223	0	91091
15757	681	91807	453	1719	0	94660
15758	91307	1700	395	1299	0	94701
15759	90795	691	441	1253	0	93180
15760	2036	606	89801	846	0	93289
15761	1028	550	87522	836	0	89936
15762	992	404	1482	87356	0	90234
15763	663	90438	635	1693	0	93429
15764	752	1416	461	91972	0	94601
15765	90709	507	451	2279	0	93946
15766	1476	415	87236	888	0	90015
15767	792	379	1148	82746	0	85065
15768	443	260	83087	1302	0	85092
15769	452	316	77598	678	0	79044
15770	339	84220	1213	579	0	86351
15771	1260	2027	709	80611	0	84607
15772	74053	258	303	1082	0	75696
15773	638	190	74688	303	0	75819
15774	269	73118	553	281	0	74221
15775	72408	421	222	381	0	73432
15776	522	173	175	73352	0	74222
15777	74829	125	127	919	0	76000
15778	74634	135	112	726	0	75607
15779	75234	90	99	640	0	76063
15780	658	117	79835	167	0	80777
15781	73392	103	533	570	0	74598
15782	79613	86	227	462	0	80388
15783	686	82813	198	194	0	83891
15784	404	577	138	84216	0	85335
15785	378	204	100	82971	0	83653
15786	308	123	108	85315	0	85854
15787	84707	122	119	1053	0	86001
15788	80939	82	117	731	0	81869
15789	816	180	83302	272	0	84570
15790	568	122	529	81876	0	83095
15791	273	82610	254	617	0	83754
15792	82807	533	153	669	0	84162
15793	700	266	83561	220	0	84747
15794	574	125	578	79992	0	81269
15795	418	120	257	82744	0	83539
15796	259	82844	208	766	0	84077
15797	295	562	187	83966	0	85010
15798	463	309	158	77669	0	78599
15799	307	175	122	84025	0	84629
15800	83152	110	168	1340	0	84770
15801	813	110	186	83057	0	84166
15802	427	108	119	83482	0	84136
15803	83583	125	134	1438	0	85280
15804	914	172	103	84061	0	85250
15805	443	95464	131	1013	0	97051
15806	97951	1337	97	953	0	100338
15807	100835	631	116	865	0	102447
15808	103116	269	114	783	0	104282
15809	110002	191	104	821	0	111118
15810	3052	114763	144	392	0	118351
15811	123847	2327	98	741	0	127013
15812	126164	917	121	778	0	127980
15813	4373	576	83	124122	0	129154
15814	1731	363	123530	3092	0	128716
15815	1582	212	2807	122228	0	126829
15816	1224	187	904	124335	0	126650
15817	1054	211	448	122847	0	124560
15818	960	264	347	123247	0	124818
15819	931	190	216	124520	0	125857
15820	118823	169	179	5166	0	124337
15821	3647	136	196	120769	0	124748
15822	1315	248	120410	4124	0	126097
15823	1338	245	2894	117220	0	121697
15824	736	119772	995	3787	0	125290
15825	915	3155	510	120199	0	124779
15826	526	981	120487	3940	0	125934
15827	103394	499	3157	2619	0	109669
15828	113445	387	1083	1777	0	116692
15829	4031	325	119329	995	0	124680
15830	1625	118629	3068	802	0	124124
15831	121149	3032	1069	1185	0	126435
15832	122213	1111	568	1098	0	124990
15833	122982	658	440	1045	0	125125
15834	119842	398	399	877	0	121516
15835	5581	373	320	114734	0	121008
15836	2576	499	115547	3524	0	122146
15837	2235	439	3166	115296	0	121136
15838	1898	428	1124	120017	0	123467
15839	1310	340	117886	4840	0	124376
15840	1200	365	116347	2287	0	120199
15841	112328	265	4176	2154	0	118923
15842	3990	117229	1821	1691	0	124731
15843	2186	3219	1172	117891	0	124468
15844	1392	1161	116204	4388	0	123145
15845	107568	715	3701	3066	0	115050
15846	4219	608	115196	1981	0	122004
15847	109159	442	4097	2247	0	115945
15848	4541	114568	1889	1748	0	122746
15849	2687	3349	1222	115422	0	122680
15850	1881	1583	115103	4392	0	122959
15851	106570	930	3752	2944	0	114196
15852	4677	113709	1968	1719	0	122073
15853	2553	122558	1426	1460	0	127997
15854	2403	4487	1304	119991	0	128185
15855	2038	2226	1072	126029	0	131365
15856	126248	1563	919	6054	0	134784
15857	5279	125563	1042	3215	0	135099
15858	3400	4294	928	127872	0	136494
15859	126244	1878	921	6066	0	135109
15860	130325	1302	887	3567	0	136081
15861	132214	1063	820	3086	0	137183
15862	7389	858	131554	2540	0	142341
15863	4001	778	134033	2449	0	141261
15864	139240	771	5841	2795	0	148647
15865	6562	140937	2842	2345	0	152686
15866	3330	146209	2019	2398	0	153956
15867	3377	6225	1688	134364	0	145654
15868	2297	144096	1536	5947	0	153876
15869	144600	5960	1643	3481	0	155684
15870	6902	2783	1703	143450	0	154838
15871	3726	2043	142853	6322	0	154944
15872	142505	1616	5723	3663	0	153507
15873	148798	1793	2693	2691	0	155975
15874	8926	1662	1927	144538	0	157053
15875	5149	1588	1773	148044	0	156554
15876	4332	1603	1810	149239	0	156984
15877	3921	1530	1636	148572	0	155659
15878	3118	1750	138286	8911	0	152065
15879	2980	137463	5628	4958	0	151029
15880	3539	5956	2722	124824	0	137041
15881	2980	137281	2145	7011	0	149417
15882	3459	6337	1848	123855	0	135499
15883	2819	134008	1745	7132	0	145704
15884	132224	6371	1687	4886	0	145168
15885	133696	3138	1806	4035	0	142675
15886	8171	132571	1833	3613	0	146188
15887	134590	6198	1751	3389	0	145928
15888	8331	3179	1758	133025	0	146293
15889	132014	2685	1834	7274	0	143807
15890	8054	131801	1883	4010	0	145748
15891	133317	6805	1819	3137	0	145078
15892	137103	3614	1785	2778	0	145280
15893	9336	3281	1642	130880	0	145139
15894	5327	2870	130231	6796	0	145224
15895	4184	130335	5749	3795	0	144063
15896	4392	6449	2623	131574	0	145038
15897	132587	3842	1947	7244	0	145620
15898	7927	3275	129889	4199	0	145290
15899	5337	2460	5522	128293	0	141612
15900	4430	2310	2628	134008	0	143376
15901	132573	1901	2109	8706	0	145289
15902	134534	2150	1793	5303	0	143780
15903	132794	2023	1676	4548	0	141041
15904	9194	127613	1873	3902	0	142582
15905	117414	5114	1297	3431	0	127256
15906	6850	2441	110360	3170	0	122821
15907	3821	2107	107074	3056	0	116058
15908	3414	1755	108002	2627	0	115798
15909	3655	4893	5702	95013	0	109263
15910	2496	1308	94678	4131	0	102613
15911	85836	1174	2920	2352	0	92282
15912	4058	1054	1499	88126	0	94737
15913	2766	1048	90108	3459	0	97381
15914	92032	1082	2926	2518	0	98558
15915	4312	1036	1674	92658	0	99680
15916	2871	1176	1405	95454	0	100906
15917	95691	923	1322	4147	0	102083
15918	4071	1094	1387	98198	0	104750
15919	2557	1030	99354	3878	0	106819
15920	2318	921	3428	100299	0	106966
15921	2167	908	102425	4020	0	109520
15922	2180	853	3626	101054	0	107713
15923	99029	739	1881	4546	0	106195
15924	3877	96442	1554	2853	0	104726
15925	2604	101215	1315	2403	0	107537
15926	2524	3222	1110	99619	0	106475
15927	2123	1621	1198	99633	0	104575
15928	1969	96831	1216	4575	0	104591
15929	2087	97653	1193	2857	0	103790
15930	1902	3212	1202	96124	0	102440
15931	1847	1598	1374	97041	0	101860
15932	92843	1202	1213	4898	0	100156
15933	3427	91827	1364	2942	0	99560
15934	2121	91201	1112	2441	0	96875
15935	1814	96287	1124	1928	0	101153
15936	91032	3723	1148	2169	0	98072
15937	3242	1847	91014	2060	0	98163
15938	88489	1240	2909	2208	0	94846
15939	3507	1217	1489	89619	0	95832
15940	2103	86071	1130	3522	0	92826
15941	1675	92433	860	2404	0	97372
15942	91016	3318	841	2147	0	97322
15943	3566	1927	957	87233	0	93683
15944	2069	96394	1029	3366	0	102858
15945	97626	3179	1132	2420	0	104357
15946	98434	1774	978	2070	0	103256
15947	3988	1529	96283	1663	0	103463
15948	96205	1239	2676	1846	0	101966
15949	98833	1196	1517	1715	0	103261
15950	4323	1183	958	94929	0	101393
15951	2250	93057	944	3506	0	99757
15952	1852	95218	724	2147	0	99941
15953	1789	3340	556	91274	0	96959
15954	87038	1574	611	3285	0	92508
15955	2947	1282	79058	1825	0	85112
15956	1918	918	80364	1160	0	84360
15957	2106	720	78615	1179	0	82620
15958	1914	846	81544	960	0	85264
15959	1112	81615	2414	948	0	86089
15960	1259	82326	1255	1041	0	85881
15961	1556	2485	77634	859	0	82534
15962	1018	1412	75811	901	0	79142
15963	467	66661	1664	562	0	69354
15964	469	839	615	64013	0	65936
15965	150	406	68510	727	0	69793
15966	353	251	857	64751	0	66212
15967	278	141	394	69912	0	70725
15968	307	120	243	71641	0	72311
15969	274	128	214	74550	0	75166
15970	116	150	73789	1427	0	75482
15971	287	96	1172	70381	0	71936
15972	71665	114	494	1478	0	73751
15973	1120	183	70898	531	0	72732
15974	70114	157	1171	546	0	71988
15975	1411	118	491	72842	0	74862
15976	487	135	73781	1285	0	75688
15977	71388	141	1240	781	0	73550
15978	1427	83	480	74337	0	76327
15979	74677	117	387	1552	0	76733
15980	1517	133	261	72944	0	74855
15981	539	73354	269	1508	0	75670
15982	358	1120	75984	718	0	78180
15983	470	439	1290	76129	0	78328
15984	77062	257	576	1713	0	79608
15985	77514	217	363	945	0	79039
15986	77743	263	257	735	0	78998
15987	77193	275	302	637	0	78407
15988	76323	292	263	653	0	77531
15989	1589	76854	272	527	0	79242
15990	77237	1315	318	635	0	79505
15991	1554	580	76105	423	0	78662
15992	75388	424	1203	676	0	77691
15993	1804	344	475	72892	0	75515
15994	718	358	76458	1325	0	78859
15995	541	478	75272	590	0	76881
15996	606	356	1629	74690	0	77281
15997	77012	295	663	1649	0	79619
15998	1548	76208	512	632	0	78900
15999	76152	1320	329	645	0	78446
16000	1711	76472	358	425	0	78966
16001	1018	1469	334	78061	0	80882
16002	848	667	301	79555	0	81371
16003	79003	518	284	1985	0	81790
16004	1844	336	305	79349	0	81834
16005	908	351	79183	1579	0	82021
16006	78150	268	1409	936	0	80763
16007	1833	270	605	80887	0	83595
16008	1044	230	514	81179	0	82967
16009	687	336	80392	1796	0	83211
16010	71201	262	1441	1351	0	74255
16011	78693	273	648	895	0	80509
16012	1895	79364	482	528	0	82269
16013	901	1256	76583	458	0	79198
16014	650	542	74451	440	0	76083
16015	797	713	1635	71849	0	74994
16016	693	349	688	71481	0	73211
16017	529	73572	470	1522	0	76093
16018	435	1167	71414	698	0	73714
16019	544	395	1342	67882	0	70163
16020	453	248	70483	1287	0	72471
16021	540	209	1317	66259	0	68325
16022	344	68854	577	1382	0	71157
16023	526	1111	527	71171	0	73335
16024	584	369	405	71634	0	72992
16025	565	276	345	71092	0	72278
16026	70291	277	382	1877	0	72827
16027	1348	220	70563	787	0	72918
16028	589	75013	1400	664	0	77666
16029	594	1355	589	79151	0	81689
16030	80503	519	429	2061	0	83512
16031	1886	346	363	81944	0	84539
16032	81989	208	425	2236	0	84858
16033	2001	221	81862	1013	0	85097
16034	81057	202	1676	881	0	83816
16035	2264	217	714	84407	0	87602
16036	950	285	84796	2029	0	88060
16037	709	84524	1743	1053	0	88029
16038	820	1583	744	83650	0	86797
16039	799	574	471	86267	0	88111
16040	83969	326	426	2444	0	87165
16041	1962	82519	474	1079	0	86034
16042	900	81230	418	721	0	83269
16043	653	84315	405	647	0	86020
16044	77687	1868	387	759	0	80701
16045	1760	78216	352	614	0	80942
16046	1122	1643	333	77450	0	80548
16047	936	628	351	78636	0	80551
16048	77731	429	312	2247	0	80719
16049	1714	77502	323	1018	0	80557
16050	961	1580	344	78771	0	81656
16051	79881	688	288	2098	0	82955
16052	79871	413	297	1136	0	81717
16053	79537	305	302	1010	0	81154
16054	2191	78820	323	621	0	81955
16055	77655	1422	295	692	0	80064
16056	1846	666	263	76443	0	79218
16057	816	74556	255	1677	0	77304
16058	616	77407	272	762	0	79057
16059	880	1691	270	76371	0	79212
16060	75653	657	214	1863	0	78387
16061	76542	409	221	1076	0	78248
16062	2032	362	199	73843	0	76436
16063	727	73874	256	1563	0	76420
16064	73451	1382	210	978	0	76021
16065	1527	675	72251	548	0	75001
16066	770	420	69224	513	0	70927
16067	67026	356	1346	649	0	69377
16068	1352	338	69103	443	0	71236
16069	667	223	986	65056	0	66932
16070	66355	192	390	1270	0	68207
16071	1280	247	180	67760	0	69467
16072	539	236	67524	1232	0	69531
16073	420	68019	1012	578	0	70029
16074	487	1047	367	69824	0	71725
16075	354	452	69871	1096	0	71773
16076	64996	354	981	813	0	67144
16077	1257	254	337	69676	0	71524
16078	554	253	70017	1159	0	71983
16079	523	260	953	68069	0	69805
16080	642	67650	393	1142	0	69827
16081	464	1023	239	72305	0	74031
16082	474	416	213	71640	0	72743
16083	534	268	178	69633	0	70613
16084	306	70170	224	1492	0	72192
16085	72046	1040	240	940	0	74266
16086	1249	472	209	72966	0	74896
16087	653	315	217	73522	0	74707
16088	498	230	240	74759	0	75727
16089	422	256	73555	1637	0	75870
16090	457	265	1089	73094	0	74905
16091	73379	272	416	1753	0	75820
16092	1254	74156	303	749	0	76462
16093	646	1175	181	75495	0	77497
16094	515	551	198	76169	0	77433
16095	74916	378	197	1929	0	77420
16096	1263	75420	195	926	0	77804
16097	75890	1204	196	872	0	78162
16098	77784	547	152	688	0	79171
16099	1823	374	146	77091	0	79434
16100	77427	289	172	1809	0	79697
16101	1583	75199	151	868	0	77801
16102	75915	1363	162	720	0	78160
16103	1757	638	133	77707	0	80235
16104	86569	370	109	1918	0	88966
16105	88450	315	120	1139	0	90024
16106	2568	451	81948	658	0	85625
16107	86813	323	1443	860	0	89439
16108	90455	301	362	781	0	91899
16109	89183	328	240	1009	0	90760
16110	2906	306	94995	552	0	98759
16111	1167	96370	2397	441	0	100375
16112	1188	2547	680	96735	0	101150
16113	97690	775	452	2948	0	101865
16114	2891	96926	359	973	0	101149
16115	97649	2681	210	922	0	101462
16116	3567	805	223	98628	0	103223
16117	1388	591	98409	2790	0	103178
16118	99647	452	2593	1258	0	103950
16119	3723	306	769	102844	0	107642
16120	1491	302	103951	2996	0	108740
16121	102374	316	2920	1466	0	107076
16122	3691	303	107160	728	0	111882
16123	1974	345	3159	106058	0	111536
16124	1510	276	1247	113676	0	116709
16125	112104	289	699	4418	0	117510
16126	112561	321	451	2171	0	115504
16127	4477	111532	507	1137	0	117653
16128	109539	2953	376	1034	0	113902
16129	3926	977	103919	538	0	109360
16130	1710	555	103449	587	0	106301
16131	100444	448	3569	889	0	105350
16132	3506	103378	1408	484	0	108776
16133	101617	2647	901	797	0	105962
16134	3393	102436	742	400	0	106971
16135	100402	2984	2533	648	0	106567
16136	3958	1020	547	99829	0	105354
16137	1678	660	100919	2862	0	106119
16138	1766	440	2787	99726	0	104719
16139	1451	457	1002	104065	0	106975
16140	102329	334	713	3986	0	107362
16141	3390	503	101359	1529	0	106781
16142	97928	344	2985	1406	0	102663
16143	3685	100878	1215	822	0	106600
16144	102156	2857	903	839	0	106755
16145	4107	1080	663	100345	0	106195
16146	1787	850	100400	3050	0	106087
16147	1849	617	2964	99952	0	105382
16148	100968	527	1205	3669	0	106369
16149	3952	457	846	101133	0	106388
16150	2022	472	751	99560	0	102805
16151	1493	96569	730	3840	0	102632
16152	1541	2768	619	99272	0	104200
16153	1174	992	98167	3828	0	104161
16154	1470	654	3056	97644	0	102824
16155	1452	593	1249	100788	0	104082
16156	97986	495	910	4447	0	103838
16157	3877	566	698	98303	0	103444
16158	1864	562	96610	3879	0	102915
16159	1527	96639	3112	2018	0	103296
16160	1657	2866	1450	96784	0	102757
16161	1525	1157	973	99427	0	103082
16162	97863	794	821	4514	0	103992
16163	3743	95740	760	2149	0	102392
16164	2001	3035	672	97773	0	103481
16165	94395	1236	737	4070	0	100438
16166	97859	979	716	2227	0	101781
16167	4540	672	761	96849	0	102822
16168	2252	709	96615	4129	0	103705
16169	96127	529	3165	2377	0	102198
16170	4426	608	1450	100060	0	106544
16171	99306	582	1106	4558	0	105552
16172	100408	575	966	2508	0	104457
16173	4829	96118	835	1810	0	103592
16174	96151	3149	678	1861	0	101839
16175	4409	96165	856	1548	0	102978
16176	2690	3430	787	95462	0	102369
16177	2217	1563	784	94403	0	98967
16178	1788	95422	794	4301	0	102305
16179	96664	3243	745	2570	0	103222
16180	96115	1477	782	2126	0	100500
16181	4665	1097	91913	1716	0	99391
16182	2570	964	91372	1581	0	96487
16183	2259	762	3751	92341	0	99113
16184	93258	637	1643	4312	0	99850
16185	4294	679	1186	92441	0	98600
16186	2570	625	975	94876	0	99046
16187	1951	758	92369	4827	0	99905
16188	1812	713	91491	2619	0	96635
16189	1608	745	94318	2059	0	98730
16190	89272	769	4203	2086	0	96330
16191	93171	698	1888	1874	0	97631
16192	4487	89458	1358	1559	0	96862
16193	2413	92904	1016	1569	0	97902
16194	2256	3599	906	91259	0	98020
16195	1753	1594	91229	3809	0	98385
16196	88471	1123	3355	2328	0	95277
16197	3904	891	94942	1869	0	101606
16198	2308	693	3381	93163	0	99545
16199	1842	614	1574	97210	0	101240
16200	1632	602	1201	98189	0	101624
16201	1678	596	1035	99912	0	103221
16202	96684	600	1013	5107	0	103404
16203	4301	646	805	96024	0	101776
16204	1597	469	87300	3705	0	93071
16205	79183	356	2460	2442	0	84441
16206	3008	455	84167	1596	0	89226
16207	1651	482	82422	1269	0	85824
16208	1288	82206	3010	1284	0	87788
16209	1906	1723	1623	75078	0	80330
16210	74557	670	962	2133	0	78322
16211	2031	418	538	74810	0	77797
16212	1000	429	74342	2049	0	77820
16213	915	275	1573	74298	0	77061
16214	73179	221	780	2359	0	76539
16215	1711	73715	565	1318	0	77309
16216	71304	1342	468	1167	0	74281
16217	1762	71304	377	837	0	74280
16218	69467	1363	367	988	0	72185
16219	1593	69809	356	564	0	72322
16220	817	71501	311	543	0	73172
16221	712	1413	69163	316	0	71604
16222	569	68101	1179	368	0	70217
16223	63254	859	477	328	0	64918
16224	903	312	147	62580	0	63942
16225	62658	207	117	1011	0	63993
16226	898	64122	121	391	0	65532
16227	62850	887	112	471	0	64320
16228	1080	369	64078	188	0	65715
16229	595	216	958	62524	0	64293
16230	313	65856	365	922	0	67456
16231	411	1012	227	67643	0	69293
16232	358	381	179	68690	0	69608
16233	74673	234	122	1758	0	76787
16234	1518	75879	184	640	0	78221
16235	76109	1506	160	577	0	78352
16236	1833	651	77010	268	0	79762
16237	795	373	74317	258	0	75743
16238	440	76199	2043	283	0	78965
16239	543	1559	822	76062	0	78986
16240	321	672	77766	1587	0	80346
16241	759	373	1785	71343	0	74260
16242	552	307	691	79423	0	80973
16243	299	286	76100	2334	0	79019
16244	320	271	75643	944	0	77178
16245	251	252	78732	617	0	79852
16246	361	258	79335	452	0	80406
16247	256	81986	2441	459	0	85142
16248	546	1759	1034	80839	0	84178
16249	439	743	652	84525	0	86359
16250	276	430	83115	2411	0	86232
16251	447	341	1962	81817	0	84567
16252	291	336	86597	2188	0	89412
16253	485	251	2159	84735	0	87630
16254	439	263	1060	84766	0	86528
16255	261	86393	662	2412	0	89728
16256	430	1846	488	87341	0	90105
16257	495	753	486	86979	0	88713
16258	432	526	430	88602	0	89990
16259	312	421	86228	2785	0	89746
16260	269	85866	1920	1371	0	89426
16261	85026	1834	863	1140	0	88863
16262	86142	794	555	960	0	88451
16263	2471	524	427	84868	0	88290
16264	1226	468	405	83528	0	85627
16265	587	86248	407	2419	0	89661
16266	85200	1867	377	1456	0	88900
16267	1803	87331	396	897	0	90427
16268	84465	1939	334	874	0	87612
16269	1965	903	83899	528	0	87295
16270	78837	491	1788	861	0	81977
16271	1927	84295	798	538	0	87558
16272	1088	1755	494	84692	0	88029
16273	766	817	411	84595	0	86589
16274	465	85495	388	2256	0	88604
16275	86602	1883	365	1298	0	90148
16276	2087	851	361	88594	0	91893
16277	965	567	387	91515	0	93434
16278	90532	472	367	2953	0	94324
16279	92033	448	344	1530	0	94355
16280	2623	464	91444	837	0	95368
16281	91675	378	2022	992	0	95067
16282	2541	349	898	93429	0	97217
16283	1117	399	93615	2312	0	97443
16284	977	360	2152	92567	0	96056
16285	563	439	91899	2631	0	95532
16286	582	348	92932	1315	0	95177
16287	689	386	2678	91850	0	95603
16288	461	420	93781	2524	0	97186
16289	454	94181	2550	1448	0	98633
16290	686	2022	1168	93336	0	97212
16291	654	864	837	98245	0	100600
16292	498	586	97774	3016	0	101874
16293	445	97007	2459	1641	0	101552
16294	96699	2180	1241	1386	0	101506
16295	2443	992	820	99425	0	103680
16296	98749	658	741	3052	0	103200
16297	2456	97392	724	1499	0	102071
16298	1178	2458	98128	1091	0	102855
16299	959	1079	2585	96176	0	100799
16300	95277	663	1323	3080	0	100343
16301	2355	646	95993	1467	0	100461
16302	89941	446	2621	1536	0	94544
16303	2541	92681	1345	1022	0	97589
16304	1115	94635	907	903	0	97560
16305	93843	2530	898	1053	0	98324
16306	2476	1116	923	92949	0	97464
16307	1283	769	774	92644	0	95470
16308	789	93822	661	2939	0	98211
16309	768	2205	657	95799	0	99429
16310	707	1034	629	97178	0	99548
16311	94349	718	504	3653	0	99224
16312	2347	553	594	95071	0	98565
16313	1093	522	94416	2921	0	98952
16314	984	418	2323	93933	0	97658
16315	729	428	1200	97445	0	99802
16316	575	580	96297	3336	0	100788
16317	663	621	2189	96405	0	99878
16318	93558	450	999	3653	0	98660
16319	91607	407	701	2181	0	94896
16320	92031	388	595	1742	0	94756
16321	3136	399	572	91323	0	95430
16322	1450	485	90954	2778	0	95667
16323	1040	90582	2045	1773	0	95440
16324	1136	1981	927	91132	0	95176
16325	884	953	91652	2536	0	96025
16326	1015	563	1969	89383	0	92930
16327	863	488	975	91477	0	93803
16328	88418	431	655	3171	0	92675
16329	2035	91548	637	1633	0	95853
16330	1117	1894	88663	1103	0	92777
16331	81356	827	1829	1345	0	85357
16332	2106	85873	935	948	0	89862
16333	702	80532	496	630	0	82360
16334	82539	1520	677	848	0	85584
16335	1793	625	379	83089	0	85886
16336	775	544	88486	1630	0	91435
16337	798	380	1568	85378	0	88124
16338	423	88476	687	1787	0	91373
16339	89233	1599	442	1096	0	92370
16340	1885	688	302	90384	0	93259
16341	91787	412	314	2258	0	94771
16342	2117	347	293	89786	0	92543
16343	768	95020	350	1890	0	98028
16344	96218	1691	305	1273	0	99487
16345	96264	658	310	1060	0	98292
16346	2341	96615	279	640	0	99875
16347	94087	1813	276	809	0	96985
16348	2387	687	246	91281	0	94601
16349	878	92904	279	1909	0	95970
16350	93117	1843	272	1132	0	96364
16351	2045	94162	295	638	0	97140
16352	93165	1968	203	864	0	96200
16353	2416	755	224	93118	0	96513
16354	94439	548	208	2293	0	97488
16355	94713	435	204	1270	0	96622
16356	95400	474	206	942	0	97022
16357	2799	490	148	94377	0	97814
16358	1442	433	151	96942	0	98968
16359	95213	360	185	2672	0	98430
16360	2351	431	98436	1069	0	102287
16361	1286	382	1812	97121	0	100601
16362	867	101083	624	2171	0	104745
16363	1031	2137	288	102783	0	106239
16364	1006	733	242	104679	0	106660
16365	739	593	102406	2900	0	106638
16366	1081	486	2014	107366	0	110947
16367	695	114130	751	2880	0	118456
16368	1001	2925	363	117330	0	121619
16369	704	1313	122138	3445	0	127600
16370	1266	727	3093	120034	0	125120
16371	1065	506	1187	125018	0	127776
16372	120763	443	607	5042	0	126855
16373	121091	427	429	2493	0	124440
16374	4707	472	316	118170	0	123665
16375	1972	115053	394	3724	0	121143
16376	1168	118438	313	1936	0	121855
16377	973	3867	115800	1299	0	121939
16378	1307	2035	3022	114102	0	120466
16379	114345	854	1298	3975	0	120472
16380	3625	722	660	115299	0	120306
16381	1543	591	115145	3898	0	121177
16382	1370	524	3081	113977	0	118952
16383	1223	462	1291	116809	0	119785
16384	1135	438	693	119111	0	121377
16385	827	446	115942	4796	0	122011
16386	730	115610	2975	2403	0	121718
16387	114254	3032	1219	1937	0	120442
16388	114612	1288	723	1536	0	118159
16389	4453	865	471	111696	0	117485
16390	1955	663	111291	3594	0	117503
16391	1171	111186	3047	1911	0	117315
16392	1407	3423	1269	103393	0	109492
16393	850	110349	768	3004	0	114971
16394	735	115010	559	1623	0	117927
16395	110062	3846	517	1604	0	116029
16396	3301	1707	111649	970	0	117627
16397	1581	1043	111111	879	0	114614
16398	1492	721	3629	109069	0	114911
16399	1135	648	1545	113991	0	117319
16400	787	690	114514	3907	0	119898
16401	1177	552	2964	110884	0	115577
16402	780	545	113634	3800	0	118759
16403	105179	458	3299	2294	0	111230
16404	3288	519	1478	112281	0	117566
16405	1550	626	114407	3507	0	120090
16406	1456	626	3066	105842	0	110990
16407	820	117737	1439	3348	0	123344
16408	116428	2892	909	2425	0	122654
16409	3048	118427	793	1412	0	123680
16410	118276	3209	647	1620	0	123752
16411	3484	1574	117058	1146	0	123262
16412	115769	931	2959	1521	0	121180
16413	3688	756	1426	119305	0	125175
16414	1807	703	119776	3617	0	125903
16415	1391	640	3158	118175	0	123364
16416	1058	680	116999	3944	0	122681
16417	107074	593	3290	2787	0	113744
16418	3257	116748	1651	1721	0	123377
16419	2148	2948	1071	110214	0	116381
16420	1113	119085	1024	3163	0	124385
16421	117194	3323	829	2302	0	123648
16422	117518	1563	754	1967	0	121802
16423	4091	118217	779	1493	0	124580
16424	2208	3283	782	118368	0	124641
16425	1543	1547	747	119477	0	123314
16426	1263	1011	758	120217	0	123249
16427	116040	758	807	5412	0	123017
16428	3116	116088	858	2949	0	123011
16429	1712	3047	820	114410	0	119989
16430	1258	1554	910	116543	0	120265
16431	112454	1035	757	5070	0	119316
16432	3270	904	110975	2728	0	117877
16433	1816	704	108735	2224	0	113479
16434	102289	551	3575	2066	0	108481
16435	3121	590	106568	1424	0	111703
16436	1615	738	99471	1111	0	102935
16437	1303	800	3496	97094	0	102693
16438	99430	501	1989	3272	0	105192
16439	2835	526	1228	99456	0	104045
16440	1611	526	97595	3182	0	102914
16441	89964	523	2703	2272	0	95462
16442	2925	585	94843	1277	0	99630
16443	1421	92020	2713	1103	0	97257
16444	1414	2373	1799	93196	0	98782
16445	93792	1082	1164	2885	0	98923
16446	2335	728	968	94146	0	98177
16447	1443	576	874	95640	0	98533
16448	97232	349	660	3849	0	102090
16449	2544	364	670	99266	0	102844
16450	1531	337	676	101938	0	104482
16451	967	411	100727	3375	0	105480
16452	924	397	2143	99783	0	103247
16453	100350	353	1282	3447	0	105432
16454	100032	459	781	2146	0	103418
16455	100993	428	757	1460	0	103638
16456	3432	543	555	97968	0	102498
16457	1819	97799	627	2316	0	102561
16458	97879	1912	545	1755	0	102091
16459	2342	98867	616	1139	0	102964
16460	94762	1893	508	1131	0	98294
16461	2431	961	500	94817	0	98709
16462	92844	551	392	2335	0	96122
16463	92075	381	442	1667	0	94565
16464	92030	241	532	1334	0	94137
16465	2676	90846	515	825	0	94862
16466	989	84016	296	477	0	85778
16467	78020	740	215	633	0	79608
16468	824	78658	142	289	0	79913
16469	230	72825	96	143	0	73294
16470	199	73434	158	127	0	73918
16471	73489	416	461	457	0	74823
16472	498	156	46	73251	0	73951
16473	298	79	21	74046	0	74444
16474	74660	41	15	981	0	75697
16475	492	113	77981	195	0	78781
16476	473	54	431	88648	0	89606
16477	425	73	145	89876	0	90519
16478	366	45	84	99393	0	99888
16479	465	81	50	101282	0	101878
16480	129	99706	110	2400	0	102345
16481	109	116942	94	954	0	118099
16482	117461	2698	58	999	0	121216
16483	2920	1037	42	117444	0	121443
16484	1387	527	39	120150	0	122103
16485	627	327	118019	3435	0	122408
16486	817	198	2566	117856	0	121437
16487	261	243	120064	3489	0	124057
16488	772	198	3059	119467	0	123496
16489	255	211	124947	3584	0	128997
16490	125	123735	3531	1632	0	129023
16491	758	2962	1226	124437	0	129383
16492	123983	1000	770	4075	0	129828
16493	124094	637	471	1992	0	127194
16494	4493	424	369	122566	0	127852
16495	1584	389	123015	3719	0	128707
16496	1023	319	121539	1551	0	124432
16497	113862	297	4048	1823	0	120030
16498	3213	120273	1691	1079	0	126256
16499	121865	3201	1108	1166	0	127340
16500	122053	1113	627	1212	0	125005
16501	4447	768	120632	729	0	126576
16502	2470	465	3503	116914	0	123352
16503	1804	339	1488	119102	0	122733
16504	1452	415	901	126707	0	129475
16505	1291	340	697	122613	0	124941
16506	1557	229	597	120166	0	122549
16507	775	337	115845	5684	0	122641
16508	564	351	116693	2742	0	120350
16509	1233	255	4599	114987	0	121074
16510	1235	338	1922	118660	0	122155
16511	1284	305	1174	120852	0	123615
16512	116477	380	825	6099	0	123781
16513	4426	313	751	117298	0	122788
16514	117376	289	690	5439	0	123794
16515	4947	292	712	120023	0	125974
16516	121107	258	556	5965	0	127886
16517	124668	227	544	3320	0	128759
16518	122452	231	600	2657	0	125940
16519	123526	222	608	2200	0	126556
16520	123913	249	672	1946	0	126780
16521	6452	272	641	120196	0	127561
16522	121306	258	618	5204	0	127386
16523	5091	120498	576	2485	0	128650
16524	122286	3630	562	2216	0	128694
16525	5607	1230	566	122898	0	130301
16526	2647	841	121990	4962	0	130440
16527	2317	490	4011	123312	0	130130
16528	1688	464	123409	5578	0	131139
16529	2009	397	4577	122388	0	129371
16530	1971	395	1769	127169	0	131304
16531	1519	412	124227	6163	0	132321
16532	1486	354	124801	3184	0	129825
16533	1704	326	5358	124204	0	131592
16534	123499	267	2289	5937	0	131992
16535	4786	381	124371	2911	0	132449
16536	2364	124194	4608	2481	0	133647
16537	1785	3784	129664	2029	0	137262
16538	127337	1321	5182	2072	0	135912
16539	5276	852	2193	129525	0	137846
16540	130967	568	1679	5691	0	138905
16541	133981	419	1292	3148	0	138840
16542	6514	385	1304	131726	0	139929
16543	2995	478	129914	5699	0	139086
16544	2585	275	4790	128345	0	135995
16545	2104	323	2171	131365	0	135963
16546	124410	325	1644	7355	0	133734
16547	5070	127471	1385	3658	0	137584
16548	2962	4002	1131	127914	0	136009
16549	2020	1438	125570	5798	0	134826
16550	118666	1045	4796	3392	0	127899
16551	5245	123122	2204	2729	0	133300
16552	3158	4085	1549	124267	0	133059
16553	2642	1533	1238	126384	0	131797
16554	2209	1065	1091	128906	0	133271
16555	122980	596	1210	7580	0	132366
16556	126757	524	1138	4175	0	132594
16557	6834	491	1092	125397	0	133814
16558	3298	619	123085	6275	0	133277
16559	2403	123543	4643	3541	0	134130
16560	124103	4222	1965	3079	0	133369
16561	128721	1590	1546	2629	0	134486
16562	7041	997	1170	124180	0	133388
16563	3814	736	1139	128959	0	134648
16564	2520	662	126777	7078	0	137037
16565	1950	126908	5004	3663	0	137525
16566	128663	4494	2069	3178	0	138404
16567	127638	1617	1487	2722	0	133464
16568	6419	127010	1243	2305	0	136977
16569	127628	4608	946	2354	0	135536
16570	6766	1625	964	125631	0	134986
16571	3091	1268	124001	5912	0	134272
16572	2914	856	4715	124821	0	133306
16573	2200	763	122883	6337	0	132183
16574	117871	669	5140	3589	0	127269
16575	5553	119120	2279	2694	0	129646
16576	2742	4015	1181	106212	0	114150
16577	1719	1292	105531	4756	0	113298
16578	1531	818	100665	2053	0	105067
16579	92755	972	3968	2057	0	99752
16580	3587	94666	1822	1448	0	101523
16581	82362	2234	1680	1098	0	87374
16582	81090	824	755	1097	0	83766
16583	81742	544	610	979	0	83875
16584	3292	565	714	79099	0	83670
16585	1489	410	78959	2447	0	83305
16586	1169	78116	2103	1059	0	82447
16587	1276	2345	1063	77372	0	82056
16588	881	736	78519	2316	0	82452
16589	731	547	73174	919	0	75371
16590	837	393	1905	72473	0	75608
16591	570	315	72691	1906	0	75482
16592	68786	281	1867	1057	0	71991
16593	1936	304	763	71888	0	74891
16594	995	296	652	74275	0	76218
16595	73145	323	539	2241	0	76248
16596	1785	72429	554	966	0	75734
16597	75427	1479	507	1072	0	78485
16598	2131	565	533	74564	0	77793
16599	1136	437	414	76247	0	78234
16600	971	323	466	76798	0	78558
16601	884	322	467	75452	0	77125
16602	73308	315	459	2502	0	76584
16603	1911	345	73129	1130	0	76515
16604	901	71352	1544	800	0	74597
16605	814	1312	649	71707	0	74482
16606	67623	588	546	1991	0	70748
16607	71280	377	430	1202	0	73289
16608	1789	71353	448	889	0	74479
16609	69781	1321	426	884	0	72412
16610	1688	69799	423	643	0	72553
16611	803	72999	375	674	0	74851
16612	881	1601	442	72502	0	75426
16613	602	675	73002	1673	0	75952
16614	752	672	1331	70779	0	73534
16615	70055	366	579	1886	0	72886
16616	1554	68572	470	788	0	71384
16617	928	1368	303	68507	0	71106
16618	686	581	72968	1573	0	75808
16619	71756	417	1319	1217	0	74709
16620	75722	362	571	1012	0	77667
16621	76067	359	420	910	0	77756
16622	1825	333	72423	473	0	75054
16623	68430	346	1220	691	0	70687
16624	1472	71452	496	488	0	73908
16625	790	1283	374	67826	0	70273
16626	599	71231	370	1100	0	73300
16627	71273	1164	327	794	0	73558
16628	67730	486	328	840	0	69384
16629	1435	390	72345	461	0	74631
16630	643	72158	1075	454	0	74330
16631	669	1070	482	72174	0	74395
16632	579	457	351	72946	0	74333
16633	596	328	354	72078	0	73356
16634	704	235	287	72631	0	73857
16635	627	299	289	74671	0	75886
16636	501	322	70793	1666	0	73282
16637	401	69217	1245	818	0	71681
16638	67710	1161	491	727	0	70089
16639	1451	507	69689	451	0	72098
16640	658	70703	1243	451	0	73055
16641	70600	1267	446	625	0	72938
16642	1506	490	73097	418	0	75511
16643	69647	352	1324	632	0	71955
16644	69332	372	484	756	0	70944
16645	71593	310	302	640	0	72845
16646	1619	72832	286	449	0	75186
16647	773	1398	71344	389	0	73904
16648	454	73713	1323	400	0	75890
16649	1123	1590	567	60732	0	64012
16650	397	74249	332	1089	0	76067
16651	73727	1343	300	693	0	76063
16652	78039	496	247	584	0	79366
16653	75652	357	254	720	0	76983
16654	1987	328	78490	390	0	81195
16655	857	82266	1530	390	0	85043
16656	934	1717	559	89025	0	92235
16657	94849	714	336	2199	0	98098
16658	2461	94954	311	784	0	98510
16659	1371	2229	294	93015	0	96909
16660	699	866	94738	2173	0	98476
16661	91573	563	2144	1145	0	95425
16662	2625	406	98426	560	0	102017
16663	1066	342	100565	386	0	102359
16664	92699	299	2903	704	0	96605
16665	2609	356	97208	263	0	100436
16666	91163	270	2541	589	0	94563
16667	2549	93498	1111	230	0	97388
16668	96894	2138	700	575	0	100307
16669	3027	823	525	96825	0	101200
16670	1727	432	465	96743	0	99367
16671	1185	303	470	100532	0	102490
16672	99180	238	436	3405	0	103259
16673	98748	279	405	1598	0	101030
16674	99730	252	369	992	0	101343
16675	3451	97911	348	478	0	102188
16676	1882	2200	352	98264	0	102698
16677	1018	878	98194	2488	0	102578
16678	1152	485	2275	93281	0	97193
16679	711	94754	995	2721	0	99181
16680	1150	2248	537	94599	0	98534
16681	1077	1025	355	96917	0	99374
16682	95926	603	279	3475	0	100283
16683	2970	446	318	96460	0	100194
16684	1288	417	95987	3104	0	100796
16685	907	445	94497	1494	0	97343
16686	1129	359	3040	95450	0	99978
16687	94991	376	1384	3132	0	99883
16688	3004	419	794	94278	0	98495
16689	1696	387	584	97094	0	99761
16690	1012	346	96228	3512	0	101098
16691	799	95207	2695	1770	0	100471
16692	973	2252	1325	96673	0	101223
16693	95118	1008	920	3181	0	100227
16694	2688	95888	666	1623	0	100865
16695	1739	2415	474	96709	0	101337
16696	1094	1091	96804	2995	0	101984
16697	1043	681	2516	94527	0	98767
16698	92725	480	1297	3573	0	98075
16699	2614	92449	937	1775	0	97775
16700	1491	2494	94274	1268	0	99527
16701	1443	1128	2399	92683	0	97653
16702	916	812	95309	2980	0	100017
16703	91456	578	2850	1998	0	96882
16704	94154	559	1442	1563	0	97718
16705	3432	646	94773	1112	0	99963
16706	2028	523	2708	93202	0	98461
16707	1302	608	96328	2885	0	101123
16708	931	95392	3051	1681	0	101055
16709	1126	2452	1630	96348	0	101556
16710	948	1109	97300	3078	0	102435
16711	1318	837	2978	90408	0	95541
16712	1038	94849	1534	2867	0	100288
16713	1105	2470	1188	95766	0	100529
16714	876	1149	95705	3202	0	100932
16715	89721	776	2896	2215	0	95608
16716	2766	95189	1605	1388	0	100948
16717	96349	2557	1049	1514	0	101469
16718	3141	1269	93788	1163	0	99361
16719	90643	858	2826	1428	0	95755
16720	3200	737	93149	1199	0	98285
16721	91513	694	3137	1267	0	96611
16722	97255	686	1569	1374	0	100884
16723	3820	618	1259	95457	0	101154
16724	2194	613	979	98997	0	102783
16725	97872	667	930	3861	0	103330
16726	3246	98687	948	2092	0	104973
16727	99971	2647	1058	1645	0	105321
16728	3816	1179	1039	97825	0	103859
16729	2022	98592	1064	3226	0	104904
16730	1828	2809	916	101339	0	106892
16731	1689	1119	835	103830	0	107473
16732	1503	776	924	102325	0	105528
16733	1235	101183	859	4358	0	107635
16734	100808	2552	833	2295	0	106488
16735	3401	1326	670	101834	0	107231
16736	1718	928	100488	3469	0	106603
16737	1227	768	97374	2262	0	101631
16738	947	664	99973	1921	0	103505
16739	98494	639	3477	1863	0	104473
16740	100786	675	1693	1617	0	104771
16741	3674	679	99289	1335	0	104977
16742	2158	688	2676	93011	0	98533
16743	1496	615	1468	96938	0	100517
16744	983	549	101247	3672	0	106451
16745	894	510	100194	2062	0	103660
16746	1144	492	3336	101306	0	106278
16747	102235	468	1774	3130	0	107607
16748	99557	395	1180	1854	0	102986
16749	99584	415	963	1698	0	102660
16750	3437	97929	1065	1358	0	103789
16751	1728	100772	1024	1206	0	104730
16752	1309	2405	865	97855	0	102434
16753	96889	943	788	2727	0	101347
16754	2505	719	94765	1309	0	99298
16755	84339	481	1846	1447	0	88113
16756	1899	82477	757	742	0	85875
16757	659	78653	378	479	0	80169
16758	77981	1295	455	566	0	80297
16759	1194	77152	352	348	0	79046
16760	512	76932	326	383	0	78153
16761	75758	1580	1158	867	0	79363
16762	933	78060	236	249	0	79478
16763	435	757	167	76518	0	77877
16764	351	303	131	77019	0	77804
16765	76658	223	149	1027	0	78057
16766	76052	163	125	602	0	76942
16767	881	77680	157	296	0	79014
16768	375	79240	172	211	0	79998
16769	294	798	78103	168	0	79363
16770	78339	360	760	430	0	79889
16771	83641	211	247	416	0	84515
16772	86238	137	167	362	0	86904
16773	1366	131	134	86271	0	87902
16774	615	162	109	88544	0	89430
16775	89284	157	95	1421	0	90957
16776	1343	173	118	89454	0	91088
16777	461	182	90323	1284	0	92250
16778	575	127	1033	88446	0	90181
16779	303	92655	358	1151	0	94467
16780	506	1177	205	93822	0	95710
16781	446	335	150	95584	0	96515
16782	472	269	127	95930	0	96798
16783	94470	183	135	1913	0	96701
16784	1260	94664	165	702	0	96791
16785	644	1116	139	96343	0	98242
16786	351	417	96312	1412	0	98492
16787	361	384	91126	568	0	92439
16788	501	232	1372	93494	0	95599
16789	428	158	465	95756	0	96807
16790	94052	137	281	1902	0	96372
16791	1539	186	210	91986	0	93921
16792	499	92696	186	1532	0	94913
16793	374	1269	93763	661	0	96067
16794	529	579	1246	93687	0	96041
16795	310	326	96073	1511	0	98220
16796	462	232	1358	95125	0	97177
16797	95135	164	468	1872	0	97639
16798	95838	196	320	884	0	97238
16799	1660	96086	289	537	0	98572
16800	875	1237	221	96346	0	98679
16801	99082	417	280	1740	0	101519
16802	100188	269	256	1040	0	101753
16803	101265	219	255	903	0	102642
16804	101252	168	276	801	0	102497
16805	100465	175	271	764	0	101675
16806	1836	98986	295	427	0	101544
16807	98894	1223	237	685	0	101039
16808	1675	467	98226	424	0	100792
16809	975	271	1225	98212	0	100683
16810	100349	219	381	1749	0	102698
16811	99956	207	241	937	0	101341
16812	98966	197	229	833	0	100225
16813	1929	281	98345	488	0	101043
16814	1120	227	1268	97806	0	100421
16815	101149	224	432	1772	0	103577
16816	1594	101195	321	642	0	103752
16817	104798	1316	222	977	0	107313
16818	102709	481	189	787	0	104166
16819	103534	345	199	740	0	104818
16820	2133	375	194	104227	0	106929
16821	105219	251	203	2009	0	107682
16822	1822	292	104048	791	0	106953
16823	900	289	102418	687	0	104294
16824	101395	239	1428	973	0	104035
16825	1610	274	105656	385	0	107925
16826	97478	144	1205	795	0	99622
16827	1489	213	103855	359	0	105916
16828	880	221	1193	100717	0	103011
16829	100365	141	435	1639	0	102580
16830	1393	96259	378	685	0	98715
16831	98708	1001	266	767	0	100742
16832	1459	96345	239	476	0	98519
16833	725	101846	256	381	0	103208
16834	763	1200	234	103430	0	105627
16835	734	417	316	103887	0	105354
16836	652	246	310	103923	0	105131
16837	475	227	102338	1613	0	104653
16838	96725	221	1271	1163	0	99380
16839	105873	144	470	902	0	107389
16840	106683	199	262	774	0	107918
16841	107108	220	240	754	0	108322
16842	106587	197	250	793	0	107827
16843	2207	258	98428	517	0	101410
16844	1075	265	102232	415	0	103987
16845	1069	207	1782	104878	0	107936
16846	775	233	104740	1716	0	107464
16847	104425	189	1655	1042	0	107311
16848	2354	111102	594	494	0	114544
16849	1296	1949	352	116773	0	120370
16850	117615	518	297	2630	0	121060
16851	3012	307	379	118136	0	121834
16852	1221	283	118639	2470	0	122613
16853	990	199	118401	986	0	120576
16854	1114	173	2893	121754	0	125934
16855	784	206	123322	2537	0	126849
16856	117664	224	2711	1241	0	121840
16857	2984	248	985	122093	0	126310
16858	1302	272	122939	2588	0	127101
16859	942	121851	2526	1143	0	126462
16860	1162	2254	922	124381	0	128719
16861	805	799	126035	2678	0	130317
16862	1091	510	2713	119498	0	123812
16863	1107	263	1070	122945	0	125385
16864	741	237	124269	3450	0	128697
16865	1070	231	2835	121921	0	126057
16866	1180	202	1262	118140	0	120784
16867	1063	240	773	123713	0	125789
16868	118661	221	575	3965	0	123422
16869	2907	116525	632	1522	0	121586
16870	1266	118944	510	984	0	121704
16871	831	2832	113705	785	0	118153
16872	105734	818	2436	1029	0	110017
16873	2506	526	111022	556	0	114610
16874	914	359	110087	591	0	111951
16875	836	310	2741	106820	0	110707
16876	107681	165	1050	2730	0	111626
16877	2194	109370	671	1101	0	113336
16878	107604	2064	585	1189	0	111442
16879	106855	672	441	1059	0	109027
16880	2666	108152	405	639	0	111862
16881	107252	2079	486	869	0	110686
16882	106789	694	432	828	0	108743
16883	2591	108818	436	476	0	112321
16884	1345	2260	415	108334	0	112354
16885	1039	740	480	111800	0	114059
16886	113648	403	378	3002	0	117431
16887	2470	116812	483	1107	0	120872
16888	119247	2503	418	981	0	123149
16889	120617	843	333	1005	0	122798
16890	126904	462	335	876	0	128577
16891	4039	469	335	123956	0	128799
16892	1849	360	286	128425	0	130920
16893	127084	338	266	3887	0	131575
16894	130667	387	294	1744	0	133092
16895	132437	367	252	1245	0	134301
16896	4610	332	282	133989	0	139213
16897	1672	459	135098	3550	0	140779
16898	1563	325	3222	135980	0	141090
16899	1395	298	1042	146155	0	148890
16900	927	378	142498	4684	0	148487
16901	940	436	151433	1889	0	154698
16902	1458	354	4933	149485	0	156230
16903	920	319	152700	4677	0	158616
16904	151489	272	4741	2547	0	159049
16905	5045	253	1866	154581	0	161745
16906	2451	264	1123	159210	0	163048
16907	159606	279	784	6427	0	167096
16908	5343	271	834	159006	0	165454
16909	2804	250	719	161904	0	165677
16910	1876	264	703	164153	0	166996
16911	1665	225	729	164942	0	167561
16912	1066	372	158928	6961	0	167327
16913	1418	288	4291	160169	0	166166
16914	1001	336	158269	5943	0	165549
16915	937	159615	4881	3120	0	168553
16916	1396	4212	1891	159396	0	166895
16917	983	1508	156921	5626	0	165038
16918	144976	764	4844	3631	0	154215
16919	4777	154544	2158	2243	0	163722
16920	154767	4338	1307	2215	0	162627
16921	5849	1586	1076	147225	0	155736
16922	2253	149664	1029	5204	0	158150
16923	149207	4458	878	3174	0	157717
16924	4998	151442	964	2124	0	159528
16925	152480	4845	811	2107	0	160243
16926	5926	1973	862	150901	0	159662
16927	152767	1160	805	5726	0	160458
16928	5473	154611	950	2726	0	163760
16929	155041	5015	726	2287	0	163069
16930	5996	2000	153577	1767	0	163340
16931	3296	1219	4724	154470	0	163709
16932	153233	861	1898	5974	0	161966
16933	156995	886	1160	3274	0	162315
16934	7337	744	936	152902	0	161919
16935	3185	896	152776	5824	0	162681
16936	2327	142739	4654	2993	0	152713
16937	1971	154565	2026	2153	0	160715
16938	153983	5701	1580	2323	0	163587
16939	6139	2099	974	151811	0	161023
16940	3274	1187	986	155926	0	161373
16941	152387	838	1046	7042	0	161313
16942	151960	948	1097	3695	0	157700
16943	6754	891	150409	2602	0	160656
16944	3754	798	4517	147440	0	156509
16945	2299	752	145556	5707	0	154314
16946	1999	143481	4468	3317	0	153265
16947	136264	3790	2100	2961	0	145115
16948	4487	137357	1365	2406	0	145615
16949	2280	139198	1262	1965	0	144705
16950	2415	4639	1260	136638	0	144952
16951	133432	1979	1064	5149	0	141624
16952	4127	133944	1169	2823	0	142063
16953	131673	3995	982	2654	0	139304
16954	4466	130778	1069	1965	0	138278
16955	2826	4207	875	131203	0	139111
16956	130120	1900	959	5011	0	137990
16957	4564	1413	131136	2834	0	139947
16958	3033	1297	3804	129916	0	138050
16959	1984	1200	130059	4918	0	138161
16960	1933	121568	3912	2849	0	130262
16961	1621	130235	1888	2361	0	136105
16962	124904	4612	1383	2566	0	133465
16963	4000	128430	1218	2070	0	135718
16964	127346	4197	1146	2256	0	134945
16965	127985	2043	2948	2166	0	135142
16966	5121	1760	125039	1756	0	133676
16967	124148	1301	3603	2071	0	131123
16968	4927	1606	128882	1607	0	137022
16969	3043	128881	3892	1656	0	137472
16970	130177	4045	1969	1877	0	138068
16971	4889	130153	1453	1652	0	138147
16972	3124	4181	1169	131049	0	139523
16973	132105	2078	1127	4668	0	139978
16974	5352	1586	946	131717	0	139601
16975	2840	1646	132421	4949	0	141856
16976	2589	1498	3740	130591	0	138418
16977	2224	1586	1747	134368	0	139925
16978	131597	1518	1138	5734	0	139987
16979	4956	1483	130846	2856	0	140141
16980	130186	1245	3892	2396	0	137719
16981	137285	1200	1916	2172	0	142573
16982	6272	1174	1425	133632	0	142503
16983	3752	1216	1047	135331	0	141346
16984	132255	1226	1107	5685	0	140273
16985	5288	132412	1151	2738	0	141589
16986	3352	3910	905	129207	0	137374
16987	2450	1913	125358	3978	0	133699
16988	2123	1471	118285	2434	0	124313
16989	1849	124831	4009	1771	0	132460
16990	2005	3596	1607	119389	0	126597
16991	1862	1887	1035	121883	0	126667
16992	118253	1437	891	4571	0	125152
16993	4315	1176	853	116932	0	123276
16994	111592	917	806	3968	0	117283
16995	3864	108915	808	2178	0	115765
16996	1915	106235	620	1614	0	110384
16997	1561	110721	636	1363	0	114281
16998	106288	3028	973	1668	0	111957
16999	98924	1181	756	1234	0	102095
17000	2977	97147	509	910	0	101543
17001	86812	1424	322	632	0	89190
17002	1597	86414	206	311	0	88528
17003	825	1557	168	83348	0	85898
17004	451	84247	202	1299	0	86199
17005	83898	1487	277	778	0	86440
17006	84458	641	139	562	0	85800
17007	1837	420	140	80876	0	83273
17008	81097	366	144	1586	0	83193
17009	1664	347	163	79906	0	82080
17010	676	81566	157	1451	0	83850
17011	743	1649	138	80756	0	83286
17012	539	81154	191	1350	0	83234
17013	79607	1304	149	849	0	81909
17014	1469	590	77715	405	0	80179
17015	73192	336	991	626	0	75145
17016	1349	302	294	76441	0	78386
17017	570	324	75636	1128	0	77658
17018	71730	311	944	884	0	73869
17019	1320	299	79546	365	0	81530
17020	772	220	1100	78364	0	80456
17021	631	228	397	81029	0	82285
17022	560	232	203	81228	0	82223
17023	545	222	215	83114	0	84096
17024	370	82971	238	1791	0	85370
17025	617	1444	221	88652	0	90934
17026	88164	512	178	2179	0	91033
17027	1814	332	87531	747	0	90424
17028	646	93056	1626	579	0	95907
17029	95063	1920	484	801	0	98268
17030	103505	787	256	686	0	105234
17031	3306	462	212	111636	0	115616
17032	1231	416	112252	2926	0	116825
17033	1151	341	2674	109336	0	113502
17034	1114	296	1069	113381	0	115860
17035	581	336	112745	3872	0	117534
17036	526	115942	3042	1563	0	121073
17037	117537	3171	1182	1161	0	123051
17038	117617	1349	527	1152	0	120645
17039	121181	596	470	1055	0	123302
17040	5431	454	498	117095	0	123478
17041	2778	368	371	123809	0	127326
17042	124616	366	352	5202	0	130536
17043	4953	452	380	116325	0	122110
17044	2221	122845	375	4029	0	129470
17045	127992	3540	289	2314	0	134135
17046	127389	1540	387	1874	0	131190
17047	136244	752	317	1628	0	138941
17048	138828	510	292	1550	0	141180
17049	6784	506	129595	1043	0	137928
17050	3371	567	131322	879	0	136139
17051	2790	544	5172	127813	0	136319
17052	2355	533	2059	132725	0	137672
17053	1746	458	130781	5584	0	138569
17054	1703	407	132793	2518	0	137421
17055	2033	367	5443	130231	0	138074
17056	131681	327	2492	5081	0	139581
17057	5416	333	1651	128417	0	135817
17058	2655	425	130302	5109	0	138491
17059	1809	131260	4499	2869	0	140437
17060	132032	3936	2219	2279	0	140466
17061	135380	1697	1608	1963	0	140648
17062	136519	833	1455	1722	0	140529
17063	138171	621	1249	1708	0	141749
17064	7155	580	130528	1414	0	139677
17065	3997	498	4587	130780	0	139862
17066	133044	535	2482	5283	0	141344
17067	6058	588	1689	132184	0	140519
17068	3930	504	1346	126029	0	131809
17069	2640	126776	1066	6079	0	136561
17070	2851	3948	950	129772	0	137521
17071	127412	1773	1078	5976	0	136239
17072	5290	128387	1287	3194	0	138158
17073	127606	4544	997	2487	0	135634
17074	6156	128228	874	1964	0	137222
17075	4320	4748	789	117386	0	127243
17076	2808	120980	981	4807	0	129576
17077	2377	128829	1037	2909	0	135152
17078	125017	5674	1019	2536	0	134246
17079	5873	2695	122511	2189	0	133268
17080	3475	1834	120583	2042	0	127934
17081	2603	1563	120773	1957	0	126896
17082	112752	1425	5730	2581	0	122488
17083	5044	116368	2930	2191	0	126533
17084	3317	121651	1812	2025	0	128805
17085	114626	5750	1344	2045	0	123765
17086	5805	114399	1363	1620	0	123187
17087	3709	119526	1453	1580	0	126268
17088	3255	6035	1388	116395	0	127073
17089	2746	3212	116573	5047	0	127578
17090	2767	2377	118365	3065	0	126574
17091	2869	2162	5567	117198	0	127796
17092	115579	1825	3118	5596	0	126118
17093	5692	118269	2452	3070	0	129483
17094	4079	5022	1971	118835	0	129907
17095	3237	3017	118562	5240	0	130056
17096	3227	2092	117650	3252	0	126221
17097	3221	1816	6134	115529	0	126700
17098	115243	1715	3569	5884	0	126411
17099	118506	1671	2504	3679	0	126360
17100	7259	1677	114984	2719	0	126639
17101	114318	1691	5280	2971	0	124260
17102	6648	1516	116300	2513	0	126977
17103	4562	1209	6077	107718	0	119566
17104	3449	113601	3960	5070	0	126080
17105	117396	4529	2729	3466	0	128120
17106	6822	2503	2183	117380	0	128888
17107	4901	1749	2344	115866	0	124860
17108	3805	1459	2432	121512	0	129208
17109	3464	1210	2479	122133	0	129286
17110	3191	1295	114945	7593	0	127024
17111	3303	113471	5390	4560	0	126724
17112	3530	4542	3298	115999	0	127369
17113	115420	2444	2524	6352	0	126740
17114	6353	1719	2355	116749	0	127176
17115	4182	1470	2259	119049	0	126960
17116	3180	1600	114053	7675	0	126508
17117	3073	1644	110856	4928	0	120501
17118	2839	109295	6237	3747	0	122118
17119	2580	113827	3512	3401	0	123320
17120	2691	5570	2329	111267	0	121857
17121	109784	3015	1988	6422	0	121209
17122	5479	2294	107875	4231	0	119879
17123	3518	106646	4591	3211	0	117966
17124	3178	4519	2771	99137	0	109605
17125	2223	102322	1832	4680	0	111057
17126	2382	4687	1496	95998	0	104563
17127	1942	99488	1475	4846	0	107751
17128	2310	4081	1264	92873	0	100528
17129	88835	2418	1257	4384	0	96894
17130	3249	81718	1266	2496	0	88729
17131	1566	3076	737	70415	0	75794
17132	68512	1666	713	2866	0	73757
17133	2376	68392	651	1837	0	73256
17134	1239	64509	619	1418	0	67785
17135	1222	66132	599	1264	0	69217
17136	1108	2164	962	61786	0	66020
17137	645	1347	504	61196	0	63692
17138	491	61146	363	1959	0	63959
17139	660	1851	395	61053	0	63959
17140	776	1058	61550	1734	0	65118
17141	495	60473	1079	876	0	62923
17142	535	3519	461	54745	0	59260
17143	403	58626	388	1117	0	60534
17144	427	1144	55696	621	0	57888
17145	308	55421	829	467	0	57025
17146	48839	889	487	468	0	50683
17147	578	217	86	48909	0	49790
17148	48537	109	65	626	0	49337
17149	481	130	48214	202	0	49027
17150	274	90	436	48533	0	49333
17151	109	147	49326	482	0	50064
17152	205	87	491	48695	0	49478
17153	50211	79	180	720	0	51190
17154	580	72	97	50104	0	50853
17155	49798	88	81	748	0	50715
17156	446	50963	92	273	0	51774
17157	50090	474	90	339	0	50993
17158	488	192	51346	152	0	52178
17159	183	50905	469	143	0	51700
17160	237	416	164	50730	0	51547
17161	245	151	89	50481	0	50966
17162	114	160	49634	557	0	50465
17163	105	49244	434	261	0	50044
17164	185	439	146	48933	0	49703
17165	67	49996	134	403	0	50600
17166	179	477	57	48407	0	49120
17167	56	49492	69	484	0	50101
17168	48429	475	58	350	0	49312
17169	477	191	61	49106	0	49835
17170	159	139	48415	440	0	49153
17171	77	47990	369	240	0	48676
17172	38	49662	129	167	0	49996
17173	95	518	48953	104	0	49670
17174	61	49301	391	89	0	49842
17175	152	404	126	48899	0	49581
17176	66	171	49951	383	0	50571
17177	171	102	386	48646	0	49305
17178	130	90	139	50255	0	50614
17179	37	118	50113	472	0	50740
17180	46018	108	427	405	0	46958
17181	446	85	134	50449	0	51114
17182	160	99	52834	423	0	53516
17183	88	53046	423	208	0	53765
17184	53145	383	155	359	0	54042
17185	388	53614	134	134	0	54270
17186	228	438	80	54235	0	54981
17187	53700	149	70	656	0	54575
17188	496	102	81	53642	0	54321
17189	177	109	56014	493	0	56793
17190	237	96	500	54866	0	55699
17191	96	119	55722	518	0	56455
17192	52201	104	533	492	0	53330
17193	547	114	55772	161	0	56594
17194	54500	81	540	362	0	55483
17195	55491	74	213	384	0	56162
17196	661	90	56030	137	0	56918
17197	297	99	53184	175	0	53755
17198	138	55930	708	126	0	56902
17199	57713	526	287	248	0	58774
17200	670	207	175	58385	0	59437
17201	412	128	126	57840	0	58506
17202	62547	70	131	1151	0	63899
17203	63239	95	139	606	0	64079
17204	63545	84	140	373	0	64142
17205	63568	98	126	305	0	64097
17206	909	107	101	62329	0	63446
17207	62971	87	113	843	0	64014
17208	765	84	101	63160	0	64110
17209	433	105	108	62912	0	63558
17210	331	78	103	63989	0	64501
17211	229	147	62466	837	0	63679
17212	217	60263	588	432	0	61500
17213	208	62186	257	248	0	62899
17214	243	649	157	63293	0	64342
17215	63166	271	92	819	0	64348
17216	683	139	94	63141	0	64057
17217	62534	93	127	950	0	63704
17218	710	133	63876	354	0	65073
17219	61076	166	614	446	0	62302
17220	746	138	243	65011	0	66138
17221	66561	130	162	963	0	67816
17222	66190	106	89	589	0	66974
17223	67363	99	97	489	0	68048
17224	1034	98	128	67164	0	68424
17225	429	152	66366	747	0	67694
17226	399	116	737	66000	0	67252
17227	67392	110	281	1035	0	68818
17228	913	129	77177	365	0	78584
17229	677	122	818	82697	0	84314
17230	86867	85	339	1415	0	88706
17231	1220	126	88930	487	0	90763
17232	90950	101	1173	720	0	92944
17233	97655	123	424	529	0	98731
17234	1996	85	290	98495	0	100866
17235	960	110	209	100805	0	102084
17236	100092	63	182	2223	0	102560
17237	1921	84	195	104234	0	106434
17238	102297	83	182	2529	0	105091
17239	2041	103647	195	885	0	106768
17240	747	105999	156	542	0	107444
17241	812	2155	145	104910	0	108022
17242	402	782	108633	1922	0	111739
17243	359	108358	1867	777	0	111361
17244	105433	1950	632	949	0	108964
17245	1878	105963	383	383	0	108607
17246	692	2080	105875	263	0	108910
17247	852	699	1822	102760	0	106133
17248	360	578	107434	1981	0	110353
17249	278	110872	2033	754	0	113937
17250	617	1862	647	108349	0	111475
17251	304	110788	459	1653	0	113204
17252	315	2064	110527	583	0	113489
17253	545	743	1876	108073	0	111237
17254	255	553	111884	1982	0	114674
17255	509	325	2121	109157	0	112112
17256	110227	271	762	2598	0	113858
17257	1979	359	109552	829	0	112719
17258	100555	261	2043	1035	0	103894
17259	2161	294	108386	457	0	111298
17260	1063	206	2220	106758	0	110247
17261	599	250	115103	2129	0	118081
17262	797	221	2197	113230	0	116445
17263	716	210	870	116634	0	118430
17264	742	205	621	114322	0	115890
17265	631	196	482	117725	0	119034
17266	416	256	123185	2876	0	126733
17267	116574	187	2082	2046	0	120889
17268	2239	183	815	131852	0	135089
17269	130439	176	627	2810	0	134052
17270	131688	191	488	1457	0	133824
17271	134168	164	390	1325	0	136047
17272	3058	183	425	136182	0	139848
17273	1488	226	400	134741	0	136855
17274	814	137319	419	2594	0	141146
17275	139095	1955	366	1652	0	143068
17276	139731	655	346	1436	0	142168
17277	139331	451	334	1298	0	141414
17278	3149	396	143895	654	0	148094
17279	1714	272	2135	142742	0	146863
17280	980	377	144206	2444	0	148007
17281	136879	266	2402	1574	0	141121
17282	144514	272	951	1279	0	147016
17283	3214	233	630	143165	0	147242
17284	1747	247	523	142084	0	144601
17285	1034	147858	489	2669	0	152050
17286	147875	2003	477	1854	0	152209
17287	149303	719	464	1460	0	151946
17288	2947	148977	505	767	0	153196
17289	150302	1980	423	1246	0	153951
17290	2983	699	365	152643	0	156690
17291	1418	536	429	154688	0	157071
17292	154364	376	378	3535	0	158653
17293	2634	410	156456	1323	0	160823
17294	150260	311	2051	1749	0	154371
17295	158030	269	773	1392	0	160464
17296	2890	157244	655	774	0	161563
17297	157457	1969	426	1307	0	161159
17298	2903	816	157303	734	0	161756
17299	1558	575	2107	156740	0	160980
17300	158073	400	776	2794	0	162043
17301	2857	357	586	158288	0	162088
17302	1300	502	153460	2628	0	157890
17303	1465	330	2088	147563	0	151446
17304	890	173084	891	2641	0	177506
17305	1041	2148	673	178510	0	182372
17306	1132	776	560	182409	0	184877
17307	1182	577	511	178074	0	180344
17308	1028	385	502	183270	0	185185
17309	812	491	181528	3363	0	186194
17310	994	365	2297	179128	0	182784
17311	180881	290	864	3789	0	185824
17312	2483	181203	770	1513	0	185969
17313	1363	2146	484	186006	0	189999
17314	1032	828	187147	2914	0	191921
17315	1057	530	2325	186373	0	190285
17316	188118	365	916	3889	0	193288
17317	186938	282	714	2278	0	190212
17318	184888	330	512	1933	0	187663
17319	3654	279	484	188267	0	192684
17320	1659	343	188330	2818	0	193150
17321	1186	186243	2223	1535	0	191187
17322	187567	2011	883	1922	0	192383
17323	2880	717	632	187166	0	191395
17324	1686	652	491	188473	0	191302
17325	1236	523	188804	2954	0	193517
17326	1033	183739	2139	1547	0	188458
17327	859	192115	866	1198	0	195038
17328	1316	3053	837	181866	0	187072
17329	803	905	176088	2272	0	180068
17330	152821	516	1793	2178	0	157308
17331	2203	430	168796	820	0	172249
17332	147300	250	1369	1877	0	150796
17333	1804	171368	636	644	0	174452
17334	887	1308	168880	494	0	171569
17335	156927	495	1286	1293	0	160001
17336	1545	166819	611	524	0	169499
17337	168896	841	281	1363	0	171381
17338	1240	473	172699	310	0	174722
17339	530	173369	832	370	0	175101
17340	172223	781	427	1129	0	174560
17341	1055	461	171587	328	0	173431
17342	165762	186	769	856	0	167573
17343	1074	172	411	170586	0	172243
17344	171808	153	236	1439	0	173636
17345	1072	155	204	172750	0	174181
17346	171225	146	183	1704	0	173258
17347	1056	260	175713	488	0	177517
17348	812	131	882	174964	0	176789
17349	606	138	360	175228	0	176332
17350	383	272	178054	1232	0	179941
17351	696	127	1064	179901	0	181788
17352	1299	128616	2086	2235	0	134236
17353	615	1343	262	200391	0	202611
17354	864	402	256	214560	0	216082
17355	979	243	206	232475	0	233903
17356	393	313	231413	4310	0	236429
17357	208477	184	3578	2753	0	214992
17358	4531	158	1130	240262	0	246081
17359	1438	323	247084	4145	0	252990
17360	229737	176	4378	2701	0	236992
17361	246141	152	1410	1989	0	249692
17362	253395	191	783	1651	0	256020
17363	7139	189	473	249457	0	257258
17364	3375	173	454	275802	0	279804
17365	2450	291	457	269349	0	272547
17366	927	270222	524	7200	0	278873
17367	265356	5509	465	3892	0	275222
17368	270795	1665	476	2540	0	275476
17369	8570	802	441	264647	0	274460
17370	3065	604	263268	6491	0	273428
17371	1887	509	261961	2818	0	267175
17372	1219	260739	7409	2004	0	271371
17373	2657	6157	2765	255978	0	267557
17374	260787	1789	1239	7181	0	270996
17375	6473	264137	907	3004	0	274521
17376	272073	6118	826	2803	0	281820
17377	274013	2075	834	2591	0	279513
17378	275075	1169	814	2389	0	279447
17379	10511	822	796	271704	0	283833
17380	5334	837	712	293121	0	300004
17381	295147	655	638	10669	0	307109
17382	10277	592	643	299386	0	310898
17383	3875	799	298540	9309	0	312523
17384	295691	695	7887	4388	0	308661
17385	10203	702	2584	298825	0	312314
17386	5056	847	1310	305272	0	312485
17387	4054	694	896	311306	0	316950
17388	2541	913	300063	11639	0	315156
17389	270707	851	8180	6485	0	286223
17390	9842	646	298303	3130	0	311921
17391	5407	572	8945	293118	0	308042
17392	3049	763	301826	9555	0	315193
17393	3554	609	9259	290056	0	303478
17394	3387	607	3432	301707	0	309133
17395	2606	676	305734	12012	0	321028
17396	4068	805	9288	274472	0	288633
17397	2395	305186	3768	9634	0	320983
17398	303051	8143	2204	5655	0	319053
17399	310581	2493	1700	4968	0	319742
17400	12758	1267	1661	306205	0	321891
17401	5070	878	309339	11029	0	326316
17402	3321	294274	9598	5569	0	312762
17403	2726	315137	3921	4156	0	325940
17404	290402	9927	2855	4224	0	307408
17405	10308	3598	286788	3440	0	304134
17406	282963	1860	9589	3923	0	298335
17407	11752	1183	3908	284212	0	301055
17408	5684	1221	2660	292677	0	302242
17409	277505	1259	2383	13780	0	294927
17410	10141	280637	2182	6780	0	299740
17411	4857	8858	283505	4425	0	301645
17412	5224	2970	9515	275916	0	293625
17413	3311	1934	285026	11265	0	301536
17414	2853	280312	10504	6015	0	299684
17415	4029	8730	4641	282484	0	299884
17416	279755	3663	2970	12173	0	298561
17417	285712	2381	2718	6644	0	297455
17418	12902	2163	280005	4530	0	299600
17419	6007	279363	10217	3865	0	299452
17420	276592	9127	4363	4472	0	294554
17421	11124	281521	3060	4150	0	299855
17422	6572	9949	2534	277991	0	297046
17423	278371	3964	2327	11766	0	296428
17424	11689	2895	2415	281134	0	298133
17425	5645	2378	275927	12007	0	295957
17426	5325	1968	9846	277711	0	294850
17427	3886	2458	277633	12167	0	296144
17428	4631	2220	10606	274396	0	291853
17429	274475	1769	4600	13543	0	294387
17430	11236	277933	3493	6797	0	299459
17431	279880	9546	3184	5572	0	298182
17432	12615	4083	3095	276990	0	296783
17433	6423	3143	2908	281213	0	293687
17434	5055	2999	237898	14473	0	260425
17435	4189	2579	273711	7228	0	287707
17436	4075	273397	11715	5695	0	294882
17437	4610	9698	271445	4796	0	290549
17438	251300	3843	11604	5781	0	272528
17439	11251	263281	5598	4946	0	285076
17440	5606	272126	4236	4900	0	286868
17441	4283	277243	3753	4710	0	289989
17442	4625	13129	2949	266980	0	287683
17443	4084	5491	270093	12031	0	291699
17444	3672	272259	10920	6575	0	293426
17445	5055	10791	4854	248066	0	268766
17446	3639	275017	3846	11075	0	293577
17447	267918	11225	3252	6676	0	289071
17448	274581	4682	3518	5550	0	288331
17449	13483	3465	3602	267573	0	288123
17450	7058	3295	3287	270068	0	283708
17451	252012	2813	3055	13768	0	271648
17452	10515	245453	3062	6943	0	265973
17453	5136	247475	2734	4920	0	260265
17454	4999	10964	2197	221407	0	239567
17455	2508	3941	208195	8439	0	223083
17456	2226	207117	7103	4743	0	221189
17457	196766	7007	3969	3748	0	211490
17458	6554	193931	2621	2931	0	206037
17459	3132	195787	2008	2693	0	203620
17460	184281	7785	2161	2677	0	196904
17461	6473	190974	1639	2309	0	201395
17462	3295	6881	185883	2092	0	198151
17463	2384	186767	5759	2418	0	197328
17464	160104	5149	2549	1696	0	169498
17465	4413	162390	1323	1283	0	169409
17466	161134	4973	1424	1371	0	168902
17467	5082	2483	886	159512	0	167963
17468	2610	1702	935	164504	0	169751
17469	1639	1745	162943	5095	0	171422
17470	1459	164306	3926	2355	0	172046
17471	1776	4434	1512	166586	0	174308
17472	164938	2069	1156	4856	0	173019
17473	164925	1593	963	2556	0	170037
17474	4906	167547	970	1904	0	175327
17475	2459	4333	968	165740	0	173500
17476	165558	1984	851	4628	0	173021
17477	166474	1592	908	2415	0	171389
17478	5324	1430	158418	1462	0	166634
17479	2395	1240	146093	1105	0	150833
17480	1611	1049	142612	795	0	146067
17481	904	138186	3046	754	0	142890
17482	131161	2596	2604	943	0	137304
17483	2461	131589	853	648	0	135551
17484	129453	2566	882	879	0	133780
17485	2639	134412	565	563	0	138179
17486	1379	2604	521	136393	0	140897
17487	137437	1084	472	2765	0	141758
17488	2621	904	138621	950	0	143096
17489	133188	768	2228	1091	0	137275
17490	139213	689	807	908	0	141617
17491	3080	138577	539	634	0	142830
17492	1193	140762	439	512	0	142906
17493	142860	2635	737	844	0	147076
17494	2641	1057	146107	436	0	150241
17495	133722	1169	2323	887	0	138101
17496	138014	515	842	622	0	139993
17497	2895	458	370	135577	0	139300
17498	138808	437	266	2188	0	141699
17499	2688	524	233	141149	0	144594
17500	1354	445	239	144716	0	146754
17501	1164	420	273	139923	0	141780
17502	756	141469	369	2336	0	144930
17503	141701	1946	290	1362	0	145299
17504	143523	760	300	960	0	145543
17505	2866	580	310	142967	0	146723
17506	1520	522	291	140634	0	142967
17507	917	142924	328	2309	0	146478
17508	141676	2114	295	1358	0	145443
17509	2420	969	141571	671	0	145631
17510	1467	731	1855	142211	0	146264
17511	1019	596	141560	2116	0	145291
17512	1167	515	1999	140267	0	143948
17513	823	606	141784	2342	0	145555
17514	1091	536	2061	137009	0	140697
17515	138044	511	772	2778	0	142105
17516	2469	541	140169	999	0	144178
17517	131563	410	2177	1381	0	135531
17518	2582	142936	934	784	0	147236
17519	1393	2060	682	144694	0	148829
17520	1236	833	539	147261	0	149869
17521	150103	675	535	3057	0	154370
17522	2786	582	436	157508	0	161312
17523	1436	687	162252	2477	0	166852
17524	157523	552	1731	2119	0	161925
17525	168285	500	697	1549	0	171031
17526	168525	482	545	1420	0	170972
17527	167987	432	437	1431	0	170287
17528	3202	166636	522	889	0	171249
17529	1651	1820	431	166072	0	169974
17530	165058	690	436	2597	0	168781
17531	2759	563	466	163752	0	167540
17532	161283	527	433	2619	0	164862
17533	2709	510	158885	936	0	163040
17534	1490	570	157805	810	0	160675
17535	1663	1849	1991	148684	0	154187
17536	994	155341	884	1979	0	159198
17537	909	162623	649	1303	0	165484
17538	156443	1883	663	1810	0	160799
17539	2168	769	159582	885	0	163404
17540	140835	485	1654	1610	0	144584
17541	2170	156985	849	713	0	160717
17542	157948	1481	546	1083	0	161058
17543	2355	698	431	156564	0	160048
17544	1224	810	160450	1920	0	164404
17545	1413	521	1566	157956	0	161456
17546	1295	404	658	157782	0	160139
17547	942	157485	628	2157	0	161212
17548	839	164879	545	1196	0	167459
17549	1148	1873	440	163476	0	166937
17550	903	166020	538	2164	0	169625
17551	909	1831	163162	1020	0	166922
17552	1048	758	156626	976	0	159408
17553	146217	585	1985	1622	0	150409
17554	161654	508	859	1453	0	164474
17555	2406	161125	576	772	0	164879
17556	1452	1745	499	160287	0	163983
17557	1182	674	468	162568	0	164892
17558	934	690	161902	2220	0	165746
17559	1297	425	1792	150970	0	154484
17560	778	159107	843	2095	0	162823
17561	816	1781	155903	1056	0	159556
17562	943	833	153840	881	0	156497
17563	987	145822	2057	1074	0	149940
17564	950	1927	154991	765	0	158633
17565	1175	776	1934	151489	0	155374
17566	1723	733	1043	134759	0	138258
17567	807	697	156133	2306	0	159943
17568	1203	619	1869	150747	0	154438
17569	669	148918	952	2265	0	152804
17570	651	156211	745	1213	0	158820
17571	820	2106	589	151780	0	155295
17572	618	771	152869	2095	0	156353
17573	522	153560	1986	965	0	157033
17574	1088	2116	847	151913	0	155964
17575	487	650	150059	1717	0	152913
17576	135078	469	1648	1411	0	138606
17577	147224	373	539	1252	0	149388
17578	148334	363	468	1013	0	150178
17579	2046	365	409	146489	0	149309
17580	971	304	383	147423	0	149081
17581	602	316	152056	1890	0	154864
17582	933	230	1638	147825	0	150626
17583	867	337	574	151797	0	153575
17584	451	368	152094	1966	0	154879
17585	124165	239	1578	2116	0	128098
17586	1448	143108	573	661	0	145790
17587	142156	1349	418	1140	0	145063
17588	1475	142048	381	565	0	144469
17589	749	1509	315	142433	0	145006
17590	512	584	142865	1505	0	145466
17591	951	559	1470	136230	0	139210
17592	392	493	139424	1695	0	142004
17593	114032	275	1480	1777	0	117564
17594	1346	298	133731	486	0	135861
17595	738	182	1573	128040	0	130533
17596	345	240	134304	1570	0	136459
17597	288	137017	1679	687	0	139671
17598	859	1596	649	140484	0	143588
17599	860	468	467	140498	0	142293
17600	738	271	360	150410	0	151779
17601	367	366	150083	2916	0	153732
17602	311	333	153113	1091	0	154848
17603	715	234	2979	152152	0	156080
17604	897	193	1021	182109	0	184220
17605	828	196	659	195426	0	197109
17606	196598	154	502	6774	0	204028
17607	4980	185	529	203900	0	209594
17608	1956	337	209394	5572	0	217259
17609	210285	210	5008	3308	0	218811
17610	6015	263	2297	220513	0	229088
17611	225697	244	1501	6854	0	234296
17612	231399	195	750	3836	0	236180
17613	8579	159	686	230864	0	240288
17614	232435	133	795	7279	0	240642
17615	234491	146	702	4228	0	239567
17616	8466	265	232741	2194	0	243666
17617	4131	235099	5690	1683	0	246603
17618	3564	5202	2558	226200	0	237524
17619	2593	2224	1381	239634	0	245832
17620	236188	1042	845	8882	0	246957
17621	233264	559	875	4890	0	239588
17622	230926	416	838	3398	0	235578
17623	9530	499	213256	1999	0	225284
17624	4714	215415	5973	1849	0	227951
17625	216072	5530	2848	2251	0	226701
17626	7248	218659	1704	1623	0	229234
17627	220519	6449	1000	2134	0	230102
17628	8727	2793	825	217950	0	230295
17629	219665	1528	964	7204	0	229361
17630	222588	1063	841	4063	0	228555
17631	224526	810	890	2915	0	229141
17632	10263	966	217268	1899	0	230396
17633	219328	664	5567	2657	0	228216
17634	8763	222505	2681	1848	0	235797
17635	230084	5927	1474	2079	0	239564
17636	233194	2740	1040	2302	0	239276
17637	236630	1614	1060	2027	0	241331
17638	12239	1067	1040	220884	0	235230
17639	6271	227471	1007	6434	0	241183
17640	229313	6528	956	3803	0	240600
17641	9347	3160	226918	2353	0	241778
17642	5686	228583	6193	1948	0	242410
17643	5848	6688	2741	206921	0	222198
17644	3988	226985	1754	5656	0	238383
17645	226072	7533	1322	3476	0	238403
17646	235006	3613	1181	2558	0	242358
17647	11489	2328	1108	229389	0	244314
17648	6387	1869	223610	7597	0	239463
17649	4487	224024	6626	4397	0	239534
17650	6439	7300	3377	187799	0	204915
17651	4748	3547	2093	228811	0	239199
17652	4341	2212	1671	239624	0	247848
17653	235262	1755	1400	11447	0	249864
17654	239801	1588	1409	6041	0	248839
17655	241754	1703	1297	4284	0	249038
17656	245064	1568	1238	3605	0	251475
17657	13656	1583	1142	236057	0	252438
17658	7693	1577	238816	9033	0	257119
17659	6476	1302	7168	241633	0	256579
17660	5908	1217	3364	245659	0	256148
17661	5712	1163	2044	247354	0	256273
17662	5997	1294	1554	249763	0	258608
17663	242497	1312	1510	13380	0	258699
17664	11315	1248	1997	244296	0	258856
17665	243707	1104	1748	11470	0	258029
17666	246673	1220	1611	7610	0	257114
17667	13940	1464	235496	5434	0	256334
17668	9297	1347	231386	4651	0	246681
17669	7420	1176	240864	4630	0	254090
17670	7167	1396	10081	233784	0	252428
17671	6582	1476	240881	9403	0	258342
17672	6452	1414	8842	235887	0	252595
17673	5641	1920	4716	241617	0	253894
17674	241857	1688	3041	12837	0	259423
17675	11593	1615	2292	237705	0	253205
17676	8055	244867	2356	10709	0	265987
17677	251468	7039	2381	7073	0	267961
17678	12023	252736	2226	4975	0	271960
17679	7948	8281	254436	4179	0	274844
17680	6103	259335	8001	4022	0	277461
17681	254981	8881	4403	4253	0	272518
17682	11967	4887	2787	253570	0	273211
17683	8474	3385	251540	8904	0	272303
17684	251994	2508	7798	6142	0	268442
17685	12608	2385	4249	253852	0	273094
17686	8595	2322	254059	9164	0	274140
17687	7654	2261	8029	254481	0	272425
17688	6591	2135	4619	259132	0	272477
17689	6606	2218	3016	256600	0	268440
17690	5866	256070	2515	11627	0	276078
17691	260237	7945	2204	7028	0	277414
17692	12316	4472	2173	253682	0	272643
17693	8030	256895	2047	9343	0	276315
17694	6798	8200	1737	258893	0	275628
17695	5444	5171	255609	9989	0	276213
17696	5367	257819	7584	6167	0	276937
17697	252971	8003	4514	5384	0	270872
17698	253165	4879	2824	4339	0	265207
17699	11876	3099	2032	245462	0	262469
17700	7190	2743	1839	248273	0	260045
17701	244518	2121	1823	11178	0	259640
17702	237236	2037	1843	7076	0	248192
17703	10780	237832	1827	5064	0	255503
17704	207134	4939	1273	3220	0	216566
17705	6772	2146	197298	2282	0	208498
17706	3625	1557	192306	2219	0	199707
17707	2523	188323	4807	2058	0	197711
17708	1895	191241	2370	1717	0	197223
17709	178152	4078	3443	1886	0	187559
17710	3554	179644	1028	1148	0	185374
17711	177375	3256	831	1555	0	183017
17712	175178	1345	751	1547	0	178821
17713	173148	873	743	1549	0	176313
17714	4593	803	615	169141	0	175152
17715	171743	681	590	3838	0	176852
17716	3994	784	167967	1606	0	174351
17717	2119	770	166625	1231	0	170745
17718	1642	167265	3400	1231	0	173538
17719	1402	2775	170509	1072	0	175758
17720	1785	1294	3145	162868	0	169092
17721	1166	928	170183	3314	0	175591
17722	1254	884	167986	1578	0	171702
17723	1464	700	3651	167762	0	173577
17724	169230	770	1669	3743	0	175412
17725	169648	733	1154	2109	0	173644
17726	3918	771	172774	1164	0	178627
17727	165530	605	3083	1939	0	171157
17728	3630	594	174864	1025	0	180113
17729	169724	500	3401	1674	0	175299
17730	180757	477	1582	1768	0	184584
17731	4449	495	1130	178889	0	184963
17732	2536	563	965	174270	0	178334
17733	1637	169324	1049	3717	0	175727
17734	1318	177510	970	1792	0	181590
17735	1665	3118	968	171573	0	177324
17736	1666	1300	831	174068	0	177865
17737	168372	828	678	3930	0	173808
17738	3031	168741	792	1616	0	174180
17739	166054	2690	701	1806	0	171251
17740	3043	169669	834	1027	0	174573
17741	1617	3099	168157	804	0	173677
17742	1811	1295	2680	166978	0	172764
17743	168802	785	1162	3667	0	174416
17744	178154	697	717	2181	0	181749
17745	4400	181833	739	1148	0	188120
17746	1891	184408	617	870	0	187786
17747	1276	189865	665	733	0	192539
17748	1795	4884	683	192408	0	199770
17749	1122	1733	194040	4130	0	201025
17750	901	192548	3997	1524	0	198970
17751	1800	4147	1369	188829	0	196145
17752	1409	1369	658	193257	0	196693
17753	771	1085	190691	4392	0	196939
17754	822	850	186483	1636	0	189791
17755	179319	577	4549	1952	0	186397
17756	4194	684	194039	758	0	199675
17757	187762	629	4121	1450	0	193962
17758	187485	601	1469	1323	0	190878
17759	188438	589	880	1349	0	191256
17760	186860	613	804	1355	0	189632
17761	5185	711	181768	647	0	188311
17762	2041	183098	3825	707	0	189671
17763	2108	3839	1532	179152	0	186631
17764	1261	1486	184374	3827	0	190948
17765	1939	941	3959	175366	0	182205
17766	1458	159486	2160	4109	0	167213
17767	1930	3937	1087	186260	0	193214
17768	1798	1445	954	188499	0	192696
17769	1892	995	850	184336	0	188073
17770	184637	746	823	5806	0	192012
17771	5076	746	901	183561	0	190284
17772	2580	702	861	184624	0	188767
17773	1914	790	930	181750	0	185384
17774	1063	176176	1073	5074	0	183386
17775	173497	3837	828	2934	0	181096
17776	4169	165544	914	1664	0	172291
17777	1592	172370	818	1204	0	175984
17778	1938	4406	832	170455	0	177631
17779	1821	1702	701	172121	0	176345
17780	169271	999	686	5917	0	176873
17781	5118	788	698	171952	0	178556
17782	173102	669	710	5621	0	180102
17783	209194	796	672	2791	0	213453
17784	8804	890	696	205219	0	215609
17785	4459	766	757	203497	0	209479
17786	1858	210017	778	8710	0	221363
17787	214118	6901	736	4572	0	226327
17788	7479	222900	802	2418	0	233599
17789	221577	8252	726	2257	0	232812
17790	8817	3597	216769	1629	0	230812
17791	215110	1906	6904	2473	0	226393
17792	231032	1248	2815	2486	0	237581
17793	11659	1169	1449	220506	0	234783
17794	5057	1350	222938	8276	0	237621
17795	2843	222569	7867	4228	0	237507
17796	3555	8494	3243	224674	0	239966
17797	2261	3640	226348	9007	0	241256
17798	3117	2107	8262	222362	0	235848
17799	218664	1196	3491	10244	0	233595
17800	9481	1139	219375	4412	0	234407
17801	4482	213183	8345	2814	0	228824
17802	2885	225107	3792	2112	0	233896
17803	4710	10779	2127	184372	0	201988
17804	2225	221392	1585	6513	0	231715
17805	218291	9326	1448	4174	0	233239
17806	222004	4145	1206	3239	0	230594
17807	224292	2462	1318	2778	0	230850
17808	11642	2006	211695	2034	0	227377
17809	216109	1889	8054	2550	0	228602
17810	10564	1900	3440	212357	0	228261
17811	5661	1653	1967	218203	0	227484
17812	4132	1683	1344	220772	0	227931
17813	3603	1524	1475	221577	0	228179
17814	2704	1686	213360	12390	0	230140
17815	2461	1751	214244	5947	0	224403
17816	2395	1606	215729	3790	0	223520
17817	199236	1514	11224	3673	0	215647
17818	9410	207035	4837	2986	0	224268
17819	5581	8496	2468	203921	0	220466
17820	202036	3860	1683	10278	0	217857
17821	9224	204773	1910	5225	0	221132
17822	4896	214022	2043	3516	0	224477
17823	206180	10929	1939	3097	0	222145
17824	210520	4858	1714	3082	0	220174
17825	11921	210113	1793	2751	0	226578
17826	7154	8941	1523	191142	0	208760
17827	4132	208714	1468	8606	0	222920
17828	206845	9518	1500	4949	0	222812
17829	207060	4758	1652	3690	0	217160
17830	207482	3331	1346	2989	0	215148
17831	12893	199300	1525	2669	0	216387
17832	6920	8980	1378	200642	0	217920
17833	4088	4665	199836	9681	0	218270
17834	4248	3086	8165	197715	0	213214
17835	4188	2684	3664	205185	0	215721
17836	3529	2662	196969	11803	0	214963
17837	192822	2262	8309	6241	0	209634
17838	10623	2301	3803	197994	0	214721
17839	5972	2531	2278	194650	0	205431
17840	4042	195147	1755	11528	0	212472
17841	193766	8667	1619	6231	0	210283
17842	10784	4586	1570	186720	0	203660
17843	5575	189299	1796	9448	0	206118
17844	177407	7872	1630	5298	0	192207
17845	8586	178480	1502	3721	0	192289
17846	170461	8125	1387	3286	0	183259
17847	9222	3968	167473	2897	0	183560
17848	4705	2707	156283	2503	0	166198
17849	3341	1818	158778	2166	0	166103
17850	2555	157820	9417	2256	0	172048
17851	3514	7109	5202	139285	0	155110
17852	2924	154925	2277	5904	0	166030
17853	156228	7720	1733	3834	0	169515
17854	7596	4086	157171	2359	0	171212
17855	154035	2716	6816	2353	0	165920
17856	160574	2241	3784	2021	0	168620
17857	9852	2070	2593	154459	0	168974
17858	158415	2133	1702	6967	0	169217
17859	9232	1737	1706	157903	0	170578
17860	4621	2057	156338	7546	0	170562
17861	152101	2019	6691	4350	0	165161
17862	7536	155696	3942	2674	0	169848
17863	4954	6753	2341	155756	0	169804
17864	157728	3664	1651	7103	0	170146
17865	8372	2458	1533	157676	0	170039
17866	5043	1837	154256	7867	0	169003
17867	3713	1690	6529	151017	0	162949
17868	2782	154815	3762	7399	0	168758
17869	156800	6554	2132	4251	0	169737
17870	7935	3595	1497	156310	0	169337
17871	158717	2291	1460	7781	0	170249
17872	8790	1645	1284	158113	0	169832
17873	4911	1395	1403	153699	0	161408
17874	3285	155301	1646	8617	0	168849
17875	153389	6568	1349	5100	0	166406
17876	7389	161124	1360	3353	0	173226
17877	4763	6877	1117	144163	0	156920
17878	2622	151343	1107	6408	0	161480
17879	149024	6555	979	3992	0	160550
17880	147454	3451	964	3205	0	155074
17881	147588	2404	915	2723	0	153630
17882	8846	139324	1172	2101	0	151443
17883	1967	106457	461	909	0	109794
17884	104456	3321	495	1104	0	109376
17885	3223	106911	411	941	0	111486
17886	2138	3899	703	100197	0	106937
17887	1224	1117	98510	2312	0	103163
17888	89828	708	1577	1303	0	93416
17889	93437	515	519	969	0	95440
17890	92734	519	308	707	0	94268
17891	2321	92650	239	442	0	95652
17892	88258	1496	156	601	0	90511
17893	1873	670	91817	272	0	94632
17894	708	90886	1047	273	0	92914
17895	592	1486	383	85697	0	88158
17896	238	87754	250	583	0	88825
17897	83866	715	157	481	0	85219
17898	684	86809	96	184	0	87773
17899	366	677	67	86931	0	88041
17900	231	88297	102	588	0	89218
17901	317	692	105	90582	0	91696
17902	320	231	88	89083	0	89722
17903	219	258	89872	713	0	91062
17904	338	144	605	86380	0	87467
17905	86667	161	193	1009	0	88030
17906	86451	147	147	535	0	87280
17907	889	150	106	87431	0	88576
17908	415	202	87112	681	0	88410
17909	404	161	613	85382	0	86560
17910	85815	157	217	1066	0	87255
17911	87833	139	174	724	0	88870
17912	88835	159	105	594	0	89693
17913	928	93610	125	255	0	94918
17914	93945	633	101	627	0	95306
17915	820	328	93417	220	0	94785
17916	100016	202	713	821	0	101752
17917	1064	160	271	104551	0	106046
17918	589	128	207	105676	0	106600
17919	479	158	96	107330	0	108063
17920	105441	159	77	1507	0	107184
17921	103694	134	113	852	0	104793
17922	1240	136	103	104798	0	106277
17923	611	233	106125	971	0	107940
17924	609	132	788	104355	0	105884
17925	508	152	256	103251	0	104167
17926	386	215	102608	1136	0	104345
17927	331	102095	813	602	0	103841
17928	475	822	287	103323	0	104907
17929	105234	320	217	1317	0	107088
17930	1172	245	154	105590	0	107161
17931	628	173	113	106046	0	106960
17932	106283	182	122	1663	0	108250
17933	1047	105165	128	700	0	107040
17934	497	107637	133	460	0	108727
17935	105423	1107	102	784	0	107416
17936	1101	520	106833	328	0	108782
17937	98332	296	894	968	0	100490
17938	1223	287	113875	325	0	115710
17939	512	116202	979	396	0	118089
17940	116471	983	359	777	0	118590
17941	117377	410	189	693	0	118669
17942	117508	287	151	672	0	118618
17943	116908	238	118	778	0	118042
17944	1499	337	116305	235	0	118376
17945	952	224	862	112141	0	114179
17946	114501	196	289	1371	0	116357
17947	1156	258	120439	395	0	122248
17948	653	269	117416	272	0	118610
17949	444	118160	1016	260	0	119880
17950	120888	823	458	552	0	122721
17951	1238	313	234	120172	0	121957
17952	120839	170	188	1396	0	122593
17953	1095	123276	198	392	0	124961
17954	791	976	146	131367	0	133280
17955	657	322	151	131504	0	132634
17956	618	164	134	134984	0	135900
17957	334	228	137217	1853	0	139632
17958	303	138045	1397	805	0	140550
17959	143814	1460	487	909	0	146670
17960	2110	595	277	144642	0	147624
17961	143768	303	173	2410	0	146654
17962	142670	211	171	1240	0	144292
17963	2710	182	186	143156	0	146234
17964	1032	314	145071	1931	0	148348
17965	1042	160	1720	141698	0	144620
17966	479	144095	699	1933	0	147206
17967	762	1668	331	146783	0	149544
17968	459	721	146092	2069	0	149341
17969	140917	289	1749	1435	0	144390
17970	2189	229	668	147116	0	150202
17971	144300	174	462	2558	0	147494
17972	2138	278	143404	954	0	146774
17973	132133	191	1730	1526	0	135580
17974	2177	259	142422	474	0	145332
17975	130910	173	1747	1281	0	134111
17976	2059	137062	789	493	0	140403
17977	948	141624	487	537	0	143596
17978	942	2198	396	140772	0	144308
17979	1305	928	524	126238	0	128995
17980	775	473	308	141880	0	143436
17981	141889	267	248	3025	0	145429
17982	2161	247	272	143921	0	146601
17983	974	358	143664	2136	0	147132
17984	131535	238	1667	2138	0	135578
17985	1901	143635	745	854	0	147135
17986	144372	1700	470	1220	0	147762
17987	141560	716	326	1259	0	143861
17988	2745	478	143307	519	0	147049
17989	1879	300	1915	139385	0	143479
17990	1233	318	832	149941	0	152324
17991	755	422	152830	2694	0	156701
17992	579	151805	2156	1408	0	155948
17993	147324	2113	913	1468	0	151818
17994	147664	830	545	1354	0	150393
17995	3323	529	457	149832	0	154141
17996	1874	349	413	149333	0	151969
17997	1266	326	457	156600	0	158649
17998	151597	363	434	4352	0	156746
17999	2906	156771	435	1709	0	161821
18000	157473	2631	374	1607	0	162085
18001	156743	978	392	1452	0	159565
18002	4103	721	167071	740	0	172635
18003	2426	463	3233	158637	0	164759
18004	1227	169510	1343	3440	0	175520
18005	1614	3383	706	171379	0	177082
18006	1540	1419	517	178471	0	181947
18007	1017	811	182761	5020	0	189609
18008	184482	499	4097	3037	0	192115
18009	204575	457	1604	2349	0	208985
18010	213050	488	943	1970	0	216451
18011	7765	603	674	207456	0	216498
18012	3967	670	562	201531	0	206730
18013	1972	201991	710	6488	0	211161
18014	1486	212851	840	2822	0	217999
18015	206268	6368	643	2350	0	215629
18016	6059	201247	750	1463	0	209519
18017	2666	5845	200716	1336	0	210563
18018	2644	2255	5254	200592	0	210745
18019	203470	1333	2013	6663	0	213479
18020	6195	1181	202369	2711	0	212456
18021	3020	1051	201244	1792	0	207107
18022	201608	777	6869	2104	0	211358
18023	206662	898	2733	1902	0	212195
18024	8565	787	1616	201686	0	212654
18025	3653	884	202479	6472	0	213488
18026	3164	957	5741	201898	0	211760
18027	2192	1254	188270	6854	0	198570
18028	2094	1124	202755	2976	0	208949
18029	1981	204752	6935	2048	0	215716
18030	204506	5543	3002	2412	0	215463
18031	204830	2255	2005	2450	0	211540
18032	7666	203477	1637	1820	0	214600
18033	4547	6002	1461	199753	0	211763
18034	3448	2350	1575	203488	0	210861
18035	2992	1535	1539	207580	0	213646
18036	201895	1232	1279	8730	0	213136
18037	6706	201941	1293	4017	0	213957
18038	196646	5674	1245	3086	0	206651
18039	197088	2542	1308	2687	0	203625
18040	8222	1629	190447	1988	0	202286
18041	3961	190757	6050	1830	0	202598
18042	3644	5878	2652	190174	0	202348
18043	2554	2704	193807	5922	0	204987
18044	187459	1772	6023	3602	0	198856
18045	196154	1357	2677	2817	0	203005
18046	197060	1210	1822	2554	0	202646
18047	194449	1104	1601	2423	0	199577
18048	9536	1163	1294	186374	0	198367
18049	4563	1119	184891	6406	0	196979
18050	3958	1078	5785	184194	0	195015
18051	183400	1128	2589	7148	0	194265
18052	183426	906	1655	4000	0	189987
18053	8190	177873	1579	2380	0	190022
18054	173206	5012	1249	2188	0	181655
18055	7103	2300	169488	1776	0	180667
18056	3885	1497	169554	1564	0	176500
18057	162873	1336	6524	1924	0	172657
18058	6949	164732	2752	1473	0	175906
18059	4490	4517	1520	150289	0	160816
18060	2898	158198	1257	4471	0	166824
18061	2956	4922	1080	159744	0	168702
18062	2737	2215	1240	162197	0	168389
18063	2541	1568	1143	169082	0	174334
18064	161976	1323	1099	7287	0	171685
18065	168468	1277	1090	3575	0	174410
18066	167509	1283	1156	2449	0	172397
18067	7666	1346	162144	1856	0	173012
18068	162374	996	5255	2032	0	170657
18069	7298	956	2740	166548	0	177542
18070	4452	847	1955	174982	0	182236
18071	3147	1013	173716	7104	0	184980
18072	3523	1040	5800	185330	0	195693
18073	191378	1029	2544	7824	0	202775
18074	7444	1069	190452	3799	0	202764
18075	4353	861	6606	191248	0	203068
18076	191789	810	2924	7931	0	203454
18077	193110	832	2118	4131	0	200191
18078	9331	1046	190072	2533	0	202982
18079	4998	1115	193532	2291	0	201936
18080	4259	939	7874	192745	0	205817
18081	195987	982	3720	7566	0	208255
18082	200149	1079	2199	4205	0	207632
18083	9978	1053	1791	185572	0	198394
18084	4805	194821	1814	7146	0	208586
18085	195920	5821	1854	3942	0	207537
18086	8057	198359	1972	2796	0	211184
18087	5006	6414	1628	196860	0	209908
18088	3766	2459	196509	7175	0	209909
18089	3455	1422	191915	3519	0	200311
18090	3059	1198	194888	2500	0	201645
18091	3442	1104	8334	183963	0	196843
18092	3366	898	3865	190410	0	198539
18093	187164	971	2638	8388	0	199161
18094	7283	186930	2068	4211	0	200492
18095	187123	5510	1820	2936	0	197389
18096	8721	2172	1761	172443	0	185097
18097	4005	177643	1741	5914	0	189303
18098	2947	187333	1528	3174	0	194982
18099	3323	6899	1294	180769	0	192285
18100	178734	2695	1318	6700	0	189447
18101	6518	181543	1441	3332	0	192834
18102	166235	4962	1322	2389	0	174908
18103	5930	171591	1370	1888	0	180779
18104	168054	5405	1431	1863	0	176753
18105	6390	2369	163754	1550	0	174063
18106	3237	1547	160200	1496	0	166480
18107	2512	156250	5054	1098	0	164914
18108	139064	5085	4305	1416	0	149870
18109	3757	130305	1164	787	0	136013
18110	1605	121117	730	721	0	124173
18111	2464	3794	804	122894	0	129956
18112	122982	1376	713	2997	0	128068
18113	2987	124702	727	1187	0	129603
18114	120041	2815	477	1004	0	124337
18115	3066	120847	448	607	0	124968
18116	117442	2915	395	830	0	121582
18117	2872	117682	422	488	0	121464
18118	1285	120073	471	650	0	122479
18119	1538	3288	505	110658	0	115989
18120	781	118096	433	1999	0	121309
18121	115448	2869	347	1098	0	119762
18122	2714	1366	115692	616	0	120388
18123	1622	995	2264	114688	0	119569
18124	913	1117	117404	2461	0	121895
18125	1040	742	2546	115474	0	119802
18126	1026	624	975	118580	0	121205
18127	752	847	112478	3159	0	117236
18128	100112	573	2517	2019	0	105221
18129	2810	109056	1195	1105	0	114166
18130	109801	2516	783	1209	0	114309
18131	3039	111102	763	911	0	115815
18132	1748	2820	592	111019	0	116179
18133	111435	1159	678	3093	0	116365
18134	112155	1000	838	1401	0	115394
18135	113641	737	676	1245	0	116299
18136	3944	919	656	110464	0	115983
18137	2446	769	535	108990	0	112740
18138	1537	113968	685	3002	0	119192
18139	114401	2680	625	2071	0	119777
18140	116696	1234	687	1447	0	120064
18141	116541	1023	772	1176	0	119512
18142	115937	901	676	1188	0	118702
18143	3966	112228	750	995	0	117939
18144	2217	2838	728	112731	0	118514
18145	1514	1594	111401	2830	0	117339
18146	107477	1142	2552	1690	0	112861
18147	115689	1033	873	1444	0	119039
18148	4201	1007	113356	898	0	119462
18149	2318	1061	113959	874	0	118212
18150	1830	1149	3115	112714	0	118808
18151	1478	1088	1379	117183	0	121128
18152	1369	1107	1070	119663	0	123209
18153	116912	1057	766	4106	0	122841
18154	3696	981	715	118013	0	123405
18155	1828	926	115076	3584	0	121414
18156	1662	979	3051	115998	0	121690
18157	1228	994	118090	3730	0	124042
18158	1392	923	3154	116209	0	121678
18159	1477	926	1274	126046	0	129723
18160	1386	958	125534	4132	0	132010
18161	114823	933	3357	2564	0	121677
18162	3644	125709	1510	1414	0	132277
18163	125172	3585	894	1361	0	131012
18164	4314	1686	648	127304	0	133952
18165	126154	1385	503	4212	0	132254
18166	4208	131751	552	1882	0	138393
18167	2067	139221	606	1272	0	143166
18168	2279	6225	592	139080	0	148176
18169	1443	2499	145131	4051	0	153124
18170	1248	1640	138095	1672	0	142655
18171	1076	140888	4776	1446	0	148186
18172	122367	3660	2053	1120	0	129200
18173	3577	1422	1229	121738	0	127966
18174	120454	947	994	3742	0	126137
18175	3721	119241	888	1497	0	125347
18176	1714	124416	749	1085	0	127964
18177	2009	4471	657	121344	0	128481
18178	121804	2059	496	3894	0	128253
18179	123286	1486	297	1887	0	126956
18180	4708	1290	120202	1279	0	127479
18181	2394	1058	115839	983	0	120274
18182	113602	916	3724	1278	0	119520
18183	3831	117080	1846	832	0	123589
18184	116178	3287	1351	936	0	121752
18185	4625	1531	1017	113936	0	121109
18186	2332	1121	111907	3073	0	118433
18187	104714	836	3417	1829	0	110796
18188	3834	108238	1700	1098	0	114870
18189	1939	112726	1235	871	0	116771
18190	2098	4195	1030	108704	0	116027
18191	110839	1939	786	3675	0	117239
18192	4139	1389	775	111389	0	117692
18193	115077	1100	829	4104	0	121110
18194	4297	1260	108631	1804	0	115992
18195	112741	1113	2747	1782	0	118383
18196	117936	933	1029	1574	0	121472
18197	5198	908	112620	1179	0	119905
18198	108285	662	3128	1326	0	113401
18199	4769	108551	1616	1012	0	115948
18200	3158	2985	1323	105743	0	113209
18201	2470	109538	1098	2772	0	115878
18202	111833	3643	990	1373	0	117839
18203	4542	1814	909	106921	0	114186
18204	2388	107052	894	3313	0	113647
18205	2325	3598	734	105633	0	112290
18206	1653	108426	614	3825	0	114518
18207	1831	4042	500	109158	0	115531
18208	109049	2173	542	4346	0	116110
18209	4047	1687	487	109641	0	115862
18210	2219	1418	107588	4371	0	115596
18211	105577	1307	2991	2653	0	112528
18212	4225	1185	1258	109265	0	115933
18213	2257	1179	106907	4267	0	114610
18214	2127	915	102625	2617	0	108284
18215	1899	896	109380	1979	0	114154
18216	2113	690	4885	105186	0	112874
18217	1938	692	2645	110406	0	115681
18218	1691	839	2114	110759	0	115403
18219	1589	770	1801	112227	0	116387
18220	109651	903	1554	5646	0	117754
18221	112230	809	1416	3586	0	118041
18222	113187	891	1187	2947	0	118212
18223	114949	906	999	2729	0	119583
18224	5727	892	913	111447	0	118979
18225	3520	942	114088	4685	0	123235
18226	113506	845	3238	3103	0	120692
18227	120485	935	1557	2422	0	125399
18228	6047	894	1381	117154	0	125476
18229	3833	870	1301	120941	0	126945
18230	122160	796	1188	5506	0	129650
18231	5442	733	1174	115735	0	123084
18232	3122	116456	1264	5081	0	125923
18233	120187	3254	1219	3321	0	127981
18234	119315	1567	1223	2808	0	124913
18235	6026	1316	121181	2321	0	130844
18236	3897	1198	3727	120695	0	129517
18237	3125	1116	1912	126605	0	132758
18238	124802	1015	1556	5833	0	133206
18239	126969	989	1311	3304	0	132573
18240	6497	853	1071	125527	0	133948
18241	4062	855	123655	5063	0	133635
18242	3358	698	125421	3143	0	132620
18243	3193	611	4390	126696	0	134890
18244	3115	746	2258	129658	0	135777
18245	126521	640	1702	5907	0	134770
18246	5299	123167	1545	3336	0	133347
18247	3231	122346	1475	2717	0	129769
18248	2750	128671	1518	2269	0	135208
18249	2646	4411	1450	126151	0	134658
18250	125503	2151	1186	4994	0	133834
18251	125180	1800	793	3093	0	130866
18252	5427	126003	614	2470	0	134514
18253	127247	4110	606	2220	0	134183
18254	5361	2082	611	125962	0	134016
18255	3067	1803	127186	4385	0	136441
18256	3128	1310	3245	124723	0	132406
18257	3005	1134	1372	127846	0	133357
18258	3052	965	1192	127451	0	132660
18259	120254	762	958	5328	0	127302
18260	3992	991	967	115188	0	121138
18261	2334	115112	1003	4708	0	123157
18262	112215	2464	1357	3310	0	119346
18263	3424	110957	876	2643	0	117900
18264	1880	107698	747	2110	0	112435
18265	1713	111539	729	1860	0	115841
18266	1385	2369	101283	1254	0	106291
18267	885	98597	1837	1153	0	102472
18268	761	1395	90329	637	0	93122
18269	80733	445	939	619	0	82736
18270	83793	196	253	637	0	84879
18271	934	250	85975	338	0	87497
18272	82738	163	703	738	0	84342
18273	87833	172	201	617	0	88823
18274	946	180	89287	284	0	90697
18275	404	92493	679	260	0	93836
18276	513	758	264	93229	0	94764
18277	95638	232	155	1093	0	97118
18278	987	193	124	94189	0	95493
18279	99553	165	139	1281	0	101138
18280	98108	169	161	703	0	99141
18281	984	232	99462	245	0	100923
18282	95732	160	688	588	0	97168
18283	869	101674	244	322	0	103109
18284	102597	724	152	574	0	104047
18285	1145	246	111	103318	0	104820
18286	453	232	104574	840	0	106099
18287	581	188	737	102576	0	104082
18288	102929	184	237	1207	0	104557
18289	851	104376	237	507	0	105971
18290	502	829	104495	344	0	106170
18291	629	298	751	99585	0	101263
18292	430	258	105178	881	0	106747
18293	320	105270	796	470	0	106856
18294	104265	786	311	652	0	106014
18295	1064	280	194	104922	0	106460
18296	429	310	105707	878	0	107324
18297	432	281	99682	443	0	100838
18298	104681	222	915	665	0	106483
18299	1204	237	324	106923	0	108688
18300	636	293	269	107380	0	108578
18301	434	309	108943	1085	0	110771
18302	474	294	106309	474	0	107551
18303	421	111235	1113	374	0	113143
18304	565	976	410	111900	0	113851
18305	632	309	350	111087	0	112378
18306	396	112526	316	1090	0	114328
18307	413	1045	111579	440	0	113477
18308	105398	361	1033	758	0	107550
18309	1289	268	369	113959	0	115885
18310	491	323	115756	1136	0	117706
18311	666	293	1045	109513	0	111517
18312	409	115321	376	1106	0	117212
18313	456	1217	114984	520	0	117177
18314	105672	414	1227	936	0	108249
18315	1388	364	116332	367	0	118451
18316	577	366	113601	315	0	114859
18317	433	296	112616	354	0	113699
18318	446	294	120647	332	0	121719
18319	739	222	1848	119659	0	122468
18320	421	293	128072	1654	0	130440
18321	740	290	1795	121367	0	124192
18322	294	126416	562	1617	0	128889
18323	132259	1657	390	840	0	135146
18324	2381	414	349	132978	0	136122
18325	674	340	130870	2073	0	133957
18326	396	130031	2122	795	0	133344
18327	696	1903	708	130169	0	133476
18328	129184	559	514	2495	0	132752
18329	1924	130696	419	708	0	133747
18330	981	2035	360	131622	0	134998
18331	132814	558	425	2445	0	136242
18332	2088	390	132311	689	0	135478
18333	127847	231	2147	1036	0	131261
18334	2243	265	135147	335	0	137990
18335	125247	183	2098	769	0	128297
18336	127553	233	663	759	0	129208
18337	2422	249	127220	293	0	130184
18338	746	125235	1831	335	0	128147
18339	1062	1838	794	118796	0	122490
18340	368	592	127981	1779	0	130720
18341	808	403	1912	119507	0	122630
18342	822	170	643	122584	0	124219
18343	322	260	126026	2234	0	128842
18344	301	244	124419	849	0	125813
18345	639	175	2345	123548	0	126707
18346	126030	145	908	2401	0	129484
18347	1977	123966	529	746	0	127218
18348	649	125947	474	525	0	127595
18349	125262	2205	313	795	0	128575
18350	127682	693	316	797	0	129488
18351	2808	359	419	127461	0	131047
18352	1192	299	317	128567	0	130375
18353	790	204	300	130561	0	131855
18354	126534	209	371	3049	0	130163
18355	1977	121541	393	1104	0	125015
18356	731	125471	374	695	0	127271
18357	779	2414	418	124340	0	127951
18358	709	726	422	127183	0	129040
18359	646	422	315	127499	0	128882
18360	125265	256	315	3234	0	129070
18361	2078	128481	331	1123	0	132013
18362	128587	2220	298	1012	0	132117
18363	2592	884	129571	475	0	133522
18364	1036	130128	2251	552	0	133967
18365	861	2293	837	128093	0	132084
18366	127349	788	542	3006	0	131685
18367	2528	574	127292	1169	0	131563
18368	1193	449	126752	734	0	129128
18369	1063	464	3007	125895	0	130429
18370	819	490	1174	129981	0	132464
18371	748	415	660	130008	0	131831
18372	894	364	492	124847	0	126597
18373	858	351	483	125735	0	127427
18374	598	122770	554	3429	0	127351
18375	764	2376	508	123313	0	126961
18376	119981	857	543	3381	0	124762
18377	2394	122416	620	1491	0	126921
18378	120662	2599	490	1537	0	125288
18379	2898	1019	117978	1044	0	122939
18380	1273	652	119329	932	0	122186
18381	1204	509	3309	127578	0	132600
18382	711	504	156751	3240	0	161206
18383	1245	445	4547	152566	0	158803
18384	1360	492	1945	151682	0	155479
18385	156365	473	1145	6399	0	164382
18386	153934	494	793	3351	0	158572
18387	5852	158278	751	1762	0	166643
18388	2478	167372	745	1182	0	171777
18389	1919	6104	666	162453	0	171142
18390	164154	2493	736	5684	0	173067
18391	5277	1432	166029	2532	0	175270
18392	2937	792	5060	163905	0	172694
18393	2189	659	2215	166880	0	171943
18394	1156	712	164134	6937	0	172939
18395	905	163303	5230	3623	0	173061
18396	1720	5210	2284	159241	0	168455
18397	975	2217	165103	5985	0	174280
18398	1483	1228	5246	162649	0	170606
18399	154916	783	2386	6852	0	164937
18400	4973	156423	1635	3251	0	166282
18401	2182	162128	1159	2267	0	167736
18402	1939	6487	1069	157448	0	166943
18403	154057	2862	997	6379	0	164295
18404	5151	156841	1088	3296	0	166376
18405	157984	5300	1121	2766	0	167171
18406	6046	2477	156841	2244	0	167608
18407	2992	1689	161668	2097	0	168446
18408	2605	1366	7046	152680	0	163697
18409	2062	1419	3036	164552	0	171069
18410	159647	1320	1808	8332	0	171107
18411	7163	1254	1151	160471	0	170039
18412	3390	1634	157713	7017	0	169754
18413	2992	1756	5405	155230	0	165383
18414	2271	1549	2620	161790	0	168230
18415	1571	1337	154375	8103	0	165386
18416	145257	1183	5880	4915	0	157235
18417	6141	1163	2985	153967	0	164256
18418	146961	1002	2011	7010	0	156984
18419	5407	141591	1933	3992	0	152923
18420	139401	4859	1624	3434	0	149318
18421	5316	138025	1442	2877	0	147660
18422	2637	142576	1603	2624	0	149440
18423	2679	6067	1637	132831	0	143214
18424	133344	2793	1479	5707	0	143323
18425	135859	2079	1158	3253	0	142349
18426	6301	1850	1055	133730	0	142936
18427	133879	1625	1186	5882	0	142572
18428	135544	1483	1047	3742	0	141816
18429	7174	1606	1037	133440	0	143257
18430	126968	1526	1116	5986	0	135596
18431	6010	129642	1535	3464	0	140651
18432	129856	4860	1554	3200	0	139470
18433	5996	2531	120562	2914	0	132003
18434	130244	1525	4406	3458	0	139633
18435	6679	978	2315	131292	0	141264
18436	4011	968	1910	134744	0	141633
18437	2999	1100	1756	135818	0	141673
18438	2803	1231	1571	135304	0	140909
18439	2414	1410	1565	132706	0	138095
18440	2173	119809	1835	7968	0	131785
18441	2267	130867	1610	5043	0	139787
18442	129099	5302	1424	3959	0	139784
18443	5890	3039	127675	3066	0	139670
18444	125581	2628	4407	3213	0	135829
18445	6371	2309	127286	3050	0	139016
18446	4258	2194	5051	125156	0	136659
18447	3483	2335	2149	131642	0	139609
18448	128045	1913	1474	7577	0	139009
18449	6699	2222	127048	4077	0	140046
18450	4921	1916	4461	127503	0	138801
18451	3773	1516	131400	6478	0	143167
18452	3510	133478	5370	4143	0	146501
18453	3734	4941	2483	137618	0	148776
18454	137686	2399	1806	7408	0	149299
18455	133629	1757	1679	4670	0	141735
18456	137133	1694	1677	4083	0	144587
18457	7789	132883	1857	3622	0	146151
18458	4238	139151	1969	3541	0	148899
18459	121889	6104	1909	4298	0	134200
18460	5954	135174	1622	3936	0	146686
18461	3428	136608	1552	4054	0	145642
18462	3297	6012	130993	3897	0	144199
18463	2468	128665	4528	3834	0	139495
18464	2306	133406	2611	3160	0	141483
18465	2771	6488	1670	130843	0	141772
18466	2426	4002	131009	5947	0	143384
18467	2873	2757	128698	3398	0	137726
18468	124940	1989	5995	3212	0	136136
18469	6580	1798	130346	2479	0	141203
18470	131444	1693	5782	2474	0	141393
18471	6697	1825	3014	128028	0	139564
18472	4298	131758	1983	6183	0	144222
18473	136012	4909	1793	3968	0	146682
18474	141716	2623	1754	3588	0	149681
18475	7816	1742	1767	139323	0	150648
18476	5183	1584	1789	141047	0	149603
18477	4074	1458	1671	142192	0	149395
18478	136930	1366	1242	8205	0	147743
18479	125228	1624	1161	5018	0	133031
18480	136182	1737	866	3654	0	142439
18481	7423	122026	724	2747	0	132920
18482	94651	2160	475	1144	0	98430
18483	2885	92509	431	983	0	96808
18484	1600	93888	392	873	0	96753
18485	1645	3365	877	86684	0	92571
18486	948	89129	494	2006	0	92577
18487	84961	1763	391	990	0	88105
18488	2052	817	258	84154	0	87281
18489	82202	549	207	1850	0	84808
18490	1731	79469	237	783	0	82220
18491	800	82997	253	566	0	84616
18492	84988	1656	268	691	0	87603
18493	1880	87716	299	410	0	90305
18494	1153	1717	314	87721	0	90905
18495	989	647	354	89484	0	91474
18496	88510	465	220	2252	0	91447
18497	2107	419	182	89211	0	91919
18498	887	429	90220	2036	0	93572
18499	786	409	1656	90386	0	93237
18500	91137	395	533	2338	0	94403
18501	1964	93622	394	852	0	96832
18502	96602	1978	241	896	0	99717
18503	92348	797	253	914	0	94312
18504	97256	559	185	715	0	98715
18505	2734	505	94359	445	0	98043
18506	1185	437	90567	439	0	92628
18507	88776	404	1983	607	0	91770
18508	2157	91857	698	447	0	95159
18509	1050	1938	414	93127	0	96529
18510	931	750	301	92758	0	94740
18511	596	89421	395	2182	0	92594
18512	530	93625	385	812	0	95352
18513	701	2244	302	93496	0	96743
18514	677	942	264	95102	0	96985
18515	543	660	92084	2434	0	95721
18516	651	521	86544	1114	0	88830
18517	89037	453	2215	962	0	92667
18518	95276	427	833	776	0	97312
18519	2673	411	577	94120	0	97781
18520	1138	517	94251	2197	0	98103
18521	1018	431	1993	93055	0	96497
18522	92381	433	766	2637	0	96217
18523	2402	425	92778	1047	0	96652
18524	1233	433	1999	92930	0	96595
18525	817	527	94266	2202	0	97812
18526	662	92274	2154	1052	0	96142
18527	637	1959	93453	786	0	96835
18528	940	975	2248	90570	0	94733
18529	93092	497	1017	2269	0	96875
18530	2334	475	651	94803	0	98263
18531	94112	386	503	2629	0	97630
18532	96038	423	464	1287	0	98212
18533	93920	407	440	1130	0	95897
18534	2827	421	91097	682	0	95027
18535	91277	317	1978	870	0	94442
18536	2761	274	788	92480	0	96303
18537	1391	335	599	93686	0	96011
18538	1008	374	92242	2531	0	96155
18539	1019	480	1930	92209	0	95638
18540	93444	372	807	2669	0	97292
18541	2251	94964	612	1193	0	99020
18542	97713	1799	413	1257	0	101182
18543	98923	658	363	1143	0	101087
18544	99981	457	371	1016	0	101825
18545	3174	369	367	98287	0	102197
18546	1511	378	99260	2284	0	103433
18547	1263	349	1994	98799	0	102405
18548	1103	305	780	101270	0	103458
18549	100281	306	556	3040	0	104183
18550	96842	338	464	1629	0	99273
18551	2777	345	94605	981	0	98708
18552	1482	385	1980	93680	0	97527
18553	966	288	95016	2585	0	98855
18554	93597	246	2455	1411	0	97709
18555	2763	103130	920	978	0	107791
18556	103204	2282	672	899	0	107057
18557	3057	104965	537	646	0	109205
18558	104442	2632	474	883	0	108431
18559	3051	105233	487	705	0	109476
18560	1744	2757	487	103935	0	108923
18561	1375	963	388	108633	0	111359
18562	108374	695	339	3532	0	112940
18563	108117	504	365	1758	0	110744
18564	109343	442	361	1311	0	111457
18565	105263	392	412	1147	0	107214
18566	108396	405	386	984	0	110171
18567	4257	345	362	104286	0	109250
18568	2020	104569	367	2737	0	109693
18569	1829	2518	305	101956	0	106608
18570	1306	103034	310	2867	0	107517
18571	1417	2672	253	99283	0	103625
18572	1119	101846	331	2839	0	106135
18573	1288	2750	309	100799	0	105146
18574	961	992	97203	3139	0	102295
18575	90992	722	2317	1737	0	95768
18576	2963	96946	814	1085	0	101808
18577	97057	2540	557	1072	0	101226
18578	3338	975	96295	786	0	101394
18579	92922	786	2425	1010	0	97143
18580	3378	656	100373	739	0	105146
18581	1728	618	2898	98429	0	103673
18582	1161	105589	1017	2851	0	110618
18583	1014	3009	106531	1144	0	111698
18584	1183	1119	3121	106536	0	111959
18585	98076	892	1239	3679	0	103886
18586	3606	617	899	107945	0	113067
18587	1837	486	693	110040	0	113056
18588	1644	470	566	111730	0	114410
18589	1119	541	107413	4327	0	113400
18590	1330	487	2970	104140	0	108927
18591	965	103925	1166	3865	0	109921
18592	1171	2632	798	103734	0	108335
18593	1095	971	556	105124	0	107746
18594	103147	677	454	4201	0	108479
18595	3439	557	368	106075	0	110439
18596	1435	483	106047	3900	0	111865
18597	1085	468	104852	1946	0	108351
18598	884	396	105426	1519	0	108225
18599	730	104524	3850	1275	0	110379
18600	102801	2856	2207	1265	0	109129
18601	2988	103268	1150	996	0	108402
18602	102114	3150	794	964	0	107022
18603	3676	1278	658	100661	0	106273
18604	1617	957	103950	3074	0	109598
18605	1229	736	101197	1469	0	104631
18606	844	105411	3686	1181	0	111122
18607	1193	3116	1658	104862	0	110829
18608	1065	1353	1080	107745	0	111243
18609	1045	971	794	109389	0	112199
18610	650	776	106658	4704	0	112788
18611	96853	586	3446	2688	0	103573
18612	3488	626	107251	1591	0	112956
18613	1998	608	3729	103695	0	110030
18614	1615	626	1565	109233	0	113039
18615	1066	615	106229	4583	0	112493
18616	97876	529	3569	2893	0	104867
18617	3473	105681	1697	1988	0	112839
18618	106062	3245	1361	1618	0	112286
18619	4199	1427	1081	102807	0	109514
18620	1782	105786	911	3770	0	112249
18621	1669	3478	815	107484	0	113446
18622	106688	1470	820	4669	0	113647
18623	4011	1139	813	107077	0	113040
18624	1932	907	104673	4507	0	112019
18625	101549	807	3484	2514	0	108354
18626	106017	669	1590	2085	0	110361
18627	4660	743	103802	1660	0	110865
18628	2601	689	3555	103265	0	110110
18629	106448	668	1722	4388	0	113226
18630	4394	650	1326	104607	0	110977
18631	2394	694	1062	105115	0	109265
18632	2053	627	976	105194	0	108850
18633	1709	608	870	106785	0	109972
18634	1271	732	102543	5623	0	110169
18635	1460	612	3588	103411	0	109071
18636	1180	549	102647	5159	0	109535
18637	98829	551	4051	3143	0	106574
18638	103906	500	2066	2546	0	109018
18639	103747	535	1517	2163	0	107962
18640	104077	550	1217	1982	0	107826
18641	5574	507	1200	98757	0	106038
18642	97016	441	1097	4584	0	103138
18643	4540	394	95469	2619	0	103022
18644	2415	482	95013	2078	0	99988
18645	90493	376	4128	2113	0	97110
18646	3948	90766	2230	1746	0	98690
18647	2016	94071	1629	1692	0	99408
18648	1925	3605	1372	91799	0	98701
18649	1519	1602	92146	3944	0	99211
18650	85360	1110	3592	2610	0	92672
18651	3842	715	92598	1860	0	99015
18652	2117	87405	3335	1543	0	94400
18653	1888	2491	87490	1341	0	93210
18654	1323	82862	3067	1256	0	88508
18655	75478	2629	2104	1334	0	81545
18656	2659	75658	1219	1168	0	80704
18657	1506	75307	940	1089	0	78842
18658	1365	2682	934	74208	0	79189
18659	1032	1370	74016	2563	0	78981
18660	1054	975	2488	70638	0	75155
18661	1023	750	1372	73523	0	76668
18662	885	723	71419	3278	0	76305
18663	1074	613	2569	68074	0	72330
18664	960	67397	1480	2737	0	72574
18665	997	2176	1120	71828	0	76121
18666	71239	1131	1004	3016	0	76390
18667	2623	808	943	72088	0	76462
18668	1468	710	71526	2991	0	76695
18669	1303	677	2372	72273	0	76625
18670	948	692	71524	3056	0	76220
18671	69443	684	2574	1952	0	74653
18672	2573	574	1418	72044	0	76609
18673	71791	548	1143	3130	0	76612
18674	2759	547	71654	1819	0	76779
18675	65527	443	2441	1821	0	70232
18676	2629	72746	1504	1318	0	78197
18677	1533	2036	74467	1189	0	79225
18678	1402	1359	2455	72357	0	77573
18679	1108	730	75861	2548	0	80247
18680	981	69913	2375	1700	0	74969
18681	923	73854	1384	1308	0	77469
18682	66588	2024	890	1129	0	70631
18683	1977	69781	764	908	0	73430
18684	69792	2022	787	969	0	73570
18685	2475	967	747	70504	0	74693
18686	1238	651	70112	2243	0	74244
18687	934	72041	2088	1199	0	76262
18688	1078	2137	1069	72418	0	76702
18689	946	1076	752	76339	0	79113
18690	992	727	609	77703	0	80031
18691	885	662	600	75370	0	77517
18692	722	71800	637	3069	0	76228
18693	617	75866	660	1626	0	78769
18694	70469	2127	572	1117	0	74285
18695	1817	70701	506	789	0	73813
18696	943	1921	397	67772	0	71033
18697	593	874	67577	1901	0	70945
18698	526	67423	1642	969	0	70560
18699	666	1741	620	66297	0	69324
18700	632	968	490	65703	0	67793
18701	404	66929	407	1983	0	69723
18702	64353	1653	365	1103	0	67474
18703	1525	804	64680	719	0	67728
18704	57986	493	1285	704	0	60468
18705	1432	63044	534	462	0	65472
18706	58753	1306	234	433	0	60726
18707	1235	61654	202	318	0	63409
18708	772	1413	212	63795	0	66192
18709	508	649	205	65537	0	66899
18710	64110	442	197	1925	0	66674
18711	1523	400	192	65174	0	67289
18712	632	406	64812	1600	0	67450
18713	353	62099	1254	815	0	64521
18714	315	64814	496	465	0	66090
18715	413	1636	260	63699	0	66008
18716	276	730	64856	1379	0	67241
18717	416	488	1200	63193	0	65297
18718	409	367	452	65267	0	66495
18719	201	370	63835	1757	0	66163
18720	255	340	61338	855	0	62788
18721	197	63683	1480	565	0	65925
18722	64134	1293	597	681	0	66705
18723	1321	644	322	63326	0	65613
18724	532	61709	335	1310	0	63886
18725	64872	1371	249	924	0	67416
18726	1321	701	275	65212	0	67509
18727	697	428	263	65011	0	66399
18728	285	64235	261	1816	0	66597
18729	414	1386	228	64151	0	66179
18730	64480	712	242	1830	0	67264
18731	1384	499	247	65629	0	67759
18732	722	454	212	66351	0	67739
18733	393	486	64414	1897	0	67190
18734	410	430	59217	1104	0	61161
18735	63326	422	1575	945	0	66268
18736	1409	402	625	64765	0	67201
18737	760	413	373	65187	0	66733
18738	553	432	283	66435	0	67703
18739	408	410	64561	2066	0	67445
18740	62577	392	1328	1274	0	65571
18741	1451	410	645	64831	0	67337
18742	807	385	414	65926	0	67532
18743	63862	373	381	2237	0	66853
18744	1394	63698	373	1234	0	66699
18745	725	1394	63641	964	0	66724
18746	595	653	1341	61104	0	63693
18747	463	63170	717	1705	0	66055
18748	551	1358	439	64972	0	67320
18749	63712	719	387	1999	0	66817
18750	1577	485	374	64085	0	66521
18751	62612	510	320	2085	0	65527
18752	62089	450	371	1281	0	64191
18753	1852	426	365	60618	0	63261
18754	885	59364	335	1934	0	62518
18755	558	62024	339	1255	0	64176
18756	516	1631	61161	995	0	64303
18757	771	856	1466	56126	0	59219
18758	610	525	693	61788	0	63616
18759	564	530	432	63720	0	65246
18760	61853	434	356	2398	0	65041
18761	1560	497	313	62728	0	65098
18762	866	470	62099	2044	0	65479
18763	60984	387	1329	1517	0	64217
18764	1639	409	661	64947	0	67656
18765	977	372	410	66504	0	68263
18766	583	419	65013	2312	0	68327
18767	61634	379	1391	1590	0	64994
18768	1667	439	677	66008	0	68791
18769	796	394	68039	2142	0	71371
18770	786	323	1542	67246	0	69897
18771	862	387	802	63064	0	65115
18772	562	68673	558	2120	0	71913
18773	67806	1314	491	1603	0	71214
18774	67433	629	461	1268	0	69791
18775	1817	67158	434	1103	0	70512
18776	65101	1249	407	1136	0	67893
18777	63872	573	397	1068	0	65910
18778	1982	344	334	63585	0	66245
18779	931	329	60338	1767	0	63365
18780	696	283	57376	1087	0	59442
18781	553	255	58679	832	0	60319
18782	455	335	61605	800	0	63195
18783	539	493	1551	58648	0	61231
18784	491	245	778	62228	0	63742
18785	509	236	380	62069	0	63194
18786	573	193	300	62586	0	63652
18787	60907	180	297	2018	0	63402
18788	1320	61554	316	1087	0	64277
18789	61115	966	259	793	0	63133
18790	1341	415	61394	553	0	63703
18791	695	286	64218	494	0	65693
18792	620	409	1354	65021	0	67404
18793	66429	168	878	1622	0	69097
18794	63911	119	409	1039	0	65478
18795	1467	65089	331	620	0	67507
18796	637	68142	312	541	0	69632
18797	595	1308	265	68335	0	70503
18798	67994	514	268	1461	0	70237
18799	1146	68816	252	778	0	70992
18800	69272	1107	204	762	0	71345
18801	69212	550	203	667	0	70632
18802	69584	329	208	640	0	70761
18803	1693	288	70617	385	0	72983
18804	844	71472	1036	361	0	73713
18805	70702	988	486	571	0	72747
18806	70462	446	281	518	0	71707
18807	1515	67979	216	297	0	70007
18808	560	66287	96	140	0	67083
18809	66350	978	147	290	0	67765
18810	1093	442	76	66406	0	68017
18811	521	286	66297	805	0	67909
18812	63006	211	776	491	0	64484
18813	1146	221	276	66821	0	68464
18814	515	69367	186	760	0	70828
18815	497	929	110	70576	0	72112
18816	354	435	70828	917	0	72534
18817	450	241	864	69404	0	70959
18818	73002	198	371	1235	0	74806
18819	1160	201	208	73470	0	75039
18820	663	155	144	74260	0	75222
18821	357	210	78492	1291	0	80350
18822	526	194	902	74279	0	75901
18823	266	78580	387	996	0	80229
18824	78590	935	216	731	0	80472
18825	76094	368	190	657	0	77309
18826	1318	244	78967	347	0	80876
18827	790	183	972	75252	0	77197
18828	328	76339	408	1066	0	78141
18829	299	79708	259	509	0	80775
18830	78292	1126	216	586	0	80220
18831	1225	467	164	79708	0	81564
18832	559	304	79683	1090	0	81636
18833	401	246	77881	565	0	79093
18834	432	202	1251	79592	0	81477
18835	79172	189	542	1425	0	81328
18836	78992	210	349	728	0	80279
18837	1559	222	264	82398	0	84443
18838	689	255	84232	1178	0	86354
18839	457	83941	1128	567	0	86093
18840	83962	1031	485	724	0	86202
18841	1157	85721	341	411	0	87630
18842	86224	1224	240	632	0	88320
18843	1464	513	218	86432	0	88627
18844	701	374	86866	1233	0	89174
18845	641	292	1110	84965	0	87008
18846	85606	226	545	1615	0	87992
18847	1318	288	86667	642	0	88915
18848	655	86642	1200	493	0	88990
18849	680	1095	549	86738	0	89062
18850	87596	488	327	1557	0	89968
18851	1392	396	88245	651	0	90684
18852	891	310	1224	87806	0	90231
18853	702	296	520	90975	0	92493
18854	506	358	91426	1573	0	93863
18855	736	317	1309	88807	0	91169
18856	520	331	91051	1529	0	93431
18857	86176	271	1359	1101	0	88907
18858	1610	284	644	95070	0	97608
18859	794	353	100942	1572	0	103661
18860	584	101978	1691	798	0	105051
18861	103885	1607	677	951	0	107120
18862	111793	603	465	932	0	113793
18863	2853	463	359	118156	0	121831
18864	1091	122821	394	2226	0	126532
18865	123736	2405	381	1318	0	127840
18866	3059	876	322	123937	0	128194
18867	1179	605	124569	2660	0	129013
18868	117126	482	2429	1609	0	121646
18869	2783	121658	924	827	0	126192
18870	1568	2389	607	122898	0	127462
18871	122965	927	478	2944	0	127314
18872	2888	671	121518	1123	0	126200
18873	1310	613	122764	753	0	125440
18874	1289	486	3048	118509	0	123332
18875	863	420	125501	2725	0	129509
18876	1210	339	2918	118950	0	123417
18877	601	119234	1339	2833	0	124007
18878	869	2552	839	127155	0	131415
18879	124901	880	708	3506	0	129995
18880	2651	603	125826	1477	0	130557
18881	1086	125449	2787	1134	0	130456
18882	1113	2528	1038	123595	0	128274
18883	678	1016	128220	2805	0	132719
18884	1040	905	2497	118598	0	123040
18885	571	122285	1139	2533	0	126528
18886	440	128320	815	1214	0	130789
18887	122532	2676	691	1307	0	127206
18888	2090	126138	646	799	0	129673
18889	758	2492	122005	589	0	125844
18890	111077	1055	2464	1174	0	115770
18891	2308	762	122241	427	0	125738
18892	1339	524	2251	113336	0	117450
18893	662	530	122943	2020	0	126155
18894	501	123340	2363	839	0	127043
18895	792	2049	937	122186	0	125964
18896	620	724	674	122740	0	124758
18897	696	496	562	121661	0	123415
18898	359	494	122765	2845	0	126463
18899	683	503	2132	117570	0	120888
18900	506	444	822	123071	0	124843
18901	119042	390	581	3267	0	123280
18902	117248	395	535	1854	0	120032
18903	2599	354	120254	947	0	124154
18904	1122	117139	2216	822	0	121299
18905	799	2006	119784	687	0	123276
18906	864	732	2380	119248	0	123224
18907	573	594	122914	2269	0	126350
18908	721	456	2543	119254	0	122974
18909	591	437	1094	123973	0	126095
18910	356	377	122890	2942	0	126565
18911	107199	307	2481	2129	0	112116
18912	2054	123728	1162	1127	0	128071
18913	979	2080	707	124343	0	128109
18914	615	786	128885	2475	0	132761
18915	673	537	122374	1178	0	124762
18916	117632	469	2698	1300	0	122099
18917	2056	126650	1256	790	0	130752
18918	992	2052	849	127287	0	131180
18919	129031	739	742	2642	0	133154
18920	2435	520	677	129038	0	132670
18921	1269	482	556	130957	0	133264
18922	691	508	130777	3025	0	135001
18923	119019	391	2350	2149	0	123909
18924	131273	364	1040	1411	0	134088
18925	3056	389	773	131953	0	136171
18926	131526	366	677	2935	0	135504
18927	2925	345	619	131200	0	135089
18928	1309	127089	742	2786	0	131926
18929	966	133895	685	1440	0	136986
18930	1063	2751	550	135254	0	139618
18931	132523	1106	472	3188	0	137289
18932	2547	703	384	134115	0	137749
18933	135973	564	464	3416	0	140417
18934	137083	506	439	1937	0	139965
18935	3402	416	498	136569	0	140885
18936	1822	383	484	140021	0	142710
18937	1214	438	136557	3476	0	141685
18938	1064	389	138253	1708	0	141414
18939	1176	380	3231	138541	0	143328
18940	758	371	147967	3294	0	152390
18941	143135	336	3301	2178	0	148950
18942	3213	395	1493	154211	0	159312
18943	1207	481	161512	3518	0	166718
18944	153904	330	3644	2369	0	160247
18945	168264	296	1652	1814	0	172026
18946	4801	173479	1106	1165	0	180551
18947	2980	3463	796	175345	0	182584
18948	1633	1499	182033	4254	0	189419
18949	177693	864	3840	2729	0	185126
18950	187187	576	1871	2061	0	191695
18951	5304	603	188958	1071	0	195936
18952	188785	408	4078	1657	0	194928
18953	5330	423	2030	187672	0	195455
18954	3026	392	1307	192419	0	197144
18955	190206	328	1102	5726	0	197362
18956	191153	297	968	3143	0	195561
18957	6190	697	968	187430	0	195285
18958	3004	345	187452	4319	0	195120
18959	1989	180975	3503	2387	0	188854
18960	1620	3147	182323	1593	0	188683
18961	1623	1435	179758	1282	0	184098
18962	1286	175217	4755	1105	0	182363
18963	2035	2818	2467	160269	0	167589
18964	1322	1140	1317	164797	0	168576
18965	948	770	163925	3450	0	169093
18966	1429	495	2969	159119	0	164012
18967	162243	327	1550	4048	0	168168
18968	3250	375	165710	1846	0	171181
18969	162225	374	3030	1972	0	167601
18970	168769	261	1735	1661	0	172426
18971	169843	292	1198	1621	0	172954
18972	4909	435	166609	848	0	172801
18973	2632	458	167537	850	0	171477
18974	2407	387	3884	163656	0	170334
18975	2198	482	2174	156671	0	161525
18976	1312	167913	1430	3532	0	174187
18977	166908	2720	1102	2498	0	173228
18978	165765	1189	1146	1987	0	170087
18979	4221	166969	1159	1228	0	173577
18980	166694	2746	973	1685	0	172098
18981	3878	165503	983	1262	0	171626
18982	166738	3098	915	1665	0	172416
18983	4383	1425	910	161117	0	167835
18984	2384	959	163819	3241	0	170403
18985	1850	745	161369	1807	0	165771
18986	1808	705	4112	159968	0	166593
18987	1768	540	2275	162845	0	167428
18988	1307	603	163362	4072	0	169344
18989	1744	622	3581	157788	0	163735
18990	1829	564	2134	156932	0	161459
18991	160781	523	1575	5009	0	167888
18992	162546	517	1305	2926	0	167294
18993	158029	583	1077	2359	0	162048
18994	4977	602	155792	1449	0	162820
18995	2886	155591	3447	1291	0	163215
18996	2545	2784	1846	156517	0	163692
18997	1919	1409	161458	3321	0	168107
18998	1790	161225	3641	1834	0	168490
18999	163131	3026	2057	1971	0	170185
19000	4187	1478	1598	163694	0	170957
19001	2712	1019	1469	166440	0	171640
19002	164758	812	1288	5033	0	171891
19003	4286	740	1231	164782	0	171039
19004	2899	740	1227	165243	0	170109
19005	164318	715	1052	5412	0	171497
19006	4238	812	162117	2776	0	169943
19007	2572	160726	3492	2145	0	168935
19008	159779	3035	1959	2296	0	167069
19009	4289	1641	163904	1584	0	171418
19010	156736	1078	3574	2436	0	163824
19011	4282	167135	2313	1573	0	175303
19012	164519	3076	1740	2117	0	171452
19013	164476	1518	1480	2236	0	169710
19014	160602	1071	1313	2009	0	164995
19015	5502	827	1276	156410	0	164015
19016	3487	1071	1265	155788	0	161611
19017	2409	154226	1237	4688	0	162560
19018	2173	155230	1213	2690	0	161306
19019	2075	157088	1187	1940	0	162290
19020	155206	3679	1008	2121	0	162014
19021	3996	1883	153930	1472	0	161281
19022	2852	1302	3088	151213	0	158455
19023	2292	1045	1674	151845	0	156856
19024	1745	153477	1439	4047	0	160708
19025	2054	3204	1076	153857	0	160191
19026	2081	1773	1123	150627	0	155604
19027	1704	154335	1085	4255	0	161379
19028	151079	3098	1121	3044	0	158342
19029	3545	154860	1041	1971	0	161417
19030	2233	3363	151194	1630	0	158420
19031	146185	1737	2923	2230	0	153075
19032	3625	154390	1519	1642	0	161176
19033	151009	2879	1105	1827	0	156820
19034	4069	1641	952	150108	0	156770
19035	2936	1133	924	150603	0	155596
19036	1939	1132	148966	3593	0	155630
19037	1886	958	147098	1902	0	151844
19038	1861	1328	3042	146022	0	152253
19039	145134	746	1539	3510	0	150929
19040	139752	691	1016	2092	0	143551
19041	3743	145542	817	1265	0	151367
19042	1734	141662	634	1049	0	145079
19043	1064	141445	539	754	0	143802
19044	2579	4023	1445	136198	0	144245
19045	136650	912	1672	3197	0	142431
19046	139131	416	196	1432	0	141175
19047	137922	314	198	1162	0	139596
19048	3854	421	133784	397	0	138456
19049	1202	159639	3027	440	0	164308
19050	1402	3352	856	170521	0	176131
19051	171536	908	427	4487	0	177358
19052	5146	557	284	170683	0	176670
19053	2206	355	242	178554	0	181357
19054	176744	358	240	5806	0	183148
19055	184316	410	234	2115	0	187075
19056	5994	585	184900	832	0	192311
19057	2786	398	4751	182090	0	190025
19058	1174	403	182767	5067	0	189411
19059	1885	270	5015	180343	0	187513
19060	893	462	181821	5498	0	188674
19061	1748	522	5041	179056	0	186367
19062	174458	317	1575	6208	0	182558
19063	4953	175712	945	2084	0	183694
19064	1630	185850	717	1318	0	189515
19065	2858	5941	633	159115	0	168547
19066	870	187036	648	4143	0	192697
19067	184308	5409	613	2160	0	192490
19068	180828	1595	546	1791	0	184760
19069	6438	957	178542	848	0	186785
19070	2116	177528	5042	970	0	185656
19071	2086	4988	1493	176911	0	185478
19072	892	1606	180067	5114	0	187679
19073	175533	944	5215	2212	0	183904
19074	6279	773	1522	177519	0	186093
19075	2009	701	181215	5177	0	189102
19076	1907	631	5244	179586	0	187368
19077	180212	697	1650	6169	0	188728
19078	5431	734	179793	1975	0	187933
19079	176149	613	5320	1792	0	183874
19080	184063	505	1772	1438	0	187778
19081	7344	589	998	178182	0	187113
19082	2424	623	180118	5419	0	188584
19083	1571	683	178801	2132	0	183187
19084	173467	470	6338	1901	0	182176
19085	181461	409	2241	1669	0	185780
19086	7061	532	179047	1103	0	187743
19087	3657	491	5621	174350	0	184119
19088	2903	488	2095	168987	0	174473
19089	1416	176865	1643	6136	0	186060
19090	2212	5074	1289	176945	0	185520
19091	178726	1422	1091	6554	0	187793
19092	6899	756	1060	178177	0	186892
19093	2517	643	177484	6318	0	186962
19094	171871	546	5753	3206	0	181376
19095	6723	604	2165	173629	0	183121
19096	2682	905	174999	6071	0	184657
19097	1952	170922	5858	2671	0	181403
19098	164463	5269	2172	2753	0	174657
19099	5987	171692	1607	2035	0	181321
19100	170276	5713	1316	2292	0	179597
19101	6960	1960	168892	1909	0	179721
19102	3026	161871	5858	1976	0	172731
19103	2225	173100	2416	1723	0	179464
19104	2667	6510	1724	164688	0	175589
19105	2594	2291	1535	171394	0	177814
19106	1895	1545	167633	7404	0	178477
19107	2401	1083	6136	168136	0	177756
19108	165807	1076	2780	7476	0	177139
19109	6480	1300	164702	3131	0	175613
19110	3411	1300	6262	163145	0	174118
19111	2270	1465	162240	6863	0	172838
19112	154142	1363	6567	3732	0	165804
19113	6441	162031	2868	2682	0	174022
19114	161676	5978	2118	2898	0	172670
19115	168513	2315	1801	2711	0	175340
19116	169932	1556	1864	2508	0	175860
19117	8670	1538	161531	2179	0	173918
19118	3987	162166	6670	2090	0	174913
19119	3456	5967	2964	160966	0	173353
19120	2899	2394	2372	171984	0	179649
19121	172698	1461	2124	8672	0	184955
19122	8436	1243	2093	173370	0	185142
19123	174417	1056	2187	8620	0	186280
19124	176532	1209	2335	4194	0	184270
19125	177865	1322	1911	3322	0	184420
19126	179107	1319	2112	2670	0	185208
19127	10600	1292	1636	170925	0	184453
19128	172847	1245	1762	7907	0	183761
19129	9219	1295	164977	3616	0	179107
19130	165943	1246	6960	2972	0	177121
19131	173296	1169	3061	2454	0	179980
19132	10331	1335	162587	3459	0	177712
19133	165301	1203	6992	2448	0	175944
19134	172663	1079	3132	2480	0	179354
19135	10477	970	2230	163998	0	177675
19136	5555	1007	2180	168625	0	177367
19137	162678	2317	1930	8907	0	175832
19138	9383	890	1695	161853	0	173821
19139	5413	734	1963	158173	0	166283
19140	3820	152095	1890	8342	0	166147
19141	4090	4552	1618	149331	0	159591
19142	146742	1397	1738	7083	0	156960
19143	7770	973	1424	144734	0	154901
19144	4280	662	1572	140154	0	146668
19145	3032	132394	1643	6812	0	143881
19146	3459	4212	1243	127475	0	136389
19147	3964	1640	1240	126876	0	133720
19148	120862	978	1231	6077	0	129148
19149	5091	1598	649	89329	0	96667
19150	1960	411	79816	3550	0	85737
19151	1237	73851	2396	1990	0	79474
19152	1019	75473	1026	1269	0	78787
19153	71208	2657	825	1401	0	76091
19154	2706	72733	509	1040	0	76988
19155	65569	1932	779	950	0	69230
19156	2279	65681	314	749	0	69023
19157	66537	2086	318	821	0	69762
19158	2669	886	157	66962	0	70674
19159	1416	642	136	67511	0	69705
19160	936	67675	180	2649	0	71440
19161	1131	2137	140	68604	0	72012
19162	781	790	69024	2474	0	73069
19163	64742	551	1791	1514	0	68598
19164	2337	73636	656	849	0	77478
19165	71681	2147	354	886	0	75068
19166	72499	855	246	769	0	74369
19167	73594	623	221	621	0	75059
19168	3496	411	169	70335	0	74411
19169	1794	408	241	69813	0	72256
19170	1093	71084	195	2794	0	75166
19171	70527	2260	102	1546	0	74435
19172	2591	71690	147	931	0	75359
19173	71849	2372	116	902	0	75239
19174	2914	960	72715	634	0	77223
19175	75482	567	2152	868	0	79069
19176	3493	397	793	75994	0	80677
19177	1550	479	75946	2756	0	80731
19178	1216	432	76729	1222	0	79599
19179	1269	367	3194	75708	0	80538
19180	987	322	77451	2849	0	81609
19181	1158	308	3015	75911	0	80392
19182	72821	269	1189	3309	0	77588
19183	3219	335	698	74154	0	78406
19184	1530	354	72833	3199	0	77916
19185	1151	69519	2614	1534	0	74818
19186	839	74008	1074	1149	0	77070
19187	1120	3055	783	71498	0	76456
19188	72234	1269	527	3111	0	77141
19189	3158	724	346	73193	0	77421
19190	1671	444	343	75301	0	77759
19191	1351	385	452	76128	0	78316
19192	1048	448	405	76653	0	78554
19193	788	466	74108	4112	0	79474
19194	828	391	72962	2049	0	76230
19195	72036	309	3194	1589	0	77128
19196	75697	333	1347	1350	0	78727
19197	3793	341	791	74027	0	78952
19198	1979	367	542	76025	0	78913
19199	1191	392	73532	3799	0	78914
19200	883	73901	2639	1932	0	79355
19201	73306	2581	1161	1530	0	78578
19202	75800	1115	701	1170	0	78786
19203	3902	848	408	74097	0	79255
19204	1835	600	74254	3266	0	79955
19205	1483	532	2535	70910	0	75460
19206	934	74021	1206	3132	0	79293
19207	942	2660	74369	1582	0	79553
19208	72244	1139	2720	1392	0	77495
19209	3249	767	1195	75355	0	80566
19210	76172	503	851	3443	0	80969
19211	3266	518	73922	1752	0	79458
19212	73588	475	2745	1514	0	78322
19213	3497	618	1294	74057	0	79466
19214	73867	546	878	3173	0	78464
19215	3636	553	620	70662	0	75471
19216	1832	67962	672	3296	0	73762
19217	1304	71861	577	1731	0	75473
19218	1450	3344	580	68519	0	73893
19219	866	1240	67406	2691	0	72203
19220	742	66289	2201	1469	0	70701
19221	1059	1890	1026	62042	0	66017
19222	60165	762	760	2396	0	64083
19223	60935	530	476	1330	0	63271
19224	2569	386	437	60744	0	64136
19225	1465	348	480	60134	0	62427
19226	929	57613	531	2530	0	61603
19227	755	61450	508	1406	0	64119
19228	60045	2216	433	1275	0	63969
19229	2099	1007	416	60418	0	63940
19230	1198	626	409	61782	0	64015
19231	809	471	60030	2824	0	64134
19232	765	422	1909	59699	0	62795
19233	733	396	967	60018	0	62114
19234	754	441	710	61263	0	63168
19235	686	390	60021	3076	0	64173
19236	832	321	1970	60698	0	63821
19237	59766	305	1012	2969	0	64052
19238	2034	332	59219	1652	0	63237
19239	60576	377	2173	1583	0	64709
19240	2393	369	1046	62512	0	66320
19241	1295	307	754	65344	0	67700
19242	1094	283	589	67481	0	69447
19243	773	238	64649	3277	0	68937
19244	60116	239	2123	2130	0	64608
19245	2212	65921	1115	1346	0	70594
19246	65855	1901	776	1244	0	69776
19247	2364	66581	636	1040	0	70621
19248	1265	2145	540	66863	0	70813
19249	66948	907	450	2741	0	71046
19250	2379	609	65633	1527	0	70148
19251	63091	347	1991	1418	0	66847
19252	2514	339	66798	1021	0	70672
19253	1405	440	2255	65373	0	69473
19254	954	350	65708	2303	0	69315
19255	779	64437	2237	1300	0	68753
19256	1053	1734	1069	62805	0	66661
19257	61504	744	704	2348	0	65300
19258	1959	494	483	59747	0	62683
19259	1016	59293	462	2066	0	62837
19260	920	1604	428	60236	0	63188
19261	58897	714	352	2175	0	62138
19262	57191	471	361	1293	0	59316
19263	2265	56104	383	922	0	59674
19264	837	52042	276	485	0	53640
19265	743	1366	326	50834	0	53269
19266	519	646	241	51850	0	53256
19267	50682	406	230	1726	0	53044
19268	49968	296	212	999	0	51475
19269	1471	50671	244	621	0	53007
19270	854	1209	169	48988	0	51220
19271	641	575	184	49917	0	51317
19272	470	375	48995	1488	0	51328
19273	371	47643	1004	937	0	49955
19274	307	46750	388	571	0	48016
19275	326	934	227	44386	0	45873
19276	203	302	44594	799	0	45898
19277	174	198	44412	368	0	45152
19278	263	147	920	44460	0	45790
19279	248	132	373	45751	0	46504
19280	142	134	45793	1031	0	47100
19281	262	111	795	46079	0	47247
19282	141	127	47192	1022	0	48482
19283	47658	121	923	622	0	49324
19284	1161	134	362	49165	0	50822
19285	433	119	50057	1209	0	51818
19286	281	110	49721	577	0	50689
19287	354	177	1512	51635	0	53678
19288	203	126	55914	1441	0	57684
19289	166	126	55872	658	0	56822
19290	154	54312	1757	474	0	56697
19291	56091	1327	753	431	0	58602
19292	1418	502	58104	273	0	60297
19293	699	275	1554	56484	0	59012
19294	521	187	693	57985	0	59386
19295	378	138	424	60180	0	61120
19296	200	168	58509	2139	0	61016
19297	341	125	1581	57290	0	59337
19298	57433	143	670	2024	0	60270
19299	1588	142	462	57535	0	59727
19300	621	181	57473	1874	0	60149
19301	501	124	1590	57093	0	59308
19302	57255	112	714	2087	0	60168
19303	58407	106	505	1094	0	60112
19304	58156	122	379	769	0	59426
19305	2235	106	365	57464	0	60170
19306	57823	84	336	1893	0	60136
19307	58046	86	324	1013	0	59469
19308	57953	87	320	776	0	59136
19309	2176	55648	355	522	0	58701
19310	56760	1356	309	613	0	59038
19311	2045	507	326	56225	0	59103
19312	943	298	55761	1718	0	58720
19313	639	55801	1575	839	0	58854
19314	56465	1444	698	761	0	59368
19315	1856	576	500	56663	0	59595
19316	1033	369	352	55659	0	57413
19317	645	54706	383	1970	0	57704
19318	469	58113	378	994	0	59954
19319	54700	1793	327	796	0	57616
19320	1626	55548	342	604	0	58120
19321	54042	1650	317	555	0	56564
19322	1775	54334	306	470	0	56885
19323	53313	1693	255	583	0	55844
19324	1778	53503	258	520	0	56059
19325	835	56403	292	495	0	58025
19326	55158	1963	245	619	0	57985
19327	1815	837	55304	425	0	58381
19328	841	56246	1481	457	0	59025
19329	828	1651	621	56088	0	59188
19330	640	708	417	59776	0	61541
19331	671	487	391	59693	0	61242
19332	621	413	306	61101	0	62441
19333	535	373	60449	2484	0	63841
19334	58778	328	1715	1344	0	62165
19335	2075	304	729	62699	0	65807
19336	62977	285	527	2278	0	66067
19337	65165	292	440	1187	0	67084
19338	65830	296	377	1031	0	67534
19339	63919	295	401	887	0	65502
19340	2859	281	61393	711	0	65244
19341	1382	370	1927	60581	0	64260
19342	888	281	60569	2236	0	63974
19343	728	59488	2173	1134	0	63523
19344	1161	1924	1052	53618	0	57755
19345	861	693	617	58725	0	60896
19346	695	383	556	60296	0	61930
19347	720	299	473	59988	0	61480
19348	537	282	58717	2886	0	62422
19349	717	321	1957	58624	0	61619
19350	715	315	886	60654	0	62570
19351	59813	318	591	2901	0	63623
19352	62115	294	495	1588	0	64492
19353	2939	288	472	61955	0	65654
19354	1437	285	479	63190	0	65391
19355	1052	291	499	64352	0	66194
19356	62609	318	438	3506	0	66871
19357	64786	299	436	1849	0	67370
19358	61405	344	421	1488	0	63658
19359	64514	337	382	1165	0	66398
19360	3084	63373	376	1082	0	67915
19361	64758	1934	362	1131	0	68185
19362	65986	707	317	1114	0	68124
19363	3324	469	243	63813	0	67849
19364	1880	346	243	64655	0	67124
19365	62843	291	270	3108	0	66512
19366	2799	60585	297	1553	0	65234
19367	1639	63844	249	1091	0	66823
19368	66241	2368	240	1121	0	69970
19369	2993	988	233	67400	0	71614
19370	1826	621	194	68976	0	71617
19371	1520	487	188	70498	0	72693
19372	1314	515	201	70380	0	72410
19373	1241	517	205	69113	0	71076
19374	955	66932	240	3203	0	71330
19375	956	1916	173	66319	0	69364
19376	65689	788	179	2781	0	69437
19377	2334	547	166	65079	0	68126
19378	1185	433	160	65896	0	67674
19379	63684	400	168	2988	0	67240
19380	2187	64492	173	1558	0	68410
19381	1196	2034	197	63076	0	66503
19382	870	64367	188	2198	0	67623
19383	780	2174	177	62688	0	65819
19384	683	626	61359	1971	0	64639
19385	55331	416	1262	1304	0	58313
19386	1574	59895	402	830	0	62701
19387	56756	1152	219	747	0	58874
19388	1446	458	56116	555	0	58575
19389	728	549	977	51833	0	54087
19390	457	52734	381	1202	0	54774
19391	429	55138	275	693	0	56535
19392	53852	1190	229	612	0	55883
19393	1333	446	148	54476	0	56403
19394	581	315	57684	1288	0	59868
19395	527	210	996	58311	0	60044
19396	347	227	58671	1480	0	60725
19397	53934	164	1103	1050	0	56251
19398	1261	193	59588	615	0	61657
19399	761	157	1108	58075	0	60101
19400	480	61365	440	1298	0	63583
19401	571	1109	230	60692	0	62602
19402	418	62152	246	1366	0	64182
19403	63724	1161	188	891	0	65964
19404	1563	433	155	66266	0	68417
19405	702	316	66936	1529	0	69483
19406	604	275	63337	839	0	65055
19407	64185	222	1337	951	0	66695
19408	69864	220	488	737	0	71309
19409	69526	244	268	683	0	70721
19410	69020	200	225	743	0	70188
19411	1755	68538	226	565	0	71084
19412	69549	1183	213	710	0	71655
19413	69670	459	151	740	0	71020
19414	1809	379	67918	517	0	70623
19415	1053	263	1073	66801	0	69190
19416	68746	288	327	1728	0	71089
19417	1556	300	67385	809	0	70050
19418	920	249	1142	66916	0	69227
19419	718	281	70424	1561	0	72984
19420	799	233	1220	68483	0	70735
19421	639	72016	456	1440	0	74551
19422	72875	1147	257	1003	0	75282
19423	1546	520	71409	626	0	74101
19424	69845	366	1131	749	0	72091
19425	1705	333	434	72160	0	74632
19426	72502	248	257	1635	0	74642
19427	1630	285	228	72047	0	74190
19428	76214	244	225	1994	0	78677
19429	1562	324	74236	772	0	76894
19430	77692	269	1088	1055	0	80104
19431	1498	243	435	80083	0	82259
19432	868	220	258	80589	0	81935
19433	79691	206	236	1711	0	81844
19434	1384	182	182	80305	0	82053
19435	530	299	80584	1272	0	82685
19436	658	302	837	79369	0	81166
19437	76993	128	381	1381	0	78883
19438	917	76719	298	581	0	78515
19439	475	77782	204	470	0	78931
19440	77129	704	181	627	0	78641
19441	824	81240	198	364	0	82626
19442	613	695	167	81059	0	82534
19443	80527	269	241	1111	0	82148
19444	80317	231	134	629	0	81311
19445	79610	202	109	618	0	80539
19446	938	222	80796	283	0	82239
19447	559	325	603	79221	0	80708
19448	338	81019	287	698	0	82342
19449	465	588	227	81735	0	83015
19450	338	287	84103	661	0	85389
19451	338	78753	662	334	0	80087
19452	386	699	196	82230	0	83511
19453	80161	162	128	831	0	81282
19454	484	81222	111	246	0	82063
19455	268	498	83601	160	0	84527
19456	440	175	556	80653	0	81824
19457	205	172	83253	575	0	84205
19458	406	87	615	79226	0	80334
19459	83498	80	253	953	0	84784
19460	742	72	151	83949	0	84914
19461	84045	73	137	980	0	85235
19462	84241	92	132	662	0	85127
19463	764	85924	176	215	0	87079
19464	86924	582	121	564	0	88191
19465	798	86922	169	198	0	88087
19466	432	744	87948	173	0	89297
19467	812	214	739	84725	0	86490
19468	481	145	248	92617	0	93491
19469	289	198	89783	995	0	91265
19470	279	88946	836	394	0	90455
19471	89949	790	280	633	0	91652
19472	91816	239	220	591	0	92866
19473	1294	166	167	92981	0	94608
19474	708	137	170	92340	0	93355
19475	480	101	154	95170	0	95905
19476	93110	106	157	1546	0	94919
19477	1009	174	91687	517	0	93387
19478	470	242	91142	358	0	92212
19479	612	111	996	93371	0	95090
19480	322	173	93101	1040	0	94636
19481	306	200	91880	485	0	92871
19482	618	105	1073	88548	0	90344
19483	330	176	94526	1044	0	96076
19484	268	93651	1055	525	0	95499
19485	479	920	386	95263	0	97048
19486	270	359	97462	1145	0	99236
19487	533	185	1087	93982	0	95787
19488	246	91940	440	1190	0	93816
19489	404	895	309	95265	0	96873
19490	257	353	97301	1171	0	99082
19491	531	234	1035	92459	0	94259
19492	93107	171	411	1649	0	95338
19493	1047	190	95253	457	0	96947
19494	85545	141	1038	916	0	87640
19495	1143	94032	387	303	0	95865
19496	94073	1041	255	630	0	95999
19497	1343	341	231	94894	0	96809
19498	399	95517	252	1182	0	97350
19499	97941	1185	212	831	0	100169
19500	1649	426	211	99894	0	102180
19501	498	337	100777	1539	0	103151
19502	315	101032	1523	609	0	103479
19503	592	1444	512	101396	0	103944
19504	98893	411	300	1978	0	101582
19505	96625	303	226	887	0	98041
19506	2069	169	199	96559	0	98996
19507	647	215	96057	1675	0	98594
19508	86919	163	1591	1275	0	89948
19509	1632	278	96054	526	0	98490
19510	861	203	1758	94029	0	96851
19511	95580	236	573	2133	0	98522
19512	1661	95940	420	820	0	98841
19513	95863	1445	330	949	0	98587
19514	1907	505	94462	466	0	97340
19515	93187	288	1682	756	0	95913
19516	2087	222	715	95758	0	98782
19517	1000	214	490	97848	0	99552
19518	660	289	96899	1987	0	99835
19519	770	254	1653	92449	0	95126
19520	93464	241	623	2330	0	96658
19521	1945	295	493	93386	0	96119
19522	873	94775	438	1865	0	97951
19523	846	1497	438	93290	0	96071
19524	538	95158	397	1995	0	98088
19525	486	1696	92896	922	0	96000
19526	86187	532	1716	1323	0	89758
19527	2058	374	663	95169	0	98264
19528	760	368	90945	2005	0	94078
19529	652	89733	1747	928	0	93060
19530	680	1710	640	86993	0	90023
19531	680	730	503	88995	0	90908
19532	87182	500	474	2638	0	90794
19533	2089	422	462	89784	0	92757
19534	89989	338	499	2633	0	93459
19535	89059	339	505	1407	0	91310
19536	2415	89617	470	943	0	93445
19537	91010	2045	457	1059	0	94571
19538	2761	677	375	97155	0	100968
19539	1095	499	97139	2696	0	101429
19540	95601	334	2282	1512	0	99729
19541	3029	304	754	95125	0	99212
19542	1195	351	94957	2725	0	99228
19543	90741	407	2343	1428	0	94919
19544	3008	353	800	94249	0	98410
19545	1186	96901	680	2755	0	101522
19546	1381	2311	565	92251	0	96508
19547	858	96740	604	2775	0	100977
19548	94803	2494	606	1572	0	99475
19549	2839	798	97383	1031	0	102051
19550	1144	96351	2424	1015	0	100934
19551	1171	2494	836	96762	0	101263
19552	805	873	98336	2807	0	102821
19553	800	767	94596	1255	0	97418
19554	746	97714	2776	1094	0	102330
19555	1258	2816	1071	96322	0	101467
19556	938	911	777	100308	0	102934
19557	1083	748	606	120184	0	122621
19558	121858	496	642	5401	0	128397
19559	4570	640	126399	1659	0	133268
19560	1343	127020	4728	1283	0	134374
19561	1447	4707	1356	122604	0	130114
19562	1143	1319	986	130642	0	134090
19563	706	964	126887	5903	0	134460
19564	1277	785	4695	126565	0	133322
19565	703	536	126073	5764	0	133076
19566	698	608	123009	2001	0	126316
19567	808	531	124144	1525	0	127008
19568	1185	488	5772	115203	0	122648
19569	1007	547	2009	120549	0	124112
19570	973	459	1181	125384	0	127997
19571	120341	405	1021	6491	0	128258
19572	4600	120354	1097	2374	0	128425
19573	121576	4558	957	1860	0	128951
19574	116646	1297	830	1935	0	120708
19575	123773	855	763	1566	0	126957
19576	5726	123660	808	1392	0	131586
19577	124723	4672	756	1398	0	131549
19578	128353	1451	664	1324	0	131792
19579	6436	995	693	123813	0	131937
19580	2829	706	659	127428	0	131622
19581	2013	649	663	130164	0	133489
19582	1281	777	124407	6592	0	133057
19583	120360	551	4829	2787	0	128527
19584	5726	585	1546	123962	0	131819
19585	121078	629	1168	5977	0	128852
19586	5495	121033	920	2506	0	129954
19587	2329	4660	924	121624	0	129537
19588	1850	1270	915	127063	0	131098
19589	122667	980	845	6656	0	131148
19590	5661	723	718	123161	0	130263
19591	112033	834	758	6598	0	120223
19592	121851	819	618	2689	0	125977
19593	6036	115542	639	2210	0	124427
19594	2118	120801	678	1677	0	125274
19595	2145	5821	652	112997	0	121615
19596	1204	119156	682	5069	0	126111
19597	1705	5157	668	118091	0	125621
19598	1269	1424	116458	5568	0	124719
19599	1008	1146	113190	2207	0	117551
19600	106534	986	4747	1988	0	114255
19601	111442	591	1725	1694	0	115452
19602	5048	109103	1110	1677	0	116938
19603	108981	4138	808	1679	0	115606
19604	4861	114536	850	1442	0	121689
19605	1930	4484	900	116067	0	123381
19606	1623	1328	883	119210	0	123044
19607	1422	979	837	119644	0	122882
19608	1064	869	916	121086	0	123935
19609	115960	635	954	6357	0	123906
19610	4403	116716	931	2754	0	124804
19611	117362	4170	817	2355	0	124704
19612	120576	1266	871	2018	0	124731
19613	5694	1037	116333	1558	0	124622
19614	113817	907	4099	1724	0	120547
19615	5539	115982	1177	1344	0	124042
19616	2424	4574	915	115658	0	123571
19617	2224	1642	684	114518	0	119068
19618	1677	114728	713	5152	0	122270
19619	117087	4554	880	2615	0	125136
19620	5266	1467	115240	2031	0	124004
19621	113120	1277	4276	2395	0	121068
19622	5677	852	116177	2120	0	124826
19623	2649	820	4974	115561	0	124004
19624	2336	1095	1900	120181	0	125512
19625	2082	925	1677	122481	0	127165
19626	119295	1155	1484	7246	0	129180
19627	5187	978	121137	3739	0	131041
19628	120021	1008	4878	3525	0	129432
19629	125240	933	2221	3173	0	131567
19630	125175	762	1888	3139	0	130964
19631	124906	691	1932	2609	0	130138
19632	6820	714	1706	121199	0	130439
19633	2868	791	118207	5554	0	127420
19634	2893	910	4197	116953	0	124953
19635	2318	768	116591	5833	0	125510
19636	2294	1068	114113	2796	0	120271
19637	2399	114722	4168	2348	0	123637
19638	2628	4128	1446	104972	0	113174
19639	2610	1610	929	111140	0	116289
19640	2923	1438	840	96245	0	101446
19641	2818	970	765	109887	0	114440
19642	109010	1026	717	5361	0	116114
19643	111047	810	528	2669	0	115054
19644	6002	740	519	107848	0	115109
19645	2735	732	104248	5473	0	113188
19646	2205	624	3515	105953	0	112297
19647	1863	592	1205	109802	0	113462
19648	1694	495	105655	5887	0	113731
19649	2063	535	3559	104209	0	110366
19650	104019	780	1167	5628	0	111594
19651	105720	714	812	2891	0	110137
19652	105375	919	487	2497	0	109278
19653	5638	797	362	102526	0	109323
19654	100728	657	459	4941	0	106785
19655	99548	586	523	2529	0	103186
19656	5234	554	95018	2062	0	102868
19657	1325	217	68869	889	0	71300
19658	1030	232	70024	727	0	72013
19659	63562	125	817	576	0	65080
19660	857	66185	423	369	0	67834
19661	66898	561	379	430	0	68268
19662	884	71395	196	296	0	72771
19663	519	665	217	71400	0	72801
19664	460	205	147	71896	0	72708
19665	442	167	140	72175	0	72924
19666	342	136	71377	972	0	72827
19667	65399	98	674	722	0	66893
19668	968	79	273	70880	0	72200
19669	390	94	70071	708	0	71263
19670	349	113	65370	353	0	66185
19671	63902	68	725	559	0	65254
19672	681	69538	335	312	0	70866
19673	68421	508	258	410	0	69597
19674	68060	170	124	434	0	68788
19675	734	67905	130	236	0	69005
19676	65811	502	123	373	0	66809
19677	756	188	67766	189	0	68899
19678	353	149	64195	172	0	64869
19679	300	112	67509	151	0	68072
19680	328	300	691	66984	0	68303
19681	176	75	68738	478	0	69467
19682	63494	45	507	488	0	64534
19683	66378	35	216	389	0	67018
19684	643	80	68560	132	0	69415
19685	396	54	461	66640	0	67551
19686	67869	30	187	661	0	68747
19687	531	69882	176	223	0	70812
19688	239	71491	122	156	0	72008
19689	71438	470	71	382	0	72361
19690	512	196	72981	77	0	73766
19691	330	258	421	70148	0	71157
19692	231	30	176	71308	0	71745
19693	159	30	118	73075	0	73382
19694	75	73442	95	544	0	74156
19695	485	532	114	67478	0	68609
19696	77546	140	62	915	0	78663
19697	863	90	60	79006	0	80019
19698	255	79424	72	882	0	80633
19699	80389	770	46	551	0	81756
19700	1000	272	42	81042	0	82356
19701	425	170	46	84987	0	85628
19702	86231	93	42	1424	0	87790
19703	86751	55	56	674	0	87536
19704	1421	57	48	84472	0	85998
19705	85866	84	42	1428	0	87420
19706	86168	60	35	692	0	86955
19707	1457	86871	77	342	0	88747
19708	87297	1115	28	481	0	88921
19709	1409	86836	55	207	0	88507
19710	828	1173	31	86447	0	88479
19711	404	475	87914	1231	0	90024
19712	549	229	1115	86394	0	88287
19713	561	146	340	87843	0	88890
19714	431	151	163	91893	0	92638
19715	90773	131	106	2014	0	93024
19716	1420	90776	105	765	0	93066
19717	93370	1278	72	724	0	95444
19718	1620	97068	140	452	0	99280
19719	98901	1535	97	666	0	101199
19720	99937	588	65	658	0	101248
19721	100732	343	84	580	0	101739
19722	99951	265	80	567	0	100863
19723	2354	301	99619	301	0	102575
19724	1248	246	1546	98886	0	101926
19725	1006	218	473	103419	0	105116
19726	536	262	101926	2314	0	105038
19727	96267	174	1837	1118	0	99396
19728	2434	158	534	100088	0	103214
19729	929	240	99042	2155	0	102366
19730	709	227	97829	748	0	99513
19731	845	206	2304	100017	0	103372
19732	590	240	102823	2198	0	105851
19733	861	187	2206	99807	0	103061
19734	897	136	761	101572	0	103366
19735	572	215	99574	2598	0	102959
19736	93703	182	2175	1340	0	97400
19737	2455	182	804	99360	0	102801
19738	921	234	100141	2424	0	103720
19739	882	155	2186	99906	0	103129
19740	99937	136	876	2826	0	103775
19741	2349	146	99931	1175	0	103601
19742	94760	154	2225	1255	0	98394
19743	101941	129	890	952	0	103912
19744	2994	153	670	100904	0	104721
19745	1404	162	519	101716	0	103801
19746	957	233	100767	2820	0	104777
19747	976	192	2241	100416	0	103825
19748	1348	232	1033	90596	0	93209
19749	887	171	684	102914	0	104656
19750	753	188	99547	3117	0	103605
19751	94997	140	2236	1859	0	99232
19752	99929	148	973	1407	0	102457
19753	101773	169	674	1279	0	103895
19754	104038	179	557	1175	0	105949
19755	3463	254	519	103121	0	107357
19756	102548	222	509	2917	0	106196
19757	103477	220	473	1530	0	105700
19758	77429	961	797	2371	0	81558
19759	102850	178	539	1321	0	104888
19760	3239	102597	592	970	0	107398
19761	103512	1947	482	1196	0	107137
19762	103288	546	480	1256	0	105570
19763	3496	102291	564	986	0	107337
19764	103288	2389	513	1016	0	107206
19765	3809	660	500	102592	0	107561
19766	1983	451	437	104460	0	107331
19767	102193	351	523	3594	0	106661
19768	3424	99835	511	1461	0	105231
19769	1624	101868	523	1097	0	105112
19770	1552	2680	461	102606	0	107299
19771	1283	843	103462	2937	0	108525
19772	1340	472	2538	101003	0	105353
19773	1317	359	860	105836	0	108372
19774	103320	375	668	3796	0	108159
19775	105256	401	608	1698	0	107963
19776	3815	341	511	104368	0	109035
19777	1569	408	103467	3337	0	108781
19778	1476	273	2737	104821	0	109307
19779	106316	235	995	3787	0	111333
19780	3539	310	110191	1685	0	115725
19781	1723	110361	3215	1320	0	116619
19782	112955	2890	1076	1470	0	118391
19783	4072	861	812	112799	0	118544
19784	1962	520	731	114098	0	117311
19785	1607	427	643	117099	0	119776
19786	1285	356	112196	4656	0	118493
19787	101770	306	3213	2649	0	107938
19788	3966	369	108729	1536	0	114600
19789	1881	106959	3421	1353	0	113614
19790	1751	2702	1300	108665	0	114418
19791	1639	849	897	111915	0	115300
19792	1558	607	822	117871	0	120858
19793	1211	474	114153	5363	0	121201
19794	1100	355	110915	2346	0	114716
19795	962	419	112276	1705	0	115362
19796	993	110431	4290	1348	0	117062
19797	1430	3363	1831	109407	0	116031
19798	111387	912	1105	4376	0	117780
19799	117302	576	910	1970	0	120758
19800	4948	451	119619	1368	0	126386
19801	1985	119094	4140	1291	0	126510
19802	1463	3816	117754	1037	0	124070
19803	1105	122212	4183	1084	0	128584
19804	117273	4557	2078	1389	0	125297
19805	118336	1328	1149	1288	0	122101
19806	4948	116798	952	994	0	123692
19807	117324	4229	840	996	0	123389
19808	5360	1428	820	115170	0	122778
19809	2477	1027	782	119112	0	123398
19810	117252	868	702	5187	0	124009
19811	115912	709	592	2229	0	119442
19812	115727	639	523	1744	0	118633
19813	5890	110452	576	1340	0	118258
19814	2489	116134	646	1151	0	120420
19815	114440	4613	563	1331	0	120947
19816	5070	1669	113245	998	0	120982
19817	2635	1829	3786	108830	0	117080
19818	106593	920	1240	4254	0	113007
19819	4905	102194	876	1489	0	109464
19820	2061	108614	644	1160	0	112479
19821	107070	4635	612	1142	0	113459
19822	4897	1688	104135	949	0	111669
19823	99923	1345	3713	1051	0	106032
19824	4893	931	99831	806	0	106461
19825	2121	848	99492	577	0	103038
19826	1988	956	4192	96462	0	103598
19827	1396	858	101005	3460	0	106719
19828	98194	747	4046	1443	0	104430
19829	101558	614	1736	1206	0	105114
19830	103758	593	1282	983	0	106616
19831	103760	586	1095	903	0	106344
19832	5588	566	949	98539	0	105642
19833	99717	591	854	3820	0	104982
19834	4759	97701	874	1457	0	104791
19835	2911	3396	716	90891	0	97914
19836	2023	99138	761	3162	0	105084
19837	102370	3675	729	1538	0	108312
19838	103982	1365	726	1267	0	107340
19839	5177	1087	746	101043	0	108053
19840	103106	852	757	3938	0	108653
19841	105288	857	737	1727	0	108609
19842	5376	801	675	102248	0	109100
19843	3054	790	630	103554	0	108028
19844	2544	709	607	105872	0	109732
19845	2058	667	100921	4923	0	108569
19846	1828	666	97717	2294	0	102505
19847	1804	684	100933	1650	0	105071
19848	1896	738	4435	99706	0	106775
19849	1515	733	102318	4185	0	108751
19850	1713	735	4219	101024	0	107691
19851	1610	634	106576	4531	0	113351
19852	1540	605	104723	2076	0	108944
19853	99565	577	4722	2031	0	106895
19854	4135	101933	2209	1498	0	109775
19855	104169	3391	1715	1379	0	110654
19856	4699	1268	1375	102364	0	109706
19857	2501	929	1224	104917	0	109571
19858	1889	862	102915	4569	0	110235
19859	1582	101934	3863	2224	0	109603
19860	1755	3620	1660	102483	0	109518
19861	1508	1407	104449	3879	0	111243
19862	1382	101188	3509	1806	0	107885
19863	1520	3142	1674	101599	0	107935
19864	100992	1277	1434	3829	0	107532
19865	102660	1063	1145	1855	0	106723
19866	4455	835	1134	101563	0	107987
19867	102133	842	1008	3811	0	107794
19868	4169	101695	1040	1774	0	108678
19869	2313	3281	973	102812	0	109379
19870	1892	1422	104882	3723	0	111919
19871	1966	984	3422	104656	0	111028
19872	1679	880	104666	4101	0	111326
19873	101842	856	3666	2113	0	108477
19874	4432	803	1407	103324	0	109966
19875	2087	104228	1212	3857	0	111384
19876	2024	3519	926	107290	0	113759
19877	1613	1192	105151	4213	0	112169
19878	1607	967	102662	2039	0	107275
19879	1515	737	100675	1510	0	104437
19880	92258	899	3945	1314	0	98416
19881	3091	95606	1629	1122	0	101448
19882	1577	2660	1207	94539	0	99983
19883	95095	963	1101	3210	0	100369
19884	2933	95260	1138	1523	0	100854
19885	97917	2585	995	1523	0	103020
19886	99461	1091	977	1202	0	102731
19887	100905	889	874	1213	0	103881
19888	102583	644	899	1159	0	105285
19889	3972	675	99010	883	0	104540
19890	94972	454	2679	1129	0	99234
19891	3423	479	95788	801	0	100491
19892	88017	355	2228	854	0	91454
19893	2984	382	1144	92742	0	97252
19894	1729	353	91793	1831	0	95706
19895	1402	89507	1881	977	0	93767
19896	1628	3896	1113	84693	0	91330
19897	1268	87047	746	1440	0	90501
19898	1006	89023	595	943	0	91567
19899	79941	1282	749	811	0	82783
19900	1419	404	78668	421	0	80912
19901	475	74519	775	238	0	76007
19902	72677	608	635	344	0	74264
19903	695	74328	261	141	0	75425
19904	74783	589	155	318	0	75845
19905	824	302	159	74579	0	75864
19906	75348	163	155	695	0	76361
19907	744	123	149	74470	0	75486
19908	74793	122	272	751	0	75938
19909	726	168	133	74683	0	75710
19910	305	76735	143	628	0	77811
19911	357	578	158	78505	0	79598
19912	78198	248	154	796	0	79396
19913	623	77824	169	312	0	78928
19914	359	590	153	77793	0	78895
19915	78352	260	131	770	0	79513
19916	744	194	105	78930	0	79973
19917	429	158	122	78791	0	79500
19918	292	177	79819	762	0	81050
19919	297	185	76661	375	0	77518
19920	341	177	662	77205	0	78385
19921	248	201	82654	677	0	83780
19922	313	166	635	81557	0	82671
19923	601	193	382	71805	0	72981
19924	303	162	176	83317	0	83958
19925	254	210	83344	834	0	84642
19926	409	152	556	78653	0	79770
19927	346	142	219	81158	0	81865
19928	235	81833	188	813	0	83069
19929	289	551	175	83676	0	84691
19930	83269	205	185	978	0	84637
19931	790	145	191	84950	0	86076
19932	326	142	96537	916	0	97921
19933	87733	122	1370	890	0	90115
19934	1366	101101	792	427	0	103686
19935	1077	1374	567	102211	0	105229
19936	654	794	101783	1523	0	104754
19937	91837	582	1494	1389	0	95302
19938	1498	100124	952	783	0	103357
19939	100759	1502	689	688	0	103638
19940	2170	887	366	99891	0	103314
19941	99280	652	270	1889	0	102091
19942	2155	409	98416	946	0	101926
19943	1239	95772	1451	833	0	99295
19944	875	104044	838	508	0	106265
19945	104774	1993	660	697	0	108124
19946	104607	1173	320	758	0	106858
19947	2384	842	104046	260	0	107532
19948	100190	411	1602	526	0	102729
19949	103859	316	824	502	0	105501
19950	103556	301	632	568	0	105057
19951	2832	98913	380	277	0	102402
19952	1735	101116	227	295	0	103373
19953	100892	2000	300	499	0	103691
19954	101652	1237	207	489	0	103585
19955	2369	102583	193	279	0	105424
19956	1733	1781	134	102199	0	105847
19957	1024	1067	102382	1443	0	105916
19958	97822	807	1503	1163	0	101295
19959	90263	825	990	1614	0	93692
19960	105607	332	688	825	0	107452
19961	2462	103787	387	430	0	107066
19962	1474	1570	103983	347	0	107374
19963	105254	848	1700	516	0	108318
19964	2242	720	832	106943	0	110737
19965	1551	427	656	107072	0	109706
19966	1293	307	364	110407	0	112371
19967	709	376	109006	2650	0	112741
19968	819	212	1540	106437	0	109008
19969	571	267	108418	2322	0	111578
19970	268	103800	1781	1286	0	107135
19971	101934	1329	911	1155	0	105329
19972	1364	103121	682	551	0	105718
19973	874	104339	444	343	0	106000
19974	103243	2007	325	625	0	106200
19975	1567	107009	301	190	0	109067
19976	1126	2069	148	104187	0	107530
19977	883	105467	151	1162	0	107663
19978	104358	2037	136	877	0	107408
19979	1557	106096	127	581	0	108361
19980	1223	1995	122	106913	0	110253
19981	846	1220	105875	1468	0	109409
19982	710	813	1417	105935	0	108875
19983	398	106751	868	2213	0	110230
19984	573	1721	710	109807	0	112811
19985	531	1232	408	108983	0	111154
19986	723	851	360	104332	0	106266
19987	565	434	294	110522	0	111815
19988	570	386	242	111176	0	112374
19989	556	410	240	112043	0	113249
19990	421	358	108656	3542	0	112977
19991	103052	323	1910	2537	0	107822
19992	2191	340	1043	115139	0	118713
19993	1228	318	114233	2782	0	118561
19994	1047	402	112428	1691	0	115568
19995	925	367	3113	115475	0	119880
19996	116847	396	1902	3042	0	122187
19997	2592	446	114845	1643	0	119526
19998	111348	391	2709	1707	0	116155
19999	3223	427	118428	851	0	122929
20000	2159	457	3126	116632	0	122374
20001	1736	500	1617	121347	0	125200
20002	1217	552	120000	3322	0	125091
20003	111324	464	2860	2493	0	117141
20004	3106	462	1570	118174	0	123312
20005	1811	440	118484	2977	0	123712
20006	1616	404	117032	1860	0	120912
20007	1595	440	3590	110066	0	115691
20008	971	117973	2320	2578	0	123842
20009	119821	2304	1523	1864	0	125512
20010	119012	1330	1050	1635	0	123027
20011	3909	1096	119722	924	0	125651
20012	2703	699	2861	115467	0	121730
20013	118971	597	1606	3287	0	124461
20014	3341	562	118690	1856	0	124449
20015	113302	349	3013	1950	0	118614
20016	3716	113814	1923	1222	0	120675
20017	2331	2372	1501	119222	0	125426
20018	1961	1280	1089	121143	0	125473
20019	122319	997	959	4169	0	128444
20020	3456	688	934	123141	0	128219
20021	2174	679	799	121680	0	125332
20022	1830	615	687	123789	0	126921
20023	119610	452	693	5410	0	126165
20024	3354	518	118646	3101	0	125619
20025	116964	482	2965	2624	0	123035
20026	118970	416	1674	2205	0	123265
20027	122774	429	1375	1830	0	126408
20028	5261	605	969	119265	0	126100
20029	3074	573	121451	3593	0	128691
20030	2070	115152	3382	2284	0	122888
20031	1577	117543	1691	2100	0	122911
20032	1055	112715	833	1185	0	115788
20033	1124	2775	113376	1130	0	118405
20034	1393	1589	2795	123873	0	129650
20035	127451	624	1269	4214	0	133558
20036	135076	445	796	2436	0	138753
20037	5206	425	636	138861	0	145128
20038	2583	430	137962	4437	0	145412
20039	1732	426	138141	2280	0	142579
20040	1558	337	4999	138522	0	145416
20041	1145	359	141479	4693	0	147676
20042	1429	261	4919	141369	0	147978
20043	1544	323	2479	137024	0	141370
20044	996	139727	1967	5584	0	148274
20045	1473	3746	1350	141953	0	148522
20046	1400	1549	1215	147880	0	152044
20047	143281	1140	1395	6950	0	152766
20048	4911	552	1323	145260	0	152046
20049	2683	491	1184	147862	0	152220
20050	141430	440	1250	7257	0	150377
20051	4585	141527	1375	4146	0	151633
20052	143121	3810	1335	3276	0	151542
20053	5388	1801	140873	2391	0	150453
20054	139077	1153	4578	2757	0	147565
20055	141831	774	2427	2601	0	147633
20056	6525	719	137945	2038	0	147227
20057	3608	765	137706	2023	0	144102
20058	3130	740	5976	131995	0	141841
20059	133695	514	3256	5830	0	143295
20060	5535	604	132421	2981	0	141541
20061	3619	465	5306	130929	0	140319
20062	2531	576	131458	5493	0	140058
20063	2622	522	5780	128367	0	137291
20064	2464	508	3108	132525	0	138605
20065	129148	542	2591	7187	0	139468
20066	127212	532	2078	4556	0	134378
20067	132616	567	1684	3665	0	138532
20068	7359	530	130809	2660	0	141358
20069	4006	532	131767	2616	0	138921
20070	3241	573	6281	128924	0	139019
20071	2788	635	3660	131295	0	138378
20072	2718	659	2543	135459	0	141379
20073	129043	608	2109	7685	0	139445
20074	5572	128788	2057	4427	0	140844
20075	125503	3929	1893	3657	0	134982
20076	122881	1768	1629	3291	0	129569
20077	6768	121504	1734	2692	0	132698
20078	4211	126388	1764	2464	0	134827
20079	123907	5003	1641	2872	0	133423
20080	5989	2453	1539	119374	0	129355
20081	3840	120227	1578	6235	0	131880
20082	4169	4224	1385	122111	0	131889
20083	3213	2301	119205	6527	0	131246
20084	2982	1616	4770	120440	0	129808
20085	118337	1138	3348	7197	0	130020
20086	5494	1216	117403	4387	0	128500
20087	3467	1065	116868	4060	0	125460
20088	3346	2630	6578	106031	0	118585
20089	2562	106716	3849	6000	0	119127
20090	2284	109064	2434	4444	0	118226
20091	2026	114662	2041	4047	0	122776
20092	108694	5021	1911	3856	0	119482
20093	109160	2402	1434	3868	0	116864
20094	105684	1606	1420	3583	0	112293
20095	6091	105039	1598	3536	0	116264
20096	107370	3566	1585	3409	0	115930
20097	106931	2018	1576	3029	0	113554
20098	6504	2136	103823	2401	0	114864
20099	4613	100995	4595	2091	0	112294
20100	3886	3932	3203	101672	0	112693
20101	102009	2203	2529	4934	0	111675
20102	6023	1655	100717	3215	0	111610
20103	3842	1086	5082	96563	0	106573
20104	2988	99144	3511	5321	0	110964
20105	3222	3619	2475	100003	0	109319
20106	3273	1864	2188	102615	0	109940
20107	101218	1359	2512	6727	0	111816
20108	102181	1313	2181	4869	0	110544
20109	6298	1201	2206	101187	0	110892
20110	4097	1249	97891	6039	0	109276
20111	3393	1213	97576	4365	0	106547
20112	97701	1169	5036	3716	0	107622
20113	6597	1172	99821	2726	0	110316
20114	5000	1032	5006	89698	0	100736
20115	3724	95038	3623	4452	0	106837
20116	95666	3493	3174	3309	0	105642
20117	5367	95254	2591	3308	0	106520
20118	97117	3992	2111	3615	0	106835
20119	5946	2115	2006	95212	0	105279
20120	4373	1856	1847	97034	0	105110
20121	96015	1896	1686	5983	0	105580
20122	98484	1509	1716	3739	0	105448
20123	7144	1704	1633	95419	0	105900
20124	4725	2048	1610	96536	0	104919
20125	3678	1939	92490	5519	0	103626
20126	3091	1676	91565	3849	0	100181
20127	89547	1526	4699	3687	0	99459
20128	4810	1826	85061	3016	0	94713
20129	86050	1247	4026	3409	0	94732
20130	89101	932	2902	3095	0	96030
20131	6040	1012	85060	2791	0	94903
20132	4111	79045	3831	2372	0	89359
20133	3303	81350	3002	1793	0	89448
20134	1575	1841	66567	939	0	70922
20135	2487	3455	3032	58589	0	67563
20136	56662	972	2072	2285	0	61991
20137	55510	293	401	892	0	57096
20138	60877	245	314	741	0	62177
20139	69391	235	275	700	0	70601
20140	70136	213	293	629	0	71271
20141	3083	69967	421	415	0	73886
20142	67614	2111	258	472	0	70455
20143	2574	66934	270	317	0	70095
20144	65553	2133	189	330	0	68205
20145	2652	669	63766	131	0	67218
20146	1412	262	1953	61368	0	64995
20147	1183	246	551	59698	0	61678
20148	568	62303	273	2106	0	65250
20149	62744	2114	151	814	0	65823
20150	64336	848	132	454	0	65770
20151	3168	409	159	61736	0	65472
20152	1370	286	321	63517	0	65494
20153	62419	153	234	2915	0	65721
20154	2544	228	161	62542	0	65475
20155	1149	329	128	64135	0	65741
20156	62742	300	102	2881	0	66025
20157	2860	205	98	62620	0	65783
20158	63012	161	124	2796	0	66093
20159	63680	152	111	1423	0	65366
20160	3021	124	62170	726	0	66041
20161	62622	118	1926	968	0	65634
20162	63911	119	545	872	0	65447
20163	64505	125	229	731	0	65590
20164	3191	147	60469	577	0	64384
20165	1707	113	1941	59205	0	62966
20166	1265	106	613	62126	0	64110
20167	828	149	60229	2634	0	63840
20168	58196	131	2164	1037	0	61528
20169	3019	106	659	57948	0	61732
20170	1383	122	57432	2317	0	61254
20171	904	130	59543	863	0	61440
20172	895	116	2615	58573	0	62199
20173	669	135	60407	2639	0	63850
20174	821	96	2540	59412	0	62869
20175	971	99	927	61464	0	63461
20176	752	154	60451	3102	0	64459
20177	858	151	2478	57447	0	60934
20178	571	57178	1123	2436	0	61308
20179	518	62821	709	1191	0	65239
20180	61014	2454	689	935	0	65092
20181	61827	726	498	1025	0	64076
20182	2871	60897	415	906	0	65089
20183	61213	2159	506	876	0	64754
20184	62727	735	459	797	0	64718
20185	3329	560	335	60658	0	64882
20186	1457	596	304	62754	0	65111
20187	60533	485	284	3101	0	64403
20188	3069	59004	276	1178	0	63527
20189	1477	61719	313	763	0	64272
20190	1404	2683	294	60294	0	64675
20191	1221	901	60872	2572	0	65566
20192	58795	537	2239	1503	0	63074
20193	62147	381	759	1192	0	64479
20194	60563	430	382	1008	0	62383
20195	3437	60572	375	630	0	65014
20196	1816	2614	348	59218	0	63996
20197	1360	978	355	62524	0	65217
20198	60653	495	477	3386	0	65011
20199	3262	60372	472	1406	0	65512
20200	2127	2341	349	59779	0	64596
20201	1813	920	297	62011	0	65041
20202	1653	777	309	62275	0	65014
20203	60505	680	326	3753	0	65264
20204	3247	60111	390	1946	0	65694
20205	2130	2878	334	56945	0	62287
20206	1489	60173	417	2747	0	64826
20207	59314	2651	433	1628	0	64026
20208	3243	1018	58043	1481	0	63785
20209	56690	597	2399	1677	0	61363
20210	3250	580	56684	1391	0	61905
20211	1930	1015	2291	54198	0	59434
20212	54553	604	853	2994	0	59004
20213	3069	628	54617	1546	0	59860
20214	55097	437	2176	1354	0	59064
20215	57711	281	1060	1369	0	60421
20216	58684	248	664	1274	0	60870
20217	3664	267	704	55479	0	60114
20218	1925	255	578	56342	0	59100
20219	1677	214	529	57725	0	60145
20220	55406	194	633	3457	0	59690
20221	3197	55735	636	1633	0	61201
20222	57487	1864	613	1107	0	61071
20223	58928	621	619	985	0	61153
20224	3611	365	56043	1028	0	61047
20225	56078	296	2150	1227	0	59751
20226	59396	207	939	1315	0	61857
20227	3607	276	678	58037	0	62598
20228	1827	477	631	58635	0	61570
20229	1510	396	604	59407	0	61917
20230	56920	334	602	3099	0	60955
20231	56755	268	713	1574	0	59310
20232	54878	221	664	1161	0	56924
20233	3009	51013	646	958	0	55626
20234	1160	48587	566	1003	0	51316
20235	728	49997	525	1123	0	52373
20236	48587	1929	643	1281	0	52440
20237	2243	611	47333	1081	0	51268
20238	1050	336	40588	723	0	42697
20239	31103	126	664	312	0	32205
20240	595	90	35680	191	0	36556
20241	221	45	260	31669	0	32195
20242	116	30644	133	285	0	31178
20243	33805	258	50	220	0	34333
20244	34002	86	57	140	0	34285
20245	34016	67	46	142	0	34271
20246	486	66	27	38025	0	38604
20247	204	79	39834	263	0	40380
20248	165	82	37849	126	0	38222
20249	38492	76	305	174	0	39047
20250	40386	40	128	171	0	40725
20251	39834	32	96	170	0	40132
20252	460	39	69	40777	0	41345
20253	258	32	65	40919	0	41274
20254	176	51	40598	320	0	41145
20255	38913	57	247	271	0	39488
20256	369	63	105	42126	0	42663
20257	241	30	46	41949	0	42266
20258	202	36	59	42011	0	42308
20259	137	42092	51	375	0	42655
20260	167	243	42	42428	0	42880
20261	145	83	78	42140	0	42446
20262	41774	32	63	497	0	42366
20263	390	57	41057	153	0	41657
20264	38860	37	256	261	0	39414
20265	42027	48	91	228	0	42394
20266	414	58	36	41737	0	42245
20267	210	58	63	41760	0	42091
20268	41447	27	56	460	0	41990
20269	388	67	40655	150	0	41260
20270	178	40509	282	163	0	41132
20271	131	181	82	40858	0	41252
20272	40559	68	58	334	0	41019
20273	284	44	69	39708	0	40105
20274	159	61	39276	282	0	39778
20275	200	40	37243	153	0	37636
20276	37703	29	239	208	0	38179
20277	327	42	85	40629	0	41083
20278	155	52	40172	244	0	40623
20279	38153	19	204	295	0	38671
20280	41887	31	75	274	0	42267
20281	300	29	51	41950	0	42330
20282	194	25	62	41859	0	42140
20283	109	41887	64	230	0	42290
20284	43360	162	39	268	0	43829
20285	267	49	44	43721	0	44081
20286	177	45	31	44067	0	44320
20287	72	53	44924	257	0	45306
20288	39908	21	181	338	0	40448
20289	43491	21	68	209	0	43789
20290	258	43273	50	91	0	43672
20291	94	125	42138	62	0	42419
20292	84	51	41916	57	0	42108
20293	139	110	148	41320	0	41717
20294	43645	35	84	261	0	44025
20295	142	6	24	43518	0	43690
20296	44861	6	14	327	0	45208
20297	44895	12	14	230	0	45151
20298	45210	14	17	190	0	45431
20299	184	9	33	45469	0	45695
20300	135	19	34	45513	0	45701
20301	46369	7	16	257	0	46649
20302	113	32	47610	46	0	47801
20303	42235	11	45	240	0	42531
20304	43853	6	13	216	0	44088
20305	61	19	46536	13	0	46629
20306	37	26	44877	21	0	44961
20307	21	46018	48	20	0	46107
20308	71	65	51	47164	0	47351
20309	43387	29	51	222	0	43689
20310	59	13	4	47204	0	47280
20311	21	49	47862	46	0	47978
20312	18	46079	40	27	0	46164
20313	11	47099	28	20	0	47158
20314	67	28	9	49451	0	49555
20315	72	10	9	48725	0	48816
20316	11	48904	23	51	0	48989
20317	36	71	48830	14	0	48951
20318	44091	10	65	285	0	44451
20319	50157	4	9	181	0	50351
20320	70	50770	19	29	0	50888
20321	49188	86	15	182	0	49471
20322	137	71	6	48665	0	48879
20323	48613	10	3	258	0	48884
20324	175	12	4	48719	0	48910
20325	31	52409	19	192	0	52651
20326	38	320	53455	23	0	53836
20327	178	31	332	58717	0	59258
20328	308	48	87	55794	0	56237
20329	138	17	16	62834	0	63005
20330	64299	13	20	1049	0	65381
20331	1036	22	13	64752	0	65823
20332	233	37	68623	946	0	69839
20333	152	54	68873	280	0	69359
20334	69642	19	1359	441	0	71461
20335	1270	56	73045	136	0	74507
20336	72116	21	1351	319	0	73807
20337	1604	23	293	76709	0	78629
20338	617	24	178	78336	0	79155
20339	454	43	181	81922	0	82600
20340	444	34	131	80683	0	81292
20341	79678	21	118	2430	0	82247
20342	1825	45	80161	671	0	82702
20343	853	14	1780	76034	0	78681
20344	309	80986	544	1703	0	83542
20345	81384	1671	279	813	0	84147
20346	2068	327	240	77814	0	80449
20347	76452	152	201	2202	0	79007
20348	2135	121	75990	669	0	78915
20349	944	90	1925	70717	0	73676
20350	360	75381	492	1866	0	78099
20351	75937	1791	285	860	0	78873
20352	2111	400	75695	575	0	78781
20353	890	198	1928	73396	0	76412
20354	698	147	556	77123	0	78524
20355	75569	164	364	2632	0	78729
20356	2117	184	75719	932	0	78952
20357	712	193	76488	680	0	78073
20358	855	163	2333	75562	0	78913
20359	516	116	76505	2137	0	79274
20360	424	120	78016	897	0	79457
20361	777	194	2513	75392	0	78876
20362	832	176	873	77645	0	79526
20363	618	120	698	82310	0	83746
20364	80331	120	550	3053	0	84054
20365	2183	81541	523	1315	0	85562
20366	82179	1990	571	1051	0	85791
20367	2692	469	570	80781	0	84512
20368	863	82516	556	2684	0	86619
20369	849	2156	461	84931	0	88397
20370	86408	528	533	3265	0	90734
20371	2606	90009	610	1313	0	94538
20372	1251	2560	464	92538	0	96813
20373	855	701	93490	3148	0	98194
20374	91890	517	2918	1651	0	96976
20375	3187	460	957	94459	0	99063
20376	1443	411	714	96414	0	98982
20377	1098	395	93702	3836	0	99031
20378	896	432	92978	1886	0	96192
20379	89569	385	3365	1758	0	95077
20380	3122	90924	1411	1278	0	96735
20381	1561	2676	958	91654	0	96849
20382	91946	948	791	3594	0	97279
20383	3324	657	92127	1612	0	97720
20384	1238	91062	3350	1346	0	96996
20385	1326	2800	1328	91266	0	96720
20386	92421	895	946	3920	0	98182
20387	89429	708	905	2187	0	93229
20388	93408	471	841	1894	0	96614
20389	3918	90905	899	1487	0	97209
20390	1756	2814	91819	1319	0	97708
20391	1553	1063	3219	92165	0	98000
20392	1968	878	1724	79628	0	84198
20393	1516	603	1025	94733	0	97877
20394	1288	559	1009	95822	0	98678
20395	92783	588	887	4739	0	98997
20396	92597	623	860	2489	0	96569
20397	4116	508	90301	1924	0	96849
20398	1953	514	89551	1743	0	93761
20399	87023	484	3683	1828	0	93018
20400	90811	517	1618	1730	0	94676
20401	4327	532	1391	85876	0	92126
20402	2119	87564	1173	3660	0	94516
20403	87881	2937	1000	2167	0	93985
20404	3685	85676	1042	1899	0	92302
20405	1757	86515	941	1847	0	91060
20406	1890	3568	788	89265	0	95511
20407	1675	1355	818	92335	0	96183
20408	1479	993	928	92346	0	95746
20409	1411	905	1005	92999	0	96320
20410	1407	767	88580	4729	0	95483
20411	86057	788	3316	2465	0	92626
20412	90942	784	1309	2070	0	95105
20413	4402	758	982	87857	0	93999
20414	2288	722	907	88730	0	92647
20415	86803	723	930	4592	0	93048
20416	3817	875	77984	2399	0	85075
20417	83911	682	2844	2113	0	89550
20418	85699	672	1283	1973	0	89627
20419	4269	695	82885	1786	0	89635
20420	84968	643	3171	1908	0	90690
20421	4273	544	1427	85855	0	92099
20422	2273	541	1259	87685	0	91758
20423	2037	508	1046	88019	0	91610
20424	2022	444	985	87670	0	91121
20425	80917	455	889	4539	0	86800
20426	3921	497	863	79149	0	84430
20427	1707	362	685	72138	0	74892
20428	1336	66154	649	3529	0	71668
20429	1147	69178	649	1901	0	72875
20430	1209	2100	488	67514	0	71311
20431	66396	848	414	2830	0	70488
20432	2664	661	411	61873	0	65609
20433	1072	457	57378	2355	0	61262
20434	918	389	53492	1184	0	55983
20435	52770	358	1841	1230	0	56199
20436	1943	54752	836	974	0	58505
20437	51179	1313	851	878	0	54221
20438	1949	560	51019	642	0	54170
20439	1214	1509	1484	47009	0	51216
20440	47206	300	647	1455	0	49608
20441	1388	46720	509	756	0	49373
20442	46190	997	386	770	0	48343
20443	1520	436	50004	599	0	52559
20444	861	340	1063	49199	0	51463
20445	632	231	562	51282	0	52707
20446	51782	221	473	1640	0	54116
20447	51795	228	386	906	0	53315
20448	53434	251	267	779	0	54731
20449	53242	253	197	710	0	54402
20450	53926	247	212	653	0	55038
20451	1668	52883	237	583	0	55371
20452	963	904	265	54056	0	56188
20453	55148	380	202	1353	0	57083
20454	1498	306	155	54604	0	56563
20455	950	203	150	54540	0	55843
20456	827	192	153	54676	0	55848
20457	652	52704	206	1564	0	55126
20458	53450	895	183	979	0	55507
20459	1181	366	216	53510	0	55273
20460	51405	235	199	1460	0	53299
20461	50389	142	139	995	0	51665
20462	1347	49010	147	719	0	51223
20463	48791	716	141	620	0	50268
20464	1342	334	47438	367	0	49481
20465	46010	226	817	426	0	47479
20466	1267	423	636	46560	0	48886
20467	679	138	47728	771	0	49316
20468	599	47265	629	556	0	49049
20469	568	579	47195	451	0	48793
20470	226	43473	394	234	0	44327
20471	40439	560	667	387	0	42053
20472	39578	95	98	285	0	40056
20473	38696	32	32	221	0	38981
20474	228	38356	35	68	0	38687
20475	37548	113	27	201	0	37889
20476	168	79	37804	47	0	38098
20477	107	83	37093	49	0	37332
20478	194	95	151	36808	0	37248
20479	95	25	75	39806	0	40001
20480	28	39682	34	216	0	39960
20481	40153	146	18	215	0	40532
20482	223	44	19	40837	0	41123
20483	58	39972	32	186	0	40248
20484	92	194	19	41299	0	41604
20485	40959	59	11	422	0	41451
20486	39094	36	10	242	0	39382
20487	307	38	37648	74	0	38067
20488	265	24	202	37773	0	38264
20489	81	104	38208	226	0	38619
20490	115	26	240	38245	0	38626
20491	64	51	38447	306	0	38868
20492	136	31	285	37943	0	38395
20493	57	39	38452	313	0	38861
20494	108	17	304	37889	0	38318
20495	66	35	38942	344	0	39387
20496	130	18	317	37805	0	38270
20497	104	17	105	39508	0	39734
20498	51	40127	87	383	0	40648
20499	91	292	50	42386	0	42819
20500	50	115	41670	366	0	42201
20501	125	43	328	40973	0	41469
20502	77	25	122	41648	0	41872
20503	41815	21	67	601	0	42504
20504	359	25	47	42733	0	43164
20505	165	24	54	42237	0	42480
20506	64	57	40509	448	0	41078
20507	38648	22	339	416	0	39425
20508	362	24	114	41889	0	42389
20509	178	19	65	42105	0	42367
20510	103	19	54	42766	0	42942
20511	42678	22	52	679	0	43431
20512	397	25	60	43309	0	43791
20513	184	14	61	43551	0	43810
20514	42855	15	49	757	0	43676
20515	375	43063	47	278	0	43763
20516	184	338	30	42960	0	43512
20517	138	119	39	43489	0	43785
20518	65	96	42305	548	0	43014
20519	35111	36	389	651	0	36187
20520	447	43	121	41910	0	42521
20521	168	53	40793	477	0	41491
20522	40421	39	361	482	0	41303
20523	452	24	125	43351	0	43952
20524	244	39	96	45639	0	46018
20525	179	24	61	46362	0	46626
20526	149	17	82	47701	0	47949
20527	104	65	51606	937	0	52712
20528	203	33	932	51667	0	52835
20529	370	29	240	65386	0	66025
20530	101	64	73130	2001	0	75296
20531	73980	21	2084	1068	0	77153
20532	78983	45	875	893	0	80796
20533	79940	29	681	602	0	81252
20534	4036	44	424	77434	0	81938
20535	79399	37	266	2641	0	82343
20536	80981	17	162	1371	0	82531
20537	4144	25	187	79127	0	83483
20538	80056	31	122	3200	0	83409
20539	81366	38	156	1572	0	83132
20540	81795	35	125	1313	0	83268
20541	82827	36	126	981	0	83970
20542	4715	42	107	77811	0	82675
20543	2447	74145	152	2616	0	79360
20544	1763	75140	252	1193	0	78348
20545	1337	77590	178	910	0	80015
20546	73935	3607	136	922	0	78600
20547	77078	1778	121	724	0	79701
20548	3795	1225	73635	590	0	79245
20549	75884	749	2433	677	0	79743
20550	4228	484	940	76528	0	82180
20551	2383	328	714	77694	0	81119
20552	2010	267	474	79179	0	81930
20553	76545	164	331	4394	0	81434
20554	3645	139	204	76286	0	80274
20555	1750	74342	259	3923	0	80274
20556	1589	2448	136	76991	0	81164
20557	1051	1168	77104	3800	0	83123
20558	1174	885	2465	78298	0	82822
20559	77707	716	1016	4041	0	83480
20560	3428	478	78110	1882	0	83898
20561	1985	279	2835	77999	0	83098
20562	1711	306	1352	78334	0	81703
20563	1504	258	897	79555	0	82214
20564	866	79191	681	4389	0	85127
20565	1042	2581	398	80983	0	85004
20566	80006	1022	299	4503	0	85830
20567	80292	774	326	2439	0	83831
20568	4106	571	76943	1818	0	83438
20569	2214	548	78308	1356	0	82426
20570	1884	350	3367	77468	0	83069
20571	1443	341	1762	81020	0	84566
20572	1019	303	81021	4339	0	86682
20573	1360	321	3247	75364	0	80292
20574	839	78225	1620	3783	0	84467
20575	81854	2670	1124	2371	0	88019
20576	82969	1110	868	1903	0	86850
20577	82363	808	603	1736	0	85510
20578	4821	695	81024	1187	0	87727
20579	2955	456	2859	81879	0	88149
20580	2201	337	81626	3452	0	87616
20581	78511	302	3356	2026	0	84195
20582	3659	80289	1732	1617	0	87297
20583	2176	2637	1243	80898	0	86954
20584	81336	1124	867	3779	0	87106
20585	3826	922	686	81467	0	86901
20586	2253	656	632	84494	0	88035
20587	1755	523	81237	4561	0	88076
20588	76409	478	2885	2941	0	82713
20589	3878	80936	1426	2016	0	88256
20590	2426	2564	1071	82484	0	88545
20591	82619	1117	839	3761	0	88336
20592	4095	884	705	82895	0	88579
20593	82293	756	553	4463	0	88065
20594	4212	82177	647	2408	0	89444
20595	84577	2853	428	2098	0	89956
20596	4658	1443	84286	1520	0	91907
20597	84630	1056	2868	1686	0	90240
20598	86650	788	1371	1394	0	90203
20599	87764	576	1277	1402	0	91019
20600	5705	531	881	83598	0	90715
20601	3802	683	824	78280	0	83589
20602	3028	617	506	84159	0	88310
20603	2138	81258	529	4744	0	88669
20604	83346	2851	402	3237	0	89836
20605	4326	1259	433	83648	0	89666
20606	2586	1043	476	85164	0	89269
20607	2266	759	531	85768	0	89324
20608	82459	725	521	5386	0	89091
20609	4189	532	449	84046	0	89216
20610	2263	628	80514	4953	0	88358
20611	1955	80886	2703	3051	0	88595
20612	1757	2930	1192	82893	0	88772
20613	1561	1459	892	84986	0	88898
20614	1353	1185	831	86400	0	89769
20615	1238	851	81569	5441	0	89099
20616	1287	569	81884	3443	0	87183
20617	1256	511	3798	83265	0	88830
20618	1289	496	85643	4481	0	91909
20619	1198	369	3738	87159	0	92464
20620	86324	359	1792	5398	0	93873
20621	89666	411	1268	3553	0	94898
20622	89852	445	986	2713	0	93996
20623	4944	512	85653	1960	0	93069
20624	82592	483	2883	1763	0	87721
20625	4807	554	1514	84886	0	91761
20626	2536	287	83513	3551	0	89887
20627	2019	280	79955	2053	0	84307
20628	1458	77872	3397	2129	0	84856
20629	809	67567	1218	957	0	70551
20630	58342	1080	1860	642	0	61924
20631	1163	289	276	57068	0	58796
20632	391	215	58132	975	0	59713
20633	423	137	807	58348	0	59715
20634	58805	81	311	1266	0	60463
20635	1029	142	62889	457	0	64517
20636	60861	85	1045	727	0	62718
20637	65935	91	371	526	0	66923
20638	65867	78	248	528	0	66721
20639	1407	65000	215	341	0	66963
20640	67028	973	190	498	0	68689
20641	1470	280	189	67383	0	69322
20642	719	216	177	66323	0	67435
20643	621	138	132	68082	0	68973
20644	489	98	149	67755	0	68491
20645	65931	69	165	1626	0	67791
20646	1149	64647	177	636	0	66609
20647	412	62716	138	412	0	63678
20648	308	65339	133	304	0	66084
20649	65119	1121	184	476	0	66900
20650	65337	341	166	511	0	66355
20651	64973	202	111	452	0	65738
20652	64948	159	109	411	0	65627
20653	1490	141	110	64695	0	66436
20654	680	111	119	64997	0	65907
20655	64854	82	88	1455	0	66479
20656	1081	64889	128	531	0	66629
20657	63114	911	105	562	0	64692
20658	64047	239	79	490	0	64855
20659	1391	210	87	63448	0	65136
20660	508	64194	124	1056	0	65882
20661	538	987	100	65488	0	67113
20662	64094	275	96	1439	0	65904
20663	1257	240	65480	431	0	67408
20664	708	155	927	62362	0	64152
20665	399	65221	273	975	0	66868
20666	64796	942	207	644	0	66589
20667	63306	283	134	668	0	64391
20668	1346	221	65476	297	0	67340
20669	551	63921	955	276	0	65703
20670	421	982	65864	225	0	67492
20671	568	364	957	62979	0	64868
20672	293	222	63820	951	0	65286
20673	305	169	62700	332	0	63506
20674	244	62973	975	273	0	64465
20675	62033	851	358	409	0	63651
20676	62397	243	230	498	0	63368
20677	1036	64658	166	234	0	66094
20678	428	64737	137	241	0	65543
20679	400	1045	61263	158	0	62866
20680	362	392	59537	208	0	60499
20681	315	259	62391	193	0	63158
20682	393	171	1089	62132	0	63785
20683	270	223	63951	936	0	65380
20684	428	171	1004	60764	0	62367
20685	514	141	376	59565	0	60596
20686	282	199	62748	1061	0	64290
20687	273	62001	951	426	0	63651
20688	414	895	274	62063	0	63646
20689	61795	298	234	1150	0	63477
20690	1137	244	172	62039	0	63592
20691	456	241	62679	1023	0	64399
20692	344	61325	928	410	0	63007
20693	344	65111	358	332	0	66145
20694	400	1064	271	63543	0	65278
20695	63355	384	219	1230	0	65188
20696	63000	274	201	589	0	64064
20697	1376	241	177	62372	0	64166
20698	555	66217	204	1048	0	68024
20699	596	1194	142	66405	0	68337
20700	557	392	183	68442	0	69574
20701	558	318	133	68777	0	69786
20702	70598	241	161	1901	0	72901
20703	1537	71349	233	684	0	73803
20704	71774	1419	187	803	0	74183
20705	72788	492	195	657	0	74132
20706	72707	380	155	607	0	73849
20707	74639	298	162	570	0	75669
20708	2316	286	173	72335	0	75110
20709	886	288	72852	1576	0	75602
20710	599	72832	1418	706	0	75555
20711	73707	1503	493	823	0	76526
20712	74927	513	318	714	0	76472
20713	75622	383	210	681	0	76896
20714	2250	300	73553	338	0	76441
20715	71713	303	1486	602	0	74104
20716	75077	267	501	529	0	76374
20717	2455	324	305	73758	0	76842
20718	1005	278	71090	1569	0	73942
20719	742	70012	1517	568	0	72839
20720	867	1518	536	69769	0	72690
20721	69545	469	438	1814	0	72266
20722	1928	340	270	68802	0	71340
20723	985	263	301	71814	0	73363
20724	72927	258	243	2258	0	75686
20725	1957	251	71886	739	0	74833
20726	71017	232	1594	816	0	73659
20727	71719	234	611	724	0	73288
20728	71770	241	425	587	0	73023
20729	71777	238	310	629	0	72954
20730	2460	198	69491	405	0	72554
20731	1327	222	1578	67646	0	70773
20732	692	218	69522	1639	0	72071
20733	906	260	1628	67944	0	70738
20734	551	217	69250	1739	0	71757
20735	61090	141	1600	968	0	63799
20736	1747	62154	617	506	0	65024
20737	801	66329	403	310	0	67843
20738	1009	1760	300	71428	0	74497
20739	1071	566	297	73210	0	75144
20740	500	77481	289	2443	0	80713
20741	78155	2286	269	1185	0	81895
20742	82567	724	241	791	0	84323
20743	85242	433	230	616	0	86521
20744	88916	284	261	585	0	90046
20745	4177	222	220	86201	0	90820
20746	1933	239	234	90103	0	92509
20747	89729	258	221	3909	0	94117
20748	3746	177	238	88820	0	92981
20749	1603	253	86325	3400	0	91581
20750	1168	333	87320	1325	0	90146
20751	1237	252	3478	87524	0	92491
20752	815	242	88327	3336	0	92720
20753	86103	160	3278	1729	0	91270
20754	3677	208	1247	87471	0	92603
20755	88472	172	787	3588	0	93019
20756	3727	203	88334	1466	0	93730
20757	2002	214	3174	87126	0	92516
20758	1174	204	88922	3416	0	93716
20759	923	87851	3514	1647	0	93935
20760	86859	2930	1539	1391	0	92719
20761	88849	1009	837	1156	0	91851
20762	4268	86961	642	881	0	92752
20763	86607	3051	583	985	0	91226
20764	4295	1104	577	84458	0	90434
20765	2189	707	513	87122	0	90531
20766	84794	459	478	4300	0	90031
20767	3956	82376	468	1809	0	88609
20768	1955	85531	464	1196	0	89146
20769	1831	3857	400	83024	0	89112
20770	82257	1499	416	3650	0	87822
20771	84486	866	426	1835	0	87613
20772	85001	586	407	1403	0	87397
20773	5127	626	80682	845	0	87280
20774	2550	627	80714	841	0	84732
20775	1778	80365	3848	895	0	86886
20776	81229	3215	1523	1027	0	86994
20777	4561	1260	868	78740	0	85429
20778	80337	796	635	3688	0	85456
20779	82041	582	694	1736	0	85053
20780	5419	501	724	78321	0	84965
20781	2670	552	77930	3814	0	84966
20782	78480	503	3340	1929	0	84252
20783	4625	449	1340	78084	0	84498
20784	2363	439	78190	4026	0	85018
20785	77791	413	3453	2081	0	83738
20786	81073	386	1494	1649	0	84602
20787	5219	350	1187	78151	0	84907
20788	2659	377	78207	4021	0	85264
20789	2316	443	3582	74317	0	80658
20790	1808	77506	1704	3899	0	84917
20791	1970	3140	77479	1868	0	84457
20792	1919	79008	3597	1440	0	85964
20793	78073	3394	1557	1339	0	84363
20794	80098	1229	1263	1340	0	83930
20795	79488	819	1018	1472	0	82797
20796	79431	670	964	1308	0	82373
20797	5773	670	833	74375	0	81651
20798	72684	640	820	3655	0	77799
20799	4818	534	795	70963	0	77110
20800	69111	531	725	3836	0	74203
20801	4343	66815	704	1959	0	73821
20802	2532	2628	641	62110	0	67911
20803	1770	64807	625	3142	0	70344
20804	65027	2966	530	1732	0	70255
20805	65794	1293	610	1448	0	69145
20806	4271	63703	630	1127	0	69731
20807	2439	2899	600	62489	0	68427
20808	1839	1253	61955	3084	0	68131
20809	1825	1126	2649	61717	0	67317
20810	1722	693	61610	3267	0	67292
20811	1930	793	2903	55269	0	60895
20812	1475	59180	1311	2867	0	64833
20813	59800	2632	866	1664	0	64962
20814	61635	1107	739	1413	0	64894
20815	4127	748	624	59667	0	65166
20816	62246	581	634	3278	0	66739
20817	3945	645	636	61585	0	66811
20818	2144	691	586	63491	0	66912
20819	1878	541	581	64591	0	67591
20820	62390	514	532	4152	0	67588
20821	63531	429	504	2158	0	66622
20822	63551	441	579	1539	0	66110
20823	4252	59057	600	1190	0	65099
20824	58909	2386	577	1136	0	63008
20825	3642	57417	573	1021	0	62653
20826	58526	2715	497	1027	0	62765
20827	3897	1113	484	56805	0	62299
20828	2331	831	410	59169	0	62741
20829	57730	734	382	3399	0	62245
20830	58642	630	394	1766	0	61432
20831	3899	56427	403	1218	0	61947
20832	57187	2400	307	1114	0	61008
20833	3810	948	276	54304	0	59338
20834	2209	620	304	55705	0	58838
20835	54035	469	264	3410	0	58178
20836	3399	467	51649	1671	0	57186
20837	1761	48628	1902	1201	0	53492
20838	1441	1551	547	40784	0	44323
20839	809	501	37159	1405	0	39874
20840	878	1133	1111	34264	0	37386
20841	34377	238	523	1512	0	36650
20842	1334	31303	320	731	0	33688
20843	604	28550	203	573	0	29930
20844	427	26584	175	329	0	27515
20845	759	1006	578	24650	0	26993
20846	24773	184	485	726	0	26168
20847	654	141	50	24390	0	25235
20848	24439	104	46	676	0	25265
20849	24684	93	58	244	0	25079
20850	699	60	46	24485	0	25290
20851	24620	69	67	616	0	25372
20852	697	71	48	25080	0	25896
20853	256	82	25266	614	0	26218
20854	24435	87	467	291	0	25280
20855	648	63	27000	249	0	27960
20856	24630	52	506	220	0	25408
20857	602	49	25664	142	0	26457
20858	237	42	343	24176	0	24798
20859	174	43	86	25151	0	25454
20860	25603	66	54	560	0	26283
20861	507	55	37	26447	0	27046
20862	26496	42	45	545	0	27128
20863	450	26767	44	175	0	27436
20864	27931	342	34	282	0	28589
20865	549	85	50	29106	0	29790
20866	266	73	35	29490	0	29864
20867	225	45	47	29701	0	30018
20868	209	58	45	29871	0	30183
20869	132	59	29215	521	0	29927
20870	133	53	28601	213	0	29000
20871	170	78	406	29041	0	29695
20872	136	54	29871	433	0	30494
20873	100	29837	381	194	0	30512
20874	153	367	108	30090	0	30718
20875	111	110	30988	468	0	31677
20876	103	96	30222	248	0	30669
20877	207	100	440	30687	0	31434
20878	181	55	142	31158	0	31536
20879	72	31825	98	492	0	32487
20880	151	389	77	32294	0	32911
20881	77	118	32581	490	0	33266
20882	31062	59	467	293	0	31881
20883	514	42	181	32942	0	33679
20884	33068	45	127	628	0	33868
20885	33037	53	105	362	0	33557
20886	33621	73	106	300	0	34100
20887	593	87	34400	172	0	35252
20888	209	63	33900	171	0	34343
20889	30734	55	567	305	0	31661
20890	553	56	35098	173	0	35880
20891	333	45	482	32974	0	33834
20892	258	60	167	33960	0	34445
20893	179	64	34644	597	0	35484
20894	171	34522	524	250	0	35467
20895	34184	432	207	265	0	35088
20896	544	34575	160	221	0	35500
20897	232	35820	142	181	0	36375
20898	35599	492	163	247	0	36501
20899	598	182	36934	154	0	37868
20900	207	97	37145	179	0	37628
20901	210	93	701	36200	0	37204
20902	37053	94	252	664	0	38063
20903	580	37556	206	244	0	38586
20904	37610	582	151	303	0	38646
20905	669	198	38742	174	0	39783
20906	217	40965	670	175	0	42027
20907	280	665	245	41826	0	43016
20908	216	218	43115	727	0	44276
20909	271	158	729	42953	0	44111
20910	542	201	455	36233	0	37431
20911	346	127	158	44047	0	44678
20912	270	100	198	44209	0	44777
20913	43387	103	209	1017	0	44716
20914	42857	91	171	522	0	43641
20915	920	90	43571	272	0	44853
20916	40421	108	752	382	0	41663
20917	788	41733	272	262	0	43055
20918	41432	610	195	331	0	42568
20919	771	216	41958	227	0	43172
20920	382	204	706	40941	0	42233
20921	253	108	42108	729	0	43198
20922	210	101	41981	310	0	42602
20923	275	116	851	40958	0	42200
20924	289	102	305	41758	0	42454
20925	176	103	41672	885	0	42836
20926	204	40305	728	361	0	41598
20927	206	41407	310	257	0	42180
20928	243	742	269	41528	0	42782
20929	40809	215	232	881	0	42137
20930	686	43128	222	351	0	44387
20931	308	679	43366	249	0	44602
20932	187	239	42259	252	0	42937
20933	174	191	43673	235	0	44273
20934	283	175	938	42143	0	43539
20935	43405	135	397	872	0	44809
20936	733	43026	280	410	0	44449
20937	290	696	42866	310	0	44162
20938	201	42757	836	249	0	44043
20939	213	746	399	43163	0	44521
20940	153	289	43647	747	0	44836
20941	155	43828	831	381	0	45195
20942	303	717	322	43215	0	44557
20943	261	332	227	44926	0	45746
20944	205	234	45827	852	0	47118
20945	287	211	876	43487	0	44861
20946	133	45078	399	764	0	46374
20947	188	718	44880	359	0	46145
20948	43128	270	818	354	0	44570
20949	807	241	332	45021	0	46401
20950	383	200	281	44740	0	45604
20951	184	45169	293	828	0	46474
20952	44152	684	248	509	0	45593
20953	715	278	43985	266	0	45244
20954	42212	223	769	338	0	43542
20955	739	223	274	42614	0	43850
20956	245	43609	214	709	0	44777
20957	228	611	210	43835	0	44884
20958	172	237	178	45450	0	46037
20959	44546	198	182	999	0	45925
20960	45059	141	245	474	0	45919
20961	911	116	178	45352	0	46557
20962	333	138	45193	799	0	46463
20963	40488	155	677	636	0	41956
20964	658	45442	297	326	0	46723
20965	413	713	199	45137	0	46462
20966	348	265	205	46217	0	47035
20967	299	143	184	46513	0	47139
20968	221	153	45774	987	0	47135
20969	254	170	714	44318	0	45456
20970	161	45782	351	844	0	47138
20971	261	705	225	44831	0	46022
20972	166	45631	175	815	0	46787
20973	240	778	166	45285	0	46469
20974	140	282	44913	915	0	46250
20975	40153	158	726	589	0	41626
20976	761	156	329	44393	0	45639
20977	250	181	44993	759	0	46183
20978	169	44826	658	391	0	46044
20979	44144	638	312	470	0	45564
20980	622	283	44142	292	0	45339
20981	42366	222	712	385	0	43685
20982	746	111	290	44663	0	45810
20983	370	115	221	44320	0	45026
20984	152	45081	171	753	0	46157
20985	44891	596	157	470	0	46114
20986	44158	253	145	394	0	44950
20987	718	46615	165	229	0	47727
20988	385	606	150	47602	0	48743
20989	296	231	138	47948	0	48613
20990	201	169	120	47587	0	48077
20991	131	198	46472	845	0	47646
20992	44339	141	608	519	0	45607
20993	724	143	241	46388	0	47496
20994	343	137	154	46893	0	47527
20995	179	157	45886	825	0	47047
20996	131	140	44962	452	0	45685
20997	220	143	736	46912	0	48011
20998	150	127	47917	718	0	48912
20999	44960	98	695	406	0	46159
21000	623	99	238	46934	0	47894
21001	312	74	182	47615	0	48183
21002	145	107	49388	795	0	50435
21003	221	109	587	49759	0	50676
21004	94	101	50983	689	0	51867
21005	113	49816	639	342	0	50910
21006	46646	547	362	484	0	48039
21007	46731	163	146	319	0	47359
21008	523	46460	100	224	0	47307
21009	311	444	99	47068	0	47922
21010	164	206	47827	510	0	48707
21011	188	114	462	47288	0	48052
21012	47245	71	215	668	0	48199
21013	438	47827	172	254	0	48691
21014	47940	425	72	289	0	48726
21015	549	189	173	47855	0	48766
21016	48021	127	78	605	0	48831
21017	496	47913	105	299	0	48813
21018	47885	418	91	338	0	48732
21019	515	199	46984	159	0	47857
21020	239	47498	412	162	0	48311
21021	235	436	185	47418	0	48274
21022	49031	151	124	575	0	49881
21023	49457	116	68	349	0	49990
21024	642	65	61	49644	0	50412
21025	50301	82	64	684	0	51131
21026	49875	87	76	393	0	50431
21027	51442	63	86	380	0	51971
21028	729	75	71	51596	0	52471
21029	306	79	52003	523	0	52911
21030	242	83	47782	271	0	48378
21031	180	84	49614	216	0	50094
21032	49856	51	618	272	0	50797
21033	617	56	214	50865	0	51752
21034	255	51812	151	519	0	52737
21035	327	454	89	51191	0	52061
21036	147	52257	132	528	0	53064
21037	52985	525	123	362	0	53995
21038	634	171	118	53704	0	54627
21039	352	131	122	55436	0	56041
21040	56010	90	102	915	0	57117
21041	771	73	79	56171	0	57094
21042	353	106	98	57115	0	57672
21043	57312	83	74	1055	0	58524
21044	791	121	58251	372	0	59535
21045	428	74	736	57958	0	59196
21046	215	83	58678	867	0	59843
21047	56920	65	813	526	0	58324
21048	953	76	258	59295	0	60582
21049	59435	59	178	1036	0	60708
21050	985	71	100	60171	0	61327
21051	370	92	61316	961	0	62739
21052	364	84	808	61070	0	62326
21053	62562	69	312	1177	0	64120
21054	883	63886	224	430	0	65423
21055	392	804	63369	280	0	64845
21056	58905	220	800	451	0	60376
21057	917	64462	298	252	0	65929
21058	350	65874	195	252	0	66671
21059	307	72591	153	280	0	73331
21060	547	1317	129	76374	0	78367
21061	77575	424	187	1575	0	79761
21062	79040	253	139	702	0	80134
21063	1859	208	77872	281	0	80220
21064	75297	173	1371	446	0	77287
21065	1697	76315	420	236	0	78668
21066	883	1464	217	76378	0	78942
21067	79818	429	137	1782	0	82166
21068	81063	270	140	742	0	82215
21069	81956	175	165	540	0	82836
21070	80769	167	177	500	0	81613
21071	81982	202	162	382	0	82728
21072	2347	207	135	80607	0	83296
21073	920	255	80682	1594	0	83451
21074	928	212	1419	80779	0	83338
21075	874	183	366	82560	0	83983
21076	81735	186	212	2083	0	84216
21077	2003	79602	211	751	0	82567
21078	80724	1477	183	722	0	83106
21079	81807	444	221	631	0	83103
21080	83596	256	259	717	0	84828
21081	85654	203	233	732	0	86822
21082	2560	224	83134	488	0	86406
21083	83536	228	1468	635	0	85867
21084	86380	216	454	591	0	87641
21085	71901	567	376	1186	0	74030
21086	86516	202	198	519	0	87435
21087	2868	160	182	82256	0	85466
21088	1368	163	80666	1756	0	83953
21089	78798	120	1595	915	0	81428
21090	2278	81104	609	536	0	84527
21091	1438	1456	369	78635	0	81898
21092	1031	82648	317	1623	0	85619
21093	1097	1577	238	84361	0	87273
21094	85071	546	280	2109	0	88006
21095	85758	356	285	912	0	87311
21096	85864	313	281	728	0	87186
21097	2720	313	79849	460	0	83342
21098	79798	303	1454	610	0	82165
21099	2390	337	79201	458	0	82386
21100	1357	298	79738	481	0	81874
21101	1136	300	83377	465	0	85278
21102	1402	381	1965	76107	0	79855
21103	1141	202	759	80925	0	83027
21104	1067	228	492	81120	0	82907
21105	1034	221	475	80727	0	82457
21106	1168	266	516	76815	0	78765
21107	978	262	490	79743	0	81473
21108	763	80743	437	2073	0	84016
21109	79196	1555	377	1198	0	82326
21110	1953	81043	391	839	0	84226
21111	1189	1628	300	81663	0	84780
21112	1049	608	323	83421	0	85401
21113	81655	351	319	2539	0	84864
21114	2125	81616	392	1079	0	85212
21115	82717	1605	370	999	0	85691
21116	2400	683	406	82314	0	85803
21117	1416	465	400	83033	0	85314
21118	1095	468	403	83686	0	85652
21119	958	442	82341	2473	0	86214
21120	1149	462	1560	82147	0	85318
21121	1026	431	81194	2327	0	84978
21122	1099	371	79152	1273	0	81895
21123	1121	359	85195	1014	0	87689
21124	1284	365	2054	84127	0	87830
21125	1170	374	827	87500	0	89871
21126	1103	424	544	89180	0	91251
21127	87905	433	543	2949	0	91830
21128	2549	411	512	89628	0	93100
21129	89757	312	590	2857	0	93516
21130	2801	89256	539	1439	0	94035
21131	92110	1916	470	1348	0	95844
21132	95705	680	415	1482	0	98282
21133	3159	98974	503	1057	0	103693
21134	99359	1993	401	1507	0	103260
21135	99395	716	445	1397	0	101953
21136	101334	430	577	1201	0	103542
21137	101575	362	545	1036	0	103518
21138	3714	437	98470	754	0	103375
21139	1997	97230	2038	681	0	101946
21140	1880	2108	818	94926	0	99732
21141	96238	646	635	2581	0	100100
21142	2864	461	95814	1222	0	100361
21143	1602	94167	2002	953	0	98724
21144	1671	1806	744	90240	0	94461
21145	1309	95599	489	2033	0	99430
21146	1567	2103	393	95274	0	99337
21147	1453	966	365	96657	0	99441
21148	1335	607	96079	2449	0	100470
21149	1348	547	93775	1074	0	96744
21150	87023	504	2298	1252	0	91077
21151	2633	571	95478	642	0	99324
21152	1398	514	95162	673	0	97747
21153	1470	463	2346	91562	0	95841
21154	1282	485	1008	91897	0	94672
21155	913	92712	918	2392	0	96935
21156	935	99446	900	1144	0	102425
21157	864	2266	98351	801	0	102282
21158	1222	1440	2474	96094	0	101230
21159	495	474	94568	2120	0	97657
21160	374	337	86217	692	0	87620
21161	258	86785	1882	501	0	89426
21162	826	1511	775	84711	0	87823
21163	85241	484	504	1673	0	87902
21164	1654	285	390	85693	0	88022
21165	85999	198	346	1951	0	88494
21166	86165	167	372	964	0	87668
21167	85127	205	283	813	0	86428
21168	1964	247	84382	404	0	86997
21169	82699	207	1500	603	0	85009
21170	1996	201	528	85351	0	88076
21171	85581	148	385	1893	0	88007
21172	85790	165	314	962	0	87231
21173	1898	84939	346	442	0	87625
21174	84668	1394	264	611	0	86937
21175	1792	470	85469	313	0	88044
21176	81123	308	1461	640	0	83532
21177	83305	237	469	669	0	84680
21178	1922	84791	358	314	0	87385
21179	85070	1381	243	531	0	87225
21180	2055	503	261	81186	0	84005
21181	1065	308	283	80612	0	82268
21182	637	80157	317	1624	0	82735
21183	834	1385	237	81284	0	83740
21184	762	439	282	82545	0	84028
21185	578	426	80915	1859	0	83778
21186	579	384	78778	817	0	80558
21187	75731	285	1777	949	0	78742
21188	80603	225	649	752	0	82229
21189	2231	244	469	81554	0	84498
21190	970	266	82188	1698	0	85122
21191	745	81405	1678	715	0	84543
21192	802	1603	683	80353	0	83441
21193	590	569	82128	1770	0	85057
21194	76975	377	1847	1108	0	80307
21195	2206	318	631	83564	0	86719
21196	887	85276	498	2036	0	88697
21197	871	1931	414	85929	0	89145
21198	815	660	452	87305	0	89232
21199	817	429	472	88549	0	90267
21200	85220	351	465	2878	0	88914
21201	2521	286	443	84450	0	87700
21202	85301	343	341	2757	0	88742
21203	86196	353	376	1457	0	88382
21204	2950	334	84941	783	0	89008
21205	1210	85311	2156	797	0	89474
21206	1376	2197	804	77154	0	81531
21207	817	89370	633	1913	0	92733
21208	90165	2450	496	1227	0	94338
21209	2943	873	426	90115	0	94357
21210	1214	590	89898	2668	0	94370
21211	926	490	88089	1161	0	90666
21212	814	438	89243	850	0	91345
21213	86220	384	2978	1104	0	90686
21214	2698	89534	1185	777	0	94194
21215	88580	2465	668	950	0	92663
21216	2921	90165	629	787	0	94502
21217	1635	2594	631	87755	0	92615
21218	1346	923	725	86864	0	89858
21219	852	89339	665	2832	0	93688
21220	936	2666	88708	1196	0	93506
21221	768	90403	2547	954	0	94672
21222	86538	2604	879	1061	0	91082
21223	2821	1011	591	83465	0	87888
21224	1095	694	82386	2498	0	86673
21225	845	536	82615	1074	0	85070
21226	1133	615	2778	80936	0	85462
21227	764	454	81070	2370	0	84658
21228	675	536	78316	955	0	80482
21229	72425	458	2653	954	0	76490
21230	2162	75872	1065	719	0	79818
21231	72944	1950	711	833	0	76438
21232	2297	777	72635	545	0	76254
21233	991	66790	2199	620	0	70600
21234	697	69986	1024	572	0	72279
21235	1018	2567	956	67424	0	71965
21236	798	901	560	69453	0	71712
21237	769	634	455	70956	0	72814
21238	564	478	69551	2794	0	73387
21239	757	409	2166	69381	0	72713
21240	727	431	869	71615	0	73642
21241	69889	442	587	2990	0	73908
21242	2177	69591	506	1365	0	73639
21243	1152	2086	453	70630	0	74321
21244	70230	912	423	2683	0	74248
21245	69714	574	499	1297	0	72084
21246	2885	471	451	68264	0	72071
21247	1140	482	67858	2553	0	72033
21248	955	455	2188	68020	0	71618
21249	628	425	68225	2670	0	71948
21250	70759	375	2404	1524	0	75062
21251	79384	345	1067	1087	0	81883
21252	3776	475	737	80010	0	84998
21253	1312	386	80672	3108	0	85478
21254	826	81737	2952	1308	0	86823
21255	697	3065	82883	834	0	87479
21256	1085	1637	3123	69721	0	75566
21257	522	76975	1056	2590	0	81143
21258	74230	2663	521	1028	0	78442
21259	3099	809	405	70351	0	74664
21260	864	73644	589	2647	0	77744
21261	74153	2815	498	1050	0	78516
21262	3060	891	549	72137	0	76637
21263	952	73778	476	2857	0	78063
21264	921	2842	399	73933	0	78095
21265	631	965	73503	2925	0	78024
21266	70372	577	2703	1422	0	75074
21267	73180	584	905	961	0	75630
21268	3386	495	71110	593	0	75584
21269	1096	70951	2724	684	0	75455
21270	71749	2824	930	718	0	76221
21271	3059	950	530	71140	0	75679
21272	1394	579	610	71877	0	74460
21273	1120	464	456	73121	0	75161
21274	998	477	450	73353	0	75278
21275	850	450	498	73585	0	75383
21276	70486	524	393	3877	0	75280
21277	72948	419	412	1628	0	75407
21278	3582	380	426	70764	0	75152
21279	1376	331	455	72979	0	75141
21280	788	347	70175	3755	0	75065
21281	727	374	71016	1538	0	73655
21282	68977	368	3162	1218	0	73725
21283	3304	399	1041	69498	0	74242
21284	1320	383	68622	3098	0	73423
21285	975	319	2756	69106	0	73156
21286	68328	297	976	3675	0	73276
21287	70907	288	782	1641	0	73618
21288	3596	310	685	68756	0	73347
21289	1554	284	543	69854	0	72235
21290	68273	258	456	3792	0	72779
21291	3244	298	540	66537	0	70619
21292	1218	67479	479	3318	0	72494
21293	1115	2498	456	66514	0	70583
21294	1112	849	442	67901	0	70304
21295	688	427	64969	3402	0	69486
21296	693	344	63665	1533	0	66235
21297	741	64275	2726	1141	0	68883
21298	62530	2332	1079	1172	0	67113
21299	62362	844	581	992	0	64779
21300	63106	468	440	1079	0	65093
21301	3132	59882	470	1008	0	64492
21302	1189	62237	576	869	0	64871
21303	59261	2531	546	998	0	63336
21304	2519	60852	473	865	0	64709
21305	1102	2422	58651	770	0	62945
21306	886	59310	2122	802	0	63120
21307	789	2202	56904	749	0	60644
21308	54608	881	2121	822	0	58432
21309	56958	654	757	801	0	59170
21310	2621	56409	531	696	0	60257
21311	57877	2276	443	756	0	61352
21312	63479	805	470	762	0	65516
21313	64379	623	402	775	0	66179
21314	3440	500	526	62245	0	66711
21315	63124	448	408	2632	0	66612
21316	3215	522	59847	1137	0	64721
21317	62051	571	2176	982	0	65780
21318	3367	438	833	61934	0	66572
21319	1612	462	61421	2569	0	66064
21320	1294	481	62783	1192	0	65750
21321	1140	436	2767	61594	0	65937
21322	1129	382	1180	63835	0	66526
21323	63042	374	873	3274	0	67563
21324	2996	343	562	63290	0	67191
21325	1356	362	62218	3235	0	67171
21326	1317	330	2363	60108	0	64118
21327	980	62847	1030	2937	0	67794
21328	64124	2103	674	1658	0	68559
21329	2859	785	604	64279	0	68527
21330	1385	595	63354	2734	0	68068
21331	1068	63150	2337	1497	0	68052
21332	61647	2040	1087	1170	0	65944
21333	2694	771	769	62909	0	67143
21334	1223	635	63296	2595	0	67749
21335	1069	62698	2257	1327	0	67351
21336	62991	2054	999	1210	0	67254
21337	62451	719	711	1012	0	64893
21338	63741	602	559	899	0	65801
21339	3230	380	476	61366	0	65452
21340	1624	341	378	63054	0	65397
21341	61317	318	469	2865	0	64969
21342	2541	60565	390	1453	0	64949
21343	61337	1897	389	1211	0	64834
21344	2736	736	410	60876	0	64758
21345	62074	531	393	2452	0	65450
21346	2790	435	410	61735	0	65370
21347	1535	398	394	62796	0	65123
21348	1452	368	406	63048	0	65274
21349	1536	493	399	63247	0	65675
21350	924	313	55263	2540	0	59040
21351	677	242	48654	1207	0	50780
21352	42736	132	1233	954	0	45055
21353	1123	153	46182	615	0	48073
21354	583	120	42186	413	0	43302
21355	40557	123	1217	445	0	42342
21356	42510	115	863	381	0	43869
21357	1203	132	485	45418	0	47238
21358	46005	87	344	979	0	47415
21359	1114	46731	274	571	0	48690
21360	48131	624	192	641	0	49588
21361	47871	370	211	481	0	48933
21362	50734	327	171	528	0	51760
21363	1445	236	185	50267	0	52133
21364	940	49090	245	767	0	51042
21365	733	51120	205	535	0	52593
21366	51493	864	218	511	0	53086
21367	51882	550	219	464	0	53115
21368	1223	414	172	51369	0	53178
21369	902	298	180	51032	0	52412
21370	671	50843	208	1000	0	52722
21371	50720	681	130	796	0	52327
21372	1009	456	50850	564	0	52879
21373	766	366	622	50177	0	51931
21374	733	202	351	51449	0	52735
21375	517	201	51335	1084	0	53137
21376	462	149	689	50344	0	51644
21377	479	37644	687	1186	0	39996
21378	429	713	334	52315	0	53791
21379	444	387	243	51735	0	52809
21380	362	47069	250	1146	0	48827
21381	370	51982	191	800	0	53343
21382	348	851	156	52564	0	53919
21383	52170	542	172	1076	0	53960
21384	792	409	174	52464	0	53839
21385	577	263	215	52798	0	53853
21386	490	54202	251	1101	0	56044
21387	452	585	195	57140	0	58372
21388	406	390	216	56800	0	57812
21389	402	317	208	57218	0	58145
21390	56470	246	176	1384	0	58276
21391	859	219	130	57377	0	58585
21392	658	158	115	56800	0	57731
21393	580	225	86	57228	0	58119
21394	469	228	54683	1282	0	56662
21395	48123	176	522	1197	0	50018
21396	821	53902	358	744	0	55825
21397	54260	537	268	593	0	55658
21398	973	352	180	54311	0	55816
21399	581	355	53576	760	0	55272
21400	48826	272	557	745	0	50400
21401	893	231	62636	512	0	64272
21402	731	153	742	63426	0	65052
21403	66568	107	428	1017	0	68120
21404	65858	128	369	708	0	67063
21405	67831	115	228	703	0	68877
21406	1204	129	153	68055	0	69541
21407	858	143	157	68935	0	70093
21408	704	174	163	69195	0	70236
21409	449	65126	132	1103	0	66810
21410	337	65335	127	774	0	66573
21411	257	64406	124	631	0	65418
21412	80	61745	66	104	0	61995
21413	213	187	75	64680	0	65155
21414	131	52	37	65211	0	65431
21415	64753	40	39	437	0	65269
21416	63824	33	36	304	0	64197
21417	65207	40	30	287	0	65564
21418	303	56	21	65028	0	65408
21419	154	66	26	65946	0	66192
21420	64617	62	22	438	0	65139
21421	62902	56	26	368	0	63352
21422	247	95	62781	140	0	63263
21423	191	100	59852	166	0	60309
21424	156	99	61795	138	0	62188
21425	127	112	66548	103	0	66890
21426	175	43	204	66588	0	67010
21427	67119	29	59	462	0	67669
21428	220	66418	64	188	0	66890
21429	160	181	30	68558	0	68929
21430	143	96	68638	233	0	69110
21431	87	71264	224	197	0	71772
21432	136	174	78	73763	0	74151
21433	95	96	73393	257	0	73841
21434	177	47	205	71060	0	71489
21435	158	43	79	72877	0	73157
21436	74368	51	76	459	0	74954
21437	274	44	69	75271	0	75658
21438	105	90	76158	257	0	76610
21439	181	46	214	74661	0	75102
21440	87	80622	103	316	0	81128
21441	131	204	76	85535	0	85946
21442	154	62	67	86032	0	86315
21443	145	45	54	85800	0	86044
21444	87073	41	55	587	0	87756
21445	86397	47	45	458	0	86947
21446	86831	25	60	517	0	87433
21447	86327	22	73	442	0	86864
21448	286	83	85674	155	0	86198
21449	81871	32	189	426	0	82518
21450	85764	30	54	354	0	86202
21451	271	74	84830	107	0	85282
21452	161	86	88811	93	0	89151
21453	213	34	214	90187	0	90648
21454	78	91294	72	273	0	91717
21455	93312	162	67	421	0	93962
21456	94727	44	36	405	0	95212
21457	93285	30	42	381	0	93738
21458	341	33	26	92957	0	93357
21459	137	95253	64	222	0	95676
21460	98915	176	45	530	0	99666
21461	100220	54	43	475	0	100792
21462	344	44	54	99082	0	99524
21463	183	113	96988	273	0	97557
21464	95969	35	229	409	0	96642
21465	318	36	101	102169	0	102624
21466	104567	24	64	638	0	105293
21467	332	40	39	106407	0	106818
21468	186	116	105797	232	0	106331
21469	109247	27	207	656	0	110137
21470	357	36	85	114201	0	114679
21471	288	38	65	114264	0	114655
21472	195	28	47	115791	0	116061
21473	189	36	47	115333	0	115605
21474	116853	25	38	665	0	117581
21475	344	14	32	116605	0	116995
21476	213	114911	88	346	0	115558
21477	175	249	53	118009	0	118486
21478	95	117221	81	354	0	117751
21479	173	308	43	119859	0	120383
21480	187	121	32	120409	0	120749
21481	73	119423	80	429	0	120005
21482	165	297	47	122064	0	122573
21483	221	104	42	121737	0	122104
21484	120775	55	37	929	0	121796
21485	443	115	123482	290	0	124330
21486	332	52	485	123748	0	124617
21487	124738	56	116	1110	0	126020
21488	123936	41	75	656	0	124708
21489	124087	68	55	629	0	124839
21490	897	137	124270	151	0	125455
21491	365	142	122676	169	0	123352
21492	505	127	909	126601	0	128142
21493	129825	26	324	1267	0	131442
21494	876	125	128379	318	0	129698
21495	121682	45	870	721	0	123318
21496	964	129578	284	242	0	131068
21497	558	744	161	135303	0	136766
21498	476	203	173	137390	0	138242
21499	138005	107	186	1496	0	139794
21500	1054	79	119	139301	0	140553
21501	131593	70	105	1450	0	133218
21502	132308	49	98	835	0	133290
21503	1327	68	110	131114	0	132619
21504	626	63	130	131786	0	132605
21505	131086	39	118	1608	0	132851
21506	1117	106	137092	457	0	138772
21507	131311	32	907	1148	0	133398
21508	1177	104	142001	277	0	143559
21509	140326	63	910	882	0	142181
21510	150643	69	279	912	0	151903
21511	147768	77	185	903	0	148933
21512	146722	50	131	719	0	147622
21513	1340	145820	183	257	0	147600
21514	148874	843	118	682	0	150517
21515	149195	193	121	680	0	150189
21516	1394	154831	164	257	0	156646
21517	156103	902	109	886	0	158000
21518	1397	326	154750	225	0	156698
21519	150593	140	984	794	0	152511
21520	1530	277	156779	177	0	158763
21521	996	121	1165	156177	0	158459
21522	797	80	428	158576	0	159881
21523	606	196	156623	1357	0	158782
21524	807	106	1197	155939	0	158049
21525	3678	842	2605	93623	0	100748
21526	163923	112	333	2260	0	166628
21527	1864	148	218	165336	0	167566
21528	1031	149	238	164212	0	165630
21529	767	106	187	165862	0	166922
21530	458	162588	271	1990	0	165307
21531	618	1308	200	163220	0	165346
21532	161969	377	209	2423	0	164978
21533	1808	314	165114	841	0	168077
21534	1056	157	1730	167400	0	170343
21535	590	234	167778	2213	0	170815
21536	160473	115	2028	1483	0	164099
21537	2511	104	682	175102	0	178399
21538	979	322	212084	2767	0	216152
21539	1271	127	4650	211367	0	217415
21540	1225	139	2998	208799	0	213161
21541	590	207840	2372	7483	0	218285
21542	1236	4477	1523	215594	0	222830
21543	1289	2709	654	225663	0	230315
21544	706	2317	219722	9632	0	232377
21545	1432	1317	5372	219476	0	227597
21546	1245	555	3223	226819	0	231842
21547	216756	368	2449	10826	0	230399
21548	216227	366	1794	7313	0	225700
21549	7968	217623	1178	4885	0	231654
21550	221988	5259	899	4046	0	232192
21551	223291	3150	1001	3371	0	230813
21552	9869	220935	1230	2753	0	234787
21553	6906	6715	921	219803	0	234345
21554	223338	3782	642	8111	0	235873
21555	224429	2835	778	5743	0	233785
21556	219435	1989	735	5212	0	227371
21557	11613	216010	1045	3554	0	232222
21558	7961	6231	222550	2533	0	239275
21559	224898	3810	5998	3089	0	237795
21560	230603	3175	3237	2994	0	240009
21561	11633	227272	2602	2265	0	243772
21562	230578	7551	1773	2710	0	242612
21563	236312	4300	1191	2424	0	244227
21564	14210	3278	849	225811	0	244148
21565	8667	2797	225057	7982	0	244503
21566	7425	1841	7008	226230	0	242504
21567	6013	1323	3896	229447	0	240679
21568	5003	1428	2869	232776	0	242076
21569	3851	1585	220047	13064	0	238547
21570	4787	1357	7703	212437	0	226284
21571	4158	1354	4240	225234	0	234986
21572	3928	1097	3276	228970	0	237271
21573	3937	993	2428	230729	0	238087
21574	3826	1062	1479	231682	0	238049
21575	2765	224046	1433	16359	0	244603
21576	3251	7508	1374	232080	0	244213
21577	2965	3850	1666	241823	0	250304
21578	2126	2959	229359	15435	0	249879
21579	2974	1990	8065	248212	0	261241
21580	2776	1439	4424	254864	0	263503
21581	2807	1211	3364	261854	0	269236
21582	3126	1103	2831	267089	0	274149
21583	249431	1290	2133	21521	0	274375
21584	10908	1480	1615	261139	0	275142
21585	6967	1656	1303	263424	0	273350
21586	5027	1851	242410	19583	0	268871
21587	4016	228020	8860	13971	0	254867
21588	2491	248494	5649	11324	0	267958
21589	238415	11490	4900	9948	0	264753
21590	8961	245240	3452	8696	0	266349
21591	6421	11593	2070	243759	0	263843
21592	240354	6652	1911	15637	0	264554
21593	11289	4713	240606	11384	0	267992
21594	7466	3635	9280	240496	0	260877
21595	5530	240597	5665	15348	0	267140
21596	5251	9914	3940	238914	0	258019
21597	3203	245070	3113	16278	0	267664
21598	3943	12466	2044	247905	0	266358
21599	240821	7681	1603	17638	0	267743
21600	11739	5866	243327	11267	0	272199
21601	8618	4462	9934	232492	0	255506
21602	6111	244201	6239	14511	0	271062
21603	243351	11019	4829	10922	0	270121
21604	12127	6863	241916	9521	0	270427
21605	8463	5410	10309	241996	0	266178
21606	6814	4537	235301	14868	0	261520
21607	6624	3233	12604	236187	0	258648
21608	4678	3030	231299	17267	0	256274
21609	4236	3175	13738	227161	0	248310
21610	3856	3058	8611	234086	0	249611
21611	219989	3249	5915	20126	0	249279
21612	227571	3284	4502	13541	0	248898
21613	16472	2967	3437	222216	0	245092
21614	10325	219184	3269	16399	0	249177
21615	8261	10978	2789	224887	0	246915
21616	6304	6430	3069	227716	0	243519
21617	210259	4600	3509	21797	0	240165
21618	11130	212848	3477	15703	0	243158
21619	211567	11305	2912	13041	0	238825
21620	213215	7141	2780	11041	0	234177
21621	16057	203538	2657	10028	0	232280
21622	10194	217158	2442	10248	0	240042
21623	211525	13755	2986	10642	0	238908
21624	14300	8228	203422	11209	0	237159
21625	205264	6278	10441	10720	0	232703
21626	208587	5182	6268	9874	0	229911
21627	18254	199511	5218	9072	0	232055
21628	13131	11607	4194	179717	0	208649
21629	8853	201745	3902	15317	0	229817
21630	199357	14064	3950	11719	0	229090
21631	206443	9584	4127	9475	0	229629
21632	17558	7795	3381	198494	0	227228
21633	12583	6748	2818	202916	0	225065
21634	189569	5259	2314	19359	0	216501
21635	14751	186074	2326	14458	0	217609
21636	10664	182725	2544	12018	0	207951
21637	9059	181891	3062	9353	0	203365
21638	4090	136234	2014	6083	0	148421
21639	3851	142298	1757	6363	0	154269
21640	4337	10888	1972	136298	0	153495
21641	3744	6120	129749	10450	0	150063
21642	4261	132901	5863	6449	0	149474
21643	125305	7855	3089	4682	0	140931
21644	8484	4719	2775	124490	0	140468
21645	124103	4266	2387	8351	0	139107
21646	8048	124019	2310	5398	0	139775
21647	124136	7263	2792	4736	0	138927
21648	8768	123415	3319	4218	0	139720
21649	5776	7333	3420	123957	0	140486
21650	124165	4133	2777	8795	0	139870
21651	127983	3631	2871	6150	0	140635
21652	9179	3377	2358	126183	0	141097
21653	5960	3389	2075	126629	0	138053
21654	5241	122203	1579	10659	0	139682
21655	5525	6870	1358	125194	0	138947
21656	5452	4034	1106	128486	0	139078
21657	5379	4049	1059	124379	0	134866
21658	4138	114021	1158	10726	0	130043
21659	104433	6008	940	6723	0	118104
21660	6524	106885	962	5285	0	119656
21661	105782	6803	925	4081	0	117591
21662	7722	105571	1193	3324	0	117810
21663	5734	6796	101276	3073	0	116879
21664	5280	4499	4590	101363	0	115732
21665	4397	4012	99991	5672	0	114072
21666	4097	3615	99965	3618	0	111295
21667	4199	3318	6144	98137	0	111798
21668	4500	2676	99347	5835	0	112358
21669	4809	2394	5737	97168	0	110108
21670	4902	2616	3119	98640	0	109277
21671	4163	2787	2103	102197	0	111250
21672	97171	3029	1681	8577	0	110458
21673	6859	2646	1342	97800	0	108647
21674	5515	2468	977	96143	0	105103
21675	88481	1791	701	7919	0	98892
21676	6510	84566	608	5827	0	97511
21677	4478	79273	491	4745	0	88987
21678	4053	82643	469	3638	0	90803
21679	2576	5863	548	63307	0	72294
21680	1933	2076	62543	3455	0	70007
21681	54030	1801	2156	2164	0	60151
21682	2888	56906	966	1335	0	62095
21683	55798	2352	668	1153	0	59971
21684	56274	1597	440	873	0	59184
21685	56565	1441	332	807	0	59145
21686	3104	1417	54980	839	0	60340
21687	2037	1315	1588	55325	0	60265
21688	1928	1043	776	56900	0	60647
21689	1912	965	584	57681	0	61142
21690	1819	813	503	55763	0	58898
21691	1567	52405	417	2756	0	57145
21692	52289	1767	337	1639	0	56032
21693	1893	930	48638	1065	0	52526
21694	46159	667	1076	985	0	48887
21695	1922	838	449	44687	0	47896
21696	1203	43098	221	1705	0	46227
21697	936	45494	194	1207	0	47831
21698	1061	2811	305	41034	0	45211
21699	697	41389	211	1323	0	43620
21700	37443	756	193	652	0	39044
21701	785	402	36837	450	0	38474
21702	388	211	506	35565	0	36670
21703	290	188	198	37276	0	37952
21704	225	196	137	37847	0	38405
21705	215	223	113	37709	0	38260
21706	37799	195	94	925	0	39013
21707	652	39412	84	483	0	40631
21708	42941	639	109	370	0	44059
21709	902	322	110	43707	0	45041
21710	508	233	111	44934	0	45786
21711	317	28108	112	19179	0	47716
21712	46994	586	100	1041	0	48721
21713	47560	284	110	690	0	48644
21714	1237	47486	122	401	0	49246
21715	740	938	102	44632	0	46412
21716	386	46727	136	896	0	48145
21717	46063	1016	105	608	0	47792
21718	1017	487	46273	381	0	48158
21719	526	324	44579	325	0	45754
21720	43068	206	1111	459	0	44844
21721	968	45245	503	287	0	47003
21722	609	902	281	45194	0	46986
21723	438	469	183	45662	0	46752
21724	264	343	45330	1304	0	47241
21725	379	254	839	44976	0	46448
21726	320	230	392	45465	0	46407
21727	222	45013	282	1341	0	46858
21728	313	913	190	45513	0	46929
21729	286	476	166	45619	0	46547
21730	44269	304	141	1496	0	46210
21731	943	43027	173	741	0	44884
21732	478	43869	148	503	0	44998
21733	394	1096	169	43968	0	45627
21734	306	551	134	44839	0	45830
21735	356	333	111	44380	0	45180
21736	176	43805	137	1481	0	45599
21737	273	949	113	44763	0	46098
21738	299	439	79	44850	0	45667
21739	306	330	83	45090	0	45809
21740	292	248	73	44442	0	45055
21741	206	41644	101	1609	0	43560
21742	205	44763	100	913	0	45981
21743	43194	1087	71	682	0	45034
21744	43795	523	67	523	0	44908
21745	1271	375	58	43609	0	45313
21746	602	264	43365	1135	0	45366
21747	487	239	803	43716	0	45245
21748	387	191	327	44195	0	45100
21749	42779	219	217	1502	0	44717
21750	972	44409	139	766	0	46286
21751	547	954	109	44310	0	45920
21752	412	459	85	45049	0	46005
21753	278	342	43547	1426	0	45593
21754	270	293	43584	765	0	44912
21755	285	246	1121	43295	0	44947
21756	286	205	523	42959	0	43973
21757	221	42434	344	1322	0	44321
21758	197	43918	229	720	0	45064
21759	43002	1094	175	700	0	44971
21760	994	528	155	44109	0	45786
21761	444	344	43683	1099	0	45570
21762	293	43744	789	703	0	45529
21763	298	872	385	44722	0	46277
21764	44470	478	213	1270	0	46431
21765	902	403	139	45273	0	46717
21766	44458	279	144	1429	0	46310
21767	1010	45276	116	771	0	47173
21768	44363	963	117	717	0	46160
21769	1152	530	109	45791	0	47582
21770	566	434	47819	1259	0	50078
21771	479	328	1010	47360	0	49177
21772	265	49409	426	1440	0	51540
21773	404	1251	259	49202	0	51116
21774	252	51917	211	1496	0	53876
21775	383	1434	156	53795	0	55768
21776	246	639	52249	1809	0	54943
21777	329	473	50473	999	0	52274
21778	273	385	51957	853	0	53468
21779	50700	379	1650	877	0	53606
21780	1366	51401	732	666	0	54165
21781	700	53575	488	539	0	55302
21782	51917	1649	305	744	0	54615
21783	52481	809	286	684	0	54260
21784	1826	600	259	51662	0	54347
21785	805	484	51587	1675	0	54551
21786	626	417	49366	876	0	51285
21787	592	338	1663	49532	0	52125
21788	49301	336	799	1892	0	52328
21789	1327	49194	540	1019	0	52080
21790	717	1464	378	49803	0	52362
21791	49133	657	363	1944	0	52097
21792	49242	453	329	1210	0	51234
21793	1661	422	48280	900	0	51263
21794	46155	398	1268	911	0	48732
21795	1653	415	49408	673	0	52149
21796	843	408	50546	573	0	52370
21797	806	338	1686	47917	0	50747
21798	668	333	794	49252	0	51047
21799	570	388	523	50604	0	52085
21800	419	413	48669	2106	0	51607
21801	47577	376	1306	1288	0	50547
21802	1588	352	595	50268	0	52803
21803	48095	281	426	2003	0	50805
21804	47765	387	389	1179	0	49720
21805	1758	47999	408	910	0	51075
21806	880	48765	417	784	0	50846
21807	625	48215	400	615	0	49855
21808	580	1508	345	42918	0	45351
21809	383	556	42961	1202	0	45102
21810	449	1228	1076	39199	0	41952
21811	343	40039	443	1091	0	41916
21812	325	40541	325	431	0	41622
21813	424	1061	258	39522	0	41265
21814	38430	396	267	1103	0	40196
21815	940	37891	289	454	0	39574
21816	375	38607	232	418	0	39632
21817	38994	1028	184	508	0	40714
21818	1096	439	206	39153	0	40894
21819	522	339	207	39372	0	40440
21820	500	251	168	40374	0	41293
21821	38845	254	188	1331	0	40618
21822	39519	210	187	697	0	40613
21823	1272	196	236	39413	0	41117
21824	600	238	38481	1066	0	40385
21825	37710	239	960	624	0	39533
21826	1122	220	398	39792	0	41532
21827	489	177	39407	1209	0	41282
21828	413	196	38986	596	0	40191
21829	429	213	1142	40167	0	41951
21830	335	241	42474	1209	0	44259
21831	459	215	1104	45329	0	47107
21832	587	239	555	42943	0	44324
21833	453	189	373	48295	0	49310
21834	47166	267	303	1883	0	49619
21835	1389	294	265	47759	0	49707
21836	718	294	268	48597	0	49877
21837	511	316	276	48615	0	49718
21838	453	283	293	48891	0	49920
21839	333	299	46513	1889	0	49034
21840	347	46368	1183	970	0	48868
21841	401	1200	469	46095	0	48165
21842	394	554	400	45224	0	46572
21843	312	43558	389	1552	0	45811
21844	341	46587	336	818	0	48082
21845	45621	1338	313	811	0	48083
21846	1204	45420	303	624	0	47551
21847	639	1267	275	45024	0	47205
21848	457	556	45311	1484	0	47808
21849	42649	399	1096	939	0	45083
21850	1314	337	43659	735	0	46045
21851	42918	229	1188	774	0	45109
21852	44184	211	514	672	0	45581
21853	1627	180	44258	596	0	46661
21854	904	189	1302	41175	0	43570
21855	633	42332	554	1447	0	44966
21856	517	1118	495	45836	0	47966
21857	46638	370	439	1757	0	49204
21858	47224	299	424	933	0	48880
21859	1585	46754	414	807	0	49560
21860	46981	1168	360	819	0	49328
21861	1675	439	316	46198	0	48628
21862	46046	323	317	1821	0	48507
21863	47300	274	311	1020	0	48905
21864	1896	249	227	46572	0	48944
21865	46100	257	198	1839	0	48394
21866	44371	287	231	1126	0	46015
21867	1522	271	44338	872	0	47003
21868	42869	299	1087	877	0	45132
21869	1548	311	43212	677	0	45748
21870	657	236	40085	511	0	41489
21871	522	41745	1153	549	0	43969
21872	551	976	576	39790	0	41893
21873	363	402	40981	1010	0	42756
21874	358	296	39217	551	0	40422
21875	39827	267	1008	437	0	41539
21876	987	209	419	40324	0	41939
21877	468	207	305	42046	0	43026
21878	366	191	240	42572	0	43369
21879	354	214	182	42505	0	43255
21880	385	189	190	42883	0	43647
21881	363	159	42018	1246	0	43786
21882	402	161	41390	593	0	42546
21883	437	147	933	42262	0	43779
21884	41866	148	421	1190	0	43625
21885	953	41515	314	618	0	43400
21886	535	757	225	42022	0	43539
21887	41746	228	247	1196	0	43417
21888	1030	41685	290	588	0	43593
21889	601	818	275	42059	0	43753
21890	513	301	208	42858	0	43880
21891	436	232	212	43079	0	43959
21892	42151	153	235	1412	0	43951
21893	1057	173	41695	741	0	43666
21894	41331	144	896	690	0	43061
21895	1177	165	378	42502	0	44222
21896	566	157	339	40826	0	41888
21897	381	41383	297	1349	0	43410
21898	388	783	40235	777	0	42183
21899	39349	278	842	807	0	41276
21900	41319	212	422	676	0	42629
21901	1146	195	40803	548	0	42692
21902	38341	152	826	703	0	40022
21903	1025	40388	398	553	0	42364
21904	486	41141	347	503	0	42477
21905	403	41755	321	420	0	42899
21906	39857	996	315	476	0	41644
21907	1029	454	40435	393	0	42311
21908	557	455	799	38434	0	40245
21909	409	38365	385	889	0	40048
21910	393	39449	258	485	0	40585
21911	359	40138	243	398	0	41138
21912	888	1191	292	30494	0	32865
21913	38597	386	209	999	0	40191
21914	895	39117	218	519	0	40749
21915	505	785	191	39621	0	41102
21916	415	373	194	40314	0	41296
21917	39233	273	230	1078	0	40814
21918	1039	214	243	39036	0	40532
21919	602	184	190	40241	0	41217
21920	450	250	39421	1115	0	41236
21921	456	247	741	38838	0	40282
21922	436	198	299	40459	0	41392
21923	39487	148	259	1203	0	41097
21924	39583	155	212	620	0	40570
21925	1180	147	200	39542	0	41069
21926	36591	184	183	1151	0	38109
21927	38000	166	196	609	0	38971
21928	1007	38025	250	395	0	39677
21929	526	707	36953	326	0	38512
21930	448	35487	719	297	0	36951
21931	529	982	374	31946	0	33831
21932	31324	159	282	599	0	32364
21933	460	31043	106	262	0	31871
21934	260	422	78	31195	0	31955
21935	30735	180	90	607	0	31612
21936	30483	132	122	307	0	31044
21937	556	106	117	30568	0	31347
21938	229	111	30999	582	0	31921
21939	234	90	389	31216	0	31929
21940	179	106	117	32120	0	32522
21941	120	126	31696	658	0	32600
21942	231	71	417	31203	0	31922
21943	238	81	185	31845	0	32349
21944	32976	59	123	734	0	33892
21945	515	69	100	33451	0	34135
21946	245	88	80	33827	0	34240
21947	32889	102	78	788	0	33857
21948	32727	94	103	432	0	33356
21949	32560	94	100	370	0	33124
21950	629	123	32151	235	0	33138
21951	325	126	412	31267	0	32130
21952	198	32083	151	502	0	32934
21953	184	454	84	33195	0	33917
21954	236	186	33746	526	0	34694
21955	347	264	403	30790	0	31804
21956	173	95	31976	444	0	32688
21957	28738	53	394	295	0	29480
21958	30189	51	128	218	0	30586
21959	402	36	60	30657	0	31155
21960	192	50	68	30446	0	30756
21961	126	36	50	30153	0	30365
21962	97	31129	60	395	0	31681
21963	31021	268	41	343	0	31673
21964	31307	96	38	290	0	31731
21965	423	71	46	31152	0	31692
21966	210	46	39	31064	0	31359
21967	163	34	34	31308	0	31539
21968	170	39	53	31295	0	31557
21969	116	55	30750	442	0	31363
21970	149	47	269	30620	0	31085
21971	29308	40	95	476	0	29919
21972	29093	39	54	292	0	29478
21973	389	43	49	28400	0	28881
21974	136	58	27481	351	0	28026
21975	25685	40	280	250	0	26255
21976	392	78	93	27411	0	27974
21977	154	25899	60	384	0	26497
21978	86	27325	50	174	0	27635
21979	28307	338	56	339	0	29040
21980	375	117	33	29088	0	29613
21981	187	66	26	29904	0	30183
21982	155	37	21	31703	0	31916
21983	135	27	21	31805	0	31988
21984	118	20	33	33056	0	33227
21985	76	29	32646	684	0	33435
21986	64	32	31877	304	0	32277
21987	71	28	32596	214	0	32909
21988	138	12	621	32785	0	33556
21989	60	42	34804	603	0	35509
21990	143	17	594	34488	0	35242
21991	186	23	223	35062	0	35494
21992	143	21	158	36687	0	37009
21993	36631	12	145	1032	0	37820
21994	682	26	129	36891	0	37728
21995	291	49	122	37609	0	38071
21996	36951	26	134	1037	0	38148
21997	678	36435	148	433	0	37694
21998	214	37959	126	317	0	38616
21999	37729	752	82	409	0	38972
22000	696	39056	80	307	0	40139
22001	39076	729	67	394	0	40266
22002	39696	241	63	393	0	40393
22003	39997	140	46	351	0	40534
22004	39060	98	65	377	0	39600
22005	39486	116	52	358	0	40012
22006	1044	39065	65	243	0	40417
22007	38970	786	50	340	0	40146
22008	39968	288	63	334	0	40653
22009	1115	41190	81	231	0	42617
22010	46125	806	59	381	0	47371
22011	47327	294	63	329	0	48013
22012	50340	208	60	292	0	50900
22013	51859	182	66	321	0	52428
22014	2070	235	52136	217	0	54658
22015	1181	200	1369	53357	0	56107
22016	891	195	410	55464	0	56960
22017	562	210	54667	1882	0	57321
22018	543	188	53590	775	0	55096
22019	53833	150	1862	523	0	56368
22020	2144	154	668	54923	0	57889
22021	941	173	55660	1572	0	58346
22022	723	168	55073	637	0	56601
22023	54275	134	2023	607	0	57039
22024	56619	147	788	476	0	58030
22025	56867	127	509	416	0	57919
22026	2513	117	56133	267	0	59030
22027	1481	87	1680	55544	0	58792
22028	884	117	57479	1639	0	60119
22029	56431	85	1956	825	0	59297
22030	2074	150	58857	558	0	61639
22031	1160	90	2098	57077	0	60425
22032	1068	116	891	56847	0	58922
22033	635	58888	682	2025	0	62230
22034	59911	1598	523	1052	0	63084
22035	2098	516	59803	666	0	63083
22036	59152	314	2054	619	0	62139
22037	2379	219	61602	423	0	64623
22038	1282	154	2272	59281	0	62989
22039	1124	121	952	61317	0	63514
22040	966	140	711	62002	0	63819
22041	60528	125	558	2703	0	63914
22042	2525	140	586	59270	0	62521
22043	1362	146	537	60184	0	62229
22044	930	58413	566	2532	0	62441
22045	947	1629	591	59348	0	62515
22046	58201	520	606	2620	0	61947
22047	2336	391	58446	1166	0	62339
22048	1355	258	2014	57932	0	61559
22049	1023	229	58690	2309	0	62251
22050	850	56643	2373	1213	0	61079
22051	794	1619	59043	981	0	62437
22052	56984	631	2491	1028	0	61134
22053	59287	368	1162	928	0	61745
22054	2769	227	995	57341	0	61332
22055	57954	176	851	2499	0	61480
22056	59117	157	814	1330	0	61418
22057	2936	208	762	58263	0	62169
22058	1657	206	740	59601	0	62204
22059	1154	239	58560	2713	0	62666
22060	1065	57931	2153	1405	0	62554
22061	58415	1698	1093	1178	0	62384
22062	2473	57547	851	943	0	61814
22063	1560	1963	771	57545	0	61839
22064	1303	742	725	58997	0	61767
22065	1184	498	775	59264	0	61721
22066	1064	360	755	59487	0	61666
22067	871	332	57193	3116	0	61512
22068	54875	342	2273	1816	0	59306
22069	58688	306	1040	1405	0	61439
22070	3027	347	845	57270	0	61489
22071	57778	284	664	2648	0	61374
22072	2846	280	622	57933	0	61681
22073	1455	309	56935	2901	0	61600
22074	1343	313	2081	55852	0	59589
22075	1043	56124	1109	2724	0	61000
22076	1096	1661	796	54871	0	58424
22077	872	56650	744	2667	0	60933
22078	987	1925	610	54221	0	57743
22079	823	55587	630	2655	0	59695
22080	53999	1959	622	1699	0	58279
22081	2262	815	54337	1430	0	58844
22082	1152	50898	1923	1271	0	55244
22083	1016	53255	1000	1189	0	56460
22084	1161	1957	1071	51724	0	55913
22085	1060	776	691	51823	0	54350
22086	1017	523	660	51938	0	54138
22087	968	438	683	52777	0	54866
22088	854	50430	688	2727	0	54699
22089	920	1607	605	50254	0	53386
22090	966	654	472	50724	0	52816
22091	48449	554	528	2635	0	52166
22092	2095	415	399	49123	0	52032
22093	1032	408	47425	2440	0	51305
22094	835	401	46129	1555	0	48920
22095	43999	400	1753	1435	0	47587
22096	1686	45711	888	1129	0	49414
22097	869	47483	632	1022	0	50006
22098	912	1770	607	46324	0	49613
22099	725	847	388	47602	0	49562
22100	565	619	45093	2357	0	48634
22101	42834	449	1471	1575	0	46329
22102	45078	404	667	1343	0	47492
22103	1891	395	46604	1154	0	50044
22104	1011	322	44976	1066	0	47375
22105	45425	275	1733	1155	0	48588
22106	48410	314	803	1057	0	50584
22107	48467	365	543	1012	0	50387
22108	47833	332	415	976	0	49556
22109	2094	44503	354	885	0	47836
22110	39620	1068	271	677	0	41636
22111	1388	403	37601	607	0	39999
22112	553	316	34104	469	0	35442
22113	420	205	36749	410	0	37784
22114	568	1222	1022	31941	0	34753
22115	32311	102	394	538	0	33345
22116	32391	98	132	268	0	32889
22117	526	80	126	32264	0	32996
22118	313	80	126	30286	0	30805
22119	225	82	88	32327	0	32722
22120	181	33888	108	565	0	34742
22121	34819	371	83	429	0	35702
22122	35311	110	78	345	0	35844
22123	35562	109	84	319	0	36074
22124	35560	90	82	272	0	36004
22125	35617	72	92	269	0	36050
22126	627	81	82	34488	0	35278
22127	281	33576	103	460	0	34420
22128	303	335	64	31449	0	32151
22129	193	191	56	32084	0	32524
22130	31472	73	54	436	0	32035
22131	323	57	30807	173	0	31360
22132	170	59	28937	134	0	29300
22133	128	52	29416	106	0	29702
22134	31464	21	234	172	0	31891
22135	33032	32	153	145	0	33362
22136	277	42	72	34164	0	34555
22137	158	20	52	33445	0	33675
22138	140	35	33	34350	0	34558
22139	77	38	34651	295	0	35061
22140	137	14	231	33623	0	34005
22141	69	40	36861	285	0	37255
22142	127	27	241	36522	0	36917
22143	97	21	103	36843	0	37064
22144	82	29	62	38449	0	38622
22145	38414	22	41	475	0	38952
22146	38275	22	33	334	0	38664
22147	291	41	38767	115	0	39214
22148	37392	12	215	254	0	37873
22149	38692	12	102	174	0	38980
22150	334	10	71	38845	0	39260
22151	39213	13	65	376	0	39667
22152	335	9	42	40149	0	40535
22153	184	8	36	40358	0	40586
22154	106	31	39547	387	0	40071
22155	36729	13	254	350	0	37346
22156	303	10	111	40038	0	40462
22157	160	34	40265	299	0	40758
22158	155	40	41795	167	0	42157
22159	215	9	322	41148	0	41694
22160	126	7	162	42161	0	42456
22161	43329	0	99	532	0	43960
22162	360	8	79	43953	0	44400
22163	233	6	53	43893	0	44185
22164	162	2	68	44873	0	45105
22165	185	7	83	48157	0	48432
22166	49623	4	78	832	0	50537
22167	49389	5	65	543	0	50002
22168	50544	14	52	438	0	51048
22169	51689	8	79	329	0	52105
22170	992	7	61	52991	0	54051
22171	53707	3	74	872	0	54656
22172	930	6	59	53858	0	54853
22173	54400	8	69	979	0	55456
22174	992	5	61	54057	0	55115
22175	580	8	72	53515	0	54175
22176	259	53488	77	1530	0	55354
22177	313	637	57	54168	0	55175
22178	53231	240	35	1116	0	54622
22179	51889	99	53	692	0	52733
22180	1044	69	53142	313	0	54568
22181	478	53225	702	273	0	54678
22182	53280	653	315	438	0	54686
22183	881	54571	168	198	0	55818
22184	54075	741	104	459	0	55379
22185	943	56958	87	234	0	58222
22186	518	809	57133	240	0	58700
22187	309	57235	754	235	0	58533
22188	228	57961	319	256	0	58764
22189	331	989	145	60101	0	61566
22190	61295	378	126	1100	0	62899
22191	1045	197	71	61926	0	63239
22192	616	132	73	62529	0	63350
22193	61918	123	71	1401	0	63513
22194	62907	112	76	830	0	63925
22195	1345	129	67	63172	0	64713
22196	772	93	117	63292	0	64274
22197	571	109	75	63888	0	64643
22198	61876	91	94	1537	0	63598
22199	1029	152	62569	634	0	64384
22200	706	128	812	62320	0	63966
22201	409	161	64542	1040	0	66152
22202	311	62981	910	624	0	64826
22203	334	791	62471	423	0	64019
22204	417	377	899	61429	0	63122
22205	291	229	62280	1065	0	63865
22206	58497	150	940	809	0	60396
22207	1052	132	421	61565	0	63170
22208	569	62685	241	1122	0	64617
22209	527	844	169	62789	0	64329
22210	413	62289	138	1089	0	63929
22211	373	62517	162	653	0	63705
22212	362	63648	144	484	0	64638
22213	465	1099	151	59292	0	61007
22214	329	61370	122	1044	0	62865
22215	60161	943	142	757	0	62003
22216	1074	494	58772	457	0	60797
22217	632	310	55872	476	0	57290
22218	428	281	59319	364	0	60392
22219	464	199	1162	60552	0	62377
22220	459	230	482	58450	0	59621
22221	551	195	263	58087	0	59096
22222	575	198	219	58388	0	59380
22223	684	219	195	55587	0	56685
22224	558	58492	228	1435	0	60713
22225	513	987	57057	797	0	59354
22226	550	567	55256	590	0	56963
22227	454	58902	1138	560	0	61054
22228	576	979	505	60461	0	62521
22229	497	510	287	61490	0	62784
22230	510	373	226	61375	0	62484
22231	60289	347	231	1778	0	62645
22232	1139	346	59438	956	0	61879
22233	56918	289	910	878	0	58995
22234	58324	264	457	791	0	59836
22235	1441	57240	332	585	0	59598
22236	741	58157	249	515	0	59662
22237	58434	1199	256	692	0	60581
22238	1340	644	228	58491	0	60703
22239	858	410	197	60284	0	61749
22240	564	427	61650	1527	0	64168
22241	477	417	60139	762	0	61795
22242	507	435	1425	62404	0	64771
22243	63160	445	684	1550	0	65839
22244	1325	443	66455	762	0	68985
22245	66479	384	1458	811	0	69132
22246	1695	340	642	69120	0	71797
22247	915	343	401	71926	0	73585
22248	737	321	370	74542	0	75970
22249	533	333	73539	2300	0	76705
22250	477	70156	1620	1143	0	73396
22251	477	75612	651	837	0	77577
22252	74876	1905	315	978	0	78074
22253	77350	643	295	852	0	79140
22254	2430	350	284	77489	0	80553
22255	77921	259	307	2395	0	80882
22256	2143	293	76752	996	0	80184
22257	823	357	76432	695	0	78307
22258	723	293	2282	75984	0	79282
22259	78753	256	894	2508	0	82411
22260	2275	223	620	79755	0	82873
22261	1041	214	528	82705	0	84488
22262	80219	205	490	3092	0	84006
22263	82103	275	484	1349	0	84211
22264	2595	84265	461	928	0	88249
22265	82099	2020	352	746	0	85217
22266	2647	691	289	79132	0	82759
22267	778	80937	301	2214	0	84230
22268	80596	2024	270	974	0	83864
22269	2315	82037	286	595	0	85233
22270	947	2152	274	81036	0	84409
22271	80914	511	219	2360	0	84004
22272	2243	340	79747	671	0	83001
22273	739	270	79787	511	0	81307
22274	824	311	2164	77936	0	81235
22275	705	225	625	80962	0	82517
22276	806	240	325	78210	0	79581
22277	482	81685	304	2109	0	84580
22278	84102	2140	208	1091	0	87541
22279	84741	599	216	873	0	86429
22280	84913	350	215	865	0	86343
22281	2695	87337	236	633	0	90901
22282	1297	2323	204	91363	0	95187
22283	957	628	238	93362	0	95185
22284	826	409	233	94109	0	95577
22285	87733	375	231	3616	0	91955
22286	2628	88546	286	1154	0	92614
22287	1213	2407	242	88568	0	92430
22288	879	669	200	90761	0	92509
22289	608	510	87129	3271	0	91518
22290	533	86167	2319	1256	0	90275
22291	926	2596	603	85372	0	89497
22292	911	730	318	87668	0	89627
22293	943	521	238	87867	0	89569
22294	84160	463	223	3674	0	88520
22295	2708	84522	264	1585	0	89079
22296	84892	2520	221	1382	0	89015
22297	3090	810	268	84834	0	89002
22298	85049	567	282	3286	0	89184
22299	2999	605	83132	1353	0	88089
22300	82173	460	2423	1374	0	86430
22301	84208	445	674	1345	0	86672
22302	3392	526	83196	987	0	88101
22303	1540	534	2519	82856	0	87449
22304	1299	502	781	82451	0	85033
22305	86479	440	520	3963	0	91402
22306	3253	410	480	88419	0	92562
22307	1544	410	441	88894	0	91289
22308	1262	512	360	90357	0	92491
22309	1090	466	86739	3884	0	92179
22310	80453	420	2552	2184	0	85609
22311	3226	88121	827	1469	0	93643
22312	1725	2718	551	85332	0	90326
22313	1236	86746	543	3210	0	91735
22314	1108	91868	504	1563	0	95043
22315	1164	3277	434	90689	0	95564
22316	929	1144	90430	3767	0	96270
22317	1034	797	91277	1784	0	94892
22318	1231	680	3133	91926	0	96970
22319	1000	672	91991	3819	0	97482
22320	89698	658	3062	2089	0	95507
22321	3479	640	1054	94086	0	99259
22322	1582	615	800	95457	0	98454
22323	1066	94670	738	4152	0	100626
22324	1122	3046	600	95163	0	99931
22325	1077	1099	564	95063	0	97803
22326	860	92892	594	4376	0	98722
22327	1097	3117	562	94941	0	99717
22328	1145	1130	496	94532	0	97303
22329	989	93331	578	4210	0	99108
22330	92677	2999	603	2350	0	98629
22331	3409	1175	92341	1737	0	98662
22332	1435	846	92034	1660	0	95975
22333	1348	947	3242	91527	0	97064
22334	1120	808	1101	95031	0	98060
22335	918	726	92415	4356	0	98415
22336	840	771	90620	2191	0	94422
22337	82810	759	3217	2159	0	88945
22338	3035	91015	1179	1693	0	96922
22339	88894	2919	739	1733	0	94285
22340	3153	997	87820	1605	0	93575
22341	1138	87038	2935	1529	0	92640
22342	1223	3141	1114	88284	0	93762
22343	915	1056	90649	3560	0	96180
22344	785	738	88168	1575	0	91266
22345	1227	1100	3257	87792	0	93376
22346	765	609	89094	3516	0	93984
22347	701	87038	2968	1618	0	92325
22348	888	2746	1178	85590	0	90402
22349	694	995	86710	3107	0	91506
22350	655	86962	2845	1521	0	91983
22351	84819	2646	1099	1329	0	89893
22352	2771	987	84754	995	0	89507
22353	1030	84840	2674	1074	0	89618
22354	1068	2572	1236	82945	0	87821
22355	789	993	887	87592	0	90261
22356	85197	703	765	3634	0	90299
22357	2844	466	743	84853	0	88906
22358	1092	474	715	84325	0	86606
22359	81062	480	668	3482	0	85692
22360	2524	530	560	80799	0	84413
22361	920	481	77608	3005	0	82014
22362	934	654	2164	76620	0	80372
22363	556	458	76204	2904	0	80122
22364	648	373	71274	1359	0	73654
22365	534	389	73963	1057	0	75943
22366	822	388	2451	69438	0	73099
22367	633	296	1231	73267	0	75427
22368	71965	289	735	2794	0	75783
22369	2026	275	663	69615	0	72579
22370	815	73130	606	2386	0	76937
22371	669	1670	638	75929	0	78906
22372	629	616	640	74690	0	76575
22373	316	75316	685	2623	0	78940
22374	74129	1715	620	1620	0	78084
22375	72910	630	598	1384	0	75522
22376	2024	72628	650	976	0	76278
22377	695	72066	506	800	0	74067
22378	712	2914	616	69563	0	73805
22379	70420	834	605	2058	0	73917
22380	1727	584	70579	1018	0	73908
22381	704	442	64239	768	0	66153
22382	59111	327	1393	624	0	61455
22383	1239	63693	677	474	0	66083
22384	580	1306	424	63924	0	66234
22385	618	579	398	61581	0	63176
22386	493	408	346	63117	0	64364
22387	466	302	341	63733	0	64842
22388	344	62947	364	1759	0	65414
22389	370	1241	297	64655	0	66563
22390	64224	495	279	1807	0	66805
22391	1305	413	263	65268	0	67249
22392	605	263	288	66290	0	67446
22393	65802	228	322	2027	0	68379
22394	66112	261	309	1188	0	67870
22395	67120	232	285	944	0	68581
22396	67854	274	252	794	0	69174
22397	1957	219	273	67046	0	69495
22398	67220	190	257	1758	0	69425
22399	1612	215	256	67162	0	69245
22400	66566	189	275	1860	0	68890
22401	67031	176	279	999	0	68485
22402	1863	210	270	67564	0	69907
22403	898	219	68226	1617	0	70960
22404	66229	202	1220	1113	0	68764
22405	68442	198	506	978	0	70124
22406	67739	208	377	799	0	69123
22407	67794	200	291	748	0	69033
22408	2132	206	277	67694	0	70309
22409	1021	246	67407	1468	0	70142
22410	761	230	64963	837	0	66791
22411	64432	193	1398	947	0	66970
22412	68588	200	643	729	0	70160
22413	1659	67720	469	557	0	70405
22414	823	68223	332	471	0	69849
22415	68996	1170	308	648	0	71122
22416	1445	489	312	67409	0	69655
22417	861	361	272	68762	0	70256
22418	68077	202	238	1676	0	70193
22419	1312	69531	235	785	0	71863
22420	70827	1036	192	869	0	72924
22421	1418	445	70386	553	0	72802
22422	69271	312	1012	688	0	71283
22423	1442	225	399	70912	0	72978
22424	736	183	72991	1320	0	75230
22425	648	73549	983	775	0	75955
22426	684	983	425	75659	0	77751
22427	542	426	78882	1273	0	81123
22428	663	294	1066	77743	0	79766
22429	80688	160	525	1756	0	83129
22430	1375	199	80731	787	0	83092
22431	76017	158	1182	924	0	78281
22432	1464	81485	588	480	0	84017
22433	895	1055	415	82677	0	85042
22434	678	506	87832	1296	0	90312
22435	742	319	1141	86647	0	88849
22436	592	226	89699	1454	0	91971
22437	546	88350	1252	808	0	90956
22438	86020	1030	537	767	0	88354
22439	1233	91294	396	441	0	93364
22440	793	1143	265	90624	0	92825
22441	706	502	280	91527	0	93015
22442	442	387	88709	1404	0	90942
22443	69975	262	964	1351	0	72552
22444	1029	83107	505	483	0	85124
22445	507	79828	242	261	0	80838
22446	337	81035	166	309	0	81847
22447	508	1050	319	78723	0	80600
22448	225	79272	205	701	0	80403
22449	418	738	195	77936	0	79287
22450	242	79012	179	647	0	80080
22451	299	741	110	77691	0	78841
22452	199	80178	109	585	0	81071
22453	79116	645	128	602	0	80491
22454	578	384	79378	289	0	80629
22455	73963	245	552	489	0	75249
22456	78609	165	252	410	0	79436
22457	80750	199	149	422	0	81520
22458	742	81628	128	223	0	82721
22459	82216	574	112	403	0	83305
22460	82018	277	110	373	0	82778
22461	82766	165	163	398	0	83492
22462	1000	188	82690	141	0	84019
22463	701	144	553	83427	0	84825
22464	377	221	86483	684	0	87765
22465	396	170	693	84618	0	85877
22466	85257	150	342	1032	0	86781
22467	889	85884	228	429	0	87430
22468	521	811	97268	253	0	98853
22469	738	356	1472	93645	0	96211
22470	405	237	387	101607	0	102636
22471	232	222	107990	1977	0	110421
22472	101568	157	2097	923	0	104745
22473	109274	164	579	592	0	110609
22474	111855	185	333	512	0	112885
22475	2943	176	267	109132	0	112518
22476	904	105512	219	2176	0	108811
22477	535	112783	267	739	0	114324
22478	681	2312	264	111059	0	114316
22479	781	733	223	110155	0	111892
22480	445	110595	207	2367	0	113614
22481	109982	2088	192	1089	0	113351
22482	2168	110747	208	565	0	113688
22483	973	2292	184	108973	0	112422
22484	485	807	108605	2256	0	112153
22485	697	422	2058	106797	0	109974
22486	108297	375	599	2706	0	111977
22487	2321	374	108424	809	0	111928
22488	106684	339	2133	859	0	110015
22489	112243	352	818	856	0	114269
22490	114317	298	440	764	0	115819
22491	113985	286	342	807	0	115420
22492	117536	251	301	725	0	118813
22493	3275	299	112233	351	0	116158
22494	1417	299	110575	397	0	112688
22495	118440	274	2737	656	0	122107
22496	125434	266	882	581	0	127163
22497	3951	294	467	125857	0	130569
22498	1559	128139	409	2895	0	133002
22499	1246	2799	343	130521	0	134909
22500	131951	1005	348	3587	0	136891
22501	3816	586	345	126678	0	131425
22502	1527	133778	326	3088	0	138719
22503	133737	2944	288	1661	0	138630
22504	132241	1145	266	1204	0	134856
22505	133284	621	261	1105	0	135271
22506	4322	131549	331	618	0	136820
22507	2249	2921	336	131436	0	136942
22508	1720	1174	254	130307	0	133455
22509	1235	124994	285	3664	0	130178
22510	1393	3077	239	129550	0	134259
22511	127807	1182	219	3902	0	133110
22512	128505	793	249	1916	0	131463
22513	4237	126913	386	1101	0	132637
22514	2256	3107	316	127348	0	133027
22515	1740	1304	329	129969	0	133342
22516	1449	804	438	131180	0	133871
22517	126316	646	386	4989	0	132337
22518	3993	636	124395	2153	0	131177
22519	118328	630	2941	1942	0	123841
22520	4284	1003	123547	1409	0	130243
22521	2531	709	3205	118006	0	124451
22522	1745	119105	1193	3640	0	125683
22523	1655	126493	718	1885	0	130751
22524	121315	4034	589	1775	0	127713
22525	121330	1791	413	1658	0	125192
22526	4499	117499	544	1321	0	123863
22527	2018	119117	473	1337	0	122945
22528	119265	4120	473	1451	0	125309
22529	121461	1921	451	1479	0	125312
22530	4832	122413	484	1195	0	128924
22531	125166	3799	495	1296	0	130756
22532	4921	1798	123058	974	0	130751
22533	123421	1297	3230	1356	0	129304
22534	124160	1060	1214	1292	0	127726
22535	5596	957	834	119731	0	127118
22536	2943	119319	665	3832	0	126759
22537	2870	3603	551	119350	0	126374
22538	122456	1475	689	4334	0	128954
22539	5393	1104	527	117939	0	124963
22540	3113	961	573	121590	0	126237
22541	2309	920	120116	4984	0	128329
22542	2389	931	3391	120893	0	127604
22543	2107	894	1354	125672	0	130027
22544	123346	921	874	5486	0	130627
22545	4741	1005	122566	2557	0	130869
22546	123439	979	3536	2175	0	130129
22547	5160	1026	1375	124793	0	132354
22548	2925	917	799	127038	0	131679
22549	2241	1051	658	125843	0	129793
22550	1996	119256	572	5365	0	127189
22551	2073	124180	671	2544	0	129468
22552	2382	4263	568	121733	0	128946
22553	121334	1828	557	4598	0	128317
22554	123320	1297	591	2402	0	127610
22555	5853	1073	526	121221	0	128673
22556	121449	1053	504	4798	0	127804
22557	5442	1037	470	120352	0	127301
22558	3059	1006	456	123059	0	127580
22559	115243	953	485	5768	0	122449
22560	4792	120760	545	2844	0	128941
22561	120645	3649	516	2436	0	127246
22562	120391	1534	459	2265	0	124649
22563	118450	1075	473	2306	0	122304
22564	5331	116005	507	2007	0	123850
22565	3112	3764	500	116563	0	123939
22566	2590	1599	512	119388	0	124089
22567	2231	1166	113301	5152	0	121850
22568	1895	1425	2594	103268	0	109182
22569	1656	901	99447	3795	0	105799
22570	1479	94089	2427	2106	0	100101
22571	1085	85466	987	1416	0	88954
22572	1121	88453	631	1227	0	91432
22573	1557	2588	941	90347	0	95433
22574	1157	1190	410	91337	0	94094
22575	977	816	344	92797	0	94934
22576	934	735	288	94170	0	96127
22577	782	718	93964	3504	0	98968
22578	820	780	108593	2006	0	112199
22579	1063	730	2814	112923	0	117530
22580	913	605	115259	3442	0	120219
22581	113852	515	2776	2313	0	119456
22582	117714	454	1133	1825	0	121126
22583	3615	546	116853	1530	0	122544
22584	2105	453	2709	117899	0	123166
22585	1631	519	1290	120493	0	123933
22586	1503	480	866	123071	0	125920
22587	1626	491	772	121869	0	124758
22588	1655	486	634	124013	0	126788
22589	86948	1707	933	5631	0	95219
22590	117433	517	646	2845	0	121441
22591	3453	118270	534	2156	0	124413
22592	1626	2473	112125	1678	0	117902
22593	1100	110927	2419	1711	0	116157
22594	909	113852	1102	1595	0	117458
22595	106337	2495	567	1397	0	110796
22596	2402	105115	507	1063	0	109087
22597	1032	102419	393	724	0	104568
22598	100404	2362	634	903	0	104303
22599	2093	968	99204	711	0	102976
22600	96343	712	1753	883	0	99691
22601	2226	530	645	100116	0	103517
22602	1151	430	396	97366	0	99343
22603	886	421	350	98533	0	100190
22604	641	437	95475	2759	0	99312
22605	643	95932	1941	1430	0	99946
22606	95979	1807	827	1313	0	99926
22607	2206	685	675	96808	0	100374
22608	843	97650	463	2678	0	101634
22609	781	2014	543	101351	0	104689
22610	766	875	100258	2699	0	104598
22611	1046	648	2153	100765	0	104612
22612	901	637	814	104370	0	106722
22613	916	481	512	105517	0	107426
22614	103532	430	354	3794	0	108110
22615	2427	439	426	104742	0	108034
22616	976	335	102770	3539	0	107620
22617	679	102338	2194	2006	0	107217
22618	954	2021	813	103968	0	107756
22619	993	865	667	104946	0	107471
22620	714	799	102731	3287	0	107531
22621	810	599	99384	1596	0	102389
22622	98061	707	3166	1635	0	103569
22623	97308	753	1373	1667	0	101101
22624	3013	99466	1213	1118	0	104810
22625	99649	2270	765	1360	0	104044
22626	3075	993	98835	1212	0	104115
22627	1637	561	96917	1407	0	100522
22628	96287	592	2980	1963	0	101822
22629	96212	419	1249	2071	0	99951
22630	2786	394	92982	1997	0	98159
22631	89922	455	2124	2051	0	94552
22632	2690	476	92540	1510	0	97216
22633	90938	511	2552	1066	0	95067
22634	92753	843	1182	820	0	95598
22635	3056	1127	884	86931	0	91998
22636	1433	95354	985	2191	0	99963
22637	67354	3250	1191	2185	0	73980
22638	2085	1531	95603	912	0	100131
22639	1470	96159	2433	801	0	100863
22640	96487	2881	1033	1146	0	101547
22641	92869	1306	778	1358	0	96311
22642	3249	92974	880	1312	0	98415
22643	1974	2261	1072	93541	0	98848
22644	1509	988	91842	3136	0	97475
22645	1157	719	2632	92781	0	97289
22646	912	1002	91571	3455	0	96940
22647	1097	820	2630	91413	0	95960
22648	1090	827	1511	92742	0	96170
22649	1049	1128	90431	3201	0	95809
22650	1122	90448	2611	1958	0	96139
22651	1298	2431	1207	89166	0	94102
22652	1380	1682	61548	3591	0	68201
22653	88869	879	1787	2124	0	93659
22654	2684	673	1223	91675	0	96255
22655	1333	590	964	93755	0	96642
22656	91346	588	980	4036	0	96950
22657	3016	671	774	91091	0	95552
22658	2032	633	838	88650	0	92153
22659	1245	89572	1146	3302	0	95265
22660	1435	2247	1112	88647	0	93441
22661	1016	1290	87089	3753	0	93148
22662	1186	754	2460	84546	0	88946
22663	1164	85245	1424	3131	0	90964
22664	962	88054	1506	1888	0	92410
22665	1172	2620	1226	87790	0	92808
22666	87762	1357	900	2865	0	92884
22667	3072	1089	992	87644	0	92797
22668	87725	1246	1020	2857	0	92848
22669	3383	694	1108	87624	0	92809
22670	87135	779	1400	2994	0	92308
22671	89169	820	1176	1970	0	93135
22672	3882	898	1012	86767	0	92559
22673	2650	3136	1386	82417	0	89589
22674	1690	81685	1452	3344	0	88171
22675	1884	83659	1136	1862	0	88541
22676	1728	2121	81707	1773	0	87329
22677	1626	78662	2073	1535	0	83896
22678	59438	1711	1599	1094	0	63842
22679	1850	512	762	58704	0	61828
22680	768	56744	568	1492	0	59572
22681	58224	1191	445	1037	0	60897
22682	1697	528	369	58293	0	60887
22683	1023	351	480	56883	0	58737
22684	805	367	522	58018	0	59712
22685	754	467	571	57775	0	59567
22686	648	57516	522	1812	0	60498
22687	711	61499	382	970	0	63562
22688	61169	1375	397	758	0	63699
22689	1675	62825	431	488	0	65419
22690	797	1456	410	62970	0	65633
22691	835	572	289	64013	0	65709
22692	789	427	298	64056	0	65570
22693	687	424	261	64793	0	66165
22694	63343	377	287	2093	0	66100
22695	64509	281	369	1008	0	66167
22696	1977	337	63386	724	0	66424
22697	1028	321	1468	63634	0	66451
22698	747	289	64515	1866	0	67417
22699	740	297	1624	64217	0	66878
22700	645	353	635	66180	0	67813
22701	64684	318	395	2371	0	67768
22702	1971	326	385	64749	0	67431
22703	696	306	63911	2023	0	66936
22704	501	311	60909	1011	0	62732
22705	61229	257	1715	1099	0	64300
22706	1570	255	63643	845	0	66313
22707	793	352	1503	60537	0	63185
22708	470	198	62741	1772	0	65181
22709	545	473	1467	59956	0	62441
22710	259	61348	659	1653	0	63919
22711	416	1258	456	60521	0	62651
22712	234	59809	412	1518	0	61973
22713	218	60816	268	750	0	62052
22714	328	1505	244	59440	0	61517
22715	58675	442	215	1656	0	60988
22716	1063	59887	204	666	0	61820
22717	498	1182	157	60136	0	61973
22718	60032	431	150	1635	0	62248
22719	61113	321	141	832	0	62407
22720	62662	281	145	726	0	63814
22721	1585	196	145	61698	0	63624
22722	729	198	155	62813	0	63895
22723	62874	221	127	1815	0	65037
22724	63034	218	139	965	0	64356
22725	63777	191	128	786	0	64882
22726	1656	197	114	63435	0	65402
22727	685	233	60760	1234	0	62912
22728	60046	160	873	790	0	61869
22729	1385	173	278	60959	0	62795
22730	581	62528	218	1297	0	64624
22731	633	1229	166	61463	0	63491
22732	458	61655	148	1197	0	63458
22733	493	1049	126	62999	0	64667
22734	340	383	62182	1294	0	64199
22735	274	61596	883	655	0	63408
22736	391	899	280	59584	0	61154
22737	333	295	195	60007	0	60830
22738	297	234	149	59817	0	60497
22739	60663	212	105	1547	0	62527
22740	1051	61281	170	665	0	63167
22741	522	1100	143	62705	0	64470
22742	63662	420	113	1559	0	65754
22743	64206	270	120	814	0	65410
22744	1648	230	89	64428	0	66395
22745	633	201	64968	1575	0	67377
22746	603	214	1183	63311	0	65311
22747	311	65134	417	1519	0	67381
22748	438	1248	247	66423	0	68356
22749	65986	399	196	1853	0	68434
22750	1585	245	152	69844	0	71826
22751	571	210	71442	1811	0	74034
22752	367	76414	1360	875	0	79016
22753	77131	1639	429	843	0	80042
22754	1746	602	78015	579	0	80942
22755	77893	323	1718	668	0	80602
22756	2113	242	571	80573	0	83499
22757	1061	161	370	81227	0	82819
22758	456	82051	350	2218	0	85075
22759	85283	1716	238	1221	0	88458
22760	2222	563	290	86643	0	89718
22761	1116	319	279	88478	0	90192
22762	854	247	240	91318	0	92659
22763	470	220	90472	2935	0	94097
22764	622	222	1897	90270	0	93011
22765	91532	225	677	2760	0	95194
22766	94292	233	409	1446	0	96380
22767	2721	236	270	93607	0	96834
22768	1196	214	260	95373	0	97043
22769	93582	191	234	3059	0	97066
22770	2200	256	92554	1275	0	96285
22771	90220	207	1911	1274	0	93612
22772	2408	318	91456	645	0	94827
22773	1119	273	92005	683	0	94080
22774	979	179	2342	91874	0	95374
22775	622	248	94154	2358	0	97382
22776	92426	180	2181	1369	0	96156
22777	2400	169	894	95887	0	99350
22778	1033	226	95994	2283	0	99536
22779	91579	165	2086	1424	0	95254
22780	95598	145	756	1157	0	97656
22781	2699	215	97911	844	0	101669
22782	1616	483	1999	91469	0	95567
22783	895	98559	759	1959	0	102172
22784	99757	1769	530	1343	0	103399
22785	2414	662	102059	693	0	105828
22786	92912	501	1787	1067	0	96267
22787	2112	99557	811	636	0	103116
22788	97325	1449	638	841	0	100253
22789	96775	558	357	908	0	98598
22790	97654	357	315	863	0	99189
22791	2344	379	342	97385	0	100450
22792	1081	98306	359	1723	0	101469
22793	819	1547	97003	842	0	100211
22794	643	99680	1546	731	0	102600
22795	1060	1631	662	89874	0	93227
22796	579	97098	440	1480	0	99597
22797	513	100231	401	813	0	101958
22798	97284	1733	367	887	0	100271
22799	1716	738	97507	586	0	100547
22800	902	488	98695	584	0	100669
22801	737	493	99575	527	0	101332
22802	621	101954	1731	685	0	104991
22803	102078	1363	741	911	0	105093
22804	102453	628	460	856	0	104397
22805	101920	343	415	848	0	103526
22806	1964	101368	460	702	0	104494
22807	1048	1347	412	104224	0	107031
22808	730	658	103114	1716	0	106218
22809	810	469	100677	1041	0	102997
22810	102966	330	1763	1366	0	106425
22811	108196	353	825	1095	0	110469
22812	108366	465	583	969	0	110383
22813	2242	322	106588	816	0	109968
22814	105288	230	1708	1068	0	108294
22815	2255	282	908	107358	0	110803
22816	1370	235	669	107740	0	110014
22817	1043	397	111339	2262	0	115041
22818	985	111624	1644	1265	0	115518
22819	1058	1358	896	113143	0	116455
22820	846	621	112156	2103	0	115726
22821	104939	318	1843	1752	0	108852
22822	2109	298	1078	112883	0	116368
22823	1428	242	831	113553	0	116054
22824	112524	189	828	2664	0	116205
22825	2469	223	585	113155	0	116432
22826	112612	238	635	2620	0	116105
22827	112881	247	736	1773	0	115637
22828	2739	244	661	112561	0	116205
22829	1709	286	776	113160	0	115931
22830	111645	235	745	2640	0	115265
22831	2349	240	883	112860	0	116332
22832	113285	301	899	2418	0	116903
22833	112058	323	809	1640	0	114830
22834	111961	276	795	1295	0	114327
22835	2953	271	796	110556	0	114576
22836	1810	379	642	110769	0	113600
22837	110595	262	677	2486	0	114020
22838	2182	108299	790	1010	0	112281
22839	1311	106520	662	593	0	109086
22840	105534	1277	658	902	0	108371
22841	1810	647	103812	456	0	106725
22842	101123	353	1294	898	0	103668
22843	1789	332	657	107563	0	110341
22844	1080	398	107918	1148	0	110544
22845	106588	287	1225	1051	0	109151
22846	1825	375	563	109830	0	112593
22847	1363	341	409	111463	0	113576
22848	1232	345	371	113799	0	115747
22849	1224	313	267	113789	0	115593
22850	110636	276	274	1894	0	113080
22851	1233	108731	328	732	0	111024
22852	99886	665	176	768	0	101495
22853	944	362	101527	177	0	103010
22854	575	257	96509	173	0	97514
22855	434	103037	605	199	0	104275
22856	839	1085	635	101718	0	104277
22857	283	313	101784	496	0	102876
22858	242	90969	485	393	0	92089
22859	148	357	95898	102	0	96505
22860	274	73	234	93370	0	93951
22861	195	51	84	92696	0	93026
22862	93660	26	33	693	0	94412
22863	322	32	52	91987	0	92393
22864	91274	17	25	716	0	92032
22865	275	74	91308	92	0	91749
22866	113	91154	245	107	0	91619
22867	245	206	70	95146	0	95667
22868	234	75	63	102353	0	102725
22869	103	122	103700	277	0	104202
22870	173	156	94832	162	0	95323
22871	94027	34	286	760	0	95107
22872	103395	21	75	539	0	104030
22873	376	27	74	103691	0	104168
22874	237	53	49	103113	0	103452
22875	71	102074	68	373	0	102586
22876	158	245	35	105815	0	106253
22877	106096	64	60	931	0	107151
22878	106232	40	48	751	0	107071
22879	476	109190	72	147	0	109885
22880	109176	436	51	666	0	110329
22881	107500	118	51	562	0	108231
22882	799	77	40	114216	0	115132
22883	217	118172	90	833	0	119312
22884	417	902	33	120060	0	121412
22885	367	196	44	119763	0	120370
22886	159	177	117081	1247	0	118664
22887	115927	82	1057	890	0	117956
22888	1738	77	218	130327	0	132360
22889	970	103	104	137997	0	139174
22890	290	156005	162	2371	0	158828
22891	825	2889	44	162566	0	166324
22892	163611	804	87	4260	0	168762
22893	172123	542	78	1955	0	174698
22894	4771	591	169465	908	0	175735
22895	1693	498	169871	771	0	172833
22896	1907	363	4638	170370	0	177278
22897	1719	149	1464	179492	0	182824
22898	883	244	178059	5108	0	184294
22899	734	250	178930	1833	0	181747
22900	1420	147	5563	167648	0	174778
22901	514	186	178033	4993	0	183726
22902	548	244	178597	1945	0	181334
22903	1172	143	6047	171362	0	178724
22904	176747	140	2481	5613	0	184981
22905	181834	137	1824	2533	0	186328
22906	5912	140	1426	179501	0	186979
22907	2752	142	1147	182438	0	186479
22908	179600	108	1026	6383	0	187117
22909	5720	131	837	177270	0	183958
22910	175350	170	737	6339	0	182596
22911	177648	154	632	3149	0	181583
22912	6700	164	576	175747	0	183187
22913	3174	199	583	179347	0	183303
22914	174109	197	554	6977	0	181837
22915	5509	172596	657	3037	0	181799
22916	2419	177486	673	2599	0	183177
22917	2457	4906	577	170712	0	178652
22918	1669	1699	169967	5594	0	178929
22919	1987	1132	4509	168211	0	175839
22920	168719	944	1668	6498	0	177829
22921	5469	752	1205	169662	0	177088
22922	169922	639	1080	6596	0	178237
22923	5493	634	168610	3207	0	177944
22924	165166	492	4844	2797	0	173299
22925	6270	405	1751	168610	0	177036
22926	3246	355	1279	173204	0	178084
22927	2212	421	172972	6639	0	182244
22928	2745	347	4832	170570	0	178494
22929	2244	377	1876	176307	0	180804
22930	2067	515	1391	180296	0	184269
22931	173574	555	1216	8507	0	183852
22932	5410	545	173914	4318	0	184187
22933	2693	640	172254	3380	0	178967
22934	167415	331	5914	3704	0	177364
22935	174501	279	2803	3270	0	180853
22936	6933	389	175224	2461	0	185007
22937	3828	414	6057	165890	0	176189
22938	2523	172851	3165	5824	0	184363
22939	2797	4248	2575	177990	0	187610
22940	176252	1327	2475	7475	0	187529
22941	180058	855	2523	4295	0	187731
22942	7030	764	2533	175637	0	185964
22943	3140	173575	2384	7146	0	186245
22944	3391	4329	2162	167706	0	177588
22945	2852	172577	2143	6675	0	184247
22946	173014	4791	1864	4664	0	184333
22947	164808	1873	1925	4250	0	172856
22948	169328	1227	1897	3929	0	176381
22949	7392	160492	1747	3693	0	173324
22950	4052	168176	1719	3554	0	177501
22951	4131	5746	1493	168742	0	180112
22952	3785	2223	1362	171723	0	179093
22953	3724	1500	1232	169500	0	175956
22954	3716	1297	1144	174469	0	180626
22955	3010	1249	165560	8997	0	178816
22956	158947	1277	5067	5986	0	171277
22957	6962	1394	169564	4485	0	182405
22958	169973	1239	5796	4691	0	181699
22959	7411	1253	175573	3898	0	188135
22960	171855	962	6326	4302	0	183445
22961	7919	977	178013	3609	0	190518
22962	172217	921	6638	3810	0	183586
22963	8551	936	3455	178325	0	191267
22964	181566	906	2701	7928	0	193101
22965	8653	916	2395	182770	0	194734
22966	5170	779	2146	185158	0	193253
22967	4233	697	2195	178268	0	185393
22968	3394	169437	2062	9393	0	184286
22969	169106	4847	1767	6148	0	181868
22970	170883	1834	1717	5331	0	179765
22971	8328	169209	1641	4659	0	183837
22972	5101	5317	1550	170979	0	182947
22973	3835	2150	167739	7994	0	181718
22974	164841	1495	5876	5099	0	177311
22975	172458	1259	2784	4393	0	180894
22976	171245	1042	2389	3855	0	178531
22977	9355	969	2042	160202	0	172568
22978	5142	159599	1962	6889	0	173592
22979	4409	5140	1858	160809	0	172216
22980	160263	2051	1727	7615	0	171656
22981	8240	1588	1605	152806	0	164239
22982	4265	150639	1650	6513	0	163067
22983	144811	4786	1407	4134	0	155138
22984	7184	2314	143964	3035	0	156497
22985	4612	1912	140961	2976	0	150461
22986	3287	140315	5577	2835	0	152014
22987	2943	136900	2461	2288	0	144592
22988	3741	4862	126088	2018	0	136709
22989	2948	2258	115590	1599	0	122395
22990	2290	5755	3299	89315	0	100659
22991	92694	591	1564	2503	0	97352
22992	2225	548	92978	1083	0	96834
22993	902	86556	1458	703	0	89619
22994	85561	1409	1031	880	0	88881
22995	1571	86129	503	428	0	88631
22996	81541	1098	324	562	0	83525
22997	1219	81140	318	325	0	83002
22998	711	83595	269	380	0	84955
22999	817	1241	361	83918	0	86337
23000	709	616	375	84275	0	85975
23001	557	415	80216	1164	0	82352
23002	656	317	860	78496	0	80329
23003	79195	315	410	1416	0	81336
23004	79704	327	236	972	0	81239
23005	1378	306	168	78511	0	80363
23006	730	346	76770	1088	0	78934
23007	516	297	74624	745	0	76182
23008	534	223	1213	77042	0	79012
23009	437	269	78772	1091	0	80569
23010	531	225	1216	77184	0	79156
23011	643	211	699	75994	0	77547
23012	370	317	85289	1355	0	87331
23013	79909	262	1418	1117	0	82706
23014	84930	225	892	817	0	86864
23015	1701	206	86107	385	0	88399
23016	901	220	87894	457	0	89472
23017	863	213	2210	88816	0	92102
23018	734	223	1050	101476	0	103483
23019	704	276	575	105613	0	107168
23020	784	349	482	105223	0	106838
23021	105578	286	389	3270	0	109523
23022	113222	271	409	1636	0	115538
23023	3484	297	443	121618	0	125842
23024	1717	280	437	129655	0	132089
23025	723	298	136962	4177	0	142160
23026	1039	204	3500	139619	0	144362
23027	934	185	1634	147772	0	150525
23028	146620	184	722	6464	0	153990
23029	4460	156866	559	2675	0	164560
23030	2601	4436	420	156667	0	164124
23031	1555	1615	447	160417	0	164034
23032	1341	704	530	156821	0	159396
23033	693	141045	671	7320	0	149729
23034	590	156794	571	3428	0	161383
23035	1247	5716	470	154329	0	161762
23036	1219	2231	430	156463	0	160343
23037	1203	1122	436	159961	0	162722
23038	148592	768	491	8221	0	158072
23039	4583	152537	507	3935	0	161562
23040	153071	4960	466	2761	0	161258
23041	157075	2224	445	2236	0	161980
23042	7049	1289	401	149456	0	158195
23043	2671	151076	424	5986	0	160157
23044	151058	5030	319	3641	0	160048
23045	5973	2275	251	152170	0	160669
23046	152856	1336	329	6732	0	161253
23047	6474	1081	307	154701	0	162563
23048	2930	1041	153136	6517	0	163624
23049	1777	903	157256	3598	0	163534
23050	1872	835	6029	155125	0	163861
23051	1797	843	2403	158997	0	164040
23052	1961	899	1091	154559	0	158510
23053	1504	149325	765	7654	0	159248
23054	1353	161067	708	3964	0	167092
23055	154319	6045	654	3001	0	164019
23056	151980	2544	728	2708	0	157960
23057	6358	149651	720	2044	0	158773
23058	2498	144439	524	1860	0	149321
23059	1465	152449	472	1884	0	156270
23060	141798	6108	493	2354	0	150753
23061	4517	146586	534	1872	0	153509
23062	2647	5278	475	145812	0	154212
23063	144860	2371	472	5625	0	153328
23064	147183	1379	456	3110	0	152128
23065	6549	1259	397	141877	0	150082
23066	2773	1267	139205	5580	0	148825
23067	1745	1329	141031	2780	0	146885
23068	1868	1169	5465	139974	0	148476
23069	1483	1173	143850	5633	0	152139
23070	1868	1123	4796	142150	0	149937
23071	1801	1048	2017	144148	0	149014
23072	1353	1170	142555	6941	0	152019
23073	1338	1062	143801	3492	0	149693
23074	1663	975	6092	140538	0	149268
23075	1546	987	2681	148895	0	154109
23076	141265	982	1587	7706	0	151540
23077	4937	140162	1273	4159	0	150531
23078	2316	148988	1069	3254	0	155627
23079	141950	5897	1059	3277	0	152183
23080	146942	2634	1135	3034	0	153745
23081	6216	143021	1146	2978	0	153361
23082	2974	148427	1096	2886	0	155383
23083	145851	6201	947	3109	0	156108
23084	5858	2910	862	145709	0	155339
23085	142295	1946	924	6948	0	152113
23086	5763	143493	1026	4300	0	154582
23087	144231	5241	884	3599	0	153955
23088	6403	2738	141769	3096	0	154006
23089	140741	1868	4606	3284	0	150499
23090	6470	1870	143011	2893	0	154244
23091	3847	1643	5180	142012	0	152682
23092	140639	1555	2399	7125	0	151718
23093	6090	1586	137864	4550	0	150090
23094	3595	1738	4997	139469	0	149799
23095	137652	1791	2346	7103	0	148892
23096	6277	1880	137236	4365	0	149758
23097	3792	1759	5002	139242	0	149795
23098	135888	1663	2254	7437	0	147242
23099	5951	135503	1482	4518	0	147454
23100	3678	5617	1170	138289	0	148754
23101	3094	3131	1066	136706	0	143997
23102	2894	2281	1008	138989	0	145172
23103	2501	138468	1098	7891	0	149958
23104	2863	5741	1049	143308	0	152961
23105	2979	2954	996	146377	0	153306
23106	3189	2097	963	146544	0	152793
23107	3156	1844	974	149575	0	155549
23108	2796	1830	141431	8423	0	154480
23109	134136	1728	5072	4989	0	145925
23110	142100	1514	2428	3838	0	149880
23111	7398	140005	1666	3295	0	152364
23112	3719	5071	1209	134414	0	144413
23113	2790	2418	1157	136094	0	142459
23114	2170	133810	1380	7668	0	145028
23115	2141	4518	1495	134842	0	142996
23116	127104	2057	1452	6988	0	137601
23117	4432	125043	1562	4075	0	135112
23118	115185	4044	1289	2778	0	123296
23119	4587	1890	967	114897	0	122341
23120	2040	1340	112882	5391	0	121653
23121	1460	113285	3712	3175	0	121632
23122	104089	3875	2009	2279	0	112252
23123	3442	95845	892	1426	0	101605
23124	1712	94848	683	1158	0	98401
23125	81287	2555	921	1079	0	85842
23126	2296	987	81206	805	0	85294
23127	744	74600	1426	613	0	77383
23128	64922	2278	2912	983	0	71095
23129	59284	399	557	398	0	60638
23130	865	59866	112	227	0	61070
23131	503	755	104	61289	0	62651
23132	304	353	62549	758	0	63964
23133	338	234	660	61617	0	62849
23134	414	216	289	59402	0	60321
23135	255	191	178	65130	0	65754
23136	218	200	65257	972	0	66647
23137	369	195	626	62467	0	63657
23138	234	214	64595	820	0	65863
23139	203	198	60177	375	0	60953
23140	54398	161	759	680	0	55998
23141	685	62933	328	218	0	64164
23142	294	64397	208	224	0	65123
23143	463	843	149	65815	0	67270
23144	70484	373	126	1082	0	72065
23145	71066	235	124	560	0	71985
23146	69450	185	121	521	0	70277
23147	70566	163	137	430	0	71296
23148	67878	139	130	395	0	68542
23149	1123	171	66171	213	0	67678
23150	653	205	766	65362	0	66986
23151	348	63746	321	829	0	65244
23152	317	803	240	66158	0	67518
23153	66824	354	145	1135	0	68458
23154	867	65593	186	462	0	67108
23155	521	851	114	67909	0	69395
23156	67937	373	128	1106	0	69544
23157	69404	262	151	671	0	70488
23158	1294	183	128	68983	0	70588
23159	719	172	157	67953	0	69001
23160	504	187	125	69543	0	70359
23161	360	215	68120	1268	0	69963
23162	357	241	67962	609	0	69169
23163	398	210	985	69609	0	71202
23164	394	202	422	71190	0	72208
23165	70589	184	263	1451	0	72487
23166	69931	196	187	863	0	71177
23167	70365	212	175	691	0	71443
23168	70947	208	140	713	0	72008
23169	70359	205	167	617	0	71348
23170	1292	71280	175	478	0	73225
23171	73088	874	177	667	0	74806
23172	73751	396	190	648	0	74985
23173	73910	304	176	564	0	74954
23174	1618	223	165	75593	0	77599
23175	788	208	74845	1230	0	77071
23176	746	192	1008	76013	0	77959
23177	527	214	80816	1402	0	82959
23178	681	207	1117	76842	0	78847
23179	433	80743	438	1230	0	82844
23180	81465	1091	300	715	0	83571
23181	83307	456	219	642	0	84624
23182	1713	320	190	84773	0	86996
23183	980	215	192	89360	0	90747
23184	805	190	196	89228	0	90419
23185	534	90928	198	1583	0	93243
23186	90286	1143	190	932	0	92551
23187	90550	457	172	714	0	91893
23188	1653	91329	199	479	0	93660
23189	915	1205	189	92185	0	94494
23190	779	487	184	90543	0	91993
23191	505	92812	207	1540	0	95064
23192	94035	1226	156	996	0	96413
23193	94844	479	177	773	0	96273
23194	1888	315	181	94784	0	97168
23195	847	258	94648	1500	0	97253
23196	664	268	90972	783	0	92687
23197	682	242	1511	97231	0	99666
23198	678	256	557	97685	0	99176
23199	670	275	321	101049	0	102315
23200	98396	216	217	2321	0	101150
23201	98783	212	208	1218	0	100421
23202	1939	101992	228	724	0	104883
23203	100746	1345	249	852	0	103192
23204	1836	474	100241	493	0	103044
23205	866	393	98553	470	0	100282
23206	629	104584	1644	480	0	107337
23207	102074	1332	740	761	0	104907
23208	1356	102771	335	469	0	104931
23209	102316	1354	238	694	0	104602
23210	1615	524	101946	350	0	104435
23211	804	355	99374	393	0	100926
23212	856	226	1529	99442	0	102053
23213	566	316	104543	1534	0	106959
23214	755	245	1436	105616	0	108052
23215	1183	370	744	91064	0	93361
23216	474	107239	436	1819	0	109968
23217	640	1323	376	109221	0	111560
23218	644	498	373	111225	0	112740
23219	113627	393	353	2216	0	116589
23220	1760	114913	330	905	0	117908
23221	967	1617	307	117219	0	120110
23222	653	638	117579	1947	0	120817
23223	100293	407	1776	1724	0	104200
23224	1894	390	116629	777	0	119690
23225	1084	354	1800	111961	0	115199
23226	674	119239	645	1905	0	122463
23227	799	1919	406	118867	0	121991
23228	119794	664	333	2568	0	123359
23229	119464	449	351	1396	0	121660
23230	2506	122795	378	797	0	126476
23231	125698	1987	341	1206	0	129232
23232	126961	742	343	1347	0	129393
23233	126654	643	312	1316	0	128925
23234	131586	465	297	1094	0	133442
23235	121603	463	426	1300	0	123792
23236	2628	439	128356	668	0	132091
23237	1501	444	2030	126188	0	130163
23238	1479	391	866	122069	0	124805
23239	1029	472	524	127625	0	129650
23240	789	128171	458	2708	0	132126
23241	1048	1963	384	127190	0	130585
23242	915	766	127471	2275	0	131427
23243	779	123797	1921	1084	0	127581
23244	720	124065	806	844	0	126435
23245	1009	2227	577	123151	0	126964
23246	862	811	479	123563	0	125715
23247	916	580	441	121670	0	123607
23248	739	118622	460	2606	0	122427
23249	664	122185	500	1239	0	124588
23250	120211	2167	444	1174	0	123996
23251	120712	893	434	1090	0	123129
23252	2269	122221	474	851	0	125815
23253	122975	2008	493	1178	0	126654
23254	126144	825	454	1327	0	128750
23255	2682	622	548	127252	0	131104
23256	1361	618	513	131143	0	133635
23257	1082	680	450	132704	0	134916
23258	877	678	132904	2906	0	137365
23259	879	637	130881	1369	0	133766
23260	880	139889	2510	1071	0	144350
23261	140407	2432	992	1410	0	145241
23262	2816	1136	143101	864	0	147917
23263	137958	652	2503	1549	0	142662
23264	3148	648	150424	858	0	155078
23265	145563	586	3022	1337	0	150508
23266	3269	155811	1333	897	0	161310
23267	155587	3012	808	1269	0	160676
23268	3773	1211	678	154407	0	160069
23269	2050	838	609	157063	0	160560
23270	1295	799	155635	3882	0	161611
23271	1044	161404	2769	1728	0	166945
23272	1412	3124	1221	162496	0	168253
23273	1013	1331	162905	3156	0	168405
23274	144662	875	2930	2176	0	150643
23275	2962	160031	1238	1105	0	165336
23276	156579	2773	744	1521	0	161617
23277	3020	154531	683	970	0	159204
23278	1669	3078	587	153453	0	158787
23279	151989	1155	547	3491	0	157182
23280	2842	153695	663	1456	0	158656
23281	1663	2835	496	153761	0	158755
23282	1050	1283	151434	3098	0	156865
23283	139564	839	2591	1814	0	144808
23284	3319	782	950	148240	0	153291
23285	1383	809	147068	3026	0	152286
23286	1039	146905	2617	1561	0	152122
23287	1247	2707	929	147244	0	152127
23288	988	1202	147433	2936	0	152559
23289	1373	944	2674	139167	0	144158
23290	930	146044	1079	2760	0	150813
23291	880	150114	756	1336	0	153086
23292	917	3156	147700	846	0	152619
23293	1326	1302	2540	144384	0	149552
23294	669	897	148070	2973	0	152609
23295	140814	590	2667	1726	0	145797
23296	3111	686	1014	141678	0	146489
23297	1103	139277	638	2515	0	143533
23298	763	145964	572	1039	0	148338
23299	140802	2928	483	1270	0	145483
23300	2380	146632	519	755	0	150286
23301	144851	2515	556	1342	0	149264
23302	2667	1054	144482	576	0	148779
23303	133184	681	2234	1273	0	137372
23304	2480	142415	872	494	0	146261
23305	140696	2495	663	1013	0	144867
23306	2461	139898	510	598	0	143467
23307	1333	2577	456	136911	0	141277
23308	988	1096	385	142261	0	144730
23309	639	750	140848	2889	0	145126
23310	129630	643	2344	1881	0	134498
23311	2514	783	142839	728	0	146864
23312	142214	635	2596	917	0	146362
23313	3184	634	986	142309	0	147113
23314	1550	619	569	142273	0	145011
23315	793	145549	584	3232	0	150158
23316	1113	2759	552	147474	0	151898
23317	1158	1195	461	151099	0	153913
23318	691	810	147971	3572	0	153044
23319	130172	574	2673	2326	0	135745
23320	2635	142371	1155	997	0	147158
23321	140922	2481	605	1266	0	145274
23322	2992	1106	568	140860	0	145526
23323	1571	680	517	142884	0	145652
23324	140018	529	538	3903	0	144988
23325	2762	143402	630	1532	0	148326
23326	137426	2481	442	1385	0	141734
23327	2779	136779	527	718	0	140803
23328	1233	139614	442	596	0	141885
23329	137790	3143	607	1095	0	142635
23330	3159	1270	565	135004	0	139998
23331	1340	888	134878	2713	0	139819
23332	1278	695	2561	130846	0	135380
23333	1131	689	983	130838	0	133641
23334	719	132973	632	3368	0	137692
23335	1014	2845	468	135530	0	139857
23336	961	1341	420	135797	0	138519
23337	977	784	412	138737	0	140910
23338	904	714	449	141568	0	143635
23339	581	838	138802	4154	0	144375
23340	614	801	140315	1902	0	143632
23341	916	785	3516	141975	0	147192
23342	656	717	143570	3708	0	148651
23343	731	690	142952	1716	0	146089
23344	1104	612	3884	142166	0	147766
23345	645	729	147975	3805	0	153154
23346	1286	630	3565	137387	0	142868
23347	558	147743	1549	3542	0	153392
23348	155405	3440	962	2412	0	162219
23349	3764	1392	170876	1392	0	177424
23350	2069	829	4498	168590	0	175986
23351	925	741	175737	4837	0	182240
23352	1421	633	4895	180474	0	187423
23353	1341	654	2065	186448	0	190508
23354	182381	665	1285	7043	0	191374
23355	5394	640	1068	185262	0	192364
23356	174174	618	1057	6387	0	182236
23357	179519	478	987	3387	0	184371
23358	5824	177455	974	1909	0	186162
23359	173031	4471	828	1951	0	180281
23360	5133	168393	814	1519	0	175859
23361	2007	174431	754	1313	0	178505
23362	167333	5486	1100	1646	0	175565
23363	5144	2045	167835	1189	0	176213
23364	2050	1124	163411	1013	0	167598
23365	154540	1128	6107	1342	0	163117
23366	159223	814	2055	1450	0	163542
23367	5287	160392	1129	895	0	167703
23368	162907	4113	872	1324	0	169216
23369	164313	1668	798	1464	0	168243
23370	162678	918	801	1165	0	165562
23371	6477	699	706	157143	0	165025
23372	155189	716	718	4836	0	161459
23373	5122	160271	719	1951	0	168063
23374	3007	4151	635	163994	0	171787
23375	2450	1677	625	164489	0	169241
23376	1676	164956	785	5356	0	172773
23377	1941	4205	748	167250	0	174144
23378	164059	1774	847	5548	0	172228
23379	166268	1104	717	2999	0	171088
23380	5806	160383	755	1941	0	168885
23381	2676	167198	725	1603	0	172202
23382	165373	5084	577	1910	0	172944
23383	5373	2184	162912	1450	0	171919
23384	2942	1343	163255	1364	0	168904
23385	2662	1157	5073	158603	0	167495
23386	2389	1148	2007	165065	0	170609
23387	1893	1275	162070	5495	0	170733
23388	1758	153908	4492	2702	0	162860
23389	2585	4604	2059	147708	0	156956
23390	1696	2230	161040	4803	0	169769
23391	2058	1308	4698	157972	0	166036
23392	2048	1123	2287	157480	0	162938
23393	1615	164392	1587	5692	0	173286
23394	2051	4617	1174	163411	0	171253
23395	2058	2205	1106	166339	0	171708
23396	2013	1420	1110	169280	0	173823
23397	165007	1119	1033	6816	0	173975
23398	5533	1076	1020	160777	0	168406
23399	2663	163705	1022	5604	0	172994
23400	162416	4429	928	3486	0	171259
23401	5293	2148	158284	2364	0	168089
23402	2753	1543	156566	2238	0	163100
23403	155859	1216	5340	2456	0	164871
23404	5597	1368	2370	159901	0	169236
23405	2840	1254	160899	5371	0	170364
23406	2492	1073	4672	158536	0	166773
23407	2321	1168	2313	164995	0	170797
23408	160437	1185	1631	6845	0	170098
23409	160567	1180	1421	3913	0	167081
23410	6258	160792	1365	2627	0	171042
23411	3751	4388	1376	157531	0	167046
23412	2364	2029	158235	5245	0	167873
23413	2006	164517	4471	3195	0	174189
23414	163690	4435	1989	2956	0	173070
23415	5034	170956	1589	2106	0	179685
23416	170813	4839	1272	2396	0	179320
23417	5562	2358	169589	1848	0	179357
23418	166563	1655	4330	2342	0	174890
23419	175508	1422	2074	2214	0	181218
23420	6567	1468	176889	1793	0	186717
23421	3603	1719	4695	168750	0	178767
23422	2649	167968	2122	5006	0	177745
23423	2333	180982	1428	2685	0	187428
23424	2235	183674	1266	2025	0	189200
23425	2855	6145	1084	175760	0	185844
23426	2337	2597	181370	4963	0	191267
23427	2577	1910	4446	178162	0	187095
23428	2480	1604	1935	185403	0	191422
23429	2080	1602	182936	5820	0	192438
23430	1868	180144	4688	5103	0	191803
23431	2154	4675	2034	179682	0	188545
23432	181741	2006	1521	5627	0	190895
23433	5267	1434	1364	181532	0	189597
23434	2850	1200	1190	179257	0	184497
23435	2038	178294	1065	6160	0	187557
23436	178373	4560	910	3485	0	187328
23437	5456	2262	856	183799	0	192373
23438	2521	1663	181489	5022	0	190695
23439	1757	181004	3922	2897	0	189580
23440	176257	4093	1897	2508	0	184755
23441	4336	2149	179496	1647	0	187628
23442	173346	1593	4000	2089	0	181028
23443	4779	1379	1892	175371	0	183421
23444	2155	179341	1483	3935	0	186914
23445	176417	3858	1215	2589	0	184079
23446	175375	1773	1087	2252	0	180487
23447	4712	179975	1248	1479	0	187414
23448	2649	3215	871	171318	0	178053
23449	1352	1121	582	163406	0	166461
23450	158172	755	616	3520	0	163063
23451	2548	159473	697	1516	0	164234
23452	1213	2309	385	150065	0	153972
23453	578	149087	441	1973	0	152079
23454	555	149874	395	858	0	151682
23455	853	2065	394	146860	0	150172
23456	145054	771	339	2304	0	148468
23457	1547	147112	322	791	0	149772
23458	898	1708	241	146744	0	149591
23459	738	675	224	147810	0	149447
23460	541	594	147242	1881	0	150258
23461	559	562	137251	927	0	139299
23462	366	144882	1655	754	0	147657
23463	506	1657	142908	535	0	145606
23464	676	703	1558	141569	0	144506
23465	448	612	145191	1631	0	147882
23466	641	485	1558	147552	0	150236
23467	600	452	562	151541	0	153155
23468	562	437	408	153034	0	154441
23469	149610	427	368	2635	0	153040
23470	1755	430	293	149726	0	152204
23471	815	384	293	149523	0	151015
23472	451	149246	337	2073	0	152107
23473	617	1618	283	146464	0	148982
23474	144663	625	299	2673	0	148260
23475	1455	149113	323	1011	0	151902
23476	148120	1708	267	1478	0	151573
23477	1831	795	149019	690	0	152335
23478	803	668	150957	741	0	153169
23479	986	537	1904	154816	0	158243
23480	700	814	741	159588	0	161843
23481	482	161492	571	2325	0	164870
23482	1165	2078	595	146661	0	150499
23483	159752	717	389	2981	0	163839
23484	158159	631	392	1651	0	160833
23485	2413	601	423	162720	0	166157
23486	883	621	172763	2462	0	176729
23487	1100	499	2079	172404	0	176082
23488	905	535	773	179782	0	181995
23489	792	517	561	182285	0	184155
23490	728	499	516	180711	0	182454
23491	839	521	446	177212	0	179018
23492	413	179473	468	3199	0	183553
23493	175195	2198	442	2195	0	180030
23494	176915	813	410	1968	0	180106
23495	178082	654	354	1892	0	180982
23496	2750	182494	448	1162	0	186854
23497	179453	2388	319	1761	0	183921
23498	2606	181639	413	1117	0	185775
23499	1118	2765	179866	962	0	184711
23500	1421	1049	2226	173749	0	178445
23501	862	820	182655	2861	0	187198
23502	689	184336	2604	1415	0	189044
23503	179927	2786	840	1906	0	185459
23504	2824	1199	186744	1062	0	191829
23505	1280	913	194842	968	0	198003
23506	891	204095	3871	950	0	209807
23507	1318	3507	1745	206172	0	212742
23508	846	1576	223465	3775	0	229662
23509	2058	1202	4220	209066	0	216546
23510	1679	777	1734	241271	0	245461
23511	1575	696	1088	256434	0	259793
23512	259689	621	820	7724	0	268854
23513	258689	556	722	3975	0	263942
23514	7511	608	574	254702	0	263395
23515	253713	377	575	7052	0	261717
23516	6197	511	248952	2907	0	258567
23517	2867	467	244547	2050	0	249931
23518	2020	469	245463	1786	0	249738
23519	1621	513	250609	1590	0	254333
23520	1473	247186	6851	1602	0	257112
23521	3201	4427	3646	240066	0	251340
23522	1602	1694	251687	4842	0	259825
23523	225534	904	5913	3744	0	236095
23524	246055	671	3042	2833	0	252601
23525	6441	244148	2671	4603	0	257863
23526	244526	4589	2421	2038	0	253574
23527	6752	1875	2495	243464	0	254586
23528	2909	1489	252059	5027	0	261484
23529	3450	1129	6210	232576	0	243365
23530	1657	254936	3402	4955	0	264950
23531	244090	5123	2378	3884	0	255475
23532	252802	2238	1897	2998	0	259935
23533	6795	256153	1716	1621	0	266285
23534	257139	5352	1377	2390	0	266258
23535	255586	2553	1290	2545	0	261974
23536	7581	257932	1393	1467	0	268373
23537	5055	5444	1155	244146	0	255800
23538	2854	252692	1237	5078	0	261861
23539	252974	6083	1126	3285	0	263468
23540	7423	3389	1064	250885	0	262761
23541	252222	2325	1083	6329	0	261959
23542	8003	1919	910	250413	0	261245
23543	4223	2174	248005	6084	0	260486
23544	237512	1819	4881	4026	0	248238
23545	7214	1742	247709	2329	0	258994
23546	4996	1783	5594	243229	0	255602
23547	3262	1705	245143	6036	0	256146
23548	3570	1481	5962	241981	0	252994
23549	2826	1496	244770	6673	0	255765
23550	229637	1131	6280	4993	0	242041
23551	6253	241653	3457	3072	0	254435
23552	241262	4964	2620	3217	0	252063
23553	7398	2211	2505	239617	0	251731
23554	235517	1519	2458	7285	0	246779
23555	6763	236089	2547	3599	0	248998
23556	3702	234807	2451	2796	0	243756
23557	2916	246161	2397	2434	0	253908
23558	244298	6934	2108	3262	0	256602
23559	7096	3482	1956	243571	0	256105
23560	4558	2439	1766	248125	0	256888
23561	3164	2436	243696	7556	0	256852
23562	3240	2266	241016	3873	0	250395
23563	3766	2137	6555	243530	0	255988
23564	2921	2335	250104	6439	0	261799
23565	2597	244544	6411	3694	0	257246
23566	238154	6291	3408	3855	0	251708
23567	6716	3342	245070	2472	0	257600
23568	3770	2574	243278	2570	0	252192
23569	3465	2052	8010	237106	0	250633
23570	243166	1697	4458	7557	0	256878
23571	7025	1469	3539	244764	0	256797
23572	243280	1333	3436	8029	0	256078
23573	7518	1484	3188	243869	0	256059
23574	4043	1664	246655	7015	0	259377
23575	3293	239018	7444	3878	0	253633
23576	2995	5709	244467	3135	0	256306
23577	2580	243557	7622	3088	0	256847
23578	3358	6497	4533	236615	0	251003
23579	233507	2781	3122	7541	0	246951
23580	6790	2130	236547	3780	0	249247
23581	4621	1674	6274	230464	0	243033
23582	3926	1632	3559	237286	0	246403
23583	237772	1673	2641	8603	0	250689
23584	6951	1745	2740	231637	0	243073
23585	3659	237470	2734	6693	0	250556
23586	225671	5762	2500	4813	0	238746
23587	6463	3332	225962	2985	0	238742
23588	212030	2464	5822	3666	0	223982
23589	6796	222697	3210	2791	0	235494
23590	4810	6091	2292	210461	0	223654
23591	3392	225641	1947	5779	0	236759
23592	221406	5912	1817	4420	0	233555
23593	6935	3342	223768	2770	0	236815
23594	212200	2712	5223	3798	0	223933
23595	6903	225443	2884	2606	0	237836
23596	4788	5570	1979	225377	0	237714
23597	227958	2976	1983	6674	0	239591
23598	231111	2337	2045	3967	0	239460
23599	8186	2154	1761	229012	0	241113
23600	4974	2240	1696	229483	0	238393
23601	3468	230011	1869	6796	0	242144
23602	3925	6132	1527	227619	0	239203
23603	2982	262119	1866	6397	0	273364
23604	2695	274202	1724	4022	0	282643
23605	3573	9073	1433	241876	0	255955
23606	2298	255130	1319	6267	0	265014
23607	2888	6218	254041	3010	0	266157
23608	3222	2988	248499	2692	0	257401
23609	1944	252802	6693	3006	0	264445
23610	1784	5640	242801	1621	0	251846
23611	1191	2444	237950	1257	0	242842
23612	684	1439	226210	823	0	229156
23613	408	224310	6163	747	0	231628
23614	215825	4704	3573	1554	0	225656
23615	3689	220073	1848	599	0	226209
23616	1477	5063	220788	408	0	227736
23617	2189	2265	4596	212393	0	221443
23618	215215	1615	2016	4798	0	223644
23619	4177	1229	216243	1622	0	223271
23620	2568	974	4942	211400	0	219884
23621	1282	902	218820	4211	0	225215
23622	1706	847	5500	210850	0	218903
23623	210149	875	2539	5733	0	219296
23624	4333	901	217991	2011	0	225236
23625	1751	220423	5287	1588	0	229049
23626	2387	4695	2557	210880	0	220519
23627	223482	2055	1833	5257	0	232627
23628	5010	1653	221835	1820	0	230318
23629	3279	1290	5413	202430	0	212412
23630	1494	218586	2672	4460	0	227212
23631	219904	4796	1949	2752	0	229401
23632	225001	1984	1778	2103	0	230866
23633	7085	1647	1534	219674	0	229940
23634	2995	223530	1532	5413	0	233470
23635	1970	236989	1490	2476	0	242925
23636	239111	6541	1272	2482	0	249406
23637	7131	3133	1243	230851	0	242358
23638	2573	241229	1420	6013	0	251235
23639	240313	6429	972	3199	0	250913
23640	7141	2666	1084	241842	0	252733
23641	3776	1937	1193	245984	0	252890
23642	2056	1715	234065	7743	0	245579
23643	1584	238355	5411	3853	0	249203
23644	1591	254488	2364	2451	0	260894
23645	2341	7399	1717	250583	0	262040
23646	251102	3406	1187	7318	0	263013
23647	6192	254369	1191	3141	0	264893
23648	251502	7105	969	3117	0	262693
23649	7143	254250	1169	1715	0	264277
23650	3917	7421	1081	251902	0	264321
23651	254639	3578	876	7221	0	266314
23652	7752	2816	901	254473	0	265942
23653	3434	2221	256190	7512	0	269357
23654	3456	2028	6084	238759	0	250327
23655	1839	255072	2722	7115	0	266748
23656	250714	7182	1909	3925	0	263730
23657	6680	254228	1505	2631	0	265044
23658	3868	7857	1276	243093	0	256094
23659	3157	3651	1182	252555	0	260545
23660	2096	2895	246170	8260	0	259421
23661	1876	2415	245521	4016	0	253828
23662	2470	2497	7757	240747	0	253471
23663	2292	2413	242309	7328	0	254342
23664	1602	240571	7278	3853	0	253304
23665	238429	7064	3186	3682	0	252361
23666	6535	3550	244642	2679	0	257406
23667	237787	2872	6990	3193	0	250842
23668	249399	2475	3634	2789	0	258297
23669	248776	2427	2718	2680	0	256601
23670	251211	2177	2277	2510	0	258175
23671	9741	2257	2229	243835	0	258062
23672	5395	2037	2179	235983	0	245594
23673	3320	239914	2521	7866	0	253621
23674	237658	6911	2460	4616	0	251645
23675	7556	3734	236587	2943	0	250820
23676	4565	2908	6901	230923	0	245297
23677	3744	2571	3827	235370	0	245512
23678	2720	2423	230838	8507	0	244488
23679	2680	231964	7322	4716	0	246682
23680	3811	6862	4057	215373	0	230103
23681	3305	3475	2836	238323	0	247939
23682	230751	2817	2278	9400	0	245246
23683	7268	229792	2045	5365	0	244470
23684	4756	6886	1820	223729	0	237191
23685	3217	228856	2113	7940	0	242126
23686	3230	7539	1918	232047	0	244734
23687	226057	3845	1763	9073	0	240738
23688	232000	2948	1844	5229	0	242021
23689	9182	2283	1874	229488	0	242827
23690	227043	2173	1608	9093	0	239917
23691	226863	2242	1753	5385	0	236243
23692	9200	224377	1750	3929	0	239256
23693	5982	7121	1346	214010	0	228459
23694	4085	224074	1527	7417	0	237103
23695	4099	7614	1063	222480	0	235256
23696	220357	4061	1167	8573	0	234158
23697	7934	3516	1189	218799	0	231438
23698	4899	2946	1032	222585	0	231462
23699	3720	2937	212858	9299	0	228814
23700	3490	200592	5354	5597	0	215033
23701	3276	214422	2394	4389	0	224481
23702	206377	7077	1851	4519	0	219824
23703	5748	3742	1005	169039	0	179534
23704	160730	2005	853	5396	0	168984
23705	5040	156545	870	3208	0	165663
23706	2802	149621	794	2496	0	155713
23707	2060	156471	789	2133	0	161453
23708	139671	4355	2455	2125	0	148606
23709	3368	142697	743	1469	0	148277
23710	140800	3195	1495	2123	0	147613
23711	138615	1374	638	1828	0	142455
23712	143873	1093	529	1576	0	147071
23713	4199	1081	501	151539	0	157320
23714	2181	1025	513	155268	0	158987
23715	1716	893	506	157033	0	160148
23716	1732	852	504	155775	0	158863
23717	153150	778	443	5386	0	159757
23718	3991	151655	524	2241	0	158411
23719	2166	3305	439	151752	0	157662
23720	151095	1338	399	4526	0	157358
23721	4126	906	442	149410	0	154884
23722	2186	788	391	150546	0	153911
23723	146786	712	418	5299	0	153215
23724	3869	828	143229	2182	0	150108
23725	2182	749	2750	140724	0	146405
23726	1295	747	142595	3832	0	148469
23727	1418	604	2946	137738	0	142706
23728	1411	932	1051	138850	0	142244
23729	133492	500	605	4848	0	139445
23730	3227	130146	485	2194	0	136052
23731	1496	129178	385	1319	0	132378
23732	122846	2734	345	1529	0	127454
23733	2564	125256	333	936	0	129089
23734	124325	2311	526	1624	0	128786
23735	2831	871	123482	927	0	128111
23736	112410	392	1678	1135	0	115615
23737	117388	238	517	967	0	119110
23738	118431	231	290	879	0	119831
23739	2485	221	213	115617	0	118536
23740	1143	244	218	115091	0	116696
23741	515	115235	204	2202	0	118156
23742	722	2056	144	113117	0	116039
23743	110421	567	140	2360	0	113488
23744	1709	108449	150	796	0	111104
23745	614	109462	138	463	0	110677
23746	106771	1763	61	779	0	109374
23747	1707	672	107358	277	0	110014
23748	1016	343	1420	104708	0	107487
23749	452	307	108001	1595	0	110355
23750	733	226	1468	103744	0	106171
23751	429	106510	467	1411	0	108817
23752	626	1507	180	108828	0	111141
23753	106263	470	134	2076	0	108943
23754	1813	298	128	106726	0	108965
23755	603	360	109748	1821	0	112532
23756	99046	201	1687	1445	0	102379
23757	1929	108320	594	533	0	111376
23758	758	116338	288	393	0	117777
23759	119060	2355	180	924	0	122519
23760	125530	810	177	900	0	127417
23761	3111	502	125296	367	0	129276
23762	119714	293	2407	956	0	123370
23763	2776	126095	851	482	0	130204
23764	127138	2522	331	889	0	130880
23765	3300	940	241	120179	0	124660
23766	1260	116247	230	2352	0	120089
23767	117415	2594	205	1330	0	121544
23768	3098	986	116281	570	0	120935
23769	1751	525	2430	116664	0	121370
23770	119411	555	766	3172	0	123904
23771	3224	579	119070	1085	0	123958
23772	118537	502	2555	1146	0	122740
23773	3589	499	839	117719	0	122646
23774	1966	393	496	121508	0	124363
23775	1004	463	122142	3513	0	127122
23776	1243	343	2759	120474	0	124819
23777	121873	347	970	3957	0	127147
23778	3036	120762	711	1576	0	126085
23779	121861	2709	428	1539	0	126537
23780	123412	1032	370	1419	0	126233
23781	4187	601	338	121679	0	126805
23782	1623	639	123256	3337	0	128855
23783	1416	382	2818	122711	0	127327
23784	123691	368	1037	3996	0	129092
23785	3323	122883	714	1634	0	128554
23786	126090	2801	465	1447	0	130803
23787	4031	1054	346	124724	0	130155
23788	2092	588	430	127868	0	130978
23789	1419	452	587	129825	0	132283
23790	997	460	126366	4475	0	132298
23791	1449	457	2975	126166	0	131047
23792	1080	715	126796	3726	0	132317
23793	1211	628	128120	1606	0	131565
23794	1511	523	3755	142642	0	148431
23795	937	572	145554	4476	0	151539
23796	149342	432	4284	2754	0	156812
23797	5191	428	1824	155266	0	162709
23798	2974	449	1206	152335	0	156964
23799	1519	157298	1032	5723	0	165572
23800	157594	4429	877	3209	0	166109
23801	162353	1823	721	2421	0	167318
23802	6375	163010	767	1541	0	171693
23803	3623	4609	655	161261	0	170148
23804	1939	2023	163022	5095	0	172079
23805	155736	1218	4662	3300	0	164916
23806	166604	800	2045	2348	0	171797
23807	7249	859	1316	158829	0	168253
23808	3345	876	154694	5170	0	164085
23809	2165	152957	4713	2517	0	162352
23810	149708	4718	2021	2190	0	158637
23811	5647	2160	150786	1495	0	160088
23812	2679	147102	4687	1576	0	156044
23813	136925	4053	2484	1457	0	144919
23814	138175	1674	1336	1311	0	142496
23815	6251	1170	832	132695	0	140948
23816	3051	134104	823	4037	0	142015
23817	2513	4124	767	141562	0	148966
23818	1893	1916	951	144771	0	149531
23819	2122	1310	829	139904	0	144165
23820	1936	895	729	146650	0	150210
23821	1431	839	142468	6476	0	151214
23822	1916	731	4180	143297	0	150124
23823	1826	936	1796	146744	0	151302
23824	1427	842	143157	6151	0	151577
23825	1086	143443	4326	3590	0	152445
23826	142350	4328	1931	2998	0	151607
23827	145994	1907	1308	2516	0	151725
23828	6257	1216	918	145853	0	154244
23829	147143	745	919	6055	0	154862
23830	5870	874	924	151490	0	159158
23831	2715	820	151226	6424	0	161185
23832	2133	820	149531	3619	0	156103
23833	1440	150837	5844	2901	0	161022
23834	147676	4567	2734	2637	0	157614
23835	5588	2208	157706	2015	0	167517
23836	3819	1339	5309	149309	0	159776
23837	3026	851	2776	159627	0	166280
23838	2345	890	2038	165286	0	170559
23839	2207	907	1419	164997	0	169530
23840	2388	914	1424	164125	0	168851
23841	1909	1106	158604	9084	0	170703
23842	2344	988	5548	160223	0	169103
23843	156532	1041	2855	8081	0	168509
23844	5968	156175	1991	4695	0	168829
23845	155235	5265	1632	3892	0	166024
23846	6459	157798	1682	3012	0	168951
23847	157909	6103	1345	3223	0	168580
23848	162992	2829	1280	3188	0	170289
23849	8582	1727	1503	157470	0	169282
23850	4872	1255	1346	162504	0	169977
23851	157645	1269	1269	9034	0	169217
23852	153026	1327	1289	5580	0	161222
23853	157058	1383	1249	3956	0	163646
23854	8586	147712	1228	3086	0	160612
23855	4539	152504	1264	2731	0	161038
23856	3256	6258	149113	2811	0	161438
23857	3276	3582	4986	146816	0	158660
23858	2401	1952	144764	6792	0	155909
23859	2180	139762	5356	4562	0	151860
23860	2245	4683	2582	132939	0	142449
23861	2379	2433	1516	135676	0	142004
23862	2507	1584	1116	139559	0	144766
23863	134014	1289	1054	7993	0	144350
23864	135051	1271	1112	4929	0	142363
23865	6643	134614	1236	3314	0	145807
23866	4244	4513	1265	135195	0	145217
23867	2773	2575	135584	5778	0	146710
23868	2314	2115	132043	3648	0	140120
23869	132895	1656	5864	3110	0	143525
23870	137611	1270	3253	2928	0	145062
23871	6989	1036	1933	136037	0	145995
23872	137182	1006	1789	6524	0	146501
23873	6179	1270	134555	4059	0	146063
23874	3648	133216	4933	3340	0	145137
23875	3045	4656	2835	133246	0	143782
23876	2167	2630	137932	6118	0	148847
23877	2524	1680	5196	138974	0	148374
23878	2650	1206	3060	142754	0	149670
23879	2158	1328	141688	8128	0	153302
23880	135962	1149	4735	5951	0	147797
23881	144340	1101	2908	4619	0	152968
23882	6697	150180	2273	3674	0	162824
23883	153987	5013	1635	3644	0	164279
23884	158669	2663	1562	3400	0	166294
23885	8258	1848	152585	3180	0	165871
23886	151806	1376	5124	3485	0	161791
23887	7290	161264	2973	2866	0	174393
23888	162546	5611	1868	2869	0	172894
23889	167651	2875	1512	2790	0	174828
23890	171174	2067	1496	2631	0	177368
23891	160338	1734	1326	3058	0	166456
23892	168556	1490	1268	3021	0	174335
23893	9478	161562	1487	2450	0	174977
23894	146758	4362	1067	2059	0	154246
23895	6323	143147	1094	1827	0	152391
23896	2989	129112	825	1412	0	134338
23897	2197	137431	881	1332	0	141841
23898	134242	4843	1900	1635	0	142620
23899	135161	2078	922	1587	0	139748
23900	5766	1300	129171	1160	0	137397
23901	135778	1148	3274	1404	0	141604
23902	137401	937	1555	1573	0	141466
23903	5923	1034	139055	1288	0	147300
23904	3434	844	4025	137002	0	145305
23905	3085	879	2070	132405	0	138439
23906	2283	917	1011	145978	0	150189
23907	2384	815	775	145244	0	149218
23908	2318	754	770	146529	0	150371
23909	1861	874	141229	5876	0	149840
23910	1778	140368	3990	2765	0	148901
23911	137085	3969	1865	1875	0	144794
23912	4756	139445	1099	1549	0	146849
23913	139959	4180	952	1509	0	146600
23914	140599	1977	926	1559	0	145061
23915	6268	1225	136049	1187	0	144729
23916	3656	1232	3822	124055	0	132765
23917	2152	131453	2054	3752	0	139411
23918	133650	3845	1157	2269	0	140921
23919	133704	1946	909	1827	0	138386
23920	136165	1147	875	1501	0	139688
23921	6254	136550	832	1095	0	144731
23922	139324	3764	899	1368	0	145355
23923	141640	2008	775	1234	0	145657
23924	142552	1407	620	1071	0	145650
23925	6958	1114	670	136235	0	144977
23926	4126	957	689	138585	0	144357
23927	3311	960	545	140700	0	145516
23928	137013	1072	564	5132	0	143781
23929	5332	136842	614	2178	0	144966
23930	135534	3570	453	1398	0	140955
23931	133681	1837	537	1057	0	137112
23932	128926	1238	463	1022	0	131649
23933	129685	1104	384	984	0	132157
23934	5920	125258	437	711	0	132326
23935	116127	2881	283	811	0	120102
23936	4390	111910	304	584	0	117188
23937	2324	114422	361	470	0	117577
23938	115639	3125	366	822	0	119952
23939	3760	112225	238	516	0	116739
23940	2210	117152	335	514	0	120211
23941	117009	3136	562	900	0	121607
23942	118342	1538	227	843	0	120950
23943	4159	1099	232	114251	0	119741
23944	2525	906	226	117625	0	121282
23945	119501	886	253	3782	0	124422
23946	124767	854	408	1866	0	127895
23947	121819	949	337	1468	0	124573
23948	4083	918	120638	651	0	126290
23949	127105	930	2203	1082	0	131320
23950	4133	828	866	128912	0	134739
23951	2665	686	532	130472	0	134355
23952	2022	651	585	131948	0	135206
23953	1851	661	384	132089	0	134985
23954	1626	787	126548	3774	0	132735
23955	1684	729	127793	1776	0	131982
23956	1854	684	2862	129060	0	134460
23957	1671	756	129225	3215	0	134867
23958	1715	869	126916	1757	0	131257
23959	2176	689	3155	126309	0	132329
23960	2118	613	1365	130780	0	134876
23961	1850	674	945	136550	0	140019
23962	1965	789	726	129977	0	133457
23963	134917	721	621	4744	0	141003
23964	140258	685	683	2814	0	144440
23965	4724	664	625	138181	0	144194
23966	2779	814	593	139355	0	143541
23967	2217	711	579	140030	0	143537
23968	2197	594	564	139447	0	142802
23969	2219	694	554	138192	0	141659
23970	2039	136878	620	4381	0	143918
23971	136430	2842	544	2799	0	142615
23972	3827	137097	475	2025	0	143424
23973	136720	3084	356	2144	0	142304
23974	137662	1518	326	1973	0	141479
23975	138222	940	295	1839	0	141296
23976	4983	910	341	131520	0	137754
23977	131406	920	298	3614	0	136238
23978	4395	871	270	129158	0	134694
23979	3074	928	253	127587	0	131842
23980	127126	819	212	4189	0	132346
23981	3929	122784	246	2089	0	129048
23982	2001	118695	181	1249	0	122126
23983	115892	2175	159	1363	0	119589
23984	2956	1043	114571	815	0	119385
23985	105464	735	1636	1249	0	109084
23986	3110	913	633	112089	0	116745
23987	1748	104949	280	1926	0	108903
23988	1341	107815	184	1075	0	110415
23989	108680	1884	303	1360	0	112227
23990	2364	990	99	110616	0	114069
23991	1295	115538	144	1617	0	118594
23992	114831	1447	235	1445	0	117958
23993	115033	710	98	1156	0	116997
23994	115583	545	84	1081	0	117293
23995	116368	512	77	1130	0	118087
23996	2313	112747	140	629	0	115829
23997	1046	114194	113	423	0	115776
23998	115764	1373	105	777	0	118019
23999	121094	619	136	860	0	122709
24000	2212	440	120309	332	0	123293
24001	657	118883	1227	204	0	120971
24002	120114	1389	406	611	0	122520
24003	123634	401	150	591	0	124776
24004	2190	329	123614	183	0	126316
24005	115991	174	1736	809	0	118710
24006	2429	216	127385	151	0	130181
24007	661	219	132115	107	0	133102
24008	1082	251	2465	119152	0	122950
24009	372	123172	803	1840	0	126187
24010	134713	2191	413	1024	0	138341
24011	2826	528	208	134198	0	137760
24012	1208	348	174	136199	0	137929
24013	958	229	186	138698	0	140071
24014	136738	159	207	3563	0	140667
24015	2935	173	202	136675	0	139985
24016	1231	153	164	141840	0	143388
24017	660	252	140992	3055	0	144959
24018	132390	172	2564	1927	0	137053
24019	141313	182	655	1280	0	143430
24020	3467	230	142090	554	0	146341
24021	134456	142	2771	917	0	138286
24022	3738	195	722	134247	0	138902
24023	1137	137051	576	2752	0	141516
24024	1251	2615	391	137861	0	142118
24025	136332	619	339	3692	0	140982
24026	2948	137652	325	1240	0	142165
24027	1515	2950	253	138137	0	142855
24028	1351	790	271	143041	0	145453
24029	1252	447	225	143754	0	145678
24030	1244	348	274	137435	0	139301
24031	626	147077	361	3766	0	151830
24032	146834	3238	240	2007	0	152319
24033	149465	995	271	1726	0	152457
24034	4332	153226	350	1017	0	158925
24035	164064	3702	257	1393	0	169416
24036	170173	1165	252	1325	0	172915
24037	168642	760	247	1332	0	170981
24038	6271	636	162256	756	0	169919
24039	3445	455	4060	160055	0	168015
24040	1852	567	156455	4594	0	163468
24041	156005	458	4120	2487	0	163070
24042	5058	161860	1567	1319	0	169804
24043	158966	4303	921	1696	0	165886
24044	5514	163013	722	862	0	170111
24045	3368	4893	643	153163	0	162067
24046	2707	1808	627	157979	0	163121
24047	1732	1224	156822	5638	0	165416
24048	1405	158811	4682	2518	0	167416
24049	154216	4967	1749	2117	0	163049
24050	5706	2041	154594	1227	0	163568
24051	153450	1429	4830	1384	0	161093
24052	6596	1178	1969	153935	0	163678
24053	2854	1037	155491	5361	0	164743
24054	2009	154413	5167	2577	0	164166
24055	2512	4895	2051	151770	0	161228
24056	1743	2188	154798	5289	0	164018
24057	1752	1521	154463	2354	0	160090
24058	1639	153052	5980	1829	0	162500
24059	2373	4961	2604	148156	0	158094
24060	2298	1999	1790	146340	0	152427
24061	1606	148455	1490	5832	0	157383
24062	149408	5267	1251	3260	0	159186
24063	6180	2228	1341	145306	0	155055
24064	2700	146314	1441	5473	0	155928
24065	147304	5187	1400	3221	0	157112
24066	146810	2263	1355	2642	0	153070
24067	149831	1801	1309	2306	0	155247
24068	7211	147586	1219	1900	0	157916
24069	150473	5353	1053	2389	0	159268
24070	152494	2389	1148	2242	0	158273
24071	7853	1920	1022	147477	0	158272
24072	150544	1713	924	6328	0	159509
24073	7472	1582	834	150565	0	160453
24074	3816	1488	146340	6595	0	158239
24075	3116	1418	151043	3314	0	158891
24076	3076	1348	6173	151475	0	162072
24077	2497	1340	153786	6464	0	164087
24078	148396	1392	5988	3684	0	159460
24079	7293	1237	2518	153758	0	164806
24080	4168	1129	1753	157777	0	164827
24081	2951	1276	152971	7712	0	164910
24082	2589	146310	5822	3868	0	158589
24083	2427	156201	2722	2856	0	164206
24084	2742	6486	1939	150341	0	161508
24085	2717	2831	1560	156359	0	163467
24086	2403	2048	151081	7539	0	163071
24087	2260	1745	153862	3927	0	161794
24088	2648	1486	6794	153489	0	164417
24089	2065	1586	152357	7027	0	163035
24090	148901	1589	6526	3864	0	160880
24091	7198	1589	2930	149748	0	161465
24092	150557	1493	2032	7506	0	161588
24093	7621	1492	1766	149435	0	160314
24094	4030	1331	1730	153624	0	160715
24095	2919	1319	147467	8362	0	160067
24096	2476	148823	6379	4292	0	161970
24097	2977	5848	2892	147546	0	159263
24098	2230	2400	147731	7179	0	159540
24099	2055	141200	5807	3596	0	152658
24100	2658	5098	2906	142560	0	153222
24101	141246	2193	2190	6794	0	152423
24102	5717	1604	141061	3524	0	151906
24103	129900	1179	5475	3011	0	139565
24104	5853	1125	131625	2196	0	140799
24105	121026	985	5401	2360	0	129772
24106	5205	123718	2897	1983	0	133803
24107	2340	124451	2018	1817	0	130626
24108	2336	5739	1682	114857	0	124614
24109	1499	117694	1549	4399	0	125141
24110	117899	4479	1387	3006	0	126771
24111	4705	2112	1436	118668	0	126921
24112	2575	1546	1298	121179	0	126598
24113	1942	1309	1143	123294	0	127688
24114	1325	1358	117801	6071	0	126555
24115	1715	1220	4147	117170	0	124252
24116	1249	1163	115743	5370	0	123525
24117	1326	112473	4553	2944	0	121296
24118	106768	3595	2206	2367	0	114936
24119	4035	111604	1572	1949	0	119160
24120	113379	3828	1307	2301	0	120815
24121	114955	1878	1209	2121	0	120163
24122	115970	1320	1160	2068	0	120518
24123	115107	1145	1239	1860	0	119351
24124	5390	1209	111048	1507	0	119154
24125	3004	1160	3811	108983	0	116958
24126	2445	1204	1957	106826	0	112432
24127	2081	1103	1370	113610	0	118164
24128	97558	1031	1284	5670	0	105543
24129	99458	858	1129	3418	0	104863
24130	4688	105108	1141	2250	0	113187
24131	2377	2762	99542	1597	0	106278
24132	1884	1230	97819	1526	0	102459
24133	1471	95636	3717	1605	0	102429
24134	1318	97254	1900	1695	0	102167
24135	2643	2679	2372	81396	0	89090
24136	1179	983	718	78486	0	81366
24137	81543	725	552	2699	0	85519
24138	2168	81543	653	1328	0	85692
24139	1240	1978	663	83558	0	87439
24140	908	872	85900	2440	0	90120
24141	980	694	2110	87598	0	91382
24142	929	540	961	90166	0	92596
24143	912	447	766	91586	0	93711
24144	1015	486	690	91073	0	93264
24145	794	549	88116	3079	0	92538
24146	729	83766	2162	1514	0	88171
24147	645	85276	968	1104	0	87993
24148	80924	2064	730	941	0	84659
24149	1906	81415	615	816	0	84752
24150	923	85549	523	864	0	87859
24151	979	2232	543	84414	0	88168
24152	930	962	464	85465	0	87821
24153	837	744	521	85704	0	87806
24154	699	653	84190	2744	0	88286
24155	653	83711	1807	1530	0	87701
24156	793	2022	721	80433	0	83969
24157	513	84412	653	2194	0	87772
24158	83242	1960	583	1529	0	87314
24159	1723	84484	586	1205	0	87998
24160	83825	2006	572	1179	0	87582
24161	1983	987	83433	939	0	87342
24162	82230	857	1842	1002	0	85931
24163	2191	793	769	84809	0	88562
24164	1086	789	85468	1962	0	89305
24165	82460	781	1771	1159	0	86171
24166	85517	748	737	1060	0	88062
24167	86512	650	617	990	0	88769
24168	2569	641	514	85380	0	89104
24169	1177	641	84423	2145	0	88386
24170	82728	551	1754	1494	0	86527
24171	2208	551	747	86270	0	89776
24172	1228	463	617	86312	0	88620
24173	934	589	87915	2233	0	91671
24174	755	86964	1617	1154	0	90490
24175	953	1772	666	82726	0	86117
24176	611	86339	635	1722	0	89307
24177	83983	1665	522	1052	0	87222
24178	84462	682	431	996	0	86571
24179	2026	578	437	83782	0	86823
24180	83329	416	432	1958	0	86135
24181	1804	83508	434	903	0	86649
24182	82548	1474	318	952	0	85292
24183	1839	84048	356	740	0	86983
24184	1187	1570	365	83624	0	86746
24185	1026	675	322	82374	0	84397
24186	739	84095	379	1743	0	86956
24187	825	1546	365	83323	0	86059
24188	627	634	83150	1839	0	86250
24189	502	79936	1220	812	0	82470
24190	74609	1058	343	701	0	76711
24191	1059	76031	296	461	0	77847
24192	602	1071	216	76030	0	77919
24193	439	474	76331	1098	0	78342
24194	505	430	947	75776	0	77658
24195	457	324	307	77430	0	78518
24196	74792	266	281	1662	0	77001
24197	1168	295	75913	666	0	78042
24198	491	75668	1009	641	0	77809
24199	334	1149	78432	485	0	80400
24200	223	372	74265	368	0	75228
24201	276	286	74947	291	0	75800
24202	625	636	1224	71919	0	74404
24203	75582	151	489	1324	0	77546
24204	991	76213	300	402	0	77906
24205	76914	1089	193	536	0	78732
24206	78565	351	198	504	0	79618
24207	1404	257	187	76710	0	78558
24208	414	78066	179	1107	0	79766
24209	77295	1094	130	692	0	79211
24210	1116	78637	147	420	0	80320
24211	606	1225	145	75698	0	77674
24212	487	423	158	80212	0	81280
24213	258	81602	176	1379	0	83415
24214	353	1175	153	81939	0	83620
24215	261	495	80215	1221	0	82192
24216	267	385	78932	457	0	80041
24217	405	280	1264	80575	0	82524
24218	339	231	431	82521	0	83522
24219	230	270	79603	1422	0	81525
24220	224	273	76664	587	0	77748
24221	69276	194	1351	836	0	71657
24222	1180	75932	521	345	0	77978
24223	430	81477	379	405	0	82691
24224	555	1355	249	78056	0	80215
24225	403	469	231	79361	0	80464
24226	421	319	252	80469	0	81461
24227	317	287	79593	1483	0	81680
24228	290	299	77576	587	0	78752
24229	422	264	1352	79848	0	81886
24230	220	259	80637	1349	0	82465
24231	206	79456	1384	671	0	81717
24232	77650	1255	566	760	0	80231
24233	1311	457	78807	383	0	80958
24234	475	324	77721	324	0	78844
24235	559	305	1525	78317	0	80706
24236	316	292	86117	1455	0	88180
24237	253	87280	1606	651	0	89790
24238	611	1528	596	85403	0	88138
24239	290	528	87578	1518	0	89914
24240	185	84821	1604	656	0	87266
24241	82425	1512	719	705	0	85361
24242	1560	601	486	82197	0	84844
24243	654	399	395	83279	0	84727
24244	82715	309	327	2085	0	85436
24245	1405	83151	316	850	0	85722
24246	83117	1481	305	801	0	85704
24247	83672	569	297	751	0	85289
24248	83670	386	306	688	0	85050
24249	2166	306	270	81964	0	84706
24250	79612	304	304	1823	0	82043
24251	1782	75224	339	705	0	78050
24252	844	77890	284	554	0	79572
24253	80676	1708	332	649	0	83365
24254	1920	730	292	81727	0	84669
24255	1040	538	220	82374	0	84172
24256	770	420	247	83412	0	84849
24257	482	436	80165	2223	0	83306
24258	473	80422	1518	1049	0	83462
24259	626	1654	581	81551	0	84412
24260	81363	678	423	2136	0	84600
24261	1861	432	332	81599	0	84224
24262	739	399	81150	2058	0	84346
24263	572	81222	1637	1005	0	84436
24264	81201	1658	700	1042	0	84601
24265	80997	725	548	849	0	83119
24266	81550	592	470	868	0	83480
24267	2485	486	412	81696	0	85079
24268	1098	479	81484	1966	0	85027
24269	835	463	82234	997	0	84529
24270	709	87026	2222	766	0	90723
24271	995	2209	872	85639	0	89715
24272	830	809	534	89564	0	91737
24273	84340	583	383	3139	0	88445
24274	2491	455	386	86398	0	89730
24275	87606	475	398	3032	0	91511
24276	2758	440	86107	1285	0	90590
24277	1233	489	87733	1001	0	90456
24278	1254	394	2709	86189	0	90546
24279	1036	322	1117	89503	0	91978
24280	979	349	738	93246	0	95312
24281	95197	377	623	3715	0	99912
24282	100653	387	638	1767	0	103445
24283	3904	362	681	100027	0	104974
24284	1477	390	98438	3650	0	103955
24285	951	331	99552	1868	0	102702
24286	1077	294	3791	99461	0	104623
24287	100438	315	1513	4056	0	106322
24288	3684	330	982	99002	0	103998
24289	1823	333	823	102100	0	105079
24290	1022	334	100325	4414	0	106095
24291	804	324	100296	2155	0	103579
24292	94989	288	4061	1859	0	101197
24293	3586	337	99933	1388	0	105244
24294	1989	277	3537	95285	0	101088
24295	1620	261	1596	98688	0	102165
24296	97177	223	1203	4383	0	102986
24297	3415	95768	1138	2148	0	102469
24298	94450	2764	1124	1715	0	100053
24299	3464	92364	904	1300	0	98032
24300	91104	2881	739	1548	0	96272
24301	3645	1090	89711	1248	0	95694
24302	83503	732	3179	1502	0	88916
24303	87527	478	1386	1228	0	90619
24304	4134	611	1142	86327	0	92214
24305	2049	472	86948	3057	0	92526
24306	1768	457	3158	82524	0	87907
24307	1528	424	1485	84382	0	87819
24308	1122	83940	1102	4001	0	90165
24309	1482	2606	813	81726	0	86627
24310	1251	84027	799	3443	0	89520
24311	1443	2911	677	84872	0	89903
24312	83207	1201	729	4010	0	89147
24313	3661	891	709	83679	0	88940
24314	1934	680	82954	3786	0	89354
24315	80918	639	2995	2233	0	86785
24316	3746	523	84774	1792	0	90835
24317	83272	474	3345	1761	0	88852
24318	85920	461	1586	1805	0	89772
24319	4291	83609	1298	1534	0	90732
24320	2204	90028	1052	1496	0	94780
24321	88480	3595	996	1691	0	94762
24322	91698	1569	947	1624	0	95838
24323	90556	909	896	1656	0	94017
24324	90734	728	855	1698	0	94015
24325	91343	640	794	1672	0	94449
24326	5256	710	839	87628	0	94433
24327	2898	720	916	90908	0	95442
24328	2195	684	88633	4325	0	95837
24329	87001	547	3213	2397	0	93158
24330	4662	566	1579	87330	0	94137
24331	2849	643	1171	89734	0	94397
24332	2320	680	87589	4439	0	95028
24333	2038	82368	3334	2548	0	90288
24334	2033	88343	1730	2042	0	94148
24335	85963	3352	1566	1982	0	92863
24336	80757	1247	1008	1423	0	84435
24337	4261	75177	844	1451	0	81733
24338	2309	77950	798	1334	0	82391
24339	77696	2969	1047	1472	0	83184
24340	82396	1246	864	1645	0	86151
24341	4187	896	855	80145	0	86083
24342	2483	621	834	82008	0	85946
24343	2075	595	728	85070	0	88468
24344	81873	665	717	4525	0	87780
24345	84071	746	715	2429	0	87961
24346	4538	809	691	84378	0	90416
24347	86969	800	708	3762	0	92239
24348	4413	858	86384	1924	0	93579
24349	2847	666	3019	86826	0	93358
24350	2136	747	86824	3733	0	93440
24351	1890	85454	3344	1983	0	92671
24352	2126	3074	1667	85746	0	92613
24353	85860	1193	1144	3848	0	92045
24354	4241	797	852	85236	0	91126
24355	2486	678	791	86797	0	90752
24356	1813	644	84484	4605	0	91546
24357	1730	713	84932	2469	0	89844
24358	1718	87620	3401	1834	0	94573
24359	88742	3041	1454	1752	0	94989
24360	90957	1302	992	1614	0	94865
24361	91395	898	844	1557	0	94694
24362	92220	710	779	1653	0	95362
24363	5145	554	877	89080	0	95656
24364	2945	613	893	88638	0	93089
24365	2077	90039	833	3955	0	96904
24366	90922	2904	761	2253	0	96840
24367	91478	1264	708	1772	0	95222
24368	4612	906	87238	1279	0	94035
24369	78723	664	2472	1131	0	82990
24370	3621	81951	1136	901	0	87609
24371	2336	3115	690	77522	0	83663
24372	1820	82119	507	2546	0	86992
24373	81864	2614	499	1602	0	86579
24374	3402	82459	445	1101	0	87407
24375	2100	2399	411	80325	0	85235
24376	1597	983	384	82088	0	85052
24377	1397	705	413	79950	0	82465
24378	1160	78264	457	3368	0	83249
24379	1399	2823	421	77683	0	82326
24380	1642	1509	443	75825	0	79419
24381	853	67905	321	2544	0	71623
24382	642	67413	245	1106	0	69406
24383	63974	1691	226	934	0	66825
24384	1625	65157	203	676	0	67661
24385	63050	1529	212	748	0	65539
24386	1714	755	63139	485	0	66093
24387	816	63215	1158	504	0	65693
24388	62931	1407	469	682	0	65489
24389	62636	660	293	730	0	64319
24390	1826	518	61914	503	0	64761
24391	1090	401	1140	60757	0	63388
24392	695	378	62968	1471	0	65512
24393	554	61953	1361	808	0	64676
24394	60821	1404	572	776	0	63573
24395	1481	61299	385	509	0	63674
24396	890	1469	237	61125	0	63721
24397	763	634	269	62778	0	64444
24398	564	498	62262	1685	0	65009
24399	563	389	59392	868	0	61212
24400	57358	381	1594	846	0	60179
24401	61536	347	653	655	0	63191
24402	61671	389	391	635	0	63086
24403	61557	341	269	673	0	62840
24404	1973	61306	307	528	0	64114
24405	1095	1361	312	60363	0	63131
24406	877	636	328	60380	0	62221
24407	626	62142	285	1626	0	64679
24408	62663	1448	226	1035	0	65372
24409	63299	589	236	824	0	64948
24410	2038	485	62406	474	0	65403
24411	61691	374	1340	634	0	64039
24412	1979	347	559	62222	0	65107
24413	961	385	61867	1567	0	64780
24414	1009	514	1393	60313	0	63229
24415	760	378	61720	1626	0	64484
24416	651	328	60008	734	0	61721
24417	733	650	1620	56553	0	59556
24418	473	58539	776	1225	0	61013
24419	58204	1243	454	908	0	60809
24420	56231	589	350	697	0	57867
24421	1643	57646	267	469	0	60025
24422	827	59153	306	419	0	60705
24423	59695	1412	321	684	0	62112
24424	60522	647	289	625	0	62083
24425	60888	476	266	559	0	62189
24426	60993	364	238	512	0	62107
24427	1995	342	218	61146	0	63701
24428	944	351	60639	1290	0	63224
24429	695	60224	1159	591	0	62669
24430	59121	1257	467	649	0	61494
24431	1455	60464	303	388	0	62610
24432	60505	1359	224	535	0	62623
24433	60748	582	213	494	0	62037
24434	1758	456	60450	278	0	62942
24435	849	62010	1191	280	0	64330
24436	802	1375	462	61214	0	63853
24437	706	585	307	63167	0	64765
24438	657	473	240	60361	0	61731
24439	61664	335	174	1829	0	64002
24440	58398	333	189	906	0	59826
24441	58812	311	209	702	0	60034
24442	1674	58494	199	408	0	60775
24443	56122	1071	134	557	0	57884
24444	1337	56848	145	441	0	58771
24445	622	1182	55745	368	0	57917
24446	465	55145	887	282	0	56779
24447	725	1167	658	51143	0	53693
24448	364	291	183	50989	0	51827
24449	254	282	50892	851	0	52279
24450	430	179	717	48941	0	50267
24451	346	196	290	50625	0	51457
24452	50525	190	201	1100	0	52016
24453	49256	203	134	612	0	50205
24454	50469	142	137	524	0	51272
24455	1018	50865	166	270	0	52319
24456	49515	736	157	416	0	50824
24457	47498	265	116	424	0	48303
24458	985	48414	144	253	0	49796
24459	613	730	112	47694	0	49149
24460	517	307	128	48130	0	49082
24461	47315	214	104	1087	0	48720
24462	886	221	46836	366	0	48309
24463	391	45007	665	232	0	46295
24464	413	888	182	42063	0	43546
24465	230	41839	134	680	0	42883
24466	256	43068	124	325	0	43773
24467	42986	694	182	450	0	44312
24468	43127	271	126	315	0	43839
24469	934	204	123	43226	0	44487
24470	455	201	93	42297	0	43046
24471	345	174	85	42659	0	43263
24472	315	230	83	42327	0	42955
24473	281	216	41136	880	0	42513
24474	344	180	38377	339	0	39240
24475	404	134	693	40512	0	41743
24476	242	210	43288	805	0	44545
24477	225	44340	718	425	0	45708
24478	44720	754	220	459	0	46153
24479	45213	288	205	393	0	46099
24480	1055	192	186	45502	0	46935
24481	524	170	170	45716	0	46580
24482	420	151	142	46371	0	47084
24483	240	47326	163	1033	0	48762
24484	47216	897	98	617	0	48828
24485	48105	300	75	515	0	48995
24486	1244	222	47756	263	0	49485
24487	648	173	867	51730	0	53418
24488	353	199	53493	1419	0	55464
24489	491	205	1271	57596	0	59563
24490	523	224	304	58268	0	59319
24491	618	191	244	58052	0	59105
24492	486	187	183	60574	0	61430
24493	59423	172	220	2338	0	62153
24494	61026	207	182	1078	0	62493
24495	62518	192	165	747	0	63622
24496	2484	214	124	61562	0	64384
24497	895	164	60450	1836	0	63345
24498	58293	168	1551	920	0	60932
24499	2000	152	517	60504	0	63173
24500	60684	184	314	1938	0	63120
24501	2059	142	191	60341	0	62733
24502	710	58302	217	2012	0	61241
24503	522	63125	226	907	0	64780
24504	713	1776	209	62614	0	65312
24505	709	548	165	62967	0	64389
24506	659	314	106	62870	0	63949
24507	406	61461	134	2208	0	64209
24508	60417	1537	113	1062	0	63129
24509	1682	61221	170	623	0	63696
24510	605	1703	61096	454	0	63858
24511	712	505	1535	59295	0	62047
24512	310	62893	494	1725	0	65422
24513	492	1588	319	62289	0	64688
24514	518	494	196	63855	0	65063
24515	308	382	62800	2289	0	65779
24516	57654	223	1558	1316	0	60751
24517	1722	65367	457	799	0	68345
24518	65647	1635	259	858	0	68399
24519	68012	551	141	788	0	69492
24520	68315	398	184	678	0	69575
24521	2521	311	64735	485	0	68052
24522	1253	268	1665	62920	0	66106
24523	869	300	537	64789	0	66495
24524	517	276	63061	2380	0	66234
24525	57525	263	1687	1324	0	60799
24526	2030	284	63207	734	0	66255
24527	663	239	61070	558	0	62530
24528	446	62178	1798	590	0	65012
24529	636	1587	727	61424	0	64374
24530	393	559	62829	1751	0	65532
24531	58536	328	1586	960	0	61410
24532	61627	258	549	673	0	63107
24533	2110	271	61631	402	0	64414
24534	1003	266	1627	61399	0	64295
24535	552	243	63713	1729	0	66237
24536	379	64103	1710	814	0	67006
24537	66768	1597	659	824	0	69848
24538	67824	526	487	656	0	69493
24539	68771	345	346	581	0	70043
24540	2474	259	363	66902	0	69998
24541	1109	232	347	69175	0	70863
24542	609	302	67670	2294	0	70875
24543	65600	240	1800	1041	0	68681
24544	2241	263	641	67998	0	71143
24545	67634	205	475	2118	0	70432
24546	2259	217	67866	892	0	71234
24547	910	227	69667	692	0	71496
24548	875	193	2207	66226	0	69501
24549	725	218	891	70884	0	72718
24550	585	272	69999	2369	0	73225
24551	66479	228	2019	1194	0	69920
24552	2237	275	814	67662	0	70988
24553	903	71162	623	2001	0	74689
24554	71516	1741	487	1149	0	74893
24555	2139	72986	499	778	0	76402
24556	72483	1912	505	828	0	75728
24557	2528	610	74303	639	0	78080
24558	1118	402	73267	588	0	75375
24559	885	75415	2248	618	0	79166
24560	75275	1845	911	829	0	78860
24561	2299	655	75283	609	0	78846
24562	71835	380	2073	762	0	75050
24563	2414	75126	864	581	0	78985
24564	1243	1797	709	75339	0	79088
24565	1012	623	579	74384	0	76598
24566	697	73008	647	2210	0	76562
24567	77972	1931	559	1202	0	81664
24568	80845	689	462	840	0	82836
24569	82025	501	508	781	0	83815
24570	2919	410	81023	549	0	84901
24571	1298	421	2140	80156	0	84015
24572	1005	390	865	81942	0	84202
24573	895	403	686	83873	0	85857
24574	768	431	81643	2713	0	85555
24575	747	79676	2052	1146	0	83621
24576	76868	1954	875	808	0	80505
24577	2290	696	77736	504	0	81226
24578	73561	492	2088	765	0	76906
24579	2284	76928	842	630	0	80684
24580	77345	1920	683	594	0	80542
24581	2553	786	520	76143	0	80002
24582	76934	490	545	2118	0	80087
24583	2499	396	517	76435	0	79847
24584	1029	387	77703	2114	0	81233
24585	1050	869	1833	75864	0	79616
24586	782	445	76230	2021	0	79478
24587	66080	321	1557	1012	0	68970
24588	1739	70929	761	573	0	74002
24589	919	1267	429	63459	0	66074
24590	558	67558	387	1048	0	69551
24591	66543	1074	441	778	0	68836
24592	66571	401	386	637	0	67995
24593	1426	66491	354	390	0	68661
24594	66143	1029	400	539	0	68111
24595	67663	406	333	567	0	68969
24596	1459	338	270	66502	0	68569
24597	746	287	303	67656	0	68992
24598	70114	248	254	1361	0	71977
24599	70948	249	231	693	0	72121
24600	1723	232	244	69647	0	71846
24601	929	243	210	73929	0	75311
24602	73878	208	212	1795	0	76093
24603	1551	203	73117	730	0	75601
24604	67486	201	1300	842	0	69829
24605	1638	221	71884	444	0	74187
24606	763	70984	1359	368	0	73474
24607	778	1227	521	70210	0	72736
24608	569	454	72715	1279	0	75017
24609	475	74827	1251	594	0	77147
24610	73725	1335	533	788	0	76381
24611	1511	495	74951	342	0	77299
24612	70952	335	1262	546	0	73095
24613	75280	307	444	506	0	76537
24614	75986	258	321	567	0	77132
24615	1936	241	297	72701	0	75175
24616	831	75102	305	1220	0	77458
24617	73154	1149	272	921	0	75496
24618	1542	412	75577	405	0	77936
24619	66274	251	1104	771	0	68400
24620	1413	277	75296	355	0	77341
24621	707	74826	1183	449	0	77165
24622	675	1093	522	75374	0	77664
24623	677	434	402	75057	0	76570
24624	517	74193	403	1320	0	76433
24625	644	1175	381	76093	0	78293
24626	520	534	77239	1295	0	79588
24627	452	77303	1246	572	0	79573
24628	636	1291	460	75807	0	78194
24629	75010	528	341	1544	0	77423
24630	77639	367	317	715	0	79038
24631	1968	327	310	78221	0	80826
24632	911	79987	285	1482	0	82665
24633	877	1284	264	80281	0	82706
24634	805	483	271	79629	0	81188
24635	602	351	75280	1839	0	78072
24636	558	75524	1264	832	0	78178
24637	580	1226	434	74140	0	76380
24638	430	468	73420	1390	0	75708
24639	370	73422	1229	648	0	75669
24640	575	1286	449	74011	0	76321
24641	74273	480	342	1541	0	76636
24642	1402	76156	272	619	0	78449
24643	795	1332	208	76603	0	78938
24644	77785	521	228	1647	0	80181
24645	78252	402	220	912	0	79786
24646	78530	329	234	776	0	79869
24647	77740	322	255	663	0	78980
24648	1969	289	222	76676	0	79156
24649	834	300	77680	1430	0	80244
24650	789	441	1172	74582	0	76984
24651	571	76892	436	1403	0	79302
24652	77419	1182	327	967	0	79895
24653	1464	505	75906	526	0	78401
24654	70411	318	1171	717	0	72617
24655	1475	345	74530	386	0	76736
24656	885	276	1195	73674	0	76030
24657	595	270	74262	1182	0	76309
24658	706	285	1173	71233	0	73397
24659	553	301	72370	1298	0	74522
24660	682	267	1245	70157	0	72351
24661	71771	215	490	1587	0	74063
24662	1291	75621	384	695	0	77991
24663	852	1189	348	76102	0	78491
24664	714	422	317	76635	0	78088
24665	568	316	79973	1457	0	82314
24666	551	281	74605	654	0	76091
24667	71962	265	1386	856	0	74469
24668	1220	76565	612	499	0	78896
24669	75934	983	457	601	0	77975
24670	76806	383	363	636	0	78188
24671	1463	226	369	75391	0	77449
24672	611	77498	342	1142	0	79593
24673	78725	1034	324	837	0	80920
24674	79761	388	322	747	0	81218
24675	81238	287	274	752	0	82551
24676	81480	257	274	725	0	82736
24677	80761	221	296	642	0	81920
24678	1542	266	79905	349	0	82062
24679	76671	228	1058	615	0	78572
24680	1497	273	79985	290	0	82045
24681	998	224	1112	77258	0	79592
24682	741	198	456	82224	0	83619
24683	591	227	80554	1367	0	82739
24684	77754	237	1129	901	0	80021
24685	1544	218	487	81308	0	83557
24686	916	210	323	84483	0	85932
24687	705	222	315	85824	0	87066
24688	721	192	287	84392	0	85592
24689	658	186	287	85698	0	86829
24690	459	245	86313	1763	0	88780
24691	686	206	1283	84811	0	86986
24692	480	204	87535	1633	0	89852
24693	546	207	85337	829	0	86919
24694	85339	174	1772	937	0	88222
24695	91261	145	736	857	0	92999
24696	97320	169	482	805	0	98776
24697	2451	193	99161	575	0	102380
24698	1047	189	96635	582	0	98453
24699	660	185	99135	523	0	100503
24700	521	102821	2475	613	0	106430
24701	1070	1998	1398	102025	0	106491
24702	107060	527	620	2401	0	110608
24703	2399	251	527	110667	0	113844
24704	870	113529	627	2370	0	117396
24705	114811	2115	481	1358	0	118765
24706	2857	767	437	113325	0	117386
24707	1220	117137	499	2473	0	121329
24708	1126	2154	555	119011	0	122846
24709	966	789	613	118889	0	121257
24710	115709	473	601	3440	0	120223
24711	2854	451	543	116808	0	120656
24712	1238	486	116419	2909	0	121052
24713	1309	380	2470	113408	0	117567
24714	916	111952	1226	2805	0	116899
24715	717	117472	938	1558	0	120685
24716	934	2923	846	112770	0	117473
24717	971	1281	746	111966	0	114964
24718	623	111263	646	3569	0	116101
24719	801	112023	581	1931	0	115336
24720	855	114563	453	1711	0	117582
24721	1247	3510	381	104658	0	109796
24722	909	113194	441	2952	0	117496
24723	110550	3008	441	2323	0	116322
24724	2795	1671	112965	1599	0	119030
24725	1665	1308	2296	108375	0	113644
24726	793	114018	998	3287	0	119096
24727	111273	2946	651	2509	0	117379
24728	2745	1606	113096	1856	0	119303
24729	1270	113157	2536	1509	0	118472
24730	109984	2907	1136	1768	0	115795
24731	2316	110120	787	1385	0	114608
24732	1086	112747	574	1252	0	115659
24733	1048	3729	518	109680	0	114975
24734	716	113355	488	2746	0	117305
24735	111317	3269	491	2035	0	117112
24736	2645	1973	460	111847	0	116925
24737	1232	1753	110768	2782	0	116535
24738	936	1591	110115	1476	0	114118
24739	935	1533	2799	110061	0	115328
24740	769	1540	112537	2830	0	117676
24741	1125	1408	2465	111882	0	116880
24742	109308	1119	1264	3404	0	115095
24743	2542	1304	111028	1612	0	116486
24744	1639	1243	2447	106961	0	112290
24745	1030	107805	1338	2735	0	112908
24746	1025	3002	985	110872	0	115884
24747	1144	1663	894	110455	0	114156
24748	904	107746	1067	3306	0	113023
24749	1073	3036	925	112501	0	117535
24750	989	1692	855	113790	0	117326
24751	665	1548	111640	3623	0	117476
24752	708	110405	2651	2071	0	115835
24753	109988	2849	1311	2130	0	116278
24754	2656	1563	1053	111918	0	117190
24755	1269	1205	112884	3298	0	118656
24756	1129	1046	2723	110901	0	115799
24757	819	1095	112263	3504	0	117681
24758	103786	977	3014	2804	0	110581
24759	2458	112022	1530	1971	0	117981
24760	1566	2651	1223	113079	0	118519
24761	1180	1413	1073	116277	0	119943
24762	109878	1202	1119	4233	0	116432
24763	2740	1266	1013	111615	0	116634
24764	1315	1258	109798	3904	0	116275
24765	1179	1241	2590	104024	0	109034
24766	782	103030	1475	3736	0	109023
24767	803	106861	1131	2525	0	111320
24768	848	109112	1051	2269	0	113280
24769	991	3659	1019	107619	0	113288
24770	888	2152	105917	3545	0	112502
24771	804	105972	2562	2532	0	111870
24772	103038	3007	1428	2391	0	109864
24773	2539	106037	1042	2019	0	111637
24774	105554	3116	983	2310	0	111963
24775	105681	1615	1113	2207	0	110616
24776	3115	1481	104426	1795	0	110817
24777	105481	1474	2650	2043	0	111648
24778	112166	1354	1329	2308	0	117157
24779	106232	1459	1069	2325	0	111085
24780	112299	1343	755	2141	0	116538
24781	3431	1480	109668	1663	0	116242
24782	107320	1384	2629	1798	0	113131
24783	114591	1529	1256	1771	0	119147
24784	3418	117806	995	1301	0	123520
24785	2015	3563	756	115445	0	121779
24786	1713	2116	711	115866	0	120406
24787	1334	117161	919	3375	0	122789
24788	116245	3219	925	2025	0	122414
24789	3318	118288	945	1210	0	123761
24790	114793	3130	843	1258	0	120024
24791	116827	1748	784	1285	0	120644
24792	4073	118089	662	888	0	123712
24793	2515	2906	702	116119	0	122242
24794	1827	1295	117625	2789	0	123536
24795	1564	113959	2643	1231	0	119397
24796	1651	3302	1001	103034	0	108988
24797	1163	105944	667	1893	0	109667
24798	829	111808	465	834	0	113936
24799	1254	3428	549	105098	0	110329
24800	674	990	107157	2220	0	111041
24801	546	101819	1983	974	0	105322
24802	459	103084	804	530	0	104877
24803	94394	1985	481	577	0	97437
24804	1782	733	177	96888	0	99580
24805	872	426	109	98521	0	99928
24806	588	301	100	101286	0	102275
24807	274	297	100463	2452	0	103486
24808	645	307	1940	98852	0	101744
24809	203	104295	638	2250	0	107386
24810	107145	2230	318	1035	0	110728
24811	2696	771	212	106951	0	110630
24812	808	523	106665	2419	0	110415
24813	105083	342	2307	1184	0	108916
24814	3000	311	724	108800	0	112835
24815	918	345	114500	2612	0	118375
24816	527	374	114883	945	0	116729
24817	112527	276	3281	1041	0	117125
24818	119448	279	1104	834	0	121665
24819	118445	362	563	753	0	120123
24820	119706	340	359	810	0	121215
24821	3853	400	117160	444	0	121857
24822	1383	118487	2692	606	0	123168
24823	118126	2746	881	932	0	122685
24824	3003	118513	585	464	0	122565
24825	117289	2976	438	827	0	121530
24826	3153	118510	437	520	0	122620
24827	1704	3109	406	117587	0	122806
24828	1248	1096	373	119115	0	121832
24829	1100	662	374	117809	0	119945
24830	683	114910	499	3548	0	119640
24831	685	118900	405	1364	0	121354
24832	1153	3456	315	111774	0	116698
24833	611	116027	436	2830	0	119904
24834	665	3278	115203	1015	0	120161
24835	1020	1301	2869	113937	0	119127
24836	676	951	116047	3050	0	120724
24837	111171	739	3018	1586	0	116514
24838	115023	707	1055	1206	0	117991
24839	3827	712	114618	785	0	119942
24840	1531	752	113548	731	0	116562
24841	1289	706	3523	111928	0	117446
24842	750	800	113819	3202	0	118571
24843	1121	713	3305	106081	0	111220
24844	923	97309	1631	3153	0	103016
24845	1116	3358	838	111747	0	117059
24846	1077	1291	684	114079	0	117131
24847	1072	906	627	113818	0	116423
24848	702	844	110588	4162	0	116296
24849	987	688	3221	107676	0	112572
24850	983	782	1384	108763	0	111912
24851	1144	871	940	105916	0	108871
24852	829	109648	819	3718	0	115014
24853	109778	3214	704	2057	0	115753
24854	110572	1279	777	1801	0	114429
24855	110646	902	757	1697	0	114002
24856	4261	837	844	107936	0	113878
24857	1730	840	106688	3652	0	112910
24858	1713	933	104851	1853	0	109350
24859	954	106777	3650	1521	0	112902
24860	103270	3235	1494	1740	0	109739
24861	3055	105999	1127	1526	0	111707
24862	106133	3396	978	1566	0	112073
24863	3413	106448	926	1411	0	112198
24864	105221	3553	845	1508	0	111127
24865	3607	109347	935	1245	0	115134
24866	2037	3672	882	109125	0	115716
24867	1491	1685	107894	3716	0	114786
24868	1412	1116	108600	2010	0	113138
24869	1475	1022	4099	106004	0	112600
24870	1438	989	1912	107434	0	111773
24871	1474	1062	1267	110560	0	114363
24872	1492	927	107519	4457	0	114395
24873	1619	920	3283	106191	0	112013
24874	103798	828	1617	4334	0	110577
24875	105356	845	1289	2372	0	109862
24876	4049	102724	1234	1689	0	109696
24877	100030	3265	1064	1630	0	105989
24878	3816	98937	993	1346	0	105092
24879	98480	3575	892	1450	0	104397
24880	99758	1629	926	1455	0	103768
24881	97237	1122	978	1438	0	100775
24882	4507	1009	96544	1229	0	103289
24883	2152	935	94785	1269	0	99141
24884	92284	814	3669	1370	0	98137
24885	98583	772	1768	1278	0	102401
24886	4452	938	1221	96275	0	102886
24887	2675	774	826	100359	0	104634
24888	1954	891	733	102633	0	106211
24889	1673	829	893	103455	0	106850
24890	1522	951	829	105606	0	108908
24891	100233	879	793	4906	0	106811
24892	3940	941	604	99706	0	105191
24893	1872	825	97659	3908	0	104264
24894	92654	778	3014	2309	0	98755
24895	97336	641	1404	1811	0	101192
24896	4141	95129	976	1585	0	101831
24897	1675	97975	745	1368	0	101763
24898	90617	2990	676	1240	0	95523
24899	2767	94552	606	942	0	98867
24900	92727	2787	743	1147	0	97404
24901	99290	992	675	1139	0	102096
24902	101014	523	533	1057	0	103127
24903	4662	499	453	94585	0	100199
24904	1748	95391	496	3062	0	100697
24905	96317	2695	393	1517	0	100922
24906	3638	956	415	95624	0	100633
24907	1848	503	357	93529	0	96237
24908	87741	319	236	3351	0	91647
24909	2583	86571	260	1455	0	90869
24910	1306	2201	137	86178	0	89822
24911	86775	812	120	2810	0	90517
24912	2478	88808	155	1138	0	92579
24913	90117	2264	226	1069	0	93676
24914	2957	933	81036	625	0	85551
24915	82815	488	1458	782	0	85543
24916	2683	86251	462	477	0	89873
24917	86410	2220	405	702	0	89737
24918	86868	852	115	640	0	88475
24919	2990	88628	132	433	0	92183
24920	89301	2227	100	675	0	92303
24921	2786	88100	165	435	0	91486
24922	92284	2397	86	721	0	95488
24923	3062	1037	112	92036	0	96247
24924	1700	666	85	93010	0	95461
24925	1315	484	62	94788	0	96649
24926	858	560	90902	3010	0	95330
24927	1110	470	2027	90827	0	94434
24928	833	516	92005	2552	0	95906
24929	1154	422	2275	89585	0	93436
24930	772	92270	762	2380	0	96184
24931	1075	2348	356	93891	0	97670
24932	815	1041	93011	2585	0	97452
24933	757	779	95665	1106	0	98307
24934	942	507	2613	95203	0	99265
24935	94885	490	1011	2875	0	99261
24936	96223	380	539	1542	0	98684
24937	3039	96446	384	1096	0	100965
24938	1628	2318	305	97251	0	101502
24939	958	971	99304	2709	0	103942
24940	985	635	2412	99224	0	103256
24941	774	492	100295	3030	0	104591
24942	96528	443	2638	1638	0	101247
24943	3089	511	927	100896	0	105423
24944	1472	585	99668	2820	0	104545
24945	1290	539	2480	99232	0	103541
24946	1107	506	1049	102140	0	104802
24947	885	467	100556	3533	0	105441
24948	1066	422	2551	100083	0	104122
24949	100341	426	988	3548	0	105303
24950	102124	455	707	1837	0	105123
24951	3614	521	565	101880	0	106580
24952	102322	479	581	3508	0	106890
24953	3245	496	102575	1641	0	107957
24954	1538	505	100453	1347	0	103843
24955	101052	378	3218	1432	0	106080
24956	106694	366	1410	1289	0	109759
24957	3800	385	874	104143	0	109202
24958	1960	405	678	106685	0	109728
24959	1379	433	104444	3721	0	109977
24960	1478	485	2711	97418	0	102092
24961	1026	103413	1315	2873	0	108627
24962	104979	2478	864	1905	0	110226
24963	111695	1024	670	1439	0	114828
24964	4097	111091	580	1153	0	116921
24965	108165	2941	589	1417	0	113112
24966	108971	1016	692	1440	0	112119
24967	3996	108916	798	1159	0	114869
24968	109463	2997	765	1315	0	114540
24969	3807	110044	710	1006	0	115567
24970	110753	3248	611	1272	0	115884
24971	3919	1327	110132	1102	0	116480
24972	2086	854	3096	109610	0	115646
24973	1625	639	1277	114378	0	117919
24974	1428	569	936	120149	0	123082
24975	117841	530	737	5057	0	124165
24976	4325	565	551	120249	0	125690
24977	2147	596	119168	4274	0	126185
24978	118186	614	3446	2170	0	124416
24979	4496	567	1289	118875	0	125227
24980	1937	115578	1011	4160	0	122686
24981	1477	122673	853	1951	0	126954
24982	1699	3922	691	118140	0	124452
24983	1690	1521	818	117685	0	121714
24984	1743	826	717	119976	0	123262
24985	1169	626	112714	5091	0	119600
24986	1027	110607	3285	2502	0	117421
24987	107187	2913	1104	2074	0	113278
24988	106128	1143	891	1800	0	109962
24989	3829	103775	710	1334	0	109648
24990	1727	106633	692	1296	0	110348
24991	1786	3343	822	103896	0	109847
24992	1080	1182	102995	3302	0	108559
24993	96634	1105	2856	1941	0	102536
24994	101936	573	1026	1458	0	104993
24995	3514	543	814	100400	0	105271
24996	1689	490	643	101782	0	104604
24997	97861	404	436	3938	0	102639
24998	2981	476	96749	1820	0	102026
24999	91155	429	2482	1753	0	95819
25000	3120	93896	969	994	0	98979
25001	1254	1797	375	85060	0	88486
25002	734	87146	365	2046	0	90291
25003	87690	1909	337	1259	0	91195
25004	2383	680	451	85884	0	89398
25005	1290	463	408	84084	0	86245
25006	926	85263	378	2166	0	88733
25007	85978	1834	336	1315	0	89463
25008	86164	711	297	1216	0	88388
25009	2614	586	84322	774	0	88296
25010	1116	427	78704	705	0	80952
25011	79104	282	1953	936	0	82275
25012	2195	378	80844	620	0	84037
25013	911	397	77233	600	0	79141
25014	76301	405	2212	832	0	79750
25015	2163	363	87031	515	0	90072
25016	1298	267	2641	85219	0	89425
25017	1048	263	944	86832	0	89087
25018	90608	244	682	3505	0	95039
25019	3102	405	90197	1342	0	95046
25020	92061	318	3001	1137	0	96517
25021	4089	343	1104	92130	0	97666
25022	92040	259	898	3465	0	96662
25023	93528	248	644	1673	0	96093
25024	94907	225	469	1364	0	96965
25025	5246	233	532	91242	0	97253
25026	93422	229	466	3674	0	97791
25027	5080	216	410	92430	0	98136
25028	2896	256	472	93615	0	97239
25029	2327	293	492	94488	0	97600
25030	2195	250	356	95273	0	98074
25031	91556	264	406	5472	0	97698
25032	93102	277	408	2865	0	96652
25033	4856	301	90658	2061	0	97876
25034	91243	224	3145	1978	0	96590
25035	95140	186	1150	1906	0	98382
25036	5376	190	864	89942	0	96372
25037	2892	89683	638	3887	0	97100
25038	92259	2936	569	2040	0	97804
25039	5021	1038	572	88838	0	95469
25040	88713	706	606	4173	0	94198
25041	4902	87151	663	1895	0	94611
25042	89263	3111	514	1866	0	94754
25043	5138	1261	462	86201	0	93062
25044	2474	86288	398	4020	0	93180
25045	88147	3465	440	2220	0	94272
25046	4595	85349	448	1864	0	92256
25047	2333	92203	550	1558	0	96644
25048	91590	4088	625	1602	0	97905
25049	4612	1997	89214	1382	0	97205
25050	91660	1381	3093	1460	0	97594
25051	5518	1090	1187	90743	0	98538
25052	2961	980	91827	3654	0	99422
25053	2994	814	3466	89130	0	96404
25054	2623	840	1383	93579	0	98425
25055	2211	806	91213	5040	0	99270
25056	90691	642	3729	2802	0	97864
25057	5262	450	1602	92447	0	99761
25058	3043	540	1172	94519	0	99274
25059	2744	466	841	94723	0	98774
25060	91777	557	830	6445	0	99609
25061	4737	583	88729	3679	0	97728
25062	2687	499	89746	2831	0	95763
25063	2363	374	3951	85048	0	91736
25064	2165	378	84811	4395	0	91749
25065	82106	361	3708	2984	0	89159
25066	4130	83209	2016	2334	0	91689
25067	84564	2835	1572	1929	0	90900
25068	5168	1153	1148	81122	0	88591
25069	2765	81286	1235	3856	0	89142
25070	2644	3477	1100	80522	0	87743
25071	2308	82325	921	4236	0	89790
25072	2328	3649	731	83227	0	89935
25073	2027	1691	80369	4527	0	88614
25074	1749	1543	75898	2424	0	81614
25075	1752	76785	3355	2171	0	84063
25076	74165	2837	1852	2044	0	80898
25077	3460	1659	1187	73094	0	79400
25078	2214	1279	972	74447	0	78912
25079	73826	1133	876	3989	0	79824
25080	74436	1058	865	2539	0	78898
25081	4500	802	1034	73028	0	79364
25082	2745	759	71310	3519	0	78333
25083	2342	70874	2862	2127	0	78205
25084	2136	2683	1368	70760	0	76947
25085	1917	1376	1345	70189	0	74827
25086	1699	73068	932	4064	0	79763
25087	73557	2860	864	2899	0	80180
25088	3632	1492	73553	2039	0	80716
25089	2288	1334	2859	73185	0	79666
25090	1990	1066	1418	74566	0	79040
25091	1412	1007	72630	4788	0	79837
25092	1613	891	3036	74436	0	79976
25093	74270	790	1608	4610	0	81278
25094	75261	814	1523	2681	0	80279
25095	76267	705	1291	2584	0	80847
25096	4351	74181	1326	2275	0	82133
25097	80673	2789	1217	2086	0	86765
25098	4770	1340	1010	79482	0	86602
25099	2885	1194	1034	78163	0	83276
25100	2330	86442	977	4408	0	94157
25101	92593	3583	803	2873	0	99852
25102	96867	1751	933	2357	0	101908
25103	98215	1486	890	2143	0	102734
25104	100330	1368	713	2234	0	104645
25105	100032	1031	870	2252	0	104185
25106	6352	955	95481	2013	0	104801
25107	98121	987	3884	1737	0	104729
25108	100597	1010	1657	1701	0	104965
25109	99610	748	1477	1507	0	103342
25110	7148	715	1117	94535	0	103515
25111	4479	646	998	95841	0	101964
25112	3363	572	90955	5020	0	99910
25113	76710	836	3542	3629	0	84717
25114	4544	88334	1792	2452	0	97122
25115	2305	81194	975	1454	0	85928
25116	1944	2738	79841	1189	0	85712
25117	1564	78435	2496	1142	0	83637
25118	1152	78624	1144	1064	0	81984
25119	1813	3520	1384	66886	0	73603
25120	681	73019	514	1736	0	75950
25121	72250	2297	360	947	0	75854
25122	72235	938	344	833	0	74350
25123	2810	751	306	70416	0	74283
25124	1364	584	69992	2037	0	73977
25125	68254	444	1886	1126	0	71710
25126	2459	447	70072	780	0	73758
25127	1271	338	71096	624	0	73329
25128	1332	375	2307	66334	0	70348
25129	1065	387	1063	69551	0	72066
25130	759	273	70302	2365	0	73699
25131	698	66941	2052	1191	0	70882
25132	650	71886	905	896	0	74337
25133	71478	2147	801	894	0	75320
25134	72944	860	447	754	0	75005
25135	2560	619	71037	493	0	74709
25136	70042	444	1772	573	0	72831
25137	75118	392	644	625	0	76779
25138	2753	434	507	73273	0	76967
25139	1666	357	355	74447	0	76825
25140	1471	284	325	75185	0	77265
25141	75102	309	327	2523	0	78261
25142	76394	271	324	1276	0	78265
25143	77424	233	269	916	0	78842
25144	3301	214	324	76011	0	79850
25145	1821	284	74733	1979	0	78817
25146	73130	250	1722	1086	0	76188
25147	74508	231	691	855	0	76285
25148	3082	275	606	71396	0	75359
25149	1743	72688	453	1928	0	76812
25150	1582	1667	337	71637	0	75223
25151	1107	72879	388	2110	0	76484
25152	1203	2051	386	69588	0	73228
25153	975	72790	381	2144	0	76290
25154	71546	1937	350	989	0	74822
25155	2299	887	337	71473	0	74996
25156	1141	72125	319	1767	0	75352
25157	1016	1863	71591	792	0	75262
25158	69432	820	1657	873	0	72782
25159	2124	793	626	70996	0	74539
25160	1066	71256	569	1786	0	74677
25161	1122	1668	355	68922	0	72067
25162	812	68923	368	1827	0	71930
25163	10627	64039	446	777	0	75889
25164	72281	1862	390	885	0	75418
25165	74275	944	417	741	0	76377
25166	2195	788	74453	486	0	77922
25167	73302	557	1643	618	0	76120
25168	74857	552	710	629	0	76748
25169	2255	74480	646	456	0	77837
25170	1418	1718	400	74971	0	78507
25171	1249	705	385	75589	0	77928
25172	1000	623	74348	1887	0	77858
25173	995	474	72332	935	0	74736
25174	73538	384	1937	859	0	76718
25175	76319	327	936	669	0	78251
25176	76441	290	733	708	0	78172
25177	2539	256	74329	605	0	77729
25178	1478	234	1709	73574	0	76995
25179	75044	257	737	1927	0	77965
25180	2144	240	613	74814	0	77811
25181	1086	297	73373	1984	0	76740
25182	69270	329	1528	1039	0	72166
25183	2136	332	75549	700	0	78717
25184	1091	74273	1707	594	0	77665
25185	75018	1471	723	692	0	77904
25186	1980	579	74791	511	0	77861
25187	1179	530	1636	73289	0	76634
25188	74796	361	710	1751	0	77618
25189	2008	336	513	75259	0	78116
25190	76169	367	357	2029	0	78922
25191	2157	350	266	75640	0	78413
25192	77117	348	278	2209	0	79952
25193	77566	304	264	1218	0	79352
25194	77326	332	234	973	0	78865
25195	75908	299	293	723	0	77223
25196	2716	474	348	74782	0	78320
25197	1173	265	71322	1354	0	74114
25198	950	267	70732	682	0	72631
25199	707	70082	1409	578	0	72776
25200	452	63543	563	250	0	64808
25201	57827	588	1324	280	0	60019
25202	643	178	102	55900	0	56823
25203	174	99	56356	449	0	57078
25204	166	96	55733	146	0	56141
25205	223	187	503	56525	0	57438
25206	57400	70	157	546	0	58173
25207	431	57959	96	191	0	58677
25208	62157	371	83	387	0	62998
25209	552	110	78	63354	0	64094
25210	256	89	111	63620	0	64076
25211	244	55	110	63871	0	64280
25212	134	85	64333	538	0	65090
25213	174	107	61891	254	0	62426
25214	125	62823	516	191	0	63655
25215	215	402	164	65731	0	66512
25216	64688	107	143	655	0	65593
25217	483	119	62863	209	0	63674
25218	230	110	63790	226	0	64356
25219	275	90	577	65128	0	66070
25220	240	66	253	67157	0	67716
25221	188	103	176	67754	0	68221
25222	241	72	127	70943	0	71383
25223	72518	57	123	1196	0	73894
25224	945	56	129	72998	0	74128
25225	72611	60	166	1123	0	73960
25226	942	94	73600	335	0	74971
25227	315	73782	880	281	0	75258
25228	328	851	255	73944	0	75378
25229	241	232	75239	975	0	76687
25230	265	128	73435	403	0	74231
25231	207	76163	1039	333	0	77742
25232	286	779	343	75145	0	76553
25233	268	255	216	76071	0	76810
25234	184	188	77017	1080	0	78469
25235	73222	142	1024	608	0	74996
25236	1081	110	363	76918	0	78472
25237	409	95	281	75709	0	76494
25238	212	140	77841	1224	0	79417
25239	199	75977	1238	539	0	77953
25240	141	83965	391	407	0	84904
25241	83915	1565	280	523	0	86283
25242	1672	382	261	84466	0	86781
25243	87645	270	216	1888	0	90019
25244	1895	200	86963	593	0	89651
25245	803	161	1739	86514	0	89217
25246	86687	183	544	2132	0	89546
25247	88171	173	400	857	0	89601
25248	2271	199	271	87297	0	90038
25249	884	173	87347	1890	0	90294
25250	546	148	88698	746	0	90138
25251	594	153	2105	87975	0	90827
25252	335	160	89194	1879	0	91568
25253	83964	156	1923	1001	0	87044
25254	1858	87693	655	687	0	90893
25255	88940	1622	476	704	0	91742
25256	90015	472	410	679	0	91576
25257	2475	333	400	89236	0	92444
25258	998	229	512	90529	0	92268
25259	90368	212	353	2465	0	93398
25260	2171	212	356	90400	0	93139
25261	891	256	90211	2123	0	93481
25262	633	90272	1874	858	0	93637
25263	704	1738	690	89072	0	92204
25264	634	535	516	89511	0	91196
25265	652	347	399	90149	0	91547
25266	516	259	87492	2611	0	90878
25267	578	86236	1915	1156	0	89885
25268	611	1688	752	87648	0	90699
25269	472	605	87399	2164	0	90640
25270	615	425	1980	86609	0	89629
25271	86620	364	695	2683	0	90362
25272	2119	289	558	87558	0	90524
25273	892	336	86431	2418	0	90077
25274	83051	283	2001	1476	0	86811
25275	2031	86684	922	912	0	90549
25276	772	90226	745	855	0	92598
25277	89438	2064	532	1159	0	93193
25278	2204	762	91272	868	0	95106
25279	1173	448	2035	89773	0	93429
25280	894	386	860	92444	0	94584
25281	656	405	92709	2607	0	96377
25282	549	91695	2171	1411	0	95826
25283	1020	1912	957	81420	0	85309
25284	644	749	91350	2376	0	95119
25285	833	493	2192	90382	0	93900
25286	90315	433	1040	2785	0	94573
25287	2230	433	92994	1328	0	96985
25288	1153	514	2175	92866	0	96708
25289	931	523	879	94060	0	96393
25290	768	565	92348	2885	0	96566
25291	1028	437	2261	87227	0	90953
25292	805	77919	1315	2811	0	82850
25293	1046	1891	948	82439	0	86324
25294	667	90240	869	2433	0	94209
25295	89540	2030	836	1606	0	94012
25296	86502	801	778	1491	0	89572
25297	2554	575	86937	1283	0	91349
25298	1121	509	84685	1173	0	87488
25299	856	540	84139	1054	0	86589
25300	704	83227	2669	1078	0	87678
25301	823	1869	1333	86551	0	90576
25302	768	750	88023	2461	0	92002
25303	1061	559	2265	83722	0	87607
25304	939	485	1106	85966	0	88496
25305	828	450	86714	2779	0	90771
25306	919	513	2230	85819	0	89481
25307	827	559	1081	83571	0	86038
25308	743	81878	956	2804	0	86381
25309	889	1865	834	83163	0	86751
25310	761	747	899	84969	0	87376
25311	661	591	83464	3013	0	87729
25312	677	506	2330	81710	0	85223
25313	620	496	82866	2981	0	86963
25314	569	596	81573	1706	0	84444
25315	78633	504	2546	1669	0	83352
25316	2100	602	1315	77559	0	81576
25317	834	81248	1066	2656	0	85804
25318	747	82576	948	1655	0	85926
25319	805	2290	1026	81642	0	85763
25320	622	917	81840	2809	0	86188
25321	658	81182	2425	1699	0	85964
25322	714	1743	974	77361	0	80792
25323	517	715	81198	2231	0	84661
25324	497	83592	1800	1262	0	87151
25325	87971	1789	1037	1310	0	92107
25326	88620	815	885	1121	0	91441
25327	87560	641	675	1253	0	90129
25328	2246	497	729	93244	0	96716
25329	1005	465	747	93838	0	96055
25330	743	488	650	92639	0	94520
25331	462	512	90679	2959	0	94612
25332	88727	533	2199	1682	0	93141
25333	2300	417	1023	88625	0	92365
25334	832	477	86256	2271	0	89836
25335	88182	451	1999	1484	0	92116
25336	91878	398	999	1318	0	94593
25337	2645	1165	69101	1385	0	74296
25338	86465	375	1345	1280	0	89465
25339	1945	90792	875	1003	0	94615
25340	690	1221	87381	690	0	89982
25341	82548	530	1730	885	0	85693
25342	1315	85766	757	694	0	88532
25343	539	1015	378	80824	0	82756
25344	239	83861	352	1152	0	85604
25345	330	1090	343	84591	0	86354
25346	255	352	85142	1303	0	87052
25347	75024	200	1302	970	0	77496
25348	1121	241	84766	512	0	86640
25349	377	81101	1189	467	0	83134
25350	206	83475	496	378	0	84555
25351	81148	1213	320	499	0	83180
25352	1125	488	81595	289	0	83497
25353	513	251	1207	79464	0	81435
25354	219	252	81470	1177	0	83118
25355	206	82130	1215	487	0	84038
25356	593	1129	461	74419	0	76602
25357	163	81583	422	944	0	83112
25358	83282	1164	330	670	0	85446
25359	83788	409	317	634	0	85148
25360	83685	246	326	465	0	84722
25361	1384	300	82451	336	0	84471
25362	468	284	79326	380	0	80458
25363	78244	181	1410	536	0	80371
25364	1241	227	84149	311	0	85928
25365	740	150	1386	76667	0	78943
25366	269	82723	610	1059	0	84661
25367	84614	1171	409	683	0	86877
25368	84056	383	348	605	0	85392
25369	86487	256	320	551	0	87614
25370	1698	191	255	86238	0	88382
25371	603	160	291	87100	0	88154
25372	85864	148	279	1757	0	88048
25373	1332	85408	289	646	0	87675
25374	84359	1148	228	561	0	86296
25375	1503	362	175	83049	0	85089
25376	591	195	145	83682	0	84613
25377	81711	131	145	1672	0	83659
25378	1250	81525	169	521	0	83465
25379	81407	1169	161	537	0	83274
25380	1355	82272	195	275	0	84097
25381	81141	1255	194	349	0	82939
25382	1589	384	138	82257	0	84368
25383	83383	233	145	1482	0	85243
25384	87135	203	130	648	0	88116
25385	91832	235	78	584	0	92729
25386	2097	95155	157	293	0	97702
25387	777	1794	92863	233	0	95667
25388	91126	539	1818	453	0	93936
25389	94820	302	500	446	0	96068
25390	2341	94025	306	207	0	96879
25391	1121	1861	215	93917	0	97114
25392	847	657	186	95498	0	97188
25393	94819	387	213	2433	0	97852
25394	2389	316	198	95695	0	98598
25395	972	279	96080	2104	0	99435
25396	719	304	94046	807	0	95876
25397	96360	235	2199	759	0	99553
25398	2370	239	774	97900	0	101283
25399	1151	182	426	99438	0	101197
25400	897	199	351	101281	0	102728
25401	573	213	101278	2667	0	104731
25402	807	206	2122	98897	0	102032
25403	812	165	738	101564	0	103279
25404	713	184	448	104084	0	105429
25405	101651	184	330	3271	0	105436
25406	2637	218	322	102549	0	105726
25407	941	280	103555	2778	0	107554
25408	103626	248	2275	1593	0	107742
25409	2857	306	109197	903	0	113263
25410	108091	241	2679	1075	0	112086
25411	108275	253	909	987	0	110424
25412	3718	282	556	111569	0	116125
25413	1485	112674	533	3060	0	117752
25414	1407	2521	436	112501	0	116865
25415	1310	1068	483	113164	0	116025
25416	788	114224	559	3543	0	119114
25417	113475	2549	482	1787	0	118293
25418	2906	113548	488	1153	0	118095
25419	113417	2757	380	1223	0	117777
25420	114920	996	341	1199	0	117456
25421	3866	600	360	112927	0	117753
25422	1958	505	338	113721	0	116522
25423	1115	464	108206	3637	0	113422
25424	1009	395	101315	1732	0	104451
25425	97810	432	2844	1527	0	102613
25426	101623	278	1143	1333	0	104377
25427	3284	96399	711	968	0	101362
25428	1768	2124	586	93914	0	98392
25429	1142	770	100463	2661	0	105036
25430	1432	1396	2508	99561	0	104897
25431	98854	485	1264	3074	0	103677
25432	97629	376	657	1537	0	100199
25433	3090	98839	504	1126	0	103559
25434	1738	2156	409	99662	0	103965
25435	1308	902	415	101614	0	104239
25436	1163	654	397	101913	0	104127
25437	962	560	97183	3366	0	102071
25438	86506	542	2155	2149	0	91352
25439	94468	520	911	1434	0	97333
25440	3348	570	95487	1073	0	100478
25441	1706	95487	2235	1171	0	100599
25442	95819	2115	912	1359	0	100205
25443	96349	841	792	1383	0	99365
25444	3335	698	93959	1107	0	99099
25445	1864	545	98406	977	0	101792
25446	1754	503	2765	98118	0	103140
25447	1372	636	100104	2470	0	104582
25448	96063	571	2616	1525	0	100775
25449	99545	512	1239	1299	0	102595
25450	101080	441	967	1300	0	103788
25451	3756	400	877	95609	0	100642
25452	1973	103877	819	2648	0	109317
25453	106182	2047	750	1826	0	110805
25454	105739	852	778	1510	0	108879
25455	3641	803	103742	1157	0	109343
25456	2161	642	100168	1224	0	104195
25457	96840	541	2623	1559	0	101563
25458	3296	537	1280	103716	0	108829
25459	1950	644	104128	2708	0	109430
25460	1741	103147	2502	1609	0	108999
25461	1768	2099	1337	104438	0	109642
25462	103730	966	1069	2902	0	108667
25463	3109	105879	965	1527	0	111480
25464	2075	2256	841	103391	0	108563
25465	1659	102721	895	2762	0	108037
25466	1369	106539	1018	1654	0	110580
25467	1545	2523	967	106651	0	111686
25468	1608	1220	926	106429	0	110183
25469	1468	107609	920	3053	0	113050
25470	106029	2357	813	1861	0	111060
25471	3252	1183	107335	1299	0	113069
25472	103757	1029	2325	1597	0	108708
25473	3384	831	1159	109938	0	115312
25474	2124	759	960	111036	0	114879
25475	1853	671	957	111590	0	115071
25476	1802	651	980	111533	0	114966
25477	1607	749	112003	3279	0	117638
25478	1763	604	2509	111760	0	116636
25479	1682	849	1239	113958	0	117728
25480	1347	120614	960	3541	0	126462
25481	1304	2506	121874	2089	0	127773
25482	1218	124161	2745	1745	0	129869
25483	1421	2864	125474	1426	0	131185
25484	1174	124743	2683	1238	0	129838
25485	1573	2363	1386	116171	0	121493
25486	114637	864	826	2567	0	118894
25487	2347	115952	694	1295	0	120288
25488	1527	2052	681	116330	0	120590
25489	1069	964	117510	2374	0	121917
25490	794	119198	2288	1304	0	123584
25491	116568	2249	1136	1467	0	121420
25492	117955	1089	916	1358	0	121318
25493	2744	119475	814	853	0	123886
25494	1437	2335	117002	777	0	121551
25495	111405	1164	2251	1122	0	115942
25496	2753	1025	1020	119388	0	124186
25497	117867	786	820	2889	0	122362
25498	2685	119767	678	1299	0	124429
25499	1310	123220	696	1109	0	126335
25500	1219	2735	120642	794	0	125390
25501	115816	1296	2266	1120	0	120498
25502	2908	954	1041	119628	0	124531
25503	120063	699	777	2578	0	124117
25504	2378	121325	615	1192	0	125510
25505	120297	2099	660	1267	0	124323
25506	118679	1024	629	1108	0	121440
25507	2724	858	121588	819	0	125989
25508	1247	115344	1683	551	0	118825
25509	839	119027	726	513	0	121105
25510	850	2173	440	110995	0	114458
25511	583	109590	412	1420	0	112005
25512	111196	1738	362	941	0	114237
25513	1613	112853	304	519	0	115289
25514	967	1801	230	110042	0	113040
25515	579	109639	247	1358	0	111823
25516	521	107974	273	571	0	109339
25517	607	111556	253	456	0	112872
25518	882	1913	378	109803	0	112976
25519	705	883	192	111390	0	113170
25520	644	702	223	110072	0	111641
25521	402	108731	243	1702	0	111078
25522	403	1737	106546	689	0	109375
25523	476	891	103311	525	0	105203
25524	101452	767	1458	794	0	104471
25525	1593	663	505	107651	0	110412
25526	623	785	107928	1438	0	110774
25527	551	758	105400	666	0	107375
25528	388	111633	1526	618	0	114165
25529	643	1671	600	103741	0	106655
25530	459	850	391	107643	0	109343
25531	106227	764	309	2198	0	109498
25532	1540	670	305	106535	0	109050
25533	728	609	390	105834	0	107561
25534	474	657	107004	1832	0	109967
25535	695	542	1492	104605	0	107334
25536	744	571	646	109925	0	111886
25537	426	567	110463	1948	0	113404
25538	385	581	109152	1019	0	111137
25539	370	108404	1805	764	0	111343
25540	423	1656	109427	747	0	112253
25541	602	772	1657	106508	0	109539
25542	1511	797	1319	81536	0	85163
25543	389	619	110068	2069	0	113145
25544	362	109025	1578	1143	0	112108
25545	101948	1608	856	1298	0	105710
25546	1346	105084	733	960	0	108123
25547	714	1741	623	105037	0	108115
25548	565	897	719	106100	0	108281
25549	325	106135	806	2147	0	109413
25550	491	1793	735	106271	0	109290
25551	550	932	691	106633	0	108806
25552	445	838	100697	2240	0	104220
25553	446	99778	1670	1351	0	103245
25554	534	1788	846	101096	0	104264
25555	471	965	100401	1963	0	103800
25556	687	848	1687	98555	0	101777
25557	698	774	850	99038	0	101360
25558	662	689	680	101322	0	103353
25559	638	778	585	100657	0	102658
25560	619	774	609	98357	0	100359
25561	528	100273	586	2303	0	103690
25562	96834	1718	575	1731	0	100858
25563	1526	946	97390	1137	0	100999
25564	83108	784	1625	1837	0	87354
25565	1571	749	101310	1042	0	104672
25566	609	105824	1802	1100	0	109335
25567	659	1896	104163	991	0	107709
25568	448	105577	1946	1110	0	109081
25569	851	2014	898	96816	0	100579
25570	692	907	671	100533	0	102803
25571	482	102539	537	2292	0	105850
25572	475	107274	535	1292	0	109576
25573	105748	2170	544	1348	0	109810
25574	107407	1088	586	1338	0	110419
25575	107443	856	575	1174	0	110048
25576	108567	748	580	1164	0	111059
25577	2284	896	545	106905	0	110630
25578	806	106236	539	1736	0	109317
25579	103921	1688	391	1291	0	107291
25580	1478	706	312	99206	0	101702
25581	95836	516	289	1568	0	98209
25582	92597	330	279	1038	0	94244
25583	1258	90384	269	583	0	92494
25584	493	88148	213	466	0	89320
25585	337	92785	218	398	0	93738
25586	503	1670	410	88563	0	91146
25587	218	92715	232	1084	0	94249
25588	93065	945	188	821	0	95019
25589	95366	366	167	726	0	96625
25590	94750	293	142	663	0	95848
25591	96451	259	114	625	0	97449
25592	97121	243	151	632	0	98147
25593	1515	292	99342	285	0	101434
25594	97545	200	1214	616	0	99575
25595	1552	281	100296	256	0	102385
25596	98409	135	1218	539	0	100301
25597	1643	172	415	100730	0	102960
25598	661	291	94777	1268	0	96997
25599	483	210	103635	496	0	104824
25600	313	112433	1460	354	0	114560
25601	112389	1682	688	581	0	115340
25602	115696	525	305	581	0	117107
25603	2341	126868	224	292	0	129725
25604	1384	2134	150	141536	0	145204
25605	149651	746	189	3068	0	153654
25606	3469	567	153387	968	0	158391
25607	1229	153288	2938	620	0	158075
25608	148782	3129	1048	946	0	153905
25609	3350	152859	639	557	0	157405
25610	2095	3600	435	143544	0	149674
25611	1121	154467	466	2673	0	158727
25612	1446	3937	386	145816	0	151585
25613	787	150125	452	3139	0	154503
25614	677	157285	391	1336	0	159689
25615	151889	4571	332	1335	0	158127
25616	155473	2241	285	1182	0	159181
25617	4426	1631	154120	812	0	160989
25618	2085	1314	149579	785	0	153763
25619	1482	1282	154145	658	0	157567
25620	1593	1200	4579	153320	0	160692
25621	1210	1338	158204	3334	0	164086
25622	1597	1225	4109	153782	0	160713
25623	1522	1191	1851	154131	0	158695
25624	906	156394	1409	4512	0	163221
25625	155811	4005	1132	2632	0	163580
25626	3591	158078	1097	1706	0	164472
25627	2054	4426	933	161191	0	168604
25628	1668	2140	961	163193	0	167962
25629	1723	1564	875	164398	0	168560
25630	1411	1233	162548	5322	0	170514
25631	1620	1162	4155	160450	0	167387
25632	1539	1143	2039	163647	0	168368
25633	1396	1175	1477	166838	0	170886
25634	937	1246	160922	6024	0	169129
25635	852	160100	3985	3387	0	168324
25636	156636	4160	1721	3264	0	165781
25637	152996	2117	1171	3072	0	159356
25638	4452	159165	967	2258	0	166842
25639	2644	4494	959	157782	0	165879
25640	1957	2414	928	162794	0	168093
25641	1526	1832	158502	5687	0	167547
25642	1357	157020	4041	3331	0	165749
25643	1663	4169	1990	159091	0	166913
25644	1358	2098	159875	5139	0	168470
25645	1458	1742	4395	157362	0	164957
25646	1491	1404	2168	159014	0	164077
25647	1130	1516	159341	6322	0	168309
25648	1479	1489	4511	156668	0	164147
25649	1630	1575	2311	155102	0	160618
25650	1445	1513	160424	6180	0	169562
25651	1672	1502	4371	159602	0	167147
25652	1623	1516	2385	153979	0	159503
25653	1082	1267	1753	165189	0	169291
25654	736	1208	160986	7257	0	170187
25655	1051	1073	4700	161340	0	168164
25656	156391	1136	2448	7133	0	167108
25657	156686	1061	2080	4703	0	164530
25658	4606	158314	1857	3709	0	168486
25659	158540	3776	1609	3830	0	167755
25660	4601	1846	164603	3218	0	174268
25661	2642	1340	4595	165129	0	173706
25662	2050	1194	2412	168131	0	173787
25663	1832	1216	1801	172033	0	176882
25664	162752	1109	1620	7396	0	172877
25665	4069	162248	1494	4472	0	172283
25666	2170	3876	1293	152632	0	159971
25667	1427	157098	1418	5752	0	165695
25668	154961	4158	1449	4219	0	164787
25669	4022	157743	1419	3276	0	166460
25670	154507	4411	1203	3376	0	163497
25671	4509	153929	1129	2874	0	162441
25672	2329	155740	1234	2911	0	162214
25673	2103	5181	1257	154200	0	162741
25674	1716	2639	1339	156067	0	161761
25675	1625	2031	1222	155590	0	160468
25676	1458	1835	1082	156193	0	160568
25677	1366	1975	150033	6886	0	160260
25678	1440	149669	3689	4185	0	158983
25679	1493	4435	1642	143776	0	151346
25680	1116	148718	1397	5624	0	156855
25681	1223	4791	147845	3550	0	157409
25682	1630	2480	3920	146183	0	154213
25683	1559	2128	1926	153458	0	159071
25684	1362	1861	149470	6095	0	158788
25685	1081	146419	4080	3949	0	155529
25686	1166	4223	2146	147175	0	154710
25687	863	2154	145162	6137	0	154316
25688	714	144713	4187	4430	0	154044
25689	982	4061	2072	143053	0	150168
25690	822	2189	142315	5795	0	151121
25691	1012	1947	137273	3565	0	143797
25692	854	136554	4372	2961	0	144741
25693	791	149409	2102	2609	0	154911
25694	1205	5090	1905	148918	0	157118
25695	1387	2685	1558	155831	0	161461
25696	740	2055	152714	6349	0	161858
25697	141282	1704	4249	4666	0	151901
25698	145321	1727	2271	3677	0	152996
25699	4624	1707	143378	2694	0	152403
25700	1982	134821	3915	2496	0	143214
25701	1446	134198	2148	2324	0	140116
25702	1127	132677	1557	1977	0	137338
25703	1722	99598	2134	2357	0	105811
25704	2899	5334	1863	102330	0	112426
25705	740	1271	371	122032	0	124414
25706	510	883	249	121123	0	122765
25707	549	716	205	121705	0	123175
25708	176	120257	228	5096	0	125757
25709	571	3055	242	119850	0	123718
25710	212	120776	259	3982	0	125229
25711	549	3593	215	123290	0	127647
25712	119987	1748	237	4345	0	126317
25713	3170	1100	238	122061	0	126569
25714	1305	121970	307	4333	0	127915
25715	1192	3445	208	125670	0	130515
25716	1016	1775	191	130544	0	133526
25717	803	1318	184	132310	0	134615
25718	124828	1090	184	6923	0	133025
25719	3468	1232	134	130235	0	135069
25720	1459	1087	124790	6014	0	133350
25721	938	128572	3017	3840	0	136367
25722	1143	4080	1312	132444	0	138979
25723	1300	2050	870	137657	0	141877
25724	1262	1583	628	140332	0	143805
25725	132183	1383	464	7418	0	141448
25726	4138	1250	130179	4276	0	139843
25727	2374	1134	3433	125075	0	132016
25728	1253	129320	1438	5716	0	137727
25729	1420	4420	796	131875	0	138511
25730	123282	2307	679	6804	0	133072
25731	3570	127455	683	4397	0	136105
25732	2185	4586	455	128417	0	135643
25733	1533	2211	425	129921	0	134090
25734	965	126817	522	7564	0	135868
25735	1246	4600	458	131238	0	137542
25736	1268	2499	505	134149	0	138421
25737	820	1941	127998	7882	0	138641
25738	811	129014	3723	5177	0	138725
25739	127666	4729	1641	4493	0	138529
25740	4347	2572	128822	3850	0	139591
25741	124065	2013	4102	4192	0	134372
25742	4885	1993	128210	4067	0	139155
25743	2810	1585	4396	130378	0	139169
25744	127413	1503	2159	7999	0	139074
25745	5089	1956	1291	131502	0	139838
25746	129653	1760	1194	8235	0	140842
25747	131578	1921	1044	5790	0	140333
25748	130671	2097	1130	4745	0	138643
25749	6578	129534	1122	4157	0	141391
25750	4234	4811	1015	129538	0	139598
25751	3060	2881	1276	133547	0	140764
25752	2737	2187	1225	134090	0	140239
25753	2297	1607	128275	9020	0	141199
25754	2268	1517	4674	132358	0	140817
25755	129412	1367	2492	8440	0	141711
25756	132713	1327	1781	5999	0	141820
25757	7100	1388	128400	4595	0	141483
25758	130141	1702	4762	4012	0	140617
25759	134356	1700	2347	4170	0	142573
25760	7704	1713	1736	126857	0	138010
25761	125535	1573	1330	8137	0	136575
25762	127929	1500	1184	5836	0	136449
25763	7800	1455	1522	125961	0	136738
25764	125597	1397	1715	8021	0	136730
25765	126976	1681	1497	5668	0	135822
25766	8176	1687	1531	123991	0	135385
25767	5692	1845	93153	7428	0	108118
25768	117277	1630	3749	5039	0	127695
25769	7246	1588	120793	4329	0	133956
25770	5060	1206	121684	4426	0	132376
25771	4106	120617	6041	4338	0	135102
25772	4424	4542	3094	120338	0	132398
25773	4390	2171	2100	125818	0	134479
25774	4368	1482	1892	123837	0	131579
25775	4289	1703	121121	8547	0	135660
25776	4496	1556	120213	5640	0	131905
25777	3902	121060	6159	4914	0	136035
25778	4056	4433	3514	119742	0	131745
25779	4104	2159	2803	124806	0	133872
25780	3547	1540	2679	127457	0	135223
25781	3669	1360	121232	9060	0	135321
25782	3729	119635	5257	6160	0	134781
25783	3728	4360	3165	122460	0	133713
25784	3890	2338	122378	7553	0	136159
25785	4004	1767	122344	5203	0	133318
25786	120265	1716	6820	4595	0	133396
25787	122519	1615	4030	4660	0	132824
25788	124842	1440	2812	4735	0	133829
25789	8030	1257	2490	118156	0	129933
25790	4996	1207	118372	7389	0	131964
25791	3955	114843	5460	5693	0	129951
25792	3719	120642	3455	5001	0	132817
25793	3632	4672	106591	3593	0	118488
25794	3543	3663	5132	97911	0	110249
25795	3272	1742	3490	92865	0	101369
25796	3302	90394	2706	5161	0	101563
25797	3278	96984	2113	3685	0	106060
25798	95955	3892	2076	3182	0	105105
25799	98007	1884	1858	2864	0	104613
25800	98488	1305	1615	3216	0	104624
25801	96441	1124	1686	3108	0	102359
25802	91242	1161	1520	2639	0	96562
25803	6026	84835	1594	2767	0	95222
25804	2278	67793	1134	1759	0	72964
25805	1462	59872	942	1270	0	63546
25806	60287	1820	2159	1383	0	65649
25807	2853	961	1193	58189	0	63196
25808	1358	401	666	58943	0	61368
25809	58038	337	708	2284	0	61367
25810	1996	58011	710	1289	0	62006
25811	1407	1379	668	58538	0	61992
25812	1302	659	612	59487	0	62060
25813	1321	438	651	59143	0	61553
25814	56102	331	537	1953	0	58923
25815	2058	307	510	56369	0	59244
25816	1073	333	52781	1562	0	55749
25817	50804	347	1063	951	0	53165
25818	1800	417	559	52581	0	55357
25819	989	291	52501	1292	0	55073
25820	900	51299	1034	796	0	54029
25821	611	50396	364	506	0	51877
25822	48254	1012	1068	633	0	50967
25823	48294	281	353	431	0	49359
25824	909	50845	156	249	0	52159
25825	524	819	155	53432	0	54930
25826	55307	214	114	1327	0	56962
25827	1220	119	132	58702	0	60173
25828	629	111	112	61309	0	62161
25829	439	124	123	61879	0	62565
25830	419	115	120	61375	0	62029
25831	214	60628	129	1774	0	62745
25832	326	1114	133	61854	0	63427
25833	319	407	121	62242	0	63089
25834	319	254	116	63198	0	63887
25835	189	220	60729	1885	0	63023
25836	132	61012	1173	898	0	63215
25837	258	1240	397	61161	0	63056
25838	144	446	60379	1547	0	62516
25839	180	315	56778	760	0	58033
25840	118	60314	1508	527	0	62467
25841	59880	1274	596	594	0	62344
25842	1300	483	345	60997	0	63125
25843	60727	313	243	1642	0	62925
25844	1382	61726	215	753	0	64076
25845	633	1392	169	62207	0	64401
25846	59995	507	176	1773	0	62451
25847	61574	344	173	915	0	63006
25848	1783	267	156	61154	0	63360
25849	887	240	164	61073	0	62364
25850	460	234	60525	1892	0	63111
25851	511	161	1279	59786	0	61737
25852	439	309	510	62038	0	63296
25853	59855	205	332	2094	0	62486
25854	1328	60858	224	973	0	63383
25855	604	1285	59797	686	0	62372
25856	57166	490	1146	818	0	59620
25857	1399	60502	471	548	0	62920
25858	755	1312	282	61095	0	63444
25859	60593	514	215	1701	0	63023
25860	1588	343	193	60212	0	62336
25861	804	267	152	60935	0	62158
25862	428	285	59732	1964	0	62409
25863	464	225	1237	60044	0	61970
25864	59575	193	532	2055	0	62355
25865	1552	206	298	60607	0	62663
25866	59386	221	204	2101	0	61912
25867	1536	57993	238	1065	0	60832
25868	707	60449	242	804	0	62202
25869	582	1596	231	60549	0	62958
25870	560	692	178	61434	0	62864
25871	58777	451	169	2186	0	61583
25872	1406	58962	194	1175	0	61737
25873	59276	1388	167	1038	0	61869
25874	59759	594	203	897	0	61453
25875	1911	456	193	59505	0	62065
25876	59380	352	216	1903	0	61851
25877	1793	321	57193	951	0	60258
25878	1069	299	1259	57670	0	60297
25879	674	340	58728	1755	0	61497
25880	676	305	1478	59425	0	61884
25881	57822	317	573	2122	0	60834
25882	58986	311	378	1224	0	60899
25883	1895	58386	295	942	0	61518
25884	1088	1411	239	58086	0	60824
25885	903	587	226	58680	0	60396
25886	649	58281	239	2060	0	61229
25887	685	1491	218	60109	0	62503
25888	675	640	192	60306	0	61813
25889	508	59099	234	2236	0	62077
25890	57413	1435	200	1446	0	60494
25891	58033	649	275	1092	0	60049
25892	1942	502	228	57680	0	60352
25893	1007	422	245	58278	0	59952
25894	754	396	56753	2232	0	60135
25895	827	388	1267	55307	0	57789
25896	620	55379	533	1932	0	58464
25897	56889	1427	386	1288	0	59990
25898	1633	643	305	57142	0	59723
25899	862	480	247	57181	0	58770
25900	55146	432	231	2387	0	58196
25901	1620	55219	235	1338	0	58412
25902	945	1411	210	56546	0	59112
25903	791	672	199	56260	0	57922
25904	643	55464	231	2164	0	58502
25905	55050	1465	227	1335	0	58077
25906	1657	698	54024	1047	0	57426
25907	849	532	54073	908	0	56362
25908	729	430	1570	54712	0	57441
25909	584	406	54614	1852	0	57456
25910	52734	414	1427	1139	0	55714
25911	1754	324	618	54858	0	57554
25912	909	319	55940	1858	0	59026
25913	749	349	55156	1062	0	57316
25914	619	57201	1549	879	0	60248
25915	57012	1327	693	823	0	59855
25916	1497	57718	482	804	0	60501
25917	57901	1336	435	889	0	60561
25918	58010	629	378	852	0	59869
25919	1699	56633	355	654	0	59341
25920	56332	1249	331	666	0	58578
25921	55529	578	264	663	0	57034
25922	1804	465	54983	555	0	57807
25923	1159	2371	1043	50741	0	55314
25924	609	49008	400	1012	0	51029
25925	414	49035	236	413	0	50098
25926	1128	1540	472	45387	0	48527
25927	43720	351	329	951	0	45351
25928	641	155	75	42949	0	43820
25929	342	100	77	44675	0	45194
25930	271	123	60	45869	0	46323
25931	193	47501	81	857	0	48632
25932	277	779	74	50188	0	51318
25933	175	297	51976	981	0	53429
25934	47914	169	881	539	0	49503
25935	52724	129	272	389	0	53514
25936	1139	51553	169	214	0	53075
25937	52387	916	100	245	0	53648
25938	1277	312	86	52818	0	54493
25939	450	205	52471	1007	0	54133
25940	49804	129	904	521	0	51358
25941	1057	52959	286	273	0	54575
25942	538	961	144	52808	0	54451
25943	54406	310	123	1180	0	56019
25944	1012	54627	107	432	0	56178
25945	401	56291	101	286	0	57079
25946	56020	1237	82	366	0	57705
25947	1133	537	54278	182	0	56130
25948	54906	289	920	267	0	56382
25949	1321	238	326	55011	0	56896
25950	640	213	185	55567	0	56605
25951	431	203	55085	1270	0	56989
25952	348	189	53875	530	0	54942
25953	400	170	1278	54986	0	56834
25954	353	127	54001	1179	0	55660
25955	319	192	54113	514	0	55138
25956	456	196	1317	53467	0	55436
25957	407	166	539	55676	0	56788
25958	55526	185	387	1438	0	57536
25959	1265	189	311	55814	0	57579
25960	55858	187	242	1422	0	57709
25961	1246	55756	248	655	0	57905
25962	722	1059	217	56404	0	58402
25963	428	440	58904	1262	0	61034
25964	57799	258	1076	780	0	59913
25965	60968	229	475	562	0	62234
25966	61510	218	347	453	0	62528
25967	60767	174	292	463	0	61696
25968	60606	184	313	432	0	61535
25969	1769	135	282	59252	0	61438
25970	800	142	58084	1294	0	60320
25971	599	144	56774	652	0	58169
25972	526	146	59298	468	0	60438
25973	57184	153	1516	566	0	59419
25974	60907	135	685	470	0	62197
25975	1692	165	455	58514	0	60826
25976	782	61522	381	1174	0	63859
25977	650	1072	346	62732	0	64800
25978	529	408	62805	1436	0	65178
25979	570	260	60993	656	0	62479
25980	58549	209	1495	698	0	60951
25981	1574	183	64599	410	0	66766
25982	888	176	1447	64555	0	67066
25983	68477	171	659	1676	0	70983
25984	63903	249	539	987	0	65678
25985	70520	168	451	599	0	71738
25986	71327	158	428	532	0	72445
25987	2174	174	69162	384	0	71894
25988	67043	152	1455	536	0	69186
25989	1926	69023	696	420	0	72065
25990	1149	1300	493	70514	0	73456
25991	823	541	71018	1480	0	73862
25992	843	351	1572	70140	0	72906
25993	720	296	72691	1665	0	75372
25994	765	265	1709	71173	0	73912
25995	718	277	827	73211	0	75033
25996	636	305	71998	2010	0	74949
25997	772	240	1662	71237	0	73911
25998	72131	207	881	2045	0	75264
25999	1873	191	638	72988	0	75690
26000	1051	185	592	74123	0	75951
26001	72872	219	542	2265	0	75898
26002	1852	73088	549	1097	0	76586
26003	73868	1348	514	927	0	76657
26004	1956	74615	493	683	0	77747
26005	76855	1494	486	866	0	79701
26006	2030	639	77144	649	0	80462
26007	1160	392	1639	76539	0	79730
26008	876	333	800	78380	0	80389
26009	77409	278	602	2245	0	80534
26010	1797	76979	589	1160	0	80525
26011	1064	1406	539	75825	0	78834
26012	813	536	552	76266	0	78167
26013	627	73893	508	2133	0	77161
26014	73503	1344	451	1299	0	76597
26015	1752	73996	513	853	0	77114
26016	1030	1425	388	73928	0	76771
26017	916	608	439	72221	0	74184
26018	711	72226	418	1984	0	75339
26019	71500	1399	388	1288	0	74575
26020	1859	639	70437	851	0	73786
26021	67649	486	1455	859	0	70449
26022	1876	70060	710	718	0	73364
26023	1022	1342	469	70116	0	72949
26024	70686	584	410	1705	0	73385
26025	1849	390	398	70434	0	73071
26026	1064	334	344	71085	0	72827
26027	70008	271	362	2198	0	72839
26028	1705	68004	353	1057	0	71119
26029	863	69361	319	745	0	71288
26030	68261	1238	320	798	0	70617
26031	1465	486	69048	558	0	71557
26032	630	65697	941	455	0	67723
26033	881	1010	573	67432	0	69896
26034	431	423	75717	888	0	77459
26035	454	326	1210	73366	0	75356
26036	74388	210	521	1548	0	76667
26037	1290	76438	301	683	0	78712
26038	858	1219	280	72756	0	75113
26039	404	76738	268	1104	0	78514
26040	76915	1335	175	767	0	79192
26041	78427	650	186	656	0	79919
26042	1730	79682	186	511	0	82109
26043	1002	1353	123	77265	0	79743
26044	469	79970	162	1380	0	81981
26045	80371	1566	144	837	0	82918
26046	81112	706	182	579	0	82579
26047	2170	449	180	80169	0	82968
26048	1113	404	125	81662	0	83304
26049	676	377	79610	2043	0	82706
26050	73245	320	1447	1300	0	76312
26051	1740	405	79372	630	0	82147
26052	1072	294	1603	78168	0	81137
26053	78921	254	714	1806	0	81695
26054	1722	80184	385	863	0	83154
26055	76316	1628	288	892	0	79124
26056	1794	888	71369	598	0	74649
26057	73927	461	1086	723	0	76197
26058	1959	79024	488	527	0	81998
26059	79433	1593	358	691	0	82075
26060	1967	81514	287	544	0	84312
26061	1078	1888	253	80911	0	84130
26062	703	895	79840	1734	0	83172
26063	717	646	75684	753	0	77800
26064	868	486	1892	76277	0	79523
26065	592	478	78008	1831	0	80909
26066	739	405	1748	76803	0	79695
26067	785	390	778	76870	0	78823
26068	521	418	79439	2228	0	82606
26069	66109	331	1815	1631	0	69886
26070	77758	386	769	955	0	79868
26071	2151	77128	443	653	0	80375
26072	77071	1544	356	587	0	79558
26073	2028	696	297	76845	0	79866
26074	936	455	78982	1782	0	82155
26075	776	388	1583	77912	0	80659
26076	727	333	740	79650	0	81450
26077	77276	301	461	2209	0	80247
26078	1543	75759	387	1111	0	78800
26079	826	76718	286	754	0	78584
26080	692	1686	304	77128	0	79810
26081	665	746	332	75576	0	77319
26082	533	74853	331	1791	0	77508
26083	614	1485	248	73231	0	75578
26084	590	725	246	72536	0	74097
26085	400	71323	223	2010	0	73956
26086	69993	1335	256	1111	0	72695
26087	1386	582	312	70391	0	72671
26088	648	70331	265	1650	0	72894
26089	687	1372	224	70640	0	72923
26090	69463	651	212	1812	0	72138
26091	1379	69448	229	917	0	71973
26092	69960	1520	169	846	0	72495
26093	69987	755	163	834	0	71739
26094	2005	540	144	70320	0	73009
26095	72326	537	160	1830	0	74853
26096	74060	451	154	1196	0	75861
26097	74584	416	146	889	0	76035
26098	75315	425	200	721	0	76661
26099	2373	331	162	75017	0	77883
26100	1241	353	165	76688	0	78447
26101	791	399	75305	2078	0	78573
26102	894	284	1279	76959	0	79416
26103	861	308	539	78346	0	80054
26104	677	385	76864	2284	0	80210
26105	73761	310	1567	1364	0	77002
26106	2115	264	611	77860	0	80850
26107	1067	345	79610	2103	0	83125
26108	75086	278	1787	1421	0	78572
26109	2388	285	86176	861	0	89710
26110	1169	87936	2058	833	0	91996
26111	882	93466	876	771	0	95995
26112	1044	2344	582	98436	0	102406
26113	635	1001	109299	2571	0	113506
26114	106878	624	2476	1745	0	111723
26115	116177	448	1048	1470	0	119143
26116	3344	401	115693	876	0	120314
26117	114556	354	2671	1111	0	118692
26118	117602	333	1225	1118	0	120278
26119	3456	118076	1066	730	0	123328
26120	119443	2361	774	864	0	123442
26121	3404	948	923	118118	0	123393
26122	1562	897	119693	2650	0	124802
26123	1618	847	2527	110110	0	115102
26124	960	120034	1281	2679	0	124954
26125	1157	125263	1119	1257	0	128796
26126	124559	3017	783	1159	0	129518
26127	124240	1326	858	1054	0	127478
26128	124068	1052	1039	950	0	127109
26129	4349	920	691	121613	0	127573
26130	2484	1122	762	116406	0	120774
26131	1607	118630	831	3145	0	124213
26132	117358	2670	772	2024	0	122824
26133	3582	119329	1026	1500	0	125437
26134	109745	2103	897	954	0	113699
26135	3373	110880	891	800	0	115944
26136	110911	2392	1027	805	0	115135
26137	106981	1251	601	884	0	109717
26138	4090	1188	584	105300	0	111162
26139	2394	109694	697	2098	0	114883
26140	2347	2251	103853	1212	0	109663
26141	99992	1246	1796	1773	0	104807
26142	2743	100171	923	1097	0	104934
26143	1694	2538	104992	982	0	110206
26144	1473	1525	105158	886	0	109042
26145	1845	1436	1970	99377	0	104628
26146	2191	1036	559	97291	0	101077
26147	1631	105512	376	2011	0	109530
26148	107539	2283	239	1347	0	111408
26149	3153	1215	236	103368	0	107972
26150	1840	105341	298	2201	0	109680
26151	1730	109661	344	1041	0	112776
26152	1697	2533	106948	978	0	112156
26153	1684	1760	106208	817	0	110469
26154	102809	1595	1957	876	0	107237
26155	2965	1328	108283	631	0	113207
26156	2154	1250	2039	105484	0	110927
26157	1869	1151	895	109805	0	113720
26158	1299	1260	109174	2586	0	114319
26159	1635	1427	2046	105768	0	110876
26160	1819	1046	1398	99891	0	104154
26161	105309	1095	1122	2857	0	110383
26162	107347	1468	1363	1471	0	111649
26163	2698	1024	1577	105414	0	110713
26164	1478	104583	1603	2397	0	110061
26165	1172	110031	1358	1678	0	114239
26166	109921	2439	1305	1655	0	115320
26167	2570	1574	109873	1456	0	115473
26168	1901	1164	2292	109072	0	114429
26169	111044	1313	1469	3193	0	117019
26170	111826	1574	1493	1712	0	116605
26171	3247	1292	1323	110893	0	116755
26172	1747	1216	111145	2878	0	116986
26173	2148	1341	103774	1503	0	108766
26174	101189	1112	3204	1948	0	107453
26175	106049	1053	2260	2029	0	111391
26176	3389	106696	1761	1853	0	113699
26177	2391	108894	1651	1968	0	114904
26178	110643	2553	1771	2155	0	117122
26179	111120	1442	1476	2441	0	116479
26180	4184	1223	1183	111767	0	118357
26181	3380	1096	1358	113230	0	119064
26182	3142	1153	1097	114483	0	119875
26183	113071	1262	1127	3883	0	119343
26184	4394	1639	1214	113039	0	120286
26185	3147	1495	113102	2891	0	120635
26186	111241	1350	2502	2199	0	117292
26187	4177	1577	1491	113364	0	120609
26188	2881	1720	114078	3063	0	121742
26189	109603	1584	2423	2298	0	115908
26190	98088	1760	1625	2292	0	103765
26191	3696	115984	1398	2064	0	123142
26192	2855	119109	1598	1616	0	125178
26193	2861	3073	105538	1790	0	113262
26194	112401	1915	2065	2171	0	118552
26195	4227	118454	1306	1582	0	125569
26196	3041	3206	106529	1770	0	114546
26197	109298	1738	2022	2058	0	115116
26198	4317	118811	898	1915	0	125941
26199	2532	2978	116087	2186	0	123783
26200	110284	1776	2328	2399	0	116787
26201	4053	116319	998	2024	0	123394
26202	2539	2398	846	113503	0	119286
26203	112988	1295	1132	3305	0	118720
26204	3157	112625	1060	2173	0	119015
26205	2130	2662	1173	110576	0	116541
26206	109580	833	1178	3036	0	114627
26207	2547	651	108515	1764	0	113477
26208	1481	104407	2328	1203	0	109419
26209	1529	1721	101318	985	0	105553
26210	1227	1609	1806	94361	0	99003
26211	896	650	94872	1423	0	97841
26212	721	86932	1217	681	0	89551
26213	390	79467	572	306	0	80735
26214	644	1150	495	76653	0	78942
26215	362	276	214	72236	0	73088
26216	337	176	199	73535	0	74247
26217	229	197	74513	907	0	75846
26218	343	155	814	73959	0	75271
26219	73330	184	228	1129	0	74871
26220	71809	189	188	601	0	72787
26221	962	163	74600	289	0	76014
26222	344	72733	777	288	0	74142
26223	71389	721	257	514	0	72881
26224	808	71405	244	336	0	72793
26225	70371	761	197	516	0	71845
26226	70592	259	151	451	0	71453
26227	1031	217	70315	256	0	71819
26228	390	71388	846	223	0	72847
26229	415	827	216	71688	0	73146
26230	317	273	72251	855	0	73696
26231	67298	292	868	485	0	68943
26232	1140	239	226	71135	0	72740
26233	417	192	69936	803	0	71348
26234	66694	140	872	506	0	68212
26235	1003	230	72620	178	0	74031
26236	538	214	931	72356	0	74039
26237	72998	160	340	1180	0	74678
26238	1019	75143	240	375	0	76777
26239	460	930	75251	246	0	76887
26240	72299	282	978	477	0	74036
26241	78739	182	371	404	0	79696
26242	1284	80872	326	246	0	82728
26243	658	1077	199	80979	0	82913
26244	546	327	180	81271	0	82324
26245	80384	270	154	1536	0	82344
26246	1374	211	230	81219	0	83034
26247	517	215	81857	1298	0	83887
26248	590	160	1216	80222	0	82188
26249	79880	197	398	1678	0	82153
26250	1272	80140	295	652	0	82359
26251	676	1255	181	75826	0	77938
26252	377	78085	198	1251	0	79911
26253	78898	1383	194	714	0	81189
26254	1576	420	226	82945	0	85167
26255	776	279	189	83280	0	84524
26256	451	84331	228	1839	0	86849
26257	349	1648	82755	789	0	85541
26258	588	544	1591	81374	0	84097
26259	492	414	476	83578	0	84960
26260	589	299	330	82217	0	83435
26261	294	82550	283	2023	0	85150
26262	316	1615	82489	885	0	85305
26263	322	628	82284	565	0	83799
26264	80031	399	1939	716	0	83085
26265	82597	283	659	699	0	84238
26266	2045	282	83014	447	0	85788
26267	79553	226	1686	786	0	82251
26268	1895	286	84795	498	0	87474
26269	79909	245	1936	716	0	82806
26270	1907	85695	787	405	0	88794
26271	87145	1692	531	693	0	90061
26272	2178	604	89534	432	0	92748
26273	893	421	91283	453	0	93050
26274	900	297	2376	99988	0	103561
26275	102640	327	958	2881	0	106806
26276	2773	110202	702	910	0	114587
26277	1063	2980	120633	554	0	125230
26278	1484	811	3504	119529	0	125328
26279	1036	503	1179	126858	0	129576
26280	124716	369	806	4491	0	130382
26281	126788	316	659	1720	0	129483
26282	4960	306	518	124623	0	130407
26283	125578	421	449	4247	0	130695
26284	4402	449	123067	1286	0	129204
26285	2046	335	3770	120199	0	126350
26286	1406	307	1260	126291	0	129264
26287	124026	347	786	4970	0	130129
26288	125225	336	596	1991	0	128148
26289	5240	372	484	123415	0	129511
26290	122546	356	584	4540	0	128026
26291	4559	316	119089	1640	0	125604
26292	1676	118098	3732	1362	0	124868
26293	1168	3477	119456	1160	0	125261
26294	1579	1420	3938	119511	0	126448
26295	116639	600	1435	4519	0	123193
26296	4239	116650	910	1714	0	123513
26297	2010	3630	733	115280	0	121653
26298	1596	1117	793	113038	0	116544
26299	1047	114605	752	4621	0	121025
26300	1294	3855	739	116688	0	122576
26301	1498	1342	744	118236	0	121820
26302	1488	717	656	120239	0	123100
26303	1450	633	590	119613	0	122286
26304	1506	497	694	116795	0	119492
26305	1021	113650	787	5553	0	121011
26306	1301	3663	675	115630	0	121269
26307	1386	1242	691	117778	0	121097
26308	1154	802	112099	5647	0	119702
26309	1121	111644	3813	2653	0	119231
26310	1357	3891	1277	112476	0	119001
26311	1352	1249	923	114067	0	117591
26312	1408	934	819	112307	0	115468
26313	1072	110078	758	5745	0	117653
26314	1204	3738	110482	2985	0	118409
26315	1443	1333	3919	112660	0	119355
26316	1100	1010	111158	5236	0	118504
26317	1087	826	110249	2686	0	114848
26318	1208	748	4641	110354	0	116951
26319	109692	728	1804	5499	0	117723
26320	4224	831	1200	109910	0	116165
26321	1901	750	1024	108282	0	111957
26322	1319	108575	1019	5595	0	116508
26323	1370	3774	888	112177	0	118209
26324	1284	1331	926	115290	0	118831
26325	1002	969	113054	6184	0	121209
26326	993	112181	3873	3203	0	120250
26327	1125	3857	1625	114533	0	121140
26328	110552	1451	1228	5736	0	118967
26329	3921	1174	111577	3064	0	119736
26330	1828	1018	4056	111795	0	118697
26331	1380	895	1660	115688	0	119623
26332	110229	844	1217	6408	0	118698
26333	3966	110227	1065	3557	0	118815
26334	106855	3854	876	3191	0	114776
26335	4019	107138	892	2874	0	114923
26336	1857	3968	863	107116	0	113804
26337	104114	1536	909	5808	0	112367
26338	4037	1089	103767	3306	0	112199
26339	1789	100418	3750	2947	0	108904
26340	1428	103417	1694	2684	0	109223
26341	97571	4221	1391	2557	0	105740
26342	3957	1690	1180	94770	0	101597
26343	1690	93470	1081	5006	0	101247
26344	1403	98736	990	3217	0	104346
26345	1607	4068	863	97550	0	104088
26346	1436	1875	846	100015	0	104172
26347	94816	1427	864	5875	0	102982
26348	3878	95064	951	3236	0	103129
26349	1880	3810	1088	94818	0	101596
26350	1311	1671	93452	5016	0	101450
26351	1210	92969	3659	3059	0	100897
26352	1192	3652	92381	2616	0	99841
26353	1168	92869	3551	2633	0	100221
26354	1540	3659	1693	88928	0	95820
26355	1372	1488	799	87817	0	91476
26356	1016	87827	783	4630	0	94256
26357	923	3463	87468	2792	0	94646
26358	86268	1685	3124	2528	0	93605
26359	3151	1495	1310	90634	0	96590
26360	1372	1372	978	93052	0	96774
26361	904	1392	90444	4975	0	97715
26362	1024	1390	3136	91383	0	96933
26363	769	1415	90834	4806	0	97824
26364	882	1400	3303	91084	0	96669
26365	711	1223	91857	4766	0	98557
26366	652	91610	3233	3091	0	98586
26367	627	3696	93479	2634	0	100436
26368	864	1678	3257	92680	0	98479
26369	90130	1312	1274	4944	0	97660
26370	3003	88813	980	2783	0	95579
26371	1434	3708	976	87209	0	93327
26372	889	1611	84875	4190	0	91565
26373	621	85208	3348	2300	0	91477
26374	820	3101	1133	73065	0	78119
26375	496	1180	73303	2817	0	77796
26376	379	64228	1918	1159	0	67684
26377	51014	1819	1398	896	0	55127
26378	48158	439	488	584	0	49669
26379	1050	239	236	47934	0	49459
26380	47927	222	215	1071	0	49435
26381	1005	158	195	47416	0	48774
26382	404	182	177	48421	0	49184
26383	264	214	48996	1152	0	50626
26384	347	198	844	47715	0	49104
26385	311	172	298	49210	0	49991
26386	47691	167	205	1315	0	49378
26387	46509	127	168	696	0	47500
26388	988	47227	163	415	0	48793
26389	364	866	47565	315	0	49110
26390	329	390	879	46643	0	48241
26391	216	238	46326	963	0	47743
26392	41061	176	826	618	0	42681
26393	922	137	44374	314	0	45747
26394	468	126	746	42321	0	43661
26395	211	43433	296	797	0	44737
26396	228	709	246	43415	0	44598
26397	194	241	204	43689	0	44328
26398	148	149	44379	1029	0	45705
26399	287	107	765	43878	0	45037
26400	43418	118	319	1060	0	44915
26401	43502	111	210	580	0	44403
26402	43425	141	197	440	0	44203
26403	43533	126	190	471	0	44320
26404	889	42302	205	404	0	43800
26405	330	42529	262	355	0	43476
26406	503	802	262	37578	0	39145
26407	308	301	210	41905	0	42724
26408	283	39022	192	951	0	40448
26409	287	696	156	42566	0	43705
26410	283	332	150	42953	0	43718
26411	247	248	194	42699	0	43388
26412	228	199	208	42781	0	43416
26413	242	189	207	43329	0	43967
26414	41722	159	170	1316	0	43367
26415	821	41406	192	601	0	43020
26416	417	777	41190	479	0	42863
26417	385	328	734	41167	0	42614
26418	283	290	312	42184	0	43069
26419	247	236	217	42392	0	43092
26420	42547	200	217	1420	0	44384
26421	885	48901	188	707	0	50681
26422	562	1413	210	48830	0	51015
26423	322	51202	225	1829	0	53578
26424	458	1889	210	49037	0	51594
26425	269	49025	171	2080	0	51545
26426	311	1946	51208	943	0	54408
26427	439	676	2041	53606	0	56762
26428	315	496	61576	2507	0	64894
26429	472	352	2703	60780	0	64307
26430	470	352	914	66262	0	67998
26431	64557	364	547	3998	0	69466
26432	66141	348	398	1812	0	68699
26433	67640	315	399	1203	0	69557
26434	67537	350	369	992	0	69248
26435	68167	293	445	919	0	69824
26436	4148	364	417	63053	0	67982
26437	1516	65296	407	3245	0	70464
26438	1216	2884	303	64521	0	68924
26439	854	984	62407	3582	0	67827
26440	62135	600	2670	1630	0	67035
26441	66731	375	952	1113	0	69171
26442	4262	257	553	64232	0	69304
26443	1960	290	350	64157	0	66757
26444	1197	61891	316	3902	0	67306
26445	1009	2813	255	64162	0	68239
26446	948	1019	366	64098	0	66431
26447	916	62484	384	3939	0	67723
26448	1063	2824	356	64624	0	68867
26449	59527	993	293	4210	0	65023
26450	3113	727	61469	1801	0	67110
26451	60141	562	2698	1704	0	65105
26452	3395	574	62059	1275	0	67303
26453	1462	490	3119	60712	0	65783
26454	1114	456	1082	59985	0	62637
26455	793	58054	652	4081	0	63580
26456	806	62905	468	1931	0	66110
26457	1057	3460	421	58485	0	63423
26458	881	1222	59799	3558	0	65460
26459	57126	665	2867	1627	0	62285
26460	3309	447	1055	57966	0	62777
26461	1253	57458	730	3552	0	62993
26462	1143	2796	400	58797	0	63136
26463	897	1228	306	58697	0	61128
26464	781	56869	280	3823	0	61753
26465	967	2844	393	54899	0	59103
26466	778	871	51386	3202	0	56237
26467	716	621	51712	1362	0	54411
26468	774	640	2637	46867	0	50918
26469	405	50426	939	2618	0	54388
26470	429	2489	563	51310	0	54791
26471	50878	1022	354	3193	0	55447
26472	52947	689	288	1620	0	55544
26473	50615	506	371	1279	0	52771
26474	3042	49267	446	920	0	53675
26475	1197	2360	49243	884	0	53684
26476	48316	1028	2409	954	0	52707
26477	51181	815	869	1012	0	53877
26478	3066	49721	554	1019	0	54360
26479	1430	2514	402	49900	0	54246
26480	50357	1105	355	2902	0	54719
26481	51748	762	423	1496	0	54429
26482	52751	682	529	1061	0	55023
26483	3706	505	621	49142	0	53974
26484	50830	421	550	3071	0	54872
26485	3457	425	488	50364	0	54734
26486	1778	497	390	52332	0	54997
26487	50578	590	334	3799	0	55301
26488	3438	528	381	50597	0	54944
26489	50638	513	406	3534	0	55091
26490	3730	539	438	50423	0	55130
26491	1979	536	393	52845	0	55753
26492	50101	596	366	4277	0	55340
26493	3435	580	50298	2346	0	56659
26494	2028	531	2449	52413	0	57421
26495	1919	504	967	53716	0	57106
26496	1798	404	640	54054	0	56896
26497	1666	447	504	54923	0	57540
26498	1499	469	384	53339	0	55691
26499	1343	50605	449	4415	0	56812
26500	1434	2554	525	52503	0	57016
26501	1432	1092	50756	3831	0	57111
26502	1534	778	2480	52456	0	57248
26503	1441	546	918	54381	0	57286
26504	1398	585	543	55927	0	58453
26505	1147	673	51946	4612	0	58378
26506	1042	754	51677	2655	0	56128
26507	50301	690	3055	2222	0	56268
26508	53672	619	1420	1908	0	57619
26509	3527	54824	886	1830	0	61067
26510	1888	2736	610	58337	0	63571
26511	1329	1236	503	62157	0	65225
26512	1031	836	679	63113	0	65659
26513	60529	701	750	4669	0	66649
26514	63349	561	809	2669	0	67388
26515	3693	510	657	62988	0	67848
26516	1837	758	566	63908	0	67069
26517	1341	800	460	64776	0	67377
26518	1024	746	553	64725	0	67048
26519	60461	662	635	4897	0	66655
26520	2948	560	58904	2671	0	65083
26521	1198	48864	1706	1814	0	53582
26522	818	49111	654	1244	0	51827
26523	47483	1460	411	1247	0	50601
26524	1623	1504	455	46920	0	50502
26525	710	576	46212	2121	0	49619
26526	567	432	41657	1336	0	43992
26527	373	45293	1084	1038	0	47788
26528	38160	421	463	446	0	39490
26529	444	131	38117	261	0	38953
26530	34168	81	243	198	0	34690
26531	203	38	68	36482	0	36791
26532	141	26	25	37161	0	37353
26533	63	36831	32	249	0	37175
26534	61	36360	30	156	0	36607
26535	37700	133	15	221	0	38069
26536	37579	56	43	185	0	37863
26537	182	38153	32	107	0	38474
26538	378	154	36952	443	0	37927
26539	87	98	37784	90	0	38059
26540	109	49	178	38444	0	38780
26541	40058	32	111	285	0	40486
26542	166	39930	81	139	0	40316
26543	137	143	48	41664	0	41992
26544	41919	86	40	300	0	42345
26545	238	66	56	42471	0	42831
26546	160	41	33	43182	0	43416
26547	42899	29	33	423	0	43384
26548	205	42797	46	229	0	43277
26549	131	44636	50	139	0	44956
26550	119	286	45889	95	0	46389
26551	142	150	191	46579	0	47062
26552	181	65	117	46523	0	46886
26553	71	83	49007	336	0	49497
26554	40756	43	236	619	0	41654
26555	44625	34	143	344	0	45146
26556	312	64	48640	120	0	49136
26557	39566	59	254	458	0	40337
26558	295	77	48974	74	0	49420
26559	166	50623	255	94	0	51138
26560	185	197	134	54273	0	54789
26561	145	135	77	56493	0	56850
26562	56738	72	63	567	0	57440
26563	56136	58	58	387	0	56639
26564	56045	47	70	272	0	56434
26565	56445	49	47	253	0	56794
26566	55799	51	66	273	0	56189
26567	369	83	54881	101	0	55434
26568	205	55492	227	132	0	56056
26569	174	202	127	56302	0	56805
26570	97	55828	87	224	0	56236
26571	95	56931	63	160	0	57249
26572	146	276	67	56867	0	57356
26573	143	163	42	57331	0	57679
26574	115	106	57053	275	0	57549
26575	50658	59	232	488	0	51437
26576	56746	57	135	268	0	57206
26577	290	56506	110	137	0	57043
26578	56878	197	56	250	0	57381
26579	57632	123	57	254	0	58066
26580	352	71	54	57698	0	58175
26581	228	85	60017	222	0	60552
26582	167	82	58435	147	0	58831
26583	58958	48	231	307	0	59544
26584	60853	35	136	263	0	61287
26585	351	60346	86	83	0	60866
26586	232	62547	65	71	0	62915
26587	191	345	41	63913	0	64490
26588	63803	202	35	488	0	64528
26589	309	146	64239	187	0	64881
26590	267	62	284	65029	0	65642
26591	66277	54	168	556	0	67055
26592	66235	52	106	435	0	66828
26593	520	57	65	67107	0	67749
26594	66897	49	59	636	0	67641
26595	445	64	64391	215	0	65115
26596	295	101	68381	146	0	68923
26597	377	51	469	66732	0	67629
26598	226	36	255	72018	0	72535
26599	200	68	152	71938	0	72358
26600	139	69473	103	507	0	70222
26601	120	71913	81	311	0	72425
26602	197	440	47	73421	0	74105
26603	72931	239	96	676	0	73942
26604	410	145	82	73704	0	74341
26605	302	78	85	73296	0	73761
26606	154	72201	83	544	0	72982
26607	109	74876	83	358	0	75426
26608	175	441	63	75432	0	76111
26609	182	295	51	72417	0	72945
26610	70441	163	42	785	0	71431
26611	358	69078	56	360	0	69852
26612	69423	327	47	524	0	70321
26613	503	196	34	69766	0	70499
26614	279	186	67875	383	0	68723
26615	203	159	64226	285	0	64873
26616	66208	88	457	444	0	67197
26617	458	82	242	70732	0	71514
26618	329	76	143	70678	0	71226
26619	249	78	85	71688	0	72100
26620	150	109	72047	607	0	72913
26621	237	54	346	72319	0	72956
26622	124	70923	253	578	0	71878
26623	192	428	145	75396	0	76161
26624	249	208	86	75107	0	75650
26625	114	76376	105	689	0	77284
26626	203	579	61	79372	0	80215
26627	76859	238	61	1133	0	78291
26628	658	77159	118	411	0	78346
26629	79199	761	59	597	0	80616
26630	80096	308	61	473	0	80938
26631	1252	209	55	79879	0	81395
26632	706	129	45	78896	0	79776
26633	437	116	51	81124	0	81728
26634	222	127	78664	1340	0	80353
26635	198	75379	835	655	0	77067
26636	187	79413	325	474	0	80399
26637	299	988	145	78562	0	79994
26638	77239	359	100	1259	0	78957
26639	1089	214	83	76748	0	78134
26640	411	411	77188	1157	0	79167
26641	253	74877	820	571	0	76521
26642	170	77957	336	399	0	78862
26643	76694	1035	177	613	0	78519
26644	77939	404	154	578	0	79075
26645	1079	84271	145	279	0	85774
26646	85982	967	97	665	0	87711
26647	1246	409	84522	263	0	86440
26648	484	340	82229	257	0	83310
26649	84169	263	1330	485	0	86247
26650	87235	191	428	466	0	88320
26651	1707	170	231	86795	0	88903
26652	85842	184	143	1628	0	87797
26653	1553	191	85442	444	0	87630
26654	638	217	90531	342	0	91728
26655	1014	208	1753	99420	0	102395
26656	691	156	611	115896	0	117354
26657	638	115	344	120238	0	121335
26658	984	187	352	117424	0	118947
26659	811	130	202	129158	0	130301
26660	342	171	123977	5149	0	129639
26661	683	156	3252	123085	0	127176
26662	122348	131	1149	5232	0	128860
26663	3768	125	768	124604	0	129265
26664	123211	135	568	5393	0	129307
26665	4363	147	403	124674	0	129587
26666	124854	163	495	5500	0	131012
26667	129529	167	450	3119	0	133265
26668	5331	157	435	127284	0	133207
26669	2641	183	515	130923	0	134262
26670	127515	171	356	5944	0	133986
26671	128356	171	310	3296	0	132133
26672	5396	247	127440	2424	0	135507
26673	3432	168	3304	127715	0	134619
26674	2607	154	1095	134024	0	137880
26675	131275	176	803	5848	0	138102
26676	134687	182	555	3209	0	138633
26677	5826	159	431	134050	0	140466
26678	3247	157	531	136513	0	140448
26679	2640	156	480	137101	0	140377
26680	2166	170	507	135045	0	137888
26681	1436	125011	645	6589	0	133681
26682	1290	130310	489	3714	0	135803
26683	1662	3933	383	128328	0	134306
26684	1309	128341	471	5312	0	135433
26685	1487	3960	376	131491	0	137314
26686	934	1505	128386	6119	0	136944
26687	919	1235	124419	3618	0	130191
26688	842	129585	4081	3098	0	137606
26689	1261	3997	1649	129260	0	136167
26690	829	1835	128847	5331	0	136842
26691	1222	1452	3998	126240	0	132912
26692	1123	1075	1624	132502	0	136324
26693	126520	918	1413	6609	0	135460
26694	4372	868	1208	129927	0	136375
26695	1846	812	129638	6035	0	138331
26696	1710	704	126354	3348	0	132116
26697	1521	121957	4731	3038	0	131247
26698	1322	133460	2292	2885	0	139959
26699	133551	4080	1861	2970	0	142462
26700	4646	1589	145770	2621	0	154626
26701	2614	1121	4332	145895	0	153962
26702	147389	798	1949	5860	0	155996
26703	147933	694	1747	3537	0	153911
26704	5289	150292	1610	2682	0	159873
26705	3454	3989	1270	145515	0	154228
26706	2642	1608	1115	157990	0	163355
26707	2238	1341	964	157395	0	161938
26708	152884	959	960	7140	0	161943
26709	4893	841	151182	4030	0	160946
26710	2453	154334	3933	3468	0	164188
26711	2676	4108	1515	153669	0	161968
26712	2201	1758	1289	160789	0	166037
26713	1590	1642	156849	6804	0	166885
26714	1870	1077	4089	155767	0	162803
26715	1664	970	1755	162576	0	166965
26716	1678	995	1544	162844	0	167061
26717	1651	959	1365	162771	0	166746
26718	1108	1079	156203	8318	0	166708
26719	1287	993	4408	157499	0	164187
26720	1071	877	157588	7998	0	167534
26721	1022	154886	5075	5082	0	166065
26722	1414	3590	2455	158520	0	165979
26723	1475	1450	1840	162933	0	167698
26724	1304	1195	156745	7875	0	167119
26725	1296	151992	4297	5426	0	163011
26726	1721	3712	2187	153370	0	160990
26727	1637	1589	153244	6208	0	162678
26728	1461	150760	4118	4344	0	160683
26729	1547	3804	2013	153381	0	160745
26730	1594	1715	152764	5926	0	161999
26731	2024	1529	4132	150523	0	158208
26732	1822	1205	2177	150242	0	155446
26733	1440	1161	2052	157562	0	162215
26734	151729	1257	1463	7166	0	161615
26735	4011	151576	1329	4660	0	161576
26736	151608	3579	1429	4111	0	160727
26737	4573	1669	152133	3631	0	162006
26738	149832	1356	3826	4340	0	159354
26739	161059	1136	1810	4029	0	168034
26740	5152	963	1526	161076	0	168717
26741	162474	1157	1255	6464	0	171350
26742	164536	1278	1064	4330	0	171208
26743	169141	1137	1040	4209	0	175527
26744	5689	1287	1065	167427	0	175468
26745	3376	1056	1033	164018	0	169483
26746	2242	930	157138	5771	0	166081
26747	2051	804	148603	3635	0	155093
26748	149430	878	3842	3487	0	157637
26749	4007	1379	2189	155157	0	162732
26750	2054	156602	1990	4434	0	165080
26751	156532	2798	1690	3479	0	164499
26752	3628	154800	1311	3071	0	162810
26753	1863	154760	1313	2937	0	160873
26754	2276	3701	144390	2669	0	153036
26755	1078	912	138917	1391	0	142298
26756	1412	2071	2470	135348	0	141301
26757	717	538	145235	1848	0	148338
26758	445	376	133290	769	0	134880
26759	121965	178	641	911	0	123695
26760	133164	134	309	727	0	134334
26761	600	143	257	135003	0	136003
26762	450	133	229	135280	0	136092
26763	265	231	138432	600	0	139528
26764	178	139127	491	406	0	140202
26765	381	449	250	136914	0	137994
26766	145065	170	217	1280	0	146732
26767	656	171	167	146757	0	147751
26768	225	148841	211	736	0	150013
26769	281	535	147471	369	0	148656
26770	155	151668	528	416	0	152767
26771	150781	571	250	845	0	152447
26772	147976	194	194	775	0	149139
26773	893	205	173	148158	0	149429
26774	376	205	150900	653	0	152134
26775	353	219	139510	372	0	140454
26776	176	149614	790	343	0	150923
26777	740	698	410	139791	0	141639
26778	353	250	212	151502	0	152317
26779	226	281	150789	840	0	152136
26780	572	90	693	146872	0	148227
26781	154	158181	342	880	0	159557
26782	389	1005	255	159753	0	161402
26783	411	355	161	160294	0	161221
26784	212	355	160505	1406	0	162478
26785	584	175	1177	154232	0	156168
26786	154184	130	466	2026	0	156806
26787	1267	178	159055	516	0	161016
26788	556	221	154834	379	0	155990
26789	263	161260	1740	284	0	163547
26790	520	1384	713	164738	0	167355
26791	529	447	303	171716	0	172995
26792	171	337	170161	1968	0	172637
26793	153788	113	1763	1678	0	157342
26794	1884	140	701	170180	0	172905
26795	724	368	168974	1695	0	171761
26796	851	143	1776	161179	0	163949
26797	228	228	168438	1955	0	170849
26798	267	232	161011	923	0	162433
26799	189	163546	2326	648	0	166709
26800	735	1591	988	149387	0	152701
26801	178	157312	583	1574	0	159647
26802	149684	1763	391	1518	0	153356
26803	1601	834	155275	469	0	158179
26804	615	152315	1843	495	0	155268
26805	613	1662	894	151224	0	154393
26806	148885	726	583	2499	0	152693
26807	1565	150964	467	953	0	153949
26808	979	1786	392	152250	0	155407
26809	664	810	354	152322	0	154150
26810	224	157537	449	2365	0	160575
26811	157093	2190	416	1741	0	161440
26812	2552	950	397	177601	0	181500
26813	1250	565	322	186499	0	188636
26814	525	527	183532	4586	0	189170
26815	300	189093	3611	2045	0	195049
26816	940	3846	1445	188089	0	194320
26817	1036	1529	770	199927	0	203262
26818	287	206293	555	5150	0	212285
26819	1012	4783	424	205638	0	211857
26820	1096	1839	373	211328	0	214636
26821	1084	963	1896	209260	0	213203
26822	242	212133	592	6670	0	219637
26823	205556	4965	447	3840	0	214808
26824	4897	2073	210693	1733	0	219396
26825	196463	1063	4910	2639	0	205075
26826	5246	210643	2028	1395	0	219312
26827	2525	5023	1151	209077	0	217776
26828	1063	2253	211503	5586	0	220405
26829	1578	1363	5109	207484	0	215534
26830	1378	956	2137	209622	0	214093
26831	1356	834	1233	215966	0	219389
26832	717	983	211909	7540	0	221149
26833	573	207755	5297	3982	0	217607
26834	585	5127	212294	2467	0	220473
26835	528	212790	5940	2250	0	221508
26836	598	5873	215972	1824	0	224267
26837	1440	2418	6063	211072	0	220993
26838	206236	1542	2669	7537	0	217984
26839	4766	214120	1748	3485	0	224119
26840	1858	5773	215203	2496	0	225330
26841	1052	214301	5646	2215	0	223214
26842	844	6377	214981	1947	0	224149
26843	1666	2885	6338	201222	0	212111
26844	1798	1969	2769	197601	0	204137
26845	877	204827	1998	7182	0	214884
26846	840	215703	1756	3742	0	222041
26847	210432	7529	1534	3395	0	222890
26848	6096	3580	1739	212733	0	224148
26849	2372	2604	214026	7042	0	226044
26850	2246	1905	6282	210267	0	220700
26851	1206	1769	214687	8120	0	225782
26852	1081	1934	213798	4307	0	221120
26853	1949	1902	7855	199062	0	210768
26854	1003	210466	3808	6661	0	221938
26855	202829	6553	2497	4579	0	216458
26856	6189	3125	2172	199378	0	210864
26857	3101	2350	2074	192283	0	199808
26858	1509	199433	2079	8261	0	211282
26859	195023	6800	1885	5015	0	208723
26860	198841	3493	1957	3702	0	207993
26861	7865	2527	1931	192205	0	204528
26862	3320	192191	1994	7536	0	205041
26863	1838	204811	2236	4284	0	213169
26864	196818	7919	1924	4142	0	210803
26865	5953	4172	198265	2980	0	211370
26866	186734	2928	6710	3202	0	199574
26867	191741	2402	3276	3099	0	200518
26868	190692	2240	2281	3293	0	198506
26869	7930	187662	1817	2890	0	200299
26870	3970	6772	1801	188009	0	200552
26871	187461	3526	1945	7657	0	200589
26872	187793	2678	1825	4574	0	196870
26873	7421	188393	2132	3271	0	201217
26874	189135	6539	1702	3142	0	200518
26875	7138	3611	1722	190275	0	202746
26876	3762	2711	1660	189507	0	197640
26877	2310	189247	1810	8058	0	201425
26878	2606	6659	1594	191765	0	202624
26879	2818	3530	1653	192835	0	200836
26880	2260	190544	1627	8578	0	203009
26881	2529	5985	1428	175956	0	185898
26882	1872	185927	1497	7327	0	196623
26883	183297	6715	1695	4435	0	196142
26884	177754	3553	1767	3885	0	186959
26885	6729	181196	1514	3292	0	192731
26886	3461	6038	178297	2954	0	190750
26887	2829	3774	4896	177164	0	188663
26888	2274	3006	177113	6266	0	188659
26889	2027	168973	5367	4181	0	180548
26890	2027	175586	2514	3328	0	183455
26891	164594	6049	1775	2786	0	175204
26892	5543	171207	1504	1981	0	180235
26893	3702	5650	1492	162284	0	173128
26894	2362	166344	1632	4837	0	175175
26895	2357	173497	1238	2923	0	180015
26896	168636	6594	1214	2854	0	179298
26897	5778	3274	1209	169499	0	179760
26898	3067	2628	168254	5554	0	179503
26899	2284	2295	164837	3527	0	172943
26900	1982	169613	5462	2843	0	179900
26901	166249	5801	2535	2847	0	177432
26902	5182	171031	2105	1806	0	180124
26903	3180	6489	1326	171743	0	182738
26904	171868	3408	1453	5929	0	182658
26905	6020	2714	1195	174142	0	184071
26906	3270	2399	1337	174353	0	181359
26907	2441	174621	1145	6958	0	185165
26908	2851	5837	1116	176253	0	186057
26909	1721	3606	178524	5953	0	189804
26910	170438	2329	4872	3974	0	181613
26911	5583	180972	2127	2586	0	191268
26912	1911	173526	1075	1537	0	178049
26913	162526	4631	627	1610	0	169394
26914	4546	2111	165129	1037	0	172823
26915	151838	1609	4021	1779	0	159247
26916	4225	178695	1394	979	0	185293
26917	1243	192694	797	798	0	195532
26918	969	5771	191032	549	0	198321
26919	776	194505	4828	695	0	200804
26920	1927	5437	1934	173711	0	183009
26921	1540	1937	858	180545	0	184880
26922	496	188155	437	4989	0	194077
26923	1282	5071	342	188370	0	195065
26924	188744	2094	405	5651	0	196894
26925	4741	1618	188094	1732	0	196185
26926	184518	1339	4521	2016	0	192394
26927	193551	1071	1649	1786	0	198057
26928	192980	1184	1060	1599	0	196823
26929	6753	1430	189241	898	0	198322
26930	3505	1002	4726	187598	0	196831
26931	1790	1360	191047	5125	0	199322
26932	180188	993	5870	2845	0	189896
26933	184102	1040	1936	2342	0	189420
26934	6736	188728	1344	1232	0	198040
26935	3986	5199	967	182591	0	192743
26936	2062	193777	1026	4998	0	201863
26937	1593	5862	194943	2177	0	204575
26938	2729	2234	5658	192257	0	202878
26939	190875	1358	2372	6381	0	200986
26940	194110	1031	1358	2717	0	199216
26941	8103	1227	1086	180743	0	191159
26942	3417	184985	929	5354	0	194685
26943	2092	5685	188375	2033	0	198185
26944	1444	2392	190852	1747	0	196435
26945	177970	1499	6939	2172	0	188580
26946	6560	1273	189485	1047	0	198365
26947	2959	187444	6277	1558	0	198238
26948	2595	5888	2333	184221	0	195037
26949	1538	2537	189811	5686	0	199572
26950	2212	1697	6312	184140	0	194361
26951	1492	1172	188443	6390	0	197497
26952	175304	1049	6833	3156	0	186342
26953	6759	1074	3114	178695	0	189642
26954	2981	178303	2106	5756	0	189146
26955	1951	186475	1760	2943	0	193129
26956	1990	7181	1848	179721	0	190740
26957	2007	3055	1799	178794	0	185655
26958	1468	180576	2067	7137	0	191248
26959	1851	6107	180674	3172	0	191804
26960	1890	2707	6273	179929	0	190799
26961	1291	2502	183269	6332	0	193394
26962	1376	1810	179627	3320	0	186133
26963	165676	1379	7784	3225	0	178064
26964	5998	174261	3470	2335	0	186064
26965	173728	6580	2462	2160	0	184930
26966	7348	3142	1920	166839	0	179249
26967	2958	173921	1795	6575	0	185249
26968	2700	7065	2133	173121	0	185019
26969	2366	3462	2247	173373	0	181448
26970	1939	173590	1897	7964	0	185390
26971	1904	6907	172757	4014	0	185582
26972	2459	3432	6585	173347	0	185823
26973	172649	2672	3408	7560	0	186289
26974	6982	2268	2526	172998	0	184774
26975	3813	1864	2281	174967	0	182925
26976	2588	2099	169892	8725	0	183304
26977	2418	168815	6794	4183	0	182210
26978	2462	6921	3252	167148	0	179783
26979	2207	3555	168293	7560	0	181615
26980	2105	2935	168154	4326	0	177520
26981	157918	2554	8305	4232	0	173009
26982	6580	164960	4362	3693	0	179595
26983	162858	6902	3095	3419	0	176274
26984	7247	163038	2501	3325	0	176111
26985	3608	168441	2652	3454	0	178155
26986	163117	8276	2752	3284	0	177429
26987	7809	3960	2781	156749	0	171299
26988	4219	161395	2788	7253	0	175655
26989	3829	6947	2465	164322	0	177563
26990	163431	3406	2610	7987	0	177434
26991	7877	3311	162327	3994	0	177509
26992	4168	2860	159161	3280	0	169469
26993	156112	2241	8392	3119	0	169864
26994	7221	160223	4716	2933	0	175093
26995	4239	7197	160188	2439	0	174063
26996	3701	160525	7153	2612	0	173991
26997	3545	7646	3618	156827	0	171636
26998	2528	4360	159981	7066	0	173935
26999	2625	3225	7346	157456	0	170652
27000	2401	2629	157057	8055	0	170142
27001	146509	2369	8090	4794	0	161762
27002	6777	154553	4517	3250	0	169097
27003	152264	6802	3044	2922	0	165032
27004	7532	3735	2717	146762	0	160746
27005	3292	157602	3234	6680	0	170808
27006	155075	7196	3141	4045	0	169457
27007	148162	3488	3308	3560	0	158518
27008	7789	3071	154579	2727	0	168166
27009	3882	2512	151176	2446	0	160016
27010	129649	1948	7361	2323	0	141281
27011	5329	132264	3916	2695	0	144204
27012	2489	130276	2944	2024	0	137733
27013	3735	7826	2881	119886	0	134328
27014	2129	2905	121687	4951	0	131672
27015	1999	114149	4920	2469	0	123537
27016	1537	101268	2127	1617	0	106549
27017	3220	2836	1395	72650	0	80101
27018	74693	941	601	2132	0	78367
27019	76111	706	455	1060	0	78332
27020	77374	552	459	801	0	79186
27021	2508	528	76324	509	0	79869
27022	74487	516	1955	603	0	77561
27023	76407	556	858	617	0	78438
27024	78530	582	543	536	0	80191
27025	2681	674	458	74627	0	78440
27026	1069	75625	399	1789	0	78882
27027	75319	1835	343	889	0	78386
27028	1944	75798	467	541	0	78750
27029	903	1789	473	74605	0	77770
27030	579	822	77727	1791	0	80919
27031	734	625	1745	76241	0	79345
27032	811	436	648	78035	0	79930
27033	640	439	77989	2010	0	81078
27034	587	76546	1679	764	0	79576
27035	626	1468	491	70340	0	72925
27036	69750	526	373	1567	0	72216
27037	1352	68962	301	570	0	71185
27038	67478	1293	209	522	0	69502
27039	1519	604	207	65631	0	67961
27040	610	68912	222	1175	0	70919
27041	68015	1318	233	655	0	70221
27042	1371	69965	212	382	0	71930
27043	554	1283	68610	253	0	70700
27044	65458	648	1304	524	0	67934
27045	68099	494	409	415	0	69417
27046	1415	68417	223	262	0	70317
27047	528	1191	65629	161	0	67509
27048	356	67579	1094	176	0	69205
27049	1454	1682	823	43549	0	47508
27050	364	470	247	67829	0	68910
27051	370	337	149	67959	0	68815
27052	231	68303	140	1422	0	70096
27053	352	1269	112	68579	0	70312
27054	344	440	140	69466	0	70390
27055	68004	369	106	1659	0	70138
27056	1422	258	111	67934	0	69725
27057	572	209	105	69249	0	70135
27058	67880	207	94	1749	0	69930
27059	1379	68959	122	637	0	71097
27060	69635	1301	138	578	0	71652
27061	69780	449	128	459	0	70816
27062	70322	313	127	425	0	71187
27063	1855	312	159	69137	0	71463
27064	843	232	160	70860	0	72095
27065	544	307	68421	1629	0	70901
27066	473	353	65947	680	0	67453
27067	428	330	67481	537	0	68776
27068	63602	291	1492	606	0	65991
27069	1492	302	67219	439	0	69452
27070	599	67608	1453	450	0	70110
27071	632	1367	475	67358	0	69832
27072	586	566	358	66204	0	67714
27073	460	68322	336	1488	0	70606
27074	532	1480	69533	641	0	72186
27075	517	70804	1331	624	0	73276
27076	69734	1563	492	567	0	72356
27077	1678	683	71034	405	0	73800
27078	774	70754	1422	547	0	73497
27079	682	1495	71824	407	0	74408
27080	689	629	1502	70790	0	73610
27081	526	498	72759	1520	0	75303
27082	580	451	1603	70437	0	73071
27083	72425	365	600	1845	0	75235
27084	1658	437	72858	723	0	75676
27085	697	73059	1527	653	0	75936
27086	72965	1541	558	778	0	75842
27087	1711	605	75479	621	0	78416
27088	742	547	76296	576	0	78161
27089	738	429	1767	75074	0	78008
27090	595	418	76272	1835	0	79120
27091	71218	433	1785	1006	0	74442
27092	1709	74643	698	718	0	77768
27093	982	1648	504	75287	0	78421
27094	673	79998	530	1599	0	82800
27095	80015	1819	452	981	0	83267
27096	1817	772	79674	710	0	82973
27097	857	584	82089	625	0	84155
27098	789	572	2013	81432	0	84806
27099	703	465	825	83789	0	85782
27100	691	506	627	84548	0	86372
27101	743	481	550	84940	0	86714
27102	563	556	84541	2298	0	87958
27103	482	82993	1806	1056	0	86337
27104	531	1457	576	78169	0	80733
27105	433	570	76280	1494	0	78777
27106	350	75456	1438	723	0	77967
27107	75240	1404	657	748	0	78049
27108	1745	564	472	75354	0	78135
27109	74390	447	374	1555	0	76766
27110	1374	74653	361	716	0	77104
27111	73955	1296	367	700	0	76318
27112	1481	580	76505	473	0	79039
27113	819	664	1316	72504	0	75303
27114	508	76227	533	1247	0	78515
27115	466	1218	75424	643	0	77751
27116	293	74786	1276	575	0	76930
27117	1288	1628	807	51633	0	55356
27118	71208	428	369	1314	0	73319
27119	1073	70725	353	550	0	72701
27120	69805	1076	330	563	0	71774
27121	1210	460	69172	340	0	71182
27122	534	368	67378	337	0	68617
27123	66874	264	1284	479	0	68901
27124	1220	375	581	68102	0	70278
27125	592	308	449	68886	0	70235
27126	435	263	69984	1234	0	71916
27127	350	275	67394	575	0	68594
27128	306	70976	1234	374	0	72890
27129	68658	1102	724	539	0	71023
27130	66474	318	407	367	0	67566
27131	953	65707	274	274	0	67208
27132	513	850	279	67335	0	68977
27133	67996	302	268	1102	0	69668
27134	903	241	278	68015	0	69437
27135	68711	172	268	1129	0	70280
27136	69203	162	230	602	0	70197
27137	71596	161	228	507	0	72492
27138	1210	224	201	70250	0	71885
27139	522	203	196	73769	0	74690
27140	71149	144	199	1235	0	72727
27141	70150	166	233	673	0	71222
27142	69933	160	173	501	0	70767
27143	1091	68973	201	288	0	70553
27144	66419	599	132	330	0	67480
27145	725	66271	137	240	0	67373
27146	64751	633	153	367	0	65904
27147	769	231	65010	182	0	66192
27148	58457	231	638	460	0	59786
27149	645	63675	198	139	0	64657
27150	278	65640	119	126	0	66163
27151	66671	604	125	297	0	67697
27152	731	220	119	66920	0	67990
27153	393	125	92	70808	0	71418
27154	203	70804	117	769	0	71893
27155	179	77906	116	256	0	78457
27156	80413	936	98	383	0	81830
27157	1107	324	84344	130	0	85905
27158	536	162	1012	87639	0	89349
27159	89465	135	219	1509	0	91328
27160	1461	154	89819	285	0	91719
27161	334	95629	1348	183	0	97494
27162	99082	1642	268	431	0	101423
27163	2131	384	103177	133	0	105825
27164	843	190	2154	106926	0	110113
27165	314	184	111284	2214	0	113996
27166	104024	115	2392	1049	0	107580
27167	2261	113050	637	350	0	116298
27168	114093	2309	308	595	0	117305
27169	115447	592	232	430	0	116701
27170	3110	275	168	114164	0	117717
27171	115167	195	212	2669	0	118243
27172	2821	184	155	115025	0	118185
27173	1070	183	148	116590	0	117991
27174	495	231	112992	2801	0	116519
27175	440	113202	2235	817	0	116694
27176	642	2284	546	114427	0	117899
27177	556	534	252	116210	0	117552
27178	534	264	198	116632	0	117628
27179	315	328	114175	2870	0	117688
27180	295	112981	2261	912	0	116449
27181	503	2224	539	114727	0	117993
27182	475	525	285	116879	0	118164
27183	247	371	114407	2815	0	117840
27184	568	278	2252	111019	0	114117
27185	112829	162	553	2943	0	116487
27186	2205	113246	339	919	0	116709
27187	111195	2210	262	752	0	114419
27188	2486	655	111092	429	0	114662
27189	966	351	2220	110669	0	114206
27190	113077	257	555	2717	0	116606
27191	112992	217	388	1026	0	114623
27192	2889	224	113996	485	0	117594
27193	1271	300	2413	111665	0	115649
27194	560	267	113297	2462	0	116586
27195	106202	173	2495	1181	0	110051
27196	2437	113040	806	505	0	116788
27197	113250	2293	478	775	0	116796
27198	113327	587	393	668	0	114975
27199	2986	113737	421	352	0	117496
27200	114865	2537	369	666	0	118437
27201	2987	704	112767	422	0	116880
27202	113151	398	2443	645	0	116637
27203	3140	397	704	115003	0	119244
27204	1217	382	118705	2623	0	122927
27205	1153	318	2583	117801	0	121855
27206	1176	310	887	114989	0	117362
27207	952	333	609	118843	0	120737
27208	773	119057	624	3039	0	123493
27209	119816	2520	522	1517	0	124375
27210	3054	754	472	119813	0	124093
27211	1130	119105	510	2953	0	123698
27212	1096	2611	503	115395	0	119605
27213	801	117372	546	3033	0	121752
27214	858	2781	117478	1293	0	122410
27215	999	892	2629	116222	0	120742
27216	965	604	826	119256	0	121651
27217	748	579	117913	3535	0	122775
27218	106041	503	2764	2218	0	111526
27219	2799	117599	976	1303	0	122677
27220	1280	2764	712	118783	0	123539
27221	1072	855	650	117569	0	120146
27222	1072	635	673	116007	0	118387
27223	816	117241	667	3462	0	122186
27224	115598	2759	639	2019	0	121015
27225	3074	1004	116053	1340	0	121471
27226	1295	717	112009	1249	0	115270
27227	1170	585	3112	112417	0	117284
27228	1022	502	1170	116828	0	119522
27229	114664	549	821	4038	0	120072
27230	3086	113381	868	1706	0	119041
27231	1421	2736	731	115526	0	120414
27232	114045	947	688	3682	0	119362
27233	3421	668	734	112921	0	117744
27234	112860	570	682	3783	0	117895
27235	3412	625	109189	1632	0	114858
27236	1561	111402	2825	1309	0	117097
27237	111061	2778	1063	1518	0	116420
27238	3453	1000	111375	1046	0	116874
27239	105952	612	2927	1528	0	111019
27240	3422	636	107809	1122	0	112989
27241	108152	519	2994	1328	0	112993
27242	3528	594	1134	109958	0	115214
27243	110904	582	881	3452	0	115819
27244	3467	598	772	110265	0	115102
27245	1684	554	618	112023	0	114879
27246	110273	523	675	4146	0	115617
27247	3324	111433	682	1704	0	117143
27248	1519	2832	618	112544	0	117513
27249	112879	924	588	3871	0	118262
27250	116154	724	616	1832	0	119326
27251	3877	614	589	114528	0	119608
27252	1811	556	524	117142	0	120033
27253	114954	508	551	4059	0	120072
27254	3826	500	497	114656	0	119479
27255	1594	494	436	112351	0	114875
27256	107135	407	387	3811	0	111740
27257	3305	396	394	103594	0	107689
27258	1015	277	96099	2910	0	100301
27259	89903	222	2036	1637	0	93798
27260	2617	276	96430	862	0	100185
27261	989	258	88129	690	0	90066
27262	82326	492	2612	771	0	86201
27263	1511	83296	683	444	0	85934
27264	802	1181	533	80372	0	82888
27265	600	270	225	80408	0	81503
27266	644	198	167	84485	0	85494
27267	498	105	142	87849	0	88594
27268	83794	217	151	2511	0	86673
27269	92361	93	102	983	0	93539
27270	96135	104	121	844	0	97204
27271	2478	132	102621	446	0	105677
27272	1245	94	2309	105787	0	109435
27273	929	108	777	108508	0	110322
27274	932	108	423	104434	0	105897
27275	484	101081	295	3824	0	105684
27276	380	104128	269	1745	0	106522
27277	107415	3449	210	1283	0	112357
27278	3456	1296	216	107917	0	112885
27279	1709	645	211	114732	0	117297
27280	1194	378	195	117565	0	119332
27281	631	383	112286	5079	0	118379
27282	588	349	109744	2317	0	112998
27283	108823	275	4148	1866	0	115112
27284	116397	211	1588	1365	0	119561
27285	4829	240	892	112043	0	118004
27286	1944	114583	656	3703	0	120886
27287	1759	3275	425	114797	0	120256
27288	1372	1174	386	117525	0	120457
27289	791	710	112956	5032	0	119489
27290	112410	421	3288	2680	0	118799
27291	4252	278	1300	118928	0	124758
27292	2055	241	826	118242	0	121364
27293	113472	292	574	5691	0	120029
27294	4106	116124	482	2736	0	123448
27295	118741	3696	409	2048	0	124894
27296	5163	1676	406	114987	0	122232
27297	2137	114884	349	4385	0	121755
27298	116917	3934	302	2526	0	123679
27299	4796	1647	331	116790	0	123564
27300	116083	965	356	4974	0	122378
27301	115403	707	305	2774	0	119189
27302	116034	466	317	2067	0	118884
27303	6027	110544	421	1507	0	118499
27304	3023	111315	415	1229	0	115982
27305	2413	4829	349	105674	0	113265
27306	1538	108603	377	4360	0	114878
27307	111597	4497	294	2348	0	118736
27308	5088	2086	319	111375	0	118868
27309	111908	1235	318	5029	0	118490
27310	114895	917	326	2725	0	118863
27311	6437	846	351	110748	0	118382
27312	3544	744	349	116597	0	121234
27313	115431	783	308	6446	0	122968
27314	117846	789	286	3602	0	122523
27315	120966	747	319	2652	0	124684
27316	122733	772	271	2208	0	125984
27317	124638	805	230	2013	0	127686
27318	7489	783	241	119406	0	127919
27319	4228	763	275	121994	0	127260
27320	3242	804	310	124068	0	128424
27321	120469	728	324	7139	0	128660
27322	6108	574	281	118781	0	125744
27323	3377	117530	357	6048	0	127312
27324	2921	4194	335	121518	0	128968
27325	118997	1859	382	6238	0	127476
27326	120967	1205	407	3695	0	126274
27327	7036	1049	115804	2486	0	126375
27328	4338	822	3729	111628	0	120517
27329	2838	115882	1530	5328	0	125578
27330	118138	4195	821	3518	0	126672
27331	5660	118743	656	2644	0	127703
27332	3705	4663	510	120526	0	129404
27333	121977	2166	463	5774	0	130380
27334	123956	1320	439	3565	0	129280
27335	7208	120702	447	2701	0	131058
27336	4469	4529	273	120609	0	129880
27337	3103	2246	119249	5646	0	130244
27338	115178	1488	3965	3697	0	124328
27339	6210	1247	119382	2534	0	129373
27340	120696	1017	4481	2453	0	128647
27341	125315	981	1889	2449	0	130634
27342	7704	1092	961	122618	0	132375
27343	125319	1050	632	6096	0	133097
27344	128355	1074	550	3502	0	133481
27345	129434	1107	538	2577	0	133656
27346	8611	1058	548	123573	0	133790
27347	124037	876	516	5791	0	131220
27348	7279	881	521	122195	0	130876
27349	4507	895	587	122543	0	128532
27350	3197	119713	655	6798	0	130363
27351	3586	4021	540	115720	0	123867
27352	3041	117979	437	5343	0	126800
27353	116527	4333	340	3423	0	124623
27354	118629	2145	313	2659	0	123746
27355	7061	1329	269	115417	0	124076
27356	4338	1064	292	117655	0	123349
27357	115344	849	343	6411	0	122947
27358	6071	878	110138	3549	0	120636
27359	113084	785	3259	2843	0	119971
27360	6487	811	1449	111193	0	119940
27361	3940	842	105634	5017	0	115433
27362	105093	782	3377	3393	0	112645
27363	109319	707	1491	2766	0	114283
27364	6711	764	104569	2108	0	114152
27365	102446	661	3324	2219	0	108650
27366	5777	678	99314	1682	0	107451
27367	3848	98248	3415	1524	0	107035
27368	99111	2880	2427	1714	0	106132
27369	97660	1501	1160	1758	0	102079
27370	5457	90401	712	1359	0	97929
27371	2747	84994	623	1085	0	89449
27372	80471	2301	887	1051	0	84710
27373	81046	956	421	1051	0	83474
27374	3615	740	349	81258	0	85962
27375	1909	500	78344	2325	0	83078
27376	1628	462	74452	1209	0	77751
27377	77140	425	2080	1170	0	80815
27378	2664	431	78575	785	0	82455
27379	74260	552	2117	781	0	77710
27380	2549	280	758	73467	0	77054
27381	1472	228	497	74426	0	76623
27382	1081	310	74214	2040	0	77645
27383	73462	197	1492	1414	0	76565
27384	2225	287	731	76040	0	79283
27385	1438	194	513	78188	0	80333
27386	76080	180	388	2355	0	79003
27387	75698	182	297	1517	0	77694
27388	75454	162	338	1171	0	77125
27389	2439	76896	419	711	0	80465
27390	1160	1046	72375	437	0	75018
27391	69771	360	1131	727	0	71989
27392	72946	231	450	696	0	74323
27393	1746	71237	348	479	0	73810
27394	68614	829	369	457	0	70269
27395	1330	299	153	67459	0	69241
27396	640	239	70206	875	0	71960
27397	68028	205	844	785	0	69862
27398	71349	152	320	692	0	72513
27399	71520	134	212	616	0	72482
27400	72158	122	198	494	0	72972
27401	1401	118	183	71731	0	73433
27402	789	108	199	71802	0	72898
27403	72388	94	189	1360	0	74031
27404	1286	74	169	72311	0	73840
27405	732	59	178	72440	0	73409
27406	557	71345	186	1099	0	73187
27407	579	768	150	73698	0	75195
27408	550	216	146	74136	0	75048
27409	567	156	165	74472	0	75360
27410	567	110	135	75091	0	75903
27411	414	73920	152	1226	0	75712
27412	491	799	116	72709	0	74115
27413	513	307	101	70575	0	71496
27414	325	245	69363	1121	0	71054
27415	359	179	64681	520	0	65739
27416	316	67381	823	373	0	68893
27417	77881	757	307	680	0	79625
27418	1482	80025	241	328	0	82076
27419	686	1423	192	82776	0	85077
27420	365	381	87369	1624	0	89739
27421	89903	248	1669	1044	0	92864
27422	2221	158	447	95744	0	98570
27423	94528	159	341	2411	0	97439
27424	97241	138	235	1088	0	98702
27425	2197	98346	238	524	0	101305
27426	97738	1775	163	923	0	100599
27427	2193	103284	253	415	0	106145
27428	1222	2251	140	104099	0	107712
27429	610	106851	161	2120	0	109742
27430	587	2303	105971	709	0	109570
27431	551	108727	1966	550	0	111794
27432	805	2519	554	104979	0	108857
27433	107028	709	347	2729	0	110813
27434	2103	110914	346	803	0	114166
27435	1341	2354	205	110628	0	114528
27436	911	946	160	114057	0	116074
27437	594	601	113293	3064	0	117552
27438	970	467	2429	111664	0	115530
27439	512	498	113641	3016	0	117667
27440	104909	289	2694	1822	0	109714
27441	2912	478	114794	703	0	118887
27442	1099	114970	2730	811	0	119610
27443	1231	2811	828	113844	0	118714
27444	1118	925	689	114933	0	117665
27445	1001	823	377	115707	0	117908
27446	115327	540	409	4200	0	120476
27447	3420	601	308	112493	0	116822
27448	1027	114989	471	3222	0	119709
27449	111334	3052	383	1868	0	116637
27450	2860	110936	392	1523	0	115711
27451	1563	3059	452	110221	0	115295
27452	110220	1188	332	3739	0	115479
27453	3177	107767	501	1529	0	112974
27454	1250	113753	402	1182	0	116587
27455	112087	3474	501	1441	0	117503
27456	114128	1442	412	1455	0	117437
27457	3689	1032	112930	1088	0	118739
27458	112786	741	2920	1543	0	117990
27459	3765	780	116920	975	0	122440
27460	2025	884	3242	116502	0	122653
27461	1116	882	118016	3623	0	123637
27462	1395	851	3289	117127	0	122662
27463	1058	805	118413	3925	0	124201
27464	1258	747	3408	114603	0	120016
27465	1233	685	1221	120152	0	123291
27466	116568	700	949	4735	0	122952
27467	3555	839	116539	1988	0	122921
27468	108317	902	3366	1863	0	114448
27469	3939	718	115443	1334	0	121434
27470	1757	689	115655	1095	0	119196
27471	1555	831	3884	112552	0	118822
27472	114435	616	1616	4108	0	120775
27473	3445	115437	1276	1716	0	121874
27474	112940	3096	970	1785	0	118791
27475	113792	1098	1029	1490	0	117409
27476	4093	112927	995	1283	0	119298
27477	112223	3167	1087	1338	0	117815
27478	3900	1375	113934	1246	0	120455
27479	2122	928	3333	113548	0	119931
27480	113913	725	1409	4054	0	120101
27481	3688	114997	1278	1733	0	121696
27482	2185	3140	940	114345	0	120610
27483	1722	1330	998	115110	0	119160
27484	1669	973	973	117389	0	121004
27485	1564	807	940	118661	0	121972
27486	115216	716	898	4938	0	121768
27487	116687	801	946	2522	0	120956
27488	116062	815	984	1999	0	119860
27489	113225	643	897	1994	0	116759
27490	4639	873	112506	1397	0	119415
27491	109540	712	3249	1749	0	115250
27492	115265	678	1540	1554	0	119037
27493	4827	112312	1135	1313	0	119587
27494	2547	115969	921	1323	0	120760
27495	2282	3868	905	111098	0	118153
27496	1926	1498	963	113877	0	118264
27497	1583	1062	111348	4431	0	118424
27498	1529	111558	3434	2264	0	118785
27499	1787	3357	1508	108427	0	115079
27500	1578	112660	1115	3669	0	119022
27501	1798	3572	846	114976	0	121192
27502	1877	1390	829	114868	0	118964
27503	1592	119020	973	4513	0	126098
27504	1669	3471	1060	120470	0	126670
27505	1642	1609	120992	4264	0	128507
27506	1692	1061	119220	2221	0	124194
27507	113526	1018	4314	2154	0	121012
27508	121040	899	1856	1896	0	125691
27509	4679	120129	1317	1618	0	127743
27510	120794	3547	983	1729	0	127053
27511	4766	1507	962	119890	0	127125
27512	119064	1271	904	4308	0	125547
27513	4244	118994	840	2388	0	126466
27514	2545	3504	116959	1716	0	124724
27515	112048	1513	3723	2056	0	119340
27516	4505	1287	122176	1540	0	129508
27517	1962	882	107278	977	0	111099
27518	1470	828	107289	1089	0	110676
27519	1281	105832	3379	1023	0	111515
27520	100283	2744	3037	1274	0	107338
27521	97460	1097	999	1147	0	100703
27522	3335	712	693	95031	0	99771
27523	1893	715	653	93559	0	96820
27524	1156	96175	734	2837	0	100902
27525	95837	1948	714	1755	0	100254
27526	2534	96166	719	988	0	100407
27527	1397	93280	642	740	0	96059
27528	90595	2067	656	925	0	94243
27529	2390	841	695	89031	0	92957
27530	1351	529	567	88705	0	91152
27531	1195	514	505	89144	0	91358
27532	863	88395	400	2304	0	91962
27533	85565	1567	301	1210	0	88643
27534	2108	938	293	84453	0	87792
27535	973	81901	290	1576	0	84740
27536	721	82223	307	810	0	84061
27537	731	1595	305	78869	0	81500
27538	559	80345	310	1376	0	82590
27539	773	1468	301	79631	0	82173
27540	77279	712	276	1763	0	80030
27541	1295	517	75859	758	0	78429
27542	626	77225	1022	605	0	79478
27543	732	1261	379	77854	0	80226
27544	482	651	79802	1261	0	82196
27545	74650	446	1131	1015	0	77242
27546	1562	478	484	79507	0	82031
27547	78949	268	292	1734	0	81243
27548	78372	333	253	1042	0	80000
27549	1539	83986	281	440	0	86246
27550	84861	1219	207	891	0	87178
27551	84575	621	239	819	0	86254
27552	85525	445	213	800	0	86983
27553	1877	337	199	83863	0	86276
27554	1093	347	211	82907	0	84558
27555	794	363	229	84217	0	85603
27556	608	384	82436	1648	0	85076
27557	458	81091	992	808	0	83349
27558	77508	958	440	782	0	79688
27559	982	78456	250	407	0	80095
27560	699	912	164	77922	0	79697
27561	482	515	77439	946	0	79382
27562	68185	341	851	1167	0	70544
27563	952	77702	391	395	0	79440
27564	733	910	237	76625	0	78505
27565	576	452	151	76974	0	78153
27566	367	365	76237	1088	0	78057
27567	277	76074	775	640	0	77766
27568	419	863	367	75915	0	77564
27569	394	439	269	76686	0	77788
27570	430	387	194	75255	0	76266
27571	72342	304	176	1607	0	74429
27572	900	340	72665	668	0	74573
27573	480	72545	779	515	0	74319
27574	71023	774	428	756	0	72981
27575	930	73272	292	351	0	74845
27576	643	953	187	71605	0	73388
27577	394	74885	159	950	0	76388
27578	73126	961	140	977	0	75204
27579	74978	508	209	829	0	76524
27580	1401	396	201	78588	0	80586
27581	823	339	182	79503	0	80847
27582	630	291	161	83909	0	84991
27583	361	321	84725	1987	0	87394
27584	349	88098	1529	935	0	90911
27585	693	1678	621	100577	0	103569
27586	700	753	321	103847	0	105621
27587	771	412	220	104867	0	106270
27588	710	366	166	105425	0	106667
27589	319	438	103741	3483	0	107981
27590	283	108882	2259	1521	0	112945
27591	740	2621	788	112140	0	116289
27592	776	1104	358	122158	0	124396
27593	371	717	119735	4024	0	124847
27594	851	516	2722	114474	0	118563
27595	351	114690	1140	3706	0	119887
27596	297	120942	661	2007	0	123907
27597	719	3618	410	118177	0	122924
27598	313	1524	115728	3740	0	121305
27599	102550	794	2937	3116	0	109397
27600	2626	114443	1301	1824	0	120194
27601	1004	2995	111551	1383	0	116933
27602	592	1411	111223	1260	0	114486
27603	334	109627	3776	1067	0	114804
27604	372	3172	112377	997	0	116918
27605	965	1995	3312	108265	0	114537
27606	108135	913	1450	3570	0	114068
27607	110123	680	1143	1867	0	113813
27608	109826	690	859	1574	0	112949
27609	113259	858	725	1242	0	116084
27610	3693	115734	698	929	0	121054
27611	114969	3084	793	1461	0	120307
27612	3351	117577	1020	929	0	122877
27613	1863	3495	116291	750	0	122399
27614	1783	1828	3186	109513	0	116310
27615	966	119013	1581	2954	0	124514
27616	1394	3448	1106	114075	0	120023
27617	111797	1835	806	3779	0	118217
27618	3800	1128	913	109192	0	115033
27619	1706	113874	747	3515	0	119842
27620	114106	3377	728	2033	0	120244
27621	3752	1685	114510	1283	0	121230
27622	2377	1231	3171	112937	0	119716
27623	1735	975	1462	116684	0	120856
27624	111688	1108	875	4733	0	118404
27625	3540	111926	726	2440	0	118632
27626	1825	3673	110811	1530	0	117839
27627	1758	1666	3317	110605	0	117346
27628	1081	1246	112885	3958	0	119170
27629	967	108437	3394	2297	0	115095
27630	1005	114328	1530	1991	0	118854
27631	111545	4172	1106	1713	0	118536
27632	3327	2090	111892	1716	0	119025
27633	112673	1564	3533	1791	0	119561
27634	3928	1227	1769	110187	0	117111
27635	1686	114256	1485	3611	0	121038
27636	112789	3653	1096	2489	0	120027
27637	3601	1909	115371	1912	0	122793
27638	2398	1432	3434	114102	0	121366
27639	1720	1471	1871	115946	0	121008
27640	1548	1334	1492	114529	0	118903
27641	1167	114999	1247	4780	0	122193
27642	111520	3556	1301	2710	0	119087
27643	3576	111618	1090	1916	0	118200
27644	1822	114310	1045	1558	0	118735
27645	1851	4297	1014	113345	0	120507
27646	113731	2152	1234	4061	0	121178
27647	113153	1498	1143	2464	0	118258
27648	113450	1520	963	2233	0	118166
27649	4432	108648	939	1662	0	115681
27650	2667	3787	832	108309	0	115595
27651	1829	2241	108485	3681	0	116236
27652	1933	1503	3317	107158	0	113911
27653	1832	1425	1568	106180	0	111005
27654	1513	108427	1037	4730	0	115707
27655	108887	3965	818	2904	0	116574
27656	4263	2151	962	106483	0	113859
27657	2259	109433	1042	4038	0	116772
27658	108835	3991	1043	2600	0	116469
27659	3789	2247	107366	2309	0	115711
27660	104999	1795	3173	2201	0	112168
27661	4270	109577	1608	1821	0	117276
27662	110604	3912	1170	1725	0	117411
27663	111390	2465	995	1731	0	116581
27664	4651	2043	109573	1682	0	117949
27665	109036	1594	3596	1605	0	115831
27666	4528	1433	114392	1628	0	121981
27667	2789	1450	115947	1406	0	121592
27668	112714	1702	4159	1429	0	120004
27669	116627	1415	2150	1333	0	121525
27670	5115	1359	116843	1371	0	124688
27671	3090	1406	3901	113830	0	122227
27672	2856	1212	1993	114003	0	120064
27673	2218	119589	1720	3996	0	127523
27674	115714	3594	1388	2463	0	123159
27675	121562	2099	1112	1787	0	126560
27676	5477	1519	118925	1300	0	127221
27677	118506	1246	3372	1593	0	124717
27678	121829	1190	1863	1474	0	126356
27679	5300	119627	1363	1177	0	127467
27680	2972	3583	1277	115884	0	123716
27681	2817	1753	1091	110725	0	116386
27682	2421	1198	1006	112045	0	116670
27683	107316	826	978	3739	0	112859
27684	3409	102632	998	1833	0	108872
27685	1649	2129	655	88027	0	92460
27686	1173	87215	619	1960	0	90967
27687	1174	3212	539	84039	0	88964
27688	957	84747	475	1889	0	88068
27689	939	86522	544	1148	0	89153
27690	78919	1931	974	1235	0	83059
27691	78500	643	775	986	0	80904
27692	1341	327	215	73361	0	75244
27693	662	261	189	74084	0	75196
27694	547	233	147	75133	0	76060
27695	446	251	177	75007	0	75881
27696	468	254	168	73109	0	73999
27697	336	72708	176	1264	0	74484
27698	476	970	133	74113	0	75692
27699	451	402	110	75705	0	76668
27700	73936	286	137	1438	0	75797
27701	1250	209	148	74573	0	76180
27702	644	225	142	74418	0	75429
27703	466	226	73517	1298	0	75507
27704	489	272	901	70318	0	71980
27705	464	369	276	74501	0	75610
27706	372	218	75049	1442	0	77081
27707	322	75833	1022	747	0	77924
27708	296	1007	77117	514	0	78934
27709	228	302	73775	413	0	74718
27710	149	72520	1037	306	0	74012
27711	74924	890	449	429	0	76692
27712	74636	203	152	407	0	75398
27713	1154	142	102	73250	0	74648
27714	73995	94	110	1284	0	75483
27715	1064	147	75445	305	0	76961
27716	494	102	1022	75284	0	76902
27717	279	141	83020	1108	0	84548
27718	410	115	1108	82607	0	84240
27719	382	118	316	84014	0	84830
27720	369	115	183	85455	0	86122
27721	85053	90	162	1810	0	87115
27722	1286	168	131	86783	0	88368
27723	85791	111	177	1625	0	87704
27724	87073	130	173	824	0	88200
27725	1363	87210	201	481	0	89255
27726	87285	1103	175	684	0	89247
27727	1264	89777	187	454	0	91682
27728	635	1170	139	88947	0	90891
27729	578	341	158	90183	0	91260
27730	494	220	139	91517	0	92370
27731	346	207	89012	1780	0	91345
27732	304	88582	1275	783	0	90944
27733	545	1363	358	84577	0	86843
27734	567	483	225	85198	0	86473
27735	297	88534	199	1447	0	90477
27736	88214	1330	141	943	0	90628
27737	1399	86481	158	622	0	88660
27738	85290	1422	121	716	0	87549
27739	1492	87146	172	527	0	89337
27740	787	1488	148	83618	0	86041
27741	380	87985	171	1398	0	89934
27742	88549	1481	140	1006	0	91176
27743	89538	532	123	889	0	91082
27744	89073	371	145	798	0	90387
27745	88434	333	130	805	0	89702
27746	1883	354	88165	517	0	90919
27747	87357	321	1234	847	0	89759
27748	91455	279	366	769	0	92869
27749	91015	339	215	748	0	92317
27750	1902	356	89436	445	0	92139
27751	87099	317	1158	723	0	89297
27752	1622	91467	353	521	0	93963
27753	92487	1320	258	730	0	94795
27754	1694	585	98972	445	0	101696
27755	96947	374	1276	859	0	99456
27756	101280	304	418	729	0	102731
27757	1982	259	278	100640	0	103159
27758	913	319	99691	1462	0	102385
27759	100115	229	1232	1044	0	102620
27760	1830	259	454	103511	0	106054
27761	1070	230	354	105435	0	107089
27762	729	324	105846	1693	0	108592
27763	95619	220	1303	1445	0	98587
27764	105718	251	479	941	0	107389
27765	1801	106214	360	572	0	108947
27766	1031	1385	298	104870	0	107584
27767	846	513	282	104600	0	106241
27768	801	325	297	103813	0	105236
27769	628	105439	341	1745	0	108153
27770	105702	1302	264	1066	0	108334
27771	1802	505	254	105711	0	108272
27772	1023	346	225	106325	0	107919
27773	103059	281	254	2102	0	105696
27774	102333	241	245	1240	0	104059
27775	1941	265	271	104720	0	107197
27776	1101	294	298	104037	0	105730
27777	675	366	99362	1722	0	102125
27778	90575	268	1134	1440	0	93417
27779	1613	101278	426	683	0	104000
27780	960	1372	259	107666	0	110257
27781	909	489	214	110292	0	111904
27782	682	114016	217	2285	0	117200
27783	792	2095	189	118757	0	121833
27784	124235	790	227	2985	0	128237
27785	3073	538	257	136836	0	140704
27786	1593	365	172	139789	0	141919
27787	1220	329	165	143269	0	144983
27788	725	383	140093	5514	0	146715
27789	1110	312	3076	140671	0	145169
27790	651	360	139997	4915	0	145923
27791	583	136826	3558	2580	0	143547
27792	904	3063	1698	138138	0	143803
27793	936	1360	973	140222	0	143491
27794	871	850	679	143042	0	145442
27795	789	600	571	141745	0	143705
27796	751	476	518	144648	0	146393
27797	134869	409	412	6678	0	142368
27798	3281	395	137395	3427	0	144498
27799	1522	132342	3122	2575	0	139561
27800	1028	143528	1411	2028	0	147995
27801	1056	4086	855	141756	0	147753
27802	950	1822	700	145376	0	148848
27803	911	1144	576	144200	0	146831
27804	536	142837	549	5470	0	149392
27805	858	3395	411	144076	0	148740
27806	459	1708	139577	4803	0	146547
27807	337	136726	2811	2855	0	142729
27808	680	3323	1263	139054	0	144320
27809	135908	1517	910	4815	0	143150
27810	3103	1050	575	138392	0	143120
27811	1676	850	448	137168	0	140142
27812	1031	130737	500	4904	0	137172
27813	715	141497	458	2902	0	145572
27814	874	3860	355	141292	0	146381
27815	798	1916	284	143488	0	146486
27816	448	1259	141095	5216	0	148018
27817	723	978	15130	124164	0	140995
27818	640	773	1482	139598	0	142493
27819	595	738	999	139432	0	141764
27820	540	588	821	141851	0	143800
27821	134748	627	644	6509	0	142528
27822	136132	563	497	4326	0	141518
27823	4264	409	452	139367	0	144492
27824	2338	342	418	142931	0	146029
27825	138332	353	360	6717	0	145762
27826	3821	428	419	143834	0	148502
27827	1890	597	143281	5946	0	151714
27828	1237	143175	3164	3937	0	151513
27829	1224	3006	1713	146626	0	152569
27830	957	1465	1238	150520	0	154180
27831	147444	1112	958	6700	0	156214
27832	3489	914	697	152178	0	157278
27833	1866	707	562	156457	0	159592
27834	152774	607	528	7400	0	161309
27835	4048	694	423	155803	0	160968
27836	1987	155508	488	6188	0	164171
27837	1768	3464	486	164568	0	170286
27838	1502	1830	471	169801	0	173604
27839	1416	1232	571	168067	0	171286
27840	1184	1130	483	170747	0	173544
27841	728	1219	163182	7526	0	172655
27842	658	1126	159566	4970	0	166320
27843	779	992	4355	164325	0	170451
27844	843	943	2152	163907	0	167845
27845	513	164342	1464	7120	0	173439
27846	943	3728	1101	160629	0	166401
27847	545	162226	1068	6544	0	170383
27848	158971	4329	875	4926	0	169101
27849	3561	167331	868	3724	0	175484
27850	2128	4681	618	173093	0	180520
27851	1541	2453	485	178347	0	182826
27852	1026	1912	172201	7370	0	182509
27853	157648	1377	3476	5940	0	168441
27854	162597	1228	1726	4571	0	170122
27855	4770	165386	1451	3591	0	175198
27856	2851	3895	1203	162863	0	170812
27857	1780	2132	170266	5613	0	179791
27858	1312	173250	3887	4046	0	182495
27859	169535	4252	1866	4128	0	179781
27860	170454	2272	1212	3767	0	177705
27861	5570	1766	164719	3092	0	175147
27862	164044	1320	3656	3220	0	172240
27863	5654	1141	1687	168416	0	176898
27864	2929	168713	1377	5765	0	178784
27865	168784	3989	1060	4235	0	178068
27866	5279	2014	981	170193	0	178467
27867	171113	1516	912	6424	0	179965
27868	178088	1302	854	4479	0	184723
27869	6511	1328	684	174864	0	183387
27870	3330	1235	176834	6598	0	187997
27871	173539	954	3980	5150	0	183623
27872	181919	966	1834	4117	0	188836
27873	182832	948	1216	3941	0	188937
27874	6738	185911	1093	3108	0	196850
27875	4116	4254	905	184274	0	193549
27876	3046	2003	752	192348	0	198149
27877	2117	1725	187807	7458	0	199107
27878	2394	1366	4058	181999	0	189817
27879	1623	183913	1914	6800	0	194250
27880	177210	3877	1180	4696	0	186963
27881	4301	178528	1021	3384	0	187234
27882	2164	3881	174925	2392	0	183362
27883	1474	174904	3816	2441	0	182635
27884	1187	175072	1964	1788	0	180011
27885	1644	2896	1256	158846	0	164642
27886	158069	1154	472	3162	0	162857
27887	156846	672	310	1889	0	159717
27888	154102	583	276	1604	0	156565
27889	2838	159454	393	954	0	163639
27890	1229	2379	157329	715	0	161652
27891	152673	1036	2171	1456	0	157336
27892	159824	657	852	1433	0	162766
27893	3118	159208	508	772	0	163606
27894	161252	2369	367	1267	0	165255
27895	3194	1024	410	160521	0	165149
27896	1365	862	167465	2529	0	172221
27897	163973	598	2433	2116	0	169120
27898	166585	588	904	1620	0	169697
27899	175150	436	483	1395	0	177464
27900	3970	540	372	171336	0	176218
27901	2209	514	387	176077	0	179187
27902	1679	489	327	185210	0	187705
27903	983	182138	634	4390	0	188145
27904	2629	3555	677	178610	0	185471
27905	1705	1405	300	206798	0	210208
27906	1061	1091	205044	5724	0	212920
27907	1656	754	4209	202109	0	208728
27908	1463	649	1405	209074	0	212591
27909	1514	607	921	208860	0	211902
27910	1703	637	668	205955	0	208963
27911	995	206130	704	6782	0	214611
27912	1618	4506	573	207984	0	214681
27913	1526	1567	712	208879	0	212684
27914	201657	1018	709	7905	0	211289
27915	5014	971	200633	3789	0	210407
27916	2094	932	194526	2816	0	200368
27917	186521	811	5530	3332	0	196194
27918	198497	850	2008	2720	0	204075
27919	6874	978	1301	181244	0	190397
27920	2699	196307	1046	5036	0	205088
27921	196646	4503	896	3072	0	205117
27922	6343	1724	994	189992	0	199053
27923	2498	194868	1165	5076	0	203607
27924	194799	4262	778	2986	0	202825
27925	5412	197785	618	1797	0	205612
27926	193732	4808	561	2511	0	201612
27927	189566	2033	509	2416	0	194524
27928	6308	187069	622	1361	0	195360
27929	3609	4585	594	185204	0	193992
27930	2152	2207	184900	4960	0	194219
27931	2502	1743	4111	180791	0	189147
27932	180339	1257	1346	6108	0	189050
27933	5286	1338	179117	2587	0	188328
27934	2615	177815	4165	2074	0	186669
27935	2654	4859	1451	174063	0	183027
27936	1502	2097	173742	5043	0	182384
27937	1236	171145	4501	2657	0	179539
27938	168680	4425	1915	2719	0	177739
27939	5302	1834	1263	170181	0	178580
27940	2850	1315	1172	172077	0	177414
27941	2181	1300	1093	168483	0	173057
27942	1246	170228	962	6092	0	178528
27943	167661	4400	893	3875	0	176829
27944	4519	166894	976	2367	0	174756
27945	2191	172679	720	2045	0	177635
27946	169567	5201	688	2691	0	178147
27947	171013	2267	710	2716	0	176706
27948	5780	1879	166846	1818	0	176323
27949	161308	1522	3946	2243	0	169019
27950	161570	1510	1524	1866	0	166470
27951	6675	1457	1015	156870	0	166017
27952	3207	1551	155568	4709	0	165035
27953	3059	1269	3941	155236	0	163505
27954	159469	921	1599	6088	0	168077
27955	5661	1066	164884	2547	0	174158
27956	3649	1003	4937	181653	0	191242
27957	3684	949	1978	199281	0	205892
27958	2991	1043	1379	216040	0	221453
27959	208544	994	1176	11174	0	221888
27960	8293	213905	1312	4440	0	227950
27961	213836	7786	1010	3786	0	226418
27962	9492	2437	213772	2509	0	228210
27963	4653	1568	7921	199462	0	213604
27964	2364	213455	2525	8803	0	227147
27965	213690	7982	1598	4593	0	227863
27966	9922	2667	1278	213182	0	227049
27967	3561	2100	209735	9310	0	224706
27968	3354	1571	7591	206625	0	219141
27969	199245	1363	2706	10279	0	213593
27970	7889	199482	1882	4623	0	213876
27971	4596	8257	1155	175120	0	189128
27972	2387	197453	1132	7941	0	208913
27973	192242	8203	1029	6556	0	208030
27974	194174	3021	1077	3720	0	201992
27975	9607	192008	1233	2585	0	205433
27976	190927	7844	1192	2673	0	202636
27977	10121	3023	932	177757	0	191833
27978	3674	188912	986	7647	0	201219
27979	187141	8115	910	3502	0	199668
27980	192306	2981	825	2864	0	198976
27981	10329	179225	1028	2022	0	192604
27982	4392	186378	950	1851	0	193571
27983	181387	8594	746	2028	0	192755
27984	9899	3553	636	178718	0	192806
27985	181369	2516	644	8284	0	192813
27986	10314	2172	530	179716	0	192732
27987	4469	1854	176733	8261	0	191317
27988	4212	1818	6619	179288	0	191937
27989	176109	1917	1713	9111	0	188850
27990	8984	1750	175781	3317	0	189832
27991	4682	1380	7118	173645	0	186825
27992	3873	1363	2125	181836	0	189197
27993	2702	1346	175464	9541	0	189053
27994	171131	1132	7347	4468	0	184078
27995	9198	1260	2460	174759	0	187677
27996	3371	1306	166782	8631	0	180090
27997	154182	1126	7536	4127	0	166971
27998	7733	162651	2760	3259	0	176403
27999	3124	161060	1981	2976	0	169141
28000	2429	165879	1723	2697	0	172728
28001	2058	7535	152273	2278	0	164144
28002	2538	3505	6403	143575	0	156021
28003	1683	1533	144361	7108	0	154685
28004	1995	3649	5858	124259	0	135761
28005	1128	121928	2054	5999	0	131109
28006	1086	127249	1116	2359	0	131810
28007	1835	6101	1094	122359	0	131389
28008	121631	2047	893	6093	0	130664
28009	5809	1407	711	122989	0	130916
28010	2353	1133	834	122130	0	126450
28011	1527	121195	855	6364	0	129941
28012	119046	5148	681	2938	0	127813
28013	5329	122378	665	1987	0	130359
28014	2577	5732	641	121147	0	130097
28015	2111	2251	722	121062	0	126146
28016	1506	121111	769	6906	0	130292
28017	2016	5429	699	123505	0	131649
28018	122187	2365	554	7415	0	132521
28019	6831	2364	544	122736	0	132475
28020	3531	2389	677	121965	0	128562
28021	2835	121222	1010	6556	0	131623
28022	2768	5570	1213	123537	0	133088
28023	118452	2543	908	7079	0	128982
28024	121955	2432	673	3677	0	128737
28025	123975	2171	709	2949	0	129804
28026	8070	1760	875	119348	0	130053
28027	3668	1660	116365	6873	0	128566
28028	3090	1717	118210	3467	0	126484
28029	3158	1861	5523	118685	0	129227
28030	119224	2319	1808	6797	0	130148
28031	6793	2153	1066	120120	0	130132
28032	121352	2028	998	7007	0	131385
28033	8129	1732	853	120164	0	130878
28034	4473	1687	819	124360	0	131339
28035	121542	1932	905	7432	0	131811
28036	7234	1943	117679	3439	0	130295
28037	118658	1690	4996	3140	0	128484
28038	7477	1813	118453	2542	0	130285
28039	4493	1485	5262	117406	0	128646
28040	118364	1394	1959	6583	0	128300
28041	6874	1816	117780	2914	0	129384
28042	3360	1955	119124	2328	0	126767
28043	115733	1536	6071	2685	0	126025
28044	6957	1215	117278	2752	0	128202
28045	3329	114965	5842	2940	0	127076
28046	2812	4916	2613	119744	0	130085
28047	124841	1720	2230	7577	0	136368
28048	6193	1414	127699	3743	0	139049
28049	127371	1121	5929	3371	0	137792
28050	133553	1035	2951	3015	0	140554
28051	133483	1062	2283	3222	0	140050
28052	134148	1134	1915	3300	0	140497
28053	7651	2174	1965	125400	0	137190
28054	3398	124810	1730	6358	0	136296
28055	118595	4524	1637	3603	0	128359
28056	4806	1299	96713	1979	0	104797
28057	1164	70657	1675	825	0	74321
28058	63273	976	1015	627	0	65891
28059	1060	60104	448	434	0	62046
28060	604	63574	275	377	0	64830
28061	2037	1033	1005	61709	0	65784
28062	542	331	331	64276	0	65480
28063	419	214	246	64576	0	65455
28064	66132	204	175	1323	0	67834
28065	69334	147	151	689	0	70321
28066	1488	174	189	71646	0	73497
28067	770	205	191	75985	0	77151
28068	533	183	78536	1674	0	80926
28069	74451	125	1526	1080	0	77182
28070	80428	158	518	688	0	81792
28071	2215	127	324	79319	0	81985
28072	1060	140	226	80700	0	82126
28073	593	145	80006	2065	0	82809
28074	659	156	1581	78984	0	81380
28075	478	125	82366	1942	0	84911
28076	464	81959	1761	884	0	85068
28077	425	1392	83756	595	0	86168
28078	666	531	1700	80505	0	83402
28079	415	316	85735	1647	0	88113
28080	365	222	81445	772	0	82804
28081	82844	166	2104	711	0	85825
28082	1926	235	798	89081	0	92040
28083	800	180	90002	1747	0	92729
28084	81392	125	1863	1121	0	84501
28085	1930	181	89807	581	0	92499
28086	806	158	98815	508	0	100287
28087	537	102550	2266	580	0	105933
28088	672	1521	841	102011	0	105045
28089	389	482	103306	1715	0	105892
28090	444	374	101217	701	0	102736
28091	625	200	2164	101806	0	104795
28092	615	133	971	102133	0	103852
28093	310	105060	724	1987	0	108081
28094	528	1552	499	105932	0	108511
28095	106675	473	417	2319	0	109884
28096	106170	307	463	1238	0	108178
28097	108267	180	435	1042	0	109924
28098	2573	164	455	105852	0	109044
28099	1026	108146	506	1911	0	111589
28100	107974	1559	430	1284	0	111247
28101	1889	109047	462	761	0	112159
28102	771	107363	473	611	0	109218
28103	576	109353	498	549	0	110976
28104	109553	1917	566	846	0	112882
28105	1893	776	525	109291	0	112485
28106	899	513	521	108762	0	110695
28107	496	110630	496	2004	0	113626
28108	107292	1702	545	1231	0	110770
28109	1854	710	108813	617	0	111994
28110	971	454	1863	108176	0	111464
28111	108673	318	819	2178	0	111988
28112	1791	111335	725	887	0	114738
28113	115075	1664	549	1257	0	118545
28114	2291	647	505	117178	0	120621
28115	866	120590	591	1764	0	123811
28116	721	1815	118465	762	0	121763
28117	116090	682	1833	1029	0	119634
28118	2047	582	780	121781	0	125190
28119	123198	436	625	2330	0	126589
28120	2137	449	468	123004	0	126058
28121	858	123080	501	2209	0	126648
28122	790	1728	125783	991	0	129292
28123	718	720	125555	878	0	127871
28124	862	827	1892	126238	0	129819
28125	129458	396	876	2291	0	133021
28126	129944	372	532	1247	0	132095
28127	2362	332	411	129178	0	132283
28128	1335	341	443	130299	0	132418
28129	131753	367	427	2538	0	135085
28130	2175	397	468	132569	0	135609
28131	132321	396	444	2645	0	135806
28132	2061	132500	489	1175	0	136225
28133	129655	1725	438	1429	0	133247
28134	2222	873	135015	835	0	138945
28135	1377	619	1855	133793	0	137644
28136	1075	478	919	137975	0	140447
28137	993	370	819	138710	0	140892
28138	770	135807	713	2687	0	139977
28139	1101	113092	812	1794	0	116799
28140	810	2007	633	138961	0	142411
28141	655	977	138824	2429	0	142885
28142	956	602	2069	136854	0	140481
28143	898	507	1007	141692	0	144104
28144	830	542	815	143587	0	145774
28145	137690	582	729	3165	0	142166
28146	2043	135856	685	1486	0	140070
28147	1007	137817	804	1157	0	140785
28148	1119	2288	739	132747	0	136893
28149	1013	892	721	137406	0	140032
28150	1060	672	631	136820	0	139183
28151	946	573	586	138767	0	140872
28152	134855	622	599	3293	0	139369
28153	1877	135555	737	2544	0	140713
28154	136853	1846	703	1680	0	141082
28155	139813	823	739	1527	0	142902
28156	2532	693	522	138624	0	142371
28157	1404	561	407	140881	0	143253
28158	138423	425	411	3303	0	142562
28159	139062	476	367	2024	0	141929
28160	2773	538	281	136643	0	140235
28161	1683	569	162	137475	0	139889
28162	1133	578	135795	2506	0	140012
28163	921	131567	1406	1588	0	135482
28164	927	138462	473	1077	0	140939
28165	131233	1496	538	1341	0	134608
28166	1622	654	133013	649	0	135938
28167	661	479	124011	516	0	125667
28168	112926	282	1064	959	0	115231
28169	122554	190	492	776	0	124012
28170	880	133230	272	388	0	134770
28171	476	140068	179	355	0	141078
28172	525	786	119	142662	0	144092
28173	147264	314	102	1643	0	149323
28174	147876	227	82	1128	0	149313
28175	149464	166	101	1047	0	150778
28176	1103	238	116	147885	0	149342
28177	629	225	106	150152	0	151112
28178	418	270	149743	908	0	151339
28179	484	231	137810	569	0	139094
28180	323	219	149830	382	0	150754
28181	565	1529	693	146286	0	149073
28182	144778	62	277	1246	0	146363
28183	672	169	151884	290	0	153015
28184	529	109	569	149314	0	150521
28185	199	153774	227	712	0	154912
28186	329	522	138	151073	0	152062
28187	364	165	97	152759	0	153385
28188	184	219	158349	1095	0	159847
28189	471	96	1139	154739	0	156445
28190	159673	89	325	1955	0	162042
28191	1556	251	169379	445	0	171631
28192	818	83	1552	167538	0	169991
28193	349	210	174053	1586	0	176198
28194	208	173163	1852	684	0	175907
28195	305	1727	176769	420	0	179221
28196	905	550	2047	160729	0	164231
28197	500	309	732	177463	0	179004
28198	219	360	183424	2308	0	186311
28199	653	209	1994	175696	0	178552
28200	689	242	714	174238	0	175883
28201	188	178278	512	2481	0	181459
28202	291	1851	180864	1071	0	184077
28203	725	542	2094	176894	0	180255
28204	638	290	813	182172	0	183913
28205	208	184416	564	2610	0	187798
28206	493	1997	416	186812	0	189718
28207	187032	684	405	3065	0	191186
28208	2353	407	427	187893	0	191080
28209	664	412	189677	2686	0	193439
28210	179715	244	2303	2120	0	184382
28211	194246	258	875	1589	0	196968
28212	3235	289	197668	782	0	201974
28213	184020	197	2791	1697	0	188705
28214	2896	198676	1139	820	0	203531
28215	1669	2699	663	200971	0	206002
28216	1263	1029	555	216114	0	218961
28217	1364	543	522	209454	0	211883
28218	1149	429	450	217291	0	219319
28219	1086	363	430	218501	0	220380
28220	214953	331	364	6022	0	221670
28221	3679	356	214356	2456	0	220847
28222	198933	214	3560	2601	0	205308
28223	3967	385	211402	1572	0	217326
28224	2272	225	3857	208938	0	215292
28225	210740	272	1584	4880	0	217476
28226	4602	277	1065	208155	0	214099
28227	1836	212210	1024	4290	0	219360
28228	217122	3416	843	2690	0	224071
28229	4760	1560	758	223367	0	230445
28230	1818	857	208399	5045	0	216119
28231	201714	477	3289	3596	0	209076
28232	4321	227412	1301	1913	0	234947
28233	1987	3992	233754	1698	0	241431
28234	2008	1381	4256	228289	0	235934
28235	2133	757	1849	219928	0	224667
28236	1157	229525	1206	5458	0	237346
28237	1068	4089	230928	2467	0	238552
28238	1631	1629	4243	226707	0	234210
28239	1101	1100	236143	5344	0	243688
28240	1465	782	4716	231114	0	238077
28241	1331	769	1946	234903	0	238949
28242	1075	786	234002	6398	0	242261
28243	1516	629	4792	230482	0	237419
28244	3578	910	4087	178430	0	187005
28245	1720	577	1594	246200	0	250091
28246	1517	666	1526	247781	0	251490
28247	237391	527	1480	8562	0	247960
28248	5142	549	236755	4101	0	246547
28249	235934	642	5299	3877	0	245752
28250	6130	810	2478	248153	0	257571
28251	3129	642	1830	252601	0	258202
28252	2235	652	1594	249440	0	253921
28253	1415	245785	1638	11137	0	259975
28254	248845	5159	1393	5078	0	260475
28255	6043	1999	1480	254412	0	263934
28256	2481	255987	1665	7258	0	267391
28257	1938	5102	1288	260151	0	268479
28258	259064	2067	1255	8649	0	271035
28259	257374	1379	1310	5402	0	265465
28260	256532	1206	1330	4380	0	263448
28261	7230	257643	1480	3477	0	269830
28262	3138	5428	258634	3359	0	270559
28263	250796	2286	5480	4066	0	262628
28264	261435	1319	2271	4211	0	269236
28265	7553	265332	1786	3114	0	277785
28266	264422	5616	1357	3699	0	275094
28267	258119	2521	1337	3634	0	265611
28268	267342	1519	1207	3585	0	273653
28269	8456	269867	1459	3148	0	282930
28270	4935	5889	1239	266649	0	278712
28271	267226	2523	1154	8027	0	278930
28272	276430	1776	1055	4523	0	283784
28273	267956	1384	1047	3887	0	274274
28274	274586	1387	938	3443	0	280354
28275	10236	1602	955	267561	0	280354
28276	4853	1616	266270	7919	0	280658
28277	4932	1040	6084	259651	0	271707
28278	3711	266208	2402	7862	0	280183
28279	4083	6562	1502	272827	0	284974
28280	3483	2584	275385	8307	0	289759
28281	270253	1528	6737	4738	0	283256
28282	9460	1393	2726	277725	0	291304
28283	274201	1517	1805	8918	0	286441
28284	275038	1419	1463	5333	0	283253
28285	11116	1432	1323	275172	0	289043
28286	5582	1166	275560	8492	0	290800
28287	4680	1218	258312	4158	0	268368
28288	247254	1197	7325	3906	0	259682
28289	8172	258942	2960	3121	0	273195
28290	4369	256162	1967	2464	0	264962
28291	3499	253248	1503	2750	0	261000
28292	3113	265031	1505	2479	0	272128
28293	253957	7160	2590	3009	0	266716
28294	256655	2841	1562	2529	0	263587
28295	255336	2004	1020	2529	0	260889
28296	256250	1984	933	2641	0	261808
28297	9388	1909	1030	245429	0	257756
28298	4696	245759	1096	6010	0	257561
28299	243317	5680	1086	3598	0	253681
28300	7768	2443	245029	2256	0	257496
28301	4490	243255	5277	2325	0	255347
28302	3940	5476	244609	2160	0	256185
28303	235305	2545	5515	2649	0	246014
28304	244482	1982	2442	2490	0	251396
28305	243644	2207	1629	2311	0	249791
28306	9163	1694	1401	239781	0	252039
28307	4934	1561	240772	5540	0	252807
28308	3879	240372	5143	2819	0	252213
28309	231517	5146	2298	2612	0	241573
28310	7282	233756	1453	2107	0	244598
28311	4130	226231	983	1930	0	233274
28312	3391	225480	966	1784	0	231621
28313	3205	227630	1036	1823	0	233694
28314	2948	5895	215017	1432	0	225292
28315	2751	217787	4558	1437	0	226533
28316	201519	4415	1867	1572	0	209373
28317	5294	2146	963	201465	0	209868
28318	3129	1657	852	205028	0	210666
28319	202357	1440	851	5110	0	209758
28320	4996	201960	1035	2187	0	210178
28321	2951	4145	206381	1326	0	214803
28322	3144	2100	3576	200492	0	209312
28323	3075	1394	1473	206493	0	212435
28324	2780	1512	976	209598	0	214866
28325	2186	1556	206845	4763	0	215350
28326	2175	1618	204800	2184	0	210777
28327	2795	1497	4341	203187	0	211820
28328	2201	1295	203414	3701	0	210611
28329	2223	1416	190677	1790	0	196106
28330	165753	1252	4295	2583	0	173883
28331	4398	192275	1873	1570	0	200116
28332	2457	186582	1326	1260	0	191625
28333	2392	189978	1143	1266	0	194779
28334	2842	4644	1051	177163	0	185700
28335	1990	194258	1237	2951	0	200436
28336	195875	3944	1153	2317	0	203289
28337	4602	2062	201601	1385	0	209650
28338	202154	1583	3915	1872	0	209524
28339	5346	1483	1874	205428	0	214131
28340	3287	1302	1326	205731	0	211646
28341	2016	218280	1369	4902	0	226567
28342	216740	4590	1276	2860	0	225466
28343	217184	2051	1728	2171	0	223134
28344	7122	229116	1257	1523	0	239018
28345	3482	5405	879	218552	0	228318
28346	2122	2294	223811	4778	0	233005
28347	1698	1710	222600	2201	0	228209
28348	1589	227949	6068	1518	0	237124
28349	223125	5636	2536	2029	0	233326
28350	5693	2248	226960	818	0	235719
28351	3616	1443	4990	220094	0	230143
28352	225702	1294	2162	5469	0	234627
28353	228905	1188	1346	2816	0	234255
28354	6700	258811	1295	1407	0	268213
28355	3000	272801	1229	1068	0	278098
28356	270040	8295	1069	1415	0	280819
28357	7762	3634	271149	799	0	283344
28358	267058	2223	6557	1570	0	277408
28359	275335	1644	2619	1474	0	281072
28360	10458	1618	1698	268329	0	282103
28361	4149	1584	275202	6514	0	287449
28362	2835	1456	272152	2466	0	278909
28363	257796	1103	9054	2315	0	270268
28364	8089	1272	272682	1030	0	283073
28365	252879	937	7924	1662	0	263402
28366	262066	963	3216	1742	0	267987
28367	9104	262428	2080	1091	0	274703
28368	4384	6742	260065	835	0	272026
28369	2753	258969	7250	870	0	269842
28370	250057	7156	3482	1520	0	262215
28371	7752	3119	251349	663	0	262883
28372	4931	1991	6864	233594	0	247380
28373	2879	1311	245467	5951	0	255608
28374	2424	1155	245737	2351	0	251667
28375	2229	1102	246015	1258	0	250604
28376	2128	1110	244847	934	0	249019
28377	1911	235993	9480	864	0	248248
28378	2246	6008	235466	798	0	244518
28379	1942	231244	7330	932	0	241448
28380	1891	6379	227352	740	0	236362
28381	218398	2831	7657	1321	0	230207
28382	7845	1875	3776	203226	0	216722
28383	3536	228191	2850	4474	0	239051
28384	224068	5978	2486	2744	0	235276
28385	225126	3099	2364	1979	0	232568
28386	209847	2287	2377	2036	0	216547
28387	222046	1698	2717	1547	0	228008
28388	8726	221846	2782	1069	0	234423
28389	209392	6456	2411	1992	0	220251
28390	220793	3396	2432	1778	0	228399
28391	8637	213815	2545	1365	0	226362
28392	4875	6956	202366	1034	0	215231
28393	4684	3607	6704	195077	0	210072
28394	3407	213198	4056	5061	0	225722
28395	3180	7106	214560	2527	0	227373
28396	3376	3970	216366	1683	0	225395
28397	3571	211311	9253	1282	0	225417
28398	3603	214769	5030	1221	0	224623
28399	3637	224456	3673	1428	0	233194
28400	3787	222597	3160	1286	0	230830
28401	221989	9935	3112	1708	0	236744
28402	226284	5282	3008	1766	0	236340
28403	11096	3644	230500	1217	0	246457
28404	6466	3275	236985	1124	0	247850
28405	5393	2954	10505	225654	0	244506
28406	4957	3032	5809	233258	0	247056
28407	5002	3073	4168	239854	0	252097
28408	235971	2961	4103	9241	0	252276
28409	9599	235989	4036	4180	0	253804
28410	6090	244763	4086	2385	0	257324
28411	4996	252493	4150	1909	0	263548
28412	243498	11306	4156	2013	0	260973
28413	250329	6240	4010	2149	0	262728
28414	13110	4462	3921	243270	0	264763
28415	253906	3457	4659	7814	0	269836
28416	257422	3574	4589	3789	0	269374
28417	13721	3849	4331	249960	0	271861
28418	253266	4001	4183	8917	0	270367
28419	11869	250938	5008	4188	0	272003
28420	8071	9423	5209	245463	0	268166
28421	6724	5264	247777	7911	0	267676
28422	5692	246305	11605	4051	0	267653
28423	5891	10257	251549	2995	0	270692
28424	6513	5996	11951	228113	0	252573
28425	5725	251890	7770	7306	0	272691
28426	6646	9852	6613	245489	0	268600
28427	6197	6086	6001	252707	0	270991
28428	6297	4747	250066	10414	0	271524
28429	5641	4450	261985	4954	0	277030
28430	5724	4198	13491	252178	0	275591
28431	6243	4276	8307	240706	0	259532
28432	5141	259460	6550	9798	0	280949
28433	245489	10577	5666	5570	0	267302
28434	11223	253757	5756	3852	0	274588
28435	6812	259281	4946	3263	0	274302
28436	4966	12359	245026	2929	0	265280
28437	3611	245208	10416	3050	0	262285
28438	4729	10722	6963	217830	0	240244
28439	4074	240455	5217	7407	0	257153
28440	4304	9818	4272	222154	0	240548
28441	3037	232753	4266	7769	0	247825
28442	226607	9708	3828	4356	0	244499
28443	9057	233472	3969	3019	0	249517
28444	5319	8942	2958	199659	0	216878
28445	3889	220287	2608	6103	0	232887
28446	215742	8910	2672	3248	0	230572
28447	216458	5549	1804	2780	0	226591
28448	9541	215659	2121	2008	0	229329
28449	209243	8004	1698	1759	0	220704
28450	9003	6542	1721	199161	0	216427
28451	4486	3752	202227	6465	0	216930
28452	3952	3395	203668	3091	0	214106
28453	3304	205834	7445	2625	0	219208
28454	164037	4450	2984	1643	0	173114
28455	163083	1965	1214	1446	0	167708
28456	4795	1536	163747	1116	0	171194
28457	2091	1394	161975	1096	0	166556
28458	153573	1328	4016	1491	0	160408
28459	162223	1226	1661	1312	0	166422
28460	4528	1460	160180	939	0	167107
28461	145488	1319	3432	1355	0	151594
28462	3914	153512	1573	988	0	159987
28463	1686	164138	1165	1019	0	168008
28464	1738	4476	1303	157756	0	165273
28465	1473	2130	1011	162500	0	167114
28466	163265	1652	1088	4495	0	170500
28467	162259	1501	1064	2139	0	166963
28468	163904	1452	903	1708	0	167967
28469	4733	1437	865	162323	0	169358
28470	2418	1402	863	162439	0	167122
28471	1584	157506	894	4281	0	164265
28472	1563	160344	918	1962	0	164787
28473	1533	166442	843	1425	0	170243
28474	1842	4587	804	155728	0	162961
28475	1462	163538	802	3468	0	169270
28476	1736	4336	156789	1627	0	164488
28477	143000	2289	3119	1974	0	150382
28478	3899	1951	158975	1183	0	166008
28479	1939	1823	157706	1127	0	162595
28480	150554	1699	3873	1409	0	157535
28481	4002	162011	1567	1105	0	168685
28482	162187	3974	1049	1392	0	168602
28483	162340	2102	991	1519	0	166952
28484	4707	1737	160343	1224	0	168011
28485	2464	1584	164931	1028	0	170007
28486	1875	169138	4125	1021	0	176159
28487	1864	4296	173820	994	0	180974
28488	2071	2222	3882	171947	0	180122
28489	2904	2001	2314	139918	0	147137
28490	1630	175330	1574	4018	0	182552
28491	1655	181999	1463	1736	0	186853
28492	176907	5036	1202	1665	0	184810
28493	182068	2476	1193	1520	0	187257
28494	5310	1941	1221	181166	0	189638
28495	2810	1575	1251	184969	0	190605
28496	179687	1457	1229	4731	0	187104
28497	180292	1507	1207	2334	0	185340
28498	4756	184496	1261	1483	0	191996
28499	175165	3658	1021	1324	0	181168
28500	4314	170674	932	890	0	176810
28501	2051	176977	957	903	0	180888
28502	174332	3960	857	1285	0	180434
28503	173278	1932	780	1227	0	177217
28504	4709	1619	702	170616	0	177646
28505	170004	1353	715	3310	0	175382
28506	4350	1435	169757	1111	0	176653
28507	2260	171566	2685	1200	0	177711
28508	166881	3235	1027	1577	0	172720
28509	3818	1446	172259	1112	0	178635
28510	2236	1590	2555	159854	0	166235
28511	1745	164332	1129	2227	0	169433
28512	1644	169267	855	944	0	172710
28513	166496	3017	1056	1145	0	171714
28514	3215	1563	164729	744	0	170251
28515	154457	927	2341	653	0	158378
28516	3325	679	1075	159453	0	164532
28517	1677	701	160391	1904	0	164673
28518	147282	676	2260	1616	0	151834
28519	2705	163288	1069	672	0	167734
28520	1267	171128	993	600	0	173988
28521	171350	2601	972	970	0	175893
28522	170746	1266	609	976	0	173597
28523	174933	867	505	1223	0	177528
28524	3367	717	537	171794	0	176415
28525	2048	647	560	173112	0	176367
28526	1412	657	172867	2163	0	177099
28527	1325	576	165339	1096	0	168336
28528	1160	171404	2120	964	0	175648
28529	1086	1786	783	164982	0	168637
28530	163832	692	483	1881	0	166888
28531	1680	164336	332	808	0	167156
28532	941	1691	284	164459	0	167375
28533	162556	699	329	2028	0	165612
28534	1727	162276	362	800	0	165165
28535	936	169423	335	583	0	171277
28536	1010	1654	163175	403	0	166242
28537	154002	750	1512	986	0	157250
28538	163263	554	548	876	0	165241
28539	1739	488	162408	530	0	165165
28540	145749	335	1221	880	0	148185
28541	1505	493	161271	247	0	163516
28542	629	159104	1121	258	0	161112
28543	952	1351	630	156180	0	159113
28544	154528	470	347	1394	0	156739
28545	1183	154627	303	407	0	156520
28546	561	154552	266	278	0	155657
28547	146943	994	202	668	0	148807
28548	1057	521	155245	148	0	156971
28549	143696	322	880	921	0	145819
28550	976	158844	381	222	0	160423
28551	569	898	153229	109	0	154805
28552	144230	369	790	646	0	146035
28553	153971	288	287	463	0	155009
28554	1333	203	218	151830	0	153584
28555	715	238	183	154338	0	155474
28556	382	155573	163	914	0	157032
28557	348	1076	153174	399	0	154997
28558	792	350	1025	153041	0	155208
28559	389	394	164251	1264	0	166298
28560	405	325	162742	418	0	163890
28561	730	176	1824	169612	0	172342
28562	406	244	176064	1834	0	178548
28563	462	255	170675	602	0	171994
28564	773	237	2404	163765	0	167179
28565	331	271	172249	1942	0	174793
28566	151790	193	2361	1290	0	155634
28567	1943	166414	835	682	0	169874
28568	693	1907	169297	377	0	172274
28569	641	665	179534	255	0	181095
28570	1018	494	2719	166187	0	170418
28571	184874	243	1057	2499	0	188673
28572	185502	178	720	1213	0	187613
28573	184677	223	484	974	0	186358
28574	185964	232	504	773	0	187473
28575	3111	174	473	180881	0	184639
28576	1117	318	183853	2060	0	187348
28577	177847	231	2233	1344	0	181655
28578	183438	206	831	1176	0	185651
28579	185603	214	678	963	0	187458
28580	2999	261	181768	297	0	185325
28581	169434	261	2208	787	0	172690
28582	2815	296	1000	187319	0	191430
28583	1071	192434	884	2123	0	196512
28584	1471	2420	581	183365	0	187837
28585	717	189974	591	2179	0	193461
28586	187080	2348	564	1282	0	191274
28587	2839	770	189189	626	0	193424
28588	1546	484	2689	177564	0	182283
28589	707	184149	1170	2270	0	188296
28590	560	191784	874	868	0	194086
28591	189447	2889	715	1118	0	194169
28592	188994	964	563	947	0	191468
28593	3403	718	185084	433	0	189638
28594	183495	399	2914	775	0	187583
28595	3910	311	1006	186147	0	191374
28596	1376	465	192411	2911	0	197163
28597	1239	433	190233	959	0	192864
28598	1726	382	3421	194159	0	199688
28599	208315	330	1319	4038	0	214002
28600	4459	260	946	206823	0	212488
28601	2104	244	777	208851	0	211976
28602	1703	307	746	207335	0	210091
28603	1048	212796	746	4372	0	218962
28604	1521	3406	618	214024	0	219569
28605	206707	1059	650	4894	0	213310
28606	3908	211257	748	1695	0	217608
28607	1985	3719	688	212341	0	218733
28608	209847	1195	640	4966	0	216648
28609	4056	207031	732	1813	0	213632
28610	1519	212976	812	1321	0	216628
28611	1819	4721	711	210509	0	217760
28612	205801	1710	671	4940	0	213122
28613	4530	1052	207839	1898	0	215319
28614	1876	844	205574	1430	0	209724
28615	203681	790	5141	1836	0	211448
28616	215991	805	1914	1628	0	220338
28617	5774	220209	1304	1073	0	228360
28618	3120	4546	1002	212847	0	221515
28619	1768	1621	217809	4590	0	225788
28620	1464	1107	211796	1938	0	216305
28621	1391	848	226727	1498	0	230464
28622	1302	220839	6678	1272	0	230091
28623	1183	227881	2581	1201	0	232846
28624	222717	5987	1557	1889	0	232150
28625	5777	2192	225435	1235	0	234639
28626	217851	1318	5578	1717	0	226464
28627	225564	904	2348	1812	0	230628
28628	7072	1022	226973	1130	0	236197
28629	2958	232936	5720	1144	0	242758
28630	3322	5719	2138	221671	0	232850
28631	1873	2218	237550	5615	0	247256
28632	1727	1704	226076	2193	0	231700
28633	218682	1299	6728	2445	0	229154
28634	6054	235561	2862	1380	0	245857
28635	3242	6066	1923	223517	0	234748
28636	2651	2618	1466	222633	0	229368
28637	1717	227374	1614	6424	0	237129
28638	1822	232274	1616	2563	0	238275
28639	1821	237162	1646	1761	0	242390
28640	2478	7500	1418	237564	0	248960
28641	242508	2870	1231	6982	0	253591
28642	7736	1981	1296	244793	0	255806
28643	2787	1747	245186	7502	0	257222
28644	2092	1596	245390	2996	0	252074
28645	2414	1557	8184	244831	0	256986
28646	1698	1661	250525	7015	0	260899
28647	1869	249418	7688	2947	0	261922
28648	2594	7130	2935	257962	0	270621
28649	265209	2738	2194	8636	0	278777
28650	263170	1932	1819	4017	0	270938
28651	9139	267590	1764	2725	0	281218
28652	265551	8434	1695	2855	0	278535
28653	273693	3296	1505	2711	0	281205
28654	276108	2141	1588	2937	0	282774
28655	10938	2289	237514	2042	0	252783
28656	252470	1677	6670	2844	0	263661
28657	9090	260932	2904	2222	0	275148
28658	3770	7471	257972	1632	0	270845
28659	2944	2743	256897	1704	0	264288
28660	2450	253288	8841	1791	0	266370
28661	246645	7626	3945	2077	0	260293
28662	9092	2867	2228	234441	0	248628
28663	3493	241624	1782	6592	0	253491
28664	244179	7445	1603	3180	0	256407
28665	8858	3097	1559	244256	0	257770
28666	246672	2177	1559	8275	0	258683
28667	9395	1803	1524	247714	0	260436
28668	3927	1881	245480	8024	0	259312
28669	2849	1932	239250	3215	0	247246
28670	2587	2012	243473	2196	0	250268
28671	3433	1961	9487	229539	0	244420
28672	3086	1907	3886	242639	0	251518
28673	2546	2051	240886	8971	0	254454
28674	2501	239155	8395	3810	0	253861
28675	242410	7804	3646	2872	0	256732
28676	244798	3178	2761	2670	0	253407
28677	10023	246869	2748	2076	0	261716
28678	5467	8689	2495	244295	0	260946
28679	3365	3417	254145	8255	0	269182
28680	243758	2407	9156	4159	0	259480
28681	9551	2044	255230	2806	0	269631
28682	4325	1835	235678	1973	0	243811
28683	3136	1934	247758	1610	0	254438
28684	231690	1776	10880	2202	0	246548
28685	9139	1891	241844	1858	0	254732
28686	4111	230130	9405	1969	0	245615
28687	3235	243202	4721	1702	0	252860
28688	3826	9155	3646	227642	0	244269
28689	3570	3781	3012	235037	0	245400
28690	2825	2447	233668	8732	0	247672
28691	221173	2216	8674	4330	0	236393
28692	237621	2080	4152	2809	0	246662
28693	10673	1963	3349	232109	0	248094
28694	230618	1624	2987	8056	0	243285
28695	8994	230816	2953	3438	0	246201
28696	226738	7677	2600	2896	0	239911
28697	8915	221025	2712	2538	0	235190
28698	3982	222712	2348	2145	0	231187
28699	211535	8145	2426	2365	0	224471
28700	210620	3385	2166	2364	0	218535
28701	217516	2421	2175	2089	0	224201
28702	219686	2012	2130	2242	0	226070
28703	9890	1895	203392	1865	0	217042
28704	201351	1692	7164	1960	0	212167
28705	9145	1810	3304	194833	0	209092
28706	4462	202648	2511	6104	0	215725
28707	202280	6604	2127	3035	0	214046
28708	8219	203590	2071	2159	0	216039
28709	203867	7051	1955	2054	0	214927
28710	9006	3029	1939	200404	0	214378
28711	5084	2399	1798	205522	0	214803
28712	3734	2264	194378	7688	0	208064
28713	3727	2016	200451	3276	0	209470
28714	3549	202576	7457	2406	0	215988
28715	193961	6413	3289	2418	0	206081
28716	7861	192909	2399	1762	0	204931
28717	4270	191625	2071	1800	0	199766
28718	3805	201675	1933	1621	0	209034
28719	3702	7511	191990	1476	0	204679
28720	3214	195462	6175	1431	0	206282
28721	179320	6637	3011	1615	0	190583
28722	181295	3035	2016	1544	0	187890
28723	7924	2475	1791	172542	0	184732
28724	3977	172852	1758	5326	0	183913
28725	3100	179688	1803	2427	0	187018
28726	3366	6845	1695	174209	0	186115
28727	2939	3321	176598	5260	0	188118
28728	2829	172648	5549	2315	0	183341
28729	3384	6195	2356	165653	0	177588
28730	161307	3061	1698	5657	0	171723
28731	162884	2587	1664	2793	0	169928
28732	6371	166137	1732	1992	0	176232
28733	165986	5754	1776	1926	0	175442
28734	168093	2899	1671	1711	0	174374
28735	7565	2434	1624	160733	0	172356
28736	3812	2275	159294	4928	0	170309
28737	2939	163081	5081	2436	0	173537
28738	3017	6495	2401	158777	0	170690
28739	2492	3157	160274	4481	0	170404
28740	2480	156536	4518	2112	0	165646
28741	148612	4918	2517	1898	0	157945
28742	150455	2670	1683	1747	0	156555
28743	6039	2183	1372	147375	0	156969
28744	3257	150564	1467	4012	0	159300
28745	2804	4554	149547	1948	0	158853
28746	3093	3027	4126	145237	0	155483
28747	2302	2280	150790	3906	0	159278
28748	1809	139031	3374	1875	0	146089
28749	2647	3347	1998	128378	0	136370
28750	127889	1750	1156	3041	0	133836
28751	3030	128503	895	1511	0	133939
28752	125978	2899	793	1447	0	131117
28753	123975	1771	749	1273	0	127768
28754	3736	128817	727	1050	0	134330
28755	2477	2950	734	127655	0	133816
28756	2062	1993	636	127279	0	131970
28757	1529	123937	742	3101	0	129309
28758	1418	128746	787	1631	0	132582
28759	1605	3224	690	120832	0	126351
28760	1381	126495	686	2204	0	130766
28761	126781	2818	604	1439	0	131642
28762	125581	1615	559	1224	0	128979
28763	3404	1398	124705	835	0	130342
28764	1952	1176	122872	828	0	126828
28765	121306	1133	2319	1289	0	126047
28766	129637	1035	1136	1081	0	132889
28767	2796	134231	884	761	0	138672
28768	133162	2635	675	1177	0	137649
28769	132368	1466	555	1058	0	135447
28770	3106	131266	484	843	0	135699
28771	132900	2551	403	1065	0	136919
28772	3198	1612	443	149240	0	154493
28773	1940	1406	529	153900	0	157775
28774	1242	1162	159306	3983	0	165693
28775	1069	152304	3066	1425	0	157864
28776	811	162228	893	863	0	164795
28777	153238	5026	1442	1788	0	161494
28778	153753	1081	472	1087	0	156393
28779	148177	790	359	1286	0	150612
28780	156416	485	340	987	0	158228
28781	3534	651	148401	473	0	153059
28782	1142	713	154781	435	0	157071
28783	814	158837	2892	487	0	163030
28784	1355	3037	868	155859	0	161119
28785	1369	1037	510	155858	0	158774
28786	915	162518	397	2783	0	166613
28787	1354	3157	360	159409	0	164280
28788	158268	962	464	3284	0	162978
28789	3214	159956	564	873	0	164607
28790	1306	3232	162358	576	0	167472
28791	898	166136	2751	762	0	170547
28792	163701	3148	888	1027	0	168764
28793	3169	1269	164612	691	0	169741
28794	158712	830	3031	1084	0	163657
28795	166236	690	842	990	0	168758
28796	3637	834	165631	518	0	170620
28797	1133	761	164082	501	0	166477
28798	942	784	162594	475	0	164795
28799	149037	621	3441	896	0	153995
28800	3267	578	164007	358	0	168210
28801	1249	162277	3073	397	0	166996
28802	161003	2797	1063	659	0	165522
28803	3166	883	163200	219	0	167468
28804	149902	608	3344	767	0	154621
28805	3406	518	161056	236	0	165216
28806	1499	476	166152	217	0	168344
28807	1023	169218	3653	281	0	174175
28808	968	2963	170658	235	0	174824
28809	1115	902	168240	244	0	170501
28810	939	145546	4065	501	0	151051
28811	161671	2905	1466	602	0	166644
28812	3154	984	166417	224	0	170779
28813	1708	731	3437	150163	0	156039
28814	902	165489	1359	2236	0	169986
28815	164409	2902	1196	1155	0	169662
28816	162343	1023	1184	1103	0	165653
28817	3530	971	165388	489	0	170378
28818	1446	158482	3406	440	0	163774
28819	1031	165414	1675	379	0	168499
28820	1320	3801	1117	157720	0	163958
28821	1175	147012	1120	2608	0	151915
28822	2276	3654	996	137985	0	144911
28823	1701	1273	951	162641	0	166566
28824	1147	164651	1159	3335	0	170292
28825	1402	3643	996	161161	0	167202
28826	1082	163495	1029	3216	0	168822
28827	1129	3793	160366	1360	0	166648
28828	1334	1817	3353	157578	0	164082
28829	1359	1503	1237	159358	0	163457
28830	1079	159572	1045	3722	0	165418
28831	1137	165629	956	1442	0	169164
28832	1354	4312	825	156927	0	163418
28833	955	162120	1105	3279	0	167459
28834	157113	4122	1089	1777	0	164101
28835	3778	1757	1022	158675	0	165232
28836	1348	161519	1119	3592	0	167578
28837	156349	3870	1019	1679	0	162917
28838	3592	157175	1157	1135	0	163059
28839	1554	3992	154419	1179	0	161144
28840	1653	1842	3754	151778	0	159027
28841	153359	1569	1714	3782	0	160424
28842	3910	1311	157727	1425	0	164373
28843	1896	1526	3924	149566	0	156912
28844	1703	154706	1638	3028	0	161075
28845	1606	3996	151823	1104	0	158529
28846	1328	155617	4027	938	0	161910
28847	139999	3752	2027	1261	0	147039
28848	151315	1642	1885	1005	0	155847
28849	4207	150484	1850	764	0	157305
28850	148860	3784	1808	1091	0	155543
28851	3979	1792	147560	672	0	154003
28852	1947	1453	4378	142915	0	150693
28853	1724	1485	2133	144158	0	149500
28854	1842	60277	1681	89623	0	153423
28855	151765	2329	1872	3218	0	159184
28856	154793	1638	1448	1626	0	159505
28857	4162	1571	154515	739	0	160987
28858	151621	1183	3976	1149	0	157929
28859	157908	1354	1837	1093	0	162192
28860	159056	1198	1600	1160	0	163014
28861	4843	1380	1340	153865	0	161428
28862	2328	1409	1349	155989	0	161075
28863	1682	159350	1210	3690	0	165932
28864	152433	3890	1289	1686	0	159298
28865	154584	1448	1025	1716	0	158773
28866	4376	155278	1007	1135	0	161796
28867	2131	4061	945	151255	0	158392
28868	1484	156054	780	3624	0	161942
28869	1216	165958	879	1328	0	169381
28870	158815	4676	1071	1600	0	166162
28871	4417	1874	156968	1218	0	164477
28872	1052	850	137848	471	0	140221
28873	670	138454	2378	496	0	141998
28874	127076	2065	1209	694	0	131044
28875	2051	787	129741	312	0	132891
28876	674	118936	1956	353	0	121919
28877	118868	1844	527	525	0	121764
28878	1861	633	119011	190	0	121695
28879	884	400	1841	114840	0	117965
28880	122219	372	481	2224	0	125296
28881	2216	384	121821	560	0	124981
28882	718	418	125796	341	0	127273
28883	484	412	128496	281	0	129673
28884	419	320	128859	225	0	129823
28885	119390	318	2792	564	0	123064
28886	134595	236	842	551	0	136224
28887	2517	136146	485	275	0	139423
28888	1132	2401	353	137593	0	141479
28889	794	615	348	141218	0	142975
28890	346	138440	350	2749	0	141885
28891	756	2784	276	137205	0	141021
28892	351	142470	340	2692	0	145853
28893	289	147138	321	834	0	148582
28894	748	3435	276	142994	0	147453
28895	380	1250	145084	2857	0	149571
28896	263	145943	3021	894	0	150121
28897	701	3057	988	145783	0	150529
28898	146901	1004	678	3378	0	151961
28899	3145	771	146675	936	0	151527
28900	141484	583	3082	1042	0	146191
28901	148797	594	981	839	0	151211
28902	4275	517	636	149007	0	154435
28903	1412	566	153354	3520	0	158852
28904	963	582	151948	1236	0	154729
28905	613	158735	4346	849	0	164543
28906	1098	4018	1533	152647	0	159296
28907	599	1396	155433	3669	0	161097
28908	640	852	155251	1284	0	158027
28909	424	158761	4908	889	0	164982
28910	157686	4057	1853	958	0	164554
28911	161988	1371	1137	875	0	165371
28912	5391	864	919	165273	0	172447
28913	1994	629	171016	4377	0	178016
28914	1321	611	170084	1550	0	173566
28915	925	176208	5778	1132	0	184043
28916	831	4484	179003	754	0	185072
28917	778	1722	178721	660	0	181881
28918	1274	1400	6381	165691	0	174746
28919	584	953	179400	4615	0	185552
28920	169600	674	5677	2039	0	177990
28921	4970	621	2509	177865	0	185965
28922	1736	690	183764	4756	0	190946
28923	1180	184228	5419	1821	0	192648
28924	1395	4715	2372	183805	0	192287
28925	899	1855	189454	4829	0	197037
28926	736	194204	5791	2041	0	202772
28927	1323	5348	2686	185417	0	194774
28928	733	198760	1925	4916	0	206334
28929	1192	5870	1649	197174	0	205885
28930	1273	2218	1535	199881	0	204907
28931	613	1511	197730	6998	0	206852
28932	647	198349	5987	2958	0	207941
28933	1174	5757	2575	196364	0	205870
28934	1166	2198	1825	200089	0	205278
28935	1038	1518	1633	203925	0	208114
28936	634	1335	198127	7621	0	207717
28937	507	196509	6042	3468	0	206526
28938	991	5746	2628	195984	0	205349
28939	650	2348	197601	6205	0	206804
28940	521	196772	6219	3025	0	206537
28941	934	5941	2856	194936	0	204667
28942	663	2669	197499	6201	0	207032
28943	619	197128	6137	3235	0	207119
28944	1038	5849	2861	192210	0	201958
28945	908	2589	2163	200987	0	206647
28946	575	1961	202046	7617	0	212199
28947	181878	1529	6287	4663	0	194357
28948	4919	201621	2971	2835	0	212346
28949	201026	5991	2222	2705	0	211944
28950	5716	2733	202977	2081	0	213507
28951	199603	1989	6597	2361	0	210550
28952	6241	1614	3048	202834	0	213737
28953	2528	1568	2272	210556	0	216924
28954	1427	1547	206738	7821	0	217533
28955	185566	1449	6502	4495	0	198012
28956	194960	1394	3066	3250	0	202670
28957	6463	193724	2330	2502	0	205019
28958	2515	203340	2020	2242	0	210117
28959	199915	7105	1897	2442	0	211359
28960	6237	3121	200109	2030	0	211497
28961	2625	205046	6534	2065	0	216270
28962	2347	6316	3016	206299	0	217978
28963	1902	2684	2266	213375	0	220227
28964	1413	1936	210310	7526	0	221185
28965	196009	1513	6632	4334	0	208488
28966	6192	1500	213526	2716	0	223934
28967	203402	1314	6798	2707	0	214221
28968	6402	1355	213896	1803	0	223456
28969	2763	212722	6726	1679	0	223890
28970	213182	5764	3746	2075	0	224767
28971	215170	2785	2407	2133	0	222495
28972	211606	1796	1960	2118	0	217480
28973	214843	1467	1902	1828	0	220040
28974	8181	1343	1775	209697	0	220996
28975	3567	1467	208591	6101	0	219726
28976	2807	1414	6162	199776	0	210159
28977	1962	206963	2997	6108	0	218030
28978	2242	5298	2358	208352	0	218250
28979	1801	2499	208933	6180	0	219413
28980	1660	1640	207571	2960	0	213831
28981	2251	1419	7042	201883	0	212595
28982	199714	1227	3602	6147	0	210690
28983	193916	1241	2254	3200	0	200611
28984	197483	1161	1953	2521	0	203118
28985	7568	1227	196734	1786	0	207315
28986	3608	1082	191699	1765	0	198154
28987	2479	189220	6416	1740	0	199855
28988	1925	195631	3052	1734	0	202342
28989	185717	5487	2931	2015	0	196150
28990	187726	2389	1883	1977	0	193975
28991	5849	194061	1538	1693	0	203141
28992	189186	4351	1427	1883	0	196847
28993	189824	1970	1467	1799	0	195060
28994	5887	191412	1488	1403	0	200190
28995	192445	4379	1361	1761	0	199946
28996	189898	2133	1304	1771	0	195106
28997	5982	192846	1373	1364	0	201565
28998	192671	4424	1416	1599	0	200110
28999	192258	2004	1504	1673	0	197439
29000	6256	1516	192339	1189	0	201300
29001	3342	1288	189899	1149	0	195678
29002	2373	186403	4760	1058	0	194594
29003	2173	192950	2217	982	0	198322
29004	189382	4593	2617	1341	0	197933
29005	183836	1991	1376	1191	0	188394
29006	181037	1361	1235	1078	0	184711
29007	5375	182100	1183	655	0	189313
29008	3018	3578	886	180551	0	188033
29009	2389	1875	183472	2948	0	190684
29010	2823	2468	3316	172520	0	181127
29011	2143	184350	1680	2904	0	191077
29012	179130	2929	1051	1395	0	184505
29013	3853	178399	867	746	0	183865
29014	2408	3149	828	177117	0	183502
29015	186009	1484	850	3278	0	191621
29016	185202	1042	788	1581	0	188613
29017	4751	1103	183675	742	0	190271
29018	185320	965	3036	1223	0	190544
29019	197481	849	1429	1104	0	200863
29020	199931	870	1067	1136	0	203004
29021	5289	1091	987	189878	0	197245
29022	2737	192805	878	3156	0	199576
29023	2528	3555	894	195027	0	202004
29024	2122	1654	197023	3359	0	204158
29025	1881	196679	3508	1515	0	203583
29026	2200	3271	1335	189734	0	196540
29027	1783	1575	191711	2860	0	197929
29028	1671	190778	3107	1378	0	196934
29029	2375	3361	1445	180474	0	187655
29030	1889	1598	188830	2932	0	195249
29031	165122	1243	3345	2627	0	172337
29032	4251	1144	193550	926	0	199871
29033	2627	1151	192104	875	0	196757
29034	2065	195459	3958	869	0	202351
29035	2329	3627	1742	193145	0	200843
29036	2420	1929	1150	187290	0	192789
29037	1851	189706	1210	3584	0	196351
29038	2284	3570	1195	197721	0	204770
29039	200856	1768	1059	4229	0	207912
29040	200696	1346	1136	2160	0	205338
29041	5166	1486	186036	1354	0	194042
29042	194177	1341	3156	1726	0	200400
29043	202408	1244	1485	1782	0	206919
29044	5232	1230	203948	1110	0	211520
29045	2647	202414	3943	1008	0	210012
29046	1971	205320	1909	1074	0	210274
29047	2700	4758	1411	180372	0	189241
29048	1802	201334	1245	2959	0	207340
29049	2293	4423	176614	1581	0	184911
29050	2216	2030	190270	1299	0	195815
29051	2009	200520	4352	891	0	207772
29052	196514	4151	1894	1442	0	204001
29053	202019	2231	1279	1412	0	206941
29054	203728	1775	1030	1449	0	207982
29055	203231	1580	973	1445	0	207229
29056	188195	1732	1006	1800	0	192733
29057	5257	199366	1076	833	0	206532
29058	2851	4132	196321	707	0	204011
29059	2870	2008	3476	191759	0	200113
29060	189908	1489	1491	3953	0	196841
29061	4769	188582	1037	1488	0	195876
29062	2902	3976	851	181292	0	189021
29063	2137	1712	183052	3043	0	189944
29064	1741	175825	3504	1279	0	182349
29065	1198	181288	1494	910	0	184890
29066	169546	4564	1841	1783	0	177734
29067	3185	170286	653	720	0	174844
29068	1922	2903	552	163323	0	168700
29069	162942	1223	554	3039	0	167758
29070	162354	910	593	1417	0	165274
29071	162900	870	558	1149	0	165477
29072	3602	960	161123	479	0	166164
29073	1591	163253	2537	559	0	167940
29074	164753	2880	992	956	0	169581
29075	3275	1446	594	164630	0	169945
29076	166552	937	454	3361	0	171304
29077	3487	166173	644	1177	0	171481
29078	173789	2989	532	1194	0	178504
29079	184790	1384	566	1064	0	187804
29080	5226	960	611	180093	0	186890
29081	2467	1128	185184	3465	0	192244
29082	2379	775	3461	185828	0	192443
29083	185803	702	1455	4714	0	192674
29084	187842	853	1006	2223	0	191924
29085	5532	186022	952	1255	0	193761
29086	180145	3605	796	1497	0	186043
29087	4883	182302	781	1144	0	189110
29088	181551	4000	722	1541	0	187814
29089	175488	1785	688	1839	0	179800
29090	5211	1507	179247	977	0	186942
29091	2513	179111	3523	1047	0	186194
29092	2410	4237	1573	179771	0	187991
29093	2060	2014	1187	183323	0	188584
29094	1875	1573	930	176451	0	180829
29095	1431	181021	1056	5075	0	188583
29096	1450	4096	179873	2228	0	187647
29097	1463	1992	181937	1454	0	186846
29098	1301	216022	4823	1281	0	223427
29099	214326	5470	2124	1712	0	223632
29100	5725	2328	215339	1064	0	224456
29101	204847	1943	5425	1660	0	213875
29102	6282	212149	2461	952	0	221844
29103	3039	5570	213222	920	0	222751
29104	2874	2565	5639	207456	0	218534
29105	1757	2351	215812	5358	0	225278
29106	1786	1577	220316	2467	0	226146
29107	2971	1301	6970	198178	0	209420
29108	2126	210130	3174	4844	0	220274
29109	1758	221225	2173	1791	0	226947
29110	216581	6497	1801	1748	0	226627
29111	6038	3043	215507	1162	0	225750
29112	210695	2258	5775	1537	0	220265
29113	215894	1573	2896	1364	0	221727
29114	6868	218040	2122	948	0	227978
29115	208105	5460	1044	1077	0	215686
29116	209450	2681	946	1043	0	214120
29117	199927	1666	1141	1115	0	203849
29118	7217	193878	1147	957	0	203199
29119	3893	178772	1120	687	0	184472
29120	2506	192528	1001	611	0	196646
29121	190536	6104	1717	1006	0	199363
29122	190967	2930	1037	901	0	195835
29123	6745	2031	176269	517	0	185562
29124	3687	1413	178976	416	0	184492
29125	183729	1218	4916	818	0	190681
29126	190051	1122	2152	936	0	194261
29127	192395	1028	1639	1049	0	196111
29128	7047	896	1191	185036	0	194170
29129	4188	744	938	188936	0	194806
29130	3050	875	1056	192012	0	196993
29131	2521	1127	880	193408	0	197936
29132	2023	1340	175299	5736	0	184398
29133	1927	1151	180619	2618	0	186315
29134	2007	997	181558	1698	0	186260
29135	1982	828	181380	1207	0	185397
29136	177020	784	5636	1354	0	184794
29137	4740	181397	2912	1057	0	190106
29138	2806	190249	1966	996	0	196017
29139	187145	4834	1474	1167	0	194620
29140	5376	2560	186686	850	0	195472
29141	2824	1984	181178	942	0	186928
29142	176299	1458	5573	1669	0	184999
29143	184586	1156	2814	1616	0	190172
29144	5684	186617	1991	1231	0	195523
29145	3953	4071	1492	186017	0	195533
29146	190735	1899	1596	3960	0	198190
29147	195023	1681	1619	2003	0	200326
29148	6582	1476	1373	189073	0	198504
29149	4068	198615	1197	3773	0	207653
29150	199481	4190	1000	2403	0	207074
29151	5306	2401	196901	1791	0	206399
29152	189959	1923	4265	1998	0	198145
29153	5463	198336	2314	1390	0	207503
29154	200467	4205	2013	1713	0	208398
29155	195407	2190	1751	1845	0	201193
29156	5854	2008	200656	1020	0	209538
29157	3551	1483	195574	848	0	201456
29158	193853	1402	5942	1140	0	202337
29159	201876	1449	3135	1178	0	207638
29160	5984	206972	2169	707	0	215832
29161	4269	4311	1649	208847	0	219076
29162	3076	2157	209542	3674	0	218449
29163	204052	1886	4941	1971	0	212850
29164	5674	1612	2809	211103	0	221198
29165	3933	1330	2135	216071	0	223469
29166	215552	1355	1778	5389	0	224074
29167	5344	225632	1716	2896	0	235588
29168	227665	4415	1486	2663	0	236229
29169	228857	2128	1707	1817	0	234509
29170	231892	1913	1546	1738	0	237089
29171	7103	230022	1420	1450	0	239995
29172	232687	4471	1406	1385	0	239949
29173	7179	2151	1441	229663	0	240434
29174	4514	2157	1182	229820	0	237673
29175	3858	1740	230770	5210	0	241578
29176	3475	1484	225607	2499	0	233065
29177	3084	228041	5081	1881	0	238087
29178	2482	232513	2472	1279	0	238746
29179	2560	4281	221502	758	0	229101
29180	2056	223850	3763	985	0	230654
29181	223268	4696	2054	1529	0	231547
29182	225387	1765	1157	1100	0	229409
29183	228849	1359	892	1037	0	232137
29184	6202	1322	750	217128	0	225402
29185	3452	1115	764	224606	0	229937
29186	2187	1012	229753	4521	0	237473
29187	1606	229480	3595	2442	0	237123
29188	226460	3781	1469	2043	0	233753
29189	4501	231521	1282	856	0	238160
29190	229817	4215	967	1138	0	236137
29191	231847	1722	717	1264	0	235550
29192	6131	1210	820	223681	0	231842
29193	3651	965	925	224758	0	230299
29194	2790	967	662	232711	0	237130
29195	2207	887	224089	5308	0	232491
29196	1629	218876	3392	2937	0	226834
29197	1393	219236	1542	2023	0	224194
29198	612	185953	425	659	0	187649
29199	576	185805	385	616	0	187382
29200	559	188341	400	560	0	189860
29201	167555	2314	671	970	0	171510
29202	2064	1018	178416	413	0	181911
29203	841	181178	1752	439	0	184210
29204	738	1984	172845	302	0	175869
29205	596	180689	1686	431	0	183402
29206	2404	3558	1220	117430	0	124612
29207	988	885	344	168096	0	170313
29208	533	174995	371	1937	0	177836
29209	166773	1819	417	1287	0	170296
29210	1900	905	168331	455	0	171591
29211	787	171603	1604	554	0	174548
29212	677	2041	167733	389	0	170840
29213	857	895	1685	163960	0	167397
29214	1068	697	646	154409	0	156820
29215	651	167087	433	1856	0	170027
29216	814	1864	391	168564	0	171633
29217	906	868	363	168693	0	170830
29218	528	168862	467	2033	0	171890
29219	565	1997	164050	829	0	167441
29220	572	925	161412	719	0	163628
29221	148765	719	2059	1262	0	152805
29222	165587	694	714	856	0	167851
29223	2304	627	483	162669	0	166083
29224	919	747	162631	1808	0	166105
29225	992	699	1769	154819	0	158279
29226	562	166141	808	1909	0	169420
29227	628	1946	165495	938	0	169007
29228	539	163969	1815	761	0	167084
29229	607	2169	162784	574	0	166134
29230	449	165153	1844	660	0	168106
29231	161192	2025	781	939	0	164937
29232	2029	1057	546	160152	0	163784
29233	1129	786	569	158689	0	161173
29234	685	815	161671	2045	0	165216
29235	830	755	152802	919	0	155306
29236	1184	159711	2013	748	0	163656
29237	158131	1981	834	1167	0	162113
29238	2060	881	658	155313	0	158912
29239	813	795	159516	1822	0	162946
29240	646	818	151514	915	0	153893
29241	133325	678	2327	1360	0	137690
29242	146158	747	893	1120	0	148918
29243	2056	767	152670	587	0	156080
29244	1172	1033	1753	142796	0	146754
29245	647	149322	812	1646	0	152427
29246	149318	1745	655	1340	0	153058
29247	1685	149498	609	792	0	152584
29248	143940	1657	543	991	0	147131
29249	1608	143382	518	502	0	146010
29250	723	145957	442	538	0	147660
29251	823	1900	433	143698	0	146854
29252	725	855	394	144033	0	146007
29253	419	145651	476	1924	0	148470
29254	541	1820	140328	769	0	143458
29255	583	886	136092	580	0	138141
29256	519	706	138547	464	0	140236
29257	125848	601	1948	1079	0	129476
29258	137171	512	738	1022	0	139443
29259	1751	150253	524	641	0	153169
29260	729	2455	147255	469	0	150908
29261	764	1218	2261	144606	0	148849
29262	391	850	155322	2447	0	159010
29263	389	778	159084	1001	0	161252
29264	842	714	3540	168893	0	173989
29265	889	683	1349	180704	0	183625
29266	382	682	192472	4902	0	198438
29267	172861	587	3899	3525	0	180872
29268	3944	192602	2270	1573	0	200389
29269	2022	203950	1588	964	0	208524
29270	1887	6091	902	195430	0	204310
29271	202862	3130	743	4726	0	211461
29272	4852	208762	769	2273	0	216656
29273	207376	5748	553	2062	0	215739
29274	5811	211392	617	1105	0	218925
29275	216430	6523	500	1719	0	225172
29276	6964	3495	214605	939	0	226003
29277	3683	2471	218341	811	0	225306
29278	3477	2336	7031	206932	0	219776
29279	1804	1608	211891	5301	0	220604
29280	1546	198624	6826	2595	0	209591
29281	1570	201390	3492	1761	0	208213
29282	203241	7435	2627	1464	0	214767
29283	6355	4113	1772	194585	0	206825
29284	2836	206928	1581	5475	0	216820
29285	208423	6300	1280	3041	0	219044
29286	203964	3831	1215	2034	0	211044
29287	210356	2717	1107	1445	0	215625
29288	9993	2036	1036	202048	0	215113
29289	6051	1503	1021	207210	0	215785
29290	3483	1543	205942	7809	0	218777
29291	2565	1529	205097	4054	0	213245
29292	199852	1202	7689	3294	0	212037
29293	7531	1195	4186	200765	0	213677
29294	3972	1420	203100	6578	0	215070
29295	195915	1374	6550	4364	0	208203
29296	7237	209896	3822	2817	0	223772
29297	212750	5792	2839	2640	0	224021
29298	216658	3301	1893	2288	0	224140
29299	217822	2108	1643	2220	0	223793
29300	10975	1417	209184	1785	0	223361
29301	207746	1208	6569	1802	0	217325
29302	10161	1211	3520	199169	0	214061
29303	5702	194772	2683	6191	0	209348
29304	4630	212644	2324	3186	0	222784
29305	211604	7328	2243	2645	0	223820
29306	214402	3807	1794	2066	0	222069
29307	217067	2577	1548	2232	0	223424
29308	11978	1980	1533	206502	0	221993
29309	7539	1886	1310	211202	0	221937
29310	6012	2119	1191	204686	0	214008
29311	4684	209925	1202	8970	0	224781
29312	210500	6411	1190	5264	0	223365
29313	214607	3575	1010	3862	0	223054
29314	218428	2807	1298	3203	0	225736
29315	11844	2199	211495	2610	0	228148
29316	215064	2124	6187	2939	0	226314
29317	11515	2338	3059	202365	0	219277
29318	6783	212126	2337	6383	0	227629
29319	214277	6910	1508	4040	0	226735
29320	213898	3561	1520	3552	0	222531
29321	11994	2802	213838	2331	0	230965
29322	8008	2006	6638	206872	0	223524
29323	5555	217064	3478	7390	0	233487
29324	225040	7168	2521	4641	0	239370
29325	10511	4285	1865	223445	0	240106
29326	7541	3042	1866	223134	0	235583
29327	6159	2155	1752	229830	0	239896
29328	5132	2144	1774	236580	0	245630
29329	4353	2230	227891	12367	0	246841
29330	4453	228319	7525	6813	0	247110
29331	4789	7972	3633	229806	0	246200
29332	3775	4467	231698	10081	0	250021
29333	225634	3340	8051	6665	0	243690
29334	237940	2413	4228	5269	0	249850
29335	12327	2424	3681	234526	0	252958
29336	237437	2374	2704	10329	0	252844
29337	243047	2502	2270	6534	0	254353
29338	13469	2268	236860	4781	0	257378
29339	8292	236592	8322	4147	0	257353
29340	241911	7870	4289	4424	0	258494
29341	11839	3992	3394	241388	0	260613
29342	247475	3010	2744	10309	0	263538
29343	12918	2340	2865	244115	0	262238
29344	8057	2627	2406	250507	0	263597
29345	6302	2381	240212	12441	0	261336
29346	220555	2008	8343	8437	0	239343
29347	11381	244107	4190	5723	0	265401
29348	7762	8049	241594	4528	0	261933
29349	6193	245149	8197	4634	0	264173
29350	243630	9264	4371	4198	0	261463
29351	12233	4587	3346	241392	0	261558
29352	242388	3334	2871	9961	0	258554
29353	11957	239333	2544	5871	0	259705
29354	245012	8613	2336	4944	0	260905
29355	249093	4391	2228	4558	0	260270
29356	249969	3247	2069	4064	0	259349
29357	247273	2437	1985	4282	0	255977
29358	14889	239722	2105	3886	0	260602
29359	235563	7745	2012	3150	0	248470
29360	13340	4322	1785	228917	0	248364
29361	9167	3824	1442	225760	0	240193
29362	7273	209181	1654	9188	0	227296
29363	6265	208038	1408	5437	0	221148
29364	5250	202922	1169	3311	0	212652
29365	189442	7158	1493	3053	0	201146
29366	7755	176295	919	2265	0	187234
29367	4263	169228	825	1778	0	176094
29368	165385	5288	1913	2090	0	174676
29369	161498	2287	810	1818	0	166413
29370	6650	161042	770	1589	0	170051
29371	156276	4267	643	1744	0	162930
29372	5794	2058	150075	1354	0	159281
29373	144063	1721	3114	1688	0	150586
29374	5522	1525	147875	1501	0	156423
29375	2603	134209	2665	1224	0	140701
29376	2083	139232	1037	1194	0	143546
29377	4152	3942	1580	132787	0	142461
29378	136448	1424	804	3177	0	141853
29379	138230	1122	523	1738	0	141613
29380	140062	1118	565	1637	0	143382
29381	139391	1017	670	1497	0	142575
29382	136432	1130	563	1401	0	139526
29383	4004	1110	130389	1097	0	136600
29384	2270	1248	122318	1073	0	126909
29385	129526	1128	2345	1317	0	134316
29386	10373	127592	1011	1025	0	140001
29387	134093	2348	766	1304	0	138511
29388	137148	1145	589	1263	0	140145
29389	139975	953	522	1368	0	142818
29390	139529	889	599	1304	0	142321
29391	139135	930	653	1370	0	142088
29392	4047	959	135471	1117	0	141594
29393	137629	967	2210	1597	0	142403
29394	140033	981	1007	1495	0	143516
29395	3995	1336	127944	1204	0	134479
29396	125820	1123	1515	1637	0	130095
29397	136385	1081	963	1396	0	139825
29398	4255	1077	140303	942	0	146577
29399	2904	1096	136802	800	0	141602
29400	2625	141704	2723	835	0	147887
29401	2841	2668	1207	141542	0	148258
29402	2607	1332	143676	2279	0	149894
29403	142926	1058	2431	1563	0	147978
29404	4370	964	1122	152158	0	158614
29405	2698	1051	157077	2543	0	163369
29406	153251	1038	2637	1705	0	158631
29407	160555	1086	1124	1304	0	164069
29408	161775	1060	789	1241	0	164865
29409	4839	164189	658	1052	0	170738
29410	3191	3010	669	158300	0	165170
29411	2530	163943	847	2685	0	170005
29412	164536	3244	862	1483	0	170125
29413	162502	1482	955	1376	0	166315
29414	4522	1357	160454	603	0	166936
29415	2374	154289	2511	529	0	159703
29416	1939	158919	1050	542	0	162450
29417	2245	3164	679	155505	0	161593
29418	2279	1527	492	158009	0	162307
29419	156800	1094	427	3130	0	161451
29420	4081	155123	466	1310	0	160980
29421	2596	153986	417	628	0	157627
29422	2614	3060	150723	434	0	156831
29423	1949	155247	2182	468	0	159846
29424	151257	2748	884	968	0	155857
29425	3617	1322	149470	496	0	154905
29426	131407	811	1969	1054	0	135241
29427	2945	700	142922	449	0	147016
29428	122013	429	1867	1041	0	125350
29429	2162	141092	689	365	0	144308
29430	140745	2124	487	605	0	143961
29431	2488	917	144084	223	0	147712
29432	140637	646	2129	911	0	144323
29433	143723	442	697	710	0	145572
29434	2724	547	149713	153	0	153137
29435	146047	499	1903	689	0	149138
29436	153647	410	781	601	0	155439
29437	151245	462	519	580	0	152806
29438	3066	149182	430	177	0	152855
29439	150258	2007	425	692	0	153382
29440	2859	882	152715	228	0	156684
29441	1297	166688	1983	277	0	170245
29442	169723	2530	821	650	0	173724
29443	167542	833	475	663	0	169513
29444	170297	520	356	697	0	171870
29445	3830	169068	432	339	0	173669
29446	2001	2826	325	186996	0	192148
29447	1126	994	186518	3394	0	192032
29448	1377	605	3770	184111	0	189863
29449	943	533	189320	3949	0	194745
29450	176234	425	4151	1849	0	182659
29451	4522	191041	1293	645	0	197501
29452	2437	4096	723	185364	0	192620
29453	1339	194364	632	3455	0	199790
29454	1589	4576	549	192635	0	199349
29455	1426	1663	536	193502	0	197127
29456	1140	199195	636	5072	0	206043
29457	1650	4807	492	199752	0	206701
29458	1633	1712	475	207417	0	211237
29459	1022	207390	600	5850	0	214862
29460	945	216772	567	2295	0	220579
29461	1386	6301	679	211854	0	220220
29462	1055	2360	212157	5691	0	221263
29463	960	216060	5395	2185	0	224600
29464	1660	6039	1613	213550	0	222862
29465	1167	2502	222118	5925	0	231712
29466	905	225177	5835	2497	0	234414
29467	221399	6687	1753	2368	0	232207
29468	6299	2550	223136	1516	0	233501
29469	216947	1880	6115	2044	0	226986
29470	7086	1684	1911	220317	0	230998
29471	2872	1408	1351	224589	0	230220
29472	2147	1456	1037	226787	0	231427
29473	1374	1755	220551	8271	0	231951
29474	1374	1700	217426	3248	0	223748
29475	207634	1532	7329	3003	0	219498
29476	7020	1400	2749	219631	0	230800
29477	2410	1557	222130	6951	0	233048
29478	215683	1484	6500	3647	0	227314
29479	7275	1382	2614	221339	0	232610
29480	3178	1533	1844	224268	0	230823
29481	2721	1427	1521	222331	0	228000
29482	1786	223699	1596	8297	0	235378
29483	2388	6510	1376	214410	0	224684
29484	1732	216155	1363	7336	0	226586
29485	1553	228488	1327	3578	0	234946
29486	221754	7648	1379	3395	0	234176
29487	200140	3162	1803	3563	0	208668
29488	223240	2021	1630	2740	0	229631
29489	8183	220467	1434	2357	0	232441
29490	218758	6760	1324	2787	0	229629
29491	223144	2680	1495	2524	0	229843
29492	9007	1939	1460	216242	0	228648
29493	4106	1652	1331	220604	0	227693
29494	2669	1642	213482	8964	0	226757
29495	2112	218749	6336	4346	0	231543
29496	211810	6849	2421	3525	0	224605
29497	214976	2824	1732	3092	0	222624
29498	7606	214356	1475	2570	0	226007
29499	212602	7078	1299	2909	0	223888
29500	213868	2941	1235	2902	0	220946
29501	8883	2487	1179	206798	0	219347
29502	4232	201151	1282	7077	0	213742
29503	3156	211309	1236	3252	0	218953
29504	205057	7462	1166	3260	0	216945
29505	8045	3388	1071	201734	0	214238
29506	3212	2514	199443	7539	0	212708
29507	189188	2051	5852	4533	0	201624
29508	6941	2158	204605	3169	0	216873
29509	3164	202144	6255	2540	0	214103
29510	200161	6418	2418	3113	0	212110
29511	7103	3005	199963	4499	0	214570
29512	3524	2901	5959	204487	0	216871
29513	2845	2383	213857	7272	0	226357
29514	2481	217458	6163	3859	0	229961
29515	2700	6838	2585	218241	0	230364
29516	2341	3536	216944	7339	0	230160
29517	196461	2632	6006	4930	0	210029
29518	6502	222738	2532	3319	0	235091
29519	3557	6626	1865	212962	0	225010
29520	2417	225203	2019	6631	0	236270
29521	221644	7203	1831	3785	0	234463
29522	221594	3453	1715	3753	0	230515
29523	7092	224100	1842	3295	0	236329
29524	3993	6734	1875	215276	0	227878
29525	2733	225914	2010	6301	0	236958
29526	223349	6842	1851	3934	0	235976
29527	222303	3321	2071	3266	0	230961
29528	7760	3132	221872	2625	0	235389
29529	3894	220920	5516	2768	0	233098
29530	3007	232826	3004	2516	0	241353
29531	3137	7045	1935	228283	0	240400
29532	226446	3318	1837	7086	0	238687
29533	227375	2407	2033	3761	0	235576
29534	220374	2116	1640	3163	0	227293
29535	8257	224406	1819	2806	0	237288
29536	4380	5874	1658	219762	0	231674
29537	3462	224633	1561	6217	0	235873
29538	224164	6205	1635	3691	0	235695
29539	7707	2851	1390	221461	0	233409
29540	3876	1954	212637	6136	0	224603
29541	2623	209119	4658	3131	0	219531
29542	203086	4891	2011	2614	0	212602
29543	5645	2448	204309	1868	0	214270
29544	193985	2255	4144	2517	0	202901
29545	5673	201577	1518	2234	0	211002
29546	2140	187993	865	1152	0	192150
29547	183170	3775	767	1205	0	188917
29548	3886	187587	585	1018	0	193076
29549	183466	3505	627	1205	0	188803
29550	3550	185925	522	837	0	190834
29551	185409	3461	594	1088	0	190552
29552	185233	1557	564	978	0	188332
29553	4100	1296	188767	695	0	194858
29554	1834	1137	182956	531	0	186458
29555	1430	187907	2481	602	0	192420
29556	185364	2517	1341	945	0	190167
29557	2861	1053	182459	468	0	186841
29558	171350	760	2039	774	0	174923
29559	2348	983	815	174224	0	178370
29560	997	622	178345	1385	0	181349
29561	904	581	166874	606	0	168965
29562	892	571	178199	354	0	180016
29563	568	180993	1464	292	0	183317
29564	1851	2578	1625	175499	0	181553
29565	173556	294	286	1088	0	175224
29566	896	148	210	176939	0	178193
29567	178668	155	183	1267	0	180273
29568	1155	150	165	179892	0	181362
29569	181308	154	139	1679	0	183280
29570	175369	340	219	1530	0	177458
29571	201019	129	162	932	0	202242
29572	2203	207392	160	245	0	210000
29573	850	2109	210253	157	0	213369
29574	832	666	2099	208844	0	212441
29575	5860	1811	3754	106866	0	118291
29576	729	345	313	215438	0	216825
29577	828	291	248	211507	0	212874
29578	527	205884	295	3202	0	209908
29579	458	2544	204965	1225	0	209192
29580	301	208957	2531	909	0	212698
29581	1161	2804	890	190398	0	195253
29582	630	1143	406	211239	0	213418
29583	664	555	296	212614	0	214129
29584	806	554	257	210394	0	212011
29585	320	204991	393	3523	0	209227
29586	275	208089	598	1512	0	210474
29587	382	3300	203538	1077	0	208297
29588	735	1176	2570	202870	0	207351
29589	794	791	830	205277	0	207692
29590	578	739	461	212037	0	213815
29591	209458	757	334	4759	0	215308
29592	2963	210915	480	1676	0	216034
29593	1221	3318	207402	1029	0	212970
29594	204134	1094	2928	1639	0	209795
29595	3359	784	893	208496	0	213532
29596	210042	630	463	4303	0	215438
29597	3710	637	366	211674	0	216387
29598	211929	689	395	4085	0	217098
29599	3777	801	459	211636	0	216673
29600	209063	539	742	4227	0	214571
29601	3854	604	215734	1626	0	221818
29602	2285	443	2882	212266	0	217876
29603	1341	223464	1078	3252	0	229135
29604	1592	3291	622	226800	0	232305
29605	224563	1393	523	4616	0	231095
29606	3789	223842	672	1858	0	230161
29607	2291	3871	513	231412	0	238087
29608	1147	232326	654	4301	0	238428
29609	1513	4584	404	234036	0	240537
29610	1357	1936	379	236840	0	240512
29611	1174	1121	231948	5707	0	239950
29612	1650	848	4135	223325	0	229958
29613	899	1021	219528	5085	0	226533
29614	643	215267	4618	2678	0	223206
29615	212557	4521	1649	2241	0	220968
29616	4461	1779	215891	1743	0	223874
29617	203676	960	4686	2245	0	211567
29618	217081	802	1886	1789	0	221558
29619	6327	796	1243	218140	0	226506
29620	2173	932	224000	5253	0	232358
29621	213302	883	5091	3222	0	222498
29622	234384	643	2073	2456	0	239556
29623	7139	650	1354	227056	0	236199
29624	3453	646	977	229671	0	234747
29625	1968	230264	811	7020	0	240063
29626	2033	5366	909	225921	0	234229
29627	1278	231414	1036	6085	0	239813
29628	1583	5536	228517	2905	0	238541
29629	1592	2154	4694	222569	0	231009
29630	217093	1061	1791	6644	0	226589
29631	221440	891	889	3557	0	226777
29632	5941	223738	762	2127	0	232568
29633	2893	5020	734	229357	0	238004
29634	230718	2166	731	6364	0	239979
29635	5610	228064	921	2903	0	237498
29636	228973	5528	508	2843	0	237852
29637	7066	2170	553	239446	0	249235
29638	249069	1566	521	7430	0	258586
29639	7408	1526	262633	3104	0	274671
29640	3025	263927	6779	2359	0	276090
29641	260566	7231	2386	2828	0	273011
29642	7511	270890	1389	2048	0	281838
29643	273290	7835	1052	2480	0	284657
29644	280875	3007	703	2741	0	287326
29645	10569	2090	276733	1711	0	291103
29646	5248	1677	7622	270484	0	285031
29647	280270	1590	2480	8951	0	293291
29648	9265	1554	278087	3323	0	292229
29649	274725	1552	8068	2865	0	287210
29650	10391	1419	2583	277251	0	291644
29651	4550	1409	277662	8670	0	292291
29652	3667	1168	8353	273822	0	287010
29653	268470	1239	3087	10264	0	283060
29654	9551	1433	274359	4046	0	289389
29655	5351	1407	8215	271245	0	286218
29656	4410	1347	3150	276701	0	285608
29657	276064	1020	2259	11472	0	290815
29658	275670	989	2320	5677	0	284656
29659	10880	277724	1980	3910	0	294494
29660	6551	7915	1662	274157	0	290285
29661	4922	3091	1994	278333	0	288340
29662	4340	2085	1722	277507	0	285654
29663	269100	1462	1671	12424	0	284657
29664	274204	1364	1876	5845	0	283289
29665	12796	1581	1566	264456	0	280399
29666	6285	260111	1595	9707	0	277698
29667	5393	8075	1825	250935	0	266228
29668	4117	262001	1798	9684	0	277600
29669	257474	8200	1512	6222	0	273408
29670	10332	253963	2006	4025	0	270326
29671	235233	6870	1642	3592	0	247337
29672	9975	2892	1496	229526	0	243889
29673	226979	1882	1760	8645	0	239266
29674	9195	1635	222120	4704	0	237654
29675	4978	225561	6589	4007	0	241135
29676	224596	6796	3561	3753	0	238706
29677	228648	2872	2029	3646	0	237195
29678	10639	2132	1641	217507	0	231919
29679	5303	221313	1740	8209	0	236565
29680	4947	6368	1419	229769	0	242503
29681	4342	2758	1591	233188	0	241879
29682	4319	2136	1546	233505	0	241506
29683	228693	1803	1257	11112	0	242865
29684	231735	1847	1258	6249	0	241089
29685	11009	1976	1130	221521	0	235636
29686	5785	225636	1019	8750	0	241190
29687	228886	6864	1090	5811	0	242651
29688	9434	3243	225452	4529	0	242658
29689	5975	2666	5945	227991	0	242577
29690	4824	2374	226956	8918	0	243072
29691	5035	2095	6384	226483	0	239997
29692	4202	2178	227287	9590	0	243257
29693	4527	2391	6819	226892	0	240629
29694	226786	2257	3025	9750	0	241818
29695	228169	2327	2038	5871	0	238405
29696	10592	223403	1751	4281	0	240027
29697	227622	7137	1578	4525	0	240862
29698	10510	3575	1604	222679	0	238368
29699	6418	2696	1720	227596	0	238430
29700	226339	2396	1722	10941	0	241398
29701	10274	2282	217131	5865	0	235552
29702	6502	2257	214966	4701	0	228426
29703	5451	2341	208216	4423	0	220431
29704	203798	2092	7158	4866	0	217914
29705	9479	1921	212492	4477	0	228369
29706	5933	1848	203769	4463	0	216013
29707	191790	1817	7492	4740	0	205839
29708	8488	199153	3813	4471	0	215925
29709	5422	5578	3015	201048	0	215063
29710	4702	2646	2572	207582	0	217502
29711	4432	2133	204643	8960	0	220168
29712	199828	1595	6481	6128	0	214032
29713	204554	1438	3615	5174	0	214781
29714	190400	1706	2898	5324	0	200328
29715	8746	1747	204194	4201	0	218888
29716	195308	1420	6325	5372	0	208425
29717	8724	1566	193606	4524	0	208420
29718	5433	192962	5992	4330	0	208717
29719	4845	197140	3246	4055	0	209286
29720	186372	5529	2572	4137	0	198610
29721	7051	182971	2549	3705	0	196276
29722	4640	185646	2285	3496	0	196067
29723	182338	5590	2401	3865	0	194194
29724	6964	184658	2543	3258	0	197423
29725	183420	5517	2301	3495	0	194733
29726	8030	2710	2122	187968	0	200830
29727	5160	2302	2142	191949	0	201553
29728	4260	2190	2216	193468	0	202134
29729	3880	2319	2322	187949	0	196470
29730	3642	188915	2437	7616	0	202610
29731	192392	5484	2271	4422	0	204569
29732	7846	208096	2136	3237	0	221315
29733	4379	212523	2150	3444	0	222496
29734	3984	7315	216202	2836	0	230337
29735	205906	2756	7267	3686	0	219615
29736	9152	2137	223422	2446	0	237157
29737	4366	1447	223644	1992	0	231449
29738	2662	212706	7528	1925	0	224821
29739	1221	213681	2318	1033	0	218253
29740	206821	6977	2198	1974	0	217970
29741	6036	217991	1128	1184	0	226339
29742	2456	6512	215731	753	0	225452
29743	1497	210531	6160	894	0	219082
29744	1237	6477	213056	520	0	221290
29745	915	2185	210341	397	0	213838
29746	196249	1529	7545	1132	0	206455
29747	5907	1231	206940	425	0	214503
29748	3327	824	6891	196165	0	207207
29749	194620	782	2720	6325	0	204447
29750	5520	197398	2047	2028	0	206993
29751	2196	5630	200123	1088	0	209037
29752	193667	1854	6443	1377	0	203341
29753	7053	1302	2465	184528	0	195348
29754	2418	184048	1684	5176	0	193326
29755	1576	5452	191316	1688	0	200032
29756	184461	1932	6222	1695	0	194310
29757	6305	1310	192234	635	0	200484
29758	3304	942	6721	186114	0	197081
29759	1548	819	187568	5655	0	195590
29760	2264	663	6909	183504	0	193340
29761	180358	655	2781	7235	0	191029
29762	5745	187998	2011	2452	0	198206
29763	188792	5849	1428	2051	0	198120
29764	6903	2184	189339	970	0	199396
29765	3668	1292	6662	186922	0	198544
29766	1900	973	193810	6094	0	202777
29767	185722	821	7262	2802	0	196607
29768	191218	828	2834	2136	0	197016
29769	7726	192856	2223	1207	0	204012
29770	193662	6318	1564	1414	0	202958
29771	197661	2194	1412	1300	0	202567
29772	9421	1392	1322	189035	0	201170
29773	3731	1203	191852	6012	0	202798
29774	2485	185358	6664	2234	0	196741
29775	3014	6377	2405	181548	0	193344
29776	186965	2368	1631	6498	0	197462
29777	7117	1679	186457	2248	0	197501
29778	2986	1246	188403	1513	0	194148
29779	2135	1141	184211	1158	0	188645
29780	176284	1084	8739	1541	0	187648
29781	7064	1138	182040	807	0	191049
29782	175650	1178	8133	1223	0	186184
29783	7594	1074	165465	849	0	174982
29784	3317	175901	7356	767	0	187341
29785	3035	6220	3532	170654	0	183441
29786	1936	2441	176329	5812	0	186518
29787	1698	168275	7727	2100	0	179800
29788	1667	176779	3581	1305	0	183332
29789	2301	7761	2606	169533	0	182201
29790	170455	3449	2045	6604	0	182553
29791	7112	2326	2241	170719	0	182398
29792	169059	2147	1980	7179	0	180365
29793	7968	1804	1882	168314	0	179968
29794	3455	1702	168380	7079	0	180616
29795	2693	1523	170960	2943	0	178119
29796	162535	1344	8852	2630	0	175361
29797	168590	1176	4308	2443	0	176517
29798	8760	1392	165795	1607	0	177554
29799	161694	1372	7821	2049	0	172936
29800	8497	1584	164806	1149	0	176036
29801	4218	155241	8351	1192	0	169002
29802	3223	158202	4265	1227	0	166917
29803	2819	159990	3462	1277	0	167548
29804	3156	8200	3003	152514	0	166873
29805	152928	3662	2705	6528	0	165823
29806	156812	2678	2752	2826	0	165068
29807	9362	2164	2402	151802	0	165730
29808	4429	2092	147890	6642	0	161053
29809	3594	1894	7567	146328	0	159383
29810	2952	1700	147590	7242	0	159484
29811	2983	1600	8317	144245	0	157145
29812	142405	1241	4436	7959	0	156041
29813	147788	1172	3414	3703	0	156077
29814	148036	1117	3054	2820	0	155027
29815	148912	1266	2756	2404	0	155338
29816	10429	1188	2522	139804	0	153943
29817	5686	1066	2348	145566	0	154666
29818	142291	1163	2244	8560	0	154258
29819	147044	1162	2071	3912	0	154189
29820	10414	1136	1956	140226	0	153732
29821	5722	1099	1840	143874	0	152535
29822	4319	1005	1848	142619	0	149791
29823	3911	1022	1887	143783	0	150603
29824	137249	1023	1985	9725	0	149982
29825	7926	949	134034	4946	0	147855
29826	4526	827	6743	128267	0	140363
29827	127092	775	3331	7633	0	138831
29828	7697	843	124353	4033	0	136926
29829	4944	893	6791	123593	0	136221
29830	3584	842	123988	7124	0	135538
29831	3023	114394	7258	3543	0	128218
29832	3347	3986	3164	93507	0	104004
29833	86990	1493	2399	4480	0	95362
29834	4518	2032	1890	75158	0	83598
29835	2751	72220	1620	4273	0	80864
29836	2155	67464	1481	2239	0	73339
29837	1560	52438	969	1459	0	56426
29838	1479	49013	1041	1228	0	52761
29839	28513	3523	4098	1986	0	38120
29840	2003	776	1009	20409	0	24197
29841	530	176	18317	913	0	19936
29842	450	164	755	17238	0	18607
29843	467	154	16965	826	0	18412
29844	16970	161	721	439	0	18291
29845	1001	165	295	16707	0	18168
29846	558	173	214	17200	0	18145
29847	431	167	216	17195	0	18009
29848	379	169	199	17363	0	18110
29849	16651	190	176	998	0	18015
29850	17079	145	158	577	0	17959
29851	933	141	174	16647	0	17895
29852	16079	115	179	982	0	17355
29853	778	125	15660	578	0	17141
29854	355	15307	641	584	0	16887
29855	431	520	299	15273	0	16523
29856	395	161	283	15039	0	15878
29857	318	14646	237	883	0	16084
29858	425	503	197	14119	0	15244
29859	327	508	258	13907	0	15000
29860	13684	93	207	819	0	14803
29861	608	93	12194	353	0	13248
29862	263	124	10669	278	0	11334
29863	10119	75	455	294	0	10943
29864	532	81	9271	174	0	10058
29865	4141	53	357	76	0	4627
29866	3489	18	145	70	0	3722
29867	236	109	63	2760	0	3168
29868	56	19	2214	84	0	2373
29869	1808	15	69	42	0	1934
29870	73	1728	37	39	0	1877
29871	1083	144	134	49	0	1410
29872	786	32	105	41	0	964
29873	394	2	13	15	0	424
29874	163	2	3	9	0	177
29875	127	20	15	9	0	171
29876	112	2	6	6	0	126
29877	111	2	0	10	0	123
29878	113	0	1	9	0	123
29879	110	1	9	7	0	127
29880	110	1	2	9	0	122
29881	99	2	6	3	0	110
29882	102	3	5	1	0	111
29883	97	0	2	7	0	106
29884	94	0	5	1	0	100
29885	94	2	3	2	0	101
29886	99	2	1	3	0	105
29887	97	3	2	2	0	104
29888	93	3	2	1	0	99
29889	87	5	0	3	0	95
29890	86	3	1	0	0	90
29891	92	1	0	4	0	97
29892	92	3	3	0	0	98
29893	91	2	0	2	0	95
29894	91	1	3	1	0	96
29895	98	1	0	0	0	99
29896	91	0	0	4	0	95
29897	82	0	1	4	0	87
29898	80	0	1	2	0	83
29899	89	0	1	5	0	95
29900	88	0	4	1	0	93
29901	68	0	4	1	0	73
29902	65	0	3	5	0	73
29903	37	0	14	1	0	52
29904	6	0	2	1	0	9
29905	2	2	0	2	0	6
29906	1	0	0	0	0	1
29907	1	0	0	0	0	1
