Pos	A	C	G	T	Other	Total
1	1	0	0	0	0	1
2	0	0	0	1	0	1
3	0	0	0	3	0	3
4	8	0	0	1	0	9
5	25	0	0	0	0	25
6	27	0	0	0	0	27
7	0	0	29	0	0	29
8	1	0	32	0	0	33
9	1	0	0	45	0	46
10	0	0	1	50	0	51
11	0	0	1	68	0	69
12	145	0	0	1	0	146
13	0	0	0	326	0	326
14	706	0	0	13	0	719
15	1	1135	1	4	0	1141
16	2	1923	2	6	0	1933
17	10	1	0	3661	0	3672
18	7	2	0	3965	0	3974
19	2	4929	2	8	0	4941
20	0	5311	1	5	0	5317
21	1	5741	1	89	0	5832
22	6206	1	1	28	0	6236
23	3	3	6306	0	0	6312
24	8	2	6306	2	0	6318
25	5	1	1	6893	0	6900
26	7384	0	2	18	0	7404
27	7478	0	1	19	0	7498
28	2	7544	0	9	0	7555
29	8793	3	0	48	0	8844
30	9420	2	0	36	0	9458
31	9614	1	1	24	0	9640
32	2	9672	0	2	0	9676
33	2	9925	1	5	0	9933
34	10293	3	2	17	0	10315
35	10414	2	1	20	0	10437
36	3	10554	0	10	0	10567
37	3	11219	1	16	0	11239
38	11350	2	1	25	0	11378
39	11373	0	0	16	0	11389
40	6	11539	1	7	0	11553
41	5	4	1	12021	0	12031
42	8	2	0	12137	0	12147
43	6	2	1	12156	0	12165
44	1	12062	3	9	0	12075
45	4	6	12009	2	0	12021
46	11564	3	5	14	0	11586
47	2	5	1	12347	0	12355
48	4	12342	4	7	0	12357
49	7	3	3	12506	0	12519
50	1	12537	3	3	0	12544
51	5	4	2	12604	0	12615
52	7	1	1	12761	0	12770
53	8	5	12793	6	0	12812
54	8	3	2	12671	0	12684
55	12800	3	2	20	0	12825
56	7	2	12729	2	0	12740
57	12482	1	5	20	0	12508
58	5	4	1	12963	0	12973
59	3	12989	2	6	0	13000
60	5	5	1	13111	0	13122
61	5	7	13147	3	0	13162
62	10	4	4	12928	0	12946
63	12	5	3	13164	0	13184
64	4	13291	4	11	0	13310
65	17	8	0	13380	0	13405
66	20	13268	0	27	0	13315
67	3	7	2	13443	0	13455
68	13411	2	0	29	0	13442
69	13179	2	3	16	0	13200
70	13301	4	3	18	0	13326
71	38	13420	4	13	0	13475
72	23	16	13243	4	0	13286
73	13006	4	8	31	0	13049
74	13653	4	2	23	0	13682
75	15	13918	6	22	0	13961
76	19	22	1	10812	0	10854
77	14	10	2	10798	0	10824
78	20	5	1	9814	0	9840
79	10045	6	4	83	0	10138
80	10103	3	4	51	0	10161
81	10098	3	1	38	0	10140
82	10236	2	5	37	0	10280
83	71	6	3	10190	0	10270
84	27	10198	3	56	0	10284
85	23	44	3	10434	0	10504
86	19	17	10492	59	0	10587
87	25	13	46	10679	0	10763
88	14	12	10933	72	0	11031
89	19	7	54	10916	0	10996
90	8	11	11245	82	0	11346
91	9	8	11125	37	0	11179
92	14	11693	77	32	0	11816
93	33	63	38	12143	0	12277
94	24	16	12501	80	0	12621
95	34	17	84	12316	0	12451
96	13	12491	26	92	0	12622
97	12580	83	21	63	0	12747
98	73	12917	28	27	0	13045
99	36	85	18	12879	0	13018
100	23	12995	18	96	0	13132
101	11	93	12789	36	0	12929
102	14	31	12647	32	0	12724
103	9	12836	103	34	0	12982
104	26	90	43	13098	0	13257
105	19	39	13100	88	0	13246
106	11	13033	93	46	0	13183
107	13047	84	33	70	0	13234
108	97	37	33	13178	0	13345
109	30	31	13493	96	0	13650
110	25	13502	88	40	0	13655
111	30	94	31	13619	0	13774
112	27	41	23	13610	0	13701
113	13279	30	23	151	0	13483
114	82	23	13231	42	0	13378
115	38	26	89	13003	0	13156
116	23	27	12623	105	0	12778
117	18	11787	99	40	0	11944
118	11509	92	35	63	0	11699
119	85	11224	34	33	0	11376
120	35	105	19	10991	0	11150
121	22	10912	34	88	0	11056
122	10678	100	30	64	0	10872
123	80	10765	20	48	0	10913
124	33	107	10533	34	0	10707
125	28	10551	82	28	0	10689
126	10284	104	35	34	0	10457
127	92	46	10476	21	0	10635
128	42	32	96	10456	0	10626
129	10057	32	42	99	0	10230
130	113	30	27	9812	0	9982
131	9941	31	23	131	0	10126
132	10047	19	21	58	0	10145
133	143	23	18	9939	0	10123
134	67	23	21	9931	0	10042
135	9768	19	13	152	0	9952
136	9671	23	23	65	0	9782
137	140	29	10	9437	0	9616
138	9465	19	15	127	0	9626
139	9510	18	17	64	0	9609
140	141	9410	17	53	0	9621
141	76	105	15	9385	0	9581
142	9399	32	11	139	0	9581
143	9515	29	12	60	0	9616
144	163	18	13	9437	0	9631
145	82	22	14	9526	0	9644
146	9421	13	13	155	0	9602
147	130	9429	22	71	0	9652
148	68	106	9	9395	0	9578
149	59	35	9361	128	0	9583
150	58	44	94	9159	0	9355
151	52	9210	28	136	0	9426
152	44	107	9174	58	0	9383
153	44	34	105	9087	0	9270
154	64	39	42	8862	0	9007
155	45	27	9139	145	0	9356
156	8705	27	109	90	0	8931
157	125	9227	44	62	0	9458
158	9241	104	33	72	0	9450
159	139	42	9187	55	0	9423
160	68	38	9208	38	0	9352
161	8867	29	120	64	0	9080
162	125	9294	57	49	0	9525
163	9257	113	38	47	0	9455
164	130	9283	42	37	0	9492
165	49	127	9259	47	0	9482
166	9129	44	109	63	0	9345
167	123	46	9426	33	0	9628
168	70	25	120	9323	0	9538
169	9341	38	52	126	0	9557
170	9308	20	31	71	0	9430
171	147	9180	38	38	0	9403
172	70	268	47	8853	0	9238
173	57	9057	24	115	0	9253
174	52	118	8933	49	0	9152
175	67	143	104	8327	0	8641
176	43	8170	34	90	0	8337
177	50	101	34	7906	0	8091
178	7603	39	19	108	0	7769
179	79	24	23	7645	0	7771
180	34	7650	26	71	0	7781
181	41	67	18	7693	0	7819
182	26	48	18	7651	0	7743
183	40	7642	12	79	0	7773
184	29	73	18	7609	0	7729
185	22	32	7545	74	0	7673
186	31	7448	57	38	0	7574
187	7057	53	24	56	0	7190
188	72	26	7064	20	0	7182
189	37	19	6901	20	0	6977
190	25	6762	63	16	0	6866
191	78	112	78	6342	0	6610
192	18	24	6190	42	0	6274
193	14	5222	50	38	0	5324
194	22	35	15	5636	0	5708
195	17	22	7	5687	0	5733
196	5563	15	6	57	0	5641
197	31	5638	11	25	0	5705
198	13	40	5328	21	0	5402
199	13	18	5417	15	0	5463
200	21	8	42	5356	0	5427
201	16	14	18	6159	0	6207
202	12	12	12	6254	0	6290
203	15	7183	7	116	0	7321
204	8	94	7464	42	0	7608
205	22	45	98	7910	0	8075
206	8	8229	45	126	0	8408
207	6	8749	23	61	0	8839
208	10	169	9311	29	0	9519
209	18	83	152	9278	0	9531
210	10	36	10445	169	0	10660
211	28	15	202	10442	0	10687
212	31	14	94	10807	0	10946
213	13	21	10731	263	0	11028
214	10	10630	196	144	0	10980
215	10555	178	95	95	0	10923
216	166	93	10793	47	0	11099
217	76	10772	199	41	0	11088
218	48	11093	104	34	0	11279
219	24	264	10788	33	0	11109
220	10626	143	213	38	0	11020
221	200	84	111	10075	0	10470
222	88	10833	74	166	0	11161
223	10822	208	51	97	0	11178
224	220	110	41	10457	0	10828
225	95	10728	51	212	0	11086
226	10849	213	37	129	0	11228
227	203	117	10654	69	0	11043
228	101	10647	221	44	0	11013
229	10379	218	111	52	0	10760
230	199	10394	82	37	0	10712
231	10147	254	53	50	0	10504
232	248	140	38	9835	0	10261
233	111	9960	56	190	0	10317
234	84	215	55	9998	0	10352
235	9858	104	45	274	0	10281
236	195	91	9763	153	0	10202
237	112	71	9915	85	0	10183
238	108	53	261	9638	0	10060
239	69	60	151	9792	0	10072
240	66	78	92	9579	0	9815
241	60	9517	71	290	0	9938
242	46	224	9406	141	0	9817
243	57	138	216	9109	0	9520
244	57	9120	117	211	0	9505
245	48	9480	91	128	0	9747
246	67	257	9390	109	0	9823
247	64	166	9408	64	0	9702
248	48	125	9576	70	0	9819
249	75	84	317	9346	0	9822
250	59	72	9558	219	0	9908
251	54	85	285	9479	0	9903
252	59	74	9617	260	0	10010
253	9238	62	271	165	0	9736
254	216	9925	145	103	0	10389
255	125	10632	89	87	0	10933
256	99	330	11056	71	0	11556
257	10902	180	258	81	0	11421
258	11198	111	144	98	0	11551
259	11205	105	120	66	0	11496
260	358	69	10858	66	0	11351
261	182	60	11096	85	0	11423
262	135	72	354	10853	0	11414
263	10980	63	199	286	0	11528
264	11050	73	131	182	0	11436
265	331	84	10770	141	0	11326
266	10838	81	291	105	0	11315
267	317	91	170	10731	0	11309
268	167	87	10953	252	0	11459
269	114	82	11062	160	0	11418
270	10542	81	408	139	0	11170
271	259	72	11105	100	0	11536
272	10889	67	372	107	0	11435
273	315	58	11147	107	0	11627
274	157	10678	393	114	0	11342
275	129	11168	241	112	0	11650
276	135	322	185	10761	0	11403
277	113	192	165	11265	0	11735
278	103	152	11142	337	0	11734
279	111	94	357	10864	0	11426
280	119	10674	226	314	0	11333
281	127	10938	176	167	0	11408
282	122	11305	151	119	0	11697
283	154	381	163	10953	0	11651
284	144	203	11034	267	0	11648
285	128	142	11073	161	0	11504
286	122	144	392	10816	0	11474
287	131	98	249	10950	0	11428
288	158	114	177	10480	0	10929
289	144	10827	129	379	0	11479
290	10886	276	107	213	0	11482
291	10936	162	119	164	0	11381
292	360	10953	140	117	0	11570
293	231	286	11105	114	0	11736
294	11227	172	298	132	0	11829
295	333	142	11381	74	0	11930
296	11299	100	347	104	0	11850
297	11393	95	211	111	0	11810
298	11351	101	156	139	0	11747
299	11225	93	131	143	0	11592
300	399	11141	130	159	0	11829
301	10368	226	104	136	0	10834
302	274	10307	124	126	0	10831
303	9236	197	104	113	0	9650
304	237	9022	97	92	0	9448
305	143	160	8287	61	0	8651
306	123	758	163	6999	0	8043
307	76	7549	138	124	0	7887
308	81	7111	63	89	0	7344
309	6393	209	266	174	0	7042
310	5777	59	43	58	0	5937
311	120	5957	35	28	0	6140
312	64	80	45	5690	0	5879
313	47	6105	40	77	0	6269
314	6190	82	32	38	0	6342
315	118	30	6196	32	0	6376
316	68	55	95	5981	0	6199
317	57	28	48	5990	0	6123
318	54	18	36	6061	0	6169
319	43	24	6010	101	0	6178
320	39	5872	98	40	0	6049
321	56	6153	41	30	0	6280
322	44	90	57	6223	0	6414
323	59	44	6329	78	0	6510
324	47	40	90	6244	0	6421
325	40	41	40	6365	0	6486
326	42	30	44	6313	0	6429
327	36	42	28	6320	0	6426
328	6210	36	28	121	0	6395
329	89	6252	32	61	0	6434
330	6251	89	41	53	0	6434
331	96	47	6259	39	0	6441
332	39	53	6333	34	0	6459
333	33	46	92	6237	0	6408
334	34	38	36	6293	0	6401
335	30	6403	43	103	0	6579
336	26	81	6448	64	0	6619
337	21	6580	94	54	0	6749
338	33	87	6643	52	0	6815
339	6276	35	92	71	0	6474
340	80	6707	50	39	0	6876
341	44	96	6711	44	0	6895
342	49	43	82	6655	0	6829
343	32	43	6734	93	0	6902
344	33	6748	95	45	0	6921
345	49	86	34	6639	0	6808
346	32	6754	44	86	0	6916
347	49	85	6763	47	0	6944
348	47	39	88	6657	0	6831
349	6700	35	24	95	0	6854
350	102	6645	32	41	0	6820
351	68	99	6511	28	0	6706
352	54	200	79	6165	0	6498
353	36	39	6438	76	0	6589
354	37	33	5822	37	0	5929
355	23	5459	74	25	0	5581
356	48	39	40	4816	0	4943
357	6	7	9	4826	0	4848
358	9	12	10	4784	0	4815
359	7	7	4887	37	0	4938
360	11	6	4851	8	0	4876
361	4500	7	35	18	0	4560
362	33	2	4791	9	0	4835
363	4488	8	33	15	0	4544
364	31	4724	7	11	0	4773
365	7	36	6	4672	0	4721
366	8	4837	6	25	0	4876
367	2	4920	8	6	0	4936
368	6	30	4812	6	0	4854
369	8	6	28	4733	0	4775
370	2	8	4789	35	0	4834
371	5	7	4497	12	0	4521
372	4489	7	32	17	0	4545
373	25	11	4707	12	0	4755
374	8	5	4633	6	0	4652
375	4488	7	30	9	0	4534
376	33	7	4649	5	0	4694
377	5	3	4779	8	0	4795
378	9	5	31	4600	0	4645
379	2	4756	11	35	0	4804
380	2	30	8	4811	0	4851
381	0	10	6	4717	0	4733
382	4787	5	9	38	0	4839
383	26	7	15	4751	0	4799
384	8	4865	6	33	0	4912
385	4790	30	6	18	0	4844
386	28	9	4812	14	0	4863
387	4610	5	31	24	0	4670
388	31	5	5095	13	0	5144
389	4	8	5223	5	0	5240
390	9	5409	33	16	0	5467
391	5532	32	19	11	0	5594
392	38	5604	12	11	0	5665
393	8	41	5562	10	0	5621
394	16	6	39	5154	0	5215
395	5	5575	11	37	0	5628
396	5609	41	11	8	0	5669
397	5586	14	8	10	0	5618
398	42	5607	14	10	0	5673
399	5717	42	11	7	0	5777
400	42	10	10	5566	0	5628
401	7	5692	12	48	0	5759
402	7	42	8	5801	0	5858
403	12	13	8	6059	0	6092
404	6178	8	11	50	0	6247
405	6109	8	8	17	0	6142
406	6104	4	15	14	0	6137
407	52	14	6082	6	0	6154
408	5990	5	44	15	0	6054
409	51	15	17	6175	0	6258
410	12	13	6139	44	0	6208
411	16	0	5866	12	0	5894
412	6	5952	43	14	0	6015
413	5576	45	20	14	0	5655
414	32	5792	6	8	0	5838
415	15	33	6	5731	0	5785
416	16	12	5	5810	0	5843
417	12	5	5940	34	0	5991
418	14	12	30	5753	0	5809
419	4	7	5960	30	0	6001
420	10	6	5739	13	0	5768
421	13	5907	29	5	0	5954
422	19	20	22	5724	0	5785
423	13	9	4	5649	0	5675
424	5642	8	5	28	0	5683
425	25	4	5635	7	0	5671
426	11	7	19	5726	0	5763
427	5792	5	7	42	0	5846
428	31	5	5865	14	0	5915
429	5731	4	27	15	0	5777
430	5903	4	7	13	0	5927
431	34	4	6085	4	0	6127
432	30	3	25	5947	0	6005
433	10	4	11	6029	0	6054
434	11	1	6184	31	0	6227
435	6052	4	32	22	0	6110
436	6219	10	19	14	0	6262
437	6026	6	12	13	0	6057
438	6067	14	8	15	0	6104
439	6046	6	12	19	0	6083
440	42	23	5010	36	0	5111
441	21	13	6076	11	0	6121
442	23	6164	34	15	0	6236
443	10	41	6187	10	0	6248
444	16	15	44	6022	0	6097
445	44	30	35	4310	0	4419
446	15	19	16	6179	0	6229
447	27	13	7	6239	0	6286
448	34	9	6253	41	0	6337
449	23	6161	36	19	0	6239
450	28	6387	16	24	0	6455
451	24	30	14	6274	0	6342
452	12	6513	19	32	0	6576
453	6531	35	9	33	0	6608
454	6545	12	11	31	0	6599
455	52	6808	18	18	0	6896
456	38	29	8	6854	0	6929
457	26	12	12	6978	0	7028
458	23	4	7005	52	0	7084
459	6536	6	39	33	0	6614
460	7087	8	27	23	0	7145
461	61	7230	20	17	0	7328
462	7342	43	21	26	0	7432
463	65	23	7485	16	0	7589
464	45	7347	52	15	0	7459
465	29	7593	29	13	0	7664
466	16	7602	21	24	0	7663
467	27	64	23	7541	0	7655
468	7526	20	23	83	0	7652
469	80	14	20	7689	0	7803
470	39	10	7930	81	0	8060
471	36	11	75	7928	0	8050
472	23	18	8226	84	0	8351
473	24	17	83	7966	0	8090
474	25	22	32	7832	0	7911
475	21	8101	29	90	0	8241
476	8218	81	29	37	0	8365
477	90	30	24	7993	0	8137
478	44	8154	17	83	0	8298
479	8204	81	24	44	0	8353
480	7075	37	21	68	0	7201
481	8240	21	21	40	0	8322
482	87	8190	37	42	0	8356
483	44	73	8245	40	0	8402
484	33	29	87	8229	0	8378
485	38	58	45	7985	0	8126
486	42	8246	17	101	0	8406
487	44	71	8197	42	0	8354
488	50	32	7938	35	0	8055
489	7702	32	84	28	0	7846
490	93	67	39	7684	0	7883
491	36	15	7899	81	0	8031
492	39	8005	67	32	0	8143
493	39	83	33	7641	0	7796
494	31	8027	31	63	0	8152
495	25	77	7954	31	0	8087
496	7610	24	77	28	0	7739
497	7902	20	26	42	0	7990
498	78	7940	22	31	0	8071
499	44	71	17	7860	0	7992
500	41	20	7880	72	0	8013
501	22	7751	66	46	0	7885
502	7624	80	29	22	0	7755
503	62	7404	11	21	0	7498
504	24	7403	15	11	0	7453
505	29	78	9	7277	0	7393
506	15	7361	12	61	0	7449
507	7310	69	11	23	0	7413
508	66	22	20	7219	0	7327
509	26	18	7038	57	0	7139
510	21	11	6662	22	0	6716
511	12	31	64	6703	0	6810
512	17	6757	25	56	0	6855
513	6774	57	19	27	0	6877
514	58	31	7	6578	0	6674
515	22	23	6536	59	0	6640
516	19	15	62	6498	0	6594
517	11	20	18	6480	0	6529
518	6445	17	10	78	0	6550
519	60	18	9	6387	0	6474
520	22	12	6356	62	0	6452
521	16	15	6362	28	0	6421
522	17	12	63	6492	0	6584
523	12	19	26	6643	0	6700
524	15	14	6877	73	0	6979
525	6250	15	63	53	0	6381
526	65	14	6838	20	0	6937
527	23	6835	55	25	0	6938
528	21	62	23	6887	0	6993
529	15	25	6912	61	0	7013
530	15	15	6812	30	0	6872
531	18	11	64	6668	0	6761
532	6727	11	27	72	0	6837
533	54	10	6853	24	0	6941
534	19	6832	56	27	0	6934
535	6928	53	21	26	0	7028
536	53	15	6975	26	0	7069
537	6735	13	59	25	0	6832
538	6978	8	23	24	0	7033
539	62	7192	27	21	0	7302
540	25	54	15	6899	0	6993
541	19	7030	22	50	0	7121
542	17	54	7033	22	0	7126
543	6962	15	61	30	0	7068
544	7265	24	25	27	0	7341
545	65	18	7282	10	0	7375
546	36	6	7121	15	0	7178
547	20	7506	67	9	0	7602
548	7678	61	32	20	0	7791
549	72	24	20	7612	0	7728
550	36	12	21	7320	0	7389
551	22	7542	13	70	0	7647
552	7411	64	23	40	0	7538
553	64	29	7577	17	0	7687
554	31	30	62	7775	0	7898
555	7928	15	28	88	0	8059
556	88	8112	23	26	0	8249
557	39	88	8867	18	0	9012
558	32	25	9048	11	0	9116
559	25	73	143	8858	0	9099
560	12	9185	35	119	0	9351
561	21	127	9218	27	0	9393
562	12	47	132	9162	0	9353
563	9304	15	39	140	0	9498
564	132	21	9611	30	0	9794
565	49	13	133	9639	0	9834
566	24	11	9888	139	0	10062
567	16	12	10097	37	0	10162
568	37	88	173	9931	0	10229
569	20	9	10131	139	0	10299
570	8787	11	159	48	0	9005
571	127	6	9804	21	0	9958
572	9178	3	130	37	0	9348
573	133	9618	38	15	0	9804
574	9877	121	29	22	0	10049
575	126	10085	33	14	0	10258
576	45	125	17	10032	0	10219
577	31	31	25	10401	0	10488
578	20	23	10276	143	0	10462
579	11	12	10333	47	0	10403
580	26	11	157	10406	0	10600
581	22	12	10535	142	0	10711
582	30	15	160	10095	0	10300
583	18	10208	54	142	0	10422
584	11	10684	35	40	0	10770
585	25	161	27	10489	0	10702
586	24	54	23	10617	0	10718
587	12	32	10501	172	0	10717
588	21	17	144	10340	0	10522
589	9	10231	56	169	0	10465
590	12	10297	39	60	0	10408
591	11	10418	33	45	0	10507
592	13	159	38	9894	0	10104
593	8	10035	32	145	0	10220
594	9874	151	30	53	0	10108
595	140	45	33	9869	0	10087
596	36	30	9874	160	0	10100
597	32	25	157	9787	0	10001
598	25	21	9981	169	0	10196
599	19	24	9961	58	0	10062
600	27	21	9929	38	0	10015
601	17	10000	175	38	0	10230
602	23	158	10061	31	0	10273
603	9944	41	172	42	0	10199
604	10135	37	61	43	0	10276
605	10360	29	47	33	0	10469
606	184	23	42	10233	0	10482
607	10222	27	46	170	0	10465
608	155	10037	48	67	0	10307
609	52	10560	47	54	0	10713
610	10457	163	42	63	0	10725
611	159	63	10617	37	0	10876
612	58	45	159	10548	0	10810
613	34	30	10754	172	0	10990
614	32	38	10728	68	0	10866
615	34	10772	170	49	0	11025
616	48	156	77	10227	0	10508
617	29	50	62	10893	0	11034
618	10744	49	45	199	0	11037
619	150	10801	37	81	0	11069
620	56	11024	37	61	0	11178
621	51	193	10894	52	0	11190
622	35	11057	159	56	0	11307
623	10887	179	72	72	0	11210
624	10876	57	90	57	0	11080
625	167	51	11068	55	0	11341
626	42	54	11119	60	0	11275
627	43	43	225	10666	0	10977
628	49	44	113	10662	0	10868
629	50	10775	97	195	0	11117
630	64	174	76	10674	0	10988
631	63	58	83	10784	0	10988
632	47	10739	83	205	0	11074
633	56	176	61	10712	0	11005
634	58	62	80	10516	0	10716
635	53	10355	66	231	0	10705
636	48	162	10409	100	0	10719
637	53	61	200	10524	0	10838
638	10539	67	85	206	0	10897
639	10402	48	87	80	0	10617
640	209	71	10267	65	0	10612
641	10041	58	178	79	0	10356
642	10345	49	65	85	0	10544
643	176	10323	58	82	0	10639
644	68	168	10052	77	0	10365
645	44	65	10092	90	0	10291
646	52	108	208	10387	0	10755
647	10405	44	110	216	0	10775
648	10871	45	69	89	0	11074
649	206	50	59	11662	0	11977
650	12624	59	40	223	0	12946
651	13150	53	52	89	0	13344
652	12799	48	64	95	0	13006
653	276	37	12652	70	0	13035
654	107	41	12949	57	0	13154
655	12715	20	222	79	0	13036
656	197	29	12841	49	0	13116
657	58	11902	146	32	0	12138
658	77	189	116	11637	0	12019
659	39	34	11959	126	0	12158
660	22	25	11737	49	0	11833
661	43	91	163	11380	0	11677
662	21	12	11597	116	0	11746
663	17	18	11284	41	0	11360
664	16	10470	127	26	0	10639
665	13	11120	53	11	0	11197
666	11098	128	35	23	0	11284
667	113	45	21	10932	0	11111
668	10982	10	15	111	0	11118
669	112	12	10893	31	0	11048
670	52	9	99	10813	0	10973
671	35	19	31	10977	0	11062
672	10871	6	19	139	0	11035
673	106	10901	15	53	0	11075
674	46	98	10016	23	0	10183
675	33	34	10519	16	0	10602
676	17	10679	122	16	0	10834
677	13	104	10546	16	0	10679
678	12	10508	106	12	0	10638
679	11	10060	44	3	0	10118
680	13	126	10194	5	0	10338
681	9838	35	105	17	0	9995
682	93	16	30	10352	0	10491
683	27	10487	17	118	0	10649
684	15	95	8	10447	0	10565
685	10460	31	17	112	0	10620
686	10410	10	13	43	0	10476
687	10428	9	12	24	0	10473
688	131	7	10254	8	0	10400
689	48	11	88	10023	0	10170
690	14	10390	31	89	0	10524
691	10719	93	17	36	0	10865
692	110	32	4	10760	0	10906
693	50	10	11	10585	0	10656
694	23	11	15	10964	0	11013
695	16	9	10859	135	0	11019
696	10159	6	101	71	0	10337
697	115	10877	30	19	0	11041
698	48	100	12	10848	0	11008
699	41	32	12	10906	0	10991
700	10797	14	19	143	0	10973
701	120	19	10136	41	0	10316
702	45	12	10845	22	0	10924
703	23	10919	118	16	0	11076
704	23	104	11188	18	0	11333
705	10543	31	130	41	0	10745
706	108	11215	50	18	0	11391
707	41	109	11186	20	0	11356
708	10623	36	113	33	0	10805
709	115	20	11742	13	0	11890
710	42	11776	118	22	0	11958
711	38	125	45	11769	0	11977
712	36	39	26	11923	0	12024
713	50	20	11746	139	0	11955
714	29	21	11501	51	0	11602
715	22	11627	154	32	0	11835
716	11491	113	53	34	0	11691
717	116	11852	34	36	0	12038
718	62	126	29	11786	0	12003
719	36	52	11818	129	0	12035
720	11021	26	141	63	0	11251
721	127	19	70	11531	0	11747
722	57	11397	41	110	0	11605
723	19	11892	41	53	0	12005
724	30	141	35	11828	0	12034
725	29	60	32	11927	0	12048
726	11784	34	37	160	0	12015
727	130	34	36	11965	0	12165
728	59	32	12023	138	0	12252
729	11764	35	130	60	0	11989
730	12154	29	56	51	0	12290
731	164	28	12223	39	0	12454
732	12125	20	125	41	0	12311
733	156	19	57	12685	0	12917
734	77	25	34	12786	0	12922
735	43	32	33	12885	0	12993
736	42	29	34	12508	0	12613
737	37	12704	31	174	0	12946
738	12904	141	30	78	0	13153
739	13190	57	33	55	0	13335
740	184	37	13168	48	0	13437
741	13641	31	145	62	0	13879
742	14377	27	56	39	0	14499
743	14670	36	28	46	0	14780
744	15176	31	30	54	0	15291
745	256	15101	23	54	0	15434
746	100	240	19	14623	0	14982
747	62	52	14792	180	0	15086
748	54	44	13953	64	0	14115
749	12542	179	293	96	0	13110
750	12437	61	113	53	0	12664
751	181	11994	32	31	0	12238
752	11923	123	38	30	0	12114
753	164	11999	24	13	0	12200
754	90	134	15	12015	0	12254
755	12241	46	21	154	0	12462
756	12161	35	11	57	0	12264
757	12176	16	14	43	0	12249
758	183	12043	22	24	0	12272
759	12097	124	13	44	0	12278
760	187	43	17	12144	0	12391
761	12292	30	21	140	0	12483
762	179	24	12060	44	0	12307
763	71	12153	125	31	0	12380
764	12077	115	42	30	0	12264
765	156	31	12074	29	0	12290
766	85	44	118	11964	0	12211
767	59	22	12176	124	0	12381
768	55	32	12031	35	0	12153
769	67	26	145	11978	0	12216
770	49	21	12301	132	0	12503
771	53	22	135	12214	0	12424
772	67	12	55	12335	0	12469
773	12403	20	40	175	0	12638
774	150	12375	24	66	0	12615
775	58	12645	41	47	0	12791
776	51	12884	29	42	0	13006
777	52	160	12849	35	0	13096
778	64	68	145	12726	0	13003
779	42	55	12985	140	0	13222
780	12371	40	167	64	0	12642
781	12806	29	62	60	0	12957
782	166	12872	56	47	0	13141
783	91	127	43	12689	0	12950
784	65	12922	40	133	0	13160
785	12970	149	36	60	0	13215
786	176	66	27	12926	0	13195
787	71	61	12884	159	0	13175
788	63	12759	144	72	0	13038
789	62	160	12981	56	0	13259
790	77	57	160	12873	0	13167
791	55	49	12832	164	0	13100
792	12240	53	176	77	0	12546
793	170	47	12914	60	0	13191
794	82	12939	179	49	0	13249
795	74	151	68	12953	0	13246
796	66	59	59	13166	0	13350
797	12982	45	51	198	0	13276
798	13039	46	49	84	0	13218
799	190	12961	40	71	0	13262
800	92	153	12869	58	0	13172
801	82	55	12693	66	0	12896
802	12549	46	178	52	0	12825
803	184	43	12736	41	0	13004
804	75	53	12421	40	0	12589
805	53	43	12463	39	0	12598
806	58	27	12348	49	0	12482
807	60	12321	210	39	0	12630
808	12367	152	106	52	0	12677
809	176	72	82	11999	0	12329
810	11946	59	64	151	0	12220
811	175	11899	55	72	0	12201
812	11909	156	45	73	0	12183
813	192	12191	49	56	0	12488
814	102	158	57	12083	0	12400
815	89	12619	56	126	0	12890
816	61	178	12490	58	0	12787
817	54	12771	166	48	0	13039
818	74	171	85	13704	0	14034
819	13758	76	74	187	0	14095
820	188	66	61	13755	0	14070
821	85	62	13773	183	0	14103
822	88	60	187	13414	0	13749
823	69	13725	78	199	0	14071
824	61	177	13792	91	0	14121
825	13704	74	187	94	0	14059
826	200	60	98	14128	0	14486
827	13895	67	61	198	0	14221
828	13961	55	63	111	0	14190
829	209	14043	69	84	0	14405
830	13646	161	52	98	0	13957
831	14036	81	56	79	0	14252
832	225	13994	63	49	0	14331
833	118	182	61	13858	0	14219
834	98	73	72	13810	0	14053
835	74	13877	54	200	0	14205
836	84	181	58	14074	0	14397
837	66	77	14047	195	0	14385
838	75	112	178	13815	0	14180
839	75	55	13727	184	0	14041
840	71	54	12880	80	0	13085
841	51	12803	177	75	0	13106
842	52	12549	90	61	0	12752
843	72	12693	58	43	0	12866
844	115	164	91	11929	0	12299
845	28	68	12064	95	0	12255
846	11779	40	112	59	0	11990
847	107	41	55	12112	0	12315
848	37	23	12158	114	0	12332
849	33	27	12079	42	0	12181
850	28	12301	122	34	0	12485
851	45	124	53	12109	0	12331
852	12016	41	46	125	0	12228
853	101	11778	40	41	0	11960
854	36	11674	29	34	0	11773
855	33	11593	29	34	0	11689
856	26	154	38	11647	0	11865
857	13	11984	28	100	0	12125
858	25	136	22	12532	0	12715
859	33	46	22	12846	0	12947
860	36	40	12708	151	0	12935
861	11785	29	120	108	0	12042
862	121	32	13103	36	0	13292
863	61	76	144	13035	0	13316
864	37	47	13222	132	0	13438
865	30	13100	136	67	0	13333
866	12990	148	73	70	0	13281
867	132	69	43	12806	0	13050
868	69	40	35	13024	0	13168
869	12965	31	37	156	0	13189
870	12813	30	31	100	0	12974
871	13097	20	37	73	0	13227
872	165	30	13065	45	0	13305
873	12456	35	115	45	0	12651
874	142	12715	54	35	0	12946
875	65	12754	31	43	0	12893
876	70	145	30	12366	0	12611
877	51	65	15	12171	0	12302
878	42	12257	26	139	0	12464
879	54	117	19	12280	0	12470
880	12187	52	28	147	0	12414
881	119	47	12244	68	0	12478
882	55	12181	113	54	0	12403
883	11848	117	42	68	0	12075
884	106	12048	45	57	0	12256
885	55	131	11994	47	0	12227
886	54	79	116	11935	0	12184
887	38	59	11986	124	0	12207
888	28	11919	128	62	0	12137
889	40	129	48	11840	0	12057
890	40	64	11816	120	0	12040
891	35	52	11830	65	0	11982
892	52	48	129	11846	0	12075
893	11778	32	73	131	0	12014
894	11786	32	53	72	0	11943
895	11788	33	41	65	0	11927
896	144	40	11937	42	0	12163
897	72	11904	114	37	0	12127
898	42	120	64	11896	0	12122
899	43	48	46	11709	0	11846
900	35	11849	46	140	0	12070
901	11807	122	29	77	0	12035
902	136	56	29	11823	0	12044
903	56	43	11796	133	0	12028
904	48	11794	114	60	0	12016
905	11476	119	64	59	0	11718
906	116	11624	41	64	0	11845
907	73	113	37	11443	0	11666
908	49	66	37	11490	0	11642
909	57	40	47	11535	0	11679
910	38	52	11453	158	0	11701
911	51	41	127	11168	0	11387
912	36	11131	72	130	0	11369
913	39	11053	55	93	0	11240
914	61	138	10819	60	0	11078
915	10110	74	109	85	0	10378
916	10558	62	66	80	0	10766
917	137	10375	51	64	0	10627
918	9355	98	59	49	0	9561
919	9307	52	22	52	0	9433
920	116	9536	34	51	0	9737
921	79	108	31	9632	0	9850
922	69	47	9948	111	0	10175
923	52	47	9629	52	0	9780
924	9807	49	119	58	0	10033
925	108	9954	53	55	0	10170
926	60	112	38	9887	0	10097
927	44	62	35	9968	0	10109
928	49	49	25	9990	0	10113
929	9816	27	35	167	0	10045
930	132	40	27	9839	0	10038
931	77	34	27	9833	0	9971
932	57	40	9551	135	0	9783
933	8946	29	106	90	0	9171
934	109	9365	50	58	0	9582
935	9208	96	38	55	0	9397
936	115	9116	29	36	0	9296
937	60	113	36	8993	0	9202
938	9041	42	33	116	0	9232
939	9111	34	35	68	0	9248
940	116	46	9008	37	0	9207
941	9217	38	89	53	0	9397
942	131	22	9392	41	0	9586
943	54	33	9119	35	0	9241
944	50	28	9149	34	0	9261
945	57	23	9670	39	0	9789
946	50	48	156	9983	0	10237
947	32	35	10107	125	0	10299
948	49	29	138	9962	0	10178
949	10021	29	63	158	0	10271
950	137	29	48	9994	0	10208
951	9879	19	37	170	0	10105
952	140	9958	36	84	0	10218
953	74	146	46	9935	0	10201
954	41	50	9946	158	0	10195
955	43	10234	117	70	0	10464
956	94	243	42	10004	0	10383
957	59	38	10063	150	0	10310
958	25	9670	118	58	0	9871
959	17	9730	36	41	0	9824
960	53	159	9571	35	0	9818
961	52	139	143	9159	0	9493
962	21	33	9163	123	0	9340
963	8793	9	136	44	0	8982
964	9067	8	38	30	0	9143
965	143	9002	22	16	0	9183
966	9040	119	14	17	0	9190
967	146	27	13	9038	0	9224
968	34	19	8956	125	0	9134
969	8607	9	129	41	0	8786
970	138	8	8834	30	0	9010
971	31	8779	137	11	0	8958
972	8929	129	50	26	0	9134
973	138	38	21	8907	0	9104
974	38	18	8970	125	0	9151
975	8801	12	132	45	0	8990
976	8879	10	36	36	0	8961
977	8973	10	32	16	0	9031
978	171	10	23	8843	0	9047
979	67	13	17	9014	0	9111
980	37	5	8919	158	0	9119
981	18	8871	133	59	0	9081
982	29	129	42	8782	0	8982
983	35	40	26	9019	0	9120
984	21	20	8927	156	0	9124
985	14	12	8882	61	0	8969
986	30	12	157	8823	0	9022
987	8724	7	56	145	0	8932
988	124	8790	46	40	0	9000
989	8800	130	14	46	0	8990
990	149	8869	21	44	0	9083
991	47	143	8928	31	0	9149
992	40	36	9048	32	0	9156
993	8852	26	276	28	0	9182
994	9932	24	59	32	0	10047
995	191	9923	35	38	0	10187
996	86	159	9776	36	0	10057
997	63	59	163	9748	0	10033
998	49	52	77	9556	0	9734
999	32	9884	63	191	0	10170
1000	52	155	27	9966	0	10200
1001	34	66	10017	195	0	10312
1002	9801	61	167	91	0	10120
1003	10074	33	82	67	0	10256
1004	9926	30	60	49	0	10065
1005	10228	23	43	37	0	10331
1006	267	28	10009	39	0	10343
1007	9985	21	174	40	0	10220
1008	243	15	10044	19	0	10321
1009	91	9983	209	29	0	10312
1010	99	165	85	10083	0	10432
1011	10266	57	65	185	0	10573
1012	197	54	51	10690	0	10992
1013	94	34	10744	224	0	11096
1014	10758	21	205	106	0	11090
1015	11114	26	89	83	0	11312
1016	270	30	66	10958	0	11324
1017	139	20	36	11158	0	11353
1018	102	25	10923	256	0	11306
1019	61	10980	192	132	0	11365
1020	10707	183	88	87	0	11065
1021	225	69	10253	53	0	10600
1022	9993	54	186	52	0	10285
1023	232	10287	88	40	0	10647
1024	10217	176	61	52	0	10506
1025	244	9974	56	38	0	10312
1026	109	10078	48	27	0	10262
1027	107	211	45	10059	0	10422
1028	87	89	39	10250	0	10465
1029	74	79	40	10312	0	10505
1030	64	44	40	10357	0	10505
1031	64	31	10126	272	0	10493
1032	9894	34	181	127	0	10236
1033	10291	38	76	98	0	10503
1034	10468	35	70	68	0	10641
1035	298	21	61	10249	0	10629
1036	154	24	41	10390	0	10609
1037	10388	33	41	250	0	10712
1038	10436	25	47	117	0	10625
1039	10500	41	37	92	0	10670
1040	296	37	42	10150	0	10525
1041	157	45	40	10013	0	10255
1042	115	36	9637	225	0	10013
1043	90	31	9355	119	0	9595
1044	77	9405	192	96	0	9770
1045	8520	231	215	139	0	9105
1046	8502	75	98	69	0	8744
1047	8585	42	43	64	0	8734
1048	205	37	8701	56	0	8999
1049	8578	29	119	70	0	8796
1050	8793	21	57	73	0	8944
1051	8872	20	47	60	0	8999
1052	234	12	45	8659	0	8950
1053	158	15	24	8659	0	8856
1054	115	14	37	8649	0	8815
1055	82	17	7736	210	0	8045
1056	7504	15	94	117	0	7730
1057	156	7891	50	75	0	8172
1058	7441	98	26	53	0	7618
1059	153	7328	20	44	0	7545
1060	91	7472	20	41	0	7624
1061	114	122	40	7369	0	7645
1062	66	83	47	7272	0	7468
1063	51	7264	25	122	0	7462
1064	7208	99	22	75	0	7404
1065	7234	50	19	58	0	7361
1066	136	39	27	7123	0	7325
1067	90	27	7129	111	0	7357
1068	81	19	6826	67	0	6993
1069	70	15	7109	60	0	7254
1070	71	9	7083	41	0	7204
1071	6850	36	148	51	0	7085
1072	6918	13	69	42	0	7042
1073	141	15	43	6834	0	7033
1074	88	12	6814	99	0	7013
1075	77	16	81	6933	0	7107
1076	54	6925	48	119	0	7146
1077	57	7558	42	59	0	7716
1078	7723	100	24	57	0	7904
1079	7737	65	20	44	0	7866
1080	7781	49	12	56	0	7898
1081	142	24	24	7676	0	7866
1082	84	33	25	7809	0	7951
1083	77	30	17	7808	0	7932
1084	70	17	20	7771	0	7878
1085	62	14	7734	147	0	7957
1086	59	11	76	7780	0	7926
1087	8037	7	53	130	0	8227
1088	112	13	54	8094	0	8273
1089	65	8	38	8233	0	8344
1090	63	42	32	8095	0	8232
1091	57	7830	22	143	0	8052
1092	49	7811	21	83	0	7964
1093	39	7887	23	68	0	8017
1094	37	71	23	7179	0	7310
1095	29	13	13	7254	0	7309
1096	7252	14	7	80	0	7353
1097	7199	13	11	39	0	7262
1098	7245	14	10	34	0	7303
1099	77	16	7	7210	0	7310
1100	36	14	10	7248	0	7308
1101	39	7133	10	69	0	7251
1102	36	7361	7	32	0	7436
1103	7311	50	8	32	0	7401
1104	70	16	4	7286	0	7376
1105	7306	8	10	75	0	7399
1106	7478	10	5	39	0	7532
1107	65	6	11	7444	0	7526
1108	23	7780	13	63	0	7879
1109	7897	39	9	45	0	7990
1110	8153	14	6	38	0	8211
1111	68	13	8346	24	0	8451
1112	7823	7	26	30	0	7886
1113	36	7991	7	12	0	8046
1114	23	22	10	8115	0	8170
1115	8696	7	5	63	0	8771
1116	50	7	5	8707	0	8769
1117	18	5	3	8777	0	8803
1118	22	8714	5	46	0	8787
1119	8759	35	3	38	0	8835
1120	8739	7	3	41	0	8790
1121	49	8703	6	14	0	8772
1122	22	9083	5	10	0	9120
1123	9083	38	1	22	0	9144
1124	8989	25	3	17	0	9034
1125	52	16	8836	4	0	8908
1126	33	11	8297	5	0	8346
1127	23	7	8849	5	0	8884
1128	19	7	48	9063	0	9137
1129	21	3	27	9172	0	9223
1130	14	2	9202	40	0	9258
1131	8966	4	39	39	0	9048
1132	9472	3	12	34	0	9521
1133	9509	5	15	25	0	9554
1134	9385	2	5	25	0	9417
1135	59	6	10096	8	0	10169
1136	10113	5	36	32	0	10186
1137	10233	6	21	20	0	10280
1138	10209	0	18	27	0	10254
1139	10352	2	6	22	0	10382
1140	10340	1	5	21	0	10367
1141	61	4	10468	14	0	10547
1142	31	10446	36	13	0	10526
1143	30	36	10	10354	0	10430
1144	21	17	14	10680	0	10732
1145	11	22	10625	44	0	10702
1146	9927	13	38	46	0	10024
1147	54	4	12	10427	0	10497
1148	29	7	10456	48	0	10540
1149	43	8	9815	19	0	9885
1150	19	10566	46	26	0	10657
1151	24	34	28	10682	0	10768
1152	26	12	12	10736	0	10786
1153	18	24	6	10652	0	10700
1154	10749	13	8	76	0	10846
1155	46	9	6	10741	0	10802
1156	20	8	10696	60	0	10784
1157	33	8	9719	30	0	9790
1158	24	5	10874	30	0	10933
1159	24	9	61	11100	0	11194
1160	11176	9	27	71	0	11283
1161	62	7	11237	18	0	11324
1162	11023	3	48	51	0	11125
1163	12082	6	16	65	0	12169
1164	66	9	25	12287	0	12387
1165	44	12	7	12355	0	12418
1166	39	12234	13	55	0	12341
1167	20	42	12356	36	0	12454
1168	12099	11	44	57	0	12211
1169	59	25	13	12712	0	12809
1170	20	12673	19	66	0	12778
1171	34	53	9	12816	0	12912
1172	28	19	12810	64	0	12921
1173	24	29	46	12603	0	12702
1174	18	12658	15	59	0	12750
1175	32	48	18	12588	0	12686
1176	12555	16	14	80	0	12665
1177	59	22	14	12238	0	12333
1178	24	12037	18	64	0	12143
1179	26	12236	18	29	0	12309
1180	11877	51	11	54	0	11993
1181	56	34	12288	23	0	12401
1182	43	26	52	12160	0	12281
1183	45	9	19	12468	0	12541
1184	28	13	12578	62	0	12681
1185	18	12518	49	46	0	12631
1186	25	45	12567	29	0	12666
1187	32	55	66	12280	0	12433
1188	10	12511	26	51	0	12598
1189	12720	44	26	52	0	12842
1190	40	12697	26	32	0	12795
1191	20	12858	8	17	0	12903
1192	12958	49	16	40	0	13063
1193	13042	22	8	51	0	13123
1194	13071	20	87	42	0	13220
1195	72	9	7	13260	0	13348
1196	32	14	13172	43	0	13261
1197	12955	6	38	53	0	13052
1198	13669	6	20	48	0	13743
1199	74	7	19	14086	0	14186
1200	35	6	14131	65	0	14237
1201	26	14034	62	24	0	14146
1202	14039	58	17	47	0	14161
1203	14377	13	21	51	0	14462
1204	82	14517	13	13	0	14625
1205	32	14723	6	14	0	14775
1206	14623	63	10	40	0	14736
1207	14591	25	8	40	0	14664
1208	14311	24	6	27	0	14368
1209	102	5	9	14213	0	14329
1210	33	15	14154	71	0	14273
1211	35	14	61	13720	0	13830
1212	19	11	13788	75	0	13893
1213	16	13453	74	38	0	13581
1214	19	13616	18	30	0	13683
1215	30	73	17	12753	0	12873
1216	16	16	10	12983	0	13025
1217	24	14	4	12821	0	12863
1218	9	12995	11	68	0	13083
1219	12901	49	10	50	0	13010
1220	12764	16	10	52	0	12842
1221	56	13066	17	20	0	13159
1222	42	56	7	12694	0	12799
1223	25	12743	6	57	0	12831
1224	22	72	4	12750	0	12848
1225	16	12815	4	62	0	12897
1226	12815	63	6	44	0	12928
1227	79	22	5	12576	0	12682
1228	29	18	12530	65	0	12642
1229	12199	12	51	55	0	12317
1230	12376	11	18	56	0	12461
1231	60	25	12372	21	0	12478
1232	46	9	57	12283	0	12395
1233	28	20	12423	59	0	12530
1234	23	20	57	12402	0	12502
1235	17	22	11744	75	0	11858
1236	11282	20	56	44	0	11402
1237	67	15	18	11520	0	11620
1238	24	11600	14	65	0	11703
1239	11884	66	8	40	0	11998
1240	95	24	6	12072	0	12197
1241	40	32	12	11993	0	12077
1242	31	30	11899	80	0	12040
1243	39	19	67	12255	0	12380
1244	24	21	12622	100	0	12767
1245	26	23	12921	31	0	13001
1246	45	11	94	13429	0	13579
1247	21	18	14233	115	0	14387
1248	14451	16	148	66	0	14681
1249	16936	13	30	55	0	17034
1250	18486	20	30	68	0	18604
1251	302	19794	27	29	0	20152
1252	158	254	14	20113	0	20539
1253	113	84	28	19464	0	19689
1254	39	20530	26	311	0	20906
1255	20505	270	22	143	0	20940
1256	330	92	14	20421	0	20857
1257	110	68	20729	294	0	21201
1258	80	59	19879	117	0	20135
1259	53	20128	332	101	0	20614
1260	20282	287	124	101	0	20794
1261	305	108	20201	51	0	20665
1262	19423	57	299	94	0	19873
1263	304	18989	127	79	0	19499
1264	138	265	19316	40	0	19759
1265	89	109	18128	48	0	18374
1266	70	69	19331	42	0	19512
1267	48	18980	389	53	0	19470
1268	67	286	19111	34	0	19498
1269	18621	111	331	59	0	19122
1270	344	68	158	18042	0	18612
1271	156	49	99	19067	0	19371
1272	109	42	71	19229	0	19451
1273	106	45	49	19318	0	19518
1274	65	43	19046	401	0	19555
1275	103	31	290	18979	0	19403
1276	92	45	109	19170	0	19416
1277	18786	33	88	438	0	19345
1278	19165	31	78	218	0	19492
1279	17603	52	66	192	0	17913
1280	363	49	18450	100	0	18962
1281	166	18994	294	104	0	19558
1282	99	19921	137	101	0	20258
1283	18839	383	99	116	0	19437
1284	330	19539	68	100	0	20037
1285	188	361	74	19391	0	20014
1286	153	148	84	19749	0	20134
1287	86	110	19477	426	0	20099
1288	64	19330	360	191	0	19945
1289	84	340	18835	122	0	19381
1290	18820	162	355	130	0	19467
1291	19439	104	156	109	0	19808
1292	461	73	113	19148	0	19795
1293	213	52	119	19053	0	19437
1294	147	74	103	19023	0	19347
1295	124	73	108	19163	0	19468
1296	98	58	18932	493	0	19581
1297	125	99	361	18794	0	19379
1298	90	53	18890	432	0	19465
1299	67	39	18296	236	0	18638
1300	62	18284	423	187	0	18956
1301	18339	307	192	174	0	19012
1302	329	18797	132	150	0	19408
1303	185	373	95	18441	0	19094
1304	107	146	19159	410	0	19822
1305	18815	92	393	206	0	19506
1306	388	78	19119	140	0	19725
1307	19189	71	415	139	0	19814
1308	19484	54	189	118	0	19845
1309	537	76	124	19661	0	20398
1310	256	79	99	19719	0	20153
1311	192	70	99	19877	0	20238
1312	143	91	19352	552	0	20138
1313	19078	96	415	275	0	19864
1314	452	19215	186	182	0	20035
1315	245	404	134	19253	0	20036
1316	19347	179	112	479	0	20117
1317	19683	123	113	272	0	20191
1318	19771	110	104	211	0	20196
1319	648	100	18950	186	0	19884
1320	19544	109	420	199	0	20272
1321	19742	126	210	211	0	20289
1322	597	96	16815	258	0	17766
1323	298	104	19910	208	0	20520
1324	253	130	509	19802	0	20694
1325	218	75	20150	495	0	20938
1326	148	19355	595	302	0	20400
1327	137	20172	416	156	0	20881
1328	19686	537	260	150	0	20633
1329	498	20266	207	105	0	21076
1330	338	482	207	20210	0	21237
1331	19735	228	205	480	0	20648
1332	513	20353	172	228	0	21266
1333	259	509	175	20236	0	21179
1334	186	196	217	20617	0	21216
1335	145	145	20179	635	0	21104
1336	154	138	532	20193	0	21017
1337	166	123	20080	611	0	20980
1338	194	68	20134	345	0	20741
1339	205	81	538	19659	0	20483
1340	157	72	243	20018	0	20490
1341	19514	64	153	747	0	20478
1342	494	20560	157	409	0	21620
1343	280	482	139	20310	0	21211
1344	246	485	154	20203	0	21088
1345	19459	136	94	738	0	20427
1346	552	18791	86	401	0	19830
1347	318	18002	98	221	0	18639
1348	210	17092	99	189	0	17590
1349	118	15282	99	131	0	15630
1350	12240	356	509	87	0	13192
1351	11793	104	107	52	0	12056
1352	11404	71	27	47	0	11549
1353	11374	52	24	51	0	11501
1354	305	45	21	11095	0	11466
1355	128	43	10963	228	0	11362
1356	89	10887	207	84	0	11267
1357	72	227	73	10773	0	11145
1358	63	71	10796	227	0	11157
1359	59	66	219	10658	0	11002
1360	57	39	83	10774	0	10953
1361	47	39	10624	279	0	10989
1362	48	48	220	10593	0	10909
1363	78	43	100	10280	0	10501
1364	10651	31	53	313	0	11048
1365	10648	32	60	134	0	10874
1366	10640	26	45	99	0	10810
1367	10654	29	37	84	0	10804
1368	307	26	48	10396	0	10777
1369	148	31	26	10550	0	10755
1370	116	30	35	10558	0	10739
1371	10348	34	44	317	0	10743
1372	278	36	36	10419	0	10769
1373	125	29	31	10568	0	10753
1374	109	31	10217	328	0	10685
1375	107	54	213	10065	0	10439
1376	92	9843	80	272	0	10287
1377	83	10359	44	144	0	10630
1378	10023	267	46	101	0	10437
1379	278	91	9929	93	0	10391
1380	125	9533	211	80	0	9949
1381	9251	225	133	61	0	9670
1382	248	91	51	9167	0	9557
1383	100	58	9184	249	0	9591
1384	87	99	228	8917	0	9331
1385	62	9316	85	241	0	9704
1386	9253	218	62	115	0	9648
1387	242	9447	39	95	0	9823
1388	9418	238	42	85	0	9783
1389	9656	84	46	81	0	9867
1390	303	67	32	9551	0	9953
1391	133	57	35	9440	0	9665
1392	83	9490	28	294	0	9895
1393	9520	223	32	149	0	9924
1394	263	71	9435	93	0	9862
1395	9232	58	209	88	0	9587
1396	9282	46	67	87	0	9482
1397	279	51	8953	76	0	9359
1398	139	108	186	8556	0	8989
1399	8641	38	85	223	0	8987
1400	243	37	8576	106	0	8962
1401	111	41	8313	80	0	8545
1402	7796	45	226	83	0	8150
1403	202	7706	90	82	0	8080
1404	92	7279	52	61	0	7484
1405	119	220	77	7019	0	7435
1406	60	77	6991	174	0	7302
1407	6711	54	163	76	0	7004
1408	174	39	6837	59	0	7109
1409	77	6330	158	50	0	6615
1410	6278	151	75	52	0	6556
1411	179	57	41	6261	0	6538
1412	6236	35	40	171	0	6482
1413	177	29	6190	91	0	6487
1414	97	35	141	6065	0	6338
1415	66	6234	54	152	0	6506
1416	64	145	35	6240	0	6484
1417	64	62	29	6355	0	6510
1418	68	40	6256	174	0	6538
1419	51	6052	145	100	0	6348
1420	48	6166	58	67	0	6339
1421	63	156	5909	50	0	6178
1422	5547	70	141	53	0	5811
1423	5667	35	69	56	0	5827
1424	186	48	47	5489	0	5770
1425	5231	27	29	138	0	5425
1426	143	5023	34	68	0	5268
1427	60	5236	28	54	0	5378
1428	5210	145	42	49	0	5446
1429	174	77	38	5108	0	5397
1430	5161	39	48	130	0	5378
1431	5272	29	26	72	0	5399
1432	182	27	17	5040	0	5266
1433	89	19	5022	131	0	5261
1434	4985	27	120	67	0	5199
1435	5118	21	53	45	0	5237
1436	176	32	42	4958	0	5208
1437	85	4995	28	119	0	5227
1438	63	146	23	4991	0	5223
1439	50	45	4979	149	0	5223
1440	61	26	4888	60	0	5035
1441	42	4867	144	58	0	5111
1442	88	96	50	3605	0	3839
1443	26	20	30	3616	0	3692
1444	16	16	3576	79	0	3687
1445	3511	15	61	28	0	3615
1446	3643	8	25	20	0	3696
1447	3682	9	16	21	0	3728
1448	3676	13	16	17	0	3722
1449	84	3563	12	22	0	3681
1450	33	3686	10	21	0	3750
1451	3756	67	23	16	0	3862
1452	71	28	12	3799	0	3910
1453	35	19	8	3894	0	3956
1454	24	3867	12	83	0	3986
1455	20	68	11	3899	0	3998
1456	25	23	11	3867	0	3926
1457	16	3830	16	88	0	3950
1458	22	78	3821	31	0	3952
1459	24	25	75	3858	0	3982
1460	3855	20	17	91	0	3983
1461	3863	16	13	30	0	3922
1462	91	10	3796	26	0	3923
1463	43	9	3732	14	0	3798
1464	28	8	3739	13	0	3788
1465	22	23	87	3673	0	3805
1466	25	12	3683	75	0	3795
1467	19	10	3714	34	0	3777
1468	22	39	73	3627	0	3761
1469	26	3757	30	60	0	3873
1470	15	68	3811	30	0	3924
1471	14	3836	69	22	0	3941
1472	3767	70	22	20	0	3879
1473	69	3795	22	12	0	3898
1474	16	72	17	3753	0	3858
1475	3776	18	16	67	0	3877
1476	62	18	17	3769	0	3866
1477	25	9	15	3840	0	3889
1478	22	11	3870	67	0	3970
1479	15	3695	58	37	0	3805
1480	15	3837	20	20	0	3892
1481	18	63	18	3647	0	3746
1482	15	16	12	3651	0	3694
1483	16	15	12	3562	0	3605
1484	13	9	3467	65	0	3554
1485	8	15	3277	29	0	3329
1486	3099	8	50	20	0	3177
1487	54	8	3165	14	0	3241
1488	8	9	3193	8	0	3218
1489	8	3104	46	7	0	3165
1490	20	60	15	3063	0	3158
1491	8	7	3112	40	0	3167
1492	10	3	36	3003	0	3052
1493	2	5	3170	43	0	3220
1494	4	4	43	3176	0	3227
1495	5	7	3333	40	0	3385
1496	7	3	38	3295	0	3343
1497	9	5	9	3308	0	3331
1498	5	3403	9	43	0	3460
1499	6	37	8	3423	0	3474
1500	5	3447	7	42	0	3501
1501	10	37	9	3481	0	3537
1502	7	8	9	3518	0	3542
1503	3428	7	7	49	0	3491
1504	37	6	9	3391	0	3443
1505	9	9	3381	48	0	3447
1506	13	6	41	3346	0	3406
1507	3	4	15	3417	0	3439
1508	7	4	3365	53	0	3429
1509	4	11	3315	19	0	3349
1510	13	8	46	3298	0	3365
1511	7	8	16	3395	0	3426
1512	5	6	3375	57	0	3443
1513	2	3257	47	24	0	3330
1514	4	3378	16	16	0	3414
1515	3332	46	13	20	0	3411
1516	46	10	7	3443	0	3506
1517	3540	7	11	50	0	3608
1518	3492	7	11	23	0	3533
1519	45	3529	20	18	0	3612
1520	3570	48	7	22	0	3647
1521	3592	6	16	22	0	3636
1522	47	10	3583	18	0	3658
1523	15	5	47	3590	0	3657
1524	7	8	3694	55	0	3764
1525	10	7	56	3705	0	3778
1526	3	6	3692	63	0	3764
1527	6	3537	54	19	0	3616
1528	2	3652	12	19	0	3685
1529	19	52	14	3574	0	3659
1530	3563	13	8	52	0	3636
1531	41	9	8	3582	0	3640
1532	16	6	8	3601	0	3631
1533	13	7	3625	56	0	3701
1534	8	8	3594	21	0	3631
1535	10	4	3617	20	0	3651
1536	9	3	60	3594	0	3666
1537	11	5	18	3601	0	3635
1538	4	3576	21	59	0	3660
1539	5	3700	15	21	0	3741
1540	3646	50	13	30	0	3739
1541	46	3710	11	14	0	3781
1542	9	56	3713	21	0	3799
1543	14	15	56	3696	0	3781
1544	9	15	3902	56	0	3982
1545	5	3958	57	32	0	4052
1546	16	49	19	3978	0	4062
1547	3879	9	16	68	0	3972
1548	42	13	3924	21	0	4000
1549	12	3962	51	31	0	4056
1550	14	45	3980	21	0	4060
1551	10	3924	51	16	0	4001
1552	29	63	36	3735	0	3863
1553	3781	15	18	53	0	3867
1554	3777	15	8	23	0	3823
1555	43	3777	4	23	0	3847
1556	3842	35	8	18	0	3903
1557	43	12	12	3829	0	3896
1558	3843	16	11	51	0	3921
1559	43	8	3891	22	0	3964
1560	12	8	3924	16	0	3960
1561	14	8	53	3859	0	3934
1562	9	7	17	4084	0	4117
1563	7	7	4035	59	0	4108
1564	9	7	48	4096	0	4160
1565	4122	10	15	60	0	4207
1566	4155	11	15	24	0	4205
1567	53	4031	11	17	0	4112
1568	18	4064	12	17	0	4111
1569	3983	51	11	13	0	4058
1570	56	15	16	3978	0	4065
1571	3946	19	6	62	0	4033
1572	54	3957	9	20	0	4040
1573	3973	44	7	23	0	4047
1574	58	10	3900	12	0	3980
1575	16	18	3904	10	0	3948
1576	26	10	55	3959	0	4050
1577	15	5	4036	59	0	4115
1578	16	7	58	3907	0	3988
1579	11	13	11	3816	0	3851
1580	11	6	4098	55	0	4170
1581	13	10	50	4109	0	4182
1582	17	8	13	4328	0	4366
1583	12	5	4497	59	0	4573
1584	10	7	4449	27	0	4493
1585	4428	7	53	26	0	4514
1586	52	6	4670	16	0	4744
1587	4774	13	61	17	0	4865
1588	5083	4	17	21	0	5125
1589	56	4	5223	15	0	5298
1590	25	4	5393	11	0	5433
1591	21	17	62	5225	0	5325
1592	14	6	25	5266	0	5311
1593	10	5282	23	53	0	5368
1594	9	5396	11	23	0	5439
1595	12	53	5316	19	0	5400
1596	5135	18	60	15	0	5228
1597	5292	13	22	18	0	5345
1598	58	5	5297	15	0	5375
1599	21	5	5283	12	0	5321
1600	18	9	59	5271	0	5357
1601	9	5372	30	50	0	5461
1602	13	47	21	5503	0	5584
1603	14	13	10	5611	0	5648
1604	5590	15	13	61	0	5679
1605	5617	5	14	29	0	5665
1606	65	7	14	5801	0	5887
1607	29	9	5841	52	0	5931
1608	5585	8	51	26	0	5670
1609	52	5933	22	31	0	6038
1610	6007	44	17	21	0	6089
1611	5945	12	10	16	0	5983
1612	57	5965	10	16	0	6048
1613	23	6114	16	13	0	6166
1614	28	53	9	6103	0	6193
1615	22	24	7	6135	0	6188
1616	13	6025	11	58	0	6107
1617	21	50	10	6070	0	6151
1618	18	17	6	6160	0	6201
1619	17	20	6054	62	0	6153
1620	5888	16	46	35	0	5985
1621	6098	12	20	25	0	6155
1622	6156	9	16	22	0	6203
1623	80	12	7	6088	0	6187
1624	6018	5	8	60	0	6091
1625	55	5970	15	30	0	6070
1626	30	55	17	5842	0	5944
1627	34	5852	9	42	0	5937
1628	19	6113	7	19	0	6158
1629	6104	49	15	25	0	6193
1630	6109	12	14	18	0	6153
1631	6055	12	6	12	0	6085
1632	6052	11	3	15	0	6081
1633	5994	9	11	17	0	6031
1634	69	15	6108	9	0	6201
1635	6007	16	42	15	0	6080
1636	62	14	6294	14	0	6384
1637	6109	8	45	18	0	6180
1638	6253	10	18	13	0	6294
1639	6216	10	12	20	0	6258
1640	61	9	6487	20	0	6577
1641	31	22	41	6383	0	6477
1642	24	6672	18	36	0	6750
1643	6773	37	13	15	0	6838
1644	6660	20	8	14	0	6702
1645	61	6755	13	13	0	6842
1646	6903	31	12	17	0	6963
1647	69	20	16	6814	0	6919
1648	23	6932	14	51	0	7020
1649	6928	40	14	35	0	7017
1650	6922	14	7	23	0	6966
1651	58	19	5	6947	0	7029
1652	7051	14	4	51	0	7120
1653	64	6	9	7112	0	7191
1654	30	12	16	7151	0	7209
1655	32	12	7131	51	0	7226
1656	31	11	38	7024	0	7104
1657	39	9	17	7135	0	7200
1658	30	12	7093	51	0	7186
1659	16	17	6991	25	0	7049
1660	29	8	39	7151	0	7227
1661	22	9	7215	48	0	7294
1662	6715	15	41	30	0	6801
1663	40	7336	20	25	0	7421
1664	33	30	8	7440	0	7511
1665	27	20	11	7547	0	7605
1666	30	9	9	7484	0	7532
1667	7580	6	10	64	0	7660
1668	7491	8	6	44	0	7549
1669	7597	11	12	24	0	7644
1670	51	7613	3	26	0	7693
1671	36	36	6	7697	0	7775
1672	32	14	8	7727	0	7781
1673	7698	14	5	47	0	7764
1674	7648	11	1	40	0	7700
1675	51	7	10	7648	0	7716
1676	33	18	7655	35	0	7741
1677	7540	20	26	30	0	7616
1678	7753	7	16	39	0	7815
1679	51	3	7903	20	0	7977
1680	7490	7	28	26	0	7551
1681	59	5	7991	9	0	8064
1682	7856	1	32	29	0	7918
1683	43	53	17	8003	0	8116
1684	22	8343	10	26	0	8401
1685	29	23	8624	16	0	8692
1686	15	8572	34	23	0	8644
1687	20	7869	20	14	0	7923
1688	8539	55	47	40	0	8681
1689	32	29	21	8446	0	8528
1690	7	2	6	8281	0	8296
1691	8494	1	3	34	0	8532
1692	23	1	4	8560	0	8588
1693	10	1	4	8539	0	8554
1694	10	3	4	8507	0	8524
1695	5	2	4	8448	0	8459
1696	7	3	8498	26	0	8534
1697	5	2	8255	13	0	8275
1698	5	8403	22	7	0	8437
1699	8524	23	8	20	0	8575
1700	32	9	1	8659	0	8701
1701	9	8480	3	25	0	8517
1702	12	22	2	8939	0	8975
1703	8	7	1	8970	0	8986
1704	7	3	1	8945	0	8956
1705	17	1	2	8988	0	9008
1706	10	4	1	8895	0	8910
1707	6	8753	4	46	0	8809
1708	7	20	2	8882	0	8911
1709	7	5	8721	25	0	8758
1710	8	8706	25	7	0	8746
1711	10	24	6	8790	0	8830
1712	8	8	5	8743	0	8764
1713	10	8604	3	31	0	8648
1714	6	8704	2	20	0	8732
1715	8629	20	2	24	0	8675
1716	18	8615	7	11	0	8651
1717	8594	22	8	27	0	8651
1718	8554	6	4	25	0	8589
1719	24	13	8958	10	0	9005
1720	22	3	24	8735	0	8784
1721	6	8	9068	28	0	9110
1722	4	9158	30	10	0	9202
1723	36	36	6	8317	0	8395
1724	8	10	4	9211	0	9233
1725	11	4	1	9336	0	9352
1726	8	4	2	9377	0	9391
1727	7	7	9531	38	0	9583
1728	17	5	28	9470	0	9520
1729	10	6	9590	32	0	9638
1730	14	11	9342	5	0	9372
1731	9175	4	30	27	0	9236
1732	9736	5	8	25	0	9774
1733	9836	5	6	27	0	9874
1734	35	9627	4	14	0	9680
1735	12	26	3	9760	0	9801
1736	11	11	9984	36	0	10042
1737	14	4	30	9894	0	9942
1738	17	7	10249	37	0	10310
1739	10014	2	29	35	0	10080
1740	9953	1	11	32	0	9997
1741	9926	3	11	18	0	9958
1742	40	6	9693	7	0	9746
1743	21	3	9634	4	0	9662
1744	22	9	31	9897	0	9959
1745	23	6	13	9299	0	9341
1746	8	7	5	9954	0	9974
1747	9	3	9951	31	0	9994
1748	6	9	9298	9	0	9322
1749	9721	1	29	21	0	9772
1750	33	2	10	10236	0	10281
1751	20	2	9	10281	0	10312
1752	10401	1	4	49	0	10455
1753	33	1	3	10365	0	10402
1754	10862	2	5	61	0	10930
1755	11027	1	10	39	0	11077
1756	11020	6	6	32	0	11064
1757	32	7	11168	10	0	11217
1758	8	11135	31	16	0	11190
1759	11378	26	5	32	0	11441
1760	39	3	2	11410	0	11454
1761	10	3	7	11365	0	11385
1762	6	11377	5	37	0	11425
1763	11226	32	5	23	0	11286
1764	11186	2	4	28	0	11220
1765	11260	2	3	31	0	11296
1766	41	11378	10	10	0	11439
1767	11898	32	1	37	0	11968
1768	11932	3	2	32	0	11969
1769	11927	2	2	15	0	11946
1770	40	5	5	11797	0	11847
1771	23	4	4	11866	0	11897
1772	10	9	12035	42	0	12096
1773	14	3	31	11795	0	11843
1774	22	6	6	11789	0	11823
1775	16	5	11994	38	0	12053
1776	11482	3	32	23	0	11540
1777	12004	2	3	21	0	12030
1778	47	8	3	11892	0	11950
1779	11	11639	10	34	0	11694
1780	14	11799	5	13	0	11831
1781	22	52	9	11598	0	11681
1782	15	9	11378	42	0	11444
1783	29	31	29	11059	0	11148
1784	8	8	11116	36	0	11168
1785	11	6	10755	18	0	10790
1786	16	4	23	11101	0	11144
1787	11094	2	5	45	0	11146
1788	10764	4	4	37	0	10809
1789	33	7	3	11027	0	11070
1790	17	3	7	10935	0	10962
1791	16	4	4	11008	0	11032
1792	11	6	8	10925	0	10950
1793	10957	2	6	51	0	11016
1794	10861	3	9	30	0	10903
1795	10827	4	7	39	0	10877
1796	34	5	10824	9	0	10872
1797	16	3	26	10742	0	10787
1798	15	4	7	10963	0	10989
1799	10848	5	2	44	0	10899
1800	27	10725	7	16	0	10775
1801	10711	20	5	44	0	10780
1802	10639	6	0	33	0	10678
1803	10584	2	4	38	0	10628
1804	10558	2	6	30	0	10596
1805	43	9	10817	7	0	10876
1806	21	5	10175	10	0	10211
1807	11039	4	48	41	0	11132
1808	11254	5	8	43	0	11310
1809	11268	1	3	26	0	11298
1810	11469	2	6	32	0	11509
1811	57	6	12172	11	0	12246
1812	18	12704	63	17	0	12802
1813	41	68	19	13707	0	13835
1814	14316	15	17	131	0	14479
1815	14653	16	9	76	0	14754
1816	15769	9	3	54	0	15835
1817	16136	4	7	56	0	16203
1818	16520	5	6	36	0	16567
1819	15976	5	9	44	0	16034
1820	255	19	14059	53	0	14386
1821	113	10	15469	11	0	15603
1822	97	35	165	15352	0	15649
1823	79	7	15597	140	0	15823
1824	68	15181	173	53	0	15475
1825	72	15224	68	38	0	15402
1826	85	208	38	15675	0	16006
1827	50	71	16146	145	0	16412
1828	29	34	15566	62	0	15691
1829	15531	24	224	82	0	15861
1830	16925	19	101	69	0	17114
1831	270	28	55	17208	0	17561
1832	17589	34	38	250	0	17911
1833	287	30	29	17523	0	17869
1834	119	17	42	17626	0	17804
1835	69	10	17750	300	0	18129
1836	67	7	17200	108	0	17382
1837	103	11	283	17111	0	17508
1838	68	12	17153	259	0	17492
1839	16508	12	267	145	0	16932
1840	17410	7	94	102	0	17613
1841	315	17630	63	72	0	18080
1842	17784	234	70	91	0	18179
1843	322	69	17644	37	0	18072
1844	17459	35	279	69	0	17842
1845	17939	23	109	64	0	18135
1846	18084	17	69	58	0	18228
1847	439	17	52	17466	0	17974
1848	191	17676	44	238	0	18149
1849	17822	247	46	117	0	18232
1850	17830	71	54	94	0	18049
1851	412	44	68	17817	0	18341
1852	17770	32	45	335	0	18182
1853	405	18030	45	126	0	18606
1854	214	277	49	17822	0	18362
1855	124	102	17594	352	0	18172
1856	16681	67	302	177	0	17227
1857	381	50	17623	75	0	18129
1858	190	65	320	17581	0	18156
1859	136	17416	142	314	0	18008
1860	138	18792	82	121	0	19133
1861	159	395	59	19043	0	19656
1862	110	18966	92	378	0	19546
1863	181	460	67	24624	0	25332
1864	166	141	76	26210	0	26593
1865	181	90	61	26786	0	27118
1866	25791	96	48	900	0	26835
1867	732	107	39	25770	0	26648
1868	263	78	25279	841	0	26461
1869	184	25379	602	356	0	26521
1870	25532	623	179	256	0	26590
1871	814	197	109	25454	0	26574
1872	355	108	85	26041	0	26589
1873	300	99	106	26294	0	26799
1874	236	121	25464	897	0	26718
1875	198	25477	678	402	0	26755
1876	25617	664	238	314	0	26833
1877	794	242	143	24805	0	25984
1878	296	25863	148	773	0	27080
1879	25840	714	130	383	0	27067
1880	761	279	25636	279	0	26955
1881	25706	191	715	266	0	26878
1882	804	177	26081	206	0	27268
1883	462	204	26027	161	0	26854
1884	274	25774	823	238	0	27109
1885	274	694	334	25220	0	26522
1886	230	267	25368	774	0	26639
1887	205	24628	823	338	0	25994
1888	228	716	344	24223	0	25511
1889	175	24826	242	736	0	25979
1890	145	757	24909	319	0	26130
1891	193	310	768	24790	0	26061
1892	152	237	24939	871	0	26199
1893	179	193	815	24886	0	26073
1894	182	182	336	25527	0	26227
1895	144	160	24919	998	0	26221
1896	196	141	811	24960	0	26108
1897	24354	132	346	979	0	25811
1898	740	24554	258	549	0	26101
1899	303	739	24611	405	0	26058
1900	24447	263	787	366	0	25863
1901	868	181	322	23792	0	25163
1902	403	24609	244	786	0	26042
1903	24842	758	231	407	0	26238
1904	25394	281	240	325	0	26240
1905	1019	247	176	24268	0	25710
1906	442	217	156	24872	0	25687
1907	341	174	180	24897	0	25592
1908	307	190	151	24554	0	25202
1909	236	23792	168	1132	0	25328
1910	340	1177	167	22847	0	24531
1911	236	22497	158	909	0	23800
1912	216	22291	139	560	0	23206
1913	153	21855	178	445	0	22631
1914	198	843	20584	401	0	22026
1915	177	20859	705	430	0	22171
1916	19123	811	408	386	0	20728
1917	641	19125	191	404	0	20361
1918	313	710	194	17917	0	19134
1919	218	19037	211	795	0	20261
1920	250	751	195	18981	0	20177
1921	259	344	177	19531	0	20311
1922	213	323	18876	909	0	20321
1923	18432	322	653	521	0	19928
1924	18973	267	277	445	0	19962
1925	18827	246	222	492	0	19787
1926	773	18400	250	507	0	19930
1927	349	688	256	18174	0	19467
1928	286	315	17954	836	0	19391
1929	271	17772	665	503	0	19211
1930	319	766	306	15429	0	16820
1931	255	16576	225	632	0	17688
1932	16293	659	246	370	0	17568
1933	16496	325	229	258	0	17308
1934	16677	291	249	246	0	17463
1935	16602	206	274	241	0	17323
1936	788	233	269	15952	0	17242
1937	403	218	235	16000	0	16856
1938	302	16091	219	719	0	17331
1939	277	663	181	16228	0	17349
1940	234	312	15875	768	0	17189
1941	168	280	562	15757	0	16767
1942	115	244	15457	829	0	16645
1943	105	15233	605	510	0	16453
1944	128	594	15346	393	0	16461
1945	154	319	675	15282	0	16430
1946	120	226	15401	802	0	16549
1947	160	193	688	15314	0	16355
1948	165	235	316	15553	0	16269
1949	213	197	273	15544	0	16227
1950	190	227	221	15578	0	16216
1951	14668	202	215	798	0	15883
1952	590	14777	166	449	0	15982
1953	14375	579	141	385	0	15480
1954	608	304	13821	342	0	15075
1955	13883	215	466	350	0	14914
1956	14307	213	174	320	0	15014
1957	785	188	13636	307	0	14916
1958	559	136	13256	297	0	14248
1959	317	12881	527	332	0	14057
1960	253	12419	195	332	0	13199
1961	364	605	11105	367	0	12441
1962	167	10006	409	411	0	10993
1963	311	435	191	5368	0	6305
1964	4718	63	114	125	0	5020
1965	72	31	16	4633	0	4752
1966	4646	10	15	95	0	4766
1967	4659	16	9	34	0	4718
1968	82	4696	9	33	0	4820
1969	4655	59	13	26	0	4753
1970	4682	22	9	29	0	4742
1971	82	24	6	4622	0	4734
1972	4626	12	5	81	0	4724
1973	72	4701	7	34	0	4814
1974	27	60	4	4728	0	4819
1975	4719	15	10	76	0	4820
1976	70	19	4720	23	0	4832
1977	4662	8	56	25	0	4751
1978	75	26	15	4717	0	4833
1979	26	6	4708	49	0	4789
1980	23	9	4620	14	0	4666
1981	4486	30	79	28	0	4623
1982	4475	4	18	11	0	4508
1983	50	4	12	4398	0	4464
1984	27	0	6	4432	0	4465
1985	17	6	1	4456	0	4480
1986	7	4467	3	60	0	4537
1987	4460	43	2	21	0	4526
1988	46	4468	3	16	0	4533
1989	4465	49	2	14	0	4530
1990	54	15	4451	5	0	4525
1991	25	8	43	4452	0	4528
1992	4540	6	12	52	0	4610
1993	50	4	11	4536	0	4601
1994	20	4	8	4517	0	4549
1995	15	4391	6	56	0	4468
1996	4484	42	6	29	0	4561
1997	48	4722	6	20	0	4796
1998	14	49	11	4796	0	4870
1999	16	18	4729	46	0	4809
2000	4369	16	48	23	0	4456
2001	57	4	4647	19	0	4727
2002	4404	6	65	16	0	4491
2003	60	4745	13	28	0	4846
2004	28	48	14	4599	0	4689
2005	15	4736	5	51	0	4807
2006	4795	53	6	18	0	4872
2007	59	18	7	4833	0	4917
2008	20	14	4	4906	0	4944
2009	20	11	4799	63	0	4893
2010	4626	6	47	41	0	4720
2011	56	11	14	4877	0	4958
2012	23	6	4803	61	0	4893
2013	18	4794	57	22	0	4891
2014	28	48	11	4795	0	4882
2015	4829	15	14	56	0	4914
2016	53	13	10	4847	0	4923
2017	15	11	4896	60	0	4982
2018	5165	4	52	23	0	5244
2019	71	9	14	5168	0	5262
2020	24	11	5572	73	0	5680
2021	28	6	66	5654	0	5754
2022	23	9	16	5691	0	5739
2023	12	5766	20	86	0	5884
2024	5759	71	9	40	0	5879
2025	75	5786	10	29	0	5900
2026	5771	81	8	25	0	5885
2027	98	23	6	5649	0	5776
2028	24	5763	7	74	0	5868
2029	35	79	10	5710	0	5834
2030	17	23	5676	96	0	5812
2031	5507	20	73	40	0	5640
2032	92	12	17	5558	0	5679
2033	31	11	19	5556	0	5617
2034	35	11	9	5584	0	5639
2035	18	14	5457	112	0	5601
2036	19	14	5408	44	0	5485
2037	15	5474	81	44	0	5614
2038	22	69	27	5310	0	5428
2039	5317	20	17	81	0	5435
2040	72	5409	9	36	0	5526
2041	42	68	12	5531	0	5653
2042	5624	29	15	88	0	5756
2043	5649	19	8	42	0	5718
2044	89	5651	15	32	0	5787
2045	5979	80	11	30	0	6100
2046	6502	23	9	35	0	6569
2047	136	20	11	6700	0	6867
2048	48	6707	10	124	0	6889
2049	39	111	8	6851	0	7009
2050	6814	32	7	130	0	6983
2051	130	29	6835	54	0	7048
2052	52	21	114	6800	0	6987
2053	47	23	30	6911	0	7011
2054	25	24	6739	169	0	6957
2055	43	22	118	6787	0	6970
2056	6771	23	42	157	0	6993
2057	6416	13	32	98	0	6559
2058	150	14	29	6742	0	6935
2059	61	14	6694	155	0	6924
2060	41	9	6534	96	0	6680
2061	40	6487	137	64	0	6728
2062	36	6689	54	61	0	6840
2063	58	130	39	6446	0	6673
2064	6384	37	30	139	0	6590
2065	124	6360	29	66	0	6579
2066	6308	125	29	60	0	6522
2067	128	42	36	6283	0	6489
2068	53	39	31	6299	0	6422
2069	6097	40	21	156	0	6314
2070	133	6158	19	66	0	6376
2071	6161	114	14	69	0	6358
2072	146	50	6018	55	0	6269
2073	66	41	5903	47	0	6057
2074	58	37	118	5808	0	6021
2075	44	25	5852	135	0	6056
2076	42	26	5746	58	0	5872
2077	50	37	127	5526	0	5740
2078	42	36	5675	124	0	5877
2079	45	17	128	5590	0	5780
2080	38	14	75	5630	0	5757
2081	28	18	5750	149	0	5945
2082	33	15	125	5611	0	5784
2083	25	19	67	5551	0	5662
2084	24	5536	51	155	0	5766
2085	5548	99	47	82	0	5776
2086	105	36	5589	68	0	5798
2087	40	25	119	5583	0	5767
2088	27	29	54	5664	0	5774
2089	31	20	5528	158	0	5737
2090	5276	21	117	90	0	5504
2091	105	5501	52	79	0	5737
2092	56	107	34	5511	0	5708
2093	43	41	45	5534	0	5663
2094	35	5535	42	146	0	5758
2095	35	112	5526	88	0	5761
2096	30	5572	120	70	0	5792
2097	5324	121	48	69	0	5562
2098	108	51	5289	52	0	5500
2099	51	48	106	5244	0	5449
2100	37	37	5338	128	0	5540
2101	34	42	5317	59	0	5452
2102	38	5294	129	48	0	5509
2103	50	117	65	5001	0	5233
2104	5065	43	42	117	0	5267
2105	5060	30	51	52	0	5193
2106	115	5099	51	53	0	5318
2107	46	105	36	5156	0	5343
2108	5152	31	39	131	0	5353
2109	5241	37	40	57	0	5375
2110	120	5194	30	55	0	5399
2111	5241	98	31	52	0	5422
2112	129	36	27	5165	0	5357
2113	72	5360	25	108	0	5565
2114	46	102	38	5455	0	5641
2115	56	72	24	5451	0	5603
2116	60	54	19	5466	0	5599
2117	39	39	5337	124	0	5539
2118	36	28	4873	59	0	4996
2119	35	5054	82	58	0	5229
2120	4568	81	58	44	0	4751
2121	68	4522	33	44	0	4667
2122	36	67	22	4497	0	4622
2123	19	33	4643	86	0	4781
2124	20	32	68	4547	0	4667
2125	18	23	40	4635	0	4716
2126	18	31	27	4690	0	4766
2127	4634	27	23	92	0	4776
2128	65	27	22	4677	0	4791
2129	25	21	4974	92	0	5112
2130	4808	16	72	65	0	4961
2131	4920	14	38	48	0	5020
2132	5059	11	24	49	0	5143
2133	5058	11	20	50	0	5139
2134	5080	10	23	38	0	5151
2135	95	5024	15	39	0	5173
2136	51	56	21	4887	0	5015
2137	45	4972	20	70	0	5107
2138	5024	57	16	32	0	5129
2139	4999	23	10	28	0	5060
2140	4889	17	13	21	0	4940
2141	91	4709	7	33	0	4840
2142	45	4652	12	14	0	4723
2143	43	4667	8	21	0	4739
2144	53	69	4570	17	0	4709
2145	67	221	49	3914	0	4251
2146	21	3605	7	17	0	3650
2147	3	3525	3	3	0	3534
2148	6	4	6	3486	0	3502
2149	6	1	4	3466	0	3477
2150	5	4	3504	3	0	3516
2151	3439	2	4	14	0	3459
2152	8	1	1	3655	0	3665
2153	5	1	1	3660	0	3667
2154	3	2	3652	6	0	3663
2155	3	7	3459	2	0	3471
2156	4	3771	4	7	0	3786
2157	5	8	1	3843	0	3857
2158	4	2	3	3866	0	3875
2159	2	5	3784	7	0	3798
2160	3505	3	7	9	0	3524
2161	3710	2	1	10	0	3723
2162	10	2	3851	4	0	3867
2163	3730	1	12	9	0	3752
2164	11	5	3887	5	0	3908
2165	3853	1	8	10	0	3872
2166	3943	3	4	12	0	3962
2167	12	3	4069	4	0	4088
2168	6	3	10	4045	0	4064
2169	14	1	2	3882	0	3899
2170	4	1	2	4251	0	4258
2171	4246	2	4	17	0	4269
2172	4176	2	8	11	0	4197
2173	18	0	4319	8	0	4345
2174	4	4	4167	6	0	4181
2175	4399	1	13	9	0	4422
2176	4497	0	4	13	0	4514
2177	14	2	4449	3	0	4468
2178	13	3	4337	3	0	4356
2179	13	0	15	4450	0	4478
2180	11	2	4538	12	0	4563
2181	6	0	14	4352	0	4372
2182	4545	2	9	20	0	4576
2183	20	4	4824	9	0	4857
2184	4609	3	29	14	0	4655
2185	34	1	5362	6	0	5403
2186	20	2	37	5311	0	5370
2187	8	1	15	5576	0	5600
2188	11	0	4	5613	0	5628
2189	5	5696	7	47	0	5755
2190	19	36	5	5156	0	5216
2191	10	14	4	5727	0	5755
2192	5689	1	4	62	0	5756
2193	40	8	5643	18	0	5709
2194	5356	3	39	12	0	5410
2195	43	4	5611	4	0	5662
2196	5183	1	38	22	0	5244
2197	41	5562	15	8	0	5626
2198	25	34	5548	4	0	5611
2199	7	15	5499	7	0	5528
2200	30	11	55	4904	0	5000
2201	5	5	18	5535	0	5563
2202	7	3	5562	50	0	5622
2203	7	3	5487	18	0	5515
2204	7	4	6010	9	0	6030
2205	6241	0	55	25	0	6321
2206	6377	2	20	20	0	6419
2207	6368	1	12	10	0	6391
2208	56	0	13	6283	0	6352
2209	25	3	8	6312	0	6348
2210	8	1	6572	56	0	6637
2211	17	2	41	6437	0	6497
2212	19	5	23	6058	0	6105
2213	6439	2	7	67	0	6515
2214	6418	2	6	33	0	6459
2215	6503	1	8	17	0	6529
2216	54	3	10	6483	0	6550
2217	28	2	5	6467	0	6502
2218	13	1	8	6487	0	6509
2219	6427	2	9	59	0	6497
2220	47	2	8	6368	0	6425
2221	22	6383	7	44	0	6456
2222	15	34	10	6300	0	6359
2223	15	6207	10	39	0	6271
2224	6222	37	7	24	0	6290
2225	6129	15	11	12	0	6167
2226	50	6192	11	14	0	6267
2227	22	6277	9	12	0	6320
2228	13	56	10	6253	0	6332
2229	13	15	6036	47	0	6111
2230	12	7	39	5913	0	5971
2231	11	7	6072	53	0	6143
2232	9	6095	41	36	0	6181
2233	18	43	21	6149	0	6231
2234	21	13	10	6196	0	6240
2235	13	12	6390	63	0	6478
2236	14	7	45	6371	0	6437
2237	12	4	6523	58	0	6597
2238	6390	8	45	34	0	6477
2239	6603	3	24	19	0	6649
2240	6626	6	11	25	0	6668
2241	65	5	10	6569	0	6649
2242	26	4	5	6590	0	6625
2243	15	4	6704	69	0	6792
2244	21	13	50	6539	0	6623
2245	11	6517	24	58	0	6610
2246	13	41	6619	33	0	6706
2247	13	20	6463	23	0	6519
2248	29	15	54	6126	0	6224
2249	12	10	6596	54	0	6672
2250	13	9	6470	34	0	6526
2251	6169	13	58	29	0	6269
2252	47	6922	24	23	0	7016
2253	7121	42	13	34	0	7210
2254	7143	20	9	32	0	7204
2255	7214	8	16	30	0	7268
2256	69	7	14	7191	0	7281
2257	31	10	13	7274	0	7328
2258	13	8	7227	63	0	7311
2259	22	5	47	7159	0	7233
2260	13	7193	26	61	0	7293
2261	7322	40	18	37	0	7417
2262	39	7224	18	22	0	7303
2263	26	7265	14	23	0	7328
2264	16	58	17	7275	0	7366
2265	21	19	7370	49	0	7459
2266	26	17	47	7270	0	7360
2267	22	9	7247	48	0	7326
2268	16	7184	45	34	0	7279
2269	7172	39	22	29	0	7262
2270	7195	16	20	29	0	7260
2271	7407	4	7	38	0	7456
2272	56	12	7696	19	0	7783
2273	32	7	7237	15	0	7291
2274	7548	6	54	26	0	7634
2275	7721	5	26	27	0	7779
2276	7826	6	13	38	0	7883
2277	65	6	9	7804	0	7884
2278	30	4	7	7900	0	7941
2279	7876	7	7	63	0	7953
2280	7753	5	7	51	0	7816
2281	57	8	7936	15	0	8016
2282	28	8	7637	9	0	7682
2283	7442	2	24	32	0	7500
2284	28	2	7681	8	0	7719
2285	7097	5	21	22	0	7145
2286	17	5	7238	6	0	7266
2287	16	18	8	7009	0	7051
2288	8	6	7286	8	0	7308
2289	12	0	7	7200	0	7219
2290	8	0	4	7297	0	7309
2291	1	7328	5	13	0	7347
2292	7429	6	2	26	0	7463
2293	11	3	7558	3	0	7575
2294	7206	2	8	20	0	7236
2295	11	7666	6	1	0	7684
2296	7972	7	3	26	0	8008
2297	12	1	1	8005	0	8019
2298	9	1	2	8079	0	8091
2299	5	8260	2	19	0	8286
2300	2	11	1	8666	0	8680
2301	12	5	1	8727	0	8745
2302	6	3	1	8852	0	8862
2303	8628	0	1	46	0	8675
2304	8110	3	1	39	0	8153
2305	29	4	8005	17	0	8055
2306	17	8018	21	6	0	8062
2307	20	20	9	8163	0	8212
2308	11	8	8	8402	0	8429
2309	5	9	8553	29	0	8596
2310	11	3	26	8291	0	8331
2311	8418	3	7	52	0	8480
2312	8462	2	10	32	0	8506
2313	8572	2	5	34	0	8613
2314	55	2	3	8686	0	8746
2315	8932	3	4	74	0	9013
2316	8970	0	1	49	0	9020
2317	9108	0	1	42	0	9151
2318	62	1	2	9122	0	9187
2319	37	2	4	9162	0	9205
2320	28	2	1	9175	0	9206
2321	21	4	5	9047	0	9077
2322	17	3	2	9055	0	9077
2323	10	5	8984	68	0	9067
2324	8	3	8843	35	0	8889
2325	5	8825	50	30	0	8910
2326	16	28	16	9061	0	9121
2327	21	10	12	9109	0	9152
2328	17	9	9	9156	0	9191
2329	11	11	9034	61	0	9117
2330	18	4	35	8976	0	9033
2331	14	11	8987	57	0	9069
2332	21	3	38	8967	0	9029
2333	11	7	9315	56	0	9389
2334	5	9263	48	41	0	9357
2335	14	36	18	9220	0	9288
2336	3	15	9146	58	0	9222
2337	8294	13	43	61	0	8411
2338	39	9188	19	27	0	9273
2339	15	43	23	9315	0	9396
2340	12	9339	17	52	0	9420
2341	15	55	9	9301	0	9380
2342	9445	18	8	82	0	9553
2343	52	15	7	9289	0	9363
2344	15	9290	5	69	0	9379
2345	9289	40	7	46	0	9382
2346	56	14	6	9533	0	9609
2347	22	18	10	9683	0	9733
2348	9856	9	7	97	0	9969
2349	64	9	10	10541	0	10624
2350	44	11	6	12940	0	13001
2351	29	3	13549	228	0	13809
2352	19	10	13466	92	0	13587
2353	34	6	268	13485	0	13793
2354	18	14	13648	236	0	13916
2355	12	10	13446	109	0	13577
2356	12937	9	327	114	0	13387
2357	232	9	13678	63	0	13982
2358	90	13663	327	41	0	14121
2359	103	215	139	13752	0	14209
2360	14159	77	99	256	0	14591
2361	14538	67	68	127	0	14800
2362	14450	39	49	129	0	14667
2363	377	14323	53	89	0	14842
2364	234	227	45	14226	0	14732
2365	163	95	43	14511	0	14812
2366	13788	68	38	376	0	14270
2367	14407	43	55	213	0	14718
2368	14450	37	45	168	0	14700
2369	403	33	14325	96	0	14857
2370	232	14032	271	98	0	14633
2371	158	15672	141	63	0	16034
2372	161	373	102	15351	0	15987
2373	130	214	73	16064	0	16481
2374	76	154	16132	510	0	16872
2375	15880	76	368	335	0	16659
2376	16373	54	209	235	0	16871
2377	581	52	154	16158	0	16945
2378	392	38	100	16333	0	16863
2379	308	28	68	16521	0	16925
2380	16216	32	52	669	0	16969
2381	474	34	15658	409	0	16575
2382	299	44	15914	284	0	16541
2383	219	57	527	15811	0	16614
2384	133	63	15955	474	0	16625
2385	15614	32	514	318	0	16478
2386	15860	24	321	237	0	16442
2387	16102	25	223	173	0	16523
2388	698	15350	144	141	0	16333
2389	15732	346	99	138	0	16315
2390	638	215	75	15346	0	16274
2391	396	157	58	15556	0	16167
2392	290	83	71	15789	0	16233
2393	181	57	15141	730	0	16109
2394	159	71	419	14861	0	15510
2395	140	14949	275	597	0	15961
2396	14574	348	204	426	0	15552
2397	410	14954	156	311	0	15831
2398	290	449	14669	220	0	15628
2399	276	14796	406	158	0	15636
2400	14213	502	286	157	0	15158
2401	466	14283	214	136	0	15099
2402	341	494	175	12813	0	13823
2403	218	14137	135	428	0	14918
2404	14025	498	128	319	0	14970
2405	14230	300	121	251	0	14902
2406	13363	205	126	222	0	13916
2407	684	163	13838	161	0	14846
2408	463	139	13734	130	0	14466
2409	357	114	13683	163	0	14317
2410	13477	120	663	158	0	14418
2411	538	122	440	13253	0	14353
2412	368	109	271	13495	0	14243
2413	295	104	13151	584	0	14134
2414	223	112	433	13263	0	14031
2415	12679	118	258	614	0	13669
2416	476	12734	208	405	0	13823
2417	13041	382	175	295	0	13893
2418	596	282	12768	205	0	13851
2419	13046	210	436	166	0	13858
2420	13279	161	275	137	0	13852
2421	13390	143	232	134	0	13899
2422	770	126	12783	142	0	13821
2423	560	100	423	12749	0	13832
2424	395	80	12885	461	0	13821
2425	320	74	496	12946	0	13836
2426	232	90	12980	548	0	13850
2427	223	91	555	12905	0	13774
2428	214	85	368	13208	0	13875
2429	12848	96	255	664	0	13863
2430	13038	80	181	445	0	13744
2431	13244	63	185	336	0	13828
2432	782	61	173	12620	0	13636
2433	510	11566	157	471	0	12704
2434	393	12449	143	330	0	13315
2435	12512	470	118	288	0	13388
2436	523	317	12261	232	0	13333
2437	12404	191	433	217	0	13245
2438	580	134	12164	228	0	13106
2439	12517	100	518	158	0	13293
2440	11628	89	311	206	0	12234
2441	714	65	12400	144	0	13323
2442	12642	60	447	182	0	13331
2443	12777	70	315	159	0	13321
2444	12824	76	243	158	0	13301
2445	791	12334	165	165	0	13455
2446	573	523	177	12037	0	13310
2447	362	271	12065	427	0	13125
2448	332	171	12003	289	0	12795
2449	244	11141	517	234	0	12136
2450	163	8822	284	130	0	9399
2451	333	265	261	7661	0	8520
2452	7591	165	126	197	0	8079
2453	238	7604	83	165	0	8090
2454	235	198	71	7454	0	7958
2455	188	7623	44	201	0	8056
2456	7614	206	51	165	0	8036
2457	239	158	49	7476	0	7922
2458	181	127	7275	203	0	7786
2459	129	7016	157	202	0	7504
2460	94	7064	169	116	0	7443
2461	110	232	111	6427	0	6880
2462	90	6863	76	140	0	7169
2463	98	214	61	6723	0	7096
2464	6732	172	47	204	0	7155
2465	6733	121	43	145	0	7042
2466	7024	93	38	115	0	7270
2467	7095	64	46	86	0	7291
2468	350	70	6938	59	0	7417
2469	262	6600	138	54	0	7054
2470	178	6581	114	61	0	6934
2471	84	5589	35	26	0	5734
2472	55	5355	43	22	0	5475
2473	5045	87	102	34	0	5268
2474	4956	17	14	12	0	4999
2475	5060	13	4	11	0	5088
2476	5080	6	3	11	0	5100
2477	59	9	5065	3	0	5136
2478	5268	4	38	17	0	5327
2479	5357	7	16	13	0	5393
2480	5405	6	15	4	0	5430
2481	69	3	3	5372	0	5447
2482	35	3	9	5403	0	5450
2483	5461	4	2	57	0	5524
2484	46	3	2	5403	0	5454
2485	28	5370	3	46	0	5447
2486	23	34	4	5448	0	5509
2487	13	14	1	5449	0	5477
2488	11	5451	10	51	0	5523
2489	9	38	5	5473	0	5525
2490	9	19	3	5498	0	5529
2491	5409	14	4	62	0	5489
2492	41	10	5268	34	0	5353
2493	5226	7	34	25	0	5292
2494	54	8	5297	11	0	5370
2495	29	5	5091	9	0	5134
2496	27	10	5245	6	0	5288
2497	5211	11	70	5	0	5297
2498	46	4	5504	5	0	5559
2499	5392	12	51	10	0	5465
2500	5508	6	17	15	0	5546
2501	5575	4	18	10	0	5607
2502	62	5557	6	5	0	5630
2503	5656	34	7	9	0	5706
2504	55	5701	6	8	0	5770
2505	26	47	1	5774	0	5848
2506	24	15	3	5781	0	5823
2507	17	5717	6	48	0	5788
2508	14	5684	7	28	0	5733
2509	16	5839	6	13	0	5874
2510	5815	50	8	19	0	5892
2511	45	5915	3	14	0	5977
2512	5941	52	5	11	0	6009
2513	63	21	5900	9	0	5993
2514	5878	19	38	12	0	5947
2515	6019	5	17	12	0	6053
2516	59	9	5906	7	0	5981
2517	46	6	38	5898	0	5988
2518	18	11	5955	43	0	6027
2519	15	5	48	5892	0	5960
2520	16	6	20	5980	0	6022
2521	5991	9	13	59	0	6072
2522	5960	7	8	39	0	6014
2523	59	5952	7	28	0	6046
2524	6047	45	4	12	0	6108
2525	58	21	6073	13	0	6165
2526	6019	16	43	23	0	6101
2527	65	6	6306	6	0	6383
2528	34	12	6289	9	0	6344
2529	6440	9	57	11	0	6517
2530	6559	3	33	18	0	6613
2531	64	7	6648	6	0	6725
2532	49	13	45	6417	0	6524
2533	26	10	30	6666	0	6732
2534	26	8	6572	56	0	6662
2535	25	13	42	6441	0	6521
2536	20	6226	27	53	0	6326
2537	12	47	22	6704	0	6785
2538	21	26	6	6677	0	6730
2539	22	18	6479	65	0	6584
2540	6138	13	46	45	0	6242
2541	6403	13	21	34	0	6471
2542	6344	10	21	20	0	6395
2543	6303	5	10	26	0	6344
2544	83	6226	14	16	0	6339
2545	55	41	13	6062	0	6171
2546	43	19	6022	50	0	6134
2547	30	19	5948	26	0	6023
2548	30	11	51	5896	0	5988
2549	20	10	6035	48	0	6113
2550	5888	7	52	46	0	5993
2551	55	3	30	6109	0	6197
2552	25	4	29	6124	0	6182
2553	30	10	9	6082	0	6131
2554	6003	8	11	88	0	6110
2555	57	6002	14	39	0	6112
2556	6027	44	9	44	0	6124
2557	6020	21	6	34	0	6081
2558	61	5879	20	24	0	5984
2559	54	5948	13	16	0	6031
2560	6040	58	30	13	0	6141
2561	60	28	21	6037	0	6146
2562	40	13	17	6004	0	6074
2563	6138	6	17	66	0	6227
2564	54	11	6022	32	0	6119
2565	5978	5	47	26	0	6056
2566	6123	4	25	29	0	6181
2567	82	6245	24	16	0	6367
2568	6456	52	5	23	0	6536
2569	6485	23	13	30	0	6551
2570	75	7021	16	18	0	7130
2571	50	7263	13	16	0	7342
2572	78	78	25	6969	0	7150
2573	7088	34	6	63	0	7191
2574	66	7293	3	25	0	7387
2575	38	70	6	7440	0	7554
2576	7626	31	5	87	0	7749
2577	84	24	7596	29	0	7733
2578	50	9	71	7553	0	7683
2579	33	10	7660	84	0	7787
2580	7440	14	90	51	0	7595
2581	7720	6	38	41	0	7805
2582	113	7	7714	20	0	7854
2583	53	7596	85	16	0	7750
2584	39	81	42	7662	0	7824
2585	22	33	7730	83	0	7868
2586	27	19	85	7695	0	7826
2587	31	13	35	7915	0	7994
2588	16	15	7876	119	0	8026
2589	7637	9	91	71	0	7808
2590	7898	6	36	48	0	7988
2591	120	6	7976	24	0	8126
2592	56	8000	98	22	0	8176
2593	47	94	42	7869	0	8052
2594	33	7883	26	91	0	8033
2595	26	7996	22	34	0	8078
2596	7989	126	19	32	0	8166
2597	105	63	13	7989	0	8170
2598	49	33	15	7908	0	8005
2599	31	18	7912	131	0	8092
2600	29	17	7791	70	0	7907
2601	34	15	123	7764	0	7936
2602	38	16	60	7913	0	8027
2603	32	14	7835	123	0	8004
2604	27	18	7807	73	0	7925
2605	29	16	133	7823	0	8001
2606	7927	19	65	123	0	8134
2607	96	8093	43	65	0	8297
2608	8107	108	25	65	0	8305
2609	130	8147	27	34	0	8338
2610	66	8267	29	33	0	8395
2611	8161	134	27	41	0	8363
2612	132	72	8208	23	0	8435
2613	68	43	110	8167	0	8388
2614	66	30	52	8280	0	8428
2615	40	29	46	8772	0	8887
2616	35	24	8791	180	0	9030
2617	36	21	145	8889	0	9091
2618	9062	19	79	177	0	9337
2619	152	16	45	9371	0	9584
2620	74	20	43	9696	0	9833
2621	9708	28	31	210	0	9977
2622	9713	20	25	117	0	9875
2623	191	9603	42	88	0	9924
2624	97	135	9655	63	0	9950
2625	74	51	9537	59	0	9721
2626	61	40	9633	39	0	9773
2627	48	9332	215	50	0	9645
2628	77	152	98	9065	0	9392
2629	40	63	74	9266	0	9443
2630	9153	49	62	194	0	9458
2631	165	39	42	9083	0	9329
2632	68	25	9066	209	0	9368
2633	62	41	153	9108	0	9364
2634	60	21	63	9197	0	9341
2635	46	28	9050	228	0	9352
2636	50	8950	173	115	0	9288
2637	57	151	69	8419	0	8696
2638	41	8913	81	168	0	9203
2639	28	168	8933	83	0	9212
2640	8834	73	178	77	0	9162
2641	8973	59	81	74	0	9187
2642	9047	41	70	56	0	9214
2643	220	39	52	8872	0	9183
2644	112	8957	59	177	0	9305
2645	8932	164	52	99	0	9247
2646	9117	58	47	95	0	9317
2647	9046	52	42	77	0	9217
2648	239	46	8886	64	0	9235
2649	8666	33	161	81	0	8941
2650	205	8816	75	64	0	9160
2651	8747	153	64	62	0	9026
2652	206	8852	50	55	0	9163
2653	8906	183	47	78	0	9214
2654	212	73	9018	53	0	9356
2655	8978	61	166	69	0	9274
2656	9258	51	71	48	0	9428
2657	7625	42	77	86	0	7830
2658	9243	49	34	60	0	9386
2659	262	25	9042	59	0	9388
2660	145	31	159	8992	0	9327
2661	9009	19	71	192	0	9291
2662	209	8997	72	75	0	9353
2663	114	148	48	8947	0	9257
2664	80	79	8869	180	0	9208
2665	98	92	173	8807	0	9170
2666	76	49	8842	199	0	9166
2667	75	8468	168	116	0	8827
2668	60	8175	81	81	0	8397
2669	75	8284	60	79	0	8498
2670	76	242	71	7476	0	7865
2671	76	52	33	7407	0	7568
2672	50	43	7233	167	0	7493
2673	54	7024	116	67	0	7261
2674	6664	110	58	54	0	6886
2675	117	6437	45	37	0	6636
2676	43	6395	34	34	0	6506
2677	134	119	36	6120	0	6409
2678	6080	39	33	115	0	6267
2679	6144	31	23	42	0	6240
2680	123	23	24	6065	0	6235
2681	6043	26	21	110	0	6200
2682	110	25	28	5998	0	6161
2683	37	21	5962	132	0	6152
2684	5957	17	99	51	0	6124
2685	110	26	40	5977	0	6153
2686	44	29	5843	102	0	6018
2687	35	30	5746	40	0	5851
2688	33	37	93	5772	0	5935
2689	5898	25	49	106	0	6078
2690	5916	22	26	39	0	6003
2691	102	5910	19	35	0	6066
2692	6053	79	19	28	0	6179
2693	6053	35	14	34	0	6136
2694	6095	34	17	27	0	6173
2695	122	6137	18	23	0	6300
2696	6231	75	13	27	0	6346
2697	6285	23	17	27	0	6352
2698	120	22	22	6214	0	6378
2699	6090	15	15	76	0	6196
2700	97	6030	14	35	0	6176
2701	55	6133	17	24	0	6229
2702	55	76	13	6097	0	6241
2703	37	33	18	6114	0	6202
2704	42	6139	18	72	0	6271
2705	6088	73	13	30	0	6204
2706	88	5966	12	25	0	6091
2707	5803	75	14	21	0	5913
2708	93	5877	11	18	0	5999
2709	41	70	18	5726	0	5855
2710	40	6004	6	59	0	6109
2711	6010	78	56	21	0	6165
2712	5923	40	24	38	0	6025
2713	5892	31	31	34	0	5988
2714	84	16	5783	21	0	5904
2715	45	21	5373	16	0	5455
2716	28	5304	48	20	0	5400
2717	28	41	5161	10	0	5240
2718	22	27	4920	15	0	4984
2719	24	81	34	4403	0	4542
2720	12	6	4530	13	0	4561
2721	5	4509	17	5	0	4536
2722	4480	16	6	12	0	4514
2723	14	4427	6	4	0	4451
2724	5	4479	4	4	0	4492
2725	4514	15	5	9	0	4543
2726	4523	7	4	3	0	4537
2727	18	4599	5	2	0	4624
2728	4644	17	3	6	0	4670
2729	4617	4	3	3	0	4627
2730	4626	6	1	4	0	4637
2731	23	6	4510	3	0	4542
2732	14	4	4421	0	0	4439
2733	10	2	16	4586	0	4614
2734	11	4	7	4521	0	4543
2735	4689	1	3	20	0	4713
2736	15	4600	5	6	0	4626
2737	11	17	2	4701	0	4731
2738	11	5	3	4737	0	4756
2739	7	7	4	4776	0	4794
2740	10	4	1	4780	0	4795
2741	4	3	4805	28	0	4840
2742	6	5	4724	14	0	4749
2743	2	6	22	4923	0	4953
2744	6	0	5007	18	0	5031
2745	4885	3	26	18	0	4932
2746	21	2	11	5066	0	5100
2747	13	3	5068	22	0	5106
2748	4782	2	19	20	0	4823
2749	24	5031	14	7	0	5076
2750	5017	16	6	12	0	5051
2751	24	5146	9	3	0	5182
2752	21	23	3	5045	0	5092
2753	12	19	5077	21	0	5129
2754	10	8	20	4870	0	4908
2755	7	10	4846	20	0	4883
2756	4763	4	21	20	0	4808
2757	23	2	15	4907	0	4947
2758	4946	4	11	29	0	4990
2759	25	3	4906	17	0	4951
2760	5026	3	22	14	0	5065
2761	5314	2	17	11	0	5344
2762	48	4	5364	4	0	5420
2763	27	7	30	5342	0	5406
2764	17	1	5416	26	0	5460
2765	12	5395	31	17	0	5455
2766	5384	30	23	21	0	5458
2767	5374	14	14	8	0	5410
2768	45	10	5432	7	0	5494
2769	24	5	5364	8	0	5401
2770	14	6	44	5358	0	5422
2771	13	3	26	5440	0	5482
2772	5455	5	11	45	0	5516
2773	34	5493	11	20	0	5558
2774	5565	22	9	20	0	5616
2775	5546	14	8	18	0	5586
2776	46	9	5431	6	0	5492
2777	5305	7	27	16	0	5355
2778	40	9	5490	7	0	5546
2779	38	4	34	5491	0	5567
2780	17	8	5694	23	0	5742
2781	19	5	34	5662	0	5720
2782	14	2	5707	30	0	5753
2783	5557	2	41	24	0	5624
2784	5659	2	22	17	0	5700
2785	42	2	15	5635	0	5694
2786	5763	3	9	43	0	5818
2787	41	1	11	5795	0	5848
2788	24	5845	12	37	0	5918
2789	5806	27	6	36	0	5875
2790	44	5797	12	15	0	5868
2791	32	38	5	5787	0	5862
2792	24	17	8	5655	0	5704
2793	22	7	6	5625	0	5660
2794	16	6	10	5565	0	5597
2795	9	6	5407	54	0	5476
2796	4939	5	30	45	0	5019
2797	5300	6	16	31	0	5353
2798	40	5347	11	19	0	5417
2799	27	28	6	5379	0	5440
2800	20	12	7	5379	0	5418
2801	19	8	5246	47	0	5320
2802	5107	6	32	30	0	5175
2803	40	6	17	5246	0	5309
2804	22	5	5204	34	0	5265
2805	5162	6	24	37	0	5229
2806	5265	3	22	27	0	5317
2807	5270	4	13	21	0	5308
2808	43	2	5141	15	0	5201
2809	30	4	4898	10	0	4942
2810	4946	5	46	13	0	5010
2811	36	9	23	4996	0	5064
2812	28	3	15	5080	0	5126
2813	20	7	5082	39	0	5148
2814	4950	9	28	26	0	5013
2815	34	3	21	5134	0	5192
2816	5298	5	11	37	0	5351
2817	5319	2	12	37	0	5370
2818	5335	2	11	23	0	5371
2819	48	5	5502	19	0	5574
2820	30	3	35	5527	0	5595
2821	5591	1	15	49	0	5656
2822	51	5775	7	18	0	5851
2823	38	39	7	5856	0	5940
2824	24	17	7	5886	0	5934
2825	5796	4	12	68	0	5880
2826	5766	4	5	27	0	5802
2827	65	4	11	5700	0	5780
2828	28	5	5684	61	0	5778
2829	5586	3	48	32	0	5669
2830	60	5	5861	17	0	5943
2831	5870	0	50	19	0	5939
2832	6019	1	20	26	0	6066
2833	78	3	5973	5	0	6059
2834	37	7	53	6108	0	6205
2835	24	3	6355	60	0	6442
2836	18	6773	63	24	0	6878
2837	24	69	21	6619	0	6733
2838	13	6832	12	175	0	7032
2839	12	68	8	7069	0	7157
2840	17	24	7293	77	0	7411
2841	8	7364	79	33	0	7484
2842	11	7656	26	17	0	7710
2843	27	123	26	7645	0	7821
2844	7665	37	16	106	0	7824
2845	90	15	9	8361	0	8475
2846	8573	14	3	119	0	8709
2847	117	8795	11	37	0	8960
2848	9710	116	7	31	0	9864
2849	148	40	10086	19	0	10293
2850	71	20	125	10015	0	10231
2851	42	8	42	10054	0	10146
2852	24	9	9973	172	0	10178
2853	9685	13	144	82	0	9924
2854	9958	8	41	57	0	10064
2855	174	9954	23	28	0	10179
2856	101	153	15	9383	0	9652
2857	54	9890	21	134	0	10099
2858	40	144	9807	47	0	10038
2859	28	57	9891	38	0	10014
2860	46	103	178	9597	0	9924
2861	9500	20	74	148	0	9742
2862	141	9366	35	68	0	9610
2863	9417	133	18	44	0	9612
2864	157	51	9281	25	0	9514
2865	9367	34	129	28	0	9558
2866	9572	22	48	50	0	9692
2867	183	21	9487	19	0	9710
2868	91	8	149	9379	0	9627
2869	9467	16	57	152	0	9692
2870	9506	19	33	65	0	9623
2871	9555	18	27	39	0	9639
2872	211	16	29	9385	0	9641
2873	95	12	9309	138	0	9554
2874	9240	17	144	72	0	9473
2875	177	13	9418	37	0	9645
2876	89	20	156	9295	0	9560
2877	69	18	68	9329	0	9484
2878	58	9384	38	181	0	9661
2879	52	146	9296	62	0	9556
2880	49	9003	149	58	0	9259
2881	50	9241	66	55	0	9412
2882	49	166	51	9196	0	9462
2883	48	63	9178	159	0	9448
2884	59	46	149	9157	0	9411
2885	49	28	9164	176	0	9417
2886	56	36	156	9046	0	9294
2887	41	29	76	9109	0	9255
2888	41	35	8812	200	0	9088
2889	47	38	167	8798	0	9050
2890	47	32	8847	187	0	9113
2891	35	24	8814	100	0	8973
2892	40	8772	195	86	0	9093
2893	8835	154	94	60	0	9143
2894	174	73	8815	51	0	9113
2895	8698	48	171	62	0	8979
2896	190	45	87	8880	0	9202
2897	90	42	8807	189	0	9128
2898	76	8758	190	99	0	9123
2899	54	150	111	8768	0	9083
2900	44	71	8794	190	0	9099
2901	73	49	170	8439	0	8731
2902	74	8746	92	154	0	9066
2903	8819	160	74	78	0	9131
2904	198	77	57	8816	0	9148
2905	8720	66	56	191	0	9033
2906	8833	46	54	102	0	9035
2907	8833	37	74	83	0	9027
2908	8912	27	64	101	0	9104
2909	8841	32	57	83	0	9013
2910	246	8569	49	80	0	8944
2911	157	155	52	8580	0	8944
2912	112	75	54	8648	0	8889
2913	99	55	42	8646	0	8842
2914	82	41	8356	251	0	8730
2915	86	8338	183	126	0	8733
2916	8489	164	88	92	0	8833
2917	8557	63	76	80	0	8776
2918	240	8321	53	92	0	8706
2919	133	8396	55	83	0	8667
2920	8262	210	63	84	0	8619
2921	213	95	8068	71	0	8447
2922	101	95	179	7871	0	8246
2923	7858	58	126	189	0	8231
2924	202	49	71	7690	0	8012
2925	94	7730	74	192	0	8090
2926	83	158	67	7818	0	8126
2927	84	81	7795	198	0	8158
2928	7673	68	169	119	0	8029
2929	7924	46	99	66	0	8135
2930	242	52	63	7617	0	7974
2931	136	32	68	7695	0	7931
2932	7438	33	61	214	0	7746
2933	200	7342	52	125	0	7719
2934	119	148	54	7229	0	7550
2935	102	68	51	7190	0	7411
2936	6560	31	43	217	0	6851
2937	172	6509	44	118	0	6843
2938	6368	115	44	75	0	6602
2939	187	6225	28	63	0	6503
2940	99	6201	27	61	0	6388
2941	5946	141	51	48	0	6186
2942	136	5958	26	42	0	6162
2943	92	232	69	5649	0	6042
2944	67	50	5640	137	0	5894
2945	61	29	4893	61	0	5044
2946	14	44	4641	44	0	4743
2947	28	4426	142	27	0	4623
2948	3460	75	136	25	0	3696
2949	57	28	22	3217	0	3324
2950	20	17	7	3258	0	3302
2951	18	8	3208	63	0	3297
2952	3201	10	51	33	0	3295
2953	50	5	22	3292	0	3369
2954	21	6	16	3312	0	3355
2955	27	3	8	3282	0	3320
2956	3202	3	8	87	0	3300
2957	51	8	3149	46	0	3254
2958	3151	8	50	27	0	3236
2959	72	8	15	3180	0	3275
2960	29	8	3144	60	0	3241
2961	3108	6	52	38	0	3204
2962	63	4	3171	31	0	3269
2963	38	13	59	3137	0	3247
2964	20	7	3189	56	0	3272
2965	22	3	3044	27	0	3096
2966	2906	7	69	30	0	3012
2967	55	4	2950	16	0	3025
2968	32	5	65	2905	0	3007
2969	2927	3	32	56	0	3018
2970	52	6	31	2949	0	3038
2971	32	6	2909	65	0	3012
2972	24	3	2949	30	0	3006
2973	18	2938	67	31	0	3054
2974	21	46	39	2895	0	3001
2975	2809	19	30	58	0	2916
2976	62	2793	15	30	0	2900
2977	2813	48	20	30	0	2911
2978	61	17	22	2782	0	2882
2979	2777	16	18	56	0	2867
2980	67	2736	14	28	0	2845
2981	33	47	13	2748	0	2841
2982	2748	16	12	66	0	2842
2983	58	2766	11	36	0	2871
2984	29	55	16	2765	0	2865
2985	35	18	12	2785	0	2850
2986	2803	23	8	70	0	2904
2987	57	17	7	2811	0	2892
2988	31	8	10	2819	0	2868
2989	35	10	11	2852	0	2908
2990	19	13	2717	79	0	2828
2991	2688	6	56	56	0	2806
2992	59	5	24	3083	0	3171
2993	27	14	3263	79	0	3383
2994	3290	9	76	43	0	3418
2995	88	6	3399	37	0	3530
2996	40	8	87	3328	0	3463
2997	29	3471	39	92	0	3631
2998	31	72	28	3550	0	3681
2999	21	26	3574	107	0	3728
3000	11	22	3677	49	0	3759
3001	29	17	100	3685	0	3831
3002	18	12	3668	107	0	3805
3003	3576	8	106	48	0	3738
3004	93	13	3659	34	0	3799
3005	38	10	103	3575	0	3726
3006	32	6	52	3645	0	3735
3007	26	12	34	3635	0	3707
3008	3540	8	27	133	0	3708
3009	3585	9	24	75	0	3693
3010	3684	8	20	47	0	3759
3011	122	8	23	3609	0	3762
3012	62	9	21	3657	0	3749
3013	44	5	3542	113	0	3704
3014	30	4	3564	67	0	3665
3015	27	3537	89	51	0	3704
3016	30	84	36	3204	0	3354
3017	25	20	27	3122	0	3194
3018	20	3138	20	84	0	3262
3019	3147	60	18	46	0	3271
3020	70	3143	16	34	0	3263
3021	3120	67	22	31	0	3240
3022	73	31	10	3110	0	3224
3023	3146	17	14	75	0	3252
3024	75	17	15	3162	0	3269
3025	33	15	3102	80	0	3230
3026	37	14	62	3140	0	3253
3027	3127	12	22	81	0	3242
3028	72	10	21	3148	0	3251
3029	32	6	16	3175	0	3229
3030	23	13	3149	99	0	3284
3031	30	9	62	3183	0	3284
3032	19	3	28	3161	0	3211
3033	16	3083	18	100	0	3217
3034	20	57	12	3179	0	3268
3035	16	9	12	3232	0	3269
3036	25	10	10	3199	0	3244
3037	19	3071	12	102	0	3204
3038	19	57	12	3038	0	3126
3039	2912	14	7	102	0	3035
3040	57	2821	12	47	0	2937
3041	19	2670	7	34	0	2730
3042	14	2672	9	30	0	2725
3043	13	94	12	2486	0	2605
3044	5	2482	15	66	0	2568
3045	10	2570	19	29	0	2628
3046	2495	56	15	26	0	2592
3047	57	20	2461	20	0	2558
3048	2426	17	48	18	0	2509
3049	54	23	23	2488	0	2588
3050	20	12	2483	64	0	2579
3051	2429	12	66	36	0	2543
3052	49	14	2455	28	0	2546
3053	17	9	2461	33	0	2520
3054	2521	2	91	22	0	2636
3055	71	4	44	2574	0	2693
3056	24	2	2606	68	0	2700
3057	2589	0	73	48	0	2710
3058	2672	3	30	34	0	2739
3059	73	2	2692	35	0	2802
3060	2766	5	57	36	0	2864
3061	2843	1	18	36	0	2898
3062	91	5	2720	36	0	2852
3063	2759	5	55	42	0	2861
3064	2842	2	21	35	0	2900
3065	86	8	2661	22	0	2777
3066	32	11	2945	28	0	3016
3067	28	16	69	2988	0	3101
3068	21	12	3000	80	0	3113
3069	2978	14	73	38	0	3103
3070	60	28	33	2977	0	3098
3071	38	19	8	3051	0	3116
3072	34	28	2927	76	0	3065
3073	34	21	53	2936	0	3044
3074	28	16	2939	88	0	3071
3075	2981	12	63	38	0	3094
3076	3041	9	27	47	0	3124
3077	76	10	2993	47	0	3126
3078	2998	3	66	45	0	3112
3079	3095	4	26	41	0	3166
3080	81	7	3028	45	0	3161
3081	3100	4	67	49	0	3220
3082	3125	7	26	36	0	3194
3083	73	5	3078	49	0	3205
3084	3048	9	67	45	0	3169
3085	76	18	3113	38	0	3245
3086	31	12	55	3116	0	3214
3087	18	10	27	3167	0	3222
3088	22	19	11	3216	0	3268
3089	15	20	3119	95	0	3249
3090	2968	14	51	66	0	3099
3091	77	12	3053	44	0	3186
3092	24	2657	37	27	0	2745
3093	13	2599	13	12	0	2637
3094	2477	31	27	12	0	2547
3095	27	11	10	2402	0	2450
3096	14	2427	3	20	0	2464
3097	2315	20	1	3	0	2339
3098	2293	3	5	5	0	2306
3099	24	2334	5	6	0	2369
3100	14	20	3	2208	0	2245
3101	8	2259	6	15	0	2288
3102	2293	21	1	9	0	2324
3103	2311	6	0	8	0	2325
3104	23	2	4	2247	0	2276
3105	2255	2	4	22	0	2283
3106	27	1	2	2267	0	2297
3107	8	1	2271	21	0	2301
3108	2223	1	19	11	0	2254
3109	24	1	2272	5	0	2302
3110	8	2	24	2243	0	2277
3111	2307	1	10	23	0	2341
3112	27	1	6	2319	0	2353
3113	8	1	2316	25	0	2350
3114	9	3	2268	8	0	2288
3115	7	19	30	2289	0	2345
3116	2279	1	13	28	0	2321
3117	25	2370	8	7	0	2410
3118	7	21	4	2414	0	2446
3119	6	4	2449	25	0	2484
3120	2419	3	24	10	0	2456
3121	2545	3	8	6	0	2562
3122	29	1	2509	6	0	2545
3123	2502	1	23	1	0	2527
3124	30	5	7	2580	0	2622
3125	8	2	2577	22	0	2609
3126	2551	2	22	7	0	2582
3127	27	2	4	2547	0	2580
3128	7	0	5	2535	0	2547
3129	2576	2	6	22	0	2606
3130	23	2517	3	9	0	2552
3131	7	2566	1	7	0	2581
3132	2580	22	2	4	0	2608
3133	2550	6	0	6	0	2562
3134	21	3	2640	4	0	2668
3135	11	5	2586	0	0	2602
3136	8	1	18	2650	0	2677
3137	2683	0	6	22	0	2711
3138	2647	1	3	6	0	2657
3139	2696	3	1	5	0	2705
3140	23	2633	3	7	0	2666
3141	9	2704	3	4	0	2720
3142	8	22	2	2782	0	2814
3143	6	5	2	2725	0	2738
3144	8	3	2	2844	0	2857
3145	6	3	2902	23	0	2934
3146	3	3	2653	8	0	2667
3147	2861	1	26	4	0	2892
3148	2985	0	7	4	0	2996
3149	26	1	2	2935	0	2964
3150	11	2	3	2942	0	2958
3151	7	1	2	2998	0	3008
3152	3	2	2941	30	0	2976
3153	7	4	2864	11	0	2886
3154	6	5	22	2934	0	2967
3155	4	1	2982	22	0	3009
3156	2	2894	23	8	0	2927
3157	1	2996	11	1	0	3009
3158	2980	21	4	12	0	3017
3159	18	2918	3	4	0	2943
3160	7	18	2	2945	0	2972
3161	4	9	1	2946	0	2960
3162	4	3062	2	21	0	3089
3163	7	21	1	3105	0	3134
3164	2	7	3074	26	0	3109
3165	1	3052	20	13	0	3086
3166	8	19	6	2922	0	2955
3167	0	7	2911	18	0	2936
3168	3	2855	21	6	0	2885
3169	6	21	9	2815	0	2851
3170	2	2865	1	17	0	2885
3171	6	19	1	2871	0	2897
3172	4	8	2	2839	0	2853
3173	1	2853	1	23	0	2878
3174	2809	17	3	9	0	2838
3175	2763	5	5	5	0	2778
3176	23	2758	1	3	0	2785
3177	4	2839	4	5	0	2852
3178	5	22	1	2856	0	2884
3179	7	9	2830	19	0	2865
3180	2733	3	20	6	0	2762
3181	2804	3	8	5	0	2820
3182	22	6	2776	4	0	2808
3183	2744	1	18	8	0	2771
3184	2815	3	6	4	0	2828
3185	23	4	2794	5	0	2826
3186	2686	2	20	8	0	2716
3187	25	3	2876	0	0	2904
3188	11	2914	21	4	0	2950
3189	2956	18	9	4	0	2987
3190	2954	7	4	5	0	2970
3191	24	3	2984	4	0	3015
3192	2983	2	19	6	0	3010
3193	3125	3	4	14	0	3146
3194	27	1	3089	2	0	3119
3195	3159	4	14	2	0	3179
3196	3200	2	8	1	0	3211
3197	31	0	3156	2	0	3189
3198	3194	4	19	4	0	3221
3199	22	2	7	3114	0	3145
3200	10	2	5	3119	0	3136
3201	3	4	3097	26	0	3130
3202	7	2	3026	9	0	3044
3203	10	2	23	3117	0	3152
3204	4	6	9	3173	0	3192
3205	3250	1	5	30	0	3286
3206	29	3	3210	7	0	3249
3207	3245	4	20	4	0	3273
3208	27	3	8	3394	0	3432
3209	8	8	3438	24	0	3478
3210	3612	4	22	12	0	3650
3211	27	0	8	3774	0	3809
3212	9	2	3779	25	0	3815
3213	3721	5	29	17	0	3772
3214	30	2	7	3826	0	3865
3215	3876	2	7	26	0	3911
3216	29	3	4052	7	0	4091
3217	15	3	23	3845	0	3886
3218	6	4066	10	24	0	4106
3219	4071	24	4	8	0	4107
3220	4036	9	6	14	0	4065
3221	31	4142	4	4	0	4181
3222	4197	28	0	10	0	4235
3223	4194	8	5	7	0	4214
3224	4147	4	6	7	0	4164
3225	45	4126	1	5	0	4177
3226	21	27	5	4156	0	4209
3227	14	8	4186	26	0	4234
3228	13	7	26	4134	0	4180
3229	12	4	10	4144	0	4170
3230	5	5	4142	36	0	4188
3231	7	5	4047	17	0	4076
3232	13	6	33	3958	0	4010
3233	6	4165	18	25	0	4214
3234	4142	27	13	13	0	4195
3235	4090	11	5	10	0	4116
3236	39	4256	6	12	0	4313
3237	4310	27	3	9	0	4349
3238	4283	11	3	9	0	4306
3239	34	9	4338	7	0	4388
3240	4187	8	29	9	0	4233
3241	43	4388	11	9	0	4451
3242	12	33	4351	6	0	4402
3243	18	10	4201	8	0	4237
3244	14	4308	37	7	0	4366
3245	4289	24	18	7	0	4338
3246	34	6	4374	11	0	4425
3247	15	8	30	4368	0	4421
3248	14	4	4357	27	0	4402
3249	4163	7	37	15	0	4222
3250	36	8	4834	10	0	4888
3251	15	9	4753	7	0	4784
3252	4760	2	30	10	0	4802
3253	31	4956	20	6	0	5013
3254	5058	24	9	18	0	5109
3255	5158	11	8	12	0	5189
3256	36	8	9	5101	0	5154
3257	21	5452	8	22	0	5503
3258	5522	31	6	29	0	5588
3259	34	10	5515	5	0	5564
3260	5389	6	26	11	0	5432
3261	32	5588	12	9	0	5641
3262	5490	23	5	11	0	5529
3263	5470	6	5	15	0	5496
3264	25	5603	10	3	0	5641
3265	16	16	6	5665	0	5703
3266	5759	8	12	29	0	5808
3267	29	5746	6	9	0	5790
3268	12	23	10	5809	0	5854
3269	5930	5	7	28	0	5970
3270	27	11	8	6116	0	6162
3271	21	5	4	6101	0	6131
3272	18	6145	7	31	0	6201
3273	6156	30	10	20	0	6216
3274	6206	11	7	15	0	6239
3275	6317	15	1	16	0	6349
3276	46	6467	8	6	0	6527
3277	6510	29	9	13	0	6561
3278	6536	17	0	11	0	6564
3279	44	9	6	6484	0	6543
3280	30	3	5	6523	0	6561
3281	14	11	6522	36	0	6583
3282	15	7	32	6421	0	6475
3283	31	6	11	6226	0	6274
3284	13	10	6503	39	0	6565
3285	5907	6	34	33	0	5980
3286	37	7	6494	12	0	6550
3287	19	8	6541	6	0	6574
3288	18	7	35	6532	0	6592
3289	16	4	13	6558	0	6591
3290	7	6660	18	32	0	6717
3291	6611	29	4	22	0	6666
3292	6538	12	5	17	0	6572
3293	41	6553	5	13	0	6612
3294	23	6818	3	12	0	6856
3295	24	42	7	6854	0	6927
3296	11	7077	8	34	0	7130
3297	7091	40	1	24	0	7156
3298	7064	20	8	16	0	7108
3299	55	7	7	7042	0	7111
3300	36	5	6	7111	0	7158
3301	7107	13	6	64	0	7190
3302	48	5	6951	27	0	7031
3303	6868	7	41	23	0	6939
3304	55	14	6920	11	0	7000
3305	6896	6	42	23	0	6967
3306	64	10	16	6961	0	7051
3307	26	8	7061	33	0	7128
3308	18	4	6819	22	0	6863
3309	6760	22	64	30	0	6876
3310	6838	9	25	17	0	6889
3311	48	6963	15	9	0	7035
3312	31	29	9	7182	0	7251
3313	18	16	9	7362	0	7405
3314	7329	5	3	63	0	7400
3315	47	7265	4	27	0	7343
3316	7120	40	4	21	0	7185
3317	44	7029	12	4	0	7089
3318	21	7041	6	6	0	7074
3319	7040	44	2	12	0	7098
3320	48	24	6963	8	0	7043
3321	24	13	39	6916	0	6992
3322	25	8	12	6929	0	6974
3323	7	11	6953	54	0	7025
3324	18	5	40	6870	0	6933
3325	42	9	14	6120	0	6185
3326	3	6921	6	51	0	6981
3327	6964	43	2	38	0	7047
3328	50	22	7017	11	0	7100
3329	6723	11	40	18	0	6792
3330	51	7047	13	16	0	7127
3331	26	40	15	7107	0	7188
3332	7306	20	8	62	0	7396
3333	55	10	5	7314	0	7384
3334	24	10	6	7342	0	7382
3335	21	10	7339	58	0	7428
3336	6913	6	46	45	0	7010
3337	7189	6	26	29	0	7250
3338	64	10	7252	13	0	7339
3339	30	5	43	7233	0	7311
3340	23	5	7276	40	0	7344
3341	7085	7	47	36	0	7175
3342	7381	4	21	26	0	7432
3343	58	8	12	7349	0	7427
3344	7359	4	8	58	0	7429
3345	53	10	7687	27	0	7777
3346	40	4	42	7592	0	7678
3347	32	10	19	7566	0	7627
3348	21	7	16	7788	0	7832
3349	20	4	10	7771	0	7805
3350	7213	6	9	81	0	7309
3351	57	11	7102	35	0	7205
3352	31	4	49	7186	0	7270
3353	25	2	7089	54	0	7170
3354	21	4	6864	35	0	6924
3355	19	2	61	6896	0	6978
3356	15	6	28	6991	0	7040
3357	6659	1	22	71	0	6753
3358	54	4	10	6677	0	6745
3359	33	7	14	6694	0	6748
3360	21	4	9	6793	0	6827
3361	6743	2	8	83	0	6836
3362	6723	6	16	45	0	6790
3363	6779	0	6	45	0	6830
3364	6650	3	10	26	0	6689
3365	77	6976	13	23	0	7089
3366	45	54	8	6959	0	7066
3367	29	25	10	7041	0	7105
3368	7190	16	11	95	0	7312
3369	79	7419	7	55	0	7560
3370	37	68	11	7855	0	7971
3371	25	20	8526	104	0	8675
3372	9112	13	108	56	0	9289
3373	158	9733	28	43	0	9962
3374	10263	149	28	37	0	10477
3375	10672	47	16	27	0	10762
3376	274	27	8	10591	0	10900
3377	86	21	10663	208	0	10978
3378	81	9	186	10920	0	11196
3379	11042	10	50	254	0	11356
3380	233	9	33	11055	0	11330
3381	11077	12	19	244	0	11352
3382	242	10986	11	87	0	11326
3383	11431	200	19	66	0	11716
3384	275	50	15	11485	0	11825
3385	119	38	13	12168	0	12338
3386	12233	31	19	284	0	12567
3387	12262	12	9	128	0	12411
3388	12294	12	10	84	0	12400
3389	12286	13	14	68	0	12381
3390	12272	19	13	58	0	12362
3391	349	12	23	11986	0	12370
3392	147	19	11650	239	0	12055
3393	93	11764	174	107	0	12138
3394	11557	208	49	82	0	11896
3395	278	61	11264	53	0	11656
3396	11201	47	209	63	0	11520
3397	278	11268	54	59	0	11659
3398	11461	198	50	64	0	11773
3399	309	67	26	11397	0	11799
3400	161	30	18	11598	0	11807
3401	115	27	11520	273	0	11935
3402	129	25	205	11465	0	11824
3403	86	19	11720	270	0	12095
3404	100	17	11695	116	0	11928
3405	11674	26	261	113	0	12074
3406	12189	24	83	109	0	12405
3407	326	18	11869	70	0	12283
3408	11777	35	216	96	0	12124
3409	12100	18	74	72	0	12264
3410	341	31	11673	66	0	12111
3411	182	11688	212	69	0	12151
3412	184	240	70	11970	0	12464
3413	12165	55	60	267	0	12547
3414	12410	49	39	118	0	12616
3415	12444	27	36	101	0	12608
3416	12458	23	50	69	0	12600
3417	12432	21	41	72	0	12566
3418	379	28	12014	52	0	12473
3419	205	31	12226	53	0	12515
3420	192	56	248	12233	0	12729
3421	12390	51	103	265	0	12809
3422	12619	44	68	112	0	12843
3423	12625	44	49	107	0	12825
3424	12051	35	66	124	0	12276
3425	354	12090	64	111	0	12619
3426	209	12762	65	120	0	13156
3427	12780	230	79	126	0	13215
3428	12924	77	44	141	0	13186
3429	399	12711	50	110	0	13270
3430	12838	228	66	122	0	13254
3431	401	89	12681	78	0	13249
3432	230	74	232	12596	0	13132
3433	191	43	12660	286	0	13180
3434	207	41	12564	128	0	12940
3435	220	44	264	12615	0	13143
3436	240	32	110	12896	0	13278
3437	246	35	12868	281	0	13430
3438	235	39	226	12590	0	13090
3439	213	45	91	12958	0	13307
3440	12898	33	93	328	0	13352
3441	12982	60	82	165	0	13289
3442	410	61	77	12829	0	13377
3443	240	54	12738	260	0	13292
3444	221	12777	257	127	0	13382
3445	12670	230	115	120	0	13135
3446	375	95	12797	77	0	13344
3447	220	12296	260	88	0	12864
3448	179	12980	115	124	0	13398
3449	13035	233	116	130	0	13514
3450	13281	92	96	127	0	13596
3451	377	58	100	13087	0	13622
3452	196	57	13570	287	0	14110
3453	217	37	281	13522	0	14057
3454	208	32	134	13711	0	14085
3455	191	35	117	13860	0	14203
3456	13721	35	106	322	0	14184
3457	369	13297	100	127	0	13893
3458	230	13906	86	105	0	14327
3459	182	259	97	13665	0	14203
3460	160	106	93	14016	0	14375
3461	13836	85	69	355	0	14345
3462	13795	47	64	174	0	14080
3463	13864	41	74	115	0	14094
3464	432	13585	66	107	0	14190
3465	13417	189	54	113	0	13773
3466	400	128	81	13169	0	13778
3467	223	56	13083	253	0	13615
3468	202	38	12329	135	0	12704
3469	12244	39	280	125	0	12688
3470	287	37	11977	88	0	12389
3471	174	28	11125	52	0	11379
3472	9928	16	159	52	0	10155
3473	151	18	9890	21	0	10080
3474	55	24	9463	15	0	9557
3475	59	99	105	8974	0	9237
3476	31	9	9275	45	0	9360
3477	25	9	39	8961	0	9034
3478	26	6	16	8775	0	8823
3479	12	5	9136	44	0	9197
3480	20	9197	35	23	0	9275
3481	9142	30	23	37	0	9232
3482	47	10	9327	9	0	9393
3483	21	10	9072	5	0	9108
3484	8089	13	40	30	0	8172
3485	44	4	8585	7	0	8640
3486	14	8292	34	10	0	8350
3487	11	7322	23	15	0	7371
3488	10	28	4	8545	0	8587
3489	23	7	4	8443	0	8477
3490	8782	5	3	72	0	8862
3491	8724	4	2	41	0	8771
3492	8797	4	1	23	0	8825
3493	49	4	5	8770	0	8828
3494	8788	4	4	65	0	8861
3495	8728	1	5	38	0	8772
3496	52	4	8810	6	0	8872
3497	18	7	8551	14	0	8590
3498	14	8854	43	7	0	8918
3499	13	31	17	8938	0	8999
3500	8932	10	6	52	0	9000
3501	36	8795	8	17	0	8856
3502	15	35	8	8948	0	9006
3503	8834	10	5	62	0	8911
3504	8722	5	3	29	0	8759
3505	46	8788	13	13	0	8860
3506	8743	32	2	34	0	8811
3507	8761	11	3	25	0	8800
3508	52	5	6	8722	0	8785
3509	21	5	8764	34	0	8824
3510	11	8553	36	17	0	8617
3511	7	8553	17	18	0	8595
3512	8196	39	12	22	0	8269
3513	43	20	14	8190	0	8267
3514	12	11	8193	48	0	8264
3515	10	8230	31	15	0	8286
3516	8269	30	12	30	0	8341
3517	8277	9	6	26	0	8318
3518	46	7	8354	7	0	8414
3519	28	4	38	8155	0	8225
3520	18	3	11	8570	0	8602
3521	11	6	9126	44	0	9187
3522	9188	3	59	44	0	9294
3523	11061	3	12	25	0	11101
3524	174	4	11	12800	0	12989
3525	41	13575	15	199	0	13830
3526	66	203	6	14533	0	14808
3527	35	121	14559	272	0	14987
3528	14524	52	234	173	0	14983
3529	287	55	120	14967	0	15429
3530	150	59	14828	315	0	15352
3531	14572	38	281	244	0	15135
3532	324	32	183	14819	0	15358
3533	228	25	103	14892	0	15248
3534	14686	11	81	471	0	15249
3535	335	14736	97	248	0	15416
3536	14848	248	55	182	0	15333
3537	394	131	46	14725	0	15296
3538	14740	66	37	402	0	15245
3539	423	62	14525	222	0	15232
3540	251	14527	253	168	0	15199
3541	211	293	144	14805	0	15453
3542	14839	162	77	385	0	15463
3543	377	14816	70	207	0	15470
3544	268	307	88	14908	0	15571
3545	15058	205	60	375	0	15698
3546	14836	103	66	266	0	15271
3547	535	93	49	14514	0	15191
3548	291	108	14364	404	0	15167
3549	201	83	14475	278	0	15037
3550	14504	63	399	199	0	15165
3551	428	14241	204	173	0	15046
3552	279	14256	120	157	0	14812
3553	13968	396	149	154	0	14667
3554	398	14319	136	104	0	14957
3555	316	365	109	14197	0	14987
3556	225	249	81	14517	0	15072
3557	14369	201	74	482	0	15126
3558	14302	175	40	283	0	14800
3559	14338	161	40	215	0	14754
3560	569	117	13806	193	0	14685
3561	388	80	280	13973	0	14721
3562	308	75	13959	408	0	14750
3563	269	67	13821	273	0	14430
3564	263	54	14231	186	0	14734
3565	233	47	533	13944	0	14757
3566	174	61	14257	430	0	14922
3567	144	94	14471	260	0	14969
3568	129	91	605	14246	0	15071
3569	14272	58	392	445	0	15167
3570	415	72	14391	306	0	15184
3571	271	50	507	14265	0	15093
3572	203	64	345	14647	0	15259
3573	207	54	14487	594	0	15342
3574	217	58	427	14489	0	15191
3575	189	63	14539	537	0	15328
3576	187	66	451	14303	0	15007
3577	193	75	287	14444	0	14999
3578	157	64	240	14528	0	14989
3579	141	52	181	14509	0	14883
3580	13767	45	210	711	0	14733
3581	13939	49	186	473	0	14647
3582	494	66	13627	358	0	14545
3583	312	13475	388	352	0	14527
3584	228	298	13847	299	0	14672
3585	256	183	13823	227	0	14489
3586	13591	91	545	225	0	14452
3587	463	13875	386	181	0	14905
3588	13969	354	271	189	0	14783
3589	467	14137	269	186	0	15059
3590	14106	401	285	145	0	14937
3591	14394	237	245	135	0	15011
3592	641	166	170	13991	0	14968
3593	387	14139	153	417	0	15096
3594	292	441	116	14286	0	15135
3595	279	252	116	14524	0	15171
3596	268	141	14047	621	0	15077
3597	196	14133	394	427	0	15150
3598	198	391	243	14281	0	15113
3599	14045	210	190	574	0	15019
3600	14553	128	169	412	0	15262
3601	14676	116	192	304	0	15288
3602	606	14276	184	264	0	15330
3603	14664	409	162	258	0	15493
3604	582	15188	137	211	0	16118
3605	417	447	151	15602	0	16617
3606	317	251	15550	479	0	16597
3607	280	185	433	15574	0	16472
3608	261	15622	273	514	0	16670
3609	217	467	188	15742	0	16614
3610	181	262	154	15949	0	16546
3611	153	15708	154	709	0	16724
3612	15744	460	168	445	0	16817
3613	474	301	118	15747	0	16640
3614	283	186	15380	635	0	16484
3615	231	151	411	15663	0	16456
3616	214	163	243	16034	0	16654
3617	192	142	15630	739	0	16703
3618	208	115	441	15318	0	16082
3619	176	15559	271	653	0	16659
3620	214	447	15572	445	0	16678
3621	330	221	15162	344	0	16057
3622	119	14725	600	274	0	15718
3623	120	13205	278	210	0	13813
3624	99	11529	153	93	0	11874
3625	9934	345	315	141	0	10735
3626	9466	90	80	59	0	9695
3627	9357	39	29	40	0	9465
3628	236	40	23	9232	0	9531
3629	83	34	9163	183	0	9463
3630	53	29	175	9127	0	9384
3631	43	29	56	9282	0	9410
3632	9128	38	35	241	0	9442
3633	9192	25	25	104	0	9346
3634	208	9141	28	72	0	9449
3635	9098	175	29	45	0	9347
3636	9194	53	17	56	0	9320
3637	9324	37	27	59	0	9447
3638	234	28	9094	42	0	9398
3639	90	30	9141	42	0	9303
3640	69	49	190	8990	0	9298
3641	46	21	9005	172	0	9244
3642	8794	28	174	69	0	9065
3643	8985	27	63	52	0	9127
3644	194	21	8728	39	0	8982
3645	8571	13	147	39	0	8770
3646	168	8627	51	28	0	8874
3647	8658	152	31	28	0	8869
3648	174	54	21	8563	0	8812
3649	85	29	16	8415	0	8545
3650	57	8521	23	167	0	8768
3651	8515	133	15	77	0	8740
3652	8533	58	23	48	0	8662
3653	185	8466	22	30	0	8703
3654	83	143	17	8291	0	8534
3655	52	54	17	8303	0	8426
3656	40	8278	21	179	0	8518
3657	50	157	16	8260	0	8483
3658	61	55	16	8404	0	8536
3659	8261	39	15	196	0	8511
3660	8314	19	22	92	0	8447
3661	198	24	8166	51	0	8439
3662	8097	29	144	52	0	8322
3663	171	27	8135	48	0	8381
3664	77	47	152	7984	0	8260
3665	53	26	8023	160	0	8262
3666	42	7897	147	75	0	8161
3667	66	155	62	7683	0	7966
3668	60	58	26	7767	0	7911
3669	7622	34	29	168	0	7853
3670	146	24	22	7493	0	7685
3671	61	23	7305	157	0	7546
3672	7410	25	111	74	0	7620
3673	7500	19	48	60	0	7627
3674	7557	27	37	43	0	7664
3675	7578	19	25	44	0	7666
3676	195	20	22	7818	0	8055
3677	96	20	20	8083	0	8219
3678	68	22	16	8443	0	8549
3679	47	19	28	8578	0	8672
3680	8410	16	24	219	0	8669
3681	8434	27	18	100	0	8579
3682	214	19	24	8043	0	8300
3683	103	8122	18	167	0	8410
3684	8170	139	21	83	0	8413
3685	176	47	8101	62	0	8386
3686	81	8098	142	48	0	8369
3687	7753	133	41	40	0	7967
3688	144	7758	36	35	0	7973
3689	72	135	7580	34	0	7821
3690	7602	45	104	38	0	7789
3691	7612	34	44	27	0	7717
3692	175	24	7484	23	0	7706
3693	96	25	117	7539	0	7777
3694	73	17	54	7586	0	7730
3695	51	7575	35	153	0	7814
3696	71	114	28	7610	0	7823
3697	7474	43	23	143	0	7683
3698	137	7529	28	63	0	7757
3699	64	117	16	7291	0	7488
3700	68	39	11	7323	0	7441
3701	40	36	7098	145	0	7319
3702	40	7069	95	78	0	7282
3703	6579	106	47	70	0	6802
3704	102	5907	24	31	0	6064
3705	38	5512	13	24	0	5587
3706	5399	83	59	24	0	5565
3707	94	31	15	5209	0	5349
3708	44	25	13	5251	0	5333
3709	5230	13	13	84	0	5340
3710	82	15	7	5281	0	5385
3711	41	13	10	5316	0	5380
3712	5435	16	10	88	0	5549
3713	88	12	8	5386	0	5494
3714	36	5394	16	93	0	5539
3715	5442	67	6	43	0	5558
3716	85	27	5247	34	0	5393
3717	32	5076	68	33	0	5209
3718	40	106	24	4852	0	5022
3719	27	25	4819	63	0	4934
3720	14	21	4770	30	0	4835
3721	44	208	62	4312	0	4626
3722	4315	16	37	65	0	4433
3723	51	9	12	4269	0	4341
3724	20	11	4	4298	0	4333
3725	27	4	5	4311	0	4347
3726	13	5	9	4327	0	4354
3727	13	7	8	4321	0	4349
3728	14	10	4162	71	0	4257
3729	10	7	4099	37	0	4153
3730	8	14	52	4154	0	4228
3731	16	10	4149	51	0	4226
3732	11	4143	50	28	0	4232
3733	10	48	21	4179	0	4258
3734	10	23	4073	52	0	4158
3735	3845	10	45	33	0	3933
3736	43	3982	22	28	0	4075
3737	22	3858	14	25	0	3919
3738	21	3969	9	9	0	4008
3739	16	64	3	3868	0	3951
3740	3860	28	10	58	0	3956
3741	57	15	5	3857	0	3934
3742	3744	9	7	66	0	3826
3743	45	3657	9	34	0	3745
3744	3683	46	42	28	0	3799
3745	51	20	10	3725	0	3806
3746	26	14	8	3702	0	3750
3747	17	3656	10	69	0	3752
3748	20	45	8	3671	0	3744
3749	7	22	8	3716	0	3753
3750	17	14	12	3695	0	3738
3751	3634	10	7	79	0	3730
3752	3443	11	9	49	0	3512
3753	54	12	3588	35	0	3689
3754	3589	15	41	27	0	3672
3755	53	9	3661	27	0	3750
3756	33	11	55	3631	0	3730
3757	21	9	25	3701	0	3756
3758	16	10	19	3722	0	3767
3759	6	13	3648	80	0	3747
3760	12	10	53	3715	0	3790
3761	9	16	3757	65	0	3847
3762	15	10	52	3774	0	3851
3763	3775	17	22	65	0	3879
3764	57	12	3783	35	0	3887
3765	3796	13	49	34	0	3892
3766	56	12	19	3864	0	3951
3767	3872	9	15	67	0	3963
3768	62	3855	10	40	0	3967
3769	31	44	10	3920	0	4005
3770	22	19	4026	60	0	4127
3771	23	30	48	3937	0	4038
3772	17	64	15	3867	0	3963
3773	11	3889	16	78	0	3994
3774	24	47	3843	41	0	3955
3775	10	3837	47	39	0	3933
3776	3391	51	37	22	0	3501
3777	29	3448	13	16	0	3506
3778	3208	23	41	18	0	3290
3779	3169	12	15	11	0	3207
3780	3157	7	8	9	0	3181
3781	40	4	5	3182	0	3231
3782	19	2	3171	38	0	3230
3783	13	4	25	3128	0	3170
3784	11	3172	13	35	0	3231
3785	10	26	8	3178	0	3222
3786	3146	10	7	43	0	3206
3787	27	3173	9	19	0	3228
3788	13	23	9	3084	0	3129
3789	11	17	8	3068	0	3104
3790	3062	4	11	46	0	3123
3791	30	8	3060	18	0	3116
3792	15	2997	22	15	0	3049
3793	14	23	18	2888	0	2943
3794	9	9	2843	23	0	2884
3795	9	19	21	2779	0	2828
3796	7	2727	13	25	0	2772
3797	5	23	9	2875	0	2912
3798	4	5	5	2831	0	2845
3799	3	6	5	2799	0	2813
3800	2	5	2792	34	0	2833
3801	2734	8	22	23	0	2787
3802	25	1	9	2929	0	2964
3803	3158	5	7	27	0	3197
3804	3255	6	3	16	0	3280
3805	3305	1	2	15	0	3323
3806	3265	2	6	6	0	3279
3807	3301	4	2	6	0	3313
3808	44	7	3	3253	0	3307
3809	21	3204	2	34	0	3261
3810	17	24	5	3151	0	3197
3811	7	3115	4	33	0	3159
3812	11	35	3	2950	0	2999
3813	2947	7	3	26	0	2983
3814	23	10	1	2920	0	2954
3815	8	4	2910	25	0	2947
3816	2782	5	16	12	0	2815
3817	18	2920	7	11	0	2956
3818	2946	18	10	12	0	2986
3819	2908	6	2	11	0	2927
3820	2853	6	3	4	0	2866
3821	31	2936	2	6	0	2975
3822	17	18	3	2937	0	2975
3823	13	7	1	2950	0	2971
3824	10	4	2937	24	0	2975
3825	4	4	17	2860	0	2885
3826	9	7	7	2779	0	2802
3827	4	2	7	2917	0	2930
3828	4	2925	4	26	0	2959
3829	2946	21	2	21	0	2990
3830	2892	6	3	13	0	2914
3831	26	5	3034	9	0	3074
3832	13	3018	18	6	0	3055
3833	15	18	6	3088	0	3127
3834	11	6	5	3097	0	3119
3835	12	7	4	3101	0	3124
3836	6	9	4	3162	0	3181
3837	9	4	0	3200	0	3213
3838	8	4	3140	40	0	3192
3839	7	5	2995	19	0	3026
3840	3178	5	25	17	0	3225
3841	3358	3	11	15	0	3387
3842	3380	3	8	14	0	3405
3843	38	4	8	3410	0	3460
3844	16	4	3429	33	0	3482
3845	3385	4	26	17	0	3432
3846	3500	1	10	10	0	3521
3847	39	5	3416	9	0	3469
3848	3428	3	30	10	0	3471
3849	42	3	3712	6	0	3763
3850	21	5	32	3727	0	3785
3851	14	4	3785	34	0	3837
3852	3700	2	32	13	0	3747
3853	3816	1	11	14	0	3842
3854	3823	3	10	14	0	3850
3855	3842	1	7	15	0	3865
3856	42	3	4005	8	0	4058
3857	22	3993	30	8	0	4053
3858	4065	28	9	10	0	4112
3859	4068	6	7	8	0	4089
3860	43	9	4045	4	0	4101
3861	20	7	31	3964	0	4022
3862	18	7	8	4051	0	4084
3863	16	2	3979	35	0	4032
3864	3754	3	30	18	0	3805
3865	3967	5	12	20	0	4004
3866	32	4034	10	13	0	4089
3867	4134	29	7	19	0	4189
3868	4128	6	8	13	0	4155
3869	4173	3	5	11	0	4192
3870	4052	3	7	8	0	4070
3871	52	7	4005	3	0	4067
3872	3962	4	30	5	0	4001
3873	46	22	9	3990	0	4067
3874	22	4050	6	32	0	4110
3875	20	28	3970	9	0	4027
3876	11	4062	29	15	0	4117
3877	20	56	16	3858	0	3950
3878	10	4	3913	27	0	3954
3879	3653	3	31	10	0	3697
3880	29	4	3872	7	0	3912
3881	3853	4	27	8	0	3892
3882	29	2	10	3898	0	3939
3883	16	2	3	3906	0	3927
3884	12	3825	7	30	0	3874
3885	13	3961	8	6	0	3988
3886	17	27	6	4073	0	4123
3887	4038	3	6	31	0	4078
3888	4026	4	7	8	0	4045
3889	4028	2	5	8	0	4043
3890	30	5	4071	8	0	4114
3891	3990	4	24	9	0	4027
3892	29	4	4189	7	0	4229
3893	11	2	3992	9	0	4014
3894	4084	0	32	5	0	4121
3895	4264	3	6	3	0	4276
3896	37	2	4285	3	0	4327
3897	18	1	31	4222	0	4272
3898	20	3	5	4373	0	4401
3899	4379	4	9	32	0	4424
3900	4313	1	10	9	0	4333
3901	34	3	4531	6	0	4574
3902	14	4365	22	8	0	4409
3903	8	4289	6	5	0	4308
3904	4230	20	9	9	0	4268
3905	29	6	6	4233	0	4274
3906	8	3	6	4292	0	4309
3907	15	3	4	4338	0	4360
3908	4292	2	7	21	0	4322
3909	25	7	7	4341	0	4380
3910	4366	4	2	24	0	4396
3911	4497	0	5	5	0	4507
3912	32	4797	6	7	0	4842
3913	14	21	2	5249	0	5286
3914	11	6	5268	40	0	5325
3915	5202	8	37	15	0	5262
3916	5336	5	10	17	0	5368
3917	5381	3	13	9	0	5406
3918	60	3	5456	5	0	5524
3919	27	4	40	5510	0	5581
3920	5586	1	15	50	0	5652
3921	5402	2	17	16	0	5437
3922	5444	1	7	15	0	5467
3923	59	5342	9	5	0	5415
3924	30	5643	5	12	0	5690
3925	29	38	4	5783	0	5854
3926	18	17	5	5771	0	5811
3927	14	5777	6	41	0	5838
3928	5785	38	2	28	0	5853
3929	49	15	5902	13	0	5979
3930	23	11	35	5884	0	5953
3931	22	9	9	5878	0	5918
3932	10	6	5820	48	0	5884
3933	5545	9	39	30	0	5623
3934	5901	8	16	21	0	5946
3935	54	5805	14	13	0	5886
3936	5827	31	6	12	0	5876
3937	55	14	6084	11	0	6164
3938	6127	11	37	26	0	6201
3939	58	1	6297	8	0	6364
3940	6203	11	61	15	0	6290
3941	6330	5	20	10	0	6365
3942	6320	5	17	7	0	6349
3943	6281	6	1	12	0	6300
3944	53	6267	10	3	0	6333
3945	6482	25	7	15	0	6529
3946	6617	13	10	13	0	6653
3947	84	12	6612	5	0	6713
3948	6655	3	35	10	0	6703
3949	56	6	13	6665	0	6740
3950	33	4	6643	36	0	6716
3951	6627	7	32	21	0	6687
3952	50	5	16	6748	0	6819
3953	6901	5	15	43	0	6964
3954	7274	5	6	31	0	7316
3955	56	5	7427	14	0	7502
3956	7279	4	37	20	0	7340
3957	7464	4	16	19	0	7503
3958	7485	5	16	14	0	7520
3959	7607	4	10	17	0	7638
3960	76	1	9	7468	0	7554
3961	44	7460	7	42	0	7553
3962	7259	34	9	26	0	7328
3963	7623	13	12	17	0	7665
3964	7667	10	9	10	0	7696
3965	82	11	7580	13	0	7686
3966	52	7550	40	11	0	7653
3967	45	37	19	7621	0	7722
3968	38	17	14	7658	0	7727
3969	32	11	7858	53	0	7954
3970	34	9	49	7901	0	7993
3971	37	6	7945	60	0	8048
3972	38	3	58	7934	0	8033
3973	36	9	21	8065	0	8131
3974	28	12	8133	62	0	8235
3975	7863	11	52	49	0	7975
3976	8265	9	25	47	0	8346
3977	69	10	8472	34	0	8585
3978	8378	8	57	25	0	8468
3979	8606	9	27	28	0	8670
3980	83	4	8826	17	0	8930
3981	56	8	60	8730	0	8854
3982	48	4	29	8820	0	8901
3983	8885	3	23	66	0	8977
3984	79	9021	16	32	0	9148
3985	8400	52	20	43	0	8515
3986	8950	18	16	22	0	9006
3987	84	9186	11	20	0	9301
3988	9318	51	14	30	0	9413
3989	9315	21	18	29	0	9383
3990	86	9247	20	20	0	9373
3991	57	57	13	9331	0	9458
3992	52	9381	15	67	0	9515
3993	45	65	14	9478	0	9602
3994	54	27	9417	68	0	9566
3995	40	30	9187	27	0	9284
3996	9171	16	67	41	0	9295
3997	9421	13	35	30	0	9499
3998	93	11	9496	22	0	9622
3999	9454	10	64	18	0	9546
4000	9699	6	31	36	0	9772
4001	9518	11	35	37	0	9601
4002	105	9735	24	25	0	9889
4003	66	53	21	9954	0	10094
4004	9967	11	16	74	0	10068
4005	9883	17	17	31	0	9948
4006	107	17	9991	23	0	10138
4007	73	16	58	9883	0	10030
4008	64	14	17	10013	0	10108
4009	56	9955	20	69	0	10100
4010	43	10296	14	46	0	10399
4011	34	116	20	10038	0	10208
4012	29	10026	16	83	0	10154
4013	9751	48	13	35	0	9847
4014	59	10162	11	23	0	10255
4015	10345	65	12	24	0	10446
4016	84	20	10506	15	0	10625
4017	10921	22	81	22	0	11046
4018	11439	11	24	12	0	11486
4019	11447	6	15	18	0	11486
4020	11331	7	10	18	0	11366
4021	156	11220	11	13	0	11400
4022	71	89	9	11437	0	11606
4023	55	29	7	11353	0	11444
4024	38	15	11292	120	0	11465
4025	35	15	93	11069	0	11212
4026	32	14	34	11261	0	11341
4027	11363	11	16	144	0	11534
4028	118	11454	9	65	0	11646
4029	71	98	13	11481	0	11663
4030	52	39	13	11651	0	11755
4031	33	27	10	11793	0	11863
4032	11673	23	11	184	0	11891
4033	123	22	9	11755	0	11909
4034	11790	13	17	175	0	11995
4035	141	11	22	11861	0	12035
4036	72	9	12	12024	0	12117
4037	60	12	11453	166	0	11691
4038	10729	17	110	94	0	10950
4039	143	11340	34	43	0	11560
4040	11609	107	23	60	0	11799
4041	159	30	19	11537	0	11745
4042	69	21	17	11686	0	11793
4043	11686	12	10	167	0	11875
4044	11743	22	11	87	0	11863
4045	185	20	4	12128	0	12337
4046	76	25	12088	169	0	12358
4047	52	18	11973	84	0	12127
4048	40	12681	154	68	0	12943
4049	12900	142	70	66	0	13178
4050	12960	52	28	53	0	13093
4051	217	33	15	13042	0	13307
4052	87	13183	18	171	0	13459
4053	62	163	14	13172	0	13411
4054	71	46	12	12769	0	12898
4055	46	12317	13	205	0	12581
4056	12431	148	17	106	0	12702
4057	176	71	18	12465	0	12730
4058	72	12510	19	181	0	12782
4059	58	12985	11	79	0	13133
4060	12938	179	12	74	0	13203
4061	193	66	12890	45	0	13194
4062	12915	48	148	51	0	13162
4063	200	51	51	13033	0	13335
4064	82	36	28	12986	0	13132
4065	69	13020	24	205	0	13318
4066	78	206	24	13007	0	13315
4067	77	59	13008	196	0	13340
4068	65	12777	144	93	0	13079
4069	45	12976	47	69	0	13137
4070	12763	203	36	66	0	13068
4071	173	12889	25	58	0	13145
4072	87	167	35	12908	0	13197
4073	67	12963	25	175	0	13230
4074	63	178	17	13001	0	13259
4075	57	70	13	13163	0	13303
4076	47	66	12726	237	0	13076
4077	47	58	139	12537	0	12781
4078	58	48	58	12704	0	12868
4079	12451	40	45	258	0	12794
4080	178	49	12342	135	0	12704
4081	101	40	158	12592	0	12891
4082	79	42	12609	223	0	12953
4083	12398	52	180	129	0	12759
4084	206	12803	60	115	0	13184
4085	13363	174	52	124	0	13713
4086	240	72	41	13689	0	14042
4087	120	71	37	13676	0	13904
4088	88	46	13543	304	0	13981
4089	12820	47	186	192	0	13245
4090	219	13736	65	132	0	14152
4091	13710	218	51	116	0	14095
4092	260	92	37	13684	0	14073
4093	125	13654	36	328	0	14143
4094	13803	221	32	149	0	14205
4095	242	13976	33	100	0	14351
4096	120	220	40	13949	0	14329
4097	103	109	28	14044	0	14284
4098	88	74	35	13940	0	14137
4099	89	13626	42	323	0	14080
4100	67	222	37	13773	0	14099
4101	81	102	23	13885	0	14091
4102	13388	80	38	338	0	13844
4103	13445	72	25	174	0	13716
4104	13412	88	31	125	0	13656
4105	321	64	13328	108	0	13821
4106	13325	71	191	124	0	13711
4107	13583	68	69	122	0	13842
4108	13091	82	42	123	0	13338
4109	307	71	12420	106	0	12904
4110	13035	59	149	123	0	13366
4111	279	59	70	13152	0	13560
4112	142	50	13061	251	0	13504
4113	109	12987	180	152	0	13428
4114	102	377	86	12234	0	12799
4115	100	12143	57	210	0	12510
4116	65	12208	61	128	0	12462
4117	11386	174	110	105	0	11775
4118	176	69	35	11298	0	11578
4119	11342	40	34	175	0	11591
4120	168	53	23	11319	0	11563
4121	11279	42	24	181	0	11526
4122	176	35	20	11294	0	11525
4123	11244	40	21	187	0	11492
4124	175	29	10913	87	0	11204
4125	96	52	130	10983	0	11261
4126	81	47	11047	158	0	11333
4127	79	37	10506	95	0	10717
4128	71	41	10864	66	0	11042
4129	61	83	159	10670	0	10973
4130	55	34	10700	181	0	10970
4131	10531	36	136	101	0	10804
4132	148	35	58	10679	0	10920
4133	64	32	11024	179	0	11299
4134	67	32	127	10943	0	11169
4135	53	29	59	11074	0	11215
4136	61	29	11361	200	0	11651
4137	65	28	130	11332	0	11555
4138	83	17	54	11222	0	11376
4139	70	11345	35	187	0	11637
4140	11317	107	46	99	0	11569
4141	11317	43	43	84	0	11487
4142	194	29	11129	61	0	11413
4143	10913	27	121	84	0	11145
4144	157	23	10792	60	0	11032
4145	93	19	10191	45	0	10348
4146	65	18	10216	51	0	10350
4147	103	186	160	9612	0	10061
4148	48	16	9686	109	0	9859
4149	35	25	97	9362	0	9519
4150	33	9	45	9405	0	9492
4151	40	18	30	9343	0	9431
4152	45	11	26	9300	0	9382
4153	9169	15	27	129	0	9340
4154	9252	9	23	73	0	9357
4155	101	9410	19	51	0	9581
4156	52	70	24	9529	0	9675
4157	46	27	9682	85	0	9840
4158	30	9957	85	60	0	10132
4159	45	101	33	10323	0	10502
4160	29	34	10567	124	0	10754
4161	47	23	116	10344	0	10530
4162	22	17	10501	118	0	10658
4163	15	14	10362	63	0	10454
4164	26	10	138	10590	0	10764
4165	20	7	50	10696	0	10773
4166	10635	6	39	162	0	10842
4167	116	8	31	10620	0	10775
4168	10495	6	29	151	0	10681
4169	101	10426	27	68	0	10622
4170	50	10797	24	44	0	10915
4171	32	125	20	11139	0	11316
4172	11154	37	30	137	0	11358
4173	118	11274	17	64	0	11473
4174	60	112	18	11605	0	11795
4175	11854	40	25	153	0	12072
4176	11965	20	14	76	0	12075
4177	11648	17	40	49	0	11754
4178	11577	20	31	58	0	11686
4179	12140	17	21	58	0	12236
4180	159	8	11844	41	0	12052
4181	72	12	11595	37	0	11716
4182	39	11654	133	36	0	11862
4183	58	151	69	11544	0	11822
4184	30	34	11755	112	0	11931
4185	29	22	11368	41	0	11460
4186	43	45	114	11353	0	11555
4187	20	18	11898	109	0	12045
4188	20	21	11798	39	0	11878
4189	16	14362	111	38	0	14527
4190	14361	192	43	39	0	14635
4191	180	15761	22	16	0	15979
4192	84	220	16	16556	0	16876
4193	16814	50	16	254	0	17134
4194	242	17028	28	63	0	17361
4195	96	240	26	16979	0	17341
4196	34	50	17166	251	0	17501
4197	17195	27	237	80	0	17539
4198	17558	28	54	62	0	17702
4199	17884	19	26	54	0	17983
4200	328	16	36	17823	0	18203
4201	99	24	17875	272	0	18270
4202	54	17916	262	69	0	18301
4203	69	252	59	18154	0	18534
4204	18174	61	40	303	0	18578
4205	287	37	18038	73	0	18435
4206	75	17687	278	79	0	18119
4207	50	253	17811	48	0	18162
4208	18015	51	260	68	0	18394
4209	18546	33	79	57	0	18715
4210	18506	44	43	59	0	18652
4211	349	38	18000	39	0	18426
4212	115	17815	274	53	0	18257
4213	112	262	73	17939	0	18386
4214	101	70	51	18186	0	18408
4215	92	40	56	18249	0	18437
4216	62	56	17812	357	0	18287
4217	17602	37	286	150	0	18075
4218	336	25	18001	78	0	18440
4219	18233	49	301	89	0	18672
4220	18636	36	90	91	0	18853
4221	18700	37	62	69	0	18868
4222	18372	41	67	74	0	18554
4223	402	51	18232	60	0	18745
4224	194	45	295	18286	0	18820
4225	114	76	18068	310	0	18568
4226	108	17650	314	115	0	18187
4227	113	18492	100	69	0	18774
4228	18520	344	61	115	0	19040
4229	18242	97	82	98	0	18519
4230	381	18645	81	80	0	19187
4231	18855	337	78	94	0	19364
4232	423	119	15871	92	0	16505
4233	18329	64	219	82	0	18694
4234	412	18729	86	82	0	19309
4235	19095	331	94	84	0	19604
4236	18911	113	91	86	0	19201
4237	475	72	90	18518	0	19155
4238	199	84	79	18854	0	19216
4239	18645	56	94	417	0	19212
4240	441	80	83	18629	0	19233
4241	18726	80	98	379	0	19283
4242	457	80	71	18739	0	19347
4243	18644	66	95	369	0	19174
4244	18637	73	61	169	0	18940
4245	495	18054	78	96	0	18723
4246	211	18666	85	90	0	19052
4247	18279	368	85	117	0	18849
4248	400	18437	90	94	0	19021
4249	229	367	76	18266	0	18938
4250	180	134	95	18523	0	18932
4251	18080	107	85	430	0	18702
4252	417	18034	90	176	0	18717
4253	234	17682	88	142	0	18146
4254	185	18110	95	176	0	18566
4255	234	392	17685	133	0	18444
4256	238	151	17522	97	0	18008
4257	226	124	17604	108	0	18062
4258	251	377	399	15670	0	16697
4259	220	16708	161	272	0	17361
4260	16626	326	85	163	0	17200
4261	419	131	16512	118	0	17180
4262	191	110	16315	135	0	16751
4263	184	106	16747	122	0	17159
4264	216	106	371	16518	0	17211
4265	199	75	156	16715	0	17145
4266	190	84	119	16791	0	17184
4267	16623	91	115	357	0	17186
4268	16635	99	102	149	0	16985
4269	16716	92	85	109	0	17002
4270	470	97	99	16196	0	16862
4271	230	87	15650	300	0	16267
4272	192	91	15822	125	0	16230
4273	197	78	341	15673	0	16289
4274	180	70	127	15622	0	15999
4275	15218	64	99	378	0	15759
4276	386	15014	92	164	0	15656
4277	15051	277	86	128	0	15542
4278	388	14938	78	150	0	15554
4279	228	280	70	14931	0	15509
4280	179	112	14838	343	0	15472
4281	192	117	280	14764	0	15353
4282	14888	81	98	363	0	15430
4283	406	52	14734	170	0	15362
4284	14347	80	287	147	0	14861
4285	420	56	14271	103	0	14850
4286	261	76	13869	94	0	14300
4287	13177	83	312	106	0	13678
4288	384	82	13217	75	0	13758
4289	126	37	10598	58	0	10819
4290	164	10324	286	65	0	10839
4291	8611	257	387	131	0	9386
4292	8084	53	70	37	0	8244
4293	8016	13	20	21	0	8070
4294	90	18	7715	11	0	7834
4295	7463	16	69	26	0	7574
4296	76	7678	30	15	0	7799
4297	7536	66	24	18	0	7644
4298	84	19	7579	5	0	7687
4299	44	79	70	7174	0	7367
4300	18	11	7107	44	0	7180
4301	21	6992	56	15	0	7084
4302	43	50	51	6661	0	6805
4303	22	16	22	6759	0	6819
4304	6846	4	16	48	0	6914
4305	6810	4	12	31	0	6857
4306	6829	6	10	18	0	6863
4307	6811	5	9	20	0	6845
4308	6734	5	11	18	0	6768
4309	65	6	6750	5	0	6826
4310	32	5	39	6732	0	6808
4311	23	4	6942	47	0	7016
4312	19	8	44	6975	0	7046
4313	7085	5	19	49	0	7158
4314	7177	6	12	24	0	7219
4315	7226	6	10	29	0	7271
4316	7297	5	11	24	0	7337
4317	60	16	7411	9	0	7496
4318	30	7	51	7355	0	7443
4319	19	13	7323	53	0	7408
4320	24	7387	46	23	0	7480
4321	24	7264	21	14	0	7323
4322	36	60	14	7161	0	7271
4323	26	11	14	7858	0	7909
4324	32	4	15	7956	0	8007
4325	29	3	14	8398	0	8444
4326	8319	1	18	94	0	8432
4327	77	8261	24	25	0	8387
4328	8082	71	8	16	0	8177
4329	85	12	13	8045	0	8155
4330	40	4	11	7883	0	7938
4331	17	7941	13	71	0	8042
4332	27	70	7	7929	0	8033
4333	7926	13	9	90	0	8038
4334	76	7616	3	32	0	7727
4335	23	7478	15	9	0	7525
4336	7412	78	5	20	0	7515
4337	94	15	5	7467	0	7581
4338	18	7437	8	78	0	7541
4339	25	85	7	7497	0	7614
4340	7565	11	10	94	0	7680
4341	87	8	6	7506	0	7607
4342	27	11	3	7555	0	7596
4343	7493	11	3	101	0	7608
4344	101	8	2	7457	0	7568
4345	24	7492	3	86	0	7605
4346	26	72	3	7404	0	7505
4347	24	7416	6	83	0	7529
4348	25	71	5	7454	0	7555
4349	7440	22	4	83	0	7549
4350	7500	10	7	36	0	7553
4351	97	15	6	7505	0	7623
4352	25	9	7406	91	0	7531
4353	7240	6	75	50	0	7371
4354	104	15	7379	14	0	7512
4355	7361	14	76	39	0	7490
4356	7455	11	8	21	0	7495
4357	102	6	7280	24	0	7412
4358	22	7211	78	19	0	7330
4359	7178	69	21	27	0	7295
4360	7190	12	5	31	0	7238
4361	84	13	7343	12	0	7452
4362	7200	17	73	37	0	7327
4363	7172	16	13	23	0	7224
4364	7209	7	4	27	0	7247
4365	89	14	7	7153	0	7263
4366	45	9	6	7175	0	7235
4367	24	7169	7	87	0	7287
4368	31	66	8	7254	0	7359
4369	29	18	2	7307	0	7356
4370	22	15	7115	93	0	7245
4371	29	15	6889	27	0	6960
4372	6660	13	81	38	0	6792
4373	6905	11	8	26	0	6950
4374	87	6830	14	27	0	6958
4375	26	76	17	6912	0	7031
4376	27	15	7197	87	0	7326
4377	34	7	90	7306	0	7437
4378	39	20	10	7543	0	7612
4379	30	11	8	7734	0	7783
4380	24	7733	15	105	0	7877
4381	26	91	14	7838	0	7969
4382	28	20	12	7939	0	7999
4383	32	10	7841	120	0	8003
4384	29	13	7843	41	0	7926
4385	7674	17	100	39	0	7830
4386	7890	8	19	49	0	7966
4387	121	12	19	8288	0	8440
4388	47	13	12	8244	0	8316
4389	32	17	17	8422	0	8488
4390	35	18	8149	151	0	8353
4391	22	8081	117	59	0	8279
4392	21	125	8108	48	0	8302
4393	8014	19	138	58	0	8229
4394	144	20	8158	30	0	8352
4395	8094	19	131	39	0	8283
4396	7991	18	29	38	0	8076
4397	8198	14	19	37	0	8268
4398	152	14	21	8073	0	8260
4399	41	14	8044	150	0	8249
4400	39	8125	126	41	0	8331
4401	52	128	28	8003	0	8211
4402	39	26	13	8252	0	8330
4403	32	23	8333	162	0	8550
4404	22	8218	136	58	0	8434
4405	8551	138	30	47	0	8766
4406	149	8780	31	47	0	9007
4407	9379	162	21	38	0	9600
4408	209	39	27	9594	0	9869
4409	62	33	9878	190	0	10163
4410	54	9976	195	51	0	10276
4411	10060	199	49	56	0	10364
4412	201	43	10070	48	0	10362
4413	10055	25	206	47	0	10333
4414	10204	20	58	32	0	10314
4415	235	24	10111	21	0	10391
4416	9924	18	189	30	0	10161
4417	9977	13	55	29	0	10074
4418	9784	13	44	27	0	9868
4419	249	9570	38	21	0	9878
4420	9353	182	29	34	0	9598
4421	225	9530	18	31	0	9804
4422	73	187	9466	31	0	9757
4423	64	9340	166	26	0	9596
4424	8855	207	119	28	0	9209
4425	8931	50	40	32	0	9053
4426	8998	45	29	26	0	9098
4427	229	22	27	8830	0	9108
4428	100	21	23	8960	0	9104
4429	8678	14	26	187	0	8905
4430	8963	22	14	68	0	9067
4431	222	14	17	8747	0	9000
4432	86	10	8678	168	0	8942
4433	53	8357	149	54	0	8613
4434	43	8652	48	42	0	8785
4435	57	170	40	8517	0	8784
4436	44	51	8568	147	0	8810
4437	56	66	141	8205	0	8468
4438	40	8367	43	153	0	8603
4439	52	146	35	8367	0	8600
4440	45	51	8307	161	0	8564
4441	52	35	147	8331	0	8565
4442	25	26	8622	180	0	8853
4443	37	30	178	8599	0	8844
4444	37	30	8785	179	0	9031
4445	32	27	8819	57	0	8935
4446	8659	16	180	61	0	8916
4447	8890	18	74	45	0	9027
4448	8942	22	46	38	0	9048
4449	213	8861	31	23	0	9128
4450	103	149	28	8958	0	9238
4451	8730	36	24	162	0	8952
4452	9051	36	31	61	0	9179
4453	9022	26	25	53	0	9126
4454	210	20	8903	32	0	9165
4455	91	8491	151	39	0	8772
4456	76	8957	65	30	0	9128
4457	8897	170	40	37	0	9144
4458	202	63	29	8823	0	9117
4459	8795	51	36	156	0	9038
4460	199	31	8702	58	0	8990
4461	88	23	153	8630	0	8894
4462	88	32	48	8755	0	8923
4463	74	33	42	8497	0	8646
4464	67	8644	34	177	0	8922
4465	8649	155	28	81	0	8913
4466	8701	52	31	59	0	8843
4467	203	8568	28	53	0	8852
4468	98	158	39	8530	0	8825
4469	8627	48	22	160	0	8857
4470	204	49	30	8573	0	8856
4471	8581	31	24	177	0	8813
4472	205	8546	16	68	0	8835
4473	8523	147	23	59	0	8752
4474	203	56	8415	40	0	8714
4475	80	8487	147	60	0	8774
4476	90	153	8280	28	0	8551
4477	121	199	189	7940	0	8449
4478	7819	47	79	156	0	8101
4479	7877	38	53	57	0	8025
4480	7827	21	30	58	0	7936
4481	214	23	32	7629	0	7898
4482	7656	22	21	155	0	7854
4483	204	16	23	7560	0	7803
4484	7594	10	30	179	0	7813
4485	7718	17	32	64	0	7831
4486	195	25	7639	54	0	7913
4487	93	19	7176	32	0	7320
4488	67	20	7141	29	0	7257
4489	52	48	134	6866	0	7100
4490	6889	19	100	122	0	7130
4491	125	17	39	6942	0	7123
4492	63	19	35	7088	0	7205
4493	7264	19	27	146	0	7456
4494	7273	16	18	78	0	7385
4495	7263	17	22	56	0	7358
4496	7331	20	15	46	0	7412
4497	152	10	21	7254	0	7437
4498	7213	11	24	128	0	7376
4499	148	7132	20	48	0	7348
4500	7102	85	15	51	0	7253
4501	7107	29	35	46	0	7217
4502	137	38	6822	28	0	7025
4503	6539	25	88	27	0	6679
4504	128	18	6492	24	0	6662
4505	57	11	5956	18	0	6042
4506	50	21	5895	19	0	5985
4507	70	195	75	4955	0	5295
4508	19	10	4986	33	0	5048
4509	12	30	29	4566	0	4637
4510	14	2	4690	16	0	4722
4511	11	3	4768	8	0	4790
4512	16	16	20	4699	0	4751
4513	14	0	16	4904	0	4934
4514	5	1	5037	20	0	5063
4515	4896	1	19	13	0	4929
4516	22	3	7	5016	0	5048
4517	14	3	2	5068	0	5087
4518	5065	1	1	34	0	5101
4519	25	0	2	5171	0	5198
4520	13	2	5164	20	0	5199
4521	6	1	4900	11	0	4918
4522	6	11	22	4877	0	4916
4523	2	3	5013	20	0	5038
4524	5	5136	19	12	0	5172
4525	8	21	9	5088	0	5126
4526	5155	7	9	28	0	5199
4527	14	6	5148	8	0	5176
4528	5113	4	16	9	0	5142
4529	19	0	8	5295	0	5322
4530	13	2	2	5305	0	5322
4531	9	3	3	5300	0	5315
4532	11	0	2	5268	0	5281
4533	5281	3	2	25	0	5311
4534	16	5573	1	15	0	5605
4535	11	18	3	5691	0	5723
4536	9	7	0	5696	0	5712
4537	10	4	4	5699	0	5717
4538	5	2	3	5688	0	5698
4539	5672	1	1	38	0	5712
4540	24	5671	4	15	0	5714
4541	5598	24	4	11	0	5637
4542	25	5330	0	10	0	5365
4543	10	5367	2	11	0	5390
4544	5235	23	3	15	0	5276
4545	32	9	5366	3	0	5410
4546	13	8	22	5332	0	5375
4547	5500	2	6	38	0	5546
4548	5583	3	5	20	0	5611
4549	4900	15	9	36	0	4960
4550	5583	0	3	17	0	5603
4551	35	5829	2	5	0	5871
4552	5900	25	1	17	0	5943
4553	6064	8	1	15	0	6088
4554	47	6433	2	8	0	6490
4555	31	42	0	6669	0	6742
4556	13	15	6683	44	0	6755
4557	18	12	48	6749	0	6827
4558	6708	5	12	70	0	6795
4559	50	3	6952	22	0	7027
4560	15	6867	52	18	0	6952
4561	16	50	7003	10	0	7079
4562	19	19	62	6749	0	6849
4563	9	6873	20	45	0	6947
4564	7036	55	9	37	0	7137
4565	61	7081	5	20	0	7167
4566	26	62	3	7073	0	7164
4567	21	20	8	7181	0	7230
4568	7136	13	5	81	0	7235
4569	63	9	5	7044	0	7121
4570	24	7073	6	53	0	7156
4571	7152	61	4	27	0	7244
4572	7141	19	7	31	0	7198
4573	67	7197	10	13	0	7287
4574	7183	59	8	25	0	7275
4575	72	7106	5	13	0	7196
4576	7067	69	6	19	0	7161
4577	72	7086	6	13	0	7177
4578	34	66	9	6878	0	6987
4579	27	21	5	7179	0	7232
4580	7131	17	7	80	0	7235
4581	7192	12	9	41	0	7254
4582	77	7183	6	19	0	7285
4583	30	63	7145	14	0	7252
4584	7227	27	53	22	0	7329
4585	76	19	19	7328	0	7442
4586	37	7275	16	62	0	7390
4587	28	70	4	7338	0	7440
4588	7359	23	7	76	0	7465
4589	7395	15	10	38	0	7458
4590	7488	18	6	36	0	7548
4591	103	11	2	7466	0	7582
4592	42	18	7384	72	0	7516
4593	7094	16	51	45	0	7206
4594	7151	13	19	44	0	7227
4595	7309	14	12	30	0	7365
4596	91	7205	6	21	0	7323
4597	47	63	7	7252	0	7369
4598	31	7379	9	79	0	7498
4599	29	77	4	7426	0	7536
4600	41	28	5	7551	0	7625
4601	39	23	7834	86	0	7982
4602	31	18	64	8236	0	8349
4603	31	21	21	8468	0	8541
4604	8558	19	19	134	0	8730
4605	110	8682	13	60	0	8865
4606	8719	97	10	41	0	8867
4607	9134	46	9	34	0	9223
4608	151	34	9	9094	0	9288
4609	81	18	9191	109	0	9399
4610	50	8938	93	50	0	9131
4611	39	8899	36	39	0	9013
4612	8743	143	32	41	0	8959
4613	117	8798	17	31	0	8963
4614	56	113	18	8662	0	8849
4615	61	44	19	8855	0	8979
4616	32	35	8725	153	0	8945
4617	38	34	8595	62	0	8729
4618	33	8677	137	45	0	8892
4619	47	123	50	8669	0	8889
4620	8718	57	22	132	0	8929
4621	142	36	19	8773	0	8970
4622	57	33	8929	134	0	9153
4623	46	30	114	8816	0	9006
4624	8660	28	45	159	0	8892
4625	8669	28	28	81	0	8806
4626	155	8637	19	60	0	8871
4627	8648	128	17	48	0	8841
4628	156	8644	22	47	0	8869
4629	8663	138	7	44	0	8852
4630	155	66	18	8573	0	8812
4631	79	36	8554	129	0	8798
4632	52	36	8423	62	0	8573
4633	49	8667	136	47	0	8899
4634	74	132	66	8347	0	8619
4635	53	48	18	8518	0	8637
4636	8485	36	16	159	0	8696
4637	8528	23	23	75	0	8649
4638	8656	24	18	53	0	8751
4639	176	32	20	8582	0	8810
4640	83	22	22	8737	0	8864
4641	62	23	14	8803	0	8902
4642	52	24	8662	170	0	8908
4643	44	29	8526	73	0	8672
4644	8519	24	140	56	0	8739
4645	8569	23	52	57	0	8701
4646	160	25	8565	41	0	8791
4647	8416	18	117	49	0	8600
4648	8269	17	58	54	0	8398
4649	155	21	8303	40	0	8519
4650	85	8355	112	46	0	8598
4651	83	143	69	8088	0	8383
4652	47	41	8239	120	0	8447
4653	47	8332	119	55	0	8553
4654	73	138	61	7731	0	8003
4655	40	7933	31	97	0	8101
4656	45	108	7838	47	0	8038
4657	32	44	7868	39	0	7983
4658	65	75	141	7875	0	8156
4659	7913	25	55	116	0	8109
4660	120	24	26	7901	0	8071
4661	7867	21	23	123	0	8034
4662	118	20	28	7904	0	8070
4663	55	24	7833	119	0	8031
4664	7707	23	108	68	0	7906
4665	109	24	7902	41	0	8076
4666	7938	19	121	44	0	8122
4667	136	18	51	7857	0	8062
4668	60	7904	38	121	0	8123
4669	42	101	30	7961	0	8134
4670	37	8046	23	123	0	8229
4671	48	110	32	7698	0	7888
4672	41	8021	33	120	0	8215
4673	7970	116	35	74	0	8195
4674	8040	41	27	59	0	8167
4675	7995	30	27	42	0	8094
4676	158	31	7871	37	0	8097
4677	73	24	112	7890	0	8099
4678	54	31	7953	127	0	8165
4679	39	7696	127	70	0	7932
4680	45	7956	56	33	0	8090
4681	7776	131	36	40	0	7983
4682	131	51	7818	31	0	8031
4683	67	7725	112	37	0	7941
4684	54	117	62	7861	0	8094
4685	7848	47	38	129	0	8062
4686	118	7898	29	62	0	8107
4687	8011	116	27	46	0	8200
4688	126	56	8015	36	0	8233
4689	74	42	107	8094	0	8317
4690	47	17	53	8201	0	8318
4691	43	28	34	8410	0	8515
4692	35	8361	31	164	0	8591
4693	44	130	29	7999	0	8202
4694	38	50	8479	153	0	8720
4695	48	30	130	8372	0	8580
4696	56	21	60	8544	0	8681
4697	54	23	30	8451	0	8558
4698	41	8278	29	164	0	8512
4699	42	114	32	8252	0	8440
4700	73	57	25	8195	0	8350
4701	23	7747	19	170	0	7959
4702	7297	99	26	55	0	7477
4703	97	7204	18	40	0	7359
4704	28	7086	21	30	0	7165
4705	52	145	26	6869	0	7092
4706	19	33	6835	104	0	6991
4707	6299	27	90	34	0	6450
4708	92	18	15	6520	0	6645
4709	20	11	6417	96	0	6544
4710	19	6434	79	30	0	6562
4711	21	86	17	6475	0	6599
4712	24	18	6523	97	0	6662
4713	17	21	86	6359	0	6483
4714	12	16	23	6420	0	6471
4715	6246	7	12	121	0	6386
4716	73	6255	14	42	0	6384
4717	6249	82	10	28	0	6369
4718	86	22	6310	23	0	6441
4719	22	6348	76	19	0	6465
4720	15	82	6339	19	0	6455
4721	28	54	95	6418	0	6595
4722	6340	14	25	93	0	6472
4723	80	11	14	6342	0	6447
4724	6357	8	6	99	0	6470
4725	6453	13	11	36	0	6513
4726	98	12	5	6526	0	6641
4727	31	10	6721	92	0	6854
4728	22	13	6836	23	0	6894
4729	17	17	94	6964	0	7092
4730	20	13	21	7106	0	7160
4731	7035	10	17	116	0	7178
4732	99	15	10	6953	0	7077
4733	26	6833	11	107	0	6977
4734	17	87	16	6927	0	7047
4735	16	25	6	7057	0	7104
4736	6929	15	15	125	0	7084
4737	88	7036	13	40	0	7177
4738	27	101	7	7128	0	7263
4739	24	19	9	7173	0	7225
4740	17	7021	20	118	0	7176
4741	25	107	5	7067	0	7204
4742	18	28	13	7041	0	7100
4743	13	6915	15	121	0	7064
4744	20	105	7	6943	0	7075
4745	22	22	13	6900	0	6957
4746	11	6795	20	126	0	6952
4747	16	94	9	6850	0	6969
4748	6769	20	9	136	0	6934
4749	6757	23	8	55	0	6843
4750	6619	24	8	44	0	6695
4751	6634	7	11	50	0	6702
4752	110	6403	13	31	0	6557
4753	6100	85	8	40	0	6233
4754	95	6002	8	38	0	6143
4755	26	5962	4	24	0	6016
4756	39	121	17	5871	0	6048
4757	19	19	5927	99	0	6064
4758	5691	30	85	29	0	5835
4759	5918	11	14	29	0	5972
4760	93	10	6017	32	0	6152
4761	5926	12	73	26	0	6037
4762	6123	12	10	28	0	6173
4763	94	5931	9	28	0	6062
4764	6337	81	11	34	0	6463
4765	95	18	6	6269	0	6388
4766	27	13	9	6326	0	6375
4767	24	17	10	6329	0	6380
4768	24	12	8	6316	0	6360
4769	6245	12	8	114	0	6379
4770	97	14	8	6202	0	6321
4771	33	11	3	6288	0	6335
4772	25	10	6138	109	0	6282
4773	5808	15	72	39	0	5934
4774	6205	17	14	31	0	6267
4775	6204	11	10	42	0	6267
4776	97	6054	6	31	0	6188
4777	29	6151	5	26	0	6211
4778	6114	87	4	38	0	6243
4779	95	26	8	6121	0	6250
4780	29	6189	10	92	0	6320
4781	33	76	6	6173	0	6288
4782	28	6185	6	92	0	6311
4783	6161	84	6	40	0	6291
4784	92	6188	7	37	0	6324
4785	39	90	3	6118	0	6250
4786	27	35	4	6207	0	6273
4787	29	17	6199	102	0	6347
4788	24	6385	67	33	0	6509
4789	35	105	14	6604	0	6758
4790	23	31	6767	104	0	6925
4791	14	20	6928	48	0	7010
4792	30	37	119	7112	0	7298
4793	25	8	45	7172	0	7250
4794	13	6914	24	157	0	7108
4795	20	7191	13	66	0	7290
4796	23	132	12	7184	0	7351
4797	7208	61	6	124	0	7399
4798	114	29	5	7514	0	7662
4799	7626	22	4	143	0	7795
4800	7785	19	1	92	0	7897
4801	7901	19	5	53	0	7978
4802	173	21	7871	37	0	8102
4803	7898	16	107	38	0	8059
4804	159	9	46	7925	0	8139
4805	87	8	26	8004	0	8125
4806	58	12	7862	162	0	8094
4807	34	14	7855	84	0	7987
4808	41	32	144	7702	0	7919
4809	26	7527	72	118	0	7743
4810	27	7728	33	67	0	7855
4811	41	148	24	7723	0	7936
4812	7697	65	20	132	0	7914
4813	113	34	20	7773	0	7940
4814	84	21	16	7752	0	7873
4815	39	7740	12	172	0	7963
4816	32	109	9	7889	0	8039
4817	27	59	7863	147	0	8096
4818	20	35	7542	89	0	7686
4819	7492	18	146	63	0	7719
4820	111	7630	69	49	0	7859
4821	7610	110	36	47	0	7803
4822	7680	57	21	37	0	7795
4823	165	28	20	7437	0	7650
4824	84	7554	20	113	0	7771
4825	48	109	19	7667	0	7843
4826	7559	58	14	122	0	7753
4827	105	7352	17	77	0	7551
4828	7179	95	10	59	0	7343
4829	117	7116	16	24	0	7273
4830	7160	104	10	41	0	7315
4831	7206	64	4	32	0	7306
4832	144	7132	7	17	0	7300
4833	100	108	12	7095	0	7315
4834	7127	55	11	102	0	7295
4835	122	28	6916	53	0	7119
4836	69	28	6831	44	0	6972
4837	69	92	122	6722	0	7005
4838	6750	22	70	91	0	6933
4839	103	12	30	6790	0	6935
4840	6775	11	22	115	0	6923
4841	111	20	6925	62	0	7118
4842	7005	12	84	59	0	7160
4843	7301	13	54	32	0	7400
4844	131	9	33	7233	0	7406
4845	99	10	13	7280	0	7402
4846	41	16	12	7311	0	7380
4847	40	7246	7	142	0	7435
4848	34	73	16	7243	0	7366
4849	37	44	13	7390	0	7484
4850	7292	22	11	149	0	7474
4851	7310	19	8	94	0	7431
4852	124	20	7191	49	0	7384
4853	7125	10	78	52	0	7265
4854	122	12	7184	35	0	7353
4855	6848	10	94	45	0	6997
4856	109	19	7079	28	0	7235
4857	79	12	6901	31	0	7023
4858	57	15	125	6874	0	7071
4859	38	11	6916	93	0	7058
4860	6796	18	99	73	0	6986
4861	91	14	65	7131	0	7301
4862	7230	23	28	102	0	7383
4863	7271	17	29	77	0	7394
4864	6958	13	25	45	0	7041
4865	6902	18	16	50	0	6986
4866	171	5	6839	41	0	7056
4867	118	7	82	6867	0	7074
4868	74	8	6946	88	0	7116
4869	61	6	97	6890	0	7054
4870	6945	14	54	111	0	7124
4871	102	8	47	6972	0	7129
4872	7048	7	30	125	0	7210
4873	121	4	30	7106	0	7261
4874	78	6	28	7182	0	7294
4875	7131	8	22	152	0	7313
4876	102	7084	19	97	0	7302
4877	7173	76	21	62	0	7332
4878	112	7104	11	49	0	7276
4879	78	91	18	7218	0	7405
4880	7162	48	9	115	0	7334
4881	100	29	7083	83	0	7295
4882	76	18	69	7169	0	7332
4883	7181	24	52	102	0	7359
4884	7259	6	28	88	0	7381
4885	141	22	24	7209	0	7396
4886	93	7225	22	133	0	7473
4887	63	7284	20	65	0	7432
4888	70	283	18	6841	0	7212
4889	6949	45	15	98	0	7107
4890	99	6627	16	45	0	6787
4891	32	6342	6	27	0	6407
4892	6025	71	29	17	0	6142
4893	65	5969	5	14	0	6053
4894	6200	63	19	18	0	6300
4895	80	22	11	6179	0	6292
4896	32	13	3	6215	0	6263
4897	18	6097	5	74	0	6194
4898	15	6026	3	26	0	6070
4899	5769	64	3	19	0	5855
4900	60	5877	5	13	0	5955
4901	19	6280	3	7	0	6309
4902	34	86	7	6312	0	6439
4903	6457	25	2	84	0	6568
4904	83	21	6834	25	0	6963
4905	6910	8	82	29	0	7029
4906	111	4	33	7490	0	7638
4907	36	8	7579	119	0	7742
4908	25	7	7755	38	0	7825
4909	27	5	143	7893	0	8068
4910	17	8	8140	128	0	8293
4911	8202	5	148	55	0	8410
4912	8371	7	59	37	0	8474
4913	169	3	8348	24	0	8544
4914	79	5	141	8287	0	8512
4915	50	3	57	8316	0	8426
4916	8407	5	47	175	0	8634
4917	152	4	29	8136	0	8321
4918	61	8177	18	165	0	8421
4919	8284	125	21	68	0	8498
4920	153	8185	13	45	0	8396
4921	69	8444	9	75	0	8597
4922	45	170	13	8420	0	8648
4923	53	62	7	8494	0	8616
4924	42	43	10	8532	0	8627
4925	24	28	8211	203	0	8466
4926	7793	21	129	116	0	8059
4927	135	8148	45	72	0	8400
4928	8327	138	25	58	0	8548
4929	8435	61	20	46	0	8562
4930	198	45	14	8386	0	8643
4931	86	8382	15	165	0	8648
4932	71	139	12	8614	0	8836
4933	54	61	14	8750	0	8879
4934	8758	34	11	222	0	9025
4935	8725	26	9	111	0	8871
4936	194	27	8287	69	0	8577
4937	8735	23	101	52	0	8911
4938	183	8847	38	45	0	9113
4939	8977	160	22	43	0	9202
4940	202	9320	11	31	0	9564
4941	109	169	16	9192	0	9486
4942	66	76	15	9238	0	9395
4943	55	9089	13	214	0	9371
4944	55	166	7	9355	0	9583
4945	51	69	21	9428	0	9569
4946	58	43	9	9346	0	9456
4947	43	9191	10	239	0	9483
4948	44	176	14	9339	0	9573
4949	34	85	15	9432	0	9566
4950	36	56	9	9498	0	9599
4951	36	49	9168	274	0	9527
4952	8859	37	151	160	0	9207
4953	174	26	9237	116	0	9553
4954	9159	24	180	91	0	9454
4955	187	40	9341	65	0	9633
4956	9281	29	173	81	0	9564
4957	9486	21	90	70	0	9667
4958	259	27	9426	62	0	9774
4959	122	31	169	9347	0	9669
4960	91	37	8837	187	0	9152
4961	8916	30	157	123	0	9226
4962	204	35	9390	86	0	9715
4963	122	29	9276	70	0	9497
4964	9244	16	231	86	0	9577
4965	207	9355	111	64	0	9737
4966	125	163	73	9454	0	9815
4967	9618	73	58	204	0	9953
4968	222	47	46	9625	0	9940
4969	124	42	57	9770	0	9993
4970	9635	32	55	274	0	9996
4971	9707	33	45	153	0	9938
4972	257	27	9489	101	0	9874
4973	153	16	9496	88	0	9753
4974	103	28	228	9532	0	9891
4975	84	25	9637	230	0	9976
4976	84	27	203	9585	0	9899
4977	84	26	98	9570	0	9778
4978	67	27	67	9853	0	10014
4979	9525	26	56	304	0	9911
4980	201	9571	56	169	0	9997
4981	9659	165	46	127	0	9997
4982	9710	83	45	115	0	9953
4983	255	9631	43	109	0	10038
4984	9564	177	33	97	0	9871
4985	233	90	9427	91	0	9841
4986	143	90	135	9280	0	9648
4987	9407	59	70	203	0	9739
4988	202	58	8970	128	0	9358
4989	9044	36	125	105	0	9310
4990	200	9421	59	84	0	9764
4991	10226	138	51	89	0	10504
4992	10349	73	49	66	0	10537
4993	295	10438	32	70	0	10835
4994	10715	188	41	79	0	11023
4995	291	74	43	10750	0	11158
4996	177	56	33	10963	0	11229
4997	10858	55	35	268	0	11216
4998	10743	35	25	145	0	10948
4999	294	10708	25	99	0	11126
5000	152	10690	32	86	0	10960
5001	114	290	22	10031	0	10457
5002	99	10094	33	174	0	10400
5003	85	10367	32	87	0	10571
5004	9729	189	44	67	0	10029
5005	177	9739	18	45	0	9979
5006	9279	149	15	44	0	9487
5007	136	9456	13	37	0	9642
5008	76	130	9277	27	0	9510
5009	49	9346	96	38	0	9529
5010	9072	179	71	71	0	9393
5011	8968	58	19	29	0	9074
5012	144	29	8965	10	0	9148
5013	84	36	98	8679	0	8897
5014	49	19	45	9026	0	9139
5015	41	25	8943	121	0	9130
5016	40	18	107	8837	0	9002
5017	34	21	8955	120	0	9130
5018	28	17	8781	64	0	8890
5019	8670	9	127	54	0	8860
5020	104	8850	47	37	0	9038
5021	8846	96	37	37	0	9016
5022	127	41	27	8858	0	9053
5023	63	21	8965	94	0	9143
5024	41	31	98	8726	0	8896
5025	44	8987	42	95	0	9168
5026	9078	100	24	65	0	9267
5027	9121	31	25	41	0	9218
5028	136	29	15	9080	0	9260
5029	62	20	8888	102	0	9072
5030	8608	17	85	53	0	8763
5031	119	8743	40	23	0	8925
5032	8739	99	18	30	0	8886
5033	136	44	19	8690	0	8889
5034	8706	31	18	104	0	8859
5035	144	40	19	8625	0	8828
5036	73	35	8597	117	0	8822
5037	56	25	8275	70	0	8426
5038	8299	15	98	59	0	8471
5039	120	8580	36	52	0	8788
5040	8326	82	60	37	0	8505
5041	8311	32	32	43	0	8418
5042	103	8343	18	19	0	8483
5043	8245	109	27	27	0	8408
5044	118	49	8495	30	0	8692
5045	61	44	74	8526	0	8705
5046	59	43	27	8596	0	8725
5047	67	29	13	8671	0	8780
5048	36	46	8664	106	0	8852
5049	49	24	8659	41	0	8773
5050	36	36	95	8629	0	8796
5051	25	8545	45	96	0	8711
5052	27	8897	30	37	0	8991
5053	8891	103	31	47	0	9072
5054	8957	37	27	49	0	9070
5055	106	9100	30	38	0	9274
5056	47	108	23	9257	0	9435
5057	44	44	20	9356	0	9464
5058	9420	33	32	129	0	9614
5059	111	36	19	9533	0	9699
5060	59	26	35	9477	0	9597
5061	46	25	25	9516	0	9612
5062	60	26	8994	122	0	9202
5063	47	28	8544	68	0	8687
5064	8974	18	111	65	0	9168
5065	107	14	46	9303	0	9470
5066	42	13	9226	126	0	9407
5067	33	9	9034	57	0	9133
5068	9231	19	131	64	0	9445
5069	138	11	10122	44	0	10315
5070	57	10314	145	39	0	10555
5071	53	108	57	11134	0	11352
5072	47	43	11129	143	0	11362
5073	11192	27	148	67	0	11434
5074	172	37	55	11939	0	12203
5075	80	22	11918	178	0	12198
5076	63	15	168	12198	0	12444
5077	58	17	65	12356	0	12496
5078	12272	9	48	251	0	12580
5079	175	12313	51	102	0	12641
5080	81	157	43	12308	0	12589
5081	12351	53	24	210	0	12638
5082	12472	44	19	89	0	12624
5083	12484	40	14	70	0	12608
5084	12613	25	19	54	0	12711
5085	284	27	16	12342	0	12669
5086	12223	13	20	197	0	12453
5087	12327	13	28	102	0	12470
5088	11867	13	24	101	0	12005
5089	11999	7	42	85	0	12133
5090	268	11314	26	58	0	11666
5091	88	10587	7	34	0	10716
5092	76	179	20	10488	0	10763
5093	57	10333	12	121	0	10523
5094	10253	142	14	66	0	10475
5095	154	53	7	10186	0	10400
5096	10125	25	12	139	0	10301
5097	10248	19	8	59	0	10334
5098	178	10	2	10342	0	10532
5099	83	9	12	10315	0	10419
5100	60	10198	10	156	0	10424
5101	10265	104	5	76	0	10450
5102	134	10182	11	44	0	10371
5103	10281	121	6	37	0	10445
5104	147	53	4	10324	0	10528
5105	73	33	10181	122	0	10409
5106	10118	26	102	64	0	10310
5107	9918	10	37	48	0	10013
5108	168	18	9729	25	0	9940
5109	82	15	9741	26	0	9864
5110	67	12	133	9660	0	9872
5111	10347	16	58	126	0	10547
5112	10744	13	27	77	0	10861
5113	10939	11	24	57	0	11031
5114	11118	18	14	52	0	11202
5115	206	10942	10	38	0	11196
5116	11267	137	10	54	0	11468
5117	202	55	10	11122	0	11389
5118	119	32	9	11186	0	11346
5119	79	23	9	11483	0	11594
5120	80	16	14	11630	0	11740
5121	11446	13	12	239	0	11710
5122	197	12	17	11925	0	12151
5123	99	14	11665	219	0	11997
5124	82	14	159	12040	0	12295
5125	80	16	66	12116	0	12278
5126	65	14	31	12116	0	12226
5127	72	20	26	12105	0	12223
5128	11797	8	15	301	0	12121
5129	208	11628	26	126	0	11988
5130	112	11825	19	77	0	12033
5131	82	219	13	11766	0	12080
5132	11616	85	20	218	0	11939
5133	11910	44	17	115	0	12086
5134	264	30	19	11828	0	12141
5135	125	23	11496	229	0	11873
5136	11711	26	165	123	0	12025
5137	252	20	57	12024	0	12353
5138	124	23	11967	236	0	12350
5139	11671	22	186	139	0	12018
5140	240	11861	64	99	0	12264
5141	12780	189	40	95	0	13104
5142	288	13344	33	72	0	13737
5143	188	271	12	13497	0	13968
5144	86	13913	23	283	0	14305
5145	87	367	19	14292	0	14765
5146	13981	158	13	401	0	14553
5147	320	14050	20	201	0	14591
5148	167	300	13999	140	0	14606
5149	130	185	272	14027	0	14614
5150	94	102	14070	329	0	14595
5151	87	69	335	13951	0	14442
5152	95	37	167	14278	0	14577
5153	73	44	13829	446	0	14392
5154	13038	44	307	268	0	13657
5155	326	44	13654	184	0	14208
5156	169	46	13536	113	0	13864
5157	141	13560	392	84	0	14177
5158	104	287	191	13509	0	14091
5159	69	158	130	13684	0	14041
5160	89	98	74	13446	0	13707
5161	74	63	43	13905	0	14085
5162	54	40	13317	542	0	13953
5163	12817	36	279	328	0	13460
5164	302	39	13416	200	0	13957
5165	173	36	353	13205	0	13767
5166	13084	34	169	361	0	13648
5167	314	13064	116	230	0	13724
5168	192	406	85	12586	0	13269
5169	12183	150	52	335	0	12720
5170	303	11684	62	189	0	12238
5171	153	11530	32	156	0	11871
5172	11258	324	69	109	0	11760
5173	274	11226	41	82	0	11623
5174	10642	306	56	100	0	11104
5175	307	10708	34	124	0	11173
5176	10732	284	42	65	0	11123
5177	10879	151	24	70	0	11124
5178	360	10802	37	60	0	11259
5179	205	261	29	10676	0	11171
5180	155	138	10545	252	0	11090
5181	10522	114	220	158	0	11014
5182	262	71	116	10542	0	10991
5183	165	10074	84	267	0	10590
5184	111	10539	46	174	0	10870
5185	80	290	34	10592	0	10996
5186	10466	159	47	298	0	10970
5187	249	110	10446	163	0	10968
5188	160	57	218	10592	0	11027
5189	124	59	127	10782	0	11092
5190	76	48	94	10892	0	11110
5191	70	38	54	10742	0	10904
5192	66	10339	42	407	0	10854
5193	46	235	32	10651	0	10964
5194	50	122	10323	373	0	10868
5195	52	109	10204	201	0	10566
5196	42	68	10365	164	0	10639
5197	53	54	353	10178	0	10638
5198	10004	59	197	267	0	10527
5199	239	52	10030	177	0	10498
5200	150	38	10149	138	0	10475
5201	124	49	332	10006	0	10511
5202	10013	32	199	277	0	10521
5203	240	9925	129	200	0	10494
5204	10007	227	82	148	0	10464
5205	305	130	69	9955	0	10459
5206	179	121	10092	256	0	10648
5207	139	127	226	9799	0	10291
5208	97	10084	132	305	0	10618
5209	10321	254	107	172	0	10854
5210	253	126	10294	148	0	10821
5211	148	9999	220	122	0	10489
5212	9729	252	174	82	0	10237
5213	302	171	114	9678	0	10265
5214	148	105	51	9839	0	10143
5215	9820	61	53	339	0	10273
5216	10098	42	45	223	0	10408
5217	10486	60	45	158	0	10749
5218	426	61	42	10110	0	10639
5219	246	9925	41	275	0	10487
5220	10067	219	39	187	0	10512
5221	281	9977	37	156	0	10451
5222	9618	264	33	78	0	9993
5223	307	9487	33	73	0	9900
5224	175	260	36	9280	0	9751
5225	9408	138	31	222	0	9799
5226	9514	103	21	154	0	9792
5227	9588	67	18	141	0	9814
5228	9682	49	17	92	0	9840
5229	9672	42	28	74	0	9816
5230	402	39	9297	67	0	9805
5231	275	35	186	9301	0	9797
5232	173	38	9386	195	0	9792
5233	116	40	9335	126	0	9617
5234	9235	42	286	116	0	9679
5235	9394	34	184	73	0	9685
5236	9468	31	127	55	0	9681
5237	405	42	57	9059	0	9563
5238	9127	25	50	213	0	9415
5239	330	8858	34	160	0	9382
5240	217	8965	24	129	0	9335
5241	138	8573	17	64	0	8792
5242	7631	191	47	51	0	7920
5243	161	7635	21	39	0	7856
5244	7220	114	34	23	0	7391
5245	7124	58	5	27	0	7214
5246	156	42	7079	20	0	7297
5247	113	12	88	7022	0	7235
5248	64	17	59	7306	0	7446
5249	7403	18	26	144	0	7591
5250	7446	13	15	78	0	7552
5251	192	12	16	7361	0	7581
5252	110	15	7272	120	0	7517
5253	67	21	7285	75	0	7448
5254	53	19	130	7408	0	7610
5255	64	18	74	7379	0	7535
5256	54	21	31	7510	0	7616
5257	7291	23	16	171	0	7501
5258	7370	12	19	94	0	7495
5259	188	7335	17	41	0	7581
5260	124	103	14	7404	0	7645
5261	74	62	15	7420	0	7571
5262	53	7411	16	173	0	7653
5263	68	109	17	7522	0	7716
5264	7485	76	19	143	0	7723
5265	167	41	18	7455	0	7681
5266	112	24	21	7573	0	7730
5267	7401	18	20	179	0	7618
5268	7411	21	29	99	0	7560
5269	7441	16	30	84	0	7571
5270	216	21	30	7301	0	7568
5271	125	23	7060	133	0	7341
5272	101	15	6926	91	0	7133
5273	86	21	6963	53	0	7123
5274	71	6842	148	39	0	7100
5275	6691	118	100	49	0	6958
5276	129	57	6573	49	0	6808
5277	6465	40	101	44	0	6650
5278	133	13	70	6530	0	6746
5279	6286	19	42	125	0	6472
5280	6703	27	19	78	0	6827
5281	167	6721	16	57	0	6961
5282	6857	85	16	52	0	7010
5283	6857	54	17	60	0	6988
5284	159	6797	27	51	0	7034
5285	123	88	25	6892	0	7128
5286	74	52	6883	121	0	7130
5287	57	39	91	6810	0	6997
5288	57	17	59	6919	0	7052
5289	6898	23	42	155	0	7118
5290	148	27	25	6885	0	7085
5291	87	6972	26	146	0	7231
5292	72	105	25	7026	0	7228
5293	41	58	24	7167	0	7290
5294	50	35	7005	185	0	7275
5295	66	6873	101	109	0	7149
5296	65	7065	49	76	0	7255
5297	6987	151	33	55	0	7226
5298	136	7134	20	68	0	7358
5299	84	122	23	7167	0	7396
5300	65	61	7139	136	0	7401
5301	53	7143	103	95	0	7394
5302	7190	126	58	79	0	7453
5303	153	60	43	7230	0	7486
5304	92	48	36	7338	0	7514
5305	74	25	7263	187	0	7549
5306	53	35	114	7053	0	7255
5307	58	36	65	7203	0	7362
5308	7038	21	38	198	0	7295
5309	6776	24	28	119	0	6947
5310	173	6671	22	88	0	6954
5311	6444	87	19	61	0	6611
5312	132	6322	20	47	0	6521
5313	84	186	11	5942	0	6223
5314	63	5965	19	99	0	6146
5315	53	6117	20	68	0	6258
5316	5706	149	44	60	0	5959
5317	5561	39	13	48	0	5661
5318	95	5493	19	33	0	5640
5319	5531	73	17	35	0	5656
5320	5570	32	14	41	0	5657
5321	5752	27	11	46	0	5836
5322	110	18	13	5817	0	5958
5323	5808	21	14	85	0	5928
5324	86	24	5585	48	0	5743
5325	5532	14	69	45	0	5660
5326	95	19	5766	23	0	5903
5327	58	22	69	5868	0	6017
5328	34	22	32	5993	0	6081
5329	38	28	5907	93	0	6066
5330	5682	20	62	56	0	5820
5331	5876	15	33	43	0	5967
5332	101	18	6076	32	0	6227
5333	59	25	75	5991	0	6150
5334	45	17	32	6045	0	6139
5335	35	12	14	6157	0	6218
5336	6047	14	14	116	0	6191
5337	6030	11	17	66	0	6124
5338	100	24	17	5929	0	6070
5339	47	5736	16	80	0	5879
5340	36	5637	9	45	0	5727
5341	5417	62	9	40	0	5528
5342	64	5407	13	21	0	5505
5343	28	5298	4	22	0	5352
5344	38	55	11	4933	0	5037
5345	17	9	4948	40	0	5014
5346	10	4844	37	18	0	4909
5347	13	59	16	4797	0	4885
5348	7	4779	6	39	0	4831
5349	13	30	4	4675	0	4722
5350	4693	5	3	41	0	4742
5351	30	4777	3	15	0	4825
5352	4828	27	3	18	0	4876
5353	4723	4	9	18	0	4754
5354	35	7	4711	9	0	4762
5355	4658	2	23	11	0	4694
5356	38	8	6	4762	0	4814
5357	9	6	4827	29	0	4871
5358	6	4803	22	12	0	4843
5359	17	39	6	4710	0	4772
5360	10	8	2	4735	0	4755
5361	4727	7	1	31	0	4766
5362	28	4	1	4719	0	4752
5363	7	7	1	4728	0	4743
5364	4702	6	3	35	0	4746
5365	29	4703	2	8	0	4742
5366	4643	28	1	13	0	4685
5367	31	10	4676	8	0	4725
5368	4407	3	26	15	0	4451
5369	28	9	4832	4	0	4873
5370	8	4857	22	10	0	4897
5371	4859	25	5	10	0	4899
5372	4747	8	6	9	0	4770
5373	30	4	4802	10	0	4846
5374	9	6	4827	7	0	4849
5375	11	7	4951	6	0	4975
5376	12	5138	29	6	0	5185
5377	10	30	8	5176	0	5224
5378	9	4	5511	30	0	5554
5379	9	7	5350	11	0	5377
5380	16	4	47	5473	0	5540
5381	6	4	5576	46	0	5632
5382	5591	7	43	19	0	5660
5383	6303	3	18	15	0	6339
5384	73	7	6268	8	0	6356
5385	27	6293	63	11	0	6394
5386	19	56	22	6279	0	6376
5387	12	19	6371	55	0	6457
5388	10	6306	60	21	0	6397
5389	15	59	20	6251	0	6345
5390	6298	17	18	58	0	6391
5391	6235	12	9	26	0	6282
5392	65	6338	7	18	0	6428
5393	37	50	6	6306	0	6399
5394	13	22	10	6324	0	6369
5395	13	15	3	6265	0	6296
5396	8	3	10	6324	0	6345
5397	6	7	6204	81	0	6298
5398	14	6	52	6145	0	6217
5399	6	8	6092	62	0	6168
5400	5	6000	50	26	0	6081
5401	5990	44	20	36	0	6090
5402	45	6200	21	8	0	6274
5403	21	57	2	6213	0	6293
5404	20	15	6	6215	0	6256
5405	6149	15	3	76	0	6243
5406	53	2	4	6206	0	6265
5407	22	6120	5	58	0	6205
5408	23	50	1	6233	0	6307
5409	7	21	4	6265	0	6297
5410	6200	16	1	75	0	6292
5411	47	3	6081	38	0	6169
5412	18	6000	34	18	0	6070
5413	16	6122	11	15	0	6164
5414	10	56	13	6062	0	6141
5415	5986	25	4	57	0	6072
5416	42	5956	7	28	0	6033
5417	30	47	2	6022	0	6101
5418	16	21	6000	45	0	6082
5419	9	21	41	5990	0	6061
5420	5957	7	16	67	0	6047
5421	5853	6	14	33	0	5906
5422	71	5	1	5828	0	5905
5423	5931	7	3	59	0	6000
5424	5918	8	2	40	0	5968
5425	62	6	5895	18	0	5981
5426	5640	4	48	22	0	5714
5427	64	5774	17	12	0	5867
5428	5824	49	16	8	0	5897
5429	63	21	5732	13	0	5829
5430	27	13	51	5831	0	5922
5431	5958	5	18	63	0	6044
5432	57	3	5766	24	0	5850
5433	31	10	5808	13	0	5862
5434	25	6	69	5818	0	5918
5435	9	4	5962	60	0	6035
5436	5891	4	70	30	0	5995
5437	62	4	6128	23	0	6217
5438	37	2	72	6163	0	6274
5439	25	6	26	6303	0	6360
5440	6500	3	22	101	0	6626
5441	84	2	6569	39	0	6694
5442	30	7	6922	19	0	6978
5443	28	3	103	7356	0	7490
5444	7	6	7449	96	0	7558
5445	7379	1	107	48	0	7535
5446	106	4	41	7480	0	7631
5447	39	3	7485	109	0	7636
5448	33	1	110	7518	0	7662
5449	17	5	48	7706	0	7776
5450	7664	3	29	148	0	7844
5451	115	3	7631	60	0	7809
5452	7425	8	117	35	0	7585
5453	124	6	7773	24	0	7927
5454	7645	6	123	33	0	7807
5455	7757	5	46	35	0	7843
5456	7746	6	29	33	0	7814
5457	165	7533	16	26	0	7740
5458	7620	101	18	27	0	7766
5459	7714	31	15	23	0	7783
5460	160	16	11	7659	0	7846
5461	59	15	7619	131	0	7824
5462	7453	7	115	56	0	7631
5463	130	6	7760	38	0	7934
5464	67	8	129	7687	0	7891
5465	48	5	48	7867	0	7968
5466	7844	5	36	152	0	8037
5467	134	7919	24	62	0	8139
5468	64	109	23	7887	0	8083
5469	54	40	13	7958	0	8065
5470	43	17	7891	154	0	8105
5471	32	12	116	7897	0	8057
5472	27	9	49	8027	0	8112
5473	36	2	30	7832	0	7900
5474	31	7683	23	164	0	7901
5475	7531	111	19	76	0	7737
5476	7600	37	21	69	0	7727
5477	159	7526	17	46	0	7748
5478	7200	108	16	35	0	7359
5479	147	44	15	7448	0	7654
5480	54	19	7643	137	0	7853
5481	34	7680	122	53	0	7889
5482	31	7964	41	40	0	8076
5483	7797	130	53	42	0	8022
5484	8324	33	27	34	0	8418
5485	171	23	11	8345	0	8550
5486	69	18	18	8475	0	8580
5487	54	10	13	8450	0	8527
5488	8250	11	16	197	0	8474
5489	152	13	8200	81	0	8446
5490	8288	11	134	60	0	8493
5491	167	11	51	8357	0	8586
5492	87	14	35	8294	0	8430
5493	42	8296	26	178	0	8542
5494	44	129	18	8482	0	8673
5495	53	39	21	8621	0	8734
5496	32	28	8593	201	0	8854
5497	32	8607	131	87	0	8857
5498	8757	130	47	76	0	9010
5499	8643	41	29	61	0	8774
5500	8899	22	29	35	0	8985
5501	8787	15	24	48	0	8874
5502	202	16	8544	41	0	8803
5503	8494	10	143	37	0	8684
5504	189	22	8637	38	0	8886
5505	101	12	150	8431	0	8694
5506	58	8610	55	143	0	8866
5507	50	141	30	8672	0	8893
5508	58	45	28	8845	0	8976
5509	35	28	8731	197	0	8991
5510	8529	25	138	105	0	8797
5511	8728	25	51	73	0	8877
5512	189	8610	35	65	0	8899
5513	86	131	8674	47	0	8938
5514	69	45	136	8746	0	8996
5515	57	36	8757	169	0	9019
5516	50	33	8720	78	0	8881
5517	54	27	174	8720	0	8975
5518	51	25	8713	176	0	8965
5519	54	25	161	8731	0	8971
5520	58	21	8898	185	0	9162
5521	61	24	151	8902	0	9138
5522	8916	27	64	206	0	9213
5523	8958	21	42	110	0	9131
5524	8932	19	36	94	0	9081
5525	8812	18	36	92	0	8958
5526	218	8792	33	61	0	9104
5527	111	140	38	8767	0	9056
5528	91	49	29	8900	0	9069
5529	66	39	8714	210	0	9029
5530	64	36	144	8668	0	8912
5531	50	28	8601	213	0	8892
5532	43	29	8294	108	0	8474
5533	8154	24	178	86	0	8442
5534	161	8595	75	69	0	8900
5535	8658	139	52	67	0	8916
5536	8688	56	40	71	0	8855
5537	212	8687	32	66	0	8997
5538	8722	136	40	77	0	8975
5539	191	51	8681	55	0	8978
5540	103	8548	127	48	0	8826
5541	8494	129	65	52	0	8740
5542	147	51	8006	50	0	8254
5543	7682	27	96	56	0	7861
5544	125	7949	48	52	0	8174
5545	7976	98	37	61	0	8172
5546	7984	34	39	52	0	8109
5547	142	7824	35	36	0	8037
5548	70	7766	32	37	0	7905
5549	50	8004	31	27	0	8112
5550	47	121	40	8001	0	8209
5551	48	48	32	8051	0	8179
5552	8119	25	31	136	0	8311
5553	7979	14	42	72	0	8107
5554	140	17	8010	44	0	8211
5555	66	21	7922	36	0	8045
5556	55	23	8099	40	0	8217
5557	51	15	135	8117	0	8318
5558	41	17	8229	126	0	8413
5559	52	15	129	8183	0	8379
5560	8246	15	49	146	0	8456
5561	139	16	8300	59	0	8514
5562	8218	17	111	50	0	8396
5563	8280	31	48	40	0	8399
5564	146	21	8397	42	0	8606
5565	63	8490	123	40	0	8716
5566	59	100	60	8516	0	8735
5567	43	41	8576	120	0	8780
5568	61	21	134	8516	0	8732
5569	51	24	67	9232	0	9374
5570	9044	25	43	169	0	9281
5571	153	22	37	9099	0	9311
5572	67	32	9096	139	0	9334
5573	71	25	121	9147	0	9364
5574	9249	21	52	146	0	9468
5575	158	9311	34	60	0	9563
5576	9373	123	39	41	0	9576
5577	177	94	57	9239	0	9567
5578	96	37	9262	128	0	9523
5579	52	27	9052	47	0	9178
5580	64	25	8904	40	0	9033
5581	39	8594	128	25	0	8786
5582	8201	140	121	51	0	8513
5583	93	7938	21	13	0	8065
5584	7430	68	18	23	0	7539
5585	75	7380	13	11	0	7479
5586	32	70	15	7494	0	7611
5587	18	17	8	7534	0	7577
5588	13	11	6	7538	0	7568
5589	11	7486	13	80	0	7590
5590	20	73	7	7708	0	7808
5591	23	19	10	8410	0	8462
5592	8808	10	6	120	0	8944
5593	132	4	7	9206	0	9349
5594	31	14	9774	129	0	9948
5595	9712	8	142	49	0	9911
5596	10053	13	38	32	0	10136
5597	177	10211	17	22	0	10427
5598	10263	153	6	27	0	10449
5599	10598	42	10	23	0	10673
5600	221	21	9	10484	0	10735
5601	80	10	14	10740	0	10844
5602	61	9	11	10972	0	11053
5603	10900	5	12	237	0	11154
5604	10981	15	10	86	0	11092
5605	236	8	10826	32	0	11102
5606	10811	9	166	43	0	11029
5607	10990	7	44	33	0	11074
5608	10976	8	24	35	0	11043
5609	251	8	10630	29	0	10918
5610	91	10	10785	22	0	10908
5611	78	4	205	10783	0	11070
5612	34	7	10999	199	0	11239
5613	62	7	196	10811	0	11076
5614	80	14	59	10249	0	10402
5615	52	10934	27	200	0	11213
5616	10965	180	35	73	0	11253
5617	209	38	11042	53	0	11342
5618	11217	22	191	52	0	11482
5619	259	14	68	11367	0	11708
5620	11214	11	36	229	0	11490
5621	233	11045	32	83	0	11393
5622	105	11479	30	50	0	11664
5623	96	230	20	11362	0	11708
5624	71	72	34	11583	0	11760
5625	60	38	11377	273	0	11748
5626	56	30	197	11408	0	11691
5627	11180	20	63	264	0	11527
5628	226	11228	49	103	0	11606
5629	110	196	11227	51	0	11584
5630	90	68	200	11217	0	11575
5631	77	29	11356	234	0	11696
5632	84	30	224	11297	0	11635
5633	62	20	11410	240	0	11732
5634	51	32	11147	92	0	11322
5635	52	24	259	11152	0	11487
5636	11201	16	131	243	0	11591
5637	11134	21	60	125	0	11340
5638	10967	23	60	87	0	11137
5639	285	10860	35	79	0	11259
5640	10976	192	51	62	0	11281
5641	10923	63	51	56	0	11093
5642	284	32	10689	60	0	11065
5643	121	10607	208	58	0	10994
5644	126	195	71	10480	0	10872
5645	10428	74	48	219	0	10769
5646	221	10457	49	83	0	10810
5647	10641	199	31	84	0	10955
5648	10723	72	33	66	0	10894
5649	10657	41	43	70	0	10811
5650	10607	48	34	66	0	10755
5651	312	33	27	10320	0	10692
5652	10386	42	34	222	0	10684
5653	262	28	37	10223	0	10550
5654	110	10068	38	228	0	10444
5655	95	165	46	10211	0	10517
5656	10178	56	34	245	0	10513
5657	229	31	10106	100	0	10466
5658	118	36	190	10167	0	10511
5659	10128	17	69	241	0	10455
5660	237	9999	57	104	0	10397
5661	10081	181	49	80	0	10391
5662	10218	63	43	80	0	10404
5663	279	10157	34	63	0	10533
5664	10098	183	42	52	0	10375
5665	269	71	9693	52	0	10085
5666	136	44	9586	46	0	9812
5667	9432	60	204	50	0	9746
5668	248	32	9479	66	0	9825
5669	120	42	190	8806	0	9158
5670	98	8804	73	164	0	9139
5671	9070	155	47	66	0	9338
5672	213	8898	44	49	0	9204
5673	131	8417	36	50	0	8634
5674	128	186	21	9125	0	9460
5675	92	73	37	9155	0	9357
5676	99	41	25	9084	0	9249
5677	65	34	39	9133	0	9271
5678	69	36	8856	229	0	9190
5679	68	34	143	8666	0	8911
5680	62	30	59	8767	0	8918
5681	8594	30	45	226	0	8895
5682	176	31	26	8645	0	8878
5683	97	31	8396	188	0	8712
5684	8271	36	140	101	0	8548
5685	211	29	50	8430	0	8720
5686	99	33	8552	175	0	8859
5687	87	71	151	8427	0	8736
5688	87	8587	58	154	0	8886
5689	8604	148	55	89	0	8896
5690	181	54	8404	39	0	8678
5691	71	7632	117	50	0	7870
5692	7178	104	82	33	0	7397
5693	106	6652	30	40	0	6828
5694	41	6158	20	23	0	6242
5695	6004	72	80	20	0	6176
5696	62	5815	26	10	0	5913
5697	27	5739	14	9	0	5789
5698	69	71	50	5555	0	5745
5699	15	26	5487	36	0	5564
5700	11	5527	29	22	0	5589
5701	17	46	16	5362	0	5441
5702	9	5271	6	25	0	5311
5703	5207	23	5	19	0	5254
5704	25	13	5143	16	0	5197
5705	20	14	19	5176	0	5229
5706	5324	4	16	32	0	5376
5707	25	2	9	5373	0	5409
5708	15	8	5362	27	0	5412
5709	5126	4	18	24	0	5172
5710	5412	5	12	17	0	5446
5711	36	5632	7	10	0	5685
5712	19	24	7	5649	0	5699
5713	11	14	8	5717	0	5750
5714	5779	7	6	38	0	5830
5715	5645	3	6	23	0	5677
5716	33	5	5793	8	0	5839
5717	21	5647	17	4	0	5689
5718	5634	14	7	8	0	5663
5719	22	14	3	5609	0	5648
5720	14	7	5789	14	0	5824
5721	8	6	5533	7	0	5554
5722	17	49	21	5551	0	5638
5723	5638	1	10	16	0	5665
5724	9	5575	2	15	0	5601
5725	6032	10	2	14	0	6058
5726	13	3	1	6110	0	6127
5727	7	1	0	6156	0	6164
5728	5	1	0	6213	0	6219
5729	6278	3	0	25	0	6306
5730	10	6344	1	10	0	6365
5731	6	9	1	6446	0	6462
5732	2	6	0	6421	0	6429
5733	2	1	6391	15	0	6409
5734	7	1	12	6285	0	6305
5735	4	3	6408	13	0	6428
5736	3	6249	12	8	0	6272
5737	6	12	3	6378	0	6399
5738	6290	3	1	17	0	6311
5739	11	5	6218	3	0	6237
5740	9	1	13	6243	0	6266
5741	1	3	6216	16	0	6236
5742	5921	2	12	17	0	5952
5743	16	6	6306	4	0	6332
5744	9	2	11	6109	0	6131
5745	6283	2	4	13	0	6302
5746	18	5448	10	7	0	5483
5747	6044	13	1	6	0	6064
5748	23	5513	9	6	0	5551
5749	4	12	3	6272	0	6291
5750	4	6	6205	14	0	6229
5751	7	3	5941	5	0	5956
5752	9	3	17	6262	0	6291
5753	6419	3	6	16	0	6444
5754	6246	0	1	16	0	6263
5755	20	1	2	6331	0	6354
5756	7	2	1	6398	0	6408
5757	6296	1	1	26	0	6324
5758	17	6154	4	3	0	6178
5759	4	6501	1	8	0	6514
5760	6685	20	1	14	0	6720
5761	19	7	6654	3	0	6683
5762	13	0	17	6626	0	6656
5763	4	2	6574	17	0	6597
5764	4	2	15	6600	0	6621
5765	5	3	6650	18	0	6676
5766	5	3	6497	8	0	6513
5767	7	1	24	6796	0	6828
5768	1	6445	10	19	0	6475
5769	6884	16	2	11	0	6913
5770	19	6846	4	6	0	6875
5771	9	18	3	7022	0	7052
5772	7091	7	0	27	0	7125
5773	22	4	2	7199	0	7227
5774	7269	3	1	31	0	7304
5775	7210	1	1	13	0	7225
5776	7285	2	0	11	0	7298
5777	27	7061	3	5	0	7096
5778	7393	16	2	14	0	7425
5779	21	12	3	7534	0	7570
5780	7775	2	1	26	0	7804
5781	25	1	3	7934	0	7963
5782	8025	2	1	34	0	8062
5783	8072	2	3	19	0	8096
5784	37	8012	4	18	0	8071
5785	19	25	2	8759	0	8805
5786	8	10	1	8799	0	8818
5787	5	9198	2	59	0	9264
5788	6	70	3	9545	0	9624
5789	9577	18	4	84	0	9683
5790	10015	15	2	34	0	10066
5791	9935	4	3	38	0	9980
5792	104	3	10311	12	0	10430
5793	10655	3	69	27	0	10754
5794	11097	2	21	25	0	11145
5795	11210	2	16	20	0	11248
5796	123	11078	8	11	0	11220
5797	63	83	3	11209	0	11358
5798	41	25	1	11367	0	11434
5799	29	18	2	11275	0	11324
5800	19	12	11063	127	0	11221
5801	22	8	85	11131	0	11246
5802	11258	4	30	138	0	11430
5803	119	2	22	11290	0	11433
5804	55	4	8	11617	0	11684
5805	36	11	11420	146	0	11613
5806	22	11238	100	62	0	11422
5807	11700	103	32	50	0	11885
5808	120	32	17	11717	0	11886
5809	11705	22	13	131	0	11871
5810	134	15	11411	57	0	11617
5811	10933	3	107	55	0	11098
5812	134	11538	36	40	0	11748
5813	64	107	11502	26	0	11699
5814	35	39	11521	28	0	11623
5815	46	40	142	11201	0	11429
5816	26	19	11796	116	0	11957
5817	25	11653	124	52	0	11854
5818	48	101	41	11544	0	11734
5819	26	43	36	11793	0	11898
5820	35	27	19	11721	0	11802
5821	11531	17	14	178	0	11740
5822	111	11519	16	83	0	11729
5823	55	112	17	11714	0	11898
5824	37	38	19	11823	0	11917
5825	11499	26	19	159	0	11703
5826	122	11409	11	111	0	11653
5827	11566	105	19	66	0	11756
5828	11508	45	33	62	0	11648
5829	11452	27	16	58	0	11553
5830	177	23	11233	32	0	11465
5831	96	25	104	11073	0	11298
5832	55	11203	43	134	0	11435
5833	40	11370	32	74	0	11516
5834	57	137	19	11247	0	11460
5835	51	11116	17	126	0	11310
5836	11754	150	22	71	0	11997
5837	137	60	11704	57	0	11958
5838	11550	28	111	68	0	11757
5839	12022	26	47	58	0	12153
5840	196	28	37	12064	0	12325
5841	12110	33	28	148	0	12319
5842	171	12611	24	73	0	12879
5843	12836	125	17	107	0	13085
5844	12933	51	22	88	0	13094
5845	13856	46	31	71	0	14004
5846	244	49	14038	49	0	14380
5847	141	32	14073	57	0	14303
5848	125	39	194	14202	0	14560
5849	87	13953	96	192	0	14328
5850	89	14454	71	89	0	14703
5851	79	212	35	14348	0	14674
5852	14434	105	32	225	0	14796
5853	210	59	35	14440	0	14744
5854	108	41	30	14702	0	14881
5855	14543	40	43	292	0	14918
5856	209	14526	38	152	0	14925
5857	126	174	14542	111	0	14953
5858	106	91	14328	81	0	14606
5859	14534	68	208	105	0	14915
5860	202	46	128	14421	0	14797
5861	114	48	14576	205	0	14943
5862	97	58	182	14372	0	14709
5863	80	35	88	14381	0	14584
5864	78	34	59	14687	0	14858
5865	87	31	49	14490	0	14657
5866	65	14191	55	269	0	14580
5867	76	185	37	14412	0	14710
5868	14240	75	52	284	0	14651
5869	203	14202	57	136	0	14598
5870	14461	187	59	124	0	14831
5871	14598	88	43	108	0	14837
5872	14647	86	41	86	0	14860
5873	290	62	14232	87	0	14671
5874	14254	46	186	99	0	14585
5875	14624	41	78	78	0	14821
5876	14364	40	56	108	0	14568
5877	14574	46	39	88	0	14747
5878	292	14410	39	89	0	14830
5879	14341	193	25	84	0	14643
5880	268	97	14188	58	0	14611
5881	165	65	171	13941	0	14342
5882	138	50	74	14249	0	14511
5883	14401	35	53	250	0	14739
5884	256	14197	32	116	0	14601
5885	13819	159	27	89	0	14094
5886	219	13718	37	55	0	14029
5887	13340	147	26	46	0	13559
5888	13191	52	11	51	0	13305
5889	201	13778	9	25	0	14013
5890	13772	163	30	42	0	14007
5891	14335	61	38	39	0	14473
5892	264	13369	13	23	0	13669
5893	106	13809	18	24	0	13957
5894	14687	223	63	30	0	15003
5895	309	89	13	15156	0	15567
5896	15355	45	10	269	0	15679
5897	15924	31	10	93	0	16058
5898	16401	29	9	69	0	16508
5899	16429	24	9	50	0	16512
5900	404	15794	17	38	0	16253
5901	180	16403	14	33	0	16630
5902	16392	299	21	45	0	16757
5903	330	129	16360	21	0	16840
5904	176	74	255	15983	0	16488
5905	104	42	92	16417	0	16655
5906	16124	47	49	347	0	16567
5907	301	15950	29	167	0	16447
5908	166	269	30	15972	0	16437
5909	107	113	20	16442	0	16682
5910	16304	60	18	408	0	16790
5911	358	40	20	16432	0	16850
5912	16462	43	18	383	0	16906
5913	16556	50	18	193	0	16817
5914	16645	48	14	126	0	16833
5915	489	36	18	16426	0	16969
5916	250	34	18	16575	0	16877
5917	155	34	17120	417	0	17726
5918	136	22	17003	199	0	17360
5919	17253	34	415	127	0	17829
5920	425	37	155	17684	0	18301
5921	210	36	18466	401	0	19113
5922	158	39	18701	181	0	19079
5923	137	35	505	18771	0	19448
5924	127	36	18865	453	0	19481
5925	132	41	447	18853	0	19473
5926	139	41	207	19053	0	19440
5927	104	38	18908	584	0	19634
5928	137	36	431	19095	0	19699
5929	149	38	196	18617	0	19000
5930	132	32	124	19612	0	19900
5931	107	38	18979	661	0	19785
5932	126	28	427	19448	0	20029
5933	19296	36	179	588	0	20099
5934	471	19319	109	315	0	20214
5935	19538	396	84	226	0	20244
5936	521	173	19224	169	0	20087
5937	19471	84	442	174	0	20171
5938	19805	65	204	177	0	20251
5939	19691	61	120	136	0	20008
5940	712	70	107	19118	0	20007
5941	376	52	97	19474	0	19999
5942	245	56	18261	629	0	19191
5943	17687	47	447	332	0	18513
5944	555	17730	211	204	0	18700
5945	280	16906	120	156	0	17462
5946	178	17163	89	190	0	17620
5947	270	521	133	16413	0	17337
5948	16279	192	113	474	0	17058
5949	16486	109	82	276	0	16953
5950	569	96	15962	187	0	16814
5951	319	92	393	16042	0	16846
5952	216	101	179	16300	0	16796
5953	198	69	15871	610	0	16748
5954	165	81	15566	292	0	16104
5955	15560	58	474	249	0	16341
5956	488	15710	213	215	0	16626
5957	15865	370	150	202	0	16587
5958	16040	167	111	192	0	16510
5959	624	85	120	15686	0	16515
5960	321	69	101	16071	0	16562
5961	15635	75	80	627	0	16417
5962	553	76	89	15655	0	16373
5963	339	61	106	15866	0	16372
5964	15665	56	96	644	0	16461
5965	555	59	91	15744	0	16449
5966	15774	48	85	594	0	16501
5967	16007	40	89	374	0	16510
5968	610	37	15479	260	0	16386
5969	15590	40	422	240	0	16292
5970	15754	47	220	218	0	16239
5971	15708	39	146	225	0	16118
5972	668	87	11830	242	0	12827
5973	14975	47	308	198	0	15528
5974	540	14683	184	281	0	15688
5975	15172	339	135	206	0	15852
5976	15419	143	128	191	0	15881
5977	664	58	109	15122	0	15953
5978	381	39	105	15211	0	15736
5979	276	14977	87	611	0	15951
5980	247	354	91	15210	0	15902
5981	252	157	90	15538	0	16037
5982	15093	79	96	653	0	15921
5983	559	81	82	14992	0	15714
5984	385	58	66	15104	0	15613
5985	275	73	69	15003	0	15420
5986	233	14353	75	670	0	15331
5987	14281	383	87	365	0	15116
5988	550	14239	83	252	0	15124
5989	13510	356	97	225	0	14188
5990	549	169	12901	199	0	13818
5991	12331	88	312	200	0	12931
5992	451	85	12326	192	0	13054
5993	276	11898	337	185	0	12696
5994	10826	311	374	150	0	11661
5995	10528	136	104	132	0	10900
5996	384	9937	88	104	0	10513
5997	221	9922	62	107	0	10312
5998	9499	246	105	108	0	9958
5999	9582	110	48	108	0	9848
6000	340	73	47	9420	0	9880
6001	216	66	39	9612	0	9933
6002	148	72	9327	287	0	9834
6003	9248	59	185	134	0	9626
6004	305	43	86	9244	0	9678
6005	177	9238	63	251	0	9729
6006	139	189	56	9311	0	9695
6007	134	93	34	9396	0	9657
6008	119	59	9090	313	0	9581
6009	118	77	166	9115	0	9476
6010	9059	46	78	283	0	9466
6011	236	8825	49	159	0	9269
6012	149	8759	40	118	0	9066
6013	8743	237	44	108	0	9132
6014	8807	120	42	88	0	9057
6015	8758	71	29	90	0	8948
6016	312	8345	42	79	0	8778
6017	120	7871	20	50	0	8061
6018	8331	161	54	44	0	8590
6019	8422	68	41	41	0	8572
6020	225	7969	37	38	0	8269
6021	59	7149	11	31	0	7250
6022	6944	108	40	29	0	7121
6023	117	39	6	6838	0	7000
6024	6874	13	10	109	0	7006
6025	127	21	2	6930	0	7080
6026	46	6994	2	100	0	7142
6027	30	7150	3	40	0	7223
6028	7349	127	12	22	0	7510
6029	7457	45	16	24	0	7542
6030	7656	27	9	24	0	7716
6031	164	7583	8	23	0	7778
6032	54	115	7276	6	0	7451
6033	29	7267	86	11	0	7393
6034	7070	132	40	24	0	7266
6035	6931	31	16	17	0	6995
6036	135	25	6897	9	0	7066
6037	40	6801	89	5	0	6935
6038	37	103	33	6764	0	6937
6039	37	39	15	6683	0	6774
6040	34	6008	6	119	0	6167
6041	34	106	6657	27	0	6824
6042	6783	29	96	20	0	6928
6043	122	32	29	6879	0	7062
6044	6913	19	10	112	0	7054
6045	7021	15	13	46	0	7095
6046	144	28	12	7123	0	7307
6047	68	19	17	7509	0	7613
6048	55	19	10	7714	0	7798
6049	33	20	11	7808	0	7872
6050	7687	16	7	182	0	7892
6051	7777	20	10	80	0	7887
6052	177	16	7750	49	0	7992
6053	74	28	111	7770	0	7983
6054	49	17	46	7901	0	8013
6055	51	18	18	7957	0	8044
6056	50	15	7731	183	0	7979
6057	55	15	125	7661	0	7856
6058	7587	17	54	164	0	7822
6059	147	16	24	7629	0	7816
6060	70	19	7626	172	0	7887
6061	50	18	117	7690	0	7875
6062	34	16	7721	168	0	7939
6063	7843	14	138	93	0	8088
6064	164	13	47	7889	0	8113
6065	7894	13	31	157	0	8095
6066	7872	10	28	82	0	7992
6067	191	18	16	7795	0	8020
6068	8008	14	24	170	0	8216
6069	170	15	18	7956	0	8159
6070	73	8194	20	167	0	8454
6071	8465	123	11	79	0	8678
6072	8526	51	18	51	0	8646
6073	8632	26	20	50	0	8728
6074	226	22	17	8481	0	8746
6075	95	18	18	8580	0	8711
6076	67	22	16	8607	0	8712
6077	53	21	8223	225	0	8522
6078	62	8129	130	101	0	8422
6079	74	125	41	8079	0	8319
6080	46	49	8029	167	0	8291
6081	7975	24	127	97	0	8223
6082	148	15	48	8096	0	8307
6083	72	20	8004	162	0	8258
6084	8126	17	115	89	0	8347
6085	156	9	45	8299	0	8509
6086	84	11	33	8395	0	8523
6087	75	10	21	8473	0	8579
6088	8400	11	14	220	0	8645
6089	8429	5	21	110	0	8565
6090	8351	10	24	74	0	8459
6091	181	8051	27	61	0	8320
6092	85	8211	19	61	0	8376
6093	8220	124	23	60	0	8427
6094	171	42	8150	41	0	8404
6095	102	27	105	8041	0	8275
6096	63	21	51	8193	0	8328
6097	8077	16	27	181	0	8301
6098	7903	22	17	112	0	8054
6099	171	7895	21	59	0	8146
6100	90	105	22	7972	0	8189
6101	63	40	7866	150	0	8119
6102	62	27	7867	90	0	8046
6103	78	15	131	8024	0	8248
6104	62	16	54	8192	0	8324
6105	8059	22	30	195	0	8306
6106	142	15	27	8172	0	8356
6107	8347	18	31	177	0	8573
6108	8313	13	28	114	0	8468
6109	178	17	8159	80	0	8434
6110	8300	7	90	76	0	8473
6111	8414	8	49	63	0	8534
6112	8418	14	32	69	0	8533
6113	188	8213	21	73	0	8495
6114	95	8283	23	61	0	8462
6115	72	161	33	8203	0	8469
6116	53	45	8198	155	0	8451
6117	56	7901	90	91	0	8138
6118	60	126	55	7368	0	7609
6119	60	34	28	7251	0	7373
6120	40	7203	16	122	0	7381
6121	7244	77	17	72	0	7410
6122	7287	32	26	49	0	7394
6123	121	22	7403	38	0	7584
6124	7285	7	79	49	0	7420
6125	103	11	7261	54	0	7429
6126	6773	15	64	41	0	6893
6127	112	16	6934	33	0	7095
6128	63	6749	65	23	0	6900
6129	79	47	60	6434	0	6620
6130	39	25	26	6435	0	6525
6131	6494	9	15	75	0	6593
6132	6502	11	9	55	0	6577
6133	6448	8	11	39	0	6506
6134	72	15	6547	26	0	6660
6135	48	8	38	6562	0	6656
6136	34	6	28	6653	0	6721
6137	6625	7	17	62	0	6711
6138	67	6622	11	45	0	6745
6139	6822	38	15	39	0	6914
6140	70	22	9	6930	0	7031
6141	44	9	8	7015	0	7076
6142	36	8	9	7000	0	7053
6143	32	13	10	7043	0	7098
6144	30	20	5	7016	0	7071
6145	24	6770	13	85	0	6892
6146	22	6534	8	44	0	6608
6147	13	6323	5	23	0	6364
6148	15	35	7	6269	0	6326
6149	10	6	6196	37	0	6249
6150	5764	7	25	27	0	5823
6151	32	6321	6	11	0	6370
6152	23	21	5	6329	0	6378
6153	21	5	4	6416	0	6446
6154	6541	4	7	43	0	6595
6155	6479	1	6	23	0	6509
6156	6649	4	3	17	0	6673
6157	47	5	4	6937	0	6993
6158	13	7	6990	39	0	7049
6159	8	5	7161	10	0	7184
6160	12	6	39	7227	0	7284
6161	8	2	7260	38	0	7308
6162	6984	4	43	21	0	7052
6163	49	3	8	7047	0	7107
6164	10	2	7114	43	0	7169
6165	24	4	33	7009	0	7070
6166	7	5	7377	45	0	7434
6167	13	4	7684	8	0	7709
6168	20	11	43	7975	0	8049
6169	10	5	8442	50	0	8507
6170	7	3	8130	21	0	8161
6171	5	7886	79	14	0	7984
6172	41	70	37	8169	0	8317
6173	8595	23	14	67	0	8699
6174	63	11	8	8535	0	8617
6175	42	5	5	8807	0	8859
6176	16	8	8788	91	0	8903
6177	8381	1	63	58	0	8503
6178	62	2	27	8915	0	9006
6179	33	2	18	9079	0	9132
6180	8969	4	13	95	0	9081
6181	69	2	7	9044	0	9122
6182	9093	3	5	93	0	9194
6183	9080	1	5	59	0	9145
6184	9046	1	5	39	0	9091
6185	92	8894	11	18	0	9015
6186	9043	59	7	18	0	9127
6187	79	9038	11	11	0	9139
6188	43	73	3	9159	0	9278
6189	9257	32	3	80	0	9372
6190	69	9260	8	44	0	9381
6191	9337	67	3	45	0	9452
6192	80	9287	11	22	0	9400
6193	9277	76	10	17	0	9380
6194	89	9215	6	13	0	9323
6195	50	9407	7	11	0	9475
6196	28	9934	3	31	0	9996
6197	28	107	2	9807	0	9944
6198	14	10079	6	75	0	10174
6199	25	97	9	9990	0	10121
6200	21	47	8	10091	0	10167
6201	24	23	6	10053	0	10106
6202	25	17	6	10079	0	10127
6203	10043	11	3	143	0	10200
6204	10159	10	4	74	0	10247
6205	116	20	10159	32	0	10327
6206	10420	13	80	43	0	10556
6207	10743	16	37	29	0	10825
6208	11112	14	18	30	0	11174
6209	157	13	10921	16	0	11107
6210	71	18	11059	21	0	11169
6211	11152	14	136	29	0	11331
6212	142	15	11552	26	0	11735
6213	60	12194	134	21	0	12409
6214	56	146	49	12351	0	12602
6215	12716	43	29	158	0	12946
6216	12796	32	19	72	0	12919
6217	12868	19	15	63	0	12965
6218	232	11	11	12790	0	13044
6219	102	12	20	12998	0	13132
6220	63	14	13033	193	0	13303
6221	57	10	144	13111	0	13322
6222	55	12	57	13317	0	13441
6223	13054	13	36	220	0	13323
6224	168	13139	28	86	0	13421
6225	13266	141	15	76	0	13498
6226	200	55	16	13356	0	13627
6227	13226	29	17	169	0	13441
6228	13152	24	19	93	0	13288
6229	12882	13	24	83	0	13002
6230	221	12755	14	49	0	13039
6231	96	13085	22	46	0	13249
6232	92	168	10	13130	0	13400
6233	13224	73	18	171	0	13486
6234	187	48	22	13053	0	13310
6235	94	32	18	13205	0	13349
6236	63	17	13076	235	0	13391
6237	70	22	140	13029	0	13261
6238	62	17	53	13130	0	13262
6239	56	20	30	13144	0	13250
6240	53	22	12871	223	0	13169
6241	48	24	12679	108	0	12859
6242	38	12789	171	92	0	13090
6243	12859	142	72	74	0	13147
6244	180	57	47	12982	0	13266
6245	82	30	13031	188	0	13331
6246	76	25	154	13002	0	13257
6247	59	20	60	13586	0	13725
6248	13466	17	27	264	0	13774
6249	13440	13	37	130	0	13620
6250	224	13386	25	80	0	13715
6251	13333	146	36	68	0	13583
6252	13329	62	27	49	0	13467
6253	239	45	28	13225	0	13537
6254	113	41	13095	166	0	13415
6255	61	13136	157	102	0	13456
6256	13056	144	67	87	0	13354
6257	13182	60	33	82	0	13357
6258	222	13318	35	41	0	13616
6259	123	155	19	13625	0	13922
6260	14063	67	16	216	0	14362
6261	14217	30	21	100	0	14368
6262	262	34	14	14298	0	14608
6263	14295	25	25	270	0	14615
6264	15250	19	31	117	0	15417
6265	15493	35	37	90	0	15655
6266	324	32	15372	62	0	15790
6267	156	14931	180	66	0	15333
6268	101	15292	61	64	0	15518
6269	14841	230	61	75	0	15207
6270	236	15021	38	51	0	15346
6271	120	219	14994	44	0	15377
6272	103	92	186	15021	0	15402
6273	15013	48	65	230	0	15356
6274	260	45	40	14979	0	15324
6275	15038	33	31	259	0	15361
6276	15106	38	21	127	0	15292
6277	15123	30	18	88	0	15259
6278	300	14683	27	67	0	15077
6279	142	15316	32	51	0	15541
6280	15291	233	18	78	0	15620
6281	15104	93	24	77	0	15298
6282	15345	43	28	74	0	15490
6283	310	50	17	15127	0	15504
6284	15043	32	29	243	0	15347
6285	280	14687	24	111	0	15102
6286	151	15145	22	69	0	15387
6287	110	233	20	15012	0	15375
6288	94	110	14835	226	0	15265
6289	87	67	14744	100	0	14998
6290	99	41	232	14817	0	15189
6291	85	40	14841	234	0	15200
6292	86	49	212	14832	0	15179
6293	14944	42	81	264	0	15331
6294	276	31	43	14888	0	15238
6295	14683	40	56	252	0	15031
6296	243	14240	35	124	0	14642
6297	127	203	14292	76	0	14698
6298	110	82	196	14037	0	14425
6299	87	60	84	14407	0	14638
6300	71	54	14324	273	0	14722
6301	71	42	205	14068	0	14386
6302	73	14351	87	218	0	14729
6303	81	201	38	14529	0	14849
6304	80	84	41	14670	0	14875
6305	101	36	25	14941	0	15103
6306	88	40	14778	316	0	15222
6307	71	29	14188	141	0	14429
6308	13338	23	256	112	0	13729
6309	248	47	13615	64	0	13974
6310	107	13553	234	51	0	13945
6311	13430	175	98	64	0	13767
6312	226	13522	48	49	0	13845
6313	12920	187	89	45	0	13241
6314	12961	79	52	56	0	13148
6315	12763	52	29	52	0	12896
6316	12763	39	26	51	0	12879
6317	266	12345	23	42	0	12676
6318	113	12537	26	31	0	12707
6319	12544	195	28	39	0	12806
6320	221	95	12276	40	0	12632
6321	116	51	168	12134	0	12469
6322	76	30	75	12428	0	12609
6323	64	38	12285	232	0	12619
6324	11769	28	194	101	0	12092
6325	12312	34	74	60	0	12480
6326	12236	37	41	56	0	12370
6327	273	12034	42	41	0	12390
6328	12464	181	30	53	0	12728
6329	260	74	29	12201	0	12564
6330	126	12828	30	181	0	13165
6331	13145	219	27	94	0	13485
6332	13349	101	17	67	0	13534
6333	14055	61	25	50	0	14191
6334	378	41	23	13801	0	14243
6335	194	41	14	13904	0	14153
6336	102	13597	33	313	0	14045
6337	85	219	13731	145	0	14180
6338	108	102	225	13785	0	14220
6339	103	58	105	13676	0	13942
6340	81	43	53	14306	0	14483
6341	71	34	14038	368	0	14511
6342	13880	33	240	182	0	14335
6343	295	42	110	14210	0	14657
6344	158	40	14298	285	0	14781
6345	113	31	259	14263	0	14666
6346	14482	25	115	323	0	14945
6347	295	14467	76	161	0	14999
6348	162	260	46	14801	0	15269
6349	102	115	14804	308	0	15329
6350	14402	65	275	170	0	14912
6351	14800	40	134	123	0	15097
6352	370	34	14694	100	0	15198
6353	219	61	286	13938	0	14504
6354	94	14493	137	255	0	14979
6355	14627	260	95	142	0	15124
6356	320	118	14348	96	0	14882
6357	14159	66	277	96	0	14598
6358	361	56	14054	65	0	14536
6359	202	35	13417	65	0	13719
6360	12888	42	367	74	0	13371
6361	285	13204	159	55	0	13703
6362	201	228	13006	61	0	13496
6363	117	12664	259	71	0	13111
6364	117	248	12225	62	0	12652
6365	74	12162	232	48	0	12516
6366	11520	242	159	84	0	12005
6367	228	103	11367	51	0	11749
6368	135	62	11153	54	0	11404
6369	91	38	10946	34	0	11109
6370	10475	58	304	41	0	10878
6371	10598	24	128	39	0	10789
6372	252	27	65	10374	0	10718
6373	116	22	10633	180	0	10951
6374	80	21	10635	93	0	10829
6375	10548	31	236	62	0	10877
6376	211	21	127	10666	0	11025
6377	10661	25	77	189	0	10952
6378	10740	15	60	98	0	10913
6379	268	37	42	10261	0	10608
6380	151	10223	47	178	0	10599
6381	89	167	53	10368	0	10677
6382	86	89	39	10504	0	10718
6383	68	53	10331	243	0	10695
6384	71	10094	189	127	0	10481
6385	69	10356	108	88	0	10621
6386	65	222	66	10128	0	10481
6387	56	98	10183	182	0	10519
6388	51	10111	203	109	0	10474
6389	77	165	10199	70	0	10511
6390	9935	97	217	78	0	10327
6391	10271	59	121	56	0	10507
6392	256	39	10142	42	0	10479
6393	10097	35	205	59	0	10396
6394	233	42	119	10202	0	10596
6395	126	10581	77	173	0	10957
6396	104	158	72	10658	0	10992
6397	10466	93	60	217	0	10836
6398	10587	48	75	104	0	10814
6399	10569	51	68	65	0	10753
6400	10434	35	50	69	0	10588
6401	273	10070	73	53	0	10469
6402	136	10121	64	33	0	10354
6403	10080	191	55	41	0	10367
6404	218	101	10069	40	0	10428
6405	136	255	172	9742	0	10305
6406	67	10309	105	159	0	10640
6407	89	152	61	10264	0	10566
6408	44	10593	53	177	0	10867
6409	51	186	46	10709	0	10992
6410	44	97	10670	198	0	11009
6411	10522	47	179	126	0	10874
6412	10661	32	104	59	0	10856
6413	248	47	10549	38	0	10882
6414	10553	34	189	43	0	10819
6415	10668	32	110	47	0	10857
6416	272	35	10440	31	0	10778
6417	152	33	188	10268	0	10641
6418	10474	28	107	181	0	10790
6419	213	22	10434	101	0	10770
6420	136	32	190	10237	0	10595
6421	77	32	10673	178	0	10960
6422	65	30	10514	113	0	10722
6423	10524	47	255	67	0	10893
6424	10888	29	139	46	0	11102
6425	11022	23	69	40	0	11154
6426	11363	25	47	36	0	11471
6427	302	36	38	10976	0	11352
6428	158	10529	41	192	0	10920
6429	99	10783	39	105	0	11026
6430	77	244	48	10268	0	10637
6431	10259	82	38	168	0	10547
6432	199	9943	26	78	0	10246
6433	77	9685	23	33	0	9818
6434	9665	176	18	23	0	9882
6435	169	80	19	9583	0	9851
6436	9647	30	27	146	0	9850
6437	173	9585	23	54	0	9835
6438	9711	140	20	40	0	9911
6439	187	46	10010	18	0	10261
6440	10855	44	176	34	0	11109
6441	11298	23	57	34	0	11412
6442	11611	23	36	37	0	11707
6443	307	39	9978	36	0	10360
6444	11254	21	140	37	0	11452
6445	257	11286	61	25	0	11629
6446	128	178	11220	16	0	11542
6447	125	123	201	10697	0	11146
6448	83	36	98	10453	0	10670
6449	59	10649	39	227	0	10974
6450	51	199	32	10766	0	11048
6451	61	71	36	10914	0	11082
6452	38	40	10613	289	0	10980
6453	10029	25	200	139	0	10393
6454	220	29	10693	68	0	11010
6455	113	18	218	10627	0	10976
6456	77	19	10820	212	0	11128
6457	69	14	244	10844	0	11171
6458	10947	15	104	249	0	11315
6459	11278	20	70	115	0	11483
6460	310	13	49	11219	0	11591
6461	138	10	11257	244	0	11649
6462	106	13	206	11301	0	11626
6463	78	22	11101	251	0	11452
6464	10894	16	229	139	0	11278
6465	11220	19	98	92	0	11429
6466	11015	23	74	59	0	11171
6467	11121	19	45	76	0	11261
6468	343	10620	56	50	0	11069
6469	203	217	24	10840	0	11284
6470	10771	95	41	246	0	11153
6471	270	10529	29	123	0	10951
6472	148	10857	32	89	0	11126
6473	96	273	10337	59	0	10765
6474	10416	102	226	71	0	10815
6475	10710	62	100	36	0	10908
6476	335	41	10356	50	0	10782
6477	199	33	239	10298	0	10769
6478	136	26	128	10610	0	10900
6479	122	28	10474	305	0	10929
6480	119	20	255	10406	0	10800
6481	10458	19	116	303	0	10896
6482	269	30	10144	151	0	10594
6483	141	24	10429	120	0	10714
6484	10337	27	317	91	0	10772
6485	283	27	10530	80	0	10920
6486	10438	32	280	55	0	10805
6487	302	10303	149	62	0	10816
6488	10582	216	88	53	0	10939
6489	331	96	75	10366	0	10868
6490	165	63	64	10610	0	10902
6491	10500	52	52	322	0	10926
6492	297	54	40	10511	0	10902
6493	10521	32	45	312	0	10910
6494	300	10380	41	165	0	10886
6495	186	221	42	10037	0	10486
6496	139	105	49	10314	0	10607
6497	10133	63	51	349	0	10596
6498	10227	43	50	147	0	10467
6499	10216	44	42	117	0	10419
6500	381	9652	47	91	0	10171
6501	199	9971	37	80	0	10287
6502	9936	270	35	72	0	10313
6503	342	120	9669	51	0	10182
6504	172	9563	217	58	0	10010
6505	8832	271	218	106	0	9427
6506	8498	104	114	60	0	8776
6507	8421	54	42	45	0	8562
6508	307	49	43	8115	0	8514
6509	8283	31	38	193	0	8545
6510	8265	26	28	98	0	8417
6511	312	34	18	7913	0	8277
6512	8083	22	26	197	0	8328
6513	252	28	7723	119	0	8122
6514	168	30	152	7824	0	8174
6515	101	39	89	8027	0	8256
6516	97	23	56	8233	0	8409
6517	8051	18	40	291	0	8400
6518	8254	25	51	165	0	8495
6519	8324	20	25	115	0	8484
6520	8283	18	16	111	0	8428
6521	8132	12	33	75	0	8252
6522	331	14	28	7663	0	8036
6523	198	10	21	7815	0	8044
6524	7643	11	36	233	0	7923
6525	231	7391	30	135	0	7787
6526	7445	141	19	89	0	7694
6527	223	58	7081	80	0	7442
6528	7547	39	141	62	0	7789
6529	7756	37	58	57	0	7908
6530	271	29	8007	46	0	8353
6531	8415	13	182	38	0	8648
6532	255	17	8517	53	0	8842
6533	192	9	8933	24	0	9158
6534	157	31	264	8928	0	9380
6535	136	22	154	9482	0	9794
6536	102	16	9478	247	0	9843
6537	70	19	9469	162	0	9720
6538	59	9015	263	144	0	9481
6539	40	8985	151	102	0	9278
6540	7796	197	151	48	0	8192
6541	130	8116	64	38	0	8348
6542	7783	158	48	42	0	8031
6543	156	7627	33	25	0	7841
6544	7592	151	52	32	0	7827
6545	160	86	7287	18	0	7551
6546	7394	73	117	21	0	7605
6547	184	42	61	7276	0	7563
6548	92	7384	55	93	0	7624
6549	97	113	32	7504	0	7746
6550	7528	68	25	133	0	7754
6551	7642	62	19	74	0	7797
6552	177	40	31	7503	0	7751
6553	126	35	7425	116	0	7702
6554	97	21	7179	76	0	7373
6555	54	7476	139	62	0	7731
6556	54	144	106	7439	0	7743
6557	41	61	7411	112	0	7625
6558	40	6949	113	65	0	7167
6559	59	117	63	7046	0	7285
6560	30	54	64	7120	0	7268
6561	6824	45	47	141	0	7057
6562	94	43	28	6836	0	7001
6563	53	30	6715	162	0	6960
6564	60	14	99	6737	0	6910
6565	6567	30	55	145	0	6797
6566	99	15	6588	96	0	6798
6567	6536	19	96	84	0	6735
6568	141	6740	56	52	0	6989
6569	6947	82	61	54	0	7144
6570	7004	51	41	36	0	7132
6571	159	52	30	6772	0	7013
6572	118	31	20	6877	0	7046
6573	87	6637	29	252	0	7005
6574	68	84	17	6986	0	7155
6575	6831	55	12	163	0	7061
6576	112	50	6770	87	0	7019
6577	97	32	81	6754	0	6964
6578	70	6720	53	116	0	6959
6579	47	84	52	6933	0	7116
6580	43	58	33	6995	0	7129
6581	6837	59	18	168	0	7082
6582	104	6762	12	118	0	6996
6583	68	90	26	6882	0	7066
6584	6815	58	13	140	0	7026
6585	117	61	19	6824	0	7021
6586	71	32	17	6959	0	7079
6587	7013	24	13	193	0	7243
6588	6976	20	9	136	0	7141
6589	153	27	6907	89	0	7176
6590	6887	21	77	88	0	7073
6591	7082	11	49	47	0	7189
6592	7094	23	54	54	0	7225
6593	186	6658	22	65	0	6931
6594	139	6761	22	42	0	6964
6595	114	112	21	6807	0	7054
6596	6857	78	33	104	0	7072
6597	6900	67	19	70	0	7056
6598	165	37	13	6829	0	7044
6599	137	21	6867	113	0	7138
6600	7000	26	82	74	0	7182
6601	7331	34	46	72	0	7483
6602	152	29	48	7174	0	7403
6603	131	18	25	7246	0	7420
6604	7265	20	23	138	0	7446
6605	141	14	13	7216	0	7384
6606	85	7176	24	158	0	7443
6607	102	81	15	7433	0	7631
6608	7422	53	12	149	0	7636
6609	126	51	7269	105	0	7551
6610	7078	24	76	104	0	7282
6611	165	14	7296	69	0	7544
6612	96	18	116	7348	0	7578
6613	7425	25	70	111	0	7631
6614	133	19	52	7437	0	7641
6615	102	12	33	7508	0	7655
6616	7345	15	35	164	0	7559
6617	127	18	7258	125	0	7528
6618	86	13	7402	96	0	7597
6619	81	15	119	7556	0	7771
6620	76	11	85	7699	0	7871
6621	45	6	67	7773	0	7891
6622	41	15	7574	187	0	7817
6623	7387	8	93	144	0	7632
6624	7804	5	59	117	0	7985
6625	7864	8	70	72	0	8014
6626	7909	5	33	70	0	8017
6627	188	7482	24	55	0	7749
6628	126	7482	19	53	0	7680
6629	90	7448	20	48	0	7606
6630	65	136	31	6487	0	6719
6631	52	41	17	6639	0	6749
6632	45	7	6333	65	0	6450
6633	23	5779	38	24	0	5864
6634	36	37	15	5386	0	5474
6635	5232	10	7	30	0	5279
6636	20	5261	6	13	0	5300
6637	9	20	3	5205	0	5237
6638	7	5234	1	24	0	5266
6639	5328	16	8	26	0	5378
6640	26	9	2	5343	0	5380
6641	13	4	5267	23	0	5307
6642	6	5	5219	13	0	5243
6643	10	14	31	5406	0	5461
6644	12	3	8	5441	0	5464
6645	5	2	4	5627	0	5638
6646	5580	2	4	54	0	5640
6647	35	6	5544	16	0	5601
6648	14	5469	28	14	0	5525
6649	9	29	7	5527	0	5572
6650	4	9	5529	29	0	5571
6651	4	5514	29	16	0	5563
6652	6	30	7	5619	0	5662
6653	6	8	5577	36	0	5627
6654	6	8	29	5476	0	5519
6655	2	4	9	5546	0	5561
6656	5596	1	2	47	0	5646
6657	5605	0	4	18	0	5627
6658	40	0	2	5615	0	5657
6659	5651	1	3	44	0	5699
6660	39	3	5756	12	0	5810
6661	14	1	35	5839	0	5889
6662	4	4	6013	46	0	6067
6663	14	9	41	6097	0	6161
6664	3	6029	16	48	0	6096
6665	3	6086	2	20	0	6111
6666	9	6170	2	7	0	6188
6667	11	56	10	6085	0	6162
6668	7	9	3	6670	0	6689
6669	2	4	6663	67	0	6736
6670	6	0	6646	22	0	6674
6671	2	3	7014	10	0	7029
6672	7488	4	73	15	0	7580
6673	76	7	16	7849	0	7948
6674	8148	3	8	90	0	8249
6675	84	8593	1	35	0	8713
6676	35	100	7	8812	0	8954
6677	9119	50	9	123	0	9301
6678	117	27	8	9162	0	9314
6679	9197	14	5	152	0	9368
6680	139	7	9352	76	0	9574
6681	66	9418	118	44	0	9646
6682	45	114	62	9560	0	9781
6683	9548	56	34	134	0	9772
6684	9700	23	19	76	0	9818
6685	173	11	15	9655	0	9854
6686	92	14	11	9712	0	9829
6687	9468	11	8	199	0	9686
6688	149	16	12	9443	0	9620
6689	76	11	9313	160	0	9560
6690	41	9293	117	86	0	9537
6691	34	113	60	9454	0	9661
6692	9430	54	41	149	0	9674
6693	9514	33	18	93	0	9658
6694	187	13	9573	57	0	9830
6695	96	9348	117	41	0	9602
6696	57	9764	60	43	0	9924
6697	51	172	32	9701	0	9956
6698	47	74	18	9881	0	10020
6699	42	40	16	9860	0	9958
6700	34	26	18	9892	0	9970
6701	37	9555	21	247	0	9860
6702	38	142	24	9721	0	9925
6703	39	68	12	9906	0	10025
6704	9670	38	18	255	0	9981
6705	9705	25	13	144	0	9887
6706	224	9618	17	77	0	9936
6707	9737	148	12	76	0	9973
6708	9742	74	12	66	0	9894
6709	9749	38	11	68	0	9866
6710	253	24	9457	63	0	9797
6711	129	24	154	9471	0	9778
6712	79	19	65	9698	0	9861
6713	62	26	9413	229	0	9730
6714	66	24	144	9381	0	9615
6715	60	25	81	8892	0	9058
6716	9330	20	39	250	0	9639
6717	179	27	9214	137	0	9557
6718	106	25	145	9062	0	9338
6719	8983	21	69	203	0	9276
6720	174	8945	45	130	0	9294
6721	9007	150	24	94	0	9275
6722	8982	73	20	80	0	9155
6723	216	8794	17	71	0	9098
6724	127	153	20	8871	0	9171
6725	8822	74	17	200	0	9113
6726	184	8737	19	116	0	9056
6727	109	164	11	8818	0	9102
6728	8659	88	9	198	0	8954
6729	8644	41	18	130	0	8833
6730	247	8490	21	76	0	8834
6731	8665	152	20	67	0	8904
6732	212	91	21	8618	0	8942
6733	8682	50	18	190	0	8940
6734	224	35	8500	112	0	8871
6735	136	34	146	8573	0	8889
6736	91	24	77	8608	0	8800
6737	8436	31	42	253	0	8762
6738	187	8295	29	152	0	8663
6739	8233	147	31	107	0	8518
6740	207	8145	21	86	0	8459
6741	122	159	7847	62	0	8190
6742	91	88	7764	64	0	8007
6743	87	130	193	7629	0	8039
6744	70	32	7683	176	0	7961
6745	71	42	140	7657	0	7910
6746	78	35	78	7548	0	7739
6747	61	35	44	7828	0	7968
6748	7769	25	26	249	0	8069
6749	7769	34	30	136	0	7969
6750	7907	31	17	100	0	8055
6751	243	7810	28	71	0	8152
6752	148	8498	16	69	0	8731
6753	101	186	8844	65	0	9196
6754	87	96	171	9047	0	9401
6755	89	52	9029	221	0	9391
6756	77	44	202	9028	0	9351
6757	83	45	93	9162	0	9383
6758	70	33	62	9199	0	9364
6759	55	37	8849	332	0	9273
6760	68	29	196	8817	0	9110
6761	8677	29	112	289	0	9107
6762	199	8457	61	187	0	8904
6763	113	164	41	8573	0	8891
6764	8525	92	32	273	0	8922
6765	8538	56	43	159	0	8796
6766	263	50	44	8345	0	8702
6767	165	35	33	8263	0	8496
6768	7799	38	36	279	0	8152
6769	226	28	24	7787	0	8065
6770	7387	17	31	257	0	7692
6771	243	25	17	7114	0	7399
6772	131	5	6509	246	0	6891
6773	94	5991	118	166	0	6369
6774	85	6024	55	101	0	6265
6775	119	131	104	5379	0	5733
6776	117	45	74	5356	0	5592
6777	5146	27	18	160	0	5351
6778	108	38	24	5138	0	5308
6779	53	33	27	5115	0	5228
6780	27	32	20	4797	0	4876
6781	39	4652	11	168	0	4870
6782	27	86	15	4783	0	4911
6783	45	32	11	4815	0	4903
6784	38	13	8	4814	0	4873
6785	4584	21	16	197	0	4818
6786	96	4597	13	120	0	4826
6787	50	96	16	4716	0	4878
6788	34	49	11	4765	0	4859
6789	32	30	13	4789	0	4864
6790	4616	27	9	189	0	4841
6791	121	15	6	4656	0	4798
6792	64	26	4	4650	0	4744
6793	39	19	4325	179	0	4562
6794	30	4198	74	116	0	4418
6795	27	83	27	4290	0	4427
6796	4153	31	15	152	0	4351
6797	102	4149	15	95	0	4361
6798	3997	78	12	86	0	4173
6799	4070	33	23	62	0	4188
6800	99	28	13	4031	0	4171
6801	52	28	11	4109	0	4200
6802	44	19	4070	121	0	4254
6803	45	26	61	4191	0	4323
6804	44	19	4176	120	0	4359
6805	42	19	74	4263	0	4398
6806	4078	6	36	138	0	4258
6807	82	4167	21	95	0	4365
6808	31	78	33	4384	0	4526
6809	25	27	26	4453	0	4531
6810	25	23	25	4441	0	4514
6811	28	18	25	4459	0	4530
6812	4313	18	11	153	0	4495
6813	94	4273	13	84	0	4464
6814	45	81	10	4425	0	4561
6815	4388	29	12	155	0	4584
6816	93	17	4311	117	0	4538
6817	4304	17	78	99	0	4498
6818	4425	16	26	86	0	4553
6819	131	21	4339	62	0	4553
6820	60	30	92	4426	0	4608
6821	4485	16	24	132	0	4657
6822	119	4533	35	68	0	4755
6823	4659	77	27	54	0	4817
6824	4719	27	20	66	0	4832
6825	4758	15	25	59	0	4857
6826	140	21	20	4672	0	4853
6827	78	14	11	4893	0	4996
6828	76	5243	8	127	0	5454
6829	66	112	8	5368	0	5554
6830	5399	34	9	151	0	5593
6831	162	17	5276	76	0	5531
6832	5203	22	94	78	0	5397
6833	5471	14	33	85	0	5603
6834	148	32	20	5395	0	5595
6835	69	30	26	5496	0	5621
6836	5458	18	14	166	0	5656
6837	5484	13	22	84	0	5603
6838	5033	16	27	76	0	5152
6839	169	8	5348	58	0	5583
6840	91	5320	79	75	0	5565
6841	5386	88	27	70	0	5571
6842	145	36	15	5380	0	5576
6843	96	5377	17	123	0	5613
6844	77	110	16	5414	0	5617
6845	5416	40	25	146	0	5627
6846	135	43	20	5457	0	5655
6847	81	34	5258	135	0	5508
6848	47	5192	75	86	0	5400
6849	43	5373	25	70	0	5511
6850	47	103	5057	69	0	5276
6851	4419	112	146	97	0	4774
6852	92	4330	18	42	0	4482
6853	45	61	20	3760	0	3886
6854	3710	16	14	44	0	3784
6855	39	3677	7	17	0	3740
6856	18	37	7	3722	0	3784
6857	3721	17	9	43	0	3790
6858	52	7	3	3732	0	3794
6859	3755	9	4	46	0	3814
6860	46	7	3779	19	0	3851
6861	24	3788	29	14	0	3855
6862	3887	38	8	18	0	3951
6863	3832	13	6	20	0	3871
6864	3802	7	3	21	0	3833
6865	60	5	3594	12	0	3671
6866	3684	7	28	13	0	3732
6867	3790	6	15	10	0	3821
6868	60	5	7	3752	0	3824
6869	3766	9	5	40	0	3820
6870	53	3690	7	24	0	3774
6871	29	34	5	3739	0	3807
6872	25	15	3712	41	0	3793
6873	19	7	37	3695	0	3758
6874	18	7	12	3751	0	3788
6875	3722	12	6	60	0	3800
6876	3725	11	11	24	0	3771
6877	64	11	3653	17	0	3745
6878	3613	9	41	16	0	3679
6879	48	6	3659	22	0	3735
6880	36	4	39	3684	0	3763
6881	22	12	3684	49	0	3767
6882	20	5	41	3651	0	3717
6883	25	3638	19	46	0	3728
6884	17	43	3726	15	0	3801
6885	22	15	3818	15	0	3870
6886	33	5	67	3334	0	3439
6887	3821	14	22	56	0	3913
6888	3866	13	10	29	0	3918
6889	3881	4	9	32	0	3926
6890	74	10	10	3831	0	3925
6891	33	7	12	3871	0	3923
6892	29	3	9	3892	0	3933
6893	29	11	6	3873	0	3919
6894	18	9	3753	67	0	3847
6895	28	8	39	3720	0	3795
6896	20	3690	16	53	0	3779
6897	13	44	10	3735	0	3802
6898	3781	12	8	66	0	3867
6899	58	17	3710	29	0	3814
6900	3565	11	40	38	0	3654
6901	62	5	3793	15	0	3875
6902	30	7	3709	22	0	3768
6903	21	3692	63	18	0	3794
6904	31	61	30	3359	0	3481
6905	17	22	18	3640	0	3697
6906	18	3199	18	77	0	3312
6907	3902	59	16	27	0	4004
6908	77	29	18	4136	0	4260
6909	55	16	9	4530	0	4610
6910	28	11	16	4797	0	4852
6911	5228	7	9	154	0	5398
6912	5681	14	9	79	0	5783
6913	175	8	8	5604	0	5795
6914	89	6	7	5674	0	5776
6915	5548	11	3	198	0	5760
6916	163	3	11	5552	0	5729
6917	89	4	11	5645	0	5749
6918	67	6	5	5716	0	5794
6919	62	4	5405	226	0	5697
6920	5274	1	113	130	0	5518
6921	5434	5	48	100	0	5587
6922	206	4	5173	76	0	5459
6923	105	56	121	4901	0	5183
6924	61	5085	58	152	0	5356
6925	5065	109	29	105	0	5308
6926	137	5029	44	67	0	5277
6927	85	4851	23	55	0	5014
6928	89	153	19	4491	0	4752
6929	4460	54	28	129	0	4671
6930	4576	35	14	73	0	4698
6931	151	47	14	4485	0	4697
6932	90	24	10	4520	0	4644
6933	64	37	10	4494	0	4605
6934	50	40	5	4488	0	4583
6935	41	26	4	4406	0	4477
6936	51	4260	4	191	0	4506
6937	58	105	5	4372	0	4540
6938	4282	44	3	192	0	4521
6939	4358	17	2	130	0	4507
6940	4355	16	7	103	0	4481
6941	173	4195	6	111	0	4485
6942	106	98	7	4239	0	4450
6943	66	54	4172	158	0	4450
6944	4138	37	99	126	0	4400
6945	161	45	43	4186	0	4435
6946	4177	22	24	159	0	4382
6947	4121	17	23	86	0	4247
6948	4143	36	8	66	0	4253
6949	189	27	16	3995	0	4227
6950	4021	20	33	139	0	4213
6951	203	20	15	3990	0	4228
6952	119	17	17	4083	0	4236
6953	4031	10	18	200	0	4259
6954	173	22	9	4055	0	4259
6955	4018	15	3	174	0	4210
6956	4084	21	6	119	0	4230
6957	210	15	4	4021	0	4250
6958	111	18	2	4136	0	4267
6959	81	11	3	4183	0	4278
6960	98	6	3846	214	0	4164
6961	74	13	3925	140	0	4152
6962	82	7	130	3905	0	4124
6963	66	9	52	3999	0	4126
6964	57	7	27	4043	0	4134
6965	52	7	27	4026	0	4112
6966	50	16	12	4069	0	4147
6967	3814	16	29	251	0	4110
6968	138	3792	38	141	0	4109
6969	93	93	28	3919	0	4133
6970	3936	39	23	193	0	4191
6971	159	23	20	3976	0	4178
6972	86	23	10	4053	0	4172
6973	3895	16	17	248	0	4176
6974	3987	13	17	127	0	4144
6975	192	26	3832	98	0	4148
6976	105	23	92	3943	0	4163
6977	102	20	3870	178	0	4170
6978	85	14	104	3956	0	4159
6979	65	7	57	3995	0	4124
6980	85	6	22	4037	0	4150
6981	86	9	3838	214	0	4147
6982	49	3714	127	144	0	4034
6983	45	3947	59	126	0	4177
6984	36	128	50	3908	0	4122
6985	3794	39	38	199	0	4070
6986	124	30	3766	135	0	4055
6987	68	21	3928	109	0	4126
6988	48	15	163	3943	0	4169
6989	43	24	66	3948	0	4081
6990	33	3944	44	198	0	4219
6991	31	115	46	3927	0	4119
6992	51	59	30	4138	0	4278
6993	33	36	43	4211	0	4323
6994	4072	20	38	225	0	4355
6995	4155	15	37	136	0	4343
6996	172	16	20	4190	0	4398
6997	87	4092	21	193	0	4393
6998	72	113	11	4141	0	4337
6999	4017	51	17	205	0	4290
7000	133	4035	18	147	0	4333
7001	86	107	19	3845	0	4057
7002	60	3880	15	171	0	4126
7003	3879	101	20	122	0	4122
7004	3768	70	10	85	0	3933
7005	157	3804	21	75	0	4057
7006	94	3838	13	72	0	4017
7007	59	125	3518	51	0	3753
7008	28	3265	69	57	0	3419
7009	40	141	56	2741	0	2978
7010	42	33	2658	74	0	2807
7011	5	2113	25	22	0	2165
7012	8	30	18	1728	0	1784
7013	4	8	6	1767	0	1785
7014	1	5	0	1776	0	1782
7015	1735	0	0	34	0	1769
7016	21	3	1710	13	0	1747
7017	7	2	1744	9	0	1762
7018	9	2	25	1754	0	1790
7019	4	1	1864	20	0	1889
7020	4	4	22	1868	0	1898
7021	4	2	7	1779	0	1792
7022	1	2	10	1910	0	1923
7023	0	4	2	1923	0	1929
7024	1877	1	1	35	0	1914
7025	1872	1	1	21	0	1895
7026	26	0	1	1890	0	1917
7027	15	2	1972	19	0	2008
7028	8	1	21	1989	0	2019
7029	2	1948	10	25	0	1985
7030	2	17	5	1966	0	1990
7031	1966	8	1	30	0	2005
7032	2000	6	2	11	0	2019
7033	31	0	2	2005	0	2038
7034	15	4	1	2015	0	2035
7035	9	0	1	2039	0	2049
7036	1989	3	1	38	0	2031
7037	24	1	1994	20	0	2039
7038	10	1	1964	13	0	1988
7039	7	1953	27	5	0	1992
7040	1998	18	12	5	0	2033
7041	20	11	6	2054	0	2091
7042	9	10	2097	19	0	2135
7043	9	2058	17	12	0	2096
7044	2	2148	8	13	0	2171
7045	3	29	7	2135	0	2174
7046	3	10	4	2190	0	2207
7047	5	2144	2	26	0	2177
7048	4	21	1	2217	0	2243
7049	3	12	2	2226	0	2243
7050	2204	8	3	27	0	2242
7051	17	2194	1	21	0	2233
7052	10	20	0	2202	0	2232
7053	8	9	2176	20	0	2213
7054	5	13	17	2166	0	2201
7055	2191	3	8	30	0	2232
7056	17	2197	9	10	0	2233
7057	8	15	1	2231	0	2255
7058	9	9	2193	19	0	2230
7059	4	12	2240	12	0	2268
7060	3	9	20	2309	0	2341
7061	6	1	16	2373	0	2396
7062	2383	4	8	28	0	2423
7063	16	2458	2	18	0	2494
7064	2500	16	3	13	0	2532
7065	25	8	2577	7	0	2617
7066	2562	10	18	9	0	2599
7067	33	5	2757	4	0	2799
7068	2739	4	28	7	0	2778
7069	2821	0	15	7	0	2843
7070	32	2	2947	3	0	2984
7071	26	1	2895	6	0	2928
7072	11	2843	32	9	0	2895
7073	6	19	20	3048	0	3093
7074	3128	14	10	26	0	3178
7075	24	11	3	3159	0	3197
7076	17	2	4	3212	0	3235
7077	14	3	3	3235	0	3255
7078	6	2	3207	44	0	3259
7079	2961	4	26	26	0	3017
7080	3216	1	12	22	0	3251
7081	35	3282	17	5	0	3339
7082	27	22	4	3267	0	3320
7083	14	3332	5	23	0	3374
7084	4	39	2	3369	0	3414
7085	3365	15	6	43	0	3429
7086	29	3373	2	19	0	3423
7087	14	25	2	3298	0	3339
7088	3274	17	5	34	0	3330
7089	3268	7	3	23	0	3301
7090	41	7	5	3247	0	3300
7091	26	3	3234	33	0	3296
7092	17	35	26	3136	0	3214
7093	5	3227	13	29	0	3274
7094	3204	25	20	16	0	3265
7095	25	3211	2	14	0	3252
7096	15	31	3	3160	0	3209
7097	3228	12	1	30	0	3271
7098	23	9	7	3295	0	3334
7099	14	4	0	3309	0	3327
7100	12	4	3267	32	0	3315
7101	7	3242	20	21	0	3290
7102	3254	21	10	15	0	3300
7103	3065	11	6	13	0	3095
7104	26	3201	1	7	0	3235
7105	14	3237	5	6	0	3262
7106	8	22	3	3204	0	3237
7107	3194	11	8	21	0	3234
7108	20	3170	2	12	0	3204
7109	15	21	0	3231	0	3267
7110	9	7	3229	21	0	3266
7111	9	9	16	3228	0	3262
7112	3278	5	10	29	0	3322
7113	19	3277	7	15	0	3318
7114	14	18	3	3382	0	3417
7115	10	13	3362	19	0	3404
7116	6	7	3312	14	0	3339
7117	10	4	26	3406	0	3446
7118	3	4	14	3451	0	3472
7119	10	3347	7	29	0	3393
7120	4	22	3	3360	0	3389
7121	3421	11	2	30	0	3464
7122	26	8	4	3445	0	3483
7123	3475	5	6	30	0	3516
7124	26	3469	5	16	0	3516
7125	16	3546	3	15	0	3580
7126	9	33	3	3644	0	3689
7127	9	12	2	3554	0	3577
7128	11	7	3542	32	0	3592
7129	13	5	24	3500	0	3542
7130	3531	4	8	32	0	3575
7131	23	7	3497	13	0	3540
7132	15	3	27	3579	0	3624
7133	13	11	3690	28	0	3742
7134	9	7	31	3731	0	3778
7135	8	7	14	3732	0	3761
7136	6	10	9	3814	0	3839
7137	12	3	3758	44	0	3817
7138	11	2	25	3704	0	3742
7139	3	3768	11	37	0	3819
7140	3	26	11	3823	0	3863
7141	8	13	5	3774	0	3800
7142	3723	6	6	46	0	3781
7143	28	5	3665	28	0	3726
7144	14	5	24	3670	0	3713
7145	8	8	3655	41	0	3712
7146	9	6	3501	23	0	3539
7147	12	6	39	3700	0	3757
7148	10	5	13	3569	0	3597
7149	7	6	9	3822	0	3844
7150	3790	4	10	47	0	3851
7151	29	7	3774	32	0	3842
7152	3938	4	30	22	0	3994
7153	34	4	16	4090	0	4144
7154	19	7	7	4191	0	4224
7155	12	4259	13	48	0	4332
7156	9	34	3	4355	0	4401
7157	10	13	3	4344	0	4370
7158	7	10	8	4349	0	4374
7159	4163	9	5	54	0	4231
7160	30	3	4007	27	0	4067
7161	3801	1	23	30	0	3855
7162	35	4046	8	16	0	4105
7163	3975	29	7	17	0	4028
7164	30	3929	5	13	0	3977
7165	16	3908	10	8	0	3942
7166	39	33	15	3813	0	3900
7167	3847	6	22	34	0	3909
7168	28	7	2	3850	0	3887
7169	6	3736	2	34	0	3778
7170	5	3863	1	20	0	3889
7171	8	32	3	3919	0	3962
7172	4	10	3	3927	0	3944
7173	6	3927	2	37	0	3972
7174	3	31	1	4066	0	4101
7175	5	8	2	4094	0	4109
7176	7	7	0	4137	0	4151
7177	4109	6	3	44	0	4162
7178	31	2	4069	18	0	4120
7179	4084	4	29	17	0	4134
7180	4281	1	8	10	0	4300
7181	4224	4	6	9	0	4243
7182	38	4135	4	8	0	4185
7183	18	23	1	4151	0	4193
7184	4202	10	1	35	0	4248
7185	27	4	3	4281	0	4315
7186	4261	5	2	37	0	4305
7187	25	4461	2	17	0	4505
7188	4650	21	2	19	0	4692
7189	4736	11	4	9	0	4760
7190	4797	5	3	11	0	4816
7191	34	7	2	4787	0	4830
7192	16	5	2	4896	0	4919
7193	4924	4	0	43	0	4971
7194	28	4825	1	18	0	4872
7195	9	4781	4	16	0	4810
7196	5023	29	1	15	0	5068
7197	33	12	1	5025	0	5071
7198	11	4	3	5060	0	5078
7199	11	5	1	5135	0	5152
7200	11	5043	5	39	0	5098
7201	5116	23	2	26	0	5167
7202	33	11	1	5154	0	5199
7203	12	5195	5	38	0	5250
7204	11	33	2	5445	0	5491
7205	12	12	4	5469	0	5497
7206	10	6	1	5460	0	5477
7207	9	10	2	5494	0	5515
7208	5453	0	2	51	0	5506
7209	5413	4	2	27	0	5446
7210	5489	3	1	22	0	5515
7211	46	4	1	5515	0	5566
7212	17	8	5376	34	0	5435
7213	15	3	4793	18	0	4829
7214	9	7	5090	14	0	5120
7215	5520	9	34	32	0	5595
7216	33	4	14	5594	0	5645
7217	15	6	5	5553	0	5579
7218	12	2	4	5616	0	5634
7219	5591	0	4	52	0	5647
7220	5542	2	2	33	0	5579
7221	41	5732	4	16	0	5793
7222	17	25	4	5843	0	5889
7223	16	14	5726	27	0	5783
7224	11	5696	28	24	0	5759
7225	13	33	8	5795	0	5849
7226	13	9	3	5822	0	5847
7227	8	6	2	5769	0	5785
7228	16	7	1	5703	0	5727
7229	7	3	5654	47	0	5711
7230	13	5	5296	22	0	5336
7231	8	5653	26	16	0	5703
7232	11	22	10	5767	0	5810
7233	12	9	5	5688	0	5714
7234	5609	2	5	45	0	5661
7235	31	6	5620	18	0	5675
7236	16	6	24	5681	0	5727
7237	12	3	11	5820	0	5846
7238	8	2	5910	37	0	5957
7239	4	5800	24	20	0	5848
7240	5902	25	9	15	0	5951
7241	30	13	5838	13	0	5894
7242	5704	9	23	22	0	5758
7243	32	5	6140	12	0	6189
7244	14	4	21	6267	0	6306
7245	8	10	6240	27	0	6285
7246	13	8	6257	17	0	6295
7247	11	4	28	6502	0	6545
7248	37	20	32	5019	0	5108
7249	10	3	3	6700	0	6716
7250	14	4	4	6566	0	6588
7251	15	6	2	6502	0	6525
7252	8	4	6474	33	0	6519
7253	17	2	6008	26	0	6053
7254	9	6448	31	10	0	6498
7255	6520	21	15	20	0	6576
7256	28	17	9	6623	0	6677
7257	6658	4	7	47	0	6716
7258	33	4	5	6686	0	6728
7259	6880	1	4	62	0	6947
7260	41	1	4	6967	0	7013
7261	24	2	1	6995	0	7022
7262	11	7031	3	54	0	7099
7263	10	31	3	7242	0	7286
7264	14	20	4	7213	0	7251
7265	9	5	5	7201	0	7220
7266	8	8	3	7186	0	7205
7267	4	7015	4	52	0	7075
7268	7005	27	2	39	0	7073
7269	28	6989	6	18	0	7041
7270	14	32	3	6888	0	6937
7271	6794	13	1	45	0	6853
7272	30	8	6600	19	0	6657
7273	18	4	6480	12	0	6514
7274	17	25	38	6450	0	6530
7275	4	4	16	6666	0	6690
7276	3	1	6	6677	0	6687
7277	4	2	7	6259	0	6272
7278	5	2	1	6511	0	6519
7279	2	6361	3	47	0	6413
7280	2	23	0	6499	0	6524
7281	6471	10	2	41	0	6524
7282	29	5	2	6539	0	6575
7283	13	6	6632	33	0	6684
7284	8	1	31	6534	0	6574
7285	6468	1	14	48	0	6531
7286	28	6711	5	15	0	6759
7287	18	32	1	6959	0	7010
7288	11	11	1	7280	0	7303
7289	5	5	7195	83	0	7288
7290	8	3	8556	24	0	8591
7291	10664	2	140	18	0	10824
7292	240	2	52	10983	0	11277
7293	136	5	44	11520	0	11705
7294	101	7	12265	357	0	12730
7295	86	7	12572	208	0	12873
7296	42	12728	387	181	0	13338
7297	41	276	210	12766	0	13293
7298	12	123	12778	340	0	13253
7299	10	12799	422	151	0	13382
7300	12748	362	212	126	0	13448
7301	13195	185	164	120	0	13664
7302	434	141	111	12880	0	13566
7303	239	12940	103	341	0	13623
7304	13036	369	68	184	0	13657
7305	478	188	68	12459	0	13193
7306	268	150	12725	390	0	13533
7307	195	12946	311	226	0	13678
7308	12966	391	142	190	0	13689
7309	13322	187	136	156	0	13801
7310	493	153	114	13078	0	13838
7311	303	143	88	13304	0	13838
7312	249	121	12923	461	0	13754
7313	227	62	338	13180	0	13807
7314	189	71	169	12708	0	13137
7315	137	51	128	13357	0	13673
7316	120	45	110	13392	0	13667
7317	83	35	101	13048	0	13267
7318	58	12756	74	758	0	13646
7319	12773	309	58	512	0	13652
7320	345	153	12726	398	0	13622
7321	179	12604	324	325	0	13432
7322	187	381	153	12972	0	13693
7323	12835	207	133	507	0	13682
7324	439	179	122	12907	0	13647
7325	232	135	115	13141	0	13623
7326	191	106	79	13309	0	13685
7327	158	84	90	13380	0	13712
7328	149	67	12608	768	0	13592
7329	119	12656	335	566	0	13676
7330	12771	347	148	474	0	13740
7331	386	159	12700	401	0	13646
7332	216	145	433	12952	0	13746
7333	12784	162	257	537	0	13740
7334	448	12782	188	331	0	13749
7335	12984	374	185	290	0	13833
7336	538	243	149	12122	0	13052
7337	329	185	117	13223	0	13854
7338	332	168	84	13146	0	13730
7339	261	132	68	13288	0	13749
7340	12681	117	63	793	0	13654
7341	477	102	65	13023	0	13667
7342	282	84	52	13304	0	13722
7343	12337	68	82	828	0	13315
7344	485	80	12095	550	0	13210
7345	328	72	332	12519	0	13251
7346	12044	65	175	689	0	12973
7347	12227	63	145	470	0	12905
7348	618	44	118	12000	0	12780
7349	387	59	136	12009	0	12591
7350	331	11095	105	694	0	12225
7351	294	326	78	11643	0	12341
7352	241	151	69	11758	0	12219
7353	172	136	10907	825	0	12040
7354	151	107	10777	624	0	11659
7355	122	10787	418	528	0	11855
7356	136	355	239	10977	0	11707
7357	115	170	241	11331	0	11857
7358	10837	179	200	677	0	11893
7359	397	165	168	10915	0	11645
7360	228	126	10535	712	0	11601
7361	230	93	379	10931	0	11633
7362	202	92	10380	711	0	11385
7363	175	89	10567	523	0	11354
7364	168	68	515	10561	0	11312
7365	122	76	340	10936	0	11474
7366	10458	93	271	712	0	11534
7367	10729	67	215	495	0	11506
7368	509	62	211	10794	0	11576
7369	10806	56	148	678	0	11688
7370	11115	64	109	451	0	11739
7371	696	70	84	10949	0	11799
7372	485	67	81	11204	0	11837
7373	10968	53	81	721	0	11823
7374	10881	45	65	518	0	11509
7375	671	27	101	10739	0	11538
7376	410	10358	79	713	0	11560
7377	386	307	58	10913	0	11664
7378	331	128	55	11170	0	11684
7379	251	128	10367	803	0	11549
7380	211	94	299	11048	0	11652
7381	10322	115	164	762	0	11363
7382	420	10427	156	543	0	11546
7383	10547	317	145	464	0	11473
7384	10656	175	135	360	0	11326
7385	10853	148	89	328	0	11418
7386	731	178	72	10223	0	11204
7387	557	134	9340	525	0	10556
7388	474	96	9097	356	0	10023
7389	334	8945	380	345	0	10004
7390	214	7515	169	241	0	8139
7391	117	5461	65	105	0	5748
7392	107	5108	103	86	0	5404
7393	174	151	4631	108	0	5064
7394	3528	173	188	73	0	3962
7395	46	21	17	3434	0	3518
7396	24	9	11	3362	0	3406
7397	19	7	2	3362	0	3390
7398	15	3329	6	52	0	3402
7399	3314	32	5	29	0	3380
7400	37	12	3320	19	0	3388
7401	17	3179	25	9	0	3230
7402	17	34	22	3196	0	3269
7403	3231	9	8	37	0	3285
7404	32	6	5	3209	0	3252
7405	14	3	3146	41	0	3204
7406	12	2	3125	16	0	3155
7407	10	5	30	3198	0	3243
7408	9	0	14	3211	0	3234
7409	3209	1	9	47	0	3266
7410	30	2	3199	16	0	3247
7411	3159	1	26	19	0	3205
7412	3178	2	10	13	0	3203
7413	36	1	6	3233	0	3276
7414	19	2	3275	26	0	3322
7415	11	3	26	3283	0	3323
7416	3299	3	10	36	0	3348
7417	30	3289	7	17	0	3343
7418	3376	24	2	13	0	3415
7419	36	9	4	3444	0	3493
7420	12	3527	2	40	0	3581
7421	12	34	2	3524	0	3572
7422	5	12	1	3616	0	3634
7423	5	3578	3	50	0	3636
7424	6	40	2	3644	0	3692
7425	10	16	1	3734	0	3761
7426	8	10	0	3819	0	3837
7427	4	1	3896	68	0	3969
7428	4	3863	50	22	0	3939
7429	3948	47	16	21	0	4032
7430	56	16	12	4064	0	4148
7431	14	4368	4	54	0	4440
7432	4616	56	3	27	0	4702
7433	70	14	6	4643	0	4733
7434	25	10	2	4712	0	4749
7435	21	3	1	4605	0	4630
7436	10	6	2	4567	0	4585
7437	4506	4	2	100	0	4612
7438	75	0	1	4579	0	4655
7439	21	2	1	4649	0	4673
7440	4599	4	1	97	0	4701
7441	80	3	0	4638	0	4721
7442	26	4	4576	93	0	4699
7443	20	3	66	4615	0	4704
7444	4513	6	12	101	0	4632
7445	84	4	8	4554	0	4650
7446	23	3	4553	95	0	4674
7447	14	2	4510	35	0	4561
7448	4618	8	82	31	0	4739
7449	4774	3	29	20	0	4826
7450	4813	6	14	23	0	4856
7451	4828	4	12	19	0	4863
7452	108	5	4772	12	0	4897
7453	45	4	70	4748	0	4867
7454	26	1	19	4874	0	4920
7455	4807	3	19	97	0	4926
7456	91	3	9	4854	0	4957
7457	32	2	4759	93	0	4886
7458	24	9	67	4816	0	4916
7459	14	3	4835	95	0	4947
7460	18	4822	79	34	0	4953
7461	4926	66	17	40	0	5049
7462	80	14	20	4899	0	5013
7463	22	12	4828	94	0	4956
7464	29	3	74	4857	0	4963
7465	18	3	26	5013	0	5060
7466	12	5	5019	109	0	5145
7467	18	1	87	5039	0	5145
7468	5017	5	32	102	0	5156
7469	90	9	4651	44	0	4794
7470	4722	2	68	45	0	4837
7471	99	4743	26	27	0	4895
7472	36	67	4741	20	0	4864
7473	23	15	4756	22	0	4816
7474	39	56	93	4075	0	4263
7475	22	13	36	4513	0	4584
7476	21	8	4458	91	0	4578
7477	20	5	73	4489	0	4587
7478	4549	4	25	100	0	4678
7479	4583	4	26	42	0	4655
7480	87	6	17	4544	0	4654
7481	34	8	11	4555	0	4608
7482	28	4495	18	93	0	4634
7483	4618	60	13	56	0	4747
7484	85	16	17	4644	0	4762
7485	25	4655	19	98	0	4797
7486	4721	67	18	47	0	4853
7487	4830	22	12	37	0	4901
7488	100	4907	10	35	0	5052
7489	44	76	12	4937	0	5069
7490	37	17	13	4941	0	5008
7491	27	17	4791	117	0	4952
7492	31	11	82	4758	0	4882
7493	4725	15	22	119	0	4881
7494	95	9	24	4750	0	4878
7495	46	8	4676	117	0	4847
7496	4672	8	79	56	0	4815
7497	81	7	38	4729	0	4855
7498	47	9	4673	106	0	4835
7499	40	5	87	4685	0	4817
7500	32	7	4676	111	0	4826
7501	39	4	85	4694	0	4822
7502	23	5	32	4777	0	4837
7503	4649	7	28	121	0	4805
7504	86	4641	25	65	0	4817
7505	4719	70	24	62	0	4875
7506	4724	18	24	50	0	4816
7507	4736	13	23	45	0	4817
7508	109	4663	19	41	0	4832
7509	57	83	4624	32	0	4796
7510	45	30	80	4642	0	4797
7511	4681	15	37	99	0	4832
7512	4718	15	28	60	0	4821
7513	121	11	27	4606	0	4765
7514	4578	10	14	117	0	4719
7515	108	16	4537	54	0	4715
7516	4513	11	87	44	0	4655
7517	111	14	4513	43	0	4681
7518	58	4445	81	35	0	4619
7519	4449	64	37	37	0	4587
7520	4346	25	27	35	0	4433
7521	100	4323	24	30	0	4477
7522	4272	75	27	33	0	4407
7523	4244	17	22	34	0	4317
7524	97	14	4143	22	0	4276
7525	4029	12	69	33	0	4143
7526	90	9	3989	19	0	4107
7527	45	39	48	3713	0	3845
7528	31	3805	26	59	0	3921
7529	28	46	3729	36	0	3839
7530	3361	90	93	78	0	3622
7531	3232	25	31	37	0	3325
7532	55	5	7	3060	0	3127
7533	27	7	3045	37	0	3116
7534	15	7	34	3051	0	3107
7535	3040	1	14	45	0	3100
7536	41	3066	10	20	0	3137
7537	3060	30	11	15	0	3116
7538	3085	11	5	10	0	3111
7539	43	3053	10	11	0	3117
7540	29	27	8	3049	0	3113
7541	3086	14	8	42	0	3150
7542	41	10	7	3106	0	3164
7543	24	9	9	3209	0	3251
7544	20	9	3250	41	0	3320
7545	22	2	26	3249	0	3299
7546	22	4	14	3258	0	3298
7547	3207	13	6	54	0	3280
7548	3253	1	9	22	0	3285
7549	57	4	5	3243	0	3309
7550	20	9	3206	42	0	3277
7551	24	1	3146	20	0	3191
7552	22	9	40	3164	0	3235
7553	14	6	3268	51	0	3339
7554	20	8	40	3246	0	3314
7555	14	6	17	3248	0	3285
7556	3264	1	8	58	0	3331
7557	47	3	3226	17	0	3293
7558	3184	5	38	19	0	3246
7559	3189	2	19	16	0	3226
7560	53	8	3120	11	0	3192
7561	26	1	3114	12	0	3153
7562	19	56	38	3012	0	3125
7563	14	2942	23	36	0	3015
7564	16	2990	15	15	0	3036
7565	29	41	8	2833	0	2911
7566	13	6	4	2754	0	2777
7567	17	4	6	2828	0	2855
7568	10	3	9	2853	0	2875
7569	2773	3	5	44	0	2825
7570	37	5	7	2777	0	2826
7571	15	3	2753	35	0	2806
7572	12	5	30	2711	0	2758
7573	10	2698	9	38	0	2755
7574	7	25	8	2707	0	2747
7575	2691	4	7	46	0	2748
7576	40	3	4	2734	0	2781
7577	15	3	2714	38	0	2770
7578	6	2662	29	14	0	2711
7579	7	25	10	2681	0	2723
7580	2687	10	5	39	0	2741
7581	2721	5	3	19	0	2748
7582	44	2	2	2731	0	2779
7583	16	0	2617	31	0	2664
7584	9	1	2514	12	0	2536
7585	2549	6	36	9	0	2600
7586	29	2	2618	10	0	2659
7587	12	3	2610	6	0	2631
7588	13	15	27	2486	0	2541
7589	2622	0	14	27	0	2663
7590	2566	2	5	14	0	2587
7591	2587	0	6	14	0	2607
7592	35	4	2689	2	0	2730
7593	14	1	2768	9	0	2792
7594	7	2896	24	8	0	2935
7595	6	20	14	2847	0	2887
7596	4	5	9	2902	0	2920
7597	11	7	4	2805	0	2827
7598	5	1	10	2889	0	2905
7599	5	1	2894	36	0	2936
7600	5	2858	23	16	0	2902
7601	3009	22	8	13	0	3052
7602	3327	5	8	13	0	3353
7603	3384	4	2	8	0	3398
7604	55	3454	7	14	0	3530
7605	18	35	8	3549	0	3610
7606	3784	10	6	51	0	3851
7607	57	3927	7	24	0	4015
7608	3936	55	2	17	0	4010
7609	59	3904	6	10	0	3979
7610	3925	52	2	17	0	3996
7611	3975	15	8	11	0	4009
7612	83	13	3	4009	0	4108
7613	35	5	6	4172	0	4218
7614	16	8	4132	76	0	4232
7615	15	5	4077	27	0	4124
7616	4159	3	73	14	0	4249
7617	4274	3	25	12	0	4314
7618	87	7	15	4167	0	4276
7619	40	4	12	4205	0	4261
7620	24	2	4146	86	0	4258
7621	16	10	59	4082	0	4167
7622	18	3	4108	80	0	4209
7623	32	4	67	4124	0	4227
7624	15	7	19	4244	0	4285
7625	4189	9	17	96	0	4311
7626	4185	6	9	51	0	4251
7627	86	5	10	4174	0	4275
7628	40	6	8	4201	0	4255
7629	30	5	4135	99	0	4269
7630	22	7	57	4182	0	4268
7631	20	6	4179	87	0	4292
7632	4144	9	73	38	0	4264
7633	80	3	26	4228	0	4337
7634	4193	5	23	90	0	4311
7635	89	4150	14	47	0	4300
7636	4237	62	18	41	0	4358
7637	97	23	18	4210	0	4348
7638	44	14	12	4213	0	4283
7639	36	4183	11	91	0	4321
7640	23	64	12	4244	0	4343
7641	21	26	4174	92	0	4313
7642	20	14	71	4179	0	4284
7643	24	9	4064	86	0	4183
7644	21	3963	72	44	0	4100
7645	20	57	27	3973	0	4077
7646	14	18	3934	82	0	4048
7647	13	13	3906	37	0	3969
7648	16	19	86	3855	0	3976
7649	3829	10	41	77	0	3957
7650	66	7	3806	44	0	3923
7651	34	3	65	3804	0	3906
7652	3828	5	32	87	0	3952
7653	69	3739	23	35	0	3866
7654	3919	57	11	43	0	4030
7655	80	21	17	3910	0	4028
7656	35	14	10	3976	0	4035
7657	27	8	10	4027	0	4072
7658	3974	11	12	102	0	4099
7659	74	5	7	4025	0	4111
7660	41	6	7	4058	0	4112
7661	3900	10	10	105	0	4025
7662	74	4	3896	53	0	4027
7663	37	11	68	3925	0	4041
7664	30	6	3913	80	0	4029
7665	3861	11	68	48	0	3988
7666	88	6	24	3949	0	4067
7667	42	12	3970	76	0	4100
7668	3880	11	71	46	0	4008
7669	4003	7	34	38	0	4082
7670	96	11	4104	27	0	4238
7671	48	10	65	4097	0	4220
7672	29	10	34	4195	0	4268
7673	27	5	4189	99	0	4320
7674	22	4169	72	49	0	4312
7675	23	56	4215	34	0	4328
7676	4094	19	80	39	0	4232
7677	71	16	4325	40	0	4452
7678	4179	4	87	31	0	4301
7679	81	8	4315	28	0	4432
7680	4225	6	79	26	0	4336
7681	79	4327	39	26	0	4471
7682	48	59	25	4268	0	4400
7683	33	14	22	4405	0	4474
7684	20	10	4367	104	0	4501
7685	27	8	71	4261	0	4367
7686	29	4267	30	82	0	4408
7687	4169	56	21	58	0	4304
7688	65	4197	16	49	0	4327
7689	37	57	19	4179	0	4292
7690	4186	14	13	93	0	4306
7691	74	4214	14	44	0	4346
7692	4116	65	17	32	0	4230
7693	89	25	4182	33	0	4329
7694	40	13	73	4173	0	4299
7695	37	8	32	4230	0	4307
7696	29	11	21	4305	0	4366
7697	4267	8	21	101	0	4397
7698	4268	8	25	52	0	4353
7699	4321	9	18	42	0	4390
7700	4277	10	12	38	0	4337
7701	99	6	4077	28	0	4210
7702	3640	6	50	20	0	3716
7703	66	3644	22	15	0	3747
7704	23	3607	12	15	0	3657
7705	3470	47	97	22	0	3636
7706	3409	12	22	12	0	3455
7707	32	11	5	3235	0	3283
7708	3285	2	11	26	0	3324
7709	3282	2	2	13	0	3299
7710	3529	2	7	12	0	3550
7711	48	6	1	3494	0	3549
7712	13	3436	3	27	0	3479
7713	11	3465	2	8	0	3486
7714	15	41	2	3450	0	3508
7715	3391	5	5	37	0	3438
7716	29	3427	0	4	0	3460
7717	12	28	3	3403	0	3446
7718	5	2	3462	31	0	3500
7719	3278	7	23	9	0	3317
7720	27	3462	2	4	0	3495
7721	6	3512	3	4	0	3525
7722	3441	26	1	9	0	3477
7723	28	6	3541	3	0	3578
7724	8	8	23	3483	0	3522
7725	10	3514	9	23	0	3556
7726	12	23	4	3552	0	3591
7727	9	5	1	3546	0	3561
7728	13	3119	4	30	0	3166
7729	14	26	3	3646	0	3689
7730	12	5	3	3666	0	3686
7731	3635	2	4	32	0	3673
7732	26	3587	2	9	0	3624
7733	3620	26	1	12	0	3659
7734	28	8	3	3598	0	3637
7735	9	3655	2	30	0	3696
7736	11	24	3597	8	0	3640
7737	9	13	25	3617	0	3664
7738	16	13	4	3706	0	3739
7739	10	5	3773	31	0	3819
7740	3656	4	32	13	0	3705
7741	37	3	5	4133	0	4178
7742	4134	7	7	48	0	4196
7743	43	8	4057	16	0	4124
7744	15	4	42	4179	0	4240
7745	10	4	4448	46	0	4508
7746	8	7	49	4503	0	4567
7747	12	9	12	4652	0	4685
7748	4610	1	12	66	0	4689
7749	51	4639	5	25	0	4720
7750	4676	49	6	23	0	4754
7751	56	15	4695	9	0	4775
7752	18	13	45	4693	0	4769
7753	74	4	4741	55	0	4874
7754	4344	6	55	32	0	4437
7755	4729	5	17	22	0	4773
7756	63	5	4691	9	0	4768
7757	4640	7	47	13	0	4707
7758	4783	3	20	12	0	4818
7759	71	2	15	4751	0	4839
7760	26	6	4705	57	0	4794
7761	21	4	4795	17	0	4837
7762	19	5	59	4812	0	4895
7763	15	3	25	4769	0	4812
7764	10	4703	17	61	0	4791
7765	12	4838	10	24	0	4884
7766	4803	55	8	26	0	4892
7767	59	19	9	4789	0	4876
7768	18	4736	14	52	0	4820
7769	19	4866	10	27	0	4922
7770	4707	55	10	29	0	4801
7771	56	24	6	4718	0	4804
7772	24	4719	9	49	0	4801
7773	24	49	8	4705	0	4786
7774	16	17	6	4724	0	4763
7775	14	15	12	4704	0	4745
7776	4603	12	8	83	0	4706
7777	56	4563	4	32	0	4655
7778	28	50	10	4578	0	4666
7779	25	22	10	4606	0	4663
7780	25	19	6	4604	0	4654
7781	14	10	4459	84	0	4567
7782	4363	8	49	37	0	4457
7783	65	6	27	4470	0	4568
7784	4400	10	14	72	0	4496
7785	4434	9	8	41	0	4492
7786	4420	5	17	30	0	4472
7787	79	8	4405	18	0	4510
7788	36	4375	53	21	0	4485
7789	31	54	18	4338	0	4441
7790	16	17	4340	58	0	4431
7791	17	23	4225	29	0	4294
7792	17	37	58	4097	0	4209
7793	20	4084	25	51	0	4180
7794	4119	43	18	30	0	4210
7795	4161	21	11	30	0	4223
7796	4223	21	8	26	0	4278
7797	4200	6	4	28	0	4238
7798	67	11	4151	21	0	4250
7799	4100	12	46	23	0	4181
7800	60	4216	19	20	0	4315
7801	30	44	17	4247	0	4338
7802	29	22	8	4290	0	4349
7803	4288	12	15	68	0	4383
7804	60	5	14	4285	0	4364
7805	29	12	4146	63	0	4250
7806	3997	3	51	37	0	4088
7807	4116	8	19	34	0	4177
7808	4124	9	14	17	0	4164
7809	78	3	4057	16	0	4154
7810	3751	5	46	23	0	3825
7811	56	3806	22	12	0	3896
7812	3837	40	21	19	0	3917
7813	64	16	10	3774	0	3864
7814	26	12	13	3809	0	3860
7815	23	3785	8	51	0	3867
7816	15	39	9	3802	0	3865
7817	19	3791	13	50	0	3873
7818	16	48	6	3740	0	3810
7819	19	3736	3	49	0	3807
7820	25	49	6	3719	0	3799
7821	18	3748	9	59	0	3834
7822	17	43	4	3883	0	3947
7823	13	3886	8	53	0	3960
7824	4121	49	5	26	0	4201
7825	51	19	3	4239	0	4312
7826	34	16	1	4313	0	4364
7827	23	11	3	4534	0	4571
7828	16	7	8	4616	0	4647
7829	15	9	4637	99	0	4760
7830	25	5	55	4667	0	4752
7831	14	10	32	4723	0	4779
7832	4667	3	16	95	0	4781
7833	4653	5	4	51	0	4713
7834	92	4702	5	29	0	4828
7835	56	66	6	4691	0	4819
7836	27	30	8	5060	0	5125
7837	5194	13	6	114	0	5327
7838	90	11	4914	46	0	5061
7839	4939	7	65	33	0	5044
7840	90	5015	26	24	0	5155
7841	4703	63	16	13	0	4795
7842	4692	30	6	20	0	4748
7843	88	4599	7	22	0	4716
7844	42	4696	4	10	0	4752
7845	45	104	16	4366	0	4531
7846	15	28	4316	67	0	4426
7847	4198	10	58	38	0	4304
7848	64	11	4282	14	0	4371
7849	4195	13	59	16	0	4283
7850	64	6	4285	17	0	4372
7851	33	4216	61	11	0	4321
7852	18	57	27	4235	0	4337
7853	4153	23	9	67	0	4252
7854	4226	13	7	32	0	4278
7855	91	7	7	4227	0	4332
7856	4359	8	3	68	0	4438
7857	4366	7	8	38	0	4419
7858	96	4276	2	15	0	4389
7859	4328	61	7	16	0	4412
7860	73	4399	9	10	0	4491
7861	48	56	4	4429	0	4537
7862	4397	28	7	65	0	4497
7863	4484	15	5	34	0	4538
7864	4498	8	3	18	0	4527
7865	97	18	4422	5	0	4542
7866	47	9	4497	16	0	4569
7867	28	5	86	4546	0	4665
7868	32	6	30	4790	0	4858
7869	15	5045	14	94	0	5168
7870	5099	68	8	43	0	5218
7871	84	37	13	5118	0	5252
7872	63	20	8	5200	0	5291
7873	25	14	5177	113	0	5329
7874	21	5056	62	54	0	5193
7875	23	5249	44	24	0	5340
7876	27	95	11	5283	0	5416
7877	5213	42	12	91	0	5358
7878	88	19	7	5219	0	5333
7879	51	14	11	5296	0	5372
7880	5258	16	8	119	0	5401
7881	5288	14	5	69	0	5376
7882	119	10	4	5276	0	5409
7883	60	20	5232	95	0	5407
7884	46	11	69	5302	0	5428
7885	31	12	38	5368	0	5449
7886	5320	7	16	131	0	5474
7887	89	6	19	5329	0	5443
7888	5327	10	15	107	0	5459
7889	99	15	5351	68	0	5533
7890	67	14	66	5508	0	5655
7891	43	13	43	5598	0	5697
7892	39	8	20	5651	0	5718
7893	35	7	17	5612	0	5671
7894	31	17	15	5527	0	5590
7895	34	11	5353	144	0	5542
7896	5307	16	77	91	0	5491
7897	107	14	43	5381	0	5545
7898	53	22	5293	118	0	5486
7899	37	12	5305	87	0	5441
7900	38	14	118	5296	0	5466
7901	5295	11	52	122	0	5480
7902	5330	14	26	86	0	5456
7903	5435	15	24	50	0	5524
7904	149	23	28	5237	0	5437
7905	87	5339	17	123	0	5566
7906	5433	83	17	89	0	5622
7907	5464	49	16	56	0	5585
7908	5458	31	25	47	0	5561
7909	5435	23	15	60	0	5533
7910	153	22	33	5320	0	5528
7911	106	17	5283	108	0	5514
7912	59	11	95	5292	0	5457
7913	54	18	5286	131	0	5489
7914	5249	11	96	87	0	5443
7915	5334	14	54	63	0	5465
7916	153	18	5229	59	0	5459
7917	5231	6	94	53	0	5384
7918	5496	11	57	59	0	5623
7919	163	6	31	5396	0	5596
7920	95	5367	37	120	0	5619
7921	5416	75	28	90	0	5609
7922	130	77	22	5185	0	5414
7923	102	5141	13	108	0	5364
7924	64	96	15	5075	0	5250
7925	38	35	5027	117	0	5217
7926	54	5003	65	77	0	5199
7927	4780	87	51	77	0	4995
7928	4728	45	35	63	0	4871
7929	4627	15	21	38	0	4701
7930	4679	4	28	38	0	4749
7931	104	40	14	4559	0	4717
7932	69	4531	24	73	0	4697
7933	4318	46	24	57	0	4445
7934	85	31	4462	33	0	4611
7935	59	4373	60	30	0	4522
7936	52	36	4149	33	0	4270
7937	37	40	39	3788	0	3904
7938	33	3339	28	49	0	3449
7939	27	33	17	3906	0	3983
7940	30	27	4070	46	0	4173
7941	33	12	35	3954	0	4034
7942	33	10	28	4098	0	4169
7943	32	11	12	4163	0	4218
7944	4071	4	13	59	0	4147
7945	51	4058	18	51	0	4178
7946	39	24	14	4121	0	4198
7947	4056	20	16	52	0	4144
7948	46	4073	14	45	0	4178
7949	4107	27	11	30	0	4175
7950	47	25	4152	28	0	4252
7951	44	17	35	4061	0	4157
7952	42	4152	23	36	0	4253
7953	4141	30	16	32	0	4219
7954	55	27	4083	20	0	4185
7955	51	3829	35	20	0	3935
7956	34	25	20	3981	0	4060
7957	22	28	13	4007	0	4070
7958	3964	17	7	52	0	4040
7959	42	10	15	3939	0	4006
7960	30	15	3845	39	0	3929
7961	30	17	21	3760	0	3828
7962	26	8	3915	42	0	3991
7963	32	19	33	3764	0	3848
7964	36	3874	17	27	0	3954
7965	3882	22	28	29	0	3961
7966	3817	17	7	23	0	3864
7967	48	3675	8	15	0	3746
7968	21	3511	3	20	0	3555
7969	46	23	19	3306	0	3394
7970	3281	5	7	19	0	3312
7971	18	8	8	3267	0	3301
7972	3238	5	3	23	0	3269
7973	22	3168	7	4	0	3201
7974	11	8	2	3248	0	3269
7975	9	6	3315	12	0	3342
7976	11	6	12	3262	0	3291
7977	6	1	6	3349	0	3362
7978	3408	6	1	25	0	3440
7979	16	3462	2	7	0	3487
7980	10	17	1	3506	0	3534
7981	3491	3	7	17	0	3518
7982	18	6	3514	10	0	3548
7983	3434	7	14	11	0	3466
7984	21	8	5	3568	0	3602
7985	9	3648	9	16	0	3682
7986	3658	18	3	11	0	3690
7987	23	3	3756	6	0	3788
7988	8	4	3674	4	0	3690
7989	7	3697	20	8	0	3732
7990	3623	14	26	4	0	3667
7991	18	3	3	3651	0	3675
7992	4	1	1	3643	0	3649
7993	3707	1	1	21	0	3730
7994	14	0	3714	7	0	3735
7995	6	1	13	3800	0	3820
7996	2	2	3993	15	0	4012
7997	3	1	17	3968	0	3989
7998	1	4001	6	15	0	4023
7999	2	15	2	4112	0	4131
8000	0	5	4046	18	0	4069
8001	3971	2	14	12	0	3999
8002	16	3	5	4140	0	4164
8003	9	0	4165	18	0	4192
8004	4	3	18	4111	0	4136
8005	3	1	8	4197	0	4209
8006	2	0	4169	25	0	4196
8007	0	2	4144	15	0	4161
8008	7	4	22	4311	0	4344
8009	4	2	4314	23	0	4343
8010	4243	1	22	12	0	4278
8011	22	1	10	4372	0	4405
8012	4366	3	2	28	0	4399
8013	20	1	4340	10	0	4371
8014	13	1	17	4404	0	4435
8015	7	6	4637	23	0	4673
8016	5	4568	22	13	0	4608
8017	4	18	4643	6	0	4671
8018	5	9	4398	10	0	4422
8019	4372	2	33	12	0	4419
8020	4508	4	11	11	0	4534
8021	27	8	4631	6	0	4672
8022	13	2	24	4475	0	4514
8023	9	5	16	4572	0	4602
8024	7	0	4720	32	0	4759
8025	1	4528	24	15	0	4568
8026	4490	19	10	14	0	4533
8027	20	9	4725	10	0	4764
8028	12	4	21	4761	0	4798
8029	8	2	14	4892	0	4916
8030	4970	1	5	42	0	5018
8031	4988	1	5	22	0	5016
8032	5057	2	7	5	0	5071
8033	5058	0	2	12	0	5072
8034	40	3	7	5008	0	5058
8035	16	5	5225	24	0	5270
8036	7	1	28	5201	0	5237
8037	13	0	11	5246	0	5270
8038	10	1	4	5421	0	5436
8039	7	5	5346	40	0	5398
8040	5065	1	32	19	0	5117
8041	35	1	14	5378	0	5428
8042	16	1	5560	36	0	5613
8043	8	5641	34	16	0	5699
8044	6	28	14	5782	0	5830
8045	7	15	10	5799	0	5831
8046	5740	4	8	48	0	5800
8047	32	5796	4	19	0	5851
8048	12	31	5809	14	0	5866
8049	13	7	35	5732	0	5787
8050	8	7	11	5719	0	5745
8051	5686	2	9	53	0	5750
8052	5673	4	8	19	0	5704
8053	48	5	3	5767	0	5823
8054	5744	2	9	38	0	5793
8055	41	5678	12	16	0	5747
8056	19	30	5947	14	0	6010
8057	11	7	34	5933	0	5985
8058	15	3	14	6055	0	6087
8059	11	2	3	6086	0	6102
8060	10	3	7	5998	0	6018
8061	8	5919	7	47	0	5981
8062	5847	35	6	20	0	5908
8063	37	8	7	5907	0	5959
8064	9	6068	8	42	0	6127
8065	6157	34	3	30	0	6224
8066	6115	14	11	14	0	6154
8067	44	6262	5	17	0	6328
8068	22	36	0	6370	0	6428
8069	19	13	2	6384	0	6418
8070	17	6	8	6266	0	6297
8071	12	8	2	6381	0	6403
8072	6486	3	4	63	0	6556
8073	6573	2	7	33	0	6615
8074	60	6612	2	17	0	6691
8075	25	48	6615	18	0	6706
8076	13	14	45	6699	0	6771
8077	6761	8	11	65	0	6845
8078	56	6610	6	28	0	6700
8079	21	6670	11	15	0	6717
8080	6783	64	3	23	0	6873
8081	6885	22	9	22	0	6938
8082	82	12	4	6886	0	6984
8083	36	11	7028	61	0	7136
8084	21	5	6922	29	0	6977
8085	7219	11	65	35	0	7330
8086	7432	16	21	25	0	7494
8087	7367	5	18	12	0	7402
8088	7323	3	9	23	0	7358
8089	7330	7	8	18	0	7363
8090	77	7400	8	20	0	7505
8091	41	58	10	7322	0	7431
8092	23	7620	4	53	0	7700
8093	7679	63	11	27	0	7780
8094	7591	36	2	25	0	7654
8095	7576	14	4	26	0	7620
8096	7495	11	9	19	0	7534
8097	72	7431	7	8	0	7518
8098	7411	52	3	17	0	7483
8099	62	7453	5	13	0	7533
8100	35	62	3	7471	0	7571
8101	7465	18	2	63	0	7548
8102	62	13	7554	24	0	7653
8103	32	9	41	7404	0	7486
8104	29	10	8	7550	0	7597
8105	17	16	7518	58	0	7609
8106	12	7469	51	28	0	7560
8107	7466	52	20	27	0	7565
8108	7454	13	8	17	0	7492
8109	70	7432	5	7	0	7514
8110	37	54	6	7465	0	7562
8111	28	24	7672	55	0	7779
8112	25	7832	47	23	0	7927
8113	7846	60	12	30	0	7948
8114	55	23	7806	13	0	7897
8115	7242	19	52	14	0	7327
8116	7589	6	11	31	0	7637
8117	77	11	7853	14	0	7955
8118	32	7812	46	12	0	7902
8119	44	54	17	7702	0	7817
8120	24	16	7986	42	0	8068
8121	7539	22	53	21	0	7635
8122	7784	14	14	28	0	7840
8123	72	7820	12	14	0	7918
8124	41	51	7	7828	0	7927
8125	32	22	6	7950	0	8010
8126	23	15	7990	58	0	8086
8127	16	7928	50	25	0	8019
8128	8092	55	21	37	0	8205
8129	8127	21	8	22	0	8178
8130	8180	11	8	23	0	8222
8131	72	14	8079	14	0	8179
8132	7927	5	45	16	0	7993
8133	8189	13	18	14	0	8234
8134	69	11	12	8177	0	8269
8135	25	20	7958	48	0	8051
8136	29	7	43	7891	0	7970
8137	17	13	8017	53	0	8100
8138	34	19	42	7846	0	7941
8139	19	7868	20	92	0	7999
8140	15	8209	10	26	0	8260
8141	27	55	8	8305	0	8395
8142	27	29	9	8021	0	8086
8143	7986	14	13	69	0	8082
8144	61	6	7930	24	0	8021
8145	7724	8	48	18	0	7798
8146	51	8023	16	16	0	8106
8147	8080	41	10	24	0	8155
8148	8096	16	10	24	0	8146
8149	71	10	8	8090	0	8179
8150	26	8	8286	50	0	8370
8151	28	3	46	8259	0	8336
8152	16	8608	17	47	0	8688
8153	23	66	6	8656	0	8751
8154	14	16	10	8727	0	8767
8155	8582	15	5	80	0	8682
8156	75	4	13	8397	0	8489
8157	26	8267	11	73	0	8377
8158	29	61	4	8406	0	8500
8159	8450	19	6	86	0	8561
8160	63	8509	14	22	0	8608
8161	29	66	1	8708	0	8804
8162	21	21	8	8732	0	8782
8163	16	18	9	8961	0	9004
8164	16	6	3	8903	0	8928
8165	8983	7	8	114	0	9112
8166	92	8	4	9164	0	9268
8167	36	6	7	9326	0	9375
8168	30	17	6	9435	0	9488
8169	15	9618	8	124	0	9765
8170	9555	98	4	59	0	9716
8171	111	22	9641	32	0	9806
8172	33	9457	96	20	0	9606
8173	9281	82	27	27	0	9417
8174	90	25	9448	16	0	9579
8175	28	9376	79	13	0	9496
8176	41	129	34	9170	0	9374
8177	14	9388	17	81	0	9500
8178	18	103	9319	18	0	9458
8179	17	22	9254	32	0	9325
8180	6	9305	93	21	0	9425
8181	9221	82	37	25	0	9365
8182	9184	22	16	30	0	9252
8183	84	29	8883	9	0	9005
8184	33	15	8388	14	0	8450
8185	27	11	8656	7	0	8701
8186	19	13	105	8633	0	8770
8187	24	7	38	8607	0	8676
8188	17	6	24	8853	0	8900
8189	16	8	8936	112	0	9072
8190	17	4	86	8601	0	8708
8191	16	9	28	8797	0	8850
8192	5	9	8744	115	0	8873
8193	8647	5	89	60	0	8801
8194	105	8	25	9161	0	9299
8195	35	6	27	9138	0	9206
8196	22	9308	13	122	0	9465
8197	9338	99	15	65	0	9517
8198	111	28	9320	34	0	9493
8199	9215	27	104	33	0	9379
8200	126	9	37	9324	0	9496
8201	41	19	9433	116	0	9609
8202	45	15	100	9329	0	9489
8203	9430	10	43	151	0	9634
8204	119	7	9428	46	0	9600
8205	9303	9	110	56	0	9478
8206	9452	6	45	43	0	9546
8207	9525	11	31	40	0	9607
8208	159	9423	15	32	0	9629
8209	76	104	22	9639	0	9841
8210	9822	37	27	122	0	10008
8211	9749	27	15	60	0	9851
8212	9945	10	14	50	0	10019
8213	178	14	9689	21	0	9902
8214	10118	16	112	30	0	10276
8215	179	5	52	10605	0	10841
8216	76	15	10572	155	0	10818
8217	68	8	151	10815	0	11042
8218	51	8	56	10903	0	11018
8219	31	17	11065	216	0	11329
8220	47	5	174	11162	0	11388
8221	44	12	70	11577	0	11703
8222	33	14	12835	259	0	13141
8223	13584	1	236	148	0	13969
8224	15016	7	144	95	0	15262
8225	413	13	86	15446	0	15958
8226	218	11	15380	335	0	15944
8227	196	7	340	15110	0	15653
8228	151	15101	164	380	0	15796
8229	171	274	98	15225	0	15768
8230	122	119	91	15538	0	15870
8231	15197	79	111	552	0	15939
8232	15223	55	86	344	0	15708
8233	15489	69	82	278	0	15918
8234	539	73	69	15262	0	15943
8235	338	47	34	15566	0	15985
8236	255	54	15075	552	0	15936
8237	268	37	305	14844	0	15454
8238	241	15011	141	478	0	15871
8239	15086	283	102	327	0	15798
8240	420	14856	100	276	0	15652
8241	15022	348	103	264	0	15737
8242	448	184	113	14447	0	15192
8243	242	14732	77	450	0	15501
8244	14824	380	82	252	0	15538
8245	15002	234	64	214	0	15514
8246	576	192	44	14578	0	15390
8247	354	14624	49	441	0	15468
8248	272	402	49	14722	0	15445
8249	249	218	14458	465	0	15390
8250	14308	138	313	317	0	15076
8251	448	14374	164	265	0	15251
8252	14218	361	114	211	0	14904
8253	482	211	79	14180	0	14952
8254	14323	158	119	457	0	15057
8255	514	129	14362	264	0	15269
8256	14799	123	337	209	0	15468
8257	14943	111	193	206	0	15453
8258	659	99	14701	187	0	15646
8259	469	80	354	14636	0	15539
8260	399	73	233	14781	0	15486
8261	14583	54	180	560	0	15377
8262	556	14350	158	357	0	15421
8263	384	406	173	14142	0	15105
8264	288	174	13868	535	0	14865
8265	256	132	13750	397	0	14535
8266	227	13548	435	331	0	14541
8267	265	370	13424	295	0	14354
8268	12954	272	435	270	0	13931
8269	450	167	277	12714	0	13608
8270	13002	141	230	431	0	13804
8271	429	139	12911	307	0	13786
8272	296	139	439	12907	0	13781
8273	272	126	281	13139	0	13818
8274	260	117	12698	542	0	13617
8275	288	100	390	12841	0	13619
8276	12706	96	233	507	0	13542
8277	12873	94	185	394	0	13546
8278	538	79	174	12784	0	13575
8279	12674	85	185	544	0	13488
8280	12754	74	156	404	0	13388
8281	631	12372	131	319	0	13453
8282	496	287	122	12568	0	13473
8283	12729	157	109	521	0	13516
8284	629	122	94	12671	0	13516
8285	12620	108	111	520	0	13359
8286	579	137	108	12459	0	13283
8287	406	129	12291	566	0	13392
8288	348	12187	325	421	0	13281
8289	354	351	194	11021	0	11920
8290	325	12135	164	495	0	13119
8291	12108	353	148	350	0	12959
8292	481	11696	156	306	0	12639
8293	361	11685	144	266	0	12456
8294	299	490	135	11415	0	12339
8295	11336	328	145	467	0	12276
8296	446	272	107	11357	0	12182
8297	11294	230	95	508	0	12127
8298	11289	241	80	353	0	11963
8299	546	11203	95	281	0	12125
8300	11404	370	99	292	0	12165
8301	11428	235	115	256	0	12034
8302	11492	158	104	255	0	12009
8303	710	155	10765	199	0	11829
8304	510	150	298	10831	0	11789
8305	478	136	160	11041	0	11815
8306	416	120	10410	482	0	11428
8307	10906	123	319	333	0	11681
8308	11144	90	240	305	0	11779
8309	11029	64	180	293	0	11566
8310	10693	74	157	312	0	11236
8311	627	10183	161	281	0	11252
8312	10295	262	103	251	0	10911
8313	681	156	93	9948	0	10878
8314	512	118	8834	362	0	9826
8315	9281	108	199	213	0	9801
8316	561	9071	134	196	0	9962
8317	8784	270	100	160	0	9314
8318	478	8447	81	197	0	9203
8319	343	8088	83	197	0	8711
8320	313	7902	81	190	0	8486
8321	292	7721	127	225	0	8365
8322	273	360	5997	195	0	6825
8323	221	461	227	4691	0	5600
8324	92	59	4058	110	0	4319
8325	3321	39	55	37	0	3452
8326	58	3309	33	42	0	3442
8327	44	3313	12	32	0	3401
8328	38	56	16	3244	0	3354
8329	39	39	13	3263	0	3354
8330	33	38	3199	60	0	3330
8331	29	26	3188	43	0	3286
8332	32	22	54	3189	0	3297
8333	25	17	3208	65	0	3315
8334	41	3189	48	26	0	3304
8335	35	53	24	3107	0	3219
8336	34	28	11	3357	0	3430
8337	44	12	3302	66	0	3424
8338	38	16	44	3267	0	3365
8339	3332	12	23	59	0	3426
8340	66	11	19	3266	0	3362
8341	32	14	14	3254	0	3314
8342	32	9	3213	81	0	3335
8343	3108	10	55	43	0	3216
8344	78	3198	21	29	0	3326
8345	52	44	14	3226	0	3336
8346	46	20	3212	60	0	3338
8347	48	19	39	3211	0	3317
8348	3242	25	22	64	0	3353
8349	84	18	3235	25	0	3362
8350	46	21	49	3247	0	3363
8351	45	9	3305	60	0	3419
8352	39	3278	47	35	0	3399
8353	35	59	3254	22	0	3370
8354	40	3179	54	22	0	3295
8355	20	48	2874	13	0	2955
8356	16	52	45	2597	0	2710
8357	12	2621	12	35	0	2680
8358	2544	30	3	19	0	2596
8359	36	13	5	2577	0	2631
8360	2647	9	4	38	0	2698
8361	47	7	3	2741	0	2798
8362	15	10	4	2795	0	2824
8363	2778	7	4	49	0	2838
8364	2830	6	7	14	0	2857
8365	54	5	6	2932	0	2997
8366	26	6	3001	42	0	3075
8367	16	2968	41	18	0	3043
8368	19	38	3020	10	0	3087
8369	8	3043	41	16	0	3108
8370	2999	41	20	5	0	3065
8371	41	17	2955	3	0	3016
8372	20	10	2939	9	0	2978
8373	13	6	54	2875	0	2948
8374	2922	6	16	41	0	2985
8375	39	6	3068	16	0	3129
8376	24	3207	34	10	0	3275
8377	3277	34	12	11	0	3334
8378	3342	14	5	14	0	3375
8379	3390	10	4	14	0	3418
8380	3396	7	7	8	0	3418
8381	3357	8	5	10	0	3380
8382	56	5	3328	5	0	3394
8383	18	22	36	3209	0	3285
8384	10	3221	17	36	0	3284
8385	3294	36	10	13	0	3353
8386	35	3344	8	8	0	3395
8387	3185	33	7	5	0	3230
8388	3170	13	7	4	0	3194
8389	37	3142	7	5	0	3191
8390	3209	26	8	6	0	3249
8391	36	13	4	3218	0	3271
8392	21	4	3	3257	0	3285
8393	8	6	3218	32	0	3264
8394	7	3288	27	17	0	3339
8395	10	24	12	3306	0	3352
8396	12	15	5	3340	0	3372
8397	15	6	4	3354	0	3379
8398	10	6	3244	35	0	3295
8399	3111	1	28	13	0	3153
8400	27	9	12	3298	0	3346
8401	3353	3	8	34	0	3398
8402	37	5	6	3357	0	3405
8403	19	6	3476	35	0	3536
8404	13	5	3483	16	0	3517
8405	3404	5	39	10	0	3458
8406	3530	8	14	10	0	3562
8407	44	3470	12	6	0	3532
8408	21	28	3464	10	0	3523
8409	15	14	27	3411	0	3467
8410	33	9	24	2620	0	2686
8411	3556	7	8	46	0	3617
8412	3555	6	6	23	0	3590
8413	3567	3	2	15	0	3587
8414	41	7	3533	10	0	3591
8415	3589	4	30	11	0	3634
8416	40	5	15	3627	0	3687
8417	27	5	5	3647	0	3684
8418	17	3	5	3666	0	3691
8419	10	3598	7	44	0	3659
8420	3559	25	10	26	0	3620
8421	33	15	11	3554	0	3613
8422	18	13	3566	37	0	3634
8423	13	2	32	3554	0	3601
8424	10	3579	13	34	0	3636
8425	3608	30	15	19	0	3672
8426	36	15	10	3585	0	3646
8427	25	7	1	3550	0	3583
8428	14	4	3568	49	0	3635
8429	10	6	30	3549	0	3595
8430	10	3571	16	44	0	3641
8431	14	28	8	3646	0	3696
8432	11	10	3712	40	0	3773
8433	3460	9	29	21	0	3519
8434	3659	7	14	14	0	3694
8435	41	3715	10	13	0	3779
8436	3624	23	7	12	0	3666
8437	3702	14	3	12	0	3731
8438	39	3676	4	15	0	3734
8439	19	28	12	3698	0	3757
8440	3789	9	7	40	0	3845
8441	29	3904	4	12	0	3949
8442	16	26	3967	10	0	4019
8443	3946	15	24	11	0	3996
8444	4147	5	12	11	0	4175
8445	4169	2	4	17	0	4192
8446	4146	9	4	14	0	4173
8447	46	4254	6	6	0	4312
8448	4309	21	3	13	0	4346
8449	4384	13	5	13	0	4415
8450	4443	7	8	14	0	4472
8451	43	8	3	4479	0	4533
8452	4487	6	4	30	0	4527
8453	32	4696	3	16	0	4747
8454	18	33	4891	11	0	4953
8455	20	22	36	5116	0	5194
8456	5204	6	14	53	0	5277
8457	53	2	5218	20	0	5293
8458	20	7	47	5231	0	5305
8459	16	8	5198	51	0	5273
8460	13	5139	58	23	0	5233
8461	11	45	19	5099	0	5174
8462	13	10	5146	53	0	5222
8463	9	5141	47	13	0	5210
8464	26	52	15	5147	0	5240
8465	5146	15	19	55	0	5235
8466	5180	11	9	19	0	5219
8467	5188	5	1	22	0	5216
8468	5161	5	8	12	0	5186
8469	5153	6	4	16	0	5179
8470	60	2	5197	10	0	5269
8471	5175	3	40	5	0	5223
8472	5301	2	13	8	0	5324
8473	59	4	8	5270	0	5341
8474	5281	5	10	43	0	5339
8475	5115	4	5	15	0	5139
8476	50	5002	6	14	0	5072
8477	25	42	3	5058	0	5128
8478	23	10	3	5050	0	5086
8479	5030	7	1	61	0	5099
8480	49	5004	8	15	0	5076
8481	20	5066	4	14	0	5104
8482	17	56	4	5128	0	5205
8483	19	11	4	5164	0	5198
8484	12	12	9	5154	0	5187
8485	14	6	2	5216	0	5238
8486	5106	5	3	65	0	5179
8487	5049	5	3	31	0	5088
8488	57	6	5123	16	0	5202
8489	33	4	39	5070	0	5146
8490	21	6	11	5133	0	5171
8491	13	8	5076	63	0	5160
8492	4911	2	47	29	0	4989
8493	59	5037	13	11	0	5120
8494	5020	45	8	18	0	5091
8495	61	16	7	5032	0	5116
8496	27	8	5113	54	0	5202
8497	23	8	45	5185	0	5261
8498	18	6	5314	54	0	5392
8499	6	5340	51	29	0	5426
8500	5276	44	18	21	0	5359
8501	5253	9	7	21	0	5290
8502	55	5236	11	11	0	5313
8503	21	46	7	5107	0	5181
8504	5046	15	7	52	0	5120
8505	55	5018	8	14	0	5095
8506	21	49	7	5084	0	5161
8507	5124	14	0	65	0	5203
8508	58	12	5058	19	0	5147
8509	4992	8	46	26	0	5072
8510	56	5080	13	16	0	5165
8511	5069	50	7	17	0	5143
8512	5058	10	12	19	0	5099
8513	72	10	5019	8	0	5109
8514	29	12	53	4923	0	5017
8515	27	4	11	5056	0	5098
8516	18	10	5020	59	0	5107
8517	20	7	51	4942	0	5020
8518	30	7	13	4662	0	4712
8519	5060	7	11	67	0	5145
8520	5069	7	12	33	0	5121
8521	66	2	7	5055	0	5130
8522	25	5	5041	54	0	5125
8523	27	12	46	5034	0	5119
8524	21	8	13	5108	0	5150
8525	17	6	5119	60	0	5202
8526	25	4	49	5163	0	5241
8527	5133	5	14	71	0	5223
8528	5122	9	15	29	0	5175
8529	65	5065	6	26	0	5162
8530	5186	40	7	22	0	5255
8531	5180	17	8	14	0	5219
8532	66	5151	5	20	0	5242
8533	5190	44	5	23	0	5262
8534	5224	11	14	13	0	5262
8535	5289	13	3	23	0	5328
8536	76	13	5164	14	0	5267
8537	5167	4	48	11	0	5230
8538	70	4	11	5297	0	5382
8539	5327	5	12	63	0	5407
8540	60	4	5320	24	0	5408
8541	29	5165	43	19	0	5256
8542	5175	52	22	20	0	5269
8543	62	5314	11	8	0	5395
8544	30	54	6	5236	0	5326
8545	26	16	3	5318	0	5363
8546	5314	10	7	73	0	5404
8547	5222	12	5	31	0	5270
8548	79	6	5171	20	0	5276
8549	38	3	4881	18	0	4940
8550	16	6	4983	13	0	5018
8551	29	35	68	4840	0	4972
8552	15	5	4854	61	0	4935
8553	17	8	4586	19	0	4630
8554	72	120	66	4301	0	4559
8555	4395	10	33	47	0	4485
8556	4402	1	11	22	0	4436
8557	4443	5	9	9	0	4466
8558	4471	1	4	14	0	4490
8559	47	1	9	4441	0	4498
8560	20	2	9	4497	0	4528
8561	9	5	4630	46	0	4690
8562	19	0	32	4561	0	4612
8563	16	3	13	4369	0	4401
8564	4690	2	7	44	0	4743
8565	4754	0	7	18	0	4779
8566	47	5	2	4702	0	4756
8567	4792	1	3	47	0	4843
8568	4862	4	9	21	0	4896
8569	61	1	1	4945	0	5008
8570	29	0	4	4908	0	4941
8571	23	1	4841	61	0	4926
8572	18	2	4763	26	0	4809
8573	9	11	61	4840	0	4921
8574	16	1	21	4951	0	4989
8575	10	3	4928	59	0	5000
8576	4734	3	41	39	0	4817
8577	4813	0	24	22	0	4859
8578	65	3	4812	6	0	4886
8579	34	4805	48	13	0	4900
8580	4931	35	25	19	0	5010
8581	48	18	5135	13	0	5214
8582	26	19	49	5060	0	5154
8583	26	2	26	5177	0	5231
8584	5284	4	16	59	0	5363
8585	5451	3	10	39	0	5503
8586	62	4	10	5486	0	5562
8587	44	3	9	5740	0	5796
8588	5794	0	9	78	0	5881
8589	5861	3	8	37	0	5909
8590	5856	3	10	19	0	5888
8591	86	7	5845	14	0	5952
8592	43	2	57	5875	0	5977
8593	20	3	32	6013	0	6068
8594	5956	0	14	96	0	6066
8595	65	5965	5	49	0	6084
8596	6308	51	14	20	0	6393
8597	88	6382	16	15	0	6501
8598	39	70	10	6553	0	6672
8599	31	22	8	6683	0	6744
8600	23	9	6652	123	0	6807
8601	32	2	85	6659	0	6778
8602	23	9	6642	98	0	6772
8603	19	6	98	6691	0	6814
8604	16	9	33	6693	0	6751
8605	20	6455	17	137	0	6629
8606	23	6669	19	59	0	6770
8607	26	112	18	6521	0	6677
8608	28	34	8	6752	0	6822
8609	25	15	13	6805	0	6858
8610	17	9	17	6912	0	6955
8611	22	6	4	6974	0	7006
8612	20	14	6810	147	0	6991
8613	22	9	100	6798	0	6929
8614	21	9	32	6939	0	7001
8615	28	4	6695	154	0	6881
8616	19	6641	101	79	0	6840
8617	29	92	37	6732	0	6890
8618	16	32	6709	140	0	6897
8619	16	6751	111	69	0	6947
8620	26	93	43	6812	0	6974
8621	6909	31	21	124	0	7085
8622	102	14	28	6884	0	7028
8623	41	19	18	6953	0	7031
8624	32	13	19	6991	0	7055
8625	32	8	22	6869	0	6931
8626	31	6646	19	156	0	6852
8627	24	92	14	6812	0	6942
8628	6908	33	12	156	0	7109
8629	115	22	10	7023	0	7170
8630	43	14	14	6997	0	7068
8631	24	14	13	7078	0	7129
8632	6809	14	12	179	0	7014
8633	6851	10	8	94	0	6963
8634	141	9	12	6865	0	7027
8635	6512	5	12	158	0	6687
8636	6679	7	7	95	0	6788
8637	125	6653	19	49	0	6846
8638	6606	95	12	56	0	6769
8639	110	6568	11	59	0	6748
8640	51	6554	16	41	0	6662
8641	38	118	19	6582	0	6757
8642	28	34	6622	129	0	6813
8643	40	25	83	6450	0	6598
8644	27	23	35	6479	0	6564
8645	19	6408	17	127	0	6571
8646	6366	93	9	70	0	6538
8647	103	37	14	6389	0	6543
8648	36	18	6607	120	0	6781
8649	22	20	81	6538	0	6661
8650	15	6707	42	119	0	6883
8651	6740	87	17	71	0	6915
8652	95	32	17	6791	0	6935
8653	38	19	6769	116	0	6942
8654	30	17	74	6759	0	6880
8655	14	6598	26	119	0	6757
8656	20	89	14	6692	0	6815
8657	6870	31	3	141	0	7045
8658	7007	18	15	74	0	7114
8659	7077	11	12	69	0	7169
8660	117	7117	12	81	0	7327
8661	7167	88	14	54	0	7323
8662	113	33	8	7255	0	7409
8663	7226	20	10	121	0	7377
8664	114	7256	7	68	0	7445
8665	52	115	10	7187	0	7364
8666	28	41	7234	113	0	7416
8667	6824	26	88	73	0	7011
8668	109	7197	34	34	0	7374
8669	52	105	10	7157	0	7324
8670	21	34	9	7305	0	7369
8671	25	17	12	7166	0	7220
8672	25	13	5	7067	0	7110
8673	17	7026	8	135	0	7186
8674	7066	81	10	76	0	7233
8675	7113	38	5	56	0	7212
8676	111	17	7160	40	0	7328
8677	48	15	78	7207	0	7348
8678	21	22	7194	109	0	7346
8679	7048	13	85	68	0	7214
8680	7103	11	30	40	0	7184
8681	6904	6	17	41	0	6968
8682	120	9	9	6784	0	6922
8683	48	6714	18	92	0	6872
8684	6760	79	6	43	0	6888
8685	100	25	6	6674	0	6805
8686	6679	19	10	102	0	6810
8687	101	14	6394	51	0	6560
8688	42	17	6165	32	0	6256
8689	6386	16	76	26	0	6504
8690	87	21	28	6392	0	6528
8691	6324	10	19	87	0	6440
8692	83	6334	11	45	0	6473
8693	6346	68	19	33	0	6466
8694	6380	29	13	36	0	6458
8695	97	13	6375	31	0	6516
8696	47	13	5845	14	0	5919
8697	20	5865	60	16	0	5961
8698	65	70	47	5655	0	5837
8699	5686	21	30	51	0	5788
8700	44	8	8	5676	0	5736
8701	27	2	12	5812	0	5853
8702	14	13	5699	52	0	5778
8703	5581	8	33	34	0	5656
8704	56	12	13	5856	0	5937
8705	26	9	5784	45	0	5864
8706	20	7	5609	27	0	5663
8707	13	29	45	5788	0	5875
8708	15	10	5825	37	0	5887
8709	19	4	5765	23	0	5811
8710	36	9	42	5478	0	5565
8711	12	4	5868	34	0	5918
8712	9	5	33	5780	0	5827
8713	6	5625	19	38	0	5688
8714	5988	30	8	21	0	6047
8715	36	6075	2	17	0	6130
8716	30	36	4	6110	0	6180
8717	11	6258	7	42	0	6318
8718	13	47	6465	18	0	6543
8719	20	14	49	7115	0	7198
8720	12	13	8166	77	0	8268
8721	8346	6	97	50	0	8499
8722	110	9042	42	12	0	9206
8723	9212	109	32	18	0	9371
8724	162	53	10	9131	0	9356
8725	9291	36	9	133	0	9469
8726	169	16	9266	49	0	9500
8727	69	9328	114	45	0	9556
8728	9265	121	53	27	0	9466
8729	157	47	31	9025	0	9260
8730	69	9278	17	113	0	9477
8731	69	128	21	9412	0	9630
8732	9584	65	14	167	0	9830
8733	148	10333	18	66	0	10565
8734	10390	161	9	72	0	10632
8735	199	88	10274	32	0	10593
8736	10334	44	156	46	0	10580
8737	214	19	66	10354	0	10653
8738	10329	24	42	173	0	10568
8739	202	10272	26	73	0	10573
8740	102	165	26	10296	0	10589
8741	85	64	19	10430	0	10598
8742	39	48	10067	241	0	10395
8743	40	25	162	10041	0	10268
8744	50	25	68	10211	0	10354
8745	42	25	41	10286	0	10394
8746	40	21	20	10346	0	10427
8747	23	15	10191	272	0	10501
8748	29	9818	177	130	0	10154
8749	38	166	64	9953	0	10221
8750	9814	72	45	219	0	10150
8751	9854	39	20	122	0	10035
8752	235	9884	34	69	0	10222
8753	9847	179	34	67	0	10127
8754	9894	78	12	73	0	10057
8755	9835	44	34	64	0	9977
8756	286	9623	23	53	0	9985
8757	9449	178	15	57	0	9699
8758	232	89	16	9197	0	9534
8759	116	43	9131	191	0	9481
8760	74	9069	156	94	0	9393
8761	92	191	81	8947	0	9311
8762	39	82	8874	193	0	9188
8763	8793	49	150	93	0	9085
8764	178	29	69	8847	0	9123
8765	102	38	51	8883	0	9074
8766	82	41	19	8853	0	8995
8767	78	19	24	8895	0	9016
8768	67	36	8551	243	0	8897
8769	8118	32	145	138	0	8433
8770	186	8479	64	87	0	8816
8771	8566	146	42	79	0	8833
8772	204	8563	29	58	0	8854
8773	8657	194	22	59	0	8932
8774	220	74	30	8615	0	8939
8775	99	67	8589	182	0	8937
8776	78	44	8599	96	0	8817
8777	63	32	202	8605	0	8902
8778	53	32	91	8677	0	8853
8779	58	18	47	8757	0	8880
8780	8535	25	38	285	0	8883
8781	174	18	8573	139	0	8904
8782	103	31	166	8330	0	8630
8783	67	8605	75	200	0	8947
8784	8543	165	43	126	0	8877
8785	193	80	8491	85	0	8849
8786	112	8411	168	57	0	8748
8787	85	163	8479	54	0	8781
8788	64	90	190	8481	0	8825
8789	68	58	8408	186	0	8720
8790	65	41	8451	98	0	8655
8791	59	23	223	8493	0	8798
8792	38	50	8524	205	0	8817
8793	53	18	8557	111	0	8739
8794	41	25	215	8455	0	8736
8795	8333	21	121	206	0	8681
8796	173	45	8366	116	0	8700
8797	106	17	181	8317	0	8621
8798	75	28	102	8444	0	8649
8799	8376	31	67	249	0	8723
8800	181	34	54	8460	0	8729
8801	8334	23	39	233	0	8629
8802	189	8277	56	121	0	8643
8803	106	147	46	8447	0	8746
8804	8422	80	43	209	0	8754
8805	8514	42	49	114	0	8719
8806	224	31	42	8455	0	8752
8807	133	20	8359	201	0	8713
8808	8115	34	168	114	0	8431
8809	189	8327	90	97	0	8703
8810	8118	154	63	84	0	8419
8811	8320	65	35	78	0	8498
8812	8346	44	44	78	0	8512
8813	255	25	8156	64	0	8500
8814	137	8140	149	68	0	8494
8815	104	198	70	8001	0	8373
8816	97	121	63	8071	0	8352
8817	83	54	7890	200	0	8227
8818	60	7405	138	131	0	7734
8819	39	6670	65	84	0	6858
8820	38	5846	24	36	0	5944
8821	5128	117	232	67	0	5544
8822	100	23	22	4936	0	5081
8823	38	6	17	4919	0	4980
8824	23	12	4888	79	0	5002
8825	4708	19	58	27	0	4812
8826	74	15	19	4838	0	4946
8827	54	44	11	4858	0	4967
8828	30	3	4860	82	0	4975
8829	19	4829	67	25	0	4940
8830	28	98	22	4796	0	4944
8831	17	18	4769	64	0	4868
8832	9	4440	42	36	0	4527
8833	3803	17	14	18	0	3852
8834	20	4	3922	7	0	3953
8835	12	11	19	3764	0	3806
8836	2	3847	4	17	0	3870
8837	3855	19	14	14	0	3902
8838	20	10	1	3861	0	3892
8839	3896	3	0	24	0	3923
8840	3886	2	1	11	0	3900
8841	21	3914	5	8	0	3948
8842	4015	21	1	13	0	4050
8843	4173	4	2	15	0	4194
8844	21	3	4205	4	0	4233
8845	4131	1	12	12	0	4156
8846	20	1	4196	5	0	4222
8847	4079	1	13	5	0	4098
8848	4139	2	4	7	0	4152
8849	17	4	4254	0	0	4275
8850	6	2	10	4197	0	4215
8851	3	0	4298	13	0	4314
8852	4	0	3981	3	0	3988
8853	2	1	4303	1	0	4307
8854	9	9	17	4289	0	4324
8855	6	1	2	4620	0	4629
8856	3	1	2	4651	0	4657
8857	3	0	1	4772	0	4776
8858	1	1	4856	27	0	4885
8859	7	2	22	4779	0	4810
8860	3	4488	7	27	0	4525
8861	1	22	5112	13	0	5148
8862	7	9	28	5119	0	5163
8863	5	1	5311	36	0	5353
8864	0	5246	36	18	0	5300
8865	2	5385	20	4	0	5411
8866	4	43	6	5406	0	5459
8867	4	18	5413	37	0	5472
8868	4	6	5435	12	0	5457
8869	8	7	46	5455	0	5516
8870	1	3	20	5497	0	5521
8871	4	7	8	5539	0	5558
8872	2	10	5519	47	0	5578
8873	2	5421	39	28	0	5490
8874	3	5644	19	15	0	5681
8875	5	50	12	5648	0	5715
8876	3	19	5548	48	0	5618
8877	4	7	5503	20	0	5534
8878	4	5747	48	9	0	5808
8879	5812	36	28	13	0	5889
8880	38	5920	7	9	0	5974
8881	14	43	6103	2	0	6162
8882	6058	18	45	13	0	6134
8883	48	4	21	6298	0	6371
8884	6472	5	15	49	0	6541
8885	58	15	4	6510	0	6587
8886	29	5	5	6628	0	6667
8887	6661	6	6	84	0	6757
8888	63	6807	13	26	0	6909
8889	22	65	6784	12	0	6883
8890	9	6914	57	16	0	6996
8891	6872	69	15	14	0	6970
8892	68	6831	9	17	0	6925
8893	6825	74	13	15	0	6927
8894	6851	19	7	12	0	6889
8895	82	6908	0	9	0	6999
8896	30	67	11	6802	0	6910
8897	6794	25	5	73	0	6897
8898	6844	9	8	25	0	6886
8899	85	18	5	6741	0	6849
8900	35	8	6647	73	0	6763
8901	24	5	6655	22	0	6706
8902	15	14	87	6723	0	6839
8903	10	4	6665	83	0	6762
8904	6432	7	62	37	0	6538
8905	74	6604	20	14	0	6712
8906	25	69	12	6750	0	6856
8907	14	18	16	6770	0	6818
8908	10	10	12	6757	0	6789
8909	9	8	4	6669	0	6690
8910	12	5	13	6730	0	6760
8911	12	9	6655	96	0	6772
8912	9	6634	66	30	0	6739
8913	6668	68	16	22	0	6774
8914	72	18	11	6612	0	6713
8915	22	10	10	6661	0	6703
8916	18	6	7	6663	0	6694
8917	13	6613	3	97	0	6726
8918	16	70	11	6743	0	6840
8919	12	23	6	6817	0	6858
8920	6678	9	10	105	0	6802
8921	68	6462	7	38	0	6575
8922	24	6567	6	31	0	6628
8923	17	75	3	6589	0	6684
8924	6533	35	6	87	0	6661
8925	78	18	6602	31	0	6729
8926	6347	10	65	32	0	6454
8927	89	6	6746	18	0	6859
8928	25	13	70	6706	0	6814
8929	26	11	27	6769	0	6833
8930	15	11	15	6710	0	6751
8931	21	7	7	6721	0	6756
8932	8	7	13	6616	0	6644
8933	6634	5	4	107	0	6750
8934	69	5	6541	39	0	6654
8935	23	7	63	6641	0	6734
8936	15	7	6807	89	0	6918
8937	5	6790	71	38	0	6904
8938	6770	68	25	28	0	6891
8939	73	20	6955	27	0	7075
8940	32	20	70	7074	0	7196
8941	26	10	26	7214	0	7276
8942	8	10	7133	108	0	7259
8943	11	6	7074	38	0	7129
8944	20	12	97	6707	0	6836
8945	7117	5	41	96	0	7259
8946	7151	6	21	37	0	7215
8947	99	7080	8	38	0	7225
8948	7194	75	9	38	0	7316
8949	93	27	8	6953	0	7081
8950	29	7193	11	87	0	7320
8951	28	77	8	7234	0	7347
8952	22	33	7275	103	0	7433
8953	27	11	74	7091	0	7203
8954	24	16	28	7239	0	7307
8955	6971	8	16	97	0	7092
8956	72	6951	8	48	0	7079
8957	6858	68	11	28	0	6965
8958	90	6836	5	21	0	6952
8959	6589	74	13	23	0	6699
8960	81	6503	9	20	0	6613
8961	18	6422	13	19	0	6472
8962	6343	69	48	26	0	6486
8963	73	38	15	6171	0	6297
8964	26	6212	9	55	0	6302
8965	6296	59	14	34	0	6403
8966	6337	15	4	26	0	6382
8967	6389	14	9	18	0	6430
8968	6301	10	8	17	0	6336
8969	74	6339	8	21	0	6442
8970	32	57	7	6452	0	6548
8971	18	16	9	6527	0	6570
8972	6518	17	10	73	0	6618
8973	65	7	8	6488	0	6568
8974	6384	6	2	93	0	6485
8975	79	6	6235	25	0	6345
8976	6147	7	58	35	0	6247
8977	74	14	6291	17	0	6396
8978	26	35	56	6212	0	6329
8979	6191	10	16	64	0	6281
8980	66	6117	10	17	0	6210
8981	5869	49	5	28	0	5951
8982	63	5722	10	12	0	5807
8983	20	73	8	6008	0	6109
8984	21	10	5854	46	0	5931
8985	5460	27	52	28	0	5567
8986	46	5693	9	13	0	5761
8987	25	50	8	5588	0	5671
8988	10	15	2	5494	0	5521
8989	17	9	4	5451	0	5481
8990	7	8	5429	40	0	5484
8991	8	5404	24	19	0	5455
8992	5374	26	10	20	0	5430
8993	5382	10	7	11	0	5410
8994	32	5379	3	5	0	5419
8995	5466	27	4	24	0	5521
8996	43	10	3	5459	0	5515
8997	15	5458	6	32	0	5511
8998	5481	33	4	22	0	5540
8999	40	11	5427	5	0	5483
9000	18	5525	24	9	0	5576
9001	16	33	13	5536	0	5598
9002	13	11	7	5583	0	5614
9003	9	10	5477	38	0	5534
9004	16	5	22	5414	0	5457
9005	5	12	5444	36	0	5497
9006	20	2	27	5431	0	5480
9007	7	8	12	5485	0	5512
9008	13	6	8	5467	0	5494
9009	13	4	4	5523	0	5544
9010	9	9	5460	46	0	5524
9011	7	7	5591	23	0	5628
9012	11	6195	36	19	0	6261
9013	13	42	17	6694	0	6766
9014	8	16	7042	57	0	7123
9015	13	7042	53	16	0	7124
9016	15	76	16	7379	0	7486
9017	15	20	7770	67	0	7872
9018	7514	12	71	34	0	7631
9019	8152	10	19	33	0	8214
9020	98	9	13	8163	0	8283
9021	41	6	8174	89	0	8310
9022	35	6	83	8156	0	8280
9023	8179	6	28	110	0	8323
9024	79	8266	26	49	0	8420
9025	8374	69	20	44	0	8507
9026	8465	27	13	34	0	8539
9027	120	23	10	8242	0	8395
9028	67	9	12	8272	0	8360
9029	39	16	15	8300	0	8370
9030	32	11	9	8298	0	8350
9031	28	11	13	8269	0	8321
9032	8213	12	6	151	0	8382
9033	8284	10	4	76	0	8374
9034	8213	6	4	71	0	8294
9035	115	9	7846	43	0	8013
9036	7903	7	63	45	0	8018
9037	121	17	29	7894	0	8061
9038	53	13	7905	100	0	8071
9039	43	7730	83	56	0	7912
9040	58	103	45	7625	0	7831
9041	34	34	15	7633	0	7716
9042	24	7653	18	106	0	7801
9043	32	70	20	7874	0	7996
9044	29	40	7824	105	0	7998
9045	25	18	7928	66	0	8037
9046	30	17	115	7999	0	8161
9047	7983	15	42	126	0	8166
9048	7914	9	31	79	0	8033
9049	125	12	7919	43	0	8099
9050	64	7480	97	38	0	7679
9051	43	7728	40	45	0	7856
9052	7507	111	37	36	0	7691
9053	113	44	7584	36	0	7777
9054	66	23	92	7490	0	7671
9055	7510	23	44	116	0	7693
9056	107	7368	27	62	0	7564
9057	59	7541	21	45	0	7666
9058	7452	106	20	50	0	7628
9059	111	47	21	7531	0	7710
9060	7850	28	12	122	0	8012
9061	138	24	15	8561	0	8738
9062	88	21	12	8790	0	8911
9063	53	18	8792	189	0	9052
9064	51	21	121	9193	0	9386
9065	53	19	51	9287	0	9410
9066	9291	8	37	226	0	9562
9067	166	15	29	9461	0	9671
9068	72	16	9486	216	0	9790
9069	9452	12	163	109	0	9736
9070	183	17	67	9559	0	9826
9071	9567	16	40	227	0	9850
9072	203	9237	34	116	0	9590
9073	96	9616	23	74	0	9809
9074	9524	196	30	65	0	9815
9075	9639	72	26	59	0	9796
9076	241	48	27	9460	0	9776
9077	110	40	9359	189	0	9698
9078	84	34	167	9473	0	9758
9079	9369	26	70	219	0	9684
9080	204	9327	45	108	0	9684
9081	97	176	41	9349	0	9663
9082	9314	75	29	208	0	9626
9083	214	54	8987	99	0	9354
9084	9103	43	165	70	0	9381
9085	8647	39	67	95	0	8848
9086	242	30	9149	51	0	9472
9087	123	27	9246	53	0	9449
9088	99	23	228	9012	0	9362
9089	84	15	95	9153	0	9347
9090	60	9286	67	235	0	9648
9091	66	175	48	9378	0	9667
9092	65	70	9446	246	0	9827
9093	59	39	189	9574	0	9861
9094	56	38	84	9997	0	10175
9095	58	21	9650	287	0	10016
9096	46	9575	203	151	0	9975
9097	55	171	87	9675	0	9988
9098	41	62	53	9908	0	10064
9099	9691	41	50	297	0	10079
9100	215	34	43	9667	0	9959
9101	101	31	9539	261	0	9932
9102	9438	29	182	142	0	9791
9103	9678	30	79	95	0	9882
9104	9720	26	42	91	0	9879
9105	293	26	9410	65	0	9794
9106	143	24	199	9348	0	9714
9107	95	20	84	9520	0	9719
9108	86	24	62	9571	0	9743
9109	9251	21	51	284	0	9607
9110	227	9229	36	155	0	9647
9111	123	173	8814	105	0	9215
9112	63	8530	172	86	0	8851
9113	51	8084	70	78	0	8283
9114	51	7900	61	61	0	8073
9115	160	283	90	7479	0	8012
9116	57	86	7366	190	0	7699
9117	6685	60	167	94	0	7006
9118	153	6937	73	65	0	7228
9119	6559	139	37	66	0	6801
9120	147	6742	29	55	0	6973
9121	6806	147	30	52	0	7035
9122	165	6882	20	41	0	7108
9123	73	151	6896	40	0	7160
9124	63	68	135	6844	0	7110
9125	59	39	54	7133	0	7285
9126	7035	35	35	212	0	7317
9127	160	29	42	7434	0	7665
9128	80	33	7407	207	0	7727
9129	62	24	155	7546	0	7787
9130	54	21	7494	205	0	7774
9131	43	7478	177	109	0	7807
9132	54	156	76	7195	0	7481
9133	47	7555	45	173	0	7820
9134	7556	178	36	84	0	7854
9135	187	75	34	7547	0	7843
9136	81	48	7531	182	0	7842
9137	66	33	7511	86	0	7696
9138	7409	34	206	68	0	7717
9139	184	37	86	7402	0	7709
9140	73	37	7345	190	0	7645
9141	64	26	7229	85	0	7404
9142	40	7210	204	60	0	7514
9143	43	182	97	6644	0	6966
9144	27	7032	71	138	0	7268
9145	39	155	38	6834	0	7066
9146	6917	68	40	176	0	7201
9147	149	47	33	6981	0	7210
9148	59	28	38	7120	0	7245
9149	7108	28	39	215	0	7390
9150	168	18	39	7439	0	7664
9151	69	28	29	7463	0	7589
9152	63	7616	25	216	0	7920
9153	7618	162	34	112	0	7926
9154	7776	56	35	82	0	7949
9155	209	47	19	7693	0	7968
9156	90	27	43	7760	0	7920
9157	69	28	25	7689	0	7811
9158	49	7280	29	249	0	7607
9159	45	7564	35	116	0	7760
9160	64	202	28	7209	0	7503
9161	6362	37	24	157	0	6580
9162	6296	30	25	60	0	6411
9163	137	6030	26	58	0	6251
9164	5639	104	18	39	0	5800
9165	120	5549	18	37	0	5724
9166	47	5465	19	30	0	5561
9167	100	142	45	5179	0	5466
9168	5075	40	45	94	0	5254
9169	89	4927	15	47	0	5078
9170	35	5047	11	30	0	5123
9171	29	78	10	4968	0	5085
9172	21	28	14	5035	0	5098
9173	15	24	4942	99	0	5080
9174	4879	17	68	42	0	5006
9175	4816	20	19	37	0	4892
9176	77	18	4981	32	0	5108
9177	32	19	4972	37	0	5060
9178	25	23	80	5030	0	5158
9179	26	24	22	5127	0	5199
9180	26	5112	12	110	0	5260
9181	22	87	10	5200	0	5319
9182	28	24	5191	106	0	5349
9183	20	23	80	5133	0	5256
9184	27	19	24	5222	0	5292
9185	5099	24	21	119	0	5263
9186	98	21	5035	48	0	5202
9187	4922	18	77	51	0	5068
9188	101	13	4964	37	0	5115
9189	31	22	84	4826	0	4963
9190	28	21	4802	95	0	4946
9191	18	23	4822	53	0	4916
9192	23	41	95	4678	0	4837
9193	4448	26	88	124	0	4686
9194	4359	18	22	47	0	4446
9195	91	4411	16	43	0	4561
9196	4353	78	27	38	0	4496
9197	4373	28	28	22	0	4451
9198	87	4354	24	26	0	4491
9199	43	67	18	4402	0	4530
9200	29	23	17	4466	0	4535
9201	19	25	19	4476	0	4539
9202	18	17	22	4496	0	4553
9203	19	15	4399	110	0	4543
9204	4322	17	72	57	0	4468
9205	77	14	31	4425	0	4547
9206	44	19	20	4423	0	4506
9207	34	4446	17	101	0	4598
9208	28	70	16	4507	0	4621
9209	24	29	4367	94	0	4514
9210	4361	20	61	57	0	4499
9211	78	16	4502	52	0	4648
9212	29	24	71	4426	0	4550
9213	4441	17	26	90	0	4574
9214	81	4513	20	43	0	4657
9215	45	66	7	4689	0	4807
9216	37	26	4684	96	0	4843
9217	21	23	72	4714	0	4830
9218	4666	13	25	98	0	4802
9219	86	18	4652	40	0	4796
9220	29	19	4517	40	0	4605
9221	26	4474	78	38	0	4616
9222	4360	67	42	29	0	4498
9223	76	4324	20	29	0	4449
9224	33	76	4177	27	0	4313
9225	28	23	4011	15	0	4077
9226	18	3938	71	17	0	4044
9227	3528	45	40	20	0	3633
9228	45	3501	25	15	0	3586
9229	21	44	8	3429	0	3502
9230	19	14	12	3473	0	3518
9231	11	8	3483	48	0	3550
9232	9	8	45	3465	0	3527
9233	10	7	3514	47	0	3578
9234	3440	10	46	28	0	3524
9235	3513	7	20	14	0	3554
9236	3509	9	13	11	0	3542
9237	55	4	3460	16	0	3535
9238	3445	9	43	13	0	3510
9239	49	6	21	3379	0	3455
9240	24	3454	12	45	0	3535
9241	3435	40	9	25	0	3509
9242	42	16	3304	16	0	3378
9243	3370	9	39	19	0	3437
9244	3365	3	22	14	0	3404
9245	52	5	3309	16	0	3382
9246	24	3310	45	16	0	3395
9247	27	60	27	3262	0	3376
9248	15	17	3307	36	0	3375
9249	14	8	3147	21	0	3190
9250	21	80	40	2745	0	2886
9251	8	7	2734	25	0	2774
9252	8	4	25	2611	0	2648
9253	6	7	16	2497	0	2526
9254	8	3	8	2622	0	2641
9255	7	3	2609	30	0	2649
9256	5	5	20	2623	0	2653
9257	4	12	2624	30	0	2670
9258	4	5	27	2646	0	2682
9259	2691	0	16	31	0	2738
9260	23	5	8	2710	0	2746
9261	11	2789	15	26	0	2841
9262	14	24	7	2904	0	2949
9263	2998	11	4	41	0	3054
9264	28	3033	7	24	0	3092
9265	13	28	9	3045	0	3095
9266	3038	11	7	35	0	3091
9267	28	10	3053	17	0	3108
9268	16	6	31	3066	0	3119
9269	15	6	3090	36	0	3147
9270	13	6	3031	16	0	3066
9271	11	9	43	3039	0	3102
9272	3037	5	18	33	0	3093
9273	34	2	3006	20	0	3062
9274	2978	5	30	13	0	3026
9275	39	4	22	3059	0	3124
9276	17	2	3074	27	0	3120
9277	16	3	2980	15	0	3014
9278	10	4	2992	16	0	3022
9279	16	32	42	2864	0	2954
9280	2915	5	41	24	0	2985
9281	21	2917	11	12	0	2961
9282	19	17	6	2856	0	2898
9283	11	6	12	2881	0	2910
9284	2881	8	11	27	0	2927
9285	2886	2	9	12	0	2909
9286	25	2883	8	11	0	2927
9287	2895	21	4	6	0	2926
9288	2882	11	3	9	0	2905
9289	24	9	5	2875	0	2913
9290	17	2	2871	23	0	2913
9291	2841	5	19	13	0	2878
9292	24	4	9	2919	0	2956
9293	18	4	8	2913	0	2943
9294	2922	5	3	26	0	2956
9295	28	2	2	2800	0	2832
9296	15	3	5	2812	0	2835
9297	2773	0	7	31	0	2811
9298	23	2838	6	14	0	2881
9299	2808	18	3	19	0	2848
9300	27	5	2853	9	0	2894
9301	2849	3	21	9	0	2882
9302	27	2	9	2882	0	2920
9303	12	2924	13	25	0	2974
9304	14	16	3	2961	0	2994
9305	13	9	3	2979	0	3004
9306	6	7	4	2979	0	2996
9307	2958	1	8	29	0	2996
9308	21	2901	6	13	0	2941
9309	10	2902	4	9	0	2925
9310	2873	22	3	6	0	2904
9311	20	9	2945	5	0	2979
9312	9	1	2867	8	0	2885
9313	2805	12	34	8	0	2859
9314	15	4	2880	9	0	2908
9315	8	3	13	2755	0	2779
9316	12	3	4	2555	0	2574
9317	4	2	5	2801	0	2812
9318	6	2	2	2816	0	2826
9319	7	2694	7	20	0	2728
9320	5	17	5	2840	0	2867
9321	3	4	2811	24	0	2842
9322	7	3	18	2804	0	2832
9323	2	2	2765	25	0	2794
9324	6	2	2719	11	0	2738
9325	4	2	17	2766	0	2789
9326	6	4	2813	20	0	2843
9327	4	4	20	2779	0	2807
9328	2833	2	7	31	0	2873
9329	20	1	2843	5	0	2869
9330	2788	0	19	11	0	2818
9331	23	2	8	2810	0	2843
9332	5	0	2832	20	0	2857
9333	7	2809	16	13	0	2845
9334	8	16	6	2892	0	2922
9335	6	3	2983	23	0	3015
9336	8	6	21	2983	0	3018
9337	3040	2	6	29	0	3077
9338	3080	0	7	11	0	3098
9339	3132	4	2	9	0	3147
9340	29	5	2	3123	0	3159
9341	14	4	3	3166	0	3187
9342	7	1	5	3210	0	3223
9343	3281	1	6	43	0	3331
9344	29	3365	5	14	0	3413
9345	16	27	1	3389	0	3433
9346	14	11	4	3440	0	3469
9347	3405	5	4	48	0	3462
9348	30	3478	2	24	0	3534
9349	24	24	4	3646	0	3698
9350	3723	15	4	37	0	3779
9351	3716	5	4	23	0	3748
9352	50	3	3	3709	0	3765
9353	3721	3	3	50	0	3777
9354	49	3	1	3723	0	3776
9355	19	3	3749	48	0	3819
9356	14	4	37	3748	0	3803
9357	16	3	15	3790	0	3824
9358	13	2	5	3827	0	3847
9359	3703	2	6	63	0	3774
9360	37	3678	5	30	0	3750
9361	3619	35	6	16	0	3676
9362	36	3516	4	13	0	3569
9363	15	3527	0	8	0	3550
9364	3520	50	0	16	0	3586
9365	38	3579	3	8	0	3628
9366	15	41	4	3580	0	3640
9367	3552	17	5	45	0	3619
9368	3583	9	3	22	0	3617
9369	56	3	5	3562	0	3626
9370	25	2	3	3553	0	3583
9371	12	3574	4	56	0	3646
9372	3620	37	4	31	0	3692
9373	3599	13	4	15	0	3631
9374	52	3741	5	12	0	3810
9375	23	3783	5	11	0	3822
9376	17	46	2	3797	0	3862
9377	3800	20	1	56	0	3877
9378	51	6	3	3785	0	3845
9379	21	6	5	3840	0	3872
9380	6	6	3737	71	0	3820
9381	11	6	3750	24	0	3791
9382	11	7	56	3766	0	3840
9383	15	5	3779	53	0	3852
9384	9	3778	43	23	0	3853
9385	14	53	14	3773	0	3854
9386	8	21	5	3853	0	3887
9387	12	9	3	3888	0	3912
9388	8	8	3829	76	0	3921
9389	7	9	3732	24	0	3772
9390	3711	6	57	24	0	3798
9391	56	3815	16	14	0	3901
9392	3801	50	3	15	0	3869
9393	54	15	2	3808	0	3879
9394	3869	9	3	59	0	3940
9395	57	10	5	3846	0	3918
9396	25	3883	2	61	0	3971
9397	3908	51	7	22	0	3988
9398	56	23	3804	11	0	3894
9399	16	3797	42	14	0	3869
9400	3752	47	15	21	0	3835
9401	61	20	8	3672	0	3761
9402	19	3608	7	54	0	3688
9403	15	47	6	3728	0	3796
9404	3698	17	8	65	0	3788
9405	56	11	8	3705	0	3780
9406	3705	3	6	65	0	3779
9407	61	11	3657	24	0	3753
9408	23	12	47	3679	0	3761
9409	3635	8	10	75	0	3728
9410	65	10	3606	28	0	3709
9411	21	3511	55	22	0	3609
9412	17	55	25	3441	0	3538
9413	8	24	3463	55	0	3550
9414	17	15	3409	18	0	3459
9415	14	23	58	3393	0	3488
9416	8	10	3365	56	0	3439
9417	8	8	3367	32	0	3415
9418	20	12	58	3281	0	3371
9419	3319	2	18	61	0	3400
9420	55	4	10	3327	0	3396
9421	23	5	8	3388	0	3424
9422	16	8	3408	67	0	3499
9423	14	9	47	3479	0	3549
9424	3551	8	20	61	0	3640
9425	48	7	3517	31	0	3603
9426	18	3498	46	23	0	3585
9427	15	44	20	3558	0	3637
9428	3539	15	11	61	0	3626
9429	51	13	7	3517	0	3588
9430	30	3473	11	55	0	3569
9431	14	49	3588	21	0	3672
9432	12	23	50	3648	0	3733
9433	3801	12	19	65	0	3897
9434	64	8	3730	26	0	3828
9435	21	12	56	3842	0	3931
9436	3972	8	23	71	0	4074
9437	4228	1	15	30	0	4274
9438	81	4294	13	22	0	4410
9439	4311	66	11	17	0	4405
9440	77	22	17	4319	0	4435
9441	28	10	4384	73	0	4495
9442	24	4236	64	31	0	4355
9443	14	4327	26	18	0	4385
9444	16	103	26	4167	0	4312
9445	12	27	12	4248	0	4299
9446	11	8	4117	74	0	4210
9447	5	4048	66	30	0	4149
9448	9	4015	16	22	0	4062
9449	15	77	26	3825	0	3943
9450	3758	10	17	57	0	3842
9451	54	3788	1	17	0	3860
9452	29	53	2	3833	0	3917
9453	3940	10	5	65	0	4020
9454	57	9	5	3952	0	4023
9455	17	8	7	3935	0	3967
9456	16	6	7	3939	0	3968
9457	16	11	4	3950	0	3981
9458	3881	6	8	74	0	3969
9459	56	5	4	3883	0	3948
9460	11	9	3777	67	0	3864
9461	3699	9	50	22	0	3780
9462	55	10	3757	16	0	3838
9463	16	12	3761	10	0	3799
9464	15	10	58	3771	0	3854
9465	16	5	18	3804	0	3843
9466	13	6	11	3823	0	3853
9467	3767	8	5	68	0	3848
9468	58	6	3740	25	0	3829
9469	3728	5	44	28	0	3805
9470	3820	8	10	24	0	3862
9471	61	8	3785	14	0	3868
9472	3738	4	47	23	0	3812
9473	57	5	3834	16	0	3912
9474	14	3761	46	17	0	3838
9475	20	55	36	3663	0	3774
9476	9	14	12	3750	0	3785
9477	7	7	10	3719	0	3743
9478	8	4	5	3718	0	3735
9479	8	6	3676	61	0	3751
9480	11	5	3660	21	0	3697
9481	7	5	51	3664	0	3727
9482	10	7	3681	47	0	3745
9483	3580	5	48	20	0	3653
9484	3734	2	12	21	0	3769
9485	55	3	10	3708	0	3776
9486	3691	4	7	47	0	3749
9487	54	3774	7	18	0	3853
9488	3767	36	9	21	0	3833
9489	54	12	3771	12	0	3849
9490	18	13	43	3729	0	3803
9491	10	3793	14	57	0	3874
9492	3864	39	15	23	0	3941
9493	42	15	9	3897	0	3963
9494	16	9	3830	56	0	3911
9495	17	2	48	3824	0	3891
9496	3799	5	20	63	0	3887
9497	51	7	3806	22	0	3886
9498	21	10	42	3822	0	3895
9499	20	10	18	3883	0	3931
9500	21	4	3840	62	0	3927
9501	20	3727	48	24	0	3819
9502	25	2858	27	30	0	2940
9503	25	47	7	3836	0	3915
9504	15	16	17	3896	0	3944
9505	13	13	4	3938	0	3968
9506	3849	11	7	66	0	3933
9507	3886	10	12	32	0	3940
9508	53	7	10	3892	0	3962
9509	3867	8	11	57	0	3943
9510	42	3797	12	32	0	3883
9511	24	39	11	3884	0	3958
9512	12	14	14	3926	0	3966
9513	9	11	15	3943	0	3978
9514	3789	11	9	68	0	3877
9515	45	3746	7	34	0	3832
9516	17	39	14	3812	0	3882
9517	3767	11	6	65	0	3849
9518	51	8	8	3814	0	3881
9519	23	9	11	3804	0	3847
9520	23	3587	3	67	0	3680
9521	16	3736	11	30	0	3793
9522	16	33	8	3681	0	3738
9523	16	14	9	3670	0	3709
9524	3541	11	12	59	0	3623
9525	53	5	7	3536	0	3601
9526	22	3	3480	64	0	3569
9527	14	6	39	3468	0	3527
9528	15	3421	14	57	0	3507
9529	3484	38	16	29	0	3567
9530	48	14	9	3511	0	3582
9531	24	6	10	3429	0	3469
9532	10	3350	9	64	0	3433
9533	3193	32	10	17	0	3252
9534	43	3276	6	14	0	3339
9535	14	35	6	3209	0	3264
9536	14	6	3124	33	0	3177
9537	41	78	33	2763	0	2915
9538	2740	3	15	28	0	2786
9539	20	2761	3	9	0	2793
9540	10	24	2	2753	0	2789
9541	6	2682	1	23	0	2712
9542	3	29	4	2771	0	2807
9543	1	11	2717	32	0	2761
9544	4	11	23	2665	0	2703
9545	4	1	9	2710	0	2724
9546	4	1	3	2746	0	2754
9547	2631	2	2	35	0	2670
9548	2672	5	2	17	0	2696
9549	33	2691	2	10	0	2736
9550	2711	25	4	9	0	2749
9551	24	2675	2	9	0	2710
9552	9	2741	1	5	0	2756
9553	2646	31	4	13	0	2694
9554	24	11	2592	7	0	2634
9555	12	8	24	2584	0	2628
9556	8	2	6	2657	0	2673
9557	6	4	3	2697	0	2710
9558	2621	4	0	42	0	2667
9559	27	2579	3	14	0	2623
9560	12	24	2	2667	0	2705
9561	6	2628	1	24	0	2659
9562	2786	30	1	10	0	2827
9563	27	10	4	2759	0	2800
9564	10	3	1	3152	0	3166
9565	5	3404	0	50	0	3459
9566	7	39	1	3684	0	3731
9567	8	17	4	3709	0	3738
9568	3630	11	1	75	0	3717
9569	47	3560	4	37	0	3648
9570	20	3685	2	23	0	3730
9571	13	65	0	3618	0	3696
9572	8	30	3517	59	0	3614
9573	5	17	3469	29	0	3520
9574	14	17	60	3502	0	3593
9575	7	13	3491	61	0	3572
9576	10	5	61	3510	0	3586
9577	15	6	29	3371	0	3421
9578	6	9	15	3624	0	3654
9579	3544	9	7	91	0	3651
9580	59	5	4	3556	0	3624
9581	26	6	7	3556	0	3595
9582	14	3483	6	86	0	3589
9583	10	53	4	3605	0	3672
9584	12	21	3510	71	0	3614
9585	9	13	53	3554	0	3629
9586	9	11	21	3610	0	3651
9587	3442	8	13	96	0	3559
9588	57	7	11	3455	0	3530
9589	28	4	7	3452	0	3491
9590	17	5	4	3482	0	3508
9591	3264	10	4	102	0	3380
9592	60	3303	3	54	0	3420
9593	26	51	5	3357	0	3439
9594	14	23	8	3375	0	3420
9595	12	14	3267	88	0	3381
9596	14	13	50	3275	0	3352
9597	3172	6	23	90	0	3291
9598	44	3190	15	47	0	3296
9599	23	50	8	3184	0	3265
9600	15	23	6	3239	0	3283
9601	16	17	3156	86	0	3275
9602	2991	12	48	58	0	3109
9603	52	3071	23	44	0	3190
9604	3097	57	17	31	0	3202
9605	57	23	8	3124	0	3212
9606	30	16	5	3161	0	3212
9607	21	14	5	3185	0	3225
9608	15	14	7	3188	0	3224
9609	3101	9	9	105	0	3224
9610	63	7	5	3091	0	3166
9611	27	3016	9	82	0	3134
9612	19	59	3	3108	0	3189
9613	21	19	7	3162	0	3209
9614	3082	15	13	106	0	3216
9615	56	3052	12	63	0	3183
9616	28	54	5	3145	0	3232
9617	3103	24	9	84	0	3220
9618	3152	15	8	55	0	3230
9619	81	12	9	3160	0	3262
9620	36	9	3095	90	0	3230
9621	3097	10	49	55	0	3211
9622	69	7	17	3174	0	3267
9623	38	9	3213	86	0	3346
9624	21	12	59	3310	0	3402
9625	29	7	24	3297	0	3357
9626	20	6	16	3401	0	3443
9627	21	3431	8	109	0	3569
9628	22	60	9	3489	0	3580
9629	11	27	8	3577	0	3623
9630	13	11	11	3563	0	3598
9631	15	13	7	3556	0	3591
9632	14	8	5	3562	0	3589
9633	22	12	6	3530	0	3570
9634	3296	11	5	120	0	3432
9635	56	6	3189	74	0	3325
9636	22	3122	53	54	0	3251
9637	3131	45	22	42	0	3240
9638	59	3113	10	39	0	3221
9639	3067	49	13	29	0	3158
9640	76	29	6	3036	0	3147
9641	3105	12	9	71	0	3197
9642	61	11	8	3143	0	3223
9643	42	7	4	3091	0	3144
9644	21	3115	3	71	0	3210
9645	3139	40	8	52	0	3239
9646	47	21	3172	44	0	3284
9647	36	11	37	3266	0	3350
9648	20	11	3267	63	0	3361
9649	17	11	3086	42	0	3156
9650	3210	6	50	35	0	3301
9651	46	9	26	3279	0	3360
9652	23	12	3252	64	0	3351
9653	21	5	3327	53	0	3406
9654	17	7	46	3383	0	3453
9655	21	5	23	3531	0	3580
9656	3535	7	21	73	0	3636
9657	41	12	12	3587	0	3652
9658	32	10	3747	58	0	3847
9659	28	3	37	3803	0	3871
9660	18	21	17	3792	0	3848
9661	14	3830	16	69	0	3929
9662	3764	34	15	50	0	3863
9663	46	3721	9	34	0	3810
9664	3388	26	3	27	0	3444
9665	24	3045	3	12	0	3084
9666	7	2834	7	5	0	2853
9667	13	22	17	2834	0	2886
9668	12	7	11	2815	0	2845
9669	6	7	5	2790	0	2808
9670	2733	2	1	18	0	2754
9671	10	5	2755	8	0	2778
9672	7	0	8	2710	0	2725
9673	2701	1	5	14	0	2721
9674	9	2670	1	8	0	2688
9675	9	2689	2	2	0	2702
9676	3	14	1	2766	0	2784
9677	5	2	2	2789	0	2798
9678	1	4	1	2802	0	2808
9679	1	2868	0	9	0	2878
9680	0	6	0	2914	0	2920
9681	3	4	2899	10	0	2916
9682	2	3	2680	6	0	2691
9683	2826	1	7	5	0	2839
9684	5	1	4	2964	0	2974
9685	2992	2	1	9	0	3004
9686	2995	0	0	5	0	3000
9687	9	3063	0	2	0	3074
9688	3168	5	0	7	0	3180
9689	3302	3	0	10	0	3315
9690	7	2	1	3341	0	3351
9691	7	1	0	3418	0	3426
9692	5	2	3535	9	0	3551
9693	4	3615	5	5	0	3629
9694	16	9	5	3123	0	3153
9695	2	3	2	3703	0	3710
9696	3699	0	1	14	0	3714
9697	7	3	0	3711	0	3721
9698	3776	1	0	10	0	3787
9699	10	0	0	3859	0	3869
9700	7	3876	1	9	0	3893
9701	4030	8	2	14	0	4054
9702	12	7	0	4389	0	4408
9703	10	0	0	4629	0	4639
9704	4	2	1	4915	0	4922
9705	3	0	4937	49	0	4989
9706	1	3	40	4971	0	5015
9707	5101	1	16	50	0	5168
9708	46	2	1	5283	0	5332
9709	22	1	3	5732	0	5758
9710	6	0	1	5810	0	5817
9711	6	5743	3	81	0	5833
9712	3	6011	4	26	0	6044
9713	6028	82	0	13	0	6123
9714	68	6099	1	8	0	6176
9715	6137	62	1	15	0	6215
9716	6186	30	2	12	0	6230
9717	6254	4	0	20	0	6278
9718	92	8	6235	8	0	6343
9719	30	6419	66	10	0	6525
9720	6565	65	22	20	0	6672
9721	75	29	1	6639	0	6744
9722	42	6	2	6629	0	6679
9723	14	8	3	6697	0	6722
9724	12	6526	2	95	0	6635
9725	11	65	2	6581	0	6659
9726	6621	27	1	81	0	6730
9727	78	5	3	6533	0	6619
9728	37	8	1	6625	0	6671
9729	10	7	6564	106	0	6687
9730	9	6	6652	45	0	6712
9731	17	6	89	6753	0	6865
9732	15	3	30	6831	0	6879
9733	8	6844	7	108	0	6967
9734	18	62	8	6859	0	6947
9735	17	30	4	6966	0	7017
9736	11	7	3	7018	0	7039
9737	6909	10	5	115	0	7039
9738	74	14	6972	45	0	7105
9739	40	13	67	7054	0	7174
9740	7093	7	30	92	0	7222
9741	7081	10	5	48	0	7144
9742	116	5	6	6995	0	7122
9743	44	8	10	7067	0	7129
9744	6937	11	11	117	0	7076
9745	85	6915	10	49	0	7059
9746	42	6986	7	30	0	7065
9747	21	94	5	7041	0	7161
9748	7082	35	6	96	0	7219
9749	7117	13	8	57	0	7195
9750	7079	16	3	42	0	7140
9751	114	11	7115	26	0	7266
9752	6835	8	69	37	0	6949
9753	89	18	6947	26	0	7080
9754	6799	11	73	40	0	6923
9755	89	6838	34	37	0	6998
9756	45	66	6916	38	0	7065
9757	21	41	75	6903	0	7040
9758	25	17	6891	107	0	7040
9759	35	13	78	6893	0	7019
9760	6918	19	38	113	0	7088
9761	89	11	7028	74	0	7202
9762	50	13	70	7061	0	7194
9763	28	7216	44	95	0	7383
9764	27	71	15	7540	0	7653
9765	37	37	19	7512	0	7605
9766	25	22	11	7291	0	7349
9767	7497	14	16	123	0	7650
9768	7523	13	15	64	0	7615
9769	126	16	10	7526	0	7678
9770	57	20	7485	110	0	7672
9771	50	19	7302	60	0	7431
9772	33	23	103	7589	0	7748
9773	28	21	7821	111	0	7981
9774	38	22	76	7869	0	8005
9775	52	12	45	7502	0	7611
9776	31	19	17	7863	0	7930
9777	36	7629	19	133	0	7817
9778	41	7030	23	67	0	7161
9779	42	96	15	7867	0	8020
9780	25	37	19	7858	0	7939
9781	36	23	21	7857	0	7937
9782	7733	17	16	150	0	7916
9783	95	12	7885	76	0	8068
9784	56	16	89	7883	0	8044
9785	7859	11	54	117	0	8041
9786	82	7897	24	85	0	8088
9787	59	77	19	7997	0	8152
9788	27	38	24	8039	0	8128
9789	27	17	14	7933	0	7991
9790	27	14	20	7893	0	7954
9791	28	14	7666	151	0	7859
9792	7199	13	84	88	0	7384
9793	7602	10	45	71	0	7728
9794	112	13	7680	53	0	7858
9795	7595	10	78	63	0	7746
9796	7795	10	38	59	0	7902
9797	110	17	7921	45	0	8093
9798	44	8112	77	57	0	8290
9799	40	88	48	8115	0	8291
9800	30	36	8295	100	0	8461
9801	36	8053	73	69	0	8231
9802	33	65	7828	44	0	7970
9803	24	7222	53	477	0	7776
9804	36	57	45	7438	0	7576
9805	22	18	7477	43	0	7560
9806	25	18	40	7371	0	7454
9807	12	7	7589	48	0	7656
9808	8	7468	42	33	0	7551
9809	7051	28	21	27	0	7127
9810	16	6987	8	5	0	7016
9811	6	7353	4	15	0	7378
9812	39	30	18	7307	0	7394
9813	7	5	4	7419	0	7435
9814	4	3	2	7391	0	7400
9815	3	2	0	7295	0	7300
9816	2	0	1	7394	0	7397
9817	2	6	7689	14	0	7711
9818	7	0	12	7529	0	7548
9819	3	1	2	7697	0	7703
9820	7763	1	3	21	0	7788
9821	7782	0	0	21	0	7803
9822	7865	1	2	11	0	7879
9823	21	1	0	7923	0	7945
9824	8555	1	1	29	0	8586
9825	9112	1	1	17	0	9131
9826	9304	1	0	26	0	9331
9827	54	6	9250	3	0	9313
9828	9100	1	40	17	0	9158
9829	9460	0	8	21	0	9489
9830	9442	1	7	17	0	9467
9831	68	10	8	9462	0	9548
9832	27	5	9588	46	0	9666
9833	22	1	52	9515	0	9590
9834	9772	0	9	72	0	9853
9835	66	0	9	9839	0	9914
9836	21	10058	9	59	0	10147
9837	17	48	5	10310	0	10380
9838	10251	7	10	82	0	10350
9839	10309	8	3	45	0	10365
9840	10254	7	7	41	0	10309
9841	79	9	10554	19	0	10661
9842	45	6	54	10478	0	10583
9843	33	1	12	10839	0	10885
9844	23	5	10803	75	0	10906
9845	18	10527	68	29	0	10642
9846	19	55	10581	18	0	10673
9847	21	11	68	10742	0	10842
9848	10721	6	19	91	0	10837
9849	63	16	11002	22	0	11103
9850	27	6	66	11043	0	11142
9851	17	8	11092	72	0	11189
9852	10965	1	79	35	0	11080
9853	75	5	24	11289	0	11393
9854	30	3	11671	72	0	11776
9855	25	3	73	11653	0	11754
9856	23	8	11803	84	0	11918
9857	15	11847	79	37	0	11978
9858	33	58	25	11842	0	11958
9859	11906	16	16	101	0	12039
9860	87	9	24	11859	0	11979
9861	40	10	14	11692	0	11756
9862	11675	5	18	111	0	11809
9863	93	11146	10	41	0	11290
9864	38	11365	14	36	0	11453
9865	37	75	14	11416	0	11542
9866	18	11401	20	94	0	11533
9867	30	69	11	11492	0	11602
9868	24	24	14	11529	0	11591
9869	11511	20	11	122	0	11664
9870	73	11412	13	52	0	11550
9871	31	77	11316	43	0	11467
9872	32	11603	66	32	0	11733
9873	11517	67	19	49	0	11652
9874	11810	25	22	39	0	11896
9875	110	18	18	11775	0	11921
9876	12011	20	12	115	0	12158
9877	119	12	16	12010	0	12157
9878	12019	22	12	130	0	12183
9879	12197	13	20	68	0	12298
9880	134	13	13	12556	0	12716
9881	12645	12	13	153	0	12823
9882	133	12	12729	40	0	12914
9883	12500	8	88	66	0	12662
9884	130	10	32	12819	0	12991
9885	12900	9	24	116	0	13049
9886	117	12910	25	50	0	13102
9887	73	85	20	12970	0	13148
9888	55	27	23	13023	0	13128
9889	12983	20	23	144	0	13170
9890	116	26	12945	65	0	13152
9891	66	12806	91	50	0	13013
9892	55	95	24	12992	0	13166
9893	60	12872	19	126	0	13077
9894	47	86	23	13002	0	13158
9895	61	29	23	12771	0	12884
9896	49	22	19	12966	0	13056
9897	12720	31	15	149	0	12915
9898	109	32	10	12533	0	12684
9899	12613	30	6	162	0	12811
9900	12481	35	15	111	0	12642
9901	145	18	12	12620	0	12795
9902	12564	10	19	171	0	12764
9903	12465	13	17	83	0	12578
9904	140	22	12525	59	0	12746
9905	72	24	92	12327	0	12515
9906	12498	23	34	148	0	12703
9907	127	12408	36	53	0	12624
9908	12568	99	27	74	0	12768
9909	12583	22	15	71	0	12691
9910	146	24	12334	50	0	12554
9911	86	27	86	11850	0	12049
9912	12577	9	33	150	0	12769
9913	139	17	26	12747	0	12929
9914	83	14	26	13061	0	13184
9915	72	14	25	13118	0	13229
9916	57	11	24	13655	0	13747
9917	13530	11	21	201	0	13763
9918	174	19	13882	96	0	14171
9919	86	36	141	14320	0	14583
9920	55	29	15247	197	0	15528
9921	56	21	15887	99	0	16063
9922	16097	13	351	106	0	16567
9923	318	13	17338	70	0	17739
9924	180	16816	354	49	0	17399
9925	16974	278	264	57	0	17573
9926	17264	175	76	45	0	17560
9927	513	65	37	16986	0	17601
9928	255	34	17248	295	0	17832
9929	110	25	17103	174	0	17412
9930	17523	13	471	92	0	18099
9931	386	24	233	17846	0	18489
9932	17974	14	103	342	0	18433
9933	376	18226	67	204	0	18873
9934	18420	306	48	97	0	18871
9935	18489	178	40	83	0	18790
9936	519	18278	33	61	0	18891
9937	316	342	35	18324	0	19017
9938	18371	190	35	345	0	18941
9939	398	88	18396	206	0	19088
9940	252	18511	348	95	0	19206
9941	166	356	210	18508	0	19240
9942	18607	199	92	379	0	19277
9943	404	18693	64	227	0	19388
9944	19035	371	50	111	0	19567
9945	450	248	18810	63	0	19571
9946	18836	100	360	77	0	19373
9947	497	65	19146	58	0	19766
9948	19026	52	428	73	0	19579
9949	18779	47	251	72	0	19149
9950	617	45	18605	43	0	19310
9951	338	18672	395	53	0	19458
9952	222	376	233	18132	0	18963
9953	140	217	18734	362	0	19453
9954	126	18433	392	225	0	19176
9955	139	391	229	18063	0	18822
9956	118	235	136	18662	0	19151
9957	110	118	18251	562	0	19041
9958	153	77	399	18075	0	18704
9959	125	62	269	18522	0	18978
9960	113	55	18304	608	0	19080
9961	111	67	440	17866	0	18484
9962	85	18172	300	466	0	19023
9963	18390	379	143	298	0	19210
9964	444	232	133	18257	0	19066
9965	274	18572	127	430	0	19403
9966	206	407	117	17766	0	18496
9967	170	18953	146	407	0	19676
9968	158	477	18699	266	0	19600
9969	142	18978	470	180	0	19770
9970	18683	472	303	149	0	19607
9971	18917	305	187	134	0	19543
9972	19193	179	125	158	0	19655
9973	737	124	19087	157	0	20105
9974	427	131	18865	125	0	19548
9975	241	19520	674	143	0	20578
9976	275	467	377	18772	0	19891
9977	219	20111	215	429	0	20974
9978	281	536	147	18245	0	19209
9979	191	20099	142	445	0	20877
9980	20110	567	121	284	0	21082
9981	21295	375	112	176	0	21958
9982	838	218	115	21979	0	23150
9983	489	166	21730	584	0	22969
9984	21692	176	518	405	0	22791
9985	664	22176	374	220	0	23434
9986	503	554	224	21954	0	23235
9987	329	365	170	21802	0	22666
9988	258	22530	154	729	0	23671
9989	22602	611	138	468	0	23819
9990	724	424	22372	208	0	23728
9991	498	270	585	22430	0	23783
9992	22570	199	360	636	0	23765
9993	22633	183	248	445	0	23509
9994	956	22458	190	237	0	23841
9995	591	563	216	21931	0	23301
9996	345	22829	168	585	0	23927
9997	23066	653	149	442	0	24310
9998	685	417	23008	263	0	24373
9999	452	313	23042	212	0	24019
10000	321	213	773	22816	0	24123
10001	267	192	478	22660	0	23597
10002	227	22896	273	807	0	24203
10003	245	576	209	23115	0	24145
10004	223	367	22773	744	0	24107
10005	22532	229	635	518	0	23914
10006	625	194	388	23088	0	24295
10007	369	211	22823	728	0	24131
10008	259	196	621	22930	0	24006
10009	219	175	403	22622	0	23419
10010	180	22809	246	851	0	24086
10011	242	603	158	22954	0	23957
10012	197	388	180	22707	0	23472
10013	197	289	175	22748	0	23409
10014	21457	167	151	1036	0	22811
10015	563	21049	202	575	0	22389
10016	381	21304	155	364	0	22204
10017	20643	706	110	296	0	21755
10018	20158	388	119	257	0	20922
10019	764	19173	138	189	0	20264
10020	386	18456	102	187	0	19131
10021	16681	441	105	119	0	17346
10022	363	16499	64	117	0	17043
10023	201	16218	45	109	0	16573
10024	15723	391	173	130	0	16417
10025	284	15786	49	87	0	16206
10026	15542	326	58	104	0	16030
10027	15412	204	44	92	0	15752
10028	15420	138	33	100	0	15691
10029	421	15143	48	96	0	15708
10030	218	15315	36	77	0	15646
10031	172	357	26	14771	0	15326
10032	139	14964	39	247	0	15389
10033	130	356	32	15370	0	15888
10034	15637	190	33	337	0	16197
10035	342	145	40	15449	0	15976
10036	187	15221	40	328	0	15776
10037	15085	298	38	209	0	15630
10038	313	14921	45	142	0	15421
10039	192	15305	21	107	0	15625
10040	167	475	42	14561	0	15245
10041	102	15002	53	262	0	15419
10042	14810	315	49	175	0	15349
10043	284	179	14629	131	0	15223
10044	157	14553	239	104	0	15053
10045	127	278	123	14499	0	15027
10046	83	176	14450	296	0	15005
10047	110	139	236	14234	0	14719
10048	106	105	119	14472	0	14802
10049	84	105	98	14607	0	14894
10050	85	96	78	14484	0	14743
10051	95	82	14138	431	0	14746
10052	71	14095	249	276	0	14691
10053	13967	271	138	216	0	14592
10054	260	154	13858	171	0	14443
10055	13781	126	245	165	0	14317
10056	308	89	14063	143	0	14603
10057	177	100	282	14086	0	14645
10058	144	89	14073	314	0	14620
10059	112	93	14316	183	0	14704
10060	134	67	346	14225	0	14772
10061	120	100	200	13581	0	14001
10062	103	100	116	14528	0	14847
10063	95	85	82	14463	0	14725
10064	14206	83	93	439	0	14821
10065	268	91	14227	259	0	14845
10066	14221	81	241	212	0	14755
10067	14312	89	128	165	0	14694
10068	14320	87	89	153	0	14649
10069	14277	87	63	133	0	14560
10070	14365	89	62	114	0	14630
10071	464	92	45	14022	0	14623
10072	275	95	13384	268	0	14022
10073	193	85	13053	169	0	13500
10074	150	13268	241	147	0	13806
10075	12575	253	177	109	0	13114
10076	251	197	93	12259	0	12800
10077	162	210	45	11984	0	12401
10078	141	11956	45	252	0	12394
10079	114	11773	36	168	0	12091
10080	130	11641	25	104	0	11900
10081	10341	298	73	111	0	10823
10082	156	232	37	9098	0	9523
10083	51	8988	24	100	0	9163
10084	41	93	9	8883	0	9026
10085	20	31	8960	116	0	9127
10086	25	35	9125	44	0	9229
10087	32	31	97	9803	0	9963
10088	10219	30	44	131	0	10424
10089	10918	23	22	55	0	11018
10090	10983	23	12	47	0	11065
10091	196	23	11038	37	0	11294
10092	84	36	136	10987	0	11243
10093	64	37	41	11352	0	11494
10094	40	19	11062	183	0	11304
10095	10538	38	137	99	0	10812
10096	169	25	11158	69	0	11421
10097	53	25	11040	36	0	11154
10098	52	23	11100	35	0	11210
10099	38	17	203	10842	0	11100
10100	35	20	80	11087	0	11222
10101	28	18	11333	190	0	11569
10102	35	11	167	11387	0	11600
10103	11529	16	69	188	0	11802
10104	166	11	49	11729	0	11955
10105	59	6	11901	193	0	12159
10106	43	12	12350	89	0	12494
10107	40	8	199	12277	0	12524
10108	12597	13	94	204	0	12908
10109	190	13193	58	85	0	13526
10110	13620	188	64	76	0	13948
10111	13910	79	56	55	0	14100
10112	327	34	14123	53	0	14537
10113	171	13	243	14096	0	14523
10114	14265	15	132	268	0	14680
10115	14215	17	89	151	0	14472
10116	330	14184	56	87	0	14657
10117	193	205	49	14191	0	14638
10118	112	98	52	14562	0	14824
10119	69	44	14259	344	0	14716
10120	99	20	232	14182	0	14533
10121	70	23	14285	293	0	14671
10122	63	27	14084	167	0	14341
10123	86	19	311	13954	0	14370
10124	13888	16	161	271	0	14336
10125	247	13602	93	164	0	14106
10126	13637	202	67	100	0	14006
10127	13718	95	67	92	0	13972
10128	335	13665	57	71	0	14128
10129	204	211	56	13258	0	13729
10130	13150	125	34	238	0	13547
10131	270	13195	33	128	0	13626
10132	12936	204	37	96	0	13273
10133	247	12607	31	66	0	12951
10134	153	203	39	12077	0	12472
10135	92	101	39	12340	0	12572
10136	12093	54	37	293	0	12477
10137	11900	50	33	165	0	12148
10138	286	12102	40	110	0	12538
10139	166	184	11925	71	0	12346
10140	88	103	11769	72	0	12032
10141	86	51	262	11531	0	11930
10142	70	11890	141	195	0	12296
10143	65	189	87	12081	0	12422
10144	76	100	62	12131	0	12369
10145	70	51	64	12169	0	12354
10146	55	47	12056	320	0	12478
10147	62	38	11768	176	0	12044
10148	54	12199	264	131	0	12648
10149	74	175	135	12245	0	12629
10150	74	122	86	12635	0	12917
10151	67	57	12361	311	0	12796
10152	11736	56	224	179	0	12195
10153	238	60	129	12463	0	12890
10154	155	45	12483	249	0	12932
10155	12011	43	236	177	0	12467
10156	210	12537	144	139	0	13030
10157	186	189	12802	100	0	13277
10158	135	118	214	12809	0	13276
10159	12706	87	148	245	0	13186
10160	236	46	12846	178	0	13306
10161	164	45	229	12872	0	13310
10162	90	49	166	12874	0	13179
10163	66	50	98	13808	0	14022
10164	13866	35	87	374	0	14362
10165	254	13544	78	213	0	14089
10166	160	210	70	13813	0	14253
10167	104	143	13907	292	0	14446
10168	101	76	242	13706	0	14125
10169	91	13527	145	293	0	14056
10170	88	14199	86	195	0	14568
10171	14082	309	70	134	0	14595
10172	14188	160	67	139	0	14554
10173	364	78	14014	105	0	14561
10174	13810	76	237	124	0	14247
10175	290	13988	156	93	0	14527
10176	14229	241	76	115	0	14661
10177	317	145	74	14127	0	14663
10178	190	88	14327	283	0	14888
10179	159	66	247	14350	0	14822
10180	162	67	14404	284	0	14917
10181	14196	64	277	210	0	14747
10182	264	66	175	14522	0	15027
10183	180	14853	99	293	0	15425
10184	119	265	71	15159	0	15614
10185	100	169	14936	312	0	15517
10186	81	14680	250	224	0	15235
10187	13946	252	134	179	0	14511
10188	222	13486	94	114	0	13916
10189	141	13111	73	78	0	13403
10190	105	287	74	12659	0	13125
10191	60	12946	64	190	0	13260
10192	77	222	42	13043	0	13384
10193	69	160	12809	216	0	13254
10194	12086	81	165	171	0	12503
10195	12673	74	111	95	0	12953
10196	276	60	12659	75	0	13070
10197	12240	48	182	86	0	12556
10198	217	12450	123	54	0	12844
10199	12642	172	56	66	0	12936
10200	242	133	43	12456	0	12874
10201	150	62	12531	183	0	12926
10202	95	12644	156	139	0	13034
10203	95	209	138	12523	0	12965
10204	60	125	49	12595	0	12829
10205	12069	36	30	302	0	12437
10206	11604	43	52	160	0	11859
10207	242	11421	32	96	0	11791
10208	104	11013	35	49	0	11201
10209	38	10740	19	37	0	10834
10210	97	148	44	10228	0	10517
10211	10093	38	63	103	0	10297
10212	9871	17	14	44	0	9946
10213	93	8	4	9828	0	9933
10214	41	9	8	9828	0	9886
10215	9777	9	5	101	0	9892
10216	68	14	3	9898	0	9983
10217	28	12	9932	76	0	10048
10218	9768	9	53	56	0	9886
10219	10003	11	25	35	0	10074
10220	89	8	10197	15	0	10309
10221	10276	10	64	37	0	10387
10222	90	15	25	10536	0	10666
10223	45	16	9	10503	0	10573
10224	25	10	14	10608	0	10657
10225	10470	14	11	115	0	10610
10226	70	10590	13	44	0	10717
10227	39	68	9	10610	0	10726
10228	24	10400	11	70	0	10505
10229	10446	73	9	54	0	10582
10230	84	33	9	10517	0	10643
10231	55	12	11	10579	0	10657
10232	29	10464	19	97	0	10609
10233	28	70	10392	38	0	10528
10234	32	37	63	10492	0	10624
10235	10459	13	31	104	0	10607
10236	11161	13	21	59	0	11254
10237	132	16	11860	32	0	12040
10238	77	11	132	12189	0	12409
10239	41	12413	63	145	0	12662
10240	41	140	28	12694	0	12903
10241	12616	73	12	193	0	12894
10242	12627	36	16	97	0	12776
10243	223	20	16	12510	0	12769
10244	90	12312	21	173	0	12596
10245	13118	152	7	110	0	13387
10246	198	71	6	13443	0	13718
10247	13564	36	15	210	0	13825
10248	14056	32	7	129	0	14224
10249	263	30	13	14037	0	14343
10250	137	22	11	14176	0	14346
10251	71	22	14	14531	0	14638
10252	62	14406	17	281	0	14766
10253	72	197	11	14619	0	14899
10254	67	73	13	14595	0	14748
10255	61	32	14148	276	0	14517
10256	46	41	13713	134	0	13934
10257	61	31	227	13855	0	14174
10258	13769	27	91	269	0	14156
10259	197	13798	44	129	0	14168
10260	13570	193	45	102	0	13910
10261	238	83	13694	72	0	14087
10262	117	44	13223	67	0	13451
10263	57	13324	233	64	0	13678
10264	98	199	130	13136	0	13563
10265	44	80	13100	176	0	13400
10266	37	45	13126	91	0	13299
10267	59	39	214	13044	0	13356
10268	13075	20	90	221	0	13406
10269	13079	15	59	115	0	13268
10270	232	19	41	12978	0	13270
10271	100	26	13455	206	0	13787
10272	90	18	164	13553	0	13825
10273	66	24	82	13429	0	13601
10274	46	13549	48	223	0	13866
10275	13573	157	47	129	0	13906
10276	13486	65	39	96	0	13686
10277	220	13564	32	78	0	13894
10278	125	174	37	13020	0	13356
10279	64	13347	38	174	0	13623
10280	13324	174	28	124	0	13650
10281	203	91	13165	63	0	13522
10282	113	56	12577	54	0	12800
10283	62	48	12620	49	0	12779
10284	71	61	218	12560	0	12910
10285	49	19	113	12624	0	12805
10286	12478	27	59	243	0	12807
10287	187	22	47	12519	0	12775
10288	104	22	42	12835	0	13003
10289	66	25	13153	232	0	13476
10290	56	21	12683	129	0	12889
10291	12735	29	205	123	0	13092
10292	168	13003	95	76	0	13342
10293	13114	155	57	88	0	13414
10294	206	73	48	13114	0	13441
10295	109	38	51	13047	0	13245
10296	74	12961	49	206	0	13290
10297	62	168	46	13037	0	13313
10298	12915	74	35	232	0	13256
10299	184	50	22	12918	0	13174
10300	110	34	12876	211	0	13231
10301	51	12561	173	137	0	12922
10302	12473	148	92	129	0	12842
10303	12695	76	53	102	0	12926
10304	12705	47	44	105	0	12901
10305	12850	30	36	84	0	13000
10306	261	34	31	12685	0	13011
10307	165	23	38	12819	0	13045
10308	86	38	12694	251	0	13069
10309	90	28	148	12709	0	12975
10310	81	42	12618	221	0	12962
10311	83	24	167	12658	0	12932
10312	12640	28	87	265	0	13020
10313	179	12996	60	144	0	13379
10314	101	161	38	13180	0	13480
10315	71	75	46	13439	0	13631
10316	13204	43	46	283	0	13576
10317	12922	32	49	156	0	13159
10318	249	36	12921	105	0	13311
10319	126	12942	171	108	0	13347
10320	93	159	91	12842	0	13185
10321	76	81	52	12924	0	13133
10322	12701	44	67	272	0	13084
10323	12671	35	64	163	0	12933
10324	264	39	12747	86	0	13136
10325	126	37	12622	85	0	12870
10326	91	29	242	12498	0	12860
10327	80	31	104	12798	0	13013
10328	73	29	12678	259	0	13039
10329	12383	29	186	161	0	12759
10330	221	24	107	12777	0	13129
10331	12653	25	89	241	0	13008
10332	186	12591	72	139	0	12988
10333	12959	154	43	139	0	13295
10334	217	76	13744	97	0	14134
10335	140	13515	178	86	0	13919
10336	67	13266	89	60	0	13482
10337	12404	165	197	73	0	12839
10338	12034	43	43	54	0	12174
10339	146	35	18	11941	0	12140
10340	54	11842	20	98	0	12014
10341	44	12150	32	47	0	12273
10342	45	123	17	12255	0	12440
10343	12319	51	17	141	0	12528
10344	12417	29	17	83	0	12546
10345	139	24	11620	29	0	11812
10346	11258	10	77	60	0	11405
10347	94	11940	36	25	0	12095
10348	12112	99	16	44	0	12271
10349	138	14335	9	28	0	14510
10350	73	15665	16	26	0	15780
10351	123	315	59	17544	0	18041
10352	19390	132	44	362	0	19928
10353	19906	80	6	216	0	20208
10354	567	63	19596	96	0	20322
10355	346	29	351	19711	0	20437
10356	19943	23	192	463	0	20621
10357	580	27	98	20059	0	20764
10358	20221	12	97	507	0	20837
10359	20359	14	86	339	0	20798
10360	691	17	20053	210	0	20971
10361	440	12	382	19837	0	20671
10362	308	16	199	20221	0	20744
10363	259	14	110	20383	0	20766
10364	169	19	19659	675	0	20522
10365	139	18	446	19798	0	20401
10366	129	27	233	19274	0	19663
10367	62	19374	127	723	0	20286
10368	55	386	19246	425	0	20112
10369	43	19575	435	306	0	20359
10370	19524	463	212	255	0	20454
10371	436	288	127	18908	0	19759
10372	284	200	112	18437	0	19033
10373	162	18923	99	583	0	19767
10374	18878	469	68	333	0	19748
10375	19191	242	41	280	0	19754
10376	637	18556	43	251	0	19487
10377	364	19232	36	204	0	19836
10378	19163	598	39	129	0	19929
10379	607	307	18820	103	0	19837
10380	371	209	18735	94	0	19409
10381	18351	205	572	116	0	19244
10382	502	18933	314	103	0	19852
10383	19020	448	210	122	0	19800
10384	566	258	18788	78	0	19690
10385	18961	163	483	129	0	19736
10386	601	19461	258	94	0	20414
10387	418	503	150	19483	0	20554
10388	341	263	132	19601	0	20337
10389	309	168	126	18522	0	19125
10390	248	155	83	19267	0	19753
10391	174	140	80	18895	0	19289
10392	159	18765	58	883	0	19865
10393	18879	424	58	594	0	19955
10394	487	252	18725	413	0	19877
10395	359	163	402	19104	0	20028
10396	224	166	19038	582	0	20010
10397	233	145	506	19093	0	19977
10398	207	100	343	19353	0	20003
10399	18924	82	227	808	0	20041
10400	484	77	18829	516	0	19906
10401	293	18783	536	374	0	19986
10402	253	429	294	19021	0	19997
10403	219	267	188	19428	0	20102
10404	190	196	19065	707	0	20158
10405	180	186	519	19111	0	19996
10406	164	170	269	19548	0	20151
10407	18675	127	171	903	0	19876
10408	472	18855	166	557	0	20050
10409	18937	460	139	426	0	19962
10410	19262	271	92	372	0	19997
10411	780	193	80	18993	0	20046
10412	484	195	18643	579	0	19901
10413	357	198	18562	341	0	19458
10414	335	138	617	18414	0	19504
10415	290	115	355	18162	0	18922
10416	179	18368	306	730	0	19583
10417	18327	444	277	475	0	19523
10418	517	18103	214	348	0	19182
10419	347	18679	157	314	0	19497
10420	18510	683	117	305	0	19615
10421	638	409	114	18221	0	19382
10422	397	18913	107	560	0	19977
10423	286	620	85	19052	0	20043
10424	252	369	18564	672	0	19857
10425	210	228	18645	526	0	19609
10426	186	209	610	18858	0	19863
10427	156	169	18937	712	0	19974
10428	146	135	630	18931	0	19842
10429	149	122	438	18942	0	19651
10430	140	92	328	19339	0	19899
10431	18393	83	252	952	0	19680
10432	447	17967	227	602	0	19243
10433	271	18579	142	491	0	19483
10434	17505	562	125	421	0	18613
10435	17860	359	86	349	0	18654
10436	698	285	96	17338	0	18417
10437	405	267	17185	539	0	18396
10438	318	227	426	17400	0	18371
10439	278	154	17302	650	0	18384
10440	221	17218	514	474	0	18427
10441	178	454	334	17396	0	18362
10442	17195	253	251	648	0	18347
10443	500	201	186	17397	0	18284
10444	307	209	16794	589	0	17899
10445	16652	172	446	440	0	17710
10446	610	116	17032	342	0	18100
10447	473	111	16546	270	0	17400
10448	252	15758	618	307	0	16935
10449	176	13469	326	133	0	14104
10450	163	12537	241	145	0	13086
10451	8894	447	469	379	0	10189
10452	8122	36	53	50	0	8261
10453	44	6	8	8187	0	8245
10454	24	5	10	8151	0	8190
10455	8	10	7	8293	0	8318
10456	3	8266	9	44	0	8322
10457	8257	28	2	33	0	8320
10458	29	8298	6	20	0	8353
10459	18	40	5	8345	0	8408
10460	8215	16	5	56	0	8292
10461	38	7	7	8257	0	8309
10462	23	8	3	8364	0	8398
10463	8355	5	7	60	0	8427
10464	8259	6	6	41	0	8312
10465	47	9	8300	9	0	8365
10466	21	13	8179	10	0	8223
10467	11	14	8433	12	0	8470
10468	18	10	51	8461	0	8540
10469	17	3	18	8561	0	8599
10470	9	8506	10	59	0	8584
10471	8705	36	5	46	0	8792
10472	52	22	3	8824	0	8901
10473	27	11	4	8967	0	9009
10474	17	9027	9	70	0	9123
10475	10	9442	9	30	0	9491
10476	14	63	6	9628	0	9711
10477	14	27	6	10565	0	10612
10478	10594	14	5	133	0	10746
10479	10642	5	2	60	0	10709
10480	129	10	8	10597	0	10744
10481	41	8	10618	110	0	10777
10482	30	12	10255	44	0	10341
10483	28	10	113	10466	0	10617
10484	23	9	37	10263	0	10332
10485	19	10211	17	129	0	10376
10486	9901	95	12	64	0	10072
10487	104	30	15	9921	0	10070
10488	40	16	9949	110	0	10115
10489	27	13	94	10095	0	10229
10490	15	12	10108	117	0	10252
10491	24	17	10178	44	0	10263
10492	32	55	118	10218	0	10423
10493	10173	9	49	144	0	10375
10494	99	8	10150	45	0	10302
10495	40	7	103	10060	0	10210
10496	17	5	10495	115	0	10632
10497	21	7	108	10458	0	10594
10498	30	4	41	10495	0	10570
10499	16	12	10402	141	0	10571
10500	20	8	10125	55	0	10208
10501	31	12	135	9648	0	9826
10502	14	5	50	10330	0	10399
10503	24	8	41	10354	0	10427
10504	17	8	26	10257	0	10308
10505	10162	5	23	171	0	10361
10506	10227	6	28	84	0	10345
10507	125	10196	17	61	0	10399
10508	10290	98	22	61	0	10471
10509	127	23	20	10386	0	10556
10510	10391	14	22	154	0	10581
10511	123	8	10369	54	0	10554
10512	10466	8	123	51	0	10648
10513	125	9	42	10641	0	10817
10514	60	8	25	10933	0	11026
10515	10849	7	22	186	0	11064
10516	134	8	21	11472	0	11635
10517	55	9	11978	169	0	12211
10518	12093	8	140	104	0	12345
10519	163	12607	52	82	0	12904
10520	66	143	34	13221	0	13464
10521	38	51	14452	209	0	14750
10522	58	23	193	14462	0	14736
10523	37	19	14584	250	0	14890
10524	64	19	213	14585	0	14881
10525	34	14744	69	240	0	15087
10526	55	189	45	14893	0	15182
10527	34	15389	49	233	0	15705
10528	78	240	34	14722	0	15074
10529	54	72	38	16213	0	16377
10530	57	31	33	16279	0	16400
10531	43	32	35	16314	0	16424
10532	78	20	42	16320	0	16460
10533	44	32	15889	360	0	16325
10534	55	28	239	15975	0	16297
10535	32	23	93	16207	0	16355
10536	15984	20	71	400	0	16475
10537	235	16016	60	192	0	16503
10538	16100	249	49	178	0	16576
10539	301	89	43	16180	0	16613
10540	93	62	16174	354	0	16683
10541	59	16209	257	176	0	16701
10542	16081	253	95	160	0	16589
10543	256	15902	66	139	0	16363
10544	73	16378	61	140	0	16652
10545	16175	299	55	139	0	16668
10546	295	112	42	16922	0	17371
10547	16922	67	42	383	0	17414
10548	352	52	50	16707	0	17161
10549	109	60	16691	395	0	17255
10550	87	46	16579	199	0	16911
10551	16283	42	328	181	0	16834
10552	16734	48	134	150	0	17066
10553	389	48	92	16308	0	16837
10554	176	39	72	16503	0	16790
10555	15939	54	60	426	0	16479
10556	319	15836	48	188	0	16391
10557	147	16266	51	137	0	16601
10558	16087	330	40	160	0	16617
10559	16203	141	53	114	0	16511
10560	395	16042	46	104	0	16587
10561	199	312	35	16001	0	16547
10562	135	115	15855	358	0	16463
10563	133	90	15875	154	0	16252
10564	15626	67	351	139	0	16183
10565	356	53	15836	115	0	16360
10566	174	48	327	15511	0	16060
10567	157	47	120	15349	0	15673
10568	107	15463	92	381	0	16043
10569	15489	284	89	184	0	16046
10570	366	113	77	15421	0	15977
10571	172	90	15178	348	0	15788
10572	132	15192	272	161	0	15757
10573	122	362	95	15029	0	15608
10574	111	116	14857	344	0	15428
10575	98	93	14517	165	0	14873
10576	85	14305	327	145	0	14862
10577	13216	264	134	132	0	13746
10578	254	13379	103	87	0	13823
10579	13311	244	87	107	0	13749
10580	265	102	13201	99	0	13667
10581	12940	62	251	109	0	13362
10582	265	13227	107	114	0	13713
10583	134	246	92	13278	0	13750
10584	112	102	78	13595	0	13887
10585	13425	68	77	329	0	13899
10586	250	82	13364	163	0	13859
10587	13379	74	238	146	0	13837
10588	13501	84	92	127	0	13804
10589	317	76	13113	105	0	13611
10590	138	88	13324	106	0	13656
10591	127	80	300	13059	0	13566
10592	13168	81	130	295	0	13674
10593	13274	71	83	151	0	13579
10594	309	13249	90	122	0	13770
10595	161	231	90	13352	0	13834
10596	134	103	85	13145	0	13467
10597	138	78	60	13192	0	13468
10598	128	73	64	13312	0	13577
10599	13137	66	68	356	0	13627
10600	307	62	62	13293	0	13724
10601	166	62	13214	318	0	13760
10602	143	68	13106	171	0	13488
10603	12958	47	284	147	0	13436
10604	315	12999	136	109	0	13559
10605	176	13438	115	85	0	13814
10606	145	289	100	13356	0	13890
10607	136	107	71	13577	0	13891
10608	144	77	77	13426	0	13724
10609	111	74	75	13573	0	13833
10610	105	78	13245	386	0	13814
10611	133	59	240	13196	0	13628
10612	109	51	102	13258	0	13520
10613	94	52	12706	371	0	13223
10614	12113	48	253	211	0	12625
10615	268	12450	118	174	0	13010
10616	11845	204	101	142	0	12292
10617	250	74	11381	95	0	11800
10618	124	56	10880	79	0	11139
10619	94	10692	228	80	0	11094
10620	9384	426	498	200	0	10508
10621	8711	85	94	78	0	8968
10622	8635	36	46	57	0	8774
10623	167	8460	34	53	0	8714
10624	8278	120	23	57	0	8478
10625	148	57	8291	44	0	8540
10626	69	8210	115	48	0	8442
10627	7826	107	64	50	0	8047
10628	120	7931	35	30	0	8116
10629	7524	99	25	42	0	7690
10630	7338	43	27	44	0	7452
10631	131	30	7547	17	0	7725
10632	70	7576	92	23	0	7761
10633	7528	88	63	34	0	7713
10634	115	46	7475	16	0	7652
10635	63	7436	92	22	0	7613
10636	57	112	57	7224	0	7450
10637	23	50	7179	81	0	7333
10638	20	25	7010	48	0	7103
10639	32	33	103	6995	0	7163
10640	6804	12	53	92	0	6961
10641	80	6814	24	51	0	6969
10642	50	76	6749	23	0	6898
10643	43	39	6590	14	0	6686
10644	6373	29	102	16	0	6520
10645	84	6631	51	14	0	6780
10646	5850	42	45	6	0	5943
10647	52	5805	6	2	0	5865
10648	5869	50	17	12	0	5948
10649	5740	18	8	17	0	5783
10650	60	5711	7	3	0	5781
10651	30	45	3	5738	0	5816
10652	5995	18	6	53	0	6072
10653	56	12	4	6146	0	6218
10654	30	2	6	6523	0	6561
10655	6505	5	11	86	0	6607
10656	65	6587	10	31	0	6693
10657	6711	62	6	27	0	6806
10658	79	30	6675	5	0	6789
10659	40	17	67	6696	0	6820
10660	25	11	31	6686	0	6753
10661	6626	9	17	94	0	6746
10662	6636	8	8	42	0	6694
10663	98	5	5	6613	0	6721
10664	47	11	6687	68	0	6813
10665	32	12	64	6692	0	6800
10666	22	9	28	6740	0	6799
10667	22	4	22	6812	0	6860
10668	17	11	8	6836	0	6872
10669	6733	9	5	115	0	6862
10670	76	10	6710	42	0	6838
10671	35	6726	69	30	0	6860
10672	32	64	27	6700	0	6823
10673	19	28	14	6928	0	6989
10674	14	18	6932	101	0	7065
10675	20	11	6847	42	0	6920
10676	24	10	96	7068	0	7198
10677	20	9	37	7163	0	7229
10678	23	10	6995	117	0	7145
10679	21	10	88	7043	0	7162
10680	7175	11	32	113	0	7331
10681	94	7434	29	46	0	7603
10682	42	83	7362	29	0	7516
10683	25	7365	90	27	0	7507
10684	23	104	34	7422	0	7583
10685	24	42	7433	102	0	7601
10686	23	7414	94	53	0	7584
10687	19	87	50	7413	0	7569
10688	17	40	7548	106	0	7711
10689	22	24	97	7480	0	7623
10690	20	17	41	7515	0	7593
10691	7454	16	29	150	0	7649
10692	108	15	21	7521	0	7665
10693	7574	11	23	137	0	7745
10694	7421	14	23	71	0	7529
10695	7483	17	16	53	0	7569
10696	147	14	18	7472	0	7651
10697	63	14	7420	127	0	7624
10698	51	16	7354	60	0	7481
10699	7413	12	122	44	0	7591
10700	109	11	7437	33	0	7590
10701	7135	14	116	44	0	7309
10702	104	7265	43	25	0	7437
10703	7346	79	31	33	0	7489
10704	112	34	7416	30	0	7592
10705	50	19	7578	36	0	7683
10706	43	15	113	7744	0	7915
10707	31	13	7969	110	0	8123
10708	33	8	8141	58	0	8240
10709	33	8	133	8530	0	8704
10710	34	8	54	8864	0	8960
10711	30	9	35	9123	0	9197
10712	28	9080	38	166	0	9312
10713	27	117	33	8972	0	9149
10714	23	9308	28	165	0	9524
10715	9321	135	26	95	0	9577
10716	9457	63	29	55	0	9604
10717	184	32	29	9172	0	9417
10718	73	9213	24	160	0	9470
10719	48	132	9482	84	0	9746
10720	9540	49	154	58	0	9801
10721	165	32	67	9604	0	9868
10722	81	23	37	9732	0	9873
10723	55	30	30	9841	0	9956
10724	9590	17	36	228	0	9871
10725	165	9254	25	119	0	9563
10726	71	9507	24	90	0	9692
10727	9206	171	28	74	0	9479
10728	163	9291	37	54	0	9545
10729	9374	160	26	49	0	9609
10730	9391	69	28	63	0	9551
10731	201	9283	31	51	0	9566
10732	102	159	24	9118	0	9403
10733	66	9252	17	155	0	9490
10734	65	160	26	9205	0	9456
10735	61	73	29	9581	0	9744
10736	9607	49	21	229	0	9906
10737	9892	49	21	107	0	10069
10738	230	29	38	9862	0	10159
10739	110	36	9675	209	0	10030
10740	9537	35	152	123	0	9847
10741	195	9660	71	73	0	9999
10742	100	161	50	9671	0	9982
10743	84	79	41	9787	0	9991
10744	72	55	25	9854	0	10006
10745	9455	58	22	262	0	9797
10746	9480	40	25	162	0	9707
10747	218	9086	28	108	0	9440
10748	108	9260	35	85	0	9488
10749	126	191	26	9225	0	9568
10750	100	104	34	9321	0	9559
10751	73	69	9259	239	0	9640
10752	67	78	141	9105	0	9391
10753	60	47	8913	228	0	9248
10754	66	17	8480	131	0	8694
10755	47	8471	186	97	0	8801
10756	71	163	89	8405	0	8728
10757	8414	68	56	201	0	8739
10758	174	45	42	8394	0	8655
10759	89	51	8314	199	0	8653
10760	8234	48	131	115	0	8528
10761	8387	41	62	90	0	8580
10762	210	46	8352	64	0	8672
10763	114	46	151	8459	0	8770
10764	8350	42	62	175	0	8629
10765	204	8411	49	105	0	8769
10766	8551	142	46	99	0	8838
10767	8741	72	35	96	0	8944
10768	231	58	42	8645	0	8976
10769	137	48	28	8920	0	9133
10770	8879	42	35	230	0	9186
10771	215	28	35	8989	0	9267
10772	106	31	8936	251	0	9324
10773	8763	26	163	142	0	9094
10774	8887	33	66	101	0	9087
10775	246	8640	42	83	0	9011
10776	113	8750	39	75	0	8977
10777	87	230	29	8518	0	8864
10778	83	8730	23	186	0	9022
10779	81	226	21	8712	0	9040
10780	8526	73	27	209	0	8835
10781	8322	54	29	117	0	8522
10782	207	8217	30	78	0	8532
10783	8130	146	29	78	0	8383
10784	197	8163	35	63	0	8458
10785	8172	170	29	65	0	8436
10786	8254	93	33	64	0	8444
10787	213	55	8056	71	0	8395
10788	7959	40	132	74	0	8205
10789	202	7856	63	61	0	8182
10790	118	8023	51	52	0	8244
10791	8055	170	44	67	0	8336
10792	194	106	32	8053	0	8385
10793	116	65	8037	158	0	8376
10794	122	55	123	8061	0	8361
10795	113	43	62	8135	0	8353
10796	70	52	7906	202	0	8230
10797	7659	34	137	119	0	7949
10798	172	7738	60	101	0	8071
10799	7700	137	45	73	0	7955
10800	214	66	32	7554	0	7866
10801	7586	50	28	164	0	7828
10802	200	7529	21	103	0	7853
10803	126	152	25	7552	0	7855
10804	7447	72	17	179	0	7715
10805	189	56	7111	89	0	7445
10806	99	38	6679	87	0	6903
10807	6449	48	181	70	0	6748
10808	154	6359	73	54	0	6640
10809	82	5825	38	42	0	5987
10810	157	179	72	5360	0	5768
10811	64	5482	16	94	0	5656
10812	56	123	25	5435	0	5639
10813	54	62	14	5553	0	5683
10814	48	37	24	5477	0	5586
10815	45	5351	22	139	0	5557
10816	46	100	27	5330	0	5503
10817	36	46	5237	120	0	5439
10818	41	4718	68	447	0	5274
10819	39	83	31	4715	0	4868
10820	31	4744	30	75	0	4880
10821	4689	80	20	49	0	4838
10822	4689	43	12	41	0	4785
10823	4685	34	18	39	0	4776
10824	103	4754	20	31	0	4908
10825	71	74	13	4744	0	4902
10826	51	37	4718	71	0	4877
10827	40	42	4598	39	0	4719
10828	4515	38	71	46	0	4670
10829	4553	37	37	31	0	4658
10830	84	25	23	4669	0	4801
10831	52	20	18	4798	0	4888
10832	37	24	4861	101	0	5023
10833	23	4465	70	370	0	4928
10834	30	4727	31	46	0	4834
10835	34	63	4578	23	0	4698
10836	39	78	90	4282	0	4489
10837	34	15	18	3750	0	3817
10838	17	19	9	4291	0	4336
10839	20	13	10	4314	0	4357
10840	4258	13	10	75	0	4356
10841	67	11	4153	24	0	4255
10842	4145	17	54	17	0	4233
10843	73	7	15	4200	0	4295
10844	4237	6	8	70	0	4321
10845	71	14	11	4226	0	4322
10846	29	12	4287	64	0	4392
10847	21	18	55	4300	0	4394
10848	14	12	4447	64	0	4537
10849	21	21	55	4373	0	4470
10850	13	10	4552	70	0	4645
10851	14	4499	49	24	0	4586
10852	12	43	22	4511	0	4588
10853	17	14	10	4505	0	4546
10854	10	4502	10	60	0	4582
10855	4580	53	13	23	0	4669
10856	56	17	4	4581	0	4658
10857	23	12	10	4549	0	4594
10858	4578	15	7	71	0	4671
10859	4656	4	5	39	0	4704
10860	4781	8	7	21	0	4817
10861	4788	6	7	23	0	4824
10862	73	8	4628	14	0	4723
10863	4581	6	50	23	0	4660
10864	4743	6	21	11	0	4781
10865	70	10	12	4559	0	4651
10866	29	3	11	4531	0	4574
10867	4395	4	4	64	0	4467
10868	54	4355	8	27	0	4444
10869	23	51	3	4225	0	4302
10870	11	7	4309	49	0	4376
10871	3	4160	33	18	0	4214
10872	4097	37	13	15	0	4162
10873	4109	8	14	5	0	4136
10874	4071	4	3	9	0	4087
10875	4113	2	1	7	0	4123
10876	42	1	0	4020	0	4063
10877	14	3	3991	27	0	4035
10878	10	1	4116	9	0	4136
10879	8	1	43	4393	0	4445
10880	4661	0	12	47	0	4720
10881	51	1	5	4705	0	4762
10882	14	4	4782	51	0	4851
10883	4812	1	54	21	0	4888
10884	4861	0	11	14	0	4886
10885	68	3	3	4918	0	4992
10886	13	4	5026	54	0	5097
10887	10	3	5085	16	0	5114
10888	4956	0	63	10	0	5029
10889	57	5069	13	5	0	5144
10890	15	53	5124	4	0	5196
10891	7	15	57	5084	0	5163
10892	5070	3	13	64	0	5150
10893	58	4938	6	19	0	5021
10894	12	5014	10	9	0	5045
10895	5004	61	6	14	0	5085
10896	70	14	5	5014	0	5103
10897	5283	6	6	68	0	5363
10898	65	6	7	5405	0	5483
10899	21	6	11	5480	0	5518
10900	13	2	5442	80	0	5537
10901	13	8	5177	24	0	5222
10902	14	3	5467	12	0	5496
10903	7	1	79	5494	0	5581
10904	5544	3	25	71	0	5643
10905	73	5	5542	25	0	5645
10906	32	10	69	5556	0	5667
10907	15	6	5720	77	0	5818
10908	11	5755	74	27	0	5867
10909	23	65	21	5832	0	5941
10910	18	17	12	5850	0	5897
10911	14	7	10	5876	0	5907
10912	5799	6	15	98	0	5918
10913	82	9	12	5800	0	5903
10914	29	2	13	5886	0	5930
10915	5822	5	11	116	0	5954
10916	81	9	5782	39	0	5911
10917	5733	2	78	26	0	5839
10918	5793	7	28	30	0	5858
10919	99	5	5780	15	0	5899
10920	5709	9	72	20	0	5810
10921	93	6	29	5945	0	6073
10922	42	4	6047	82	0	6175
10923	5972	4	72	48	0	6096
10924	6080	1	34	22	0	6137
10925	106	3	17	6023	0	6149
10926	43	2	18	6063	0	6126
10927	26	1	17	6102	0	6146
10928	5980	3	16	114	0	6113
10929	90	5994	15	47	0	6146
10930	5865	56	8	30	0	5959
10931	73	5611	18	22	0	5724
10932	44	5572	10	19	0	5645
10933	27	68	15	5605	0	5715
10934	25	22	21	5662	0	5730
10935	34	6	5	5627	0	5672
10936	26	10	13	5631	0	5680
10937	15	11	5545	92	0	5663
10938	5460	2	66	56	0	5584
10939	75	9	27	5588	0	5699
10940	40	13	5661	72	0	5786
10941	23	12	64	5665	0	5764
10942	27	6	25	5773	0	5831
10943	23	9	5903	98	0	6033
10944	20	16	59	5860	0	5955
10945	23	9	28	5875	0	5935
10946	5856	8	15	120	0	5999
10947	69	11	5897	54	0	6031
10948	5651	6	71	37	0	5765
10949	65	5899	38	32	0	6034
10950	5807	60	14	40	0	5921
10951	5767	22	20	31	0	5840
10952	91	7	27	5741	0	5866
10953	38	7	5714	92	0	5851
10954	21	5996	69	54	0	6140
10955	22	82	40	5862	0	6006
10956	22	6263	13	85	0	6383
10957	6246	76	18	65	0	6405
10958	92	27	6165	24	0	6308
10959	38	12	6115	30	0	6195
10960	29	4	99	6077	0	6209
10961	18	19	6232	99	0	6368
10962	28	5	83	6266	0	6382
10963	41	7	39	6206	0	6293
10964	6389	9	18	132	0	6548
10965	94	6472	15	52	0	6633
10966	50	96	17	6546	0	6709
10967	27	23	25	6685	0	6760
10968	29	16	16	6631	0	6692
10969	26	6502	19	119	0	6666
10970	18	6609	20	47	0	6694
10971	6531	90	14	39	0	6674
10972	6564	29	10	47	0	6650
10973	6544	14	21	32	0	6611
10974	121	19	6456	27	0	6623
10975	46	28	89	6440	0	6603
10976	27	10	6425	106	0	6568
10977	17	6413	79	56	0	6565
10978	6158	76	47	53	0	6334
10979	89	30	6086	22	0	6227
10980	45	17	74	5845	0	5981
10981	25	8	6005	67	0	6105
10982	5838	7	60	47	0	5952
10983	5991	5	33	24	0	6053
10984	5994	8	15	28	0	6045
10985	5923	14	10	26	0	5973
10986	84	16	5982	21	0	6103
10987	5813	7	51	25	0	5896
10988	5892	8	27	34	0	5961
10989	77	5856	12	18	0	5963
10990	5803	49	11	19	0	5882
10991	5882	18	11	13	0	5924
10992	86	13	12	5712	0	5823
10993	41	5897	11	54	0	6003
10994	6123	51	12	22	0	6208
10995	6477	19	11	27	0	6534
10996	97	9	7114	14	0	7234
10997	39	9	7288	11	0	7347
10998	21	14	7463	14	0	7512
10999	27	54	128	7349	0	7558
11000	7375	5	54	95	0	7529
11001	95	7389	27	48	0	7559
11002	7303	91	16	24	0	7434
11003	107	7330	13	19	0	7469
11004	7285	92	17	14	0	7408
11005	100	7199	12	13	0	7324
11006	53	7345	13	8	0	7419
11007	7118	123	12	19	0	7272
11008	96	7233	10	12	0	7351
11009	62	93	6	7148	0	7309
11010	24	46	7217	81	0	7368
11011	24	17	7200	34	0	7275
11012	25	15	112	7104	0	7256
11013	21	6	39	7274	0	7340
11014	14	10	7237	115	0	7376
11015	21	15	92	7199	0	7327
11016	16	12	32	7298	0	7358
11017	7288	10	17	140	0	7455
11018	94	7316	16	57	0	7483
11019	40	91	19	7116	0	7266
11020	18	7361	22	89	0	7490
11021	7239	95	8	56	0	7398
11022	95	7249	13	27	0	7384
11023	7238	99	11	21	0	7369
11024	7242	47	6	25	0	7320
11025	139	18	10	7142	0	7309
11026	67	19	8	7173	0	7267
11027	38	20	10	7233	0	7301
11028	27	14	10	7259	0	7310
11029	16	20	7049	137	0	7222
11030	6705	13	91	61	0	6870
11031	100	7046	29	32	0	7207
11032	56	91	17	7134	0	7298
11033	44	35	16	7158	0	7253
11034	20	7182	12	134	0	7348
11035	7189	98	16	71	0	7374
11036	99	7323	12	39	0	7473
11037	54	99	13	7341	0	7507
11038	40	50	11	7431	0	7532
11039	41	22	6	7441	0	7510
11040	20	23	19	7382	0	7444
11041	7261	13	7	163	0	7444
11042	114	17	7241	67	0	7439
11043	55	16	102	7055	0	7228
11044	35	21	41	7165	0	7262
11045	27	16	25	7184	0	7252
11046	33	10	21	7146	0	7210
11047	6966	13	15	155	0	7149
11048	112	16	6955	76	0	7159
11049	61	22	90	6694	0	6867
11050	32	6643	37	106	0	6818
11051	34	6898	21	50	0	7003
11052	6827	125	21	34	0	7007
11053	119	49	6771	32	0	6971
11054	6349	34	77	26	0	6486
11055	108	26	6500	16	0	6650
11056	57	9	79	6248	0	6393
11057	6347	12	41	85	0	6485
11058	82	6445	23	54	0	6604
11059	46	73	17	6220	0	6356
11060	23	6053	22	73	0	6171
11061	6331	80	19	55	0	6485
11062	6330	41	16	45	0	6432
11063	103	18	9	6346	0	6476
11064	52	19	6210	92	0	6373
11065	37	17	6115	46	0	6215
11066	25	22	98	6097	0	6242
11067	19	6130	38	81	0	6268
11068	23	83	23	6418	0	6547
11069	22	51	8	6202	0	6283
11070	32	24	5	6154	0	6215
11071	25	26	6248	121	0	6420
11072	24	15	74	6232	0	6345
11073	23	12	36	6291	0	6362
11074	14	6193	24	132	0	6363
11075	20	85	19	6045	0	6169
11076	16	34	11	6412	0	6473
11077	17	20	13	6467	0	6517
11078	17	15	17	6424	0	6473
11079	15	7	12	6332	0	6366
11080	18	14	8	6302	0	6342
11081	15	17	10	6152	0	6194
11082	13	14	18	6046	0	6091
11083	15	23	5705	206	0	5949
11084	31	14	69	5834	0	5948
11085	5781	15	30	111	0	5937
11086	88	11	14	5714	0	5827
11087	46	11	5801	110	0	5968
11088	5660	9	75	78	0	5822
11089	5912	8	33	52	0	6005
11090	5872	15	15	42	0	5944
11091	5911	11	12	41	0	5975
11092	129	4	7	5957	0	6097
11093	62	8	5841	103	0	6014
11094	30	5642	74	63	0	5809
11095	20	5231	36	45	0	5332
11096	70	151	149	4269	0	4639
11097	11	15	33	4282	0	4341
11098	4	11	4	4243	0	4262
11099	8	3	3	4389	0	4403
11100	4	3	2	4843	0	4852
11101	5271	2	0	68	0	5341
11102	62	5331	0	31	0	5424
11103	32	5585	0	19	0	5636
11104	22	98	5	5656	0	5781
11105	20	48	2	5763	0	5833
11106	11	21	2	5774	0	5808
11107	8	15	5	5739	0	5767
11108	5	4	5523	150	0	5682
11109	8	5472	68	84	0	5632
11110	12	73	37	5509	0	5631
11111	5441	49	13	90	0	5593
11112	74	22	12	5511	0	5619
11113	40	17	5544	106	0	5707
11114	23	6	5343	79	0	5451
11115	22	6	5607	43	0	5678
11116	16	25	122	5515	0	5678
11117	5627	13	88	92	0	5820
11118	71	11	32	5695	0	5809
11119	49	4	19	5870	0	5942
11120	5867	4	9	149	0	6029
11121	92	1	14	6031	0	6138
11122	54	6	22	6113	0	6195
11123	16	7	6304	130	0	6457
11124	24	6341	75	72	0	6512
11125	16	69	45	6615	0	6745
11126	6595	34	25	112	0	6766
11127	87	17	22	6650	0	6776
11128	54	17	6667	111	0	6849
11129	27	12	77	6673	0	6789
11130	27	6727	48	119	0	6921
11131	26	76	21	6874	0	6997
11132	12	45	6816	115	0	6988
11133	13	7284	76	82	0	7455
11134	30	114	53	7411	0	7608
11135	24	62	16	8075	0	8177
11136	20	25	19	8339	0	8403
11137	18	23	22	8409	0	8472
11138	4	19	8181	240	0	8444
11139	8	8221	121	135	0	8485
11140	8239	118	70	82	0	8509
11141	8352	74	37	58	0	8521
11142	189	42	26	8276	0	8533
11143	94	29	8244	149	0	8516
11144	8162	17	119	110	0	8408
11145	132	8	76	8389	0	8605
11146	73	21	8626	162	0	8882
11147	37	11	138	8690	0	8876
11148	42	15	80	8680	0	8817
11149	32	11	36	8818	0	8897
11150	28	9	8816	248	0	9101
11151	47	5	128	8534	0	8714
11152	21	8817	92	181	0	9111
11153	8882	120	44	109	0	9155
11154	8945	74	35	63	0	9117
11155	8975	43	20	73	0	9111
11156	212	8822	29	64	0	9127
11157	8894	119	27	55	0	9095
11158	173	72	17	8735	0	8997
11159	8740	33	38	176	0	8987
11160	8730	31	23	134	0	8918
11161	209	22	8552	86	0	8869
11162	122	8538	125	71	0	8856
11163	8538	130	77	56	0	8801
11164	170	87	46	8515	0	8818
11165	103	57	8497	151	0	8808
11166	62	8462	126	110	0	8760
11167	8354	126	88	75	0	8643
11168	181	77	39	8369	0	8666
11169	111	42	33	8450	0	8636
11170	79	43	22	8463	0	8607
11171	70	8304	16	238	0	8628
11172	56	131	17	8366	0	8570
11173	47	8232	23	205	0	8507
11174	41	144	40	8377	0	8602
11175	41	100	8284	186	0	8611
11176	43	51	132	8364	0	8590
11177	41	40	88	8421	0	8590
11178	35	22	44	8540	0	8641
11179	34	30	8284	263	0	8611
11180	45	32	131	8311	0	8519
11181	45	27	97	8457	0	8626
11182	29	33	39	8556	0	8657
11183	34	27	41	8570	0	8672
11184	44	26	30	8602	0	8702
11185	35	22	8314	288	0	8659
11186	39	40	125	8391	0	8595
11187	37	29	82	8315	0	8463
11188	8045	19	53	286	0	8403
11189	138	7920	50	179	0	8287
11190	98	8109	24	141	0	8372
11191	66	174	31	8095	0	8366
11192	51	91	36	8015	0	8193
11193	35	7810	31	248	0	8124
11194	46	128	26	7887	0	8087
11195	29	7798	25	225	0	8077
11196	45	137	26	7873	0	8081
11197	43	107	26	7759	0	7935
11198	44	48	7466	235	0	7793
11199	26	7266	117	162	0	7571
11200	30	7058	65	110	0	7263
11201	6242	128	68	71	0	6509
11202	86	6321	25	41	0	6473
11203	53	103	15	6156	0	6327
11204	34	49	6039	109	0	6231
11205	26	36	73	6020	0	6155
11206	5951	28	46	118	0	6143
11207	83	22	6061	81	0	6247
11208	44	6127	76	62	0	6309
11209	45	92	46	5433	0	5616
11210	26	37	35	6266	0	6364
11211	6283	35	23	152	0	6493
11212	80	23	19	6336	0	6458
11213	42	27	12	6285	0	6366
11214	35	25	13	6285	0	6358
11215	23	22	15	6247	0	6307
11216	6077	26	13	163	0	6279
11217	6063	18	17	106	0	6204
11218	104	23	12	6080	0	6219
11219	5918	14	12	120	0	6064
11220	96	19	22	5754	0	5891
11221	47	21	5589	126	0	5783
11222	29	18	5441	86	0	5574
11223	35	52	92	5095	0	5274
11224	24	5142	50	102	0	5318
11225	30	76	33	5048	0	5187
11226	4990	42	11	120	0	5163
11227	73	17	13	5076	0	5179
11228	5027	13	13	126	0	5179
11229	83	17	7	5071	0	5178
11230	48	19	5049	102	0	5218
11231	29	4917	64	75	0	5085
11232	25	5064	25	56	0	5170
11233	49	144	20	4433	0	4646
11234	11	27	4477	75	0	4590
11235	4	3889	23	15	0	3931
11236	15	41	18	3627	0	3701
11237	3569	6	1	24	0	3600
11238	13	3	3628	4	0	3648
11239	4	2	14	3633	0	3653
11240	1	2	2	3719	0	3724
11241	1	2	3719	22	0	3744
11242	3	1	3463	8	0	3475
11243	3	5	3693	4	0	3705
11244	1	6	19	3762	0	3788
11245	0	3	3840	20	0	3863
11246	3605	1	22	9	0	3637
11247	26	4	4	3965	0	3999
11248	10	3	4663	28	0	4704
11249	5	4786	29	10	0	4830
11250	2	28	4832	5	0	4867
11251	4	17	35	4855	0	4911
11252	4948	1	19	42	0	5010
11253	35	1	4	5031	0	5071
11254	17	2	3	5097	0	5119
11255	5457	3	4	54	0	5518
11256	58	3	0	5677	0	5738
11257	13	0	5804	62	0	5879
11258	5717	2	60	26	0	5805
11259	59	5889	20	8	0	5976
11260	5992	61	8	8	0	6069
11261	73	19	3	6003	0	6098
11262	22	7	5987	59	0	6075
11263	13	4	6030	21	0	6068
11264	15	8	77	6048	0	6148
11265	14	2	28	6042	0	6086
11266	5	11	6053	76	0	6145
11267	9	8	5873	27	0	5917
11268	6003	3	82	16	0	6104
11269	68	0	27	6092	0	6187
11270	6169	1	10	73	0	6253
11271	78	1	5	6131	0	6215
11272	21	3	6415	76	0	6515
11273	15	3	6566	25	0	6609
11274	10	4	85	6705	0	6804
11275	15	2	24	6868	0	6909
11276	7	5	6985	91	0	7088
11277	6933	4	77	28	0	7042
11278	82	3	25	7198	0	7308
11279	7482	0	13	90	0	7585
11280	90	8302	11	38	0	8441
11281	36	111	13	8535	0	8695
11282	8608	30	8	135	0	8781
11283	124	6	8641	43	0	8814
11284	51	8	123	8679	0	8861
11285	30	3	40	8743	0	8816
11286	25	4	10	8954	0	8993
11287	12	3	8787	176	0	8978
11288	22	1	123	8692	0	8838
11289	7	8735	45	139	0	8926
11290	12	115	20	8883	0	9030
11291	11	36	8795	140	0	8982
11292	11	13	8886	64	0	8974
11293	18	11	163	8890	0	9082
11294	29	5	53	9009	0	9096
11295	25	8	21	9120	0	9174
11296	18	5	17	9170	0	9210
11297	8997	8	9	199	0	9213
11298	9005	7	22	74	0	9108
11299	166	2	8916	41	0	9125
11300	54	9098	137	31	0	9320
11301	33	116	40	9332	0	9521
11302	9437	37	17	176	0	9667
11303	8452	16	41	98	0	8607
11304	9551	13	20	39	0	9623
11305	9564	11	17	45	0	9637
11306	192	9	9412	29	0	9642
11307	9143	9	141	34	0	9327
11308	149	9147	56	25	0	9377
11309	62	125	34	9284	0	9505
11310	29	36	9319	155	0	9539
11311	44	14	127	9240	0	9425
11312	22	17	9291	166	0	9496
11313	33	13	143	9335	0	9524
11314	28	12	60	9528	0	9628
11315	9442	8	27	211	0	9688
11316	151	11	37	9511	0	9710
11317	54	13	9591	183	0	9841
11318	44	10	133	9776	0	9963
11319	9796	7	66	185	0	10054
11320	165	4	23	9923	0	10115
11321	70	8	9812	181	0	10071
11322	38	9739	144	92	0	10013
11323	9957	135	73	51	0	10216
11324	158	52	35	9725	0	9970
11325	67	10052	33	154	0	10306
11326	10020	146	32	92	0	10290
11327	161	45	9987	56	0	10249
11328	56	9872	157	53	0	10138
11329	48	132	63	10050	0	10293
11330	34	49	9954	169	0	10206
11331	26	23	148	9816	0	10013
11332	9806	23	61	178	0	10068
11333	153	15	9734	97	0	9999
11334	82	10	145	9685	0	9922
11335	35	12	9763	177	0	9987
11336	62	14	146	9726	0	9948
11337	29	16	73	9914	0	10032
11338	9718	6	32	226	0	9982
11339	158	9755	35	80	0	10028
11340	73	125	25	9895	0	10118
11341	9814	40	35	179	0	10068
11342	9832	27	44	94	0	9997
11343	191	38	24	9684	0	9937
11344	72	9528	36	168	0	9804
11345	36	9713	27	99	0	9875
11346	52	187	39	9439	0	9717
11347	48	69	32	9340	0	9489
11348	8623	25	34	178	0	8860
11349	129	26	26	8523	0	8704
11350	57	15	8195	161	0	8428
11351	7843	8	126	107	0	8084
11352	126	8010	47	72	0	8255
11353	7976	108	36	57	0	8177
11354	130	46	8117	59	0	8352
11355	67	8176	105	40	0	8388
11356	7960	119	87	53	0	8219
11357	7949	42	43	44	0	8078
11358	141	17	7963	26	0	8147
11359	7852	29	108	30	0	8019
11360	7957	8	42	40	0	8047
11361	141	8063	19	30	0	8253
11362	58	94	29	8270	0	8451
11363	43	39	8240	106	0	8428
11364	39	22	103	8428	0	8592
11365	25	26	8522	127	0	8700
11366	44	10	107	8454	0	8615
11367	8576	13	55	132	0	8776
11368	127	10	22	8773	0	8932
11369	58	10	9349	123	0	9540
11370	9566	8	134	85	0	9793
11371	170	6	53	9894	0	10123
11372	66	10	9699	168	0	9943
11373	9394	11	150	83	0	9638
11374	196	6	62	9547	0	9811
11375	70	15	9406	175	0	9666
11376	35	15	9231	71	0	9352
11377	74	106	178	9082	0	9440
11378	35	14	9247	166	0	9462
11379	23	8912	156	76	0	9167
11380	46	135	52	8040	0	8273
11381	7982	25	37	135	0	8179
11382	109	11	8008	51	0	8179
11383	36	12	7933	29	0	8010
11384	7678	5	133	41	0	7857
11385	117	7	7967	23	0	8114
11386	7644	6	130	31	0	7811
11387	121	2	7880	18	0	8021
11388	60	3	120	7824	0	8007
11389	29	10	7961	109	0	8109
11390	40	4	125	7902	0	8071
11391	28	12	8111	119	0	8270
11392	22	5	7890	57	0	7974
11393	7574	6	147	44	0	7771
11394	100	7968	73	35	0	8176
11395	8023	94	53	45	0	8215
11396	116	8069	47	19	0	8251
11397	56	104	41	8133	0	8334
11398	55	35	43	8296	0	8429
11399	8243	19	42	130	0	8434
11400	122	11	48	8069	0	8250
11401	59	19	8012	116	0	8206
11402	7773	7	128	70	0	7978
11403	7967	11	65	50	0	8093
11404	150	4	56	7939	0	8149
11405	64	7	8075	125	0	8271
11406	56	14	130	7987	0	8187
11407	36	8050	67	124	0	8277
11408	41	101	41	8126	0	8309
11409	33	36	46	8266	0	8381
11410	44	21	8075	151	0	8291
11411	7538	29	120	83	0	7770
11412	119	8004	63	46	0	8232
11413	8013	105	35	62	0	8215
11414	128	8102	40	45	0	8315
11415	72	115	34	7964	0	8185
11416	50	8111	43	117	0	8321
11417	47	111	7909	73	0	8140
11418	46	341	124	7406	0	7917
11419	48	40	57	7760	0	7905
11420	47	20	46	7948	0	8061
11421	7764	19	49	176	0	8008
11422	137	14	45	7793	0	7989
11423	7677	26	51	157	0	7911
11424	7772	26	40	91	0	7929
11425	7669	29	39	73	0	7810
11426	159	23	7655	82	0	7919
11427	85	24	138	7666	0	7913
11428	80	26	54	7968	0	8128
11429	52	24	62	8093	0	8231
11430	8324	27	54	185	0	8590
11431	173	28	44	8378	0	8623
11432	74	27	55	8635	0	8791
11433	8890	27	50	221	0	9188
11434	180	33	62	9147	0	9422
11435	105	19	9319	214	0	9657
11436	66	27	9480	109	0	9682
11437	68	24	212	9600	0	9904
11438	9511	14	93	241	0	9859
11439	9434	10	58	147	0	9649
11440	260	11	71	9353	0	9695
11441	124	14	9304	220	0	9662
11442	95	9224	206	113	0	9638
11443	84	169	95	9383	0	9731
11444	80	50	55	9581	0	9766
11445	69	37	55	9601	0	9762
11446	9439	21	58	282	0	9800
11447	200	26	9476	142	0	9844
11448	9516	23	201	112	0	9852
11449	231	27	72	9467	0	9797
11450	115	9542	56	222	0	9935
11451	9661	167	41	142	0	10011
11452	9618	59	58	110	0	9845
11453	260	31	9979	87	0	10357
11454	114	9380	196	90	0	9780
11455	79	9485	75	106	0	9745
11456	9417	187	63	102	0	9769
11457	247	55	41	9416	0	9759
11458	117	47	46	9413	0	9623
11459	87	39	46	9307	0	9479
11460	73	8927	41	257	0	9298
11461	57	9187	32	133	0	9409
11462	8928	210	26	106	0	9270
11463	235	65	27	8826	0	9153
11464	82	35	9179	230	0	9526
11465	73	40	203	9542	0	9858
11466	65	41	10298	265	0	10669
11467	72	44	10401	118	0	10635
11468	70	36	10481	79	0	10666
11469	38	9506	320	45	0	9909
11470	82	210	217	8904	0	9413
11471	25	9123	111	186	0	9445
11472	71	226	79	8410	0	8786
11473	28	109	45	9220	0	9402
11474	9094	70	40	297	0	9501
11475	201	58	31	9159	0	9449
11476	9070	44	26	284	0	9424
11477	9187	28	20	162	0	9397
11478	308	17	17	8919	0	9261
11479	149	8842	24	257	0	9272
11480	114	181	18	8785	0	9098
11481	88	8861	16	245	0	9210
11482	66	223	23	8881	0	9193
11483	42	118	8816	271	0	9247
11484	56	79	184	8902	0	9221
11485	44	60	77	9096	0	9277
11486	8744	37	54	347	0	9182
11487	195	8792	53	184	0	9224
11488	108	189	44	8883	0	9224
11489	91	91	27	8833	0	9042
11490	66	8662	36	305	0	9069
11491	61	216	25	8748	0	9050
11492	8261	108	21	328	0	8718
11493	8634	73	28	193	0	8928
11494	264	8489	26	121	0	8900
11495	134	214	21	8567	0	8936
11496	8375	95	20	277	0	8767
11497	255	8472	20	142	0	8889
11498	135	229	21	8181	0	8566
11499	89	8434	37	247	0	8807
11500	8405	246	25	138	0	8814
11501	234	133	8296	105	0	8768
11502	115	95	8282	90	0	8582
11503	97	72	262	8290	0	8721
11504	87	57	8385	242	0	8771
11505	63	45	273	8205	0	8586
11506	8164	44	150	282	0	8640
11507	222	36	8426	180	0	8864
11508	129	40	241	8477	0	8887
11509	95	47	122	8690	0	8954
11510	8543	43	80	339	0	9005
11511	210	8620	65	202	0	9097
11512	8681	205	49	173	0	9108
11513	8686	98	30	149	0	8963
11514	312	8416	39	98	0	8865
11515	193	219	29	8525	0	8966
11516	138	108	8425	235	0	8906
11517	105	82	197	8387	0	8771
11518	81	8388	90	258	0	8817
11519	8560	228	64	164	0	9016
11520	223	128	62	8644	0	9057
11521	120	92	8742	281	0	9235
11522	92	86	202	8853	0	9233
11523	85	59	100	9011	0	9255
11524	68	51	68	9119	0	9306
11525	74	48	63	9106	0	9291
11526	71	38	38	8947	0	9094
11527	60	29	8614	418	0	9121
11528	78	40	8354	245	0	8717
11529	41	8054	240	191	0	8526
11530	26	8189	118	149	0	8482
11531	7976	215	117	101	0	8409
11532	190	114	8032	91	0	8427
11533	7460	111	209	85	0	7865
11534	207	70	7358	60	0	7695
11535	123	49	7035	61	0	7268
11536	88	31	221	6819	0	7159
11537	7105	30	141	148	0	7424
11538	153	31	90	7225	0	7499
11539	86	24	71	7331	0	7512
11540	68	23	7663	240	0	7994
11541	62	20	135	7750	0	7967
11542	48	13	82	7656	0	7799
11543	41	17	60	7813	0	7931
11544	38	16	58	7789	0	7901
11545	52	17	38	7808	0	7915
11546	7557	11	27	302	0	7897
11547	129	18	27	7650	0	7824
11548	74	14	7355	261	0	7704
11549	61	24	120	7435	0	7640
11550	66	21	7309	216	0	7612
11551	50	37	147	7374	0	7608
11552	34	14	7570	205	0	7823
11553	37	35	168	7076	0	7316
11554	28	22	112	7342	0	7504
11555	14	14	7198	226	0	7452
11556	6618	17	152	171	0	6958
11557	113	11	7287	128	0	7539
11558	85	20	159	7328	0	7592
11559	7374	10	114	155	0	7653
11560	151	7	74	7453	0	7685
11561	103	17	55	7501	0	7676
11562	69	9	7495	228	0	7801
11563	56	7218	110	153	0	7537
11564	30	6704	62	127	0	6923
11565	15	6556	40	95	0	6706
11566	129	40	94	5481	0	5744
11567	5493	10	20	28	0	5551
11568	14	3	1	5449	0	5467
11569	6	3	2	5470	0	5481
11570	5	1	2	5540	0	5548
11571	9	1	1	5503	0	5514
11572	2	5454	3	21	0	5480
11573	7	16	0	5550	0	5573
11574	5	2	2	5545	0	5554
11575	1	5474	4	25	0	5504
11576	5614	22	1	15	0	5652
11577	21	7	2	5611	0	5641
11578	5620	3	0	34	0	5657
11579	5565	5	2	15	0	5587
11580	25	5658	1	5	0	5689
11581	5	19	1	5933	0	5958
11582	6	6	5895	20	0	5927
11583	7	5	5764	6	0	5782
11584	9	10	23	5840	0	5882
11585	5965	0	6	39	0	6010
11586	6056	1	5	21	0	6083
11587	21	2	6	6135	0	6164
11588	6165	2	5	34	0	6206
11589	25	6137	1	6	0	6169
11590	6131	21	3	15	0	6170
11591	22	6401	4	9	0	6436
11592	13	23	2	6549	0	6587
11593	10	7	2	6555	0	6574
11594	11	6524	2	26	0	6563
11595	6478	27	27	21	0	6553
11596	25	9	6445	10	0	6489
11597	11	8	23	6444	0	6486
11598	9	10	6483	23	0	6525
11599	15	4	25	6441	0	6485
11600	6561	3	13	35	0	6612
11601	33	3	5	6546	0	6587
11602	6500	3	6	41	0	6550
11603	6437	1	5	33	0	6476
11604	33	3	4	6455	0	6495
11605	14	5	6462	25	0	6506
11606	10	6724	24	17	0	6775
11607	11	20	6	6603	0	6640
11608	6487	6	8	48	0	6549
11609	43	6	6396	18	0	6463
11610	15	4	21	6455	0	6495
11611	15	5	8	6344	0	6372
11612	12	3	6	6455	0	6476
11613	6437	6	10	46	0	6499
11614	24	6	2	6343	0	6375
11615	9	3	4	6477	0	6493
11616	9	6	6399	36	0	6450
11617	18	4	24	6405	0	6451
11618	11	1	8	6548	0	6568
11619	11	4	4	6610	0	6629
11620	7	6544	14	31	0	6596
11621	11	23	5	6385	0	6424
11622	5	6	6	6397	0	6414
11623	6233	4	3	52	0	6292
11624	32	8	6210	16	0	6266
11625	23	4	5893	20	0	5940
11626	7	6191	24	22	0	6244
11627	20	21	11	6329	0	6381
11628	6299	6	9	39	0	6353
11629	22	6	4	6215	0	6247
11630	17	6	2	6243	0	6268
11631	6	6	7	6296	0	6315
11632	11	2	5	6184	0	6202
11633	5	1	6	6160	0	6172
11634	7	4	6093	37	0	6141
11635	14	3	19	6058	0	6094
11636	6058	1	7	48	0	6114
11637	23	5898	7	18	0	5946
11638	13	20	6	5971	0	6010
11639	10	7	3	5924	0	5944
11640	8	9	5639	31	0	5687
11641	8	8	24	5570	0	5610
11642	6	3	6	5872	0	5887
11643	5961	5	3	49	0	6018
11644	31	6114	8	21	0	6174
11645	13	34	4	6260	0	6311
11646	5	10	4	6368	0	6387
11647	14	7	4	6392	0	6417
11648	12	9	6425	60	0	6506
11649	8	6	6123	33	0	6170
11650	4	6311	45	31	0	6391
11651	6	6492	15	29	0	6542
11652	14	50	11	6403	0	6478
11653	12	5830	21	59	0	5922
11654	10	56	9	6835	0	6910
11655	9	23	9	7512	0	7553
11656	10	15	6	8000	0	8031
11657	15	13	2	8991	0	9021
11658	8	9	9236	206	0	9459
11659	19	6	133	9411	0	9569
11660	18	4	64	9650	0	9736
11661	9	7	39	9921	0	9976
11662	9590	4	22	311	0	9927
11663	143	9753	38	162	0	10096
11664	101	154	28	9321	0	9604
11665	41	9844	30	213	0	10128
11666	9664	200	16	186	0	10066
11667	8718	107	13	168	0	9006
11668	208	9803	9	100	0	10120
11669	112	10203	10	95	0	10420
11670	63	292	9921	76	0	10352
11671	63	10259	168	61	0	10551
11672	68	265	78	10123	0	10534
11673	10181	145	53	228	0	10607
11674	202	10432	25	139	0	10798
11675	123	245	39	10555	0	10962
11676	70	172	27	10651	0	10920
11677	66	106	31	10953	0	11156
11678	10689	93	26	350	0	11158
11679	214	81	10611	212	0	11118
11680	10439	79	166	157	0	10841
11681	242	10585	90	124	0	11041
11682	154	211	51	10682	0	11098
11683	95	146	10553	261	0	11055
11684	10237	97	192	179	0	10705
11685	240	10566	110	109	0	11025
11686	162	237	75	10395	0	10869
11687	95	10666	52	234	0	11047
11688	81	252	57	10684	0	11074
11689	80	154	36	10935	0	11205
11690	54	102	10679	350	0	11185
11691	62	84	10365	218	0	10729
11692	60	87	270	10474	0	10891
11693	68	74	10557	307	0	11006
11694	41	70	246	10592	0	10949
11695	64	43	155	10485	0	10747
11696	40	53	117	10857	0	11067
11697	10570	42	86	424	0	11122
11698	201	47	103	10796	0	11147
11699	122	36	10755	351	0	11264
11700	10745	51	215	255	0	11266
11701	217	38	127	11033	0	11415
11702	150	45	89	11161	0	11445
11703	10877	42	64	422	0	11405
11704	238	11027	79	274	0	11618
11705	157	192	83	11234	0	11666
11706	108	104	74	11142	0	11428
11707	10877	76	69	432	0	11454
11708	256	41	10828	289	0	11414
11709	148	59	214	10914	0	11335
11710	119	47	122	11071	0	11359
11711	95	53	82	10877	0	11107
11712	103	10751	59	422	0	11335
11713	88	211	66	11021	0	11386
11714	10792	110	68	404	0	11374
11715	240	10786	56	276	0	11358
11716	10686	218	49	255	0	11208
11717	259	10916	64	196	0	11435
11718	10947	265	52	193	0	11457
11719	305	169	10787	162	0	11423
11720	180	140	10706	171	0	11197
11721	10784	79	283	164	0	11310
11722	291	101	11028	147	0	11567
11723	214	77	253	10982	0	11526
11724	158	82	170	10019	0	10429
11725	123	62	120	11307	0	11612
11726	11049	52	103	424	0	11628
11727	279	47	10952	246	0	11524
11728	10950	64	254	202	0	11470
11729	304	44	160	11359	0	11867
11730	11344	68	99	359	0	11870
11731	337	55	68	11557	0	12017
11732	11844	68	91	352	0	12355
11733	364	49	70	12577	0	13060
11734	229	55	12940	358	0	13582
11735	13126	45	271	253	0	13695
11736	13701	43	156	223	0	14123
11737	441	38	113	13575	0	14167
11738	276	40	81	13401	0	13798
11739	168	13460	91	438	0	14157
11740	13372	223	90	306	0	13991
11741	368	13483	68	192	0	14111
11742	13274	255	80	173	0	13782
11743	377	134	13305	169	0	13985
11744	235	95	13197	173	0	13700
11745	182	53	12938	160	0	13333
11746	12976	78	392	135	0	13581
11747	349	13145	210	120	0	13824
11748	238	243	131	13085	0	13697
11749	12999	131	109	308	0	13547
11750	304	13200	106	196	0	13806
11751	242	377	79	12762	0	13460
11752	166	12838	91	280	0	13375
11753	134	12547	71	206	0	12958
11754	131	12719	66	129	0	13045
11755	11669	328	110	153	0	12260
11756	259	11527	40	93	0	11919
11757	103	10278	39	70	0	10490
11758	83	10092	47	51	0	10273
11759	9819	160	96	52	0	10127
11760	9762	54	28	44	0	9888
11761	143	44	9525	37	0	9749
11762	9256	28	91	43	0	9418
11763	9557	22	51	32	0	9662
11764	164	29	18	9499	0	9710
11765	9635	27	15	118	0	9795
11766	131	34	9568	47	0	9780
11767	64	10119	91	37	0	10311
11768	10220	110	54	38	0	10422
11769	131	55	24	10485	0	10695
11770	10450	37	18	115	0	10620
11771	132	27	10079	58	0	10296
11772	10220	27	90	40	0	10377
11773	138	32	44	10445	0	10659
11774	74	36	10360	102	0	10572
11775	38	9971	91	57	0	10157
11776	34	10338	41	34	0	10447
11777	49	151	36	10123	0	10359
11778	25	61	24	9995	0	10105
11779	29	10149	13	105	0	10296
11780	10149	99	11	60	0	10319
11781	10056	44	11	32	0	10143
11782	10021	22	5	31	0	10079
11783	139	10189	14	12	0	10354
11784	76	95	9	9857	0	10037
11785	33	10218	13	68	0	10332
11786	10204	103	12	48	0	10367
11787	10126	44	4	33	0	10207
11788	129	10056	9	15	0	10209
11789	10172	89	8	32	0	10301
11790	123	46	10	10149	0	10328
11791	57	25	11	10221	0	10314
11792	10294	21	13	133	0	10461
11793	10122	21	11	70	0	10224
11794	10230	15	17	36	0	10298
11795	152	20	16	10136	0	10324
11796	75	21	15	10253	0	10364
11797	47	26	10189	136	0	10398
11798	49	27	88	10116	0	10280
11799	41	35	37	10023	0	10136
11800	44	32	9848	137	0	10061
11801	43	28	9374	67	0	9512
11802	37	26	9839	40	0	9942
11803	49	24	138	9794	0	10005
11804	43	34	9773	100	0	9950
11805	44	35	106	9722	0	9907
11806	43	34	43	9951	0	10071
11807	40	30	9927	144	0	10141
11808	31	37	9919	72	0	10059
11809	51	35	125	9925	0	10136
11810	40	40	10392	113	0	10585
11811	43	31	10270	62	0	10406
11812	45	10327	126	42	0	10540
11813	10580	114	60	50	0	10804
11814	10645	61	31	37	0	10774
11815	10657	42	19	46	0	10764
11816	152	10508	17	45	0	10722
11817	79	10638	25	34	0	10776
11818	61	125	25	10691	0	10902
11819	51	64	28	10642	0	10785
11820	54	32	10545	149	0	10780
11821	60	26	108	10468	0	10662
11822	10556	24	51	134	0	10765
11823	133	33	33	10239	0	10438
11824	73	10493	27	132	0	10725
11825	10764	108	34	73	0	10979
11826	10829	48	27	43	0	10947
11827	10960	37	22	51	0	11070
11828	175	26	10818	45	0	11064
11829	97	66	99	11027	0	11289
11830	11539	21	65	169	0	11794
11831	175	19	11751	71	0	12016
11832	77	11224	143	46	0	11490
11833	48	10862	54	34	0	10998
11834	10162	137	72	26	0	10397
11835	127	10129	17	24	0	10297
11836	60	123	8	9833	0	10024
11837	52	37	10056	111	0	10256
11838	46	37	106	9968	0	10157
11839	9995	22	37	130	0	10184
11840	114	9895	26	43	0	10078
11841	9823	106	19	32	0	9980
11842	119	38	9821	29	0	10007
11843	49	41	109	9527	0	9726
11844	27	9949	49	99	0	10124
11845	34	110	29	10127	0	10300
11846	10188	36	17	134	0	10375
11847	10247	24	15	60	0	10346
11848	10248	14	23	37	0	10322
11849	10281	9	24	30	0	10344
11850	144	16	18	10015	0	10193
11851	56	20	10147	114	0	10337
11852	41	20	105	9844	0	10010
11853	32	10119	40	113	0	10304
11854	10183	103	16	56	0	10358
11855	120	34	10169	23	0	10346
11856	9867	19	109	38	0	10033
11857	121	20	36	10126	0	10303
11858	40	16	10314	110	0	10480
11859	49	13	98	10246	0	10406
11860	10421	17	34	133	0	10605
11861	10420	10	26	58	0	10514
11862	10448	11	22	38	0	10519
11863	145	20	10397	31	0	10593
11864	74	30	101	10361	0	10566
11865	33	17	10515	109	0	10674
11866	27	10365	106	49	0	10547
11867	9925	95	43	41	0	10104
11868	106	9654	26	24	0	9810
11869	9412	78	22	24	0	9536
11870	100	27	13	9262	0	9402
11871	30	9416	16	83	0	9545
11872	9487	73	26	44	0	9630
11873	93	30	9538	17	0	9678
11874	52	23	68	9421	0	9564
11875	9553	15	24	87	0	9679
11876	88	9	9547	33	0	9677
11877	42	15	73	9342	0	9472
11878	29	8973	32	81	0	9115
11879	41	75	19	9567	0	9702
11880	30	30	18	9652	0	9730
11881	9492	25	15	114	0	9646
11882	97	9490	15	34	0	9636
11883	42	78	17	9276	0	9413
11884	23	9416	18	79	0	9536
11885	25	95	15	9351	0	9486
11886	27	9557	23	84	0	9691
11887	9521	85	9	43	0	9658
11888	106	36	9650	21	0	9813
11889	53	30	83	9502	0	9668
11890	42	11	24	9546	0	9623
11891	22	21	25	9589	0	9657
11892	26	20	10	9508	0	9564
11893	34	25	9391	104	0	9554
11894	39	9563	76	41	0	9719
11895	9606	74	28	44	0	9752
11896	9721	30	20	39	0	9810
11897	96	9602	15	36	0	9749
11898	9703	71	16	50	0	9840
11899	9706	33	16	42	0	9797
11900	101	9914	21	27	0	10063
11901	55	85	18	9816	0	9974
11902	49	10033	11	66	0	10159
11903	9964	78	21	45	0	10108
11904	90	33	9822	35	0	9980
11905	9347	21	75	41	0	9484
11906	104	17	9937	31	0	10089
11907	42	21	90	9940	0	10093
11908	9909	20	22	104	0	10055
11909	110	23	9825	32	0	9990
11910	9400	14	82	45	0	9541
11911	9720	15	36	38	0	9809
11912	123	19	27	9684	0	9853
11913	48	9737	25	94	0	9904
11914	9877	83	19	47	0	10026
11915	104	47	14	9815	0	9980
11916	56	9652	18	85	0	9811
11917	9738	85	17	38	0	9878
11918	110	36	13	9818	0	9977
11919	39	10083	16	92	0	10230
11920	40	92	13	10366	0	10511
11921	10430	25	23	125	0	10603
11922	10357	21	21	64	0	10463
11923	10420	21	14	57	0	10512
11924	134	19	14	10208	0	10375
11925	50	15	15	10195	0	10275
11926	29	25	10220	105	0	10379
11927	41	41	77	10203	0	10362
11928	41	16	10533	97	0	10687
11929	33	10	9785	45	0	9873
11930	20	9	9568	16	0	9613
11931	8	9942	68	34	0	10052
11932	31	60	59	9693	0	9843
11933	6	10657	25	43	0	10731
11934	10888	80	13	34	0	11015
11935	11004	15	14	34	0	11067
11936	107	13	10	11450	0	11580
11937	28	6	11881	104	0	12019
11938	32	12	126	11851	0	12021
11939	12	13	12153	141	0	12319
11940	27	12	127	11936	0	12102
11941	13	12006	24	126	0	12169
11942	13	12392	25	41	0	12471
11943	12261	144	10	41	0	12456
11944	136	37	12205	13	0	12391
11945	45	17	130	12084	0	12276
11946	28	16	35	12275	0	12354
11947	12260	17	12	186	0	12475
11948	142	12319	18	49	0	12528
11949	12342	136	14	44	0	12536
11950	142	12541	17	16	0	12716
11951	12375	135	14	29	0	12553
11952	12631	32	17	40	0	12720
11953	172	22	14	12589	0	12797
11954	54	17	12626	152	0	12849
11955	12219	20	147	62	0	12448
11956	155	12674	37	34	0	12900
11957	12801	149	22	31	0	13003
11958	176	35	12	12432	0	12655
11959	58	25	16	12459	0	12558
11960	42	12403	11	178	0	12634
11961	38	146	17	12226	0	12427
11962	35	12419	11	153	0	12618
11963	38	149	15	12269	0	12471
11964	36	43	9	12238	0	12326
11965	11929	28	8	194	0	12159
11966	163	22	11914	62	0	12161
11967	50	11842	133	37	0	12062
11968	40	148	39	11979	0	12206
11969	12037	42	17	185	0	12281
11970	12248	19	16	67	0	12350
11971	12172	22	26	53	0	12273
11972	201	24	12045	35	0	12305
11973	12047	29	164	46	0	12286
11974	205	27	40	12263	0	12535
11975	12177	22	24	203	0	12426
11976	206	12040	19	67	0	12332
11977	68	176	26	12199	0	12469
11978	12077	42	18	200	0	12337
11979	197	12366	22	68	0	12653
11980	85	189	16	12504	0	12794
11981	57	66	12303	197	0	12623
11982	12888	36	149	92	0	13165
11983	13541	26	50	58	0	13675
11984	289	32	13406	37	0	13764
11985	103	13014	198	58	0	13373
11986	67	13552	67	38	0	13724
11987	69	248	42	13541	0	13900
11988	75	94	29	13002	0	13200
11989	74	51	26	13603	0	13754
11990	55	36	13599	299	0	13989
11991	13529	47	206	135	0	13917
11992	14236	34	70	91	0	14431
11993	14526	40	47	80	0	14693
11994	14552	39	38	68	0	14697
11995	14770	33	35	77	0	14915
11996	14977	32	33	76	0	15118
11997	365	39	37	15287	0	15728
11998	155	53	15179	278	0	15665
11999	109	46	15543	100	0	15798
12000	107	41	274	15758	0	16180
12001	89	34	97	15820	0	16040
12002	98	32	54	15906	0	16090
12003	66	15946	53	373	0	16438
12004	16166	284	43	161	0	16654
12005	334	16666	40	89	0	17129
12006	150	312	23	16432	0	16917
12007	16330	101	29	329	0	16789
12008	349	16404	35	120	0	16908
12009	166	304	33	16432	0	16935
12010	119	95	31	16679	0	16924
12011	108	70	35	16669	0	16882
12012	70	16387	32	422	0	16911
12013	90	294	28	16612	0	17024
12014	66	118	16496	408	0	17088
12015	91	66	289	16756	0	17202
12016	78	75	89	17045	0	17287
12017	80	63	53	17649	0	17845
12018	76	65	40	17994	0	18175
12019	73	45	17625	546	0	18289
12020	85	17616	323	259	0	18283
12021	106	362	109	17926	0	18503
12022	102	110	79	18579	0	18870
12023	87	115	66	18399	0	18667
12024	77	17725	58	588	0	18448
12025	69	18681	52	311	0	19113
12026	18326	466	38	266	0	19096
12027	395	192	37	18131	0	18755
12028	139	131	17864	498	0	18632
12029	115	17890	342	265	0	18612
12030	17426	378	126	229	0	18159
12031	385	162	17215	174	0	17936
12032	160	143	17002	156	0	17461
12033	143	87	16927	140	0	17297
12034	132	234	496	16310	0	17172
12035	75	85	16534	420	0	17114
12036	63	15827	406	241	0	16537
12037	82	315	180	15334	0	15911
12038	59	146	15507	377	0	16089
12039	74	125	368	15305	0	15872
12040	15109	88	163	442	0	15802
12041	296	67	15178	251	0	15792
12042	14790	78	343	221	0	15432
12043	357	15383	162	165	0	16067
12044	15432	303	151	153	0	16039
12045	414	136	133	15451	0	16134
12046	15526	115	128	393	0	16162
12047	15600	95	113	236	0	16044
12048	15335	94	130	207	0	15766
12049	458	15486	110	149	0	16203
12050	15511	312	121	154	0	16098
12051	15601	129	133	150	0	16013
12052	461	116	15287	156	0	16020
12053	280	15234	332	139	0	15985
12054	257	338	183	15175	0	15953
12055	197	168	143	15443	0	15951
12056	171	155	122	15490	0	15938
12057	161	107	15100	486	0	15854
12058	155	94	318	15227	0	15794
12059	160	84	15196	464	0	15904
12060	15108	85	394	278	0	15865
12061	15504	89	193	249	0	16035
12062	452	91	15436	215	0	16194
12063	15461	87	362	205	0	16115
12064	15826	79	186	197	0	16288
12065	15943	63	171	188	0	16365
12066	560	83	151	15579	0	16373
12067	351	84	15623	384	0	16442
12068	271	15734	325	254	0	16584
12069	234	311	176	15788	0	16509
12070	204	156	15823	394	0	16577
12071	208	134	15023	221	0	15586
12072	14952	114	395	238	0	15699
12073	346	15439	254	273	0	16312
12074	15626	295	197	204	0	16322
12075	15763	151	150	190	0	16254
12076	423	15620	149	181	0	16373
12077	15659	287	155	170	0	16271
12078	445	150	15821	148	0	16564
12079	289	131	15374	144	0	15938
12080	291	118	15373	132	0	15914
12081	235	15041	411	118	0	15805
12082	14662	238	327	100	0	15327
12083	14646	134	205	103	0	15088
12084	413	14137	159	97	0	14806
12085	268	14602	155	122	0	15147
12086	213	297	151	14486	0	15147
12087	180	206	116	14674	0	15176
12088	14590	169	111	335	0	15205
12089	337	14646	123	198	0	15304
12090	14557	266	129	177	0	15129
12091	14395	168	119	131	0	14813
12092	404	156	14052	112	0	14724
12093	290	13851	243	100	0	14484
12094	325	342	155	13699	0	14521
12095	13648	159	122	237	0	14166
12096	373	140	96	13367	0	13976
12097	12922	89	116	257	0	13384
12098	341	77	12539	123	0	13080
12099	206	12122	237	130	0	12695
12100	178	12208	131	102	0	12619
12101	194	320	143	11549	0	12206
12102	176	12076	96	162	0	12510
12103	12021	232	110	123	0	12486
12104	222	148	11856	116	0	12342
12105	11214	124	171	115	0	11624
12106	240	113	11788	99	0	12240
12107	171	99	172	11727	0	12169
12108	177	96	101	11720	0	12094
12109	170	83	98	11839	0	12190
12110	11766	64	78	233	0	12141
12111	230	55	11888	144	0	12317
12112	169	74	165	11699	0	12107
12113	161	87	90	11633	0	11971
12114	143	11387	77	217	0	11824
12115	137	11289	57	166	0	11649
12116	133	11435	77	126	0	11771
12117	119	203	58	10899	0	11279
12118	86	127	60	10415	0	10688
12119	34	9868	22	102	0	10026
12120	37	9909	13	60	0	10019
12121	9701	75	45	71	0	9892
12122	75	49	11	9533	0	9668
12123	17	9335	18	28	0	9398
12124	9477	20	21	30	0	9548
12125	36	10	12	9577	0	9635
12126	10263	8	6	32	0	10309
12127	49	8	8	10526	0	10591
12128	24	9	10635	58	0	10726
12129	18	10658	40	27	0	10743
12130	10516	39	16	39	0	10610
12131	48	14	10746	7	0	10815
12132	18	10692	39	14	0	10763
12133	24	48	17	10718	0	10807
12134	19	6	12	10796	0	10833
12135	16	12	3	10554	0	10585
12136	20	4	4	10403	0	10431
12137	9	6	10607	48	0	10670
12138	1	10458	36	18	0	10513
12139	9	40	5	10519	0	10573
12140	10387	9	3	60	0	10459
12141	38	10437	7	15	0	10497
12142	16	37	3	10945	0	11001
12143	10	8	10743	58	0	10819
12144	3	10815	64	9	0	10891
12145	41	67	10	10152	0	10270
12146	7	11115	14	50	0	11186
12147	11181	87	4	19	0	11291
12148	11228	15	3	33	0	11279
12149	92	12	10950	8	0	11062
12150	10897	9	67	19	0	10992
12151	11191	11	10	22	0	11234
12152	103	12	10888	5	0	11008
12153	35	10917	78	10	0	11040
12154	44	69	17	10895	0	11025
12155	26	12	20	11283	0	11341
12156	11244	13	7	99	0	11363
12157	91	7	5	11245	0	11348
12158	23	8	11192	90	0	11313
12159	10693	9	77	44	0	10823
12160	82	7	10973	31	0	11093
12161	19	11001	83	22	0	11125
12162	10754	76	20	23	0	10873
12163	90	21	10802	13	0	10926
12164	28	20	10474	18	0	10540
12165	22	10721	84	11	0	10838
12166	16	82	33	10831	0	10962
12167	14	34	10591	77	0	10716
12168	40	19	90	9493	0	9642
12169	18	7	25	10417	0	10467
12170	6	11	10228	100	0	10345
12171	8	10239	89	39	0	10375
12172	13	79	23	10329	0	10444
12173	10123	19	21	103	0	10266
12174	10024	14	8	40	0	10086
12175	99	11	10	10079	0	10199
12176	32	14	9981	92	0	10119
12177	23	14	10173	26	0	10236
12178	20	15	94	10030	0	10159
12179	22	7	9968	95	0	10092
12180	9946	8	108	35	0	10097
12181	119	5	29	10234	0	10387
12182	39	5	29	10468	0	10541
12183	27	10401	23	115	0	10566
12184	25	108	14	10606	0	10753
12185	19	25	10328	128	0	10500
12186	9901	20	113	41	0	10075
12187	10239	14	32	45	0	10330
12188	142	10	10305	24	0	10481
12189	61	11	117	10715	0	10904
12190	47	12	35	11010	0	11104
12191	21	12	11034	164	0	11231
12192	37	6	144	11250	0	11437
12193	41	12	46	11230	0	11329
12194	15	11571	37	189	0	11812
12195	27	159	18	12011	0	12215
12196	25	36	18	12260	0	12339
12197	12488	27	20	238	0	12773
12198	13010	6	23	119	0	13158
12199	13293	12	17	67	0	13389
12200	13204	14	16	41	0	13275
12201	13114	8	25	53	0	13200
12202	300	15	12683	38	0	13036
12203	152	9	193	12647	0	13001
12204	108	9	68	12848	0	13033
12205	65	15	12719	258	0	13057
12206	12323	12	204	128	0	12667
12207	12606	10	90	82	0	12788
12208	265	14	11809	64	0	12152
12209	12512	9	181	75	0	12777
12210	12840	7	71	58	0	12976
12211	313	12	12576	26	0	12927
12212	163	12	213	12227	0	12615
12213	92	12684	92	217	0	13085
12214	81	193	63	13331	0	13668
12215	77	65	39	13459	0	13640
12216	60	35	37	13454	0	13586
12217	43	22	13219	334	0	13618
12218	13009	18	225	150	0	13402
12219	13364	21	85	101	0	13571
12220	317	14	53	13198	0	13582
12221	139	9	13028	268	0	13444
12222	103	21	235	13003	0	13362
12223	74	12	13257	282	0	13625
12224	63	14	13311	115	0	13503
12225	52	13290	291	94	0	13727
12226	88	194	129	12640	0	13051
12227	12482	60	80	242	0	12864
12228	12183	30	52	111	0	12376
12229	12399	23	40	73	0	12535
12230	318	22	45	12142	0	12527
12231	152	12635	31	228	0	13046
12232	123	209	30	12885	0	13247
12233	66	59	13457	291	0	13873
12234	14573	44	254	134	0	15005
12235	15835	33	85	122	0	16075
12236	419	29	68	15760	0	16276
12237	196	22	52	16038	0	16308
12238	173	21	41	16131	0	16366
12239	113	14	15671	477	0	16275
12240	14894	7	311	231	0	15443
12241	381	15257	120	153	0	15911
12242	151	15249	84	127	0	15611
12243	92	311	15195	103	0	15701
12244	103	163	324	14881	0	15471
12245	67	76	15034	337	0	15514
12246	14541	66	343	164	0	15114
12247	358	58	142	14621	0	15179
12248	175	35	14529	334	0	15073
12249	128	14851	313	159	0	15451
12250	14977	265	129	137	0	15508
12251	358	91	15065	112	0	15626
12252	159	14570	330	87	0	15146
12253	116	15260	146	80	0	15602
12254	15281	362	103	90	0	15836
12255	346	165	79	15286	0	15876
12256	144	104	15633	348	0	16229
12257	110	15671	336	158	0	16275
12258	15794	329	143	126	0	16392
12259	16005	117	94	98	0	16314
12260	433	15773	83	85	0	16374
12261	186	349	15969	91	0	16595
12262	168	134	347	16042	0	16691
12263	16102	94	139	365	0	16700
12264	16268	74	126	161	0	16629
12265	466	68	16007	103	0	16644
12266	214	79	345	15875	0	16513
12267	188	48	144	16322	0	16702
12268	148	54	16215	446	0	16863
12269	119	53	16139	210	0	16521
12270	16226	49	448	145	0	16868
12271	16672	64	181	112	0	17029
12272	16796	61	139	110	0	17106
12273	16852	55	114	104	0	17125
12274	531	61	16255	99	0	16946
12275	16532	33	363	100	0	17028
12276	569	45	148	16297	0	17059
12277	286	48	16396	381	0	17111
12278	200	47	16414	222	0	16883
12279	144	16298	436	196	0	17074
12280	144	302	214	16126	0	16786
12281	127	121	16256	364	0	16868
12282	15775	107	401	163	0	16446
12283	400	113	196	14893	0	15602
12284	190	15908	148	303	0	16549
12285	16010	309	152	194	0	16665
12286	16207	111	147	165	0	16630
12287	498	71	15895	110	0	16574
12288	277	15705	355	100	0	16437
12289	217	283	157	15350	0	16007
12290	15273	140	133	335	0	15881
12291	387	109	134	15101	0	15731
12292	218	88	14659	330	0	15295
12293	13742	76	310	184	0	14312
12294	346	14085	162	118	0	14711
12295	177	13372	104	116	0	13769
12296	169	14120	125	120	0	14534
12297	13568	372	235	168	0	14343
12298	13412	169	121	79	0	13781
12299	13520	102	84	54	0	13760
12300	399	74	61	13222	0	13756
12301	201	80	13319	245	0	13845
12302	147	76	255	13421	0	13899
12303	13498	55	121	308	0	13982
12304	326	30	92	13608	0	14056
12305	13767	44	80	300	0	14191
12306	13842	36	87	135	0	14100
12307	13598	42	98	120	0	13858
12308	330	13495	75	125	0	14025
12309	13598	249	79	90	0	14016
12310	358	90	13403	61	0	13912
12311	199	65	13402	49	0	13715
12312	194	13089	277	113	0	13673
12313	197	239	122	12676	0	13234
12314	12692	77	87	238	0	13094
12315	331	51	12542	95	0	13019
12316	12390	52	262	72	0	12776
12317	326	41	103	12267	0	12737
12318	150	12489	97	248	0	12984
12319	121	213	108	12708	0	13150
12320	128	94	12677	245	0	13144
12321	12291	80	244	128	0	12743
12322	292	60	12760	101	0	13213
12323	165	40	12303	84	0	12592
12324	12072	43	272	80	0	12467
12325	277	12127	120	69	0	12593
12326	12381	225	76	67	0	12749
12327	12548	76	73	64	0	12761
12328	364	57	12204	45	0	12670
12329	11980	57	264	68	0	12369
12330	304	64	11955	68	0	12391
12331	161	38	11280	84	0	11563
12332	142	31	11346	84	0	11603
12333	99	10605	252	84	0	11040
12334	8943	230	384	77	0	9634
12335	8608	36	60	41	0	8745
12336	8558	15	19	20	0	8612
12337	8561	7	18	28	0	8614
12338	115	9	8541	6	0	8671
12339	44	9	85	8525	0	8663
12340	38	14	19	8607	0	8678
12341	8584	11	16	101	0	8712
12342	102	8568	19	26	0	8715
12343	33	84	24	8515	0	8656
12344	8494	12	20	103	0	8629
12345	93	21	8559	19	0	8692
12346	33	15	94	8526	0	8668
12347	34	17	8590	90	0	8731
12348	25	8474	94	29	0	8622
12349	54	99	24	8091	0	8268
12350	8032	15	19	94	0	8160
12351	99	12	15	8186	0	8312
12352	29	9	8236	96	0	8370
12353	14	8301	88	24	0	8427
12354	8169	74	18	37	0	8298
12355	100	17	8170	16	0	8303
12356	7913	11	90	30	0	8044
12357	93	8151	16	21	0	8281
12358	8287	85	28	19	0	8419
12359	8400	21	5	22	0	8448
12360	131	8	8	8432	0	8579
12361	39	5	8388	103	0	8535
12362	19	8465	97	22	0	8603
12363	24	103	28	8604	0	8759
12364	29	27	14	8736	0	8806
12365	22	12	13	9126	0	9173
12366	34	10	17	9479	0	9540
12367	18	10204	15	156	0	10393
12368	10616	150	14	50	0	10830
12369	180	10732	12	22	0	10946
12370	65	176	7	11313	0	11561
12371	11584	50	14	197	0	11845
12372	226	37	11	11661	0	11935
12373	97	22	11599	220	0	11938
12374	62	11620	189	88	0	11959
12375	72	193	65	11668	0	11998
12376	54	77	44	11930	0	12105
12377	11475	51	23	270	0	11819
12378	221	36	11422	116	0	11795
12379	11341	35	192	87	0	11655
12380	11499	22	67	77	0	11665
12381	11505	23	44	76	0	11648
12382	305	29	11323	51	0	11708
12383	151	40	210	11195	0	11596
12384	108	37	74	11398	0	11617
12385	62	32	11372	301	0	11767
12386	62	30	11443	155	0	11690
12387	11532	25	270	102	0	11929
12388	246	25	117	11813	0	12201
12389	11955	35	73	261	0	12324
12390	12312	34	46	131	0	12523
12391	321	35	42	12261	0	12659
12392	166	19	12776	280	0	13241
12393	12748	28	241	153	0	13170
12394	314	28	112	13208	0	13662
12395	171	32	13139	285	0	13627
12396	122	12992	253	159	0	13526
12397	13002	223	125	123	0	13473
12398	302	13115	86	100	0	13603
12399	230	271	55	12211	0	12767
12400	135	13203	68	254	0	13660
12401	12897	289	71	161	0	13418
12402	13101	131	71	154	0	13457
12403	393	12949	64	139	0	13545
12404	13057	246	67	164	0	13534
12405	12958	141	76	158	0	13333
12406	406	12739	84	126	0	13355
12407	12870	257	73	144	0	13344
12408	386	136	70	12702	0	13294
12409	273	83	75	12855	0	13286
12410	12783	57	77	395	0	13312
12411	409	58	81	12275	0	12823
12412	285	12487	79	296	0	13147
12413	12573	245	67	199	0	13084
12414	12583	136	89	169	0	12977
12415	421	12536	86	136	0	13179
12416	12681	275	87	147	0	13190
12417	12777	141	99	136	0	13153
12418	459	97	85	12461	0	13102
12419	307	67	12415	305	0	13094
12420	232	12336	250	203	0	13021
12421	12624	253	124	152	0	13153
12422	12676	169	74	150	0	13069
12423	489	95	12302	148	0	13034
12424	12484	66	274	147	0	12971
12425	409	89	12116	152	0	12766
12426	12309	92	273	119	0	12793
12427	434	97	149	12229	0	12909
12428	276	114	12184	297	0	12871
12429	243	143	12206	182	0	12774
12430	218	152	317	12098	0	12785
12431	223	137	150	12137	0	12647
12432	221	125	11801	377	0	12524
12433	242	100	264	11848	0	12454
12434	208	133	11919	324	0	12584
12435	244	118	280	11883	0	12525
12436	271	113	139	11836	0	12359
12437	241	11421	108	367	0	12137
12438	262	11361	84	243	0	11950
12439	219	11909	102	186	0	12416
12440	227	334	77	11869	0	12507
12441	231	185	72	12094	0	12582
12442	201	131	11723	447	0	12502
12443	11465	108	278	270	0	12121
12444	11998	122	159	200	0	12479
12445	469	11674	133	174	0	12450
12446	11911	270	89	161	0	12431
12447	441	160	102	11717	0	12420
12448	11973	110	119	296	0	12498
12449	12116	92	103	252	0	12563
12450	489	85	107	11823	0	12504
12451	11512	96	116	337	0	12061
12452	386	11109	129	243	0	11867
12453	299	11358	97	167	0	11921
12454	250	340	122	10896	0	11608
12455	241	11382	105	270	0	11998
12456	221	273	118	11001	0	11613
12457	219	161	102	11161	0	11643
12458	10791	106	111	353	0	11361
12459	342	10559	111	237	0	11249
12460	10490	211	107	192	0	11000
12461	10264	157	112	187	0	10720
12462	364	10259	112	176	0	10911
12463	10274	211	103	195	0	10783
12464	318	138	10081	184	0	10721
12465	215	9675	211	155	0	10256
12466	9273	161	144	184	0	9762
12467	216	97	8695	132	0	9140
12468	131	8002	129	80	0	8342
12469	111	8071	129	77	0	8388
12470	7364	124	160	54	0	7702
12471	7224	64	31	52	0	7371
12472	7194	35	29	52	0	7310
12473	142	7180	30	40	0	7392
12474	106	74	25	7308	0	7513
12475	7329	50	21	101	0	7501
12476	7339	46	23	80	0	7488
12477	149	33	26	7274	0	7482
12478	82	44	7348	90	0	7564
12479	70	40	7285	65	0	7460
12480	66	25	101	7423	0	7615
12481	56	27	76	7494	0	7653
12482	56	22	7413	115	0	7606
12483	54	25	81	7298	0	7458
12484	52	7343	56	102	0	7553
12485	7248	71	44	70	0	7433
12486	102	74	36	7160	0	7372
12487	6979	25	36	98	0	7138
12488	95	6989	26	99	0	7209
12489	73	7152	30	58	0	7313
12490	7038	78	30	41	0	7187
12491	71	44	6865	40	0	7020
12492	5981	51	56	19	0	6107
12493	41	6098	34	23	0	6196
12494	38	21	16	5787	0	5862
12495	5750	15	9	26	0	5800
12496	25	11	8	5724	0	5768
12497	5887	3	5	37	0	5932
12498	5788	6	13	24	0	5831
12499	33	6054	3	17	0	6107
12500	5963	16	5	8	0	5992
12501	19	5904	2	10	0	5935
12502	5962	14	5	10	0	5991
12503	29	10	3	5962	0	6004
12504	6126	4	1	20	0	6151
12505	22	5	2	6207	0	6236
12506	6403	5	5	28	0	6441
12507	6491	7	1	20	0	6519
12508	6547	3	0	19	0	6569
12509	6581	1	5	9	0	6596
12510	6634	0	2	10	0	6646
12511	25	7	0	6713	0	6745
12512	6618	2	1	23	0	6644
12513	22	6511	3	22	0	6558
12514	15	15	6552	5	0	6587
12515	9	13	12	6543	0	6577
12516	6	4	6765	20	0	6795
12517	10	3	16	6933	0	6962
12518	7	3	7039	23	0	7072
12519	6926	3	22	16	0	6967
12520	25	6	7	7172	0	7210
12521	10	4	7122	23	0	7159
12522	9	5	7283	12	0	7309
12523	8	17	32	7434	0	7491
12524	8051	0	15	41	0	8107
12525	35	8443	8	47	0	8533
12526	8595	41	3	9	0	8648
12527	8616	32	4	9	0	8661
12528	79	8612	2	7	0	8700
12529	8950	45	1	17	0	9013
12530	55	35	2	8960	0	9052
12531	50	9	1	8971	0	9031
12532	19	7	2	9031	0	9059
12533	8998	5	2	78	0	9083
12534	50	9034	3	45	0	9132
12535	35	50	0	9163	0	9248
12536	15	30	1	9317	0	9363
12537	9277	9	4	85	0	9375
12538	57	9	3	9278	0	9347
12539	36	8	9397	72	0	9513
12540	20	9726	53	41	0	9840
12541	9949	64	32	30	0	10075
12542	85	40	14	9812	0	9951
12543	44	10067	11	67	0	10189
12544	10076	71	5	44	0	10196
12545	81	45	10034	23	0	10183
12546	55	10035	67	17	0	10174
12547	10183	78	36	25	0	10322
12548	84	48	18	10085	0	10235
12549	53	17	9	10089	0	10168
12550	21	17	10077	108	0	10223
12551	28	11	66	10012	0	10117
12552	15	7	10484	96	0	10602
12553	9	14	9979	61	0	10063
12554	9	9	10526	32	0	10576
12555	10515	9	126	36	0	10686
12556	10700	8	64	32	0	10804
12557	10878	3	36	13	0	10930
12558	125	6	26	10754	0	10911
12559	68	10756	17	69	0	10910
12560	39	10955	10	37	0	11041
12561	11154	106	8	28	0	11296
12562	11097	48	9	43	0	11197
12563	104	11141	12	14	0	11271
12564	11042	80	9	24	0	11155
12565	97	47	10896	12	0	11052
12566	69	27	10801	9	0	10906
12567	47	13	105	10408	0	10573
12568	28	11	55	10933	0	11027
12569	23	11	10913	103	0	11050
12570	28	5	84	10730	0	10847
12571	10767	2	49	115	0	10933
12572	70	12	10737	64	0	10883
12573	10587	9	78	37	0	10711
12574	107	6	54	10813	0	10980
12575	59	11	11076	83	0	11229
12576	32	11088	88	43	0	11251
12577	11205	73	49	33	0	11360
12578	97	43	10964	29	0	11133
12579	10882	23	88	26	0	11019
12580	101	13	53	10978	0	11145
12581	11025	14	26	93	0	11158
12582	103	13	11417	52	0	11585
12583	65	10	84	11514	0	11673
12584	11894	5	44	107	0	12050
12585	12069	6	30	74	0	12179
12586	12435	9	24	48	0	12516
12587	12503	7	16	37	0	12563
12588	161	6	15	12088	0	12270
12589	84	8	15	12069	0	12176
12590	59	8	12009	131	0	12207
12591	57	7	84	11993	0	12141
12592	50	7	51	11769	0	11877
12593	24	12215	21	148	0	12408
12594	12383	92	21	87	0	12583
12595	12684	43	22	58	0	12807
12596	144	13107	15	41	0	13307
12597	81	115	9	13081	0	13286
12598	61	54	14	13242	0	13371
12599	12824	28	8	180	0	13040
12600	149	21	13158	75	0	13403
12601	73	18	124	13281	0	13496
12602	52	10	13462	155	0	13679
12603	13129	14	134	112	0	13389
12604	13386	8	56	62	0	13512
12605	13493	7	46	51	0	13597
12606	191	10	22	13197	0	13420
12607	104	11	28	13164	0	13307
12608	13137	9	15	191	0	13352
12609	166	17	12991	83	0	13257
12610	91	14	112	13035	0	13252
12611	13098	11	51	169	0	13329
12612	167	12	33	13138	0	13350
12613	89	11	13488	143	0	13731
12614	44	13	13010	93	0	13160
12615	13045	10	150	76	0	13281
12616	147	13335	76	45	0	13603
12617	13463	106	40	69	0	13678
12618	13612	45	39	58	0	13754
12619	188	28	33	13573	0	13822
12620	108	26	24	13478	0	13636
12621	72	13421	17	162	0	13672
12622	13216	114	20	93	0	13443
12623	152	13226	21	63	0	13462
12624	63	12882	12	65	0	13022
12625	61	112	26	12408	0	12607
12626	12332	45	23	119	0	12519
12627	12500	27	17	68	0	12612
12628	154	25	10	12331	0	12520
12629	73	24	15	12054	0	12166
12630	53	16	11	12058	0	12138
12631	11922	5	13	159	0	12099
12632	130	12	11939	65	0	12146
12633	54	11939	98	68	0	12159
12634	11879	80	32	70	0	12061
12635	120	53	35	11948	0	12156
12636	68	18	11950	109	0	12145
12637	73	18	11805	48	0	11944
12638	49	11870	112	40	0	12071
12639	43	12055	48	47	0	12193
12640	83	137	59	11480	0	11759
12641	41	10473	27	95	0	10636
12642	39	82	26	11306	0	11453
12643	43	32	18	11473	0	11566
12644	11495	21	11	122	0	11649
12645	93	21	15	11427	0	11556
12646	35	26	16	11527	0	11604
12647	38	22	11395	114	0	11569
12648	53	13	75	11531	0	11672
12649	11670	27	24	128	0	11849
12650	11711	21	23	61	0	11816
12651	124	12067	16	56	0	12263
12652	11816	94	22	60	0	11992
12653	126	37	11896	46	0	12105
12654	56	11868	96	53	0	12073
12655	56	105	33	12136	0	12330
12656	47	52	16	12276	0	12391
12657	55	34	20	12365	0	12474
12658	12267	27	30	167	0	12491
12659	11572	33	38	81	0	11724
12660	146	26	12037	53	0	12262
12661	69	18	11870	69	0	12026
12662	43	22	12010	70	0	12145
12663	69	11960	127	54	0	12210
12664	64	12233	36	57	0	12390
12665	12140	126	37	77	0	12380
12666	12202	43	42	63	0	12350
12667	156	27	31	12380	0	12594
12668	71	31	31	12229	0	12362
12669	44	12387	42	159	0	12632
12670	49	121	37	12597	0	12804
12671	55	49	12577	150	0	12831
12672	38	12583	129	71	0	12821
12673	39	122	46	12697	0	12904
12674	51	56	12889	136	0	13132
12675	68	36	108	12105	0	12317
12676	46	12759	47	135	0	12987
12677	13050	138	27	84	0	13299
12678	13110	45	24	97	0	13276
12679	13549	32	36	75	0	13692
12680	175	38	27	13614	0	13854
12681	82	48	16	14007	0	14153
12682	13935	32	30	212	0	14209
12683	182	13961	22	80	0	14245
12684	14113	151	23	69	0	14356
12685	183	55	14722	51	0	15011
12686	14737	35	160	66	0	14998
12687	15241	18	62	72	0	15393
12688	284	30	23	15209	0	15546
12689	15435	23	23	262	0	15743
12690	15884	29	31	113	0	16057
12691	298	32	20	15860	0	16210
12692	119	24	15710	216	0	16069
12693	15325	29	191	109	0	15654
12694	235	28	15730	48	0	16041
12695	107	15870	195	57	0	16229
12696	98	174	129	15839	0	16240
12697	72	69	27	16354	0	16522
12698	17166	22	13	268	0	17469
12699	239	24	17292	104	0	17659
12700	112	18	227	16498	0	16855
12701	62	17031	81	226	0	17400
12702	29	17041	39	88	0	17197
12703	64	267	25	17206	0	17562
12704	53	77	16938	261	0	17329
12705	55	33	229	17101	0	17418
12706	57	31	84	17059	0	17231
12707	39	37	16617	303	0	16996
12708	33	16982	214	122	0	17351
12709	16569	253	95	81	0	16998
12710	233	17061	37	65	0	17396
12711	100	237	24	16931	0	17292
12712	16423	80	38	275	0	16816
12713	225	16495	38	120	0	16878
12714	82	244	16432	69	0	16827
12715	16250	104	240	60	0	16654
12716	249	16753	84	53	0	17139
12717	16737	249	45	73	0	17104
12718	280	97	16259	58	0	16694
12719	16268	49	225	76	0	16618
12720	299	42	93	16375	0	16809
12721	122	56	16297	260	0	16735
12722	90	36	254	15936	0	16316
12723	67	15975	96	270	0	16408
12724	84	258	42	16324	0	16708
12725	75	88	47	16467	0	16677
12726	65	64	16035	335	0	16499
12727	89	44	231	16169	0	16533
12728	77	72	13756	315	0	14220
12729	63	16167	201	144	0	16575
12730	83	267	80	16189	0	16619
12731	69	113	16310	289	0	16781
12732	58	16192	265	135	0	16650
12733	67	16740	110	96	0	17013
12734	67	341	16589	73	0	17070
12735	66	111	16545	85	0	16807
12736	70	64	338	16322	0	16794
12737	16193	61	125	306	0	16685
12738	299	16182	68	153	0	16702
12739	140	283	62	15949	0	16434
12740	15936	123	60	294	0	16413
12741	306	16077	50	158	0	16591
12742	15985	266	76	111	0	16438
12743	324	16292	47	91	0	16754
12744	16299	286	55	110	0	16750
12745	16321	126	62	106	0	16615
12746	16539	80	53	102	0	16774
12747	412	16956	53	86	0	17507
12748	218	324	72	17054	0	17668
12749	146	114	16805	341	0	17406
12750	133	16748	309	174	0	17364
12751	149	336	110	16315	0	16910
12752	150	150	98	16435	0	16833
12753	116	79	15912	370	0	16477
12754	111	15649	292	167	0	16219
12755	15361	285	137	125	0	15908
12756	334	15375	75	113	0	15897
12757	160	303	74	15263	0	15800
12758	131	138	15218	314	0	15801
12759	14987	84	288	180	0	15539
12760	325	91	119	15339	0	15874
12761	122	87	15134	334	0	15677
12762	14525	81	290	163	0	15059
12763	292	14883	133	129	0	15437
12764	14904	316	86	121	0	15427
12765	15049	136	70	152	0	15407
12766	373	89	75	14897	0	15434
12767	149	88	14834	327	0	15398
12768	98	14744	301	155	0	15298
12769	84	307	14667	115	0	15173
12770	75	178	289	14439	0	14981
12771	84	131	127	14795	0	15137
12772	14476	92	103	363	0	15034
12773	303	76	14364	194	0	14937
12774	130	14111	294	132	0	14667
12775	117	290	122	14011	0	14540
12776	102	130	84	14118	0	14434
12777	13700	93	75	328	0	14196
12778	294	13779	51	164	0	14288
12779	166	268	43	13258	0	13735
12780	12896	113	58	303	0	13370
12781	246	12730	50	146	0	13172
12782	12199	252	53	86	0	12590
12783	12149	95	58	80	0	12382
12784	294	11806	51	82	0	12233
12785	10553	188	32	59	0	10832
12786	213	10529	37	56	0	10835
12787	10274	183	42	49	0	10548
12788	10254	65	47	54	0	10420
12789	208	10133	25	56	0	10422
12790	9573	160	30	57	0	9820
12791	9864	49	36	46	0	9995
12792	9831	56	26	50	0	9963
12793	205	36	9665	45	0	9951
12794	84	29	9207	31	0	9351
12795	66	34	9224	33	0	9357
12796	8962	71	222	36	0	9291
12797	155	39	8804	23	0	9021
12798	63	27	7946	9	0	8045
12799	75	60	120	7341	0	7596
12800	7387	14	56	89	0	7546
12801	106	10	7455	36	0	7607
12802	47	11	7750	26	0	7834
12803	54	26	109	7691	0	7880
12804	42	13	52	7828	0	7935
12805	27	11	38	7905	0	7981
12806	31	12	7782	130	0	7955
12807	33	20	87	7749	0	7889
12808	7718	11	44	133	0	7906
12809	103	7784	35	53	0	7975
12810	54	90	30	7784	0	7958
12811	45	37	15	7921	0	8018
12812	33	24	7975	127	0	8159
12813	17	7850	97	66	0	8030
12814	7831	93	34	61	0	8019
12815	106	7907	31	36	0	8080
12816	56	106	28	7874	0	8064
12817	49	40	7881	105	0	8075
12818	41	29	102	8140	0	8312
12819	45	25	39	8318	0	8427
12820	8453	15	33	161	0	8662
12821	133	24	30	8216	0	8403
12822	61	8266	17	141	0	8485
12823	46	8788	22	56	0	8912
12824	41	131	8891	42	0	9105
12825	8929	48	123	43	0	9143
12826	140	34	57	9061	0	9292
12827	73	23	52	9162	0	9310
12828	54	22	30	9249	0	9355
12829	9198	9	23	205	0	9435
12830	135	9246	28	98	0	9507
12831	9166	124	29	68	0	9387
12832	162	47	8898	36	0	9143
12833	70	38	8747	39	0	8894
12834	8993	28	168	47	0	9236
12835	159	21	99	9034	0	9313
12836	52	13	59	9212	0	9336
12837	66	19	33	9222	0	9340
12838	42	25	9170	184	0	9421
12839	9109	22	128	102	0	9361
12840	9307	19	58	70	0	9454
12841	9154	17	58	51	0	9280
12842	194	39	32	9001	0	9266
12843	95	18	8848	151	0	9112
12844	64	18	8632	74	0	8788
12845	39	20	8975	75	0	9109
12846	38	8829	168	56	0	9091
12847	95	123	142	8102	0	8462
12848	8073	37	37	117	0	8264
12849	98	22	8179	59	0	8358
12850	8229	15	91	73	0	8408
12851	125	11	52	8343	0	8531
12852	62	16	40	8316	0	8434
12853	36	8164	28	142	0	8370
12854	44	8244	24	75	0	8387
12855	26	8577	30	58	0	8691
12856	43	114	31	8571	0	8759
12857	8502	51	33	118	0	8704
12858	8506	30	27	70	0	8633
12859	125	20	8357	64	0	8566
12860	8261	17	93	62	0	8433
12861	121	16	8417	52	0	8606
12862	61	18	115	8422	0	8616
12863	57	20	8410	104	0	8591
12864	8402	18	105	72	0	8597
12865	118	26	49	8615	0	8808
12866	60	18	8866	111	0	9055
12867	50	19	8470	57	0	8596
12868	8556	18	124	56	0	8754
12869	8767	16	61	62	0	8906
12870	121	8913	54	42	0	9130
12871	73	82	35	9064	0	9254
12872	57	30	9030	106	0	9223
12873	48	32	8957	58	0	9095
12874	44	27	114	9048	0	9233
12875	9091	19	84	106	0	9300
12876	91	9054	51	54	0	9250
12877	63	77	31	9218	0	9389
12878	9219	43	26	111	0	9399
12879	95	33	26	9257	0	9411
12880	55	9270	34	117	0	9476
12881	48	77	30	9424	0	9579
12882	9387	35	27	106	0	9555
12883	109	34	33	9416	0	9592
12884	9473	19	29	124	0	9645
12885	113	9533	26	67	0	9739
12886	9541	77	38	61	0	9717
12887	110	37	9396	43	0	9586
12888	9161	26	98	51	0	9336
12889	9494	20	51	47	0	9612
12890	119	9519	46	39	0	9723
12891	82	105	33	9262	0	9482
12892	53	38	9297	88	0	9476
12893	51	31	8976	43	0	9101
12894	8673	55	113	70	0	8911
12895	8599	24	53	37	0	8713
12896	93	8653	36	39	0	8821
12897	58	8727	17	25	0	8827
12898	8660	78	19	41	0	8798
12899	78	8588	24	29	0	8719
12900	40	8831	30	23	0	8924
12901	52	66	25	8754	0	8897
12902	44	34	15	8544	0	8637
12903	32	31	8589	87	0	8739
12904	29	9	59	8523	0	8620
12905	8502	12	34	88	0	8636
12906	74	17	8515	36	0	8642
12907	50	21	8389	30	0	8490
12908	58	15	69	8340	0	8482
12909	51	13	41	8583	0	8688
12910	34	18	32	8558	0	8642
12911	32	10	8494	85	0	8621
12912	37	17	65	8206	0	8325
12913	31	20	35	8475	0	8561
12914	8400	12	18	80	0	8510
12915	63	8283	18	45	0	8409
12916	8289	46	19	44	0	8398
12917	74	22	8310	18	0	8424
12918	7517	20	43	23	0	7603
12919	51	8058	25	28	0	8162
12920	7733	26	15	21	0	7795
12921	38	7713	9	18	0	7778
12922	7413	39	19	24	0	7495
12923	27	7192	6	6	0	7231
12924	22	7121	7	3	0	7153
12925	30	55	35	7066	0	7186
12926	7126	8	15	23	0	7172
12927	7067	5	3	20	0	7095
12928	7138	3	0	21	0	7162
12929	23	6	7089	8	0	7126
12930	12	3	6950	4	0	6969
12931	9	9	18	7181	0	7217
12932	6	7196	17	15	0	7234
12933	6	7361	5	10	0	7382
12934	9	20	4	7138	0	7171
12935	7120	10	4	25	0	7159
12936	7117	3	1	23	0	7144
12937	7190	3	6	17	0	7216
12938	25	4	7143	6	0	7178
12939	19	4	16	7247	0	7286
12940	10	2	7358	22	0	7392
12941	7377	3	23	18	0	7421
12942	7497	2	10	18	0	7527
12943	38	8	7517	4	0	7567
12944	19	3	24	7523	0	7569
12945	7542	4	10	38	0	7594
12946	33	3	7	7654	0	7697
12947	23	5	4	7696	0	7728
12948	24	2	7	7705	0	7738
12949	8324	4	4	63	0	8395
12950	65	5	5	8750	0	8825
12951	9125	1	8	75	0	9209
12952	80	9766	5	27	0	9878
12953	42	88	2	10212	0	10344
12954	28	33	3	10290	0	10354
12955	29	15	2	10209	0	10255
12956	10080	3	5	154	0	10242
12957	107	2	5	10078	0	10192
12958	46	3	5	10139	0	10193
12959	10157	3	5	151	0	10316
12960	10265	6	7	58	0	10336
12961	10173	5	3	46	0	10227
12962	153	3	9975	17	0	10148
12963	59	7	9532	26	0	9624
12964	10077	3	117	26	0	10223
12965	131	5	43	9931	0	10110
12966	43	8	20	9735	0	9806
12967	9912	2	4	150	0	10068
12968	9720	3	5	69	0	9797
12969	9780	5	7	45	0	9837
12970	141	9537	7	22	0	9707
12971	9566	96	12	26	0	9700
12972	9485	27	8	23	0	9543
12973	139	9402	8	19	0	9568
12974	57	9555	7	24	0	9643
12975	65	107	7	9610	0	9789
12976	9763	33	7	104	0	9907
12977	9755	16	5	45	0	9821
12978	9727	8	2	36	0	9773
12979	162	9	5	9551	0	9727
12980	9549	7	2	122	0	9680
12981	140	9	9456	47	0	9652
12982	9339	10	98	48	0	9495
12983	144	7	9443	17	0	9611
12984	58	9	9264	16	0	9347
12985	54	9	116	9242	0	9421
12986	9351	6	42	118	0	9517
12987	129	5	21	9305	0	9460
12988	50	5	9380	133	0	9568
12989	44	3	9351	51	0	9449
12990	39	4	122	9345	0	9510
12991	9319	7	42	131	0	9499
12992	116	9448	29	38	0	9631
12993	62	96	14	9604	0	9776
12994	53	26	12	9782	0	9873
12995	39	21	9779	130	0	9969
12996	33	12	9575	62	0	9682
12997	36	14	129	9743	0	9922
12998	9746	12	50	146	0	9954
12999	124	9	9682	60	0	9875
13000	84	9	100	9604	0	9797
13001	59	12	29	9678	0	9778
13002	50	6	24	9767	0	9847
13003	9527	12	16	181	0	9736
13004	136	14	8893	81	0	9124
13005	69	9543	82	57	0	9751
13006	60	107	29	9693	0	9889
13007	45	32	9690	139	0	9906
13008	44	9526	121	61	0	9752
13009	39	9800	42	59	0	9940
13010	9826	123	31	59	0	10039
13011	138	9903	23	48	0	10112
13012	10052	120	25	59	0	10256
13013	173	36	10005	41	0	10255
13014	84	33	126	10145	0	10388
13015	10175	18	40	155	0	10388
13016	150	10372	39	76	0	10637
13017	71	119	10369	67	0	10626
13018	90	40	118	9744	0	9992
13019	62	10452	48	124	0	10686
13020	52	139	37	10782	0	11010
13021	10713	41	24	176	0	10954
13022	162	10948	32	68	0	11210
13023	11056	133	16	81	0	11286
13024	11213	44	23	65	0	11345
13025	206	38	11218	42	0	11504
13026	107	11613	150	50	0	11920
13027	92	156	50	12257	0	12555
13028	59	51	12844	186	0	13140
13029	72	39	13992	76	0	14179
13030	92	63	271	14603	0	15029
13031	15153	17	97	264	0	15531
13032	15278	24	61	89	0	15452
13033	359	24	43	15167	0	15593
13034	140	21	15304	290	0	15755
13035	96	15349	258	94	0	15797
13036	15647	251	83	83	0	16064
13037	15801	62	64	75	0	16002
13038	350	15697	43	83	0	16173
13039	15846	265	33	63	0	16207
13040	343	85	15523	32	0	15983
13041	15473	57	266	62	0	15858
13042	14898	50	86	68	0	15102
13043	307	32	15460	43	0	15842
13044	160	39	279	15294	0	15772
13045	105	32	15325	261	0	15723
13046	92	14864	280	94	0	15330
13047	57	15131	112	83	0	15383
13048	93	375	67	14563	0	15098
13049	47	81	14609	247	0	14984
13050	29	13831	233	77	0	14170
13051	33	13834	62	69	0	13998
13052	12621	281	114	97	0	13113
13053	12760	69	36	37	0	12902
13054	225	49	25	12755	0	13054
13055	84	33	21	12670	0	12808
13056	61	12859	24	199	0	13143
13057	12863	188	17	64	0	13132
13058	12958	51	22	68	0	13099
13059	218	12928	21	40	0	13207
13060	95	190	15	13015	0	13315
13061	63	61	13022	183	0	13329
13062	58	40	168	13044	0	13310
13063	13098	36	49	221	0	13404
13064	218	28	36	13199	0	13481
13065	84	25	30	13473	0	13612
13066	13438	31	16	257	0	13742
13067	222	14	26	13257	0	13519
13068	72	13286	22	216	0	13596
13069	67	170	18	13558	0	13813
13070	61	55	13	13712	0	13841
13071	46	43	15	13489	0	13593
13072	45	13463	11	258	0	13777
13073	51	192	18	13393	0	13654
13074	31	64	13251	243	0	13589
13075	41	48	191	13242	0	13522
13076	31	36	13175	242	0	13484
13077	42	13095	193	107	0	13437
13078	56	190	70	13300	0	13616
13079	52	56	46	13486	0	13640
13080	56	47	41	13501	0	13645
13081	55	37	48	13439	0	13579
13082	38	48	13196	289	0	13571
13083	43	13119	196	122	0	13480
13084	55	199	55	13360	0	13669
13085	47	82	13431	249	0	13809
13086	60	49	208	13526	0	13843
13087	13585	44	80	274	0	13983
13088	226	39	13131	108	0	13504
13089	13213	37	188	97	0	13535
13090	270	36	84	13532	0	13922
13091	109	37	13545	254	0	13945
13092	77	13379	230	90	0	13776
13093	86	208	78	13344	0	13716
13094	82	78	13615	253	0	14028
13095	54	13544	238	129	0	13965
13096	68	223	93	13627	0	14011
13097	13578	94	70	278	0	14020
13098	13844	68	60	116	0	14088
13099	13965	59	48	101	0	14173
13100	300	44	13814	92	0	14250
13101	135	13952	220	77	0	14384
13102	114	227	82	13998	0	14421
13103	89	83	60	14685	0	14917
13104	14774	64	46	316	0	15200
13105	276	14978	42	125	0	15421
13106	15107	270	41	119	0	15537
13107	15064	104	44	111	0	15323
13108	15409	77	42	107	0	15635
13109	344	70	15266	79	0	15759
13110	15311	57	250	101	0	15719
13111	369	40	79	15263	0	15751
13112	163	51	43	15384	0	15641
13113	15083	35	53	354	0	15525
13114	318	34	38	14881	0	15271
13115	124	14810	43	334	0	15311
13116	101	261	28	14709	0	15099
13117	14394	74	18	367	0	14853
13118	284	50	14249	163	0	14746
13119	110	14165	234	123	0	14632
13120	91	249	71	14053	0	14464
13121	13979	88	55	312	0	14434
13122	290	57	13769	129	0	14245
13123	145	217	263	13479	0	14104
13124	142	53	13456	297	0	13948
13125	124	54	13003	151	0	13332
13126	109	42	12704	114	0	12969
13127	73	38	12371	105	0	12587
13128	99	42	11699	74	0	11914
13129	9770	202	416	85	0	10473
13130	125	9818	85	36	0	10064
13131	9325	94	52	37	0	9508
13132	9320	27	29	44	0	9420
13133	134	9265	32	22	0	9453
13134	44	9389	34	23	0	9490
13135	9365	107	31	34	0	9537
13136	9326	44	23	40	0	9433
13137	141	31	22	9113	0	9307
13138	65	9170	21	105	0	9361
13139	9241	98	19	54	0	9412
13140	108	9186	17	29	0	9340
13141	62	90	11	9255	0	9418
13142	9277	39	15	111	0	9442
13143	9297	20	31	44	0	9392
13144	130	30	14	9226	0	9400
13145	65	12	16	9269	0	9362
13146	37	22	9217	117	0	9393
13147	38	20	90	9139	0	9287
13148	35	21	9199	111	0	9366
13149	30	26	105	8923	0	9084
13150	37	13	38	9123	0	9211
13151	9121	14	27	124	0	9286
13152	9133	10	35	60	0	9238
13153	123	12	9026	40	0	9201
13154	8924	13	93	37	0	9067
13155	120	13	44	9015	0	9192
13156	63	11	9166	102	0	9342
13157	47	15	103	9167	0	9332
13158	41	18	32	9703	0	9794
13159	31	18	9717	137	0	9903
13160	55	8	102	9882	0	10047
13161	34	19	10137	129	0	10319
13162	38	20	118	10406	0	10582
13163	11010	20	40	144	0	11214
13164	134	11132	31	74	0	11371
13165	11334	132	29	53	0	11548
13166	161	11546	19	58	0	11784
13167	11395	149	25	37	0	11606
13168	150	11419	26	40	0	11635
13169	11316	143	17	50	0	11526
13170	168	11430	31	28	0	11657
13171	90	152	20	11444	0	11706
13172	57	70	11428	143	0	11698
13173	52	46	11282	61	0	11441
13174	55	41	161	11382	0	11639
13175	11398	32	75	159	0	11664
13176	163	11604	33	78	0	11878
13177	100	141	30	11614	0	11885
13178	50	70	11644	161	0	11925
13179	56	44	11712	77	0	11889
13180	51	77	184	11295	0	11607
13181	37	11828	94	139	0	12098
13182	11760	144	60	96	0	12060
13183	159	66	12067	58	0	12350
13184	79	47	11823	41	0	11990
13185	43	12026	183	45	0	12297
13186	11902	153	133	75	0	12263
13187	11974	72	66	41	0	12153
13188	205	36	53	11907	0	12201
13189	12015	39	36	160	0	12250
13190	11811	34	39	77	0	11961
13191	195	11871	30	52	0	12148
13192	11883	134	44	42	0	12103
13193	165	76	12088	34	0	12363
13194	123	38	135	11825	0	12121
13195	77	45	69	11867	0	12058
13196	11810	26	32	190	0	12058
13197	151	11759	37	87	0	12034
13198	11689	126	42	61	0	11918
13199	156	11896	37	43	0	12132
13200	102	11854	23	34	0	12013
13201	95	171	11584	36	0	11886
13202	70	113	11252	39	0	11474
13203	10643	89	189	60	0	10981
13204	10856	36	86	43	0	11021
13205	148	38	10634	22	0	10842
13206	83	10189	88	23	0	10383
13207	56	10417	64	15	0	10552
13208	10271	126	51	38	0	10486
13209	10249	61	29	29	0	10368
13210	132	40	30	10362	0	10564
13211	10560	32	26	90	0	10708
13212	122	24	31	10527	0	10704
13213	76	28	10569	82	0	10755
13214	59	31	10065	57	0	10212
13215	10377	25	115	41	0	10558
13216	113	27	71	10426	0	10637
13217	76	10999	35	75	0	11185
13218	11179	81	29	68	0	11357
13219	11178	50	30	41	0	11299
13220	135	31	11205	32	0	11403
13221	11249	31	84	45	0	11409
13222	11595	18	51	34	0	11698
13223	179	25	25	11524	0	11753
13224	85	11470	29	98	0	11682
13225	68	11299	26	54	0	11447
13226	57	129	21	11947	0	12154
13227	68	68	27	11631	0	11794
13228	49	45	31	11945	0	12070
13229	73	26	11814	151	0	12064
13230	57	40	11363	85	0	11545
13231	47	38	142	11480	0	11707
13232	47	32	11625	115	0	11819
13233	46	32	11397	72	0	11547
13234	42	31	151	11381	0	11605
13235	51	18	12032	125	0	12226
13236	40	11991	139	81	0	12251
13237	12422	105	82	89	0	12698
13238	121	66	62	12375	0	12624
13239	69	12470	47	126	0	12712
13240	45	115	12745	73	0	12978
13241	49	66	132	12774	0	13021
13242	42	34	13232	137	0	13445
13243	55	29	153	13190	0	13427
13244	41	29	95	13599	0	13764
13245	53	29	13951	190	0	14223
13246	50	25	155	13805	0	14035
13247	33	13631	101	153	0	13918
13248	54	126	48	14351	0	14579
13249	45	69	14310	167	0	14591
13250	41	55	137	14211	0	14444
13251	14104	30	80	185	0	14399
13252	147	14223	47	121	0	14538
13253	90	143	40	14348	0	14621
13254	52	68	14509	165	0	14794
13255	40	14068	141	113	0	14362
13256	37	14301	95	63	0	14496
13257	41	182	14118	70	0	14411
13258	56	113	137	13613	0	13919
13259	51	95	86	13361	0	13593
13260	30	36	13453	185	0	13704
13261	24	12729	132	102	0	12987
13262	29	12958	70	50	0	13107
13263	12192	116	48	35	0	12391
13264	79	12288	19	38	0	12424
13265	12119	93	18	37	0	12267
13266	89	42	19	11813	0	11963
13267	12402	31	9	121	0	12563
13268	90	23	12388	47	0	12548
13269	12280	13	86	47	0	12426
13270	107	19	47	12568	0	12741
13271	45	12725	37	100	0	12907
13272	12856	86	22	66	0	13030
13273	102	88	28	12900	0	13118
13274	50	12945	25	99	0	13119
13275	29	13575	20	53	0	13677
13276	13439	116	29	51	0	13635
13277	13488	47	11	34	0	13580
13278	13595	25	7	41	0	13668
13279	129	19	13	13245	0	13406
13280	49	12986	16	99	0	13150
13281	27	13266	16	44	0	13353
13282	26	97	18	13281	0	13422
13283	13085	49	14	107	0	13255
13284	12390	32	7	92	0	12521
13285	12968	17	12	66	0	13063
13286	134	20	12546	20	0	12720
13287	62	34	12698	24	0	12818
13288	13368	23	94	34	0	13519
13289	110	17	50	13336	0	13513
13290	57	20	25	13483	0	13585
13291	59	14	17	13277	0	13367
13292	42	25	10	13391	0	13468
13293	20	30	13145	139	0	13334
13294	28	14	95	13070	0	13207
13295	20	19	13064	121	0	13224
13296	12321	22	105	81	0	12529
13297	96	13121	53	56	0	13326
13298	60	88	36	13405	0	13589
13299	36	42	20	13195	0	13293
13300	13064	37	29	142	0	13272
13301	12999	27	19	90	0	13135
13302	13051	32	13	55	0	13151
13303	13000	30	7	57	0	13094
13304	149	29	13004	28	0	13210
13305	89	26	12763	29	0	12907
13306	64	21	121	12908	0	13114
13307	13041	19	59	122	0	13241
13308	12875	21	47	83	0	13026
13309	131	26	12792	56	0	13005
13310	76	17	92	12617	0	12802
13311	12579	25	47	146	0	12797
13312	114	30	26	12613	0	12783
13313	72	26	12822	128	0	13048
13314	66	21	98	12716	0	12901
13315	12824	33	58	131	0	13046
13316	105	13487	39	63	0	13694
13317	13358	102	22	87	0	13569
13318	13408	50	22	81	0	13561
13319	13508	27	27	83	0	13645
13320	153	25	13	13417	0	13608
13321	13241	32	19	122	0	13414
13322	126	13567	22	62	0	13777
13323	75	13910	17	56	0	14058
13324	70	173	24	13680	0	13947
13325	13945	79	20	132	0	14176
13326	123	14718	15	78	0	14934
13327	16788	125	13	83	0	17009
13328	18100	80	13	70	0	18263
13329	318	18826	17	32	0	19193
13330	177	227	11	18999	0	19414
13331	137	127	10	19320	0	19594
13332	98	62	19270	314	0	19744
13333	126	55	218	19065	0	19464
13334	88	51	19153	311	0	19603
13335	65	18557	245	185	0	19052
13336	91	253	134	18718	0	19196
13337	18127	121	73	338	0	18659
13338	18384	55	73	211	0	18723
13339	346	45	64	18326	0	18781
13340	171	44	17940	308	0	18463
13341	17137	57	249	206	0	17649
13342	260	17247	131	145	0	17783
13343	169	17062	71	124	0	17426
13344	137	17360	46	105	0	17648
13345	173	372	80	16639	0	17264
13346	88	158	16866	240	0	17352
13347	93	100	221	16731	0	17145
13348	73	89	16823	246	0	17231
13349	62	86	16561	147	0	16856
13350	48	91	16908	91	0	17138
13351	78	71	333	16335	0	16817
13352	54	50	189	16959	0	17252
13353	54	36	130	17013	0	17233
13354	53	31	107	16762	0	16953
13355	16671	36	106	392	0	17205
13356	196	16630	116	212	0	17154
13357	16626	195	91	184	0	17096
13358	222	16924	67	159	0	17372
13359	141	234	48	17008	0	17431
13360	100	125	31	17403	0	17659
13361	17218	67	41	386	0	17712
13362	17316	72	30	227	0	17645
13363	17441	69	28	148	0	17686
13364	17275	71	21	134	0	17501
13365	17200	58	17	136	0	17411
13366	390	16929	18	114	0	17451
13367	16308	210	13	128	0	16659
13368	354	16345	16	66	0	16781
13369	16180	246	15	70	0	16511
13370	366	122	16085	38	0	16611
13371	248	106	174	15721	0	16249
13372	162	16202	93	195	0	16652
13373	145	233	64	16117	0	16559
13374	135	165	15925	223	0	16448
13375	144	111	205	15477	0	15937
13376	15184	78	133	297	0	15692
13377	243	15343	94	192	0	15872
13378	155	15636	70	167	0	16028
13379	106	315	15701	146	0	16268
13380	102	208	227	15404	0	15941
13381	66	15918	156	301	0	16441
13382	84	247	106	16197	0	16634
13383	75	174	16121	291	0	16661
13384	64	15887	236	231	0	16418
13385	70	288	15971	127	0	16456
13386	80	182	15693	131	0	16086
13387	102	127	314	15598	0	16141
13388	15681	104	177	315	0	16277
13389	258	88	130	15846	0	16322
13390	147	108	15922	300	0	16477
13391	106	99	306	16246	0	16757
13392	79	112	16888	302	0	17381
13393	80	95	16731	219	0	17125
13394	16731	75	399	200	0	17405
13395	17552	64	213	203	0	18032
13396	17719	49	185	204	0	18157
13397	365	45	17522	166	0	18098
13398	185	34	17630	139	0	17988
13399	158	32	443	17264	0	17897
13400	153	31	253	17582	0	18019
13401	17554	51	159	412	0	18176
13402	336	44	114	17782	0	18276
13403	211	45	17815	383	0	18454
13404	144	45	17521	260	0	17970
13405	117	17761	378	200	0	18456
13406	143	243	187	18156	0	18729
13407	151	139	18317	342	0	18949
13408	139	96	304	18233	0	18772
13409	18231	82	204	401	0	18918
13410	302	74	18552	255	0	19183
13411	197	66	339	18495	0	19097
13412	193	55	193	18774	0	19215
13413	164	66	18297	420	0	18947
13414	186	57	314	18127	0	18684
13415	151	61	18094	380	0	18686
13416	17155	54	348	269	0	17826
13417	324	62	207	17112	0	17705
13418	184	17139	141	359	0	17823
13419	17108	254	127	274	0	17763
13420	17156	137	136	203	0	17632
13421	403	17041	128	167	0	17739
13422	428	1313	149	14804	0	16694
13423	135	16006	96	283	0	16520
13424	147	16147	72	206	0	16572
13425	400	443	15036	166	0	16045
13426	150	14781	267	142	0	15340
13427	148	308	12324	129	0	12909
13428	10483	185	154	73	0	10895
13429	10510	27	42	45	0	10624
13430	97	10532	33	26	0	10688
13431	42	10506	31	22	0	10601
13432	18	10751	21	25	0	10815
13433	10908	90	33	33	0	11064
13434	116	33	13	11110	0	11272
13435	34	23	11659	101	0	11817
13436	21	11697	116	45	0	11879
13437	31	115	46	11956	0	12148
13438	34	37	21	11854	0	11946
13439	17	13152	22	136	0	13327
13440	14275	145	24	76	0	14520
13441	193	46	14753	40	0	15032
13442	97	23	197	17662	0	17979
13443	21	19947	58	285	0	20311
13444	20043	348	23	96	0	20510
13445	380	102	19982	45	0	20509
13446	106	19695	352	43	0	20196
13447	97	367	91	19738	0	20293
13448	44	119	19766	350	0	20279
13449	19391	63	382	132	0	19968
13450	400	50	106	19515	0	20071
13451	110	41	19556	381	0	20088
13452	66	19525	397	123	0	20111
13453	19273	374	96	108	0	19851
13454	361	19634	77	62	0	20134
13455	19607	412	54	68	0	20141
13456	19891	140	36	70	0	20137
13457	511	100	38	19367	0	20016
13458	170	18971	47	361	0	19549
13459	120	341	19183	113	0	19757
13460	123	112	368	19122	0	19725
13461	186	120	157	16725	0	17188
13462	100	51	87	19356	0	19594
13463	93	47	55	19380	0	19575
13464	96	41	46	19444	0	19627
13465	19039	51	56	561	0	19707
13466	18669	51	49	240	0	19009
13467	18645	43	56	163	0	18907
13468	468	18593	47	115	0	19223
13469	204	372	18908	79	0	19563
13470	147	105	18904	74	0	19230
13471	99	84	19230	78	0	19491
13472	111	99	508	18597	0	19315
13473	110	46	196	19063	0	19415
13474	91	56	121	19065	0	19333
13475	64	56	18712	554	0	19386
13476	56	18465	416	252	0	19189
13477	66	378	18544	160	0	19148
13478	84	133	18850	119	0	19186
13479	121	87	487	18502	0	19197
13480	81	97	18852	445	0	19475
13481	141	76	474	18480	0	19171
13482	18363	78	186	509	0	19136
13483	18491	78	140	220	0	18929
13484	506	82	18289	157	0	19034
13485	233	65	455	18214	0	18967
13486	159	67	18406	483	0	19115
13487	111	18488	461	216	0	19276
13488	18526	424	188	169	0	19307
13489	467	168	18494	140	0	19269
13490	197	17775	470	122	0	18564
13491	145	17805	197	126	0	18273
13492	124	17675	166	141	0	18106
13493	127	532	16945	113	0	17717
13494	187	323	418	16010	0	16938
13495	137	16543	189	437	0	17306
13496	164	475	161	16433	0	17233
13497	185	208	145	16717	0	17255
13498	16112	157	152	590	0	17011
13499	421	16180	158	306	0	17065
13500	16013	426	152	244	0	16835
13501	477	15719	152	228	0	16576
13502	229	16191	144	184	0	16748
13503	207	522	15774	179	0	16682
13504	197	306	459	15501	0	16463
13505	165	229	15571	465	0	16430
13506	164	15347	472	233	0	16216
13507	182	436	15357	206	0	16181
13508	170	200	15411	202	0	15983
13509	163	15469	493	212	0	16337
13510	15050	460	233	217	0	15960
13511	435	15345	207	245	0	16232
13512	15339	472	215	232	0	16258
13513	459	241	15331	256	0	16287
13514	215	137	15403	283	0	16038
13515	152	15243	546	260	0	16201
13516	15206	425	234	263	0	16128
13517	481	15247	220	224	0	16172
13518	252	453	193	15297	0	16195
13519	15445	212	182	450	0	16289
13520	505	192	15359	206	0	16262
13521	226	180	525	15342	0	16273
13522	15239	134	299	497	0	16169
13523	456	15247	259	260	0	16222
13524	222	433	195	15370	0	16220
13525	176	189	15255	550	0	16170
13526	15001	156	506	310	0	15973
13527	429	134	271	15296	0	16130
13528	145	154	15192	525	0	16016
13529	140	148	510	14701	0	15499
13530	125	14965	256	530	0	15876
13531	112	408	15001	290	0	15811
13532	183	189	464	14640	0	15476
13533	14284	125	227	512	0	15148
13534	515	111	219	14136	0	14981
13535	13424	117	165	471	0	14177
13536	459	13352	176	207	0	14194
13537	13137	407	229	167	0	13940
13538	430	200	12895	178	0	13703
13539	231	164	11738	145	0	12278
13540	177	134	10475	101	0	10887
13541	181	9784	554	155	0	10674
13542	375	134	650	4702	0	5861
13543	28	33	65	4550	0	4676
13544	15	8	12	4392	0	4427
13545	11	4	8	4530	0	4553
13546	6	10	4554	49	0	4619
13547	4275	4	30	35	0	4344
13548	35	4582	19	10	0	4646
13549	4556	31	10	12	0	4609
13550	40	20	5	4558	0	4623
13551	14	4627	9	29	0	4679
13552	16	35	6	4675	0	4732
13553	4644	14	7	33	0	4698
13554	26	4800	2	20	0	4848
13555	4813	24	6	19	0	4862
13556	4749	11	9	8	0	4777
13557	38	11	3	4817	0	4869
13558	18	6	4795	29	0	4848
13559	4677	11	37	15	0	4740
13560	33	4	14	4886	0	4937
13561	4916	7	8	39	0	4970
13562	5060	4	7	15	0	5086
13563	5039	4	6	18	0	5067
13564	47	5	5047	7	0	5106
13565	20	8	29	4997	0	5054
13566	5064	5	10	33	0	5112
13567	41	5	5221	15	0	5282
13568	21	5240	35	7	0	5303
13569	25	48	16	4809	0	4898
13570	7	8	5158	33	0	5206
13571	8	5	5037	18	0	5068
13572	22	15	34	4953	0	5024
13573	13	7	15	5158	0	5193
13574	12	4	5	5191	0	5212
13575	5	0	8	5095	0	5108
13576	5	2	5103	34	0	5144
13577	5	5100	28	21	0	5154
13578	6	25	7	5121	0	5159
13579	5157	6	6	36	0	5205
13580	5022	2	4	15	0	5043
13581	5061	5	5	9	0	5080
13582	34	4	5	5041	0	5084
13583	16	10	3	5009	0	5038
13584	8	4749	3	28	0	4788
13585	4	4838	5	14	0	4861
13586	23	41	7	4746	0	4817
13587	4692	15	6	43	0	4756
13588	4674	1	4	13	0	4692
13589	4634	1	3	8	0	4646
13590	4662	2	2	9	0	4675
13591	4664	5	2	8	0	4679
13592	29	4685	1	7	0	4722
13593	6	19	1	4792	0	4818
13594	4932	4	2	25	0	4963
13595	4954	1	0	14	0	4969
13596	29	1	1	4960	0	4991
13597	11	2	1	5009	0	5023
13598	3	6	5085	29	0	5123
13599	16	0	20	4939	0	4975
13600	6	1	4	5022	0	5033
13601	5	2	5205	26	0	5238
13602	8	5	19	5170	0	5202
13603	5	5320	7	22	0	5354
13604	4	24	5340	5	0	5373
13605	7	5365	20	5	0	5397
13606	12	21	7	5282	0	5322
13607	8	6	1	5366	0	5381
13608	3	5274	2	24	0	5303
13609	6	5306	4	4	0	5320
13610	5394	25	1	19	0	5439
13611	5339	4	2	17	0	5362
13612	31	2	5353	3	0	5389
13613	5452	0	20	18	0	5490
13614	5714	1	5	12	0	5732
13615	5737	2	1	10	0	5750
13616	5717	0	3	11	0	5731
13617	28	4	5569	6	0	5607
13618	12	3	5264	3	0	5282
13619	5655	5	23	11	0	5694
13620	18	5903	5	6	0	5932
13621	6	16	5944	2	0	5968
13622	5920	7	19	11	0	5957
13623	6007	3	4	10	0	6024
13624	25	4	5971	2	0	6002
13625	6081	0	15	6	0	6102
13626	24	0	7	6578	0	6609
13627	13	6	6802	18	0	6839
13628	6414	1	23	23	0	6461
13629	20	6908	10	5	0	6943
13630	7143	20	7	13	0	7183
13631	7670	7	7	35	0	7719
13632	38	4	3	7726	0	7771
13633	18	3	2	7734	0	7757
13634	9	1	4	7861	0	7875
13635	7894	2	1	46	0	7943
13636	8132	3	2	28	0	8165
13637	44	2	4	8175	0	8225
13638	22	1	1	8104	0	8128
13639	6	4	7999	46	0	8055
13640	7765	1	32	25	0	7823
13641	39	1	10	8288	0	8338
13642	19	1	4	8277	0	8301
13643	10	8172	5	51	0	8238
13644	8	36	1	8279	0	8324
13645	10	10	2	8276	0	8298
13646	8175	5	4	57	0	8241
13647	44	8283	0	35	0	8362
13648	16	33	0	8408	0	8457
13649	20	10	1	8335	0	8366
13650	19	8	0	8417	0	8444
13651	6	5	8293	59	0	8363
13652	11	2	35	8190	0	8238
13653	8165	6	12	59	0	8242
13654	43	6	8145	20	0	8214
13655	26	0	36	8270	0	8332
13656	15	2	10	8421	0	8448
13657	8370	1	12	71	0	8454
13658	8198	5	9	45	0	8257
13659	57	4	8284	25	0	8370
13660	7923	5	38	23	0	7989
13661	53	10	8324	14	0	8401
13662	8277	3	44	33	0	8357
13663	56	8815	12	20	0	8903
13664	9035	51	12	21	0	9119
13665	72	9146	8	21	0	9247
13666	9429	63	15	28	0	9535
13667	70	9440	7	19	0	9536
13668	37	69	7	9640	0	9753
13669	20	19	8	9648	0	9695
13670	19	16	3	9610	0	9648
13671	13	9415	6	94	0	9528
13672	17	60	7	9481	0	9565
13673	13	9527	8	91	0	9639
13674	9	75	6	9669	0	9759
13675	9717	20	4	96	0	9837
13676	9631	14	5	48	0	9698
13677	86	9538	7	31	0	9662
13678	39	72	8	9719	0	9838
13679	9646	22	9	96	0	9773
13680	93	9732	5	32	0	9862
13681	37	9839	9	26	0	9911
13682	9872	92	4	36	0	10004
13683	9935	38	4	33	0	10010
13684	102	9882	8	18	0	10010
13685	9928	90	6	23	0	10047
13686	116	32	5	10018	0	10171
13687	40	33	10347	95	0	10515
13688	10378	26	73	50	0	10527
13689	10566	19	23	46	0	10654
13690	123	14	10688	29	0	10854
13691	10770	18	86	33	0	10907
13692	10963	15	23	50	0	11051
13693	11433	15	20	43	0	11511
13694	141	11373	19	39	0	11572
13695	11552	100	9	44	0	11705
13696	11673	33	16	49	0	11771
13697	160	28	8	11636	0	11832
13698	76	32	5	11777	0	11890
13699	63	19	11	11930	0	12023
13700	11915	18	6	178	0	12117
13701	124	25	5	11771	0	11925
13702	11881	23	7	150	0	12061
13703	11928	24	4	89	0	12045
13704	177	15	8	11835	0	12035
13705	76	17	13	12105	0	12211
13706	67	16	9	12204	0	12296
13707	12186	17	10	184	0	12397
13708	135	12137	9	91	0	12372
13709	87	108	9	12440	0	12644
13710	70	40	5	12663	0	12778
13711	12520	34	10	174	0	12738
13712	12511	31	7	108	0	12657
13713	181	26	12262	76	0	12545
13714	97	24	12206	58	0	12385
13715	13074	21	159	55	0	13309
13716	203	30	52	13346	0	13631
13717	109	27	23	14907	0	15066
13718	77	30	14908	312	0	15327
13719	87	44	223	14654	0	15008
13720	67	14618	60	287	0	15032
13721	68	15215	41	109	0	15433
13722	15012	268	31	79	0	15390
13723	280	88	14817	77	0	15262
13724	111	15257	191	64	0	15623
13725	92	261	55	15436	0	15844
13726	84	79	15198	282	0	15643
13727	89	49	255	14829	0	15222
13728	81	37	65	15078	0	15261
13729	70	40	14791	327	0	15228
13730	57	14737	262	128	0	15184
13731	88	244	67	14334	0	14733
13732	14369	69	55	305	0	14798
13733	14536	51	40	121	0	14748
13734	14516	42	30	110	0	14698
13735	337	14252	45	75	0	14709
13736	14239	241	29	71	0	14580
13737	327	82	24	14213	0	14646
13738	117	52	13940	286	0	14395
13739	13834	43	215	125	0	14217
13740	292	14143	78	91	0	14604
13741	132	236	44	13987	0	14399
13742	108	72	36	14070	0	14286
13743	81	13908	32	336	0	14357
13744	85	254	39	14228	0	14606
13745	75	81	31	14413	0	14600
13746	78	67	36	14613	0	14794
13747	14196	65	50	379	0	14690
13748	14254	55	41	187	0	14537
13749	321	74	14213	136	0	14744
13750	147	68	241	14246	0	14702
13751	127	61	80	14600	0	14868
13752	107	65	79	14692	0	14943
13753	14398	55	61	396	0	14910
13754	284	59	14085	198	0	14626
13755	13890	53	263	164	0	14370
13756	14339	51	84	166	0	14640
13757	359	38	77	14328	0	14802
13758	14357	34	73	376	0	14840
13759	334	49	13840	183	0	14406
13760	13950	42	212	154	0	14358
13761	336	15009	68	134	0	15547
13762	191	258	14707	101	0	15257
13763	141	91	14815	115	0	15162
13764	159	159	318	14681	0	15317
13765	135	55	14831	306	0	15327
13766	14273	77	285	177	0	14812
13767	287	14323	106	140	0	14856
13768	14407	246	80	135	0	14868
13769	315	95	63	14580	0	15053
13770	146	74	14485	320	0	15025
13771	107	62	14520	177	0	14866
13772	117	88	275	14623	0	15103
13773	14643	46	125	360	0	15174
13774	277	14404	79	212	0	14972
13775	139	14802	78	175	0	15194
13776	14728	269	72	172	0	15241
13777	307	14821	61	152	0	15341
13778	14875	258	78	140	0	15351
13779	338	128	63	14801	0	15330
13780	14720	70	79	309	0	15178
13781	335	57	67	14743	0	15202
13782	14787	70	76	336	0	15269
13783	327	46	60	14714	0	15147
13784	167	14558	74	328	0	15127
13785	14628	211	75	187	0	15101
13786	308	14521	58	174	0	15061
13787	186	238	14012	100	0	14536
13788	144	114	245	13330	0	13833
13789	133	13995	96	243	0	14467
13790	13490	242	68	148	0	13948
13791	13621	109	83	101	0	13914
13792	342	13407	72	85	0	13906
13793	134	246	13106	96	0	13582
13794	147	90	237	12624	0	13098
13795	114	12586	93	260	0	13053
13796	96	236	104	12979	0	13415
13797	159	84	68	13038	0	13349
13798	12735	98	59	314	0	13206
13799	269	12685	61	152	0	13167
13800	110	233	53	12850	0	13246
13801	12809	106	52	296	0	13263
13802	12837	69	45	150	0	13101
13803	12700	80	47	146	0	12973
13804	342	65	49	12500	0	12956
13805	12291	66	34	265	0	12656
13806	324	12247	45	109	0	12725
13807	12149	211	49	116	0	12525
13808	294	12194	41	112	0	12641
13809	12093	233	49	122	0	12497
13810	12040	80	33	122	0	12275
13811	346	134	46	11823	0	12349
13812	163	45	12074	230	0	12512
13813	149	66	11714	104	0	12033
13814	124	11954	179	85	0	12342
13815	11398	222	101	101	0	11822
13816	227	83	11195	49	0	11554
13817	9187	34	76	36	0	9333
13818	70	9284	25	26	0	9405
13819	48	9529	19	13	0	9609
13820	39	93	27	9713	0	9872
13821	32	10018	21	60	0	10131
13822	31	88	10377	31	0	10527
13823	40	60	83	10067	0	10250
13824	31	10597	25	91	0	10744
13825	25	118	16	10663	0	10822
13826	10742	47	15	141	0	10945
13827	113	38	15	10937	0	11103
13828	51	36	11111	136	0	11334
13829	35	11323	115	74	0	11547
13830	44	138	45	11275	0	11502
13831	42	53	27	11394	0	11516
13832	42	38	27	11457	0	11564
13833	11284	38	16	192	0	11530
13834	11165	28	17	117	0	11327
13835	165	32	11280	62	0	11539
13836	74	37	11105	55	0	11271
13837	52	11287	146	51	0	11536
13838	11454	121	61	67	0	11703
13839	156	57	45	11463	0	11721
13840	83	38	34	11478	0	11633
13841	63	37	23	11544	0	11667
13842	65	27	20	11576	0	11688
13843	44	32	11291	205	0	11572
13844	11044	27	122	115	0	11308
13845	173	16	42	12245	0	12476
13846	66	19	12211	217	0	12513
13847	12426	23	182	117	0	12748
13848	13848	21	58	82	0	14009
13849	283	31	15253	51	0	15618
13850	134	20	16066	44	0	16264
13851	129	25	300	15974	0	16428
13852	16155	26	118	287	0	16586
13853	16399	14	86	125	0	16624
13854	370	18	79	16034	0	16501
13855	176	13	72	16339	0	16600
13856	107	23	16264	352	0	16746
13857	120	54	291	15990	0	16455
13858	105	20	16067	350	0	16542
13859	15487	20	291	177	0	15975
13860	300	16043	128	135	0	16606
13861	15428	237	88	118	0	15871
13862	311	15473	83	79	0	15946
13863	15491	274	109	67	0	15941
13864	363	110	51	15145	0	15669
13865	194	65	59	15320	0	15638
13866	15288	57	24	383	0	15752
13867	15398	54	28	165	0	15645
13868	15428	34	31	130	0	15623
13869	15566	37	29	112	0	15744
13870	460	20	15196	92	0	15768
13871	15175	24	277	88	0	15564
13872	15596	16	101	88	0	15801
13873	15615	19	66	73	0	15773
13874	517	20	65	15181	0	15783
13875	14972	21	55	323	0	15371
13876	427	14895	51	134	0	15507
13877	250	259	55	14964	0	15528
13878	220	85	42	15199	0	15546
13879	168	55	14876	414	0	15513
13880	170	44	301	14621	0	15136
13881	110	14829	134	407	0	15480
13882	14803	282	88	218	0	15391
13883	376	14838	78	172	0	15464
13884	14979	307	70	167	0	15523
13885	424	139	62	14950	0	15575
13886	14804	82	69	394	0	15349
13887	411	14660	66	196	0	15333
13888	14863	320	64	157	0	15404
13889	15077	143	50	148	0	15418
13890	512	102	54	14742	0	15410
13891	293	92	36	15038	0	15459
13892	217	82	14675	459	0	15433
13893	247	73	278	14721	0	15319
13894	195	78	113	14877	0	15263
13895	195	51	14567	490	0	15303
13896	169	52	311	14734	0	15266
13897	185	40	14557	452	0	15234
13898	14468	45	343	254	0	15110
13899	453	31	170	14501	0	15155
13900	257	43	14244	437	0	14981
13901	14304	40	341	231	0	14916
13902	455	40	158	14402	0	15055
13903	268	42	14501	421	0	15232
13904	14589	24	335	247	0	15195
13905	460	37	149	14682	0	15328
13906	243	39	124	14874	0	15280
13907	14775	57	109	498	0	15439
13908	449	48	78	14720	0	15295
13909	238	42	81	14946	0	15307
13910	201	53	87	14532	0	14873
13911	187	14369	80	502	0	15138
13912	14037	308	53	325	0	14723
13913	14229	133	50	235	0	14647
13914	492	89	50	13848	0	14479
13915	13879	84	55	447	0	14465
13916	13965	50	53	270	0	14338
13917	14030	60	55	204	0	14349
13918	10309	97	112	258	0	10776
13919	13668	52	85	165	0	13970
13920	579	37	12712	162	0	13490
13921	307	39	12257	182	0	12785
13922	12074	40	321	164	0	12599
13923	426	11945	160	158	0	12689
13924	247	226	108	11590	0	12171
13925	182	89	11560	342	0	12173
13926	181	53	11532	196	0	11962
13927	188	183	318	11206	0	11895
13928	11147	83	249	407	0	11886
13929	335	39	106	11131	0	11611
13930	178	52	11091	330	0	11651
13931	11335	23	260	221	0	11839
13932	340	37	131	11459	0	11967
13933	217	24	89	11653	0	11983
13934	148	22	84	11772	0	12026
13935	175	23	78	11535	0	11811
13936	158	22	11135	429	0	11744
13937	133	35	226	11254	0	11648
13938	11133	22	101	385	0	11641
13939	325	25	10765	242	0	11357
13940	10881	19	225	221	0	11346
13941	11219	23	96	191	0	11529
13942	11198	36	66	164	0	11464
13943	11082	33	71	153	0	11339
13944	418	10700	69	137	0	11324
13945	225	9723	55	98	0	10101
13946	170	9912	51	110	0	10243
13947	9087	358	270	171	0	9886
13948	282	83	8311	108	0	8784
13949	6203	134	228	48	0	6613
13950	140	21	63	5821	0	6045
13951	5835	9	15	91	0	5950
13952	94	9	17	5810	0	5930
13953	5852	8	20	97	0	5977
13954	103	4	14	5829	0	5950
13955	61	8	16	5978	0	6063
13956	5696	3	14	114	0	5827
13957	90	6191	9	50	0	6340
13958	55	57	6106	31	0	6249
13959	33	6039	62	30	0	6164
13960	49	58	5726	20	0	5853
13961	44	107	52	5332	0	5535
13962	5398	11	58	51	0	5518
13963	47	8	3	5264	0	5322
13964	5235	7	9	49	0	5300
13965	43	5540	11	33	0	5627
13966	34	31	5580	18	0	5663
13967	26	5523	34	16	0	5599
13968	18	5533	12	27	0	5590
13969	5238	30	31	22	0	5321
13970	5085	7	11	9	0	5112
13971	36	5109	5	8	0	5158
13972	20	25	3	5142	0	5190
13973	10	7	4	5180	0	5201
13974	5164	5	7	43	0	5219
13975	31	9	5218	16	0	5274
13976	14	9	5094	11	0	5128
13977	13	4	29	5227	0	5273
13978	13	4	5292	30	0	5339
13979	5023	5	31	16	0	5075
13980	5281	5	15	8	0	5309
13981	37	5289	3	12	0	5341
13982	23	32	5498	7	0	5560
13983	18	4	27	5524	0	5573
13984	18	9	5788	27	0	5842
13985	12	15	26	5707	0	5760
13986	5772	7	15	47	0	5841
13987	38	5879	7	14	0	5938
13988	17	32	6072	10	0	6131
13989	13	6100	37	19	0	6169
13990	14	6368	10	15	0	6407
13991	6460	39	5	18	0	6522
13992	6256	8	8	27	0	6299
13993	42	11	6503	11	0	6567
13994	16	6602	35	10	0	6663
13995	16	37	13	6629	0	6695
13996	23	11	14	6644	0	6692
13997	14	9	12	6612	0	6647
13998	12	10	6750	44	0	6816
13999	16	9	37	6674	0	6736
14000	13	6	12	6912	0	6943
14001	6982	7	8	63	0	7060
14002	6964	7	13	35	0	7019
14003	6912	11	6	33	0	6962
14004	6837	7	10	21	0	6875
14005	6832	7	6	22	0	6867
14006	55	6759	14	7	0	6835
14007	6663	38	7	8	0	6716
14008	47	11	6661	8	0	6727
14009	25	18	28	6607	0	6678
14010	6691	9	5	40	0	6745
14011	38	6738	10	11	0	6797
14012	6827	26	4	25	0	6882
14013	6991	4	11	21	0	7027
14014	42	9	6	7070	0	7127
14015	18	9	6	7089	0	7122
14016	15	7304	9	40	0	7368
14017	20	30	4	7433	0	7487
14018	18	6	7641	38	0	7703
14019	22	15	32	7636	0	7705
14020	16	9	7723	43	0	7791
14021	7408	6	45	31	0	7490
14022	52	5	14	7826	0	7897
14023	25	7	7949	49	0	8030
14024	16	7740	43	19	0	7818
14025	16	7913	13	15	0	7957
14026	7859	45	24	15	0	7943
14027	48	28	7	7899	0	7982
14028	20	10	8107	33	0	8170
14029	12	7926	36	25	0	7999
14030	16	32	8078	8	0	8134
14031	7778	14	33	24	0	7849
14032	7892	7	20	15	0	7934
14033	7957	7	9	11	0	7984
14034	51	4	6	8007	0	8068
14035	29	4	8016	33	0	8082
14036	15	8036	31	16	0	8098
14037	14	26	19	8163	0	8222
14038	3	18	8101	33	0	8155
14039	6	17	7833	19	0	7875
14040	14	8	45	8125	0	8192
14041	8244	3	22	46	0	8315
14042	39	2	13	8244	0	8298
14043	16	6	16	8420	0	8458
14044	10	8	8487	47	0	8552
14045	22	7	36	8459	0	8524
14046	22	3	14	8492	0	8531
14047	17	7	8588	52	0	8664
14048	11	8	8333	25	0	8377
14049	13	8	53	8502	0	8576
14050	6	10	8626	42	0	8684
14051	14	6	43	8600	0	8663
14052	8647	5	26	67	0	8745
14053	33	8818	21	27	0	8899
14054	26	29	16	8972	0	9043
14055	17	18	8825	51	0	8911
14056	8005	10	34	46	0	8095
14057	37	8400	20	25	0	8482
14058	8527	34	16	27	0	8604
14059	45	15	13	8533	0	8606
14060	25	9	6	8567	0	8607
14061	8713	7	7	69	0	8796
14062	41	7	8759	29	0	8836
14063	8613	2	37	37	0	8689
14064	48	2	26	8853	0	8929
14065	8600	2	15	61	0	8678
14066	8611	5	9	38	0	8663
14067	64	8	10	8704	0	8786
14068	28	8965	11	58	0	9062
14069	9266	42	5	48	0	9361
14070	9447	13	13	36	0	9509
14071	86	17	9549	16	0	9668
14072	9482	11	58	27	0	9578
14073	78	8	28	9603	0	9717
14074	41	9701	13	68	0	9823
14075	36	52	15	9561	0	9664
14076	24	9641	14	52	0	9731
14077	9636	65	12	46	0	9759
14078	9805	27	6	26	0	9864
14079	98	15	8	10324	0	10445
14080	46	14	10248	80	0	10388
14081	39	10	10105	51	0	10205
14082	26	14	112	10565	0	10717
14083	10583	8	70	112	0	10773
14084	10998	8	26	64	0	11096
14085	138	11219	23	32	0	11412
14086	89	105	15	11295	0	11504
14087	48	54	11550	114	0	11766
14088	30	25	11785	75	0	11915
14089	46	51	185	12484	0	12766
14090	13543	12	91	195	0	13841
14091	205	10	35	13727	0	13977
14092	104	11	13573	222	0	13910
14093	13546	8	188	123	0	13865
14094	227	13	96	13555	0	13891
14095	122	8	46	13765	0	13941
14096	74	7	42	13597	0	13720
14097	46	13535	24	296	0	13901
14098	38	184	13507	143	0	13872
14099	36	91	13649	89	0	13865
14100	42	36	278	13615	0	13971
14101	25	27	13759	219	0	14030
14102	13471	15	254	130	0	13870
14103	229	12	120	13613	0	13974
14104	116	9	55	13729	0	13909
14105	78	16	58	13639	0	13791
14106	44	13621	44	319	0	14028
14107	13807	192	50	179	0	14228
14108	242	87	26	13842	0	14197
14109	13745	37	32	295	0	14109
14110	244	13774	35	139	0	14192
14111	13797	214	23	99	0	14133
14112	13490	98	30	100	0	13718
14113	13661	41	30	95	0	13827
14114	328	13252	34	63	0	13677
14115	184	13364	24	52	0	13624
14116	13074	267	25	77	0	13443
14117	256	13182	32	66	0	13536
14118	130	250	12871	64	0	13315
14119	72	12556	199	58	0	12885
14120	71	12980	109	65	0	13225
14121	12890	278	56	65	0	13289
14122	238	142	12775	37	0	13192
14123	111	97	12574	37	0	12819
14124	103	67	284	12505	0	12959
14125	12684	43	136	244	0	13107
14126	237	31	12730	110	0	13108
14127	150	34	233	12685	0	13102
14128	73	48	12249	254	0	12624
14129	83	40	12132	149	0	12404
14130	11872	35	300	99	0	12306
14131	237	39	12314	61	0	12651
14132	154	46	254	12111	0	12565
14133	102	34	136	12138	0	12410
14134	98	11918	76	293	0	12385
14135	62	12289	82	142	0	12575
14136	77	270	61	11996	0	12404
14137	50	127	12085	261	0	12523
14138	88	80	225	12068	0	12461
14139	60	66	116	12266	0	12508
14140	47	57	12216	332	0	12652
14141	55	44	242	12283	0	12624
14142	12289	48	136	316	0	12789
14143	231	45	12308	163	0	12747
14144	12183	46	276	124	0	12629
14145	291	40	134	12218	0	12683
14146	191	26	77	12515	0	12809
14147	101	12635	80	351	0	13167
14148	91	243	85	12690	0	13109
14149	89	109	75	13064	0	13337
14150	12859	58	62	399	0	13378
14151	280	54	61	12963	0	13358
14152	152	48	60	13111	0	13371
14153	12665	64	60	432	0	13221
14154	295	51	75	12745	0	13166
14155	181	48	87	12298	0	12614
14156	89	12544	76	394	0	13103
14157	12613	242	72	237	0	13164
14158	304	123	51	12621	0	13099
14159	173	83	41	12834	0	13131
14160	99	80	12451	412	0	13042
14161	102	52	251	12431	0	12836
14162	74	60	146	12645	0	12925
14163	12237	43	78	439	0	12797
14164	12401	41	70	260	0	12772
14165	361	51	66	12351	0	12829
14166	184	50	12053	338	0	12625
14167	142	11610	241	205	0	12198
14168	112	11841	144	134	0	12231
14169	175	337	127	11532	0	12171
14170	11458	121	76	344	0	11999
14171	264	107	55	11568	0	11994
14172	11559	85	29	339	0	12012
14173	293	78	34	11736	0	12141
14174	165	52	62	11787	0	12066
14175	11486	55	46	401	0	11988
14176	11503	66	34	208	0	11811
14177	342	11387	38	159	0	11926
14178	198	11759	39	131	0	12127
14179	123	256	52	10921	0	11352
14180	118	125	46	11081	0	11370
14181	113	83	10722	279	0	11197
14182	9921	60	205	170	0	10356
14183	214	10266	92	129	0	10701
14184	78	9943	53	99	0	10173
14185	9526	185	100	88	0	9899
14186	208	57	9549	59	0	9873
14187	100	53	9084	56	0	9293
14188	104	61	8497	73	0	8735
14189	46	7763	165	38	0	8012
14190	67	73	108	6652	0	6900
14191	17	11	18	6655	0	6701
14192	15	13	13	6706	0	6747
14193	6609	8	12	86	0	6715
14194	6596	9	11	41	0	6657
14195	68	6629	6	35	0	6738
14196	30	54	11	6731	0	6826
14197	19	17	6755	68	0	6859
14198	15	6772	56	31	0	6874
14199	6701	66	10	39	0	6816
14200	71	17	6739	17	0	6844
14201	6244	17	61	34	0	6356
14202	73	7	6650	14	0	6744
14203	14	29	70	6449	0	6562
14204	15	6637	12	63	0	6727
14205	6704	54	17	30	0	6805
14206	57	6861	10	25	0	6953
14207	6738	60	8	29	0	6835
14208	70	15	12	6726	0	6823
14209	17	19	6948	71	0	7055
14210	32	14	55	7156	0	7257
14211	23	12	10	7694	0	7739
14212	11	20	7749	103	0	7883
14213	7529	6	86	46	0	7667
14214	93	7982	18	29	0	8122
14215	7944	90	18	19	0	8071
14216	96	8096	9	26	0	8227
14217	32	88	12	8387	0	8519
14218	17	22	8333	111	0	8483
14219	9209	19	104	43	0	9375
14220	146	9543	25	30	0	9744
14221	61	143	13	9554	0	9771
14222	46	44	13	9991	0	10094
14223	10463	29	8	194	0	10694
14224	11233	23	12	86	0	11354
14225	223	11440	13	49	0	11725
14226	12356	194	14	48	0	12612
14227	12596	68	7	40	0	12711
14228	12966	40	12	42	0	13060
14229	362	27	13033	18	0	13440
14230	164	12725	235	22	0	13146
14231	92	13329	86	33	0	13540
14232	88	308	56	12672	0	13124
14233	77	132	38	13102	0	13349
14234	13014	83	21	328	0	13446
14235	265	12997	24	137	0	13423
14236	13116	267	11	95	0	13489
14237	322	112	8	12941	0	13383
14238	151	57	18	13233	0	13459
14239	12889	41	19	369	0	13318
14240	12909	37	13	156	0	13115
14241	364	41	12622	94	0	13121
14242	182	47	230	12563	0	13022
14243	118	17	12430	269	0	12834
14244	84	24	12350	114	0	12572
14245	70	39	12489	62	0	12660
14246	11995	62	371	76	0	12504
14247	264	31	167	11860	0	12322
14248	143	24	76	11950	0	12193
14249	105	19	57	12174	0	12355
14250	63	29	11999	346	0	12437
14251	75	25	239	12025	0	12364
14252	69	28	99	12274	0	12470
14253	11952	21	65	377	0	12415
14254	12093	27	47	179	0	12346
14255	12272	26	29	122	0	12449
14256	12340	23	30	87	0	12480
14257	441	25	20	11989	0	12475
14258	12158	30	24	294	0	12506
14259	365	25	26	12105	0	12521
14260	200	27	11461	312	0	12000
14261	11863	23	221	162	0	12269
14262	330	11847	88	112	0	12377
14263	171	252	67	11798	0	12288
14264	142	127	47	11851	0	12167
14265	96	11935	43	348	0	12422
14266	11831	276	30	185	0	12322
14267	320	11815	35	133	0	12303
14268	177	290	11674	93	0	12234
14269	126	141	11764	79	0	12110
14270	11614	78	353	74	0	12119
14271	11838	66	150	84	0	12138
14272	401	44	11518	85	0	12048
14273	11529	44	292	85	0	11950
14274	382	44	11485	80	0	11991
14275	11504	38	318	77	0	11937
14276	368	43	11470	88	0	11969
14277	219	44	11556	82	0	11901
14278	167	39	364	11042	0	11612
14279	155	31	202	11223	0	11611
14280	11404	35	116	405	0	11960
14281	11251	36	78	234	0	11599
14282	11482	43	64	167	0	11756
14283	11711	22	67	142	0	11942
14284	464	11232	74	115	0	11885
14285	282	244	56	11093	0	11675
14286	201	11237	84	296	0	11818
14287	172	281	71	11302	0	11826
14288	154	135	79	11333	0	11701
14289	153	85	64	11415	0	11717
14290	145	70	10990	451	0	11656
14291	10781	50	285	273	0	11389
14292	333	10606	154	197	0	11290
14293	203	11052	104	164	0	11523
14294	157	332	11014	128	0	11631
14295	162	152	280	10923	0	11517
14296	143	108	155	11039	0	11445
14297	10921	76	93	426	0	11516
14298	371	51	74	10933	0	11429
14299	233	59	65	11107	0	11464
14300	185	36	76	11183	0	11480
14301	168	42	81	11259	0	11550
14302	10837	32	89	489	0	11447
14303	10999	40	86	260	0	11385
14304	11080	28	93	179	0	11380
14305	484	40	82	10840	0	11446
14306	10860	33	83	348	0	11324
14307	427	38	79	10918	0	11462
14308	247	47	84	11210	0	11588
14309	165	35	10664	453	0	11317
14310	120	41	10466	252	0	10879
14311	116	29	10103	174	0	10422
14312	9813	59	416	138	0	10426
14313	354	71	227	9263	0	9915
14314	207	9554	135	262	0	10158
14315	9789	213	112	162	0	10276
14316	359	107	9501	122	0	10089
14317	9178	62	269	110	0	9619
14318	346	8929	146	104	0	9525
14319	8110	163	86	67	0	8426
14320	283	117	60	7943	0	8403
14321	7868	44	56	217	0	8185
14322	246	7461	40	141	0	7888
14323	153	7296	43	96	0	7588
14324	6297	156	42	76	0	6571
14325	157	6278	28	57	0	6520
14326	51	5124	16	22	0	5213
14327	56	5148	30	25	0	5259
14328	4558	137	158	35	0	4888
14329	4365	29	11	10	0	4415
14330	4372	20	4	6	0	4402
14331	75	7	4	4313	0	4399
14332	29	10	5	4346	0	4390
14333	19	10	4301	63	0	4393
14334	20	8	44	4340	0	4412
14335	22	4	4386	61	0	4473
14336	17	4	51	4383	0	4455
14337	11	7	14	4464	0	4496
14338	4408	3	13	71	0	4495
14339	4407	1	5	38	0	4451
14340	61	4414	11	16	0	4502
14341	21	51	4	4409	0	4485
14342	14	21	4557	61	0	4653
14343	17	9	54	4569	0	4649
14344	20	9	16	4620	0	4665
14345	18	8	12	4638	0	4676
14346	11	6	4559	75	0	4651
14347	9	9	4345	31	0	4394
14348	4503	5	59	26	0	4593
14349	57	5	25	4583	0	4670
14350	18	3	4552	59	0	4632
14351	4379	3	51	33	0	4466
14352	48	4595	20	19	0	4682
14353	4641	39	13	24	0	4717
14354	59	17	4756	12	0	4844
14355	4648	8	37	19	0	4712
14356	48	8	12	4746	0	4814
14357	20	7	4816	35	0	4878
14358	24	4750	31	15	0	4820
14359	4770	43	13	25	0	4851
14360	45	14	11	4768	0	4838
14361	16	10	15	4784	0	4825
14362	15	4836	10	34	0	4895
14363	14	30	7	4863	0	4914
14364	16	9	4842	45	0	4912
14365	5	4800	33	19	0	4857
14366	4817	33	12	23	0	4885
14367	39	16	7	4760	0	4822
14368	15	11	10	4734	0	4770
14369	20	6	4718	36	0	4780
14370	15	23	30	4721	0	4789
14371	17	8	4895	44	0	4964
14372	10	4892	32	19	0	4953
14373	4875	31	17	15	0	4938
14374	4854	17	10	15	0	4896
14375	4844	11	8	19	0	4882
14376	40	5030	11	14	0	5095
14377	16	39	5	5065	0	5125
14378	21	8	4	5075	0	5108
14379	17	19	13	4365	0	4414
14380	5016	8	7	44	0	5075
14381	4975	11	6	27	0	5019
14382	44	3	5	4978	0	5030
14383	17	6	5321	43	0	5387
14384	16	10	28	5291	0	5345
14385	17	5	11	5354	0	5387
14386	13	6	9	5340	0	5368
14387	13	5	9	5342	0	5369
14388	5368	6	8	51	0	5433
14389	31	2	5	5469	0	5507
14390	18	4	9	5459	0	5490
14391	14	5496	6	44	0	5560
14392	11	30	2	5683	0	5726
14393	17	5789	2	50	0	5858
14394	14	35	5	5824	0	5878
14395	5820	16	2	54	0	5892
14396	39	5888	4	30	0	5961
14397	5850	36	3	43	0	5932
14398	43	17	5950	14	0	6024
14399	24	12	34	5883	0	5953
14400	24	4	6037	48	0	6113
14401	10	8	36	6018	0	6072
14402	15	18	17	6015	0	6065
14403	10	5922	12	58	0	6002
14404	9	5974	8	33	0	6024
14405	7	6148	12	20	0	6187
14406	6104	40	6	21	0	6171
14407	33	5908	4	16	0	5961
14408	10	5824	8	27	0	5869
14409	51	34	23	5835	0	5943
14410	5847	8	4	29	0	5888
14411	18	6011	5	35	0	6069
14412	6108	19	2	22	0	6151
14413	6105	6	7	16	0	6134
14414	26	5	6272	8	0	6311
14415	12	5	16	6163	0	6196
14416	12	2	9	6310	0	6333
14417	7	6	4	6353	0	6370
14418	3	13	1	6310	0	6327
14419	7	4	6091	31	0	6133
14420	12	9	5638	16	0	5675
14421	5719	6	16	16	0	5757
14422	21	5954	6	9	0	5990
14423	9	5980	4	8	0	6001
14424	6018	23	5	15	0	6061
14425	21	5991	7	3	0	6022
14426	9	20	2	6076	0	6107
14427	6089	7	5	27	0	6128
14428	19	8	6101	13	0	6141
14429	11	5	18	6148	0	6182
14430	9	12	6207	23	0	6251
14431	6051	12	15	22	0	6100
14432	25	7	6624	8	0	6664
14433	6665	5	22	9	0	6701
14434	6948	7	8	22	0	6985
14435	6968	10	5	21	0	7004
14436	7023	7	5	16	0	7051
14437	7056	3	3	19	0	7081
14438	28	6	6	7074	0	7114
14439	7299	2	3	44	0	7348
14440	37	3	2	7323	0	7365
14441	10	9	8	7351	0	7378
14442	11	5	5	7301	0	7322
14443	9	7	7273	31	0	7320
14444	13	8	18	7172	0	7211
14445	8	10	10	7347	0	7375
14446	10	8	7248	29	0	7295
14447	6833	7	21	26	0	6887
14448	26	9	6	7372	0	7413
14449	17	10	7354	18	0	7399
14450	15	9	7126	10	0	7160
14451	8	6	26	7194	0	7234
14452	12	6	7381	24	0	7423
14453	15	11	19	7441	0	7486
14454	10	3	9	7403	0	7425
14455	9	7332	11	28	0	7380
14456	9	7406	11	17	0	7443
14457	7461	22	8	22	0	7513
14458	33	9	9	7512	0	7563
14459	21	4	7	7409	0	7441
14460	13	5	3	7583	0	7604
14461	13	14	7609	37	0	7673
14462	15	9	23	7516	0	7563
14463	7563	3	7	40	0	7613
14464	30	4	7674	22	0	7730
14465	21	6	25	7816	0	7868
14466	19	3	10	7871	0	7903
14467	4	6	11	8003	0	8024
14468	4	8253	11	41	0	8309
14469	8315	29	9	32	0	8385
14470	8585	10	13	31	0	8639
14471	54	8819	8	19	0	8900
14472	36	41	5	9184	0	9266
14473	18	19	9253	59	0	9349
14474	17	15	9087	23	0	9142
14475	9537	3	81	29	0	9650
14476	87	4	39	9722	0	9852
14477	10064	8	26	99	0	10197
14478	103	10359	13	48	0	10523
14479	49	10554	11	34	0	10648
14480	10572	125	15	43	0	10755
14481	101	10897	13	26	0	11037
14482	72	127	9	11031	0	11239
14483	54	51	8	10673	0	10786
14484	25	11192	8	138	0	11363
14485	11338	129	6	75	0	11548
14486	129	73	11486	39	0	11727
14487	11223	44	121	65	0	11453
14488	161	25	11688	22	0	11896
14489	11125	20	153	45	0	11343
14490	173	27	11834	28	0	12062
14491	89	11646	159	34	0	11928
14492	88	160	84	11581	0	11913
14493	11522	58	40	161	0	11781
14494	168	34	11384	64	0	11650
14495	86	28	11384	29	0	11527
14496	56	31	193	11208	0	11488
14497	40	23	11388	142	0	11593
14498	46	19	159	11237	0	11461
14499	41	27	86	11074	0	11228
14500	36	20	11308	198	0	11562
14501	37	5	177	11289	0	11508
14502	11435	3	90	195	0	11723
14503	132	11353	79	94	0	11658
14504	11529	127	38	74	0	11768
14505	173	60	44	11300	0	11577
14506	11364	40	34	167	0	11605
14507	11491	22	24	118	0	11655
14508	235	22	32	11261	0	11550
14509	99	11373	39	149	0	11660
14510	11471	130	30	97	0	11728
14511	230	69	11060	68	0	11427
14512	90	31	11062	49	0	11232
14513	10975	16	200	63	0	11254
14514	172	21	95	10952	0	11240
14515	100	23	10989	169	0	11281
14516	63	22	153	11011	0	11249
14517	11084	26	79	186	0	11375
14518	11241	28	59	116	0	11444
14519	11247	21	38	75	0	11381
14520	234	11337	30	66	0	11667
14521	154	141	20	11446	0	11761
14522	93	74	19	11493	0	11679
14523	11363	37	20	226	0	11646
14524	182	11315	24	109	0	11630
14525	11303	150	23	65	0	11541
14526	207	81	40	11183	0	11511
14527	11182	45	31	186	0	11444
14528	197	48	10806	102	0	11153
14529	115	10889	144	72	0	11220
14530	98	163	90	10393	0	10744
14531	74	11015	49	147	0	11285
14532	79	169	34	10684	0	10966
14533	10605	85	30	182	0	10902
14534	192	43	10301	97	0	10633
14535	10040	54	162	75	0	10331
14536	187	10388	88	78	0	10741
14537	107	163	47	10512	0	10829
14538	87	85	37	10668	0	10877
14539	10310	60	39	239	0	10648
14540	190	45	10263	116	0	10614
14541	133	34	152	10336	0	10655
14542	97	37	87	10348	0	10569
14543	69	29	63	10335	0	10496
14544	57	38	45	10405	0	10545
14545	10141	31	43	287	0	10502
14546	10141	34	47	159	0	10381
14547	231	30	10162	100	0	10523
14548	146	33	9949	85	0	10213
14549	10206	27	221	104	0	10558
14550	10525	24	89	91	0	10729
14551	247	27	67	10436	0	10777
14552	142	29	51	10428	0	10650
14553	10247	26	46	250	0	10569
14554	213	10130	56	144	0	10543
14555	124	134	54	10219	0	10531
14556	108	54	42	10392	0	10596
14557	81	30	10134	260	0	10505
14558	78	26	142	10267	0	10513
14559	73	33	10275	229	0	10610
14560	72	35	164	10248	0	10519
14561	10109	22	97	235	0	10463
14562	201	25	60	10213	0	10499
14563	139	17	10131	205	0	10492
14564	83	9791	160	143	0	10177
14565	92	155	107	10099	0	10453
14566	61	72	10070	226	0	10429
14567	75	10162	153	133	0	10523
14568	97	190	79	9952	0	10318
14569	73	92	9869	181	0	10215
14570	8655	57	152	151	0	9015
14571	145	9386	81	97	0	9709
14572	80	9069	53	59	0	9261
14573	49	9261	35	65	0	9410
14574	98	248	54	8783	0	9183
14575	37	65	8990	144	0	9236
14576	55	8878	120	74	0	9127
14577	91	238	67	8613	0	9009
14578	9061	47	31	134	0	9273
14579	134	34	19	11366	0	11553
14580	82	24	13219	238	0	13563
14581	42	13511	257	100	0	13910
14582	13176	275	85	97	0	13633
14583	269	13443	55	73	0	13840
14584	98	293	12897	68	0	13356
14585	59	12898	302	68	0	13327
14586	106	387	133	12423	0	13049
14587	68	158	12508	242	0	12976
14588	63	12436	299	87	0	12885
14589	102	346	127	12083	0	12658
14590	73	204	97	12085	0	12459
14591	25	12226	110	314	0	12675
14592	46	345	107	12232	0	12730
14593	13	181	12182	358	0	12734
14594	26	144	12363	180	0	12713
14595	46	137	333	12300	0	12816
14596	12136	121	136	405	0	12798
14597	12242	109	101	240	0	12692
14598	305	105	104	12041	0	12555
14599	104	12136	143	370	0	12753
14600	106	274	146	12177	0	12703
14601	12106	99	119	375	0	12699
14602	368	81	74	12043	0	12566
14603	210	72	52	12213	0	12547
14604	11906	95	40	436	0	12477
14605	318	11818	52	267	0	12455
14606	186	324	44	11894	0	12448
14607	11809	131	38	455	0	12433
14608	360	87	11562	265	0	12274
14609	11599	75	238	257	0	12169
14610	408	84	83	11775	0	12350
14611	11821	95	63	418	0	12397
14612	11977	101	62	223	0	12363
14613	11506	74	79	225	0	11884
14614	469	11564	80	158	0	12271
14615	269	259	11578	147	0	12253
14616	258	11693	270	141	0	12362
14617	11692	296	109	147	0	12244
14618	459	11543	68	120	0	12190
14619	294	349	60	11518	0	12221
14620	11383	176	83	312	0	11954
14621	374	11415	87	137	0	12013
14622	201	380	11370	116	0	12067
14623	186	232	284	11365	0	12067
14624	174	193	11374	345	0	12086
14625	168	11451	304	236	0	12159
14626	169	385	119	11336	0	12009
14627	148	187	128	11618	0	12081
14628	118	170	121	11652	0	12061
14629	103	143	152	11335	0	11733
14630	74	11347	121	470	0	12012
14631	11166	359	114	299	0	11938
14632	302	197	11182	255	0	11936
14633	145	145	289	11350	0	11929
14634	11154	119	126	517	0	11916
14635	329	153	11190	298	0	11970
14636	179	11099	331	240	0	11849
14637	181	384	170	10994	0	11729
14638	161	170	11121	393	0	11845
14639	164	11132	363	228	0	11887
14640	10903	342	190	222	0	11657
14641	366	11130	163	186	0	11845
14642	172	410	143	11043	0	11768
14643	134	249	128	11359	0	11870
14644	11004	198	129	494	0	11825
14645	358	11087	155	250	0	11850
14646	185	437	123	11187	0	11932
14647	10949	223	117	458	0	11747
14648	10882	232	89	282	0	11485
14649	425	10759	72	280	0	11536
14650	10772	400	61	255	0	11488
14651	10931	249	74	228	0	11482
14652	512	192	77	10659	0	11440
14653	320	182	10476	441	0	11419
14654	297	159	296	10488	0	11240
14655	309	152	123	10700	0	11284
14656	270	156	10343	458	0	11227
14657	229	10272	312	304	0	11117
14658	221	352	162	10306	0	11041
14659	177	157	155	10641	0	11130
14660	138	129	166	10719	0	11152
14661	160	105	151	10458	0	10874
14662	131	10227	146	578	0	11082
14663	10322	339	115	367	0	11143
14664	10429	184	79	329	0	11021
14665	10238	140	66	357	0	10801
14666	427	9845	62	358	0	10692
14667	238	354	59	9954	0	10605
14668	216	207	9693	485	0	10601
14669	291	210	258	9606	0	10365
14670	272	9833	103	417	0	10625
14671	9611	346	61	258	0	10276
14672	9685	184	65	232	0	10166
14673	9559	168	95	209	0	10031
14674	438	9238	119	218	0	10013
14675	244	8875	117	192	0	9428
14676	242	9230	114	170	0	9756
14677	305	377	8853	154	0	9689
14678	313	325	7999	219	0	8856
14679	334	816	289	4684	0	6123
14680	3585	48	155	76	0	3864
14681	3444	8	4	15	0	3471
14682	51	8	3	3543	0	3605
14683	16	12	2	3494	0	3524
14684	11	8	2	3607	0	3628
14685	14	8	4	3621	0	3647
14686	3621	7	9	55	0	3692
14687	3692	14	5	16	0	3727
14688	51	3775	2	21	0	3849
14689	3829	45	4	12	0	3890
14690	3856	13	4	11	0	3884
14691	3866	12	6	14	0	3898
14692	61	14	3328	19	0	3422
14693	3732	10	26	16	0	3784
14694	50	3855	9	13	0	3927
14695	21	45	8	3972	0	4046
14696	15	10	3	4024	0	4052
14697	10	3904	8	53	0	3975
14698	11	42	8	4059	0	4120
14699	4031	8	5	63	0	4107
14700	58	8	5	4081	0	4152
14701	18	9	4025	62	0	4114
14702	3908	7	44	28	0	3987
14703	56	4134	7	20	0	4217
14704	19	47	5	4164	0	4235
14705	26	13	3	4184	0	4226
14706	27	12	3	4188	0	4230
14707	18	10	4126	67	0	4221
14708	21	4098	42	27	0	4188
14709	20	41	8	4129	0	4198
14710	16	15	4062	56	0	4149
14711	25	14	42	3979	0	4060
14712	16	18	3986	54	0	4074
14713	21	20	49	3926	0	4016
14714	13	3947	18	59	0	4037
14715	20	44	10	3892	0	3966
14716	3899	14	10	57	0	3980
14717	3907	21	5	24	0	3957
14718	55	8	3915	27	0	4005
14719	23	8	3855	16	0	3902
14720	11	11	4209	29	0	4260
14721	9	11	59	4212	0	4291
14722	11	11	21	4385	0	4428
14723	7	13	15	4440	0	4475
14724	9	4451	11	78	0	4549
14725	15	48	8	4452	0	4523
14726	14	11	11	4658	0	4694
14727	12	10	13	4779	0	4814
14728	4757	14	7	85	0	4863
14729	4807	9	11	41	0	4868
14730	62	10	4837	32	0	4941
14731	25	6	4779	30	0	4840
14732	4879	7	72	21	0	4979
14733	5029	13	29	19	0	5090
14734	67	8	5181	23	0	5279
14735	29	8	5033	26	0	5096
14736	5046	8	66	32	0	5152
14737	5124	6	27	25	0	5182
14738	76	11	5199	22	0	5308
14739	31	8	69	5138	0	5246
14740	26	3	29	5232	0	5290
14741	26	5402	15	84	0	5527
14742	23	57	19	5528	0	5627
14743	23	16	5820	74	0	5933
14744	23	17	79	5821	0	5940
14745	24	8	32	5891	0	5955
14746	23	5	5784	94	0	5906
14747	5660	6	78	48	0	5792
14748	5892	4	28	45	0	5969
14749	101	7	23	5800	0	5931
14750	50	12	17	5874	0	5953
14751	5880	6	20	108	0	6014
14752	5855	5	22	58	0	5940
14753	5429	5	21	61	0	5516
14754	5837	6	20	40	0	5903
14755	105	5748	23	21	0	5897
14756	5703	64	14	28	0	5809
14757	89	5693	22	23	0	5827
14758	35	66	22	5737	0	5860
14759	42	18	13	5710	0	5783
14760	38	5610	19	90	0	5757
14761	37	64	19	5664	0	5784
14762	38	19	14	5629	0	5700
14763	28	5557	16	108	0	5709
14764	27	75	15	5591	0	5708
14765	29	23	16	5644	0	5712
14766	35	18	16	5657	0	5726
14767	27	13	5510	114	0	5664
14768	24	5394	67	63	0	5548
14769	32	87	24	5260	0	5403
14770	32	5401	22	87	0	5542
14771	5391	77	20	45	0	5533
14772	79	30	5347	45	0	5501
14773	38	17	5176	52	0	5283
14774	5092	20	72	40	0	5224
14775	86	33	39	5166	0	5324
14776	30	15	5035	67	0	5147
14777	40	13	4882	42	0	4977
14778	33	39	71	4839	0	4982
14779	4817	13	38	74	0	4942
14780	4846	12	19	31	0	4908
14781	73	15	17	4783	0	4888
14782	32	12	4734	75	0	4853
14783	27	4887	51	40	0	5005
14784	23	53	19	4912	0	5007
14785	21	16	4875	71	0	4983
14786	17	4856	56	39	0	4968
14787	29	61	21	4791	0	4902
14788	4771	18	15	64	0	4868
14789	49	21	13	4680	0	4763
14790	20	4719	25	68	0	4832
14791	4700	52	21	33	0	4806
14792	57	21	4853	39	0	4970
14793	25	4794	45	37	0	4901
14794	31	42	4749	22	0	4844
14795	4571	30	60	27	0	4688
14796	63	14	26	4490	0	4593
14797	35	12	14	4664	0	4725
14798	4670	11	15	64	0	4760
14799	56	10	16	4719	0	4801
14800	24	12	4655	56	0	4747
14801	4510	14	37	39	0	4600
14802	59	4711	19	35	0	4824
14803	39	42	16	4671	0	4768
14804	4681	16	16	64	0	4777
14805	48	4671	20	34	0	4773
14806	37	46	12	4792	0	4887
14807	4827	21	11	63	0	4922
14808	47	19	17	4846	0	4929
14809	25	4780	9	72	0	4886
14810	21	49	4899	38	0	5007
14811	22	18	48	4996	0	5084
14812	34	13	21	4741	0	4809
14813	5018	20	15	69	0	5122
14814	55	14	12	5063	0	5144
14815	5057	12	14	69	0	5152
14816	5056	15	19	38	0	5128
14817	63	18	13	5011	0	5105
14818	41	5055	10	58	0	5164
14819	29	39	10	5018	0	5096
14820	4694	19	7	70	0	4790
14821	53	4750	10	34	0	4847
14822	25	4869	9	26	0	4929
14823	4921	44	9	39	0	5013
14824	4974	21	8	23	0	5026
14825	56	4993	9	25	0	5083
14826	4981	52	27	30	0	5090
14827	4950	19	9	24	0	5002
14828	58	18	6	4979	0	5061
14829	20	9	5088	55	0	5172
14830	27	36	45	5034	0	5142
14831	10	13	5175	65	0	5263
14832	22	24	54	5127	0	5227
14833	15	9	5155	65	0	5244
14834	4968	8	56	24	0	5056
14835	47	4	19	5084	0	5154
14836	5298	7	9	55	0	5369
14837	61	15	10	5233	0	5319
14838	23	5376	6	58	0	5463
14839	5486	48	4	27	0	5565
14840	60	12	5237	20	0	5329
14841	5084	17	44	22	0	5167
14842	52	5186	8	13	0	5259
14843	4897	40	11	8	0	4956
14844	4951	9	4	12	0	4976
14845	44	4973	6	10	0	5033
14846	19	36	5	5133	0	5193
14847	5157	7	5	48	0	5217
14848	48	5196	1	9	0	5254
14849	21	35	2	5247	0	5305
14850	5290	8	0	47	0	5345
14851	48	14	4	5220	0	5286
14852	22	6	5	5265	0	5298
14853	24	2	3	5290	0	5319
14854	12	9	5207	51	0	5279
14855	11	8	38	5200	0	5257
14856	5247	7	6	58	0	5318
14857	53	7	5268	14	0	5342
14858	16	6	40	5298	0	5360
14859	19	7	10	5353	0	5389
14860	14	10	5287	55	0	5366
14861	5192	9	40	30	0	5271
14862	5380	9	9	31	0	5429
14863	54	8	5431	15	0	5508
14864	30	6	41	5413	0	5490
14865	20	2	11	5580	0	5613
14866	15	7	5793	58	0	5873
14867	17	9	50	5878	0	5954
14868	23	2	13	5833	0	5871
14869	19	4	6091	65	0	6179
14870	5996	9	57	34	0	6096
14871	70	5	12	6301	0	6388
14872	6281	7	16	77	0	6381
14873	6309	4	10	30	0	6353
14874	82	8	6398	27	0	6515
14875	44	11	66	6307	0	6428
14876	6421	6	16	86	0	6529
14877	74	6573	17	34	0	6698
14878	33	66	12	6743	0	6854
14879	29	11	13	6768	0	6821
14880	21	12	15	6900	0	6948
14881	14	5	6809	113	0	6941
14882	6303	11	77	49	0	6440
14883	84	8	17	6587	0	6696
14884	25	4	20	6610	0	6659
14885	32	3	6551	98	0	6684
14886	37	5	69	6480	0	6591
14887	22	6	29	6646	0	6703
14888	6555	2	24	99	0	6680
14889	74	6616	12	55	0	6757
14890	24	63	6640	38	0	6765
14891	6605	15	77	34	0	6731
14892	86	15	18	6589	0	6708
14893	25	5	6757	103	0	6890
14894	27	7	6804	39	0	6877
14895	30	10	88	6910	0	7038
14896	20	4	7045	91	0	7160
14897	27	8	6987	43	0	7065
14898	18	6848	87	40	0	6993
14899	20	69	40	7368	0	7497
14900	23	18	7363	87	0	7491
14901	31	18	76	7277	0	7402
14902	7623	9	28	109	0	7769
14903	77	8	32	7619	0	7736
14904	31	10	21	7740	0	7802
14905	7607	2	19	113	0	7741
14906	7657	2	23	50	0	7732
14907	89	8	21	7850	0	7968
14908	36	8	7857	106	0	8007
14909	19	7802	89	48	0	7958
14910	22	72	33	7905	0	8032
14911	7869	20	21	111	0	8021
14912	7898	13	23	42	0	7976
14913	95	7764	21	43	0	7923
14914	32	7968	18	43	0	8061
14915	7987	80	21	37	0	8125
14916	7976	20	20	42	0	8058
14917	100	16	8298	39	0	8453
14918	52	22	92	8131	0	8297
14919	31	8390	27	89	0	8537
14920	8701	86	29	45	0	8861
14921	105	37	21	8642	0	8805
14922	38	8486	21	100	0	8645
14923	24	84	8685	45	0	8838
14924	43	57	93	8341	0	8534
14925	26	8765	32	86	0	8909
14926	8836	85	18	53	0	8992
14927	8831	30	23	44	0	8928
14928	80	8766	18	32	0	8896
14929	8617	70	15	39	0	8741
14930	8635	19	12	40	0	8706
14931	92	8569	14	21	0	8696
14932	39	8696	14	26	0	8775
14933	54	100	21	8609	0	8784
14934	8634	25	10	92	0	8761
14935	73	21	8735	30	0	8859
14936	8343	16	62	30	0	8451
14937	70	8729	21	27	0	8847
14938	8701	67	17	33	0	8818
14939	8725	22	20	25	0	8792
14940	8780	9	12	25	0	8826
14941	87	29	14	8634	0	8764
14942	40	8645	8	72	0	8765
14943	8700	61	13	39	0	8813
14944	83	27	8828	18	0	8956
14945	28	8676	61	21	0	8786
14946	32	78	19	8977	0	9106
14947	23	24	8770	66	0	8883
14948	28	16	8670	19	0	8733
14949	40	16	79	8549	0	8684
14950	23	17	27	9109	0	9176
14951	24	15	14	9161	0	9214
14952	27	9	9	9046	0	9091
14953	17	8761	13	91	0	8882
14954	19	9123	18	37	0	9197
14955	9270	72	8	37	0	9387
14956	76	30	8	9282	0	9396
14957	30	18	13	9296	0	9357
14958	27	12	12	9441	0	9492
14959	9368	20	5	96	0	9489
14960	9426	14	10	50	0	9500
14961	94	8	11	9433	0	9546
14962	9575	13	9	87	0	9684
14963	9525	8	6	44	0	9583
14964	9685	15	7	36	0	9743
14965	98	10	10	9524	0	9642
14966	41	13	9125	69	0	9248
14967	19	17	8464	37	0	8537
14968	29	10	8789	16	0	8844
14969	21	15	9034	20	0	9090
14970	29	42	69	8998	0	9138
14971	9022	9	34	59	0	9124
14972	8955	8	9	28	0	9000
14973	68	4	8956	11	0	9039
14974	31	5	8949	15	0	9000
14975	16	9632	56	14	0	9718
14976	26	58	26	9667	0	9777
14977	9651	19	24	48	0	9742
14978	51	9	9522	24	0	9606
14979	9146	7	40	34	0	9227
14980	44	9730	21	8	0	9803
14981	24	34	9	9993	0	10060
14982	17	11	11	10333	0	10372
14983	16	5	8	10184	0	10213
14984	10432	5	11	83	0	10531
14985	60	10	8	10444	0	10522
14986	29	6	7	10531	0	10573
14987	10499	2	9	86	0	10596
14988	64	6	8	10436	0	10514
14989	21	6	10510	72	0	10609
14990	10287	4	49	40	0	10380
14991	59	2	20	10584	0	10665
14992	22	5	19	10473	0	10519
14993	21	10370	7	67	0	10465
14994	10366	47	2	48	0	10463
14995	10482	10	7	33	0	10532
14996	75	14	6	10372	0	10467
14997	34	12	10251	57	0	10354
14998	9509	5	54	52	0	9620
14999	63	7	10198	30	0	10298
15000	31	2	73	10098	0	10204
15001	28	5	20	10395	0	10448
15002	10295	4	15	93	0	10407
15003	79	2	12	10592	0	10685
15004	36	1	10649	91	0	10777
15005	10455	2	65	52	0	10574
15006	75	3	11428	36	0	11542
15007	31	4	11304	18	0	11357
15008	11762	5	80	38	0	11885
15009	95	17	46	11973	0	12131
15010	39	12263	24	71	0	12397
15011	12357	65	14	42	0	12478
15012	12307	28	15	41	0	12391
15013	102	24	12273	19	0	12418
15014	12188	4	77	33	0	12302
15015	106	11	39	12395	0	12551
15016	47	8	12621	81	0	12757
15017	39	12201	72	55	0	12367
15018	12104	76	42	63	0	12285
15019	90	12328	30	26	0	12474
15020	67	87	19	12139	0	12312
15021	64	23	17	12150	0	12254
15022	40	27	16	12012	0	12095
15023	36	7	18	11755	0	11816
15024	23	11709	20	139	0	11891
15025	20	62	11509	67	0	11658
15026	24	11561	63	55	0	11703
15027	11569	85	30	41	0	11725
15028	84	35	30	11616	0	11765
15029	11661	32	12	101	0	11806
15030	106	16	17	11740	0	11879
15031	11945	15	18	132	0	12110
15032	100	12096	13	57	0	12266
15033	12356	78	19	72	0	12525
15034	12397	39	15	47	0	12498
15035	12127	36	19	46	0	12228
15036	12220	18	10	48	0	12296
15037	132	12125	11	42	0	12310
15038	83	77	12113	30	0	12303
15039	65	41	73	12104	0	12283
15040	12147	29	32	106	0	12314
15041	12374	24	32	60	0	12490
15042	132	20	19	12564	0	12735
15043	85	20	12941	92	0	13138
15044	71	21	82	12598	0	12772
15045	51	12916	40	110	0	13117
15046	13127	92	32	61	0	13312
15047	115	48	21	13257	0	13441
15048	62	13039	14	113	0	13228
15049	53	13611	22	56	0	13742
15050	40	13849	19	49	0	13957
15051	51	136	19	14128	0	14334
15052	14264	66	15	140	0	14485
15053	128	14424	16	60	0	14628
15054	71	126	13	14611	0	14821
15055	14470	58	16	146	0	14690
15056	137	44	15	14514	0	14710
15057	14485	28	4	167	0	14684
15058	14515	32	9	82	0	14638
15059	167	14915	15	59	0	15156
15060	112	125	11	14369	0	14617
15061	68	15026	19	96	0	15209
15062	14880	143	15	75	0	15113
15063	14937	60	9	61	0	15067
15064	15114	45	19	58	0	15236
15065	211	28	24	15128	0	15391
15066	110	47	14985	137	0	15279
15067	14636	30	118	89	0	14873
15068	15138	39	47	75	0	15299
15069	203	26	32	14959	0	15220
15070	117	15227	19	134	0	15497
15071	98	131	19	15347	0	15595
15072	76	60	20	15576	0	15732
15073	15527	45	21	193	0	15786
15074	15227	31	20	115	0	15393
15075	195	39	14722	65	0	15021
15076	121	27	125	14726	0	14999
15077	14931	37	45	162	0	15175
15078	172	41	33	15009	0	15255
15079	83	41	15041	191	0	15356
15080	80	14369	122	100	0	14671
15081	55	15075	46	84	0	15260
15082	15982	155	43	70	0	16250
15083	214	68	23	16991	0	17296
15084	119	36	23	18969	0	19147
15085	19082	33	20	346	0	19481
15086	320	32	19051	143	0	19546
15087	161	30	252	19207	0	19650
15088	102	44	19365	322	0	19833
15089	81	19334	282	149	0	19846
15090	19784	268	114	136	0	20302
15091	20177	112	65	118	0	20472
15092	20392	71	66	89	0	20618
15093	442	59	19975	111	0	20587
15094	20187	59	293	97	0	20636
15095	20702	56	147	80	0	20985
15096	492	55	65	20471	0	21083
15097	16463	76	159	410	0	17108
15098	330	57	20155	147	0	20689
15099	19939	45	281	120	0	20385
15100	432	50	20169	82	0	20733
15101	244	20436	300	83	0	21063
15102	210	479	146	19106	0	19941
15103	168	20287	82	270	0	20807
15104	158	292	20004	110	0	20564
15105	129	20064	279	126	0	20598
15106	19041	321	134	108	0	19604
15107	297	18669	101	69	0	19136
15108	156	18521	73	60	0	18810
15109	95	342	18174	58	0	18669
15110	121	197	282	17981	0	18581
15111	18237	123	108	279	0	18747
15112	295	127	18136	108	0	18666
15113	133	18261	292	92	0	18778
15114	126	310	105	18210	0	18751
15115	115	123	18390	276	0	18904
15116	100	96	18057	131	0	18384
15117	130	89	340	18236	0	18795
15118	90	71	18380	298	0	18839
15119	91	73	338	17243	0	17745
15120	88	17422	161	299	0	17970
15121	101	251	141	17811	0	18304
15122	73	18026	127	293	0	18519
15123	91	289	90	18159	0	18629
15124	18019	123	95	346	0	18583
15125	295	87	87	17959	0	18428
15126	135	17842	67	361	0	18405
15127	116	276	76	18264	0	18732
15128	103	116	18035	363	0	18617
15129	84	117	278	18172	0	18651
15130	18071	83	111	378	0	18643
15131	290	98	17523	175	0	18086
15132	147	74	280	17542	0	18043
15133	17221	66	127	355	0	17769
15134	298	17147	121	179	0	17745
15135	168	272	97	17258	0	17795
15136	17345	118	76	363	0	17902
15137	340	77	109	17332	0	17858
15138	153	86	17148	352	0	17739
15139	16696	76	272	196	0	17240
15140	324	17031	150	141	0	17646
15141	144	17272	98	155	0	17669
15142	17205	314	115	120	0	17754
15143	16826	151	87	135	0	17199
15144	391	126	73	16670	0	17260
15145	16676	84	88	284	0	17132
15146	344	102	16035	159	0	16640
15147	15982	82	275	137	0	16476
15148	355	16014	109	124	0	16602
15149	15934	253	103	120	0	16410
15150	341	123	15759	114	0	16337
15151	243	152	274	15622	0	16291
15152	188	86	139	15767	0	16180
15153	166	77	126	14763	0	15132
15154	159	15403	119	309	0	15990
15155	15525	241	84	192	0	16042
15156	353	108	115	14627	0	15203
15157	169	14897	98	300	0	15464
15158	15924	246	65	216	0	16451
15159	15482	121	111	164	0	15878
15160	15755	111	62	177	0	16105
15161	15649	99	88	161	0	15997
15162	15451	86	81	165	0	15783
15163	387	110	80	15276	0	15853
15164	278	106	75	15226	0	15685
15165	15042	85	63	350	0	15540
15166	346	115	81	15040	0	15582
15167	243	109	52	15124	0	15528
15168	189	86	14212	362	0	14849
15169	14712	106	239	206	0	15263
15170	14922	93	131	222	0	15368
15171	15065	113	94	165	0	15437
15172	384	86	102	13989	0	14561
15173	189	14506	103	342	0	15140
15174	15579	231	109	198	0	16117
15175	14967	112	107	211	0	15397
15176	404	117	93	16444	0	17058
15177	16762	84	110	359	0	17315
15178	504	221	12689	273	0	13687
15179	245	16820	237	197	0	17499
15180	341	17272	119	214	0	17946
15181	384	381	16845	174	0	17784
15182	134	15506	289	177	0	16106
15183	174	14606	173	188	0	15141
15184	12651	207	210	93	0	13161
15185	159	12573	59	83	0	12874
15186	134	172	44	12673	0	13023
15187	12809	106	23	189	0	13127
15188	178	60	12440	126	0	12804
15189	12331	63	120	112	0	12626
15190	182	58	12199	104	0	12543
15191	124	44	11990	86	0	12244
15192	11711	43	180	89	0	12023
15193	180	29	12061	80	0	12350
15194	111	11794	143	61	0	12109
15195	93	122	104	11645	0	11964
15196	11676	66	56	149	0	11947
15197	161	11382	37	84	0	11664
15198	110	133	35	11489	0	11767
15199	83	93	11398	139	0	11713
15200	112	37	108	11482	0	11739
15201	11252	36	63	171	0	11522
15202	178	32	11131	112	0	11453
15203	153	25	135	11023	0	11336
15204	11144	39	69	165	0	11417
15205	11425	40	33	102	0	11600
15206	224	30	41	11349	0	11644
15207	164	19	24	11406	0	11613
15208	116	28	11550	189	0	11883
15209	98	15	11232	127	0	11472
15210	11405	12	174	79	0	11670
15211	11668	18	79	56	0	11821
15212	215	11530	41	41	0	11827
15213	11492	114	41	29	0	11676
15214	11740	55	33	42	0	11870
15215	198	40	12183	47	0	12468
15216	113	12471	121	61	0	12766
15217	12591	136	84	37	0	12848
15218	12691	65	30	30	0	12816
15219	12975	32	16	33	0	13056
15220	232	26	16	12780	0	13054
15221	122	16	9	12839	0	12986
15222	74	12715	13	224	0	13026
15223	59	130	8	12944	0	13141
15224	12857	64	11	182	0	13114
15225	162	34	8	12933	0	13137
15226	86	25	12703	177	0	12991
15227	57	16	12461	95	0	12629
15228	56	14	174	12616	0	12860
15229	33	15	12794	169	0	13011
15230	36	13	12631	89	0	12769
15231	42	15	220	12603	0	12880
15232	43	7	107	12955	0	13112
15233	33	12	12997	200	0	13242
15234	30	14	12899	105	0	13048
15235	59	12975	209	59	0	13302
15236	13128	129	101	64	0	13422
15237	152	13419	58	30	0	13659
15238	13402	160	44	40	0	13646
15239	13578	79	25	44	0	13726
15240	210	13620	17	26	0	13873
15241	13704	158	17	27	0	13906
15242	192	77	19	13580	0	13868
15243	97	53	13786	153	0	14089
15244	86	29	144	13663	0	13922
15245	53	24	75	13934	0	14086
15246	13486	14	49	239	0	13788
15247	13669	11	33	129	0	13842
15248	13699	9	29	85	0	13822
15249	13693	16	20	67	0	13796
15250	13248	7	22	51	0	13328
15251	260	12895	24	34	0	13213
15252	137	141	18	13149	0	13445
15253	84	65	13264	162	0	13575
15254	83	37	153	13270	0	13543
15255	68	33	67	13308	0	13476
15256	64	20	39	13851	0	13974
15257	14214	15	44	270	0	14543
15258	214	18	30	14332	0	14594
15259	14604	18	22	287	0	14931
15260	251	22	14976	135	0	15384
15261	146	13	214	17048	0	17421
15262	91	12	17740	340	0	18183
15263	17757	9	329	156	0	18251
15264	348	14	133	17939	0	18434
15265	139	23	18114	354	0	18630
15266	122	11	340	18217	0	18690
15267	18365	12	138	398	0	18913
15268	346	15	18080	172	0	18613
15269	18346	13	325	124	0	18808
15270	18819	9	143	101	0	19072
15271	18726	12	88	97	0	18923
15272	18523	9	74	91	0	18697
15273	480	17958	71	65	0	18574
15274	222	17196	42	74	0	17534
15275	176	16757	49	63	0	17045
15276	164	674	113	15098	0	16049
15277	92	15477	59	240	0	15868
15278	15037	278	56	91	0	15462
15279	287	14684	31	71	0	15073
15280	125	14986	52	56	0	15219
15281	113	302	45	14849	0	15309
15282	94	127	42	15170	0	15433
15283	14972	71	47	328	0	15418
15284	302	58	48	14979	0	15387
15285	141	50	14687	317	0	15195
15286	107	45	14045	146	0	14343
15287	102	47	14556	112	0	14817
15288	135	30	304	14483	0	14952
15289	127	31	131	15290	0	15579
15290	128	33	14969	332	0	15462
15291	118	52	14715	140	0	15025
15292	109	49	15327	88	0	15573
15293	15419	65	349	98	0	15931
15294	313	56	136	15624	0	16129
15295	127	66	97	15887	0	16177
15296	15758	70	70	388	0	16286
15297	306	56	57	15695	0	16114
15298	134	15444	60	349	0	15987
15299	103	16059	73	163	0	16398
15300	103	323	49	15961	0	16436
15301	15896	128	42	361	0	16427
15302	15991	74	46	194	0	16305
15303	16125	58	64	156	0	16403
15304	388	48	72	15872	0	16380
15305	174	35	15642	347	0	16198
15306	145	37	300	15617	0	16099
15307	102	34	15625	362	0	16123
15308	15051	30	350	195	0	15626
15309	340	28	167	15320	0	15855
15310	14853	27	138	372	0	15390
15311	329	31	15225	188	0	15773
15312	14536	28	328	141	0	15033
15313	379	24	15428	143	0	15974
15314	211	14611	319	116	0	15257
15315	172	14686	133	117	0	15108
15316	14286	299	127	132	0	14844
15317	377	129	71	14203	0	14780
15318	167	87	14273	307	0	14834
15319	123	13978	247	142	0	14490
15320	133	14447	113	95	0	14788
15321	143	321	71	14288	0	14823
15322	14363	132	58	332	0	14885
15323	14457	88	72	142	0	14759
15324	353	14312	65	179	0	14909
15325	14466	272	75	131	0	14944
15326	334	109	90	14409	0	14942
15327	164	92	14332	325	0	14913
15328	137	14457	286	161	0	15041
15329	131	264	139	14453	0	14987
15330	134	92	97	14644	0	14967
15331	14439	67	100	376	0	14982
15332	334	66	14339	148	0	14887
15333	14240	77	290	128	0	14735
15334	14483	52	144	121	0	14800
15335	391	67	112	14235	0	14805
15336	200	72	91	14423	0	14786
15337	14008	78	74	372	0	14532
15338	359	69	59	14042	0	14529
15339	161	65	13809	358	0	14393
15340	115	71	13665	172	0	14023
15341	127	13488	306	117	0	14038
15342	121	14264	110	137	0	14632
15343	146	311	77	13377	0	13911
15344	131	13519	77	283	0	14010
15345	13780	279	72	175	0	14306
15346	298	13927	69	125	0	14419
15347	158	290	60	13936	0	14444
15348	101	125	67	14187	0	14480
15349	90	98	13928	383	0	14499
15350	118	72	272	13865	0	14327
15351	112	54	120	14113	0	14399
15352	104	14180	98	378	0	14760
15353	121	261	91	14251	0	14724
15354	114	104	86	14584	0	14888
15355	130	68	14225	396	0	14819
15356	88	13958	284	208	0	14538
15357	103	894	100	12369	0	13466
15358	69	13131	64	272	0	13536
15359	67	216	12607	138	0	13028
15360	50	12048	221	123	0	12442
15361	9598	262	212	147	0	10219
15362	9284	47	29	38	0	9398
15363	9234	38	13	26	0	9311
15364	122	9132	18	27	0	9299
15365	9040	97	10	35	0	9182
15366	106	44	15	8931	0	9096
15367	8754	22	11	103	0	8890
15368	100	8652	13	45	0	8810
15369	8676	94	14	32	0	8816
15370	8909	41	14	25	0	8989
15371	110	9078	6	41	0	9235
15372	63	92	9165	26	0	9346
15373	46	49	86	9663	0	9844
15374	34	23	10307	122	0	10486
15375	40	17	131	10652	0	10840
15376	35	21	56	11201	0	11313
15377	20	18	11387	207	0	11632
15378	27	16	162	11546	0	11751
15379	11568	25	72	199	0	11864
15380	166	24	11641	85	0	11916
15381	65	11618	161	60	0	11904
15382	48	167	69	11440	0	11724
15383	43	65	36	11768	0	11912
15384	30	32	11623	232	0	11917
15385	46	22	167	11312	0	11547
15386	23	11516	72	202	0	11813
15387	11305	165	40	112	0	11622
15388	156	11369	27	63	0	11615
15389	10772	165	28	51	0	11016
15390	151	10790	20	45	0	11006
15391	60	11057	14	47	0	11178
15392	50	185	10533	32	0	10800
15393	49	128	175	10327	0	10679
15394	33	44	62	10232	0	10371
15395	28	28	31	10571	0	10658
15396	17	11012	21	206	0	11256
15397	25	189	21	11095	0	11330
15398	11274	72	25	232	0	11603
15399	206	46	18	11301	0	11571
15400	11304	31	18	263	0	11616
15401	231	23	11320	109	0	11683
15402	11416	25	194	92	0	11727
15403	246	20	76	11454	0	11796
15404	99	30	45	11951	0	12125
15405	12040	34	26	300	0	12400
15406	240	21	12147	132	0	12540
15407	92	12059	224	86	0	12461
15408	87	213	82	12259	0	12641
15409	12196	87	45	258	0	12586
15410	12403	61	32	103	0	12599
15411	305	38	27	12240	0	12610
15412	123	41	12141	255	0	12560
15413	11730	46	217	125	0	12118
15414	250	32	11896	87	0	12265
15415	130	49	250	11811	0	12240
15416	75	29	11887	260	0	12251
15417	57	49	247	11770	0	12123
15418	50	33	11572	289	0	11944
15419	59	11504	249	126	0	11938
15420	61	217	105	10564	0	10947
15421	44	11512	70	208	0	11834
15422	11464	239	50	115	0	11868
15423	11608	83	51	92	0	11834
15424	294	60	11339	61	0	11754
15425	138	43	231	11330	0	11742
15426	11424	36	94	259	0	11813
15427	262	42	63	11338	0	11705
15428	130	36	49	11352	0	11567
15429	92	30	11047	315	0	11484
15430	10774	27	239	171	0	11211
15431	263	27	11093	108	0	11491
15432	142	23	245	11016	0	11426
15433	95	32	11102	262	0	11491
15434	10927	21	257	149	0	11354
15435	11085	25	118	116	0	11344
15436	11041	24	93	84	0	11242
15437	327	26	73	10881	0	11307
15438	146	27	10747	265	0	11185
15439	97	30	10792	145	0	11064
15440	110	54	289	10255	0	10708
15441	72	10572	141	260	0	11045
15442	10340	211	95	128	0	10774
15443	256	97	73	10400	0	10826
15444	135	69	10324	270	0	10798
15445	127	40	241	10400	0	10808
15446	87	37	10581	305	0	11010
15447	93	53	278	10692	0	11116
15448	80	25	10732	310	0	11147
15449	97	34	10761	165	0	11057
15450	78	10596	306	136	0	11116
15451	77	211	10596	116	0	11000
15452	75	93	10617	104	0	10889
15453	117	97	296	8980	0	9490
15454	83	29	157	9705	0	9974
15455	69	10030	116	270	0	10485
15456	10011	192	91	152	0	10446
15457	238	10009	91	114	0	10452
15458	143	215	90	10019	0	10467
15459	10069	82	74	254	0	10479
15460	248	50	94	10098	0	10490
15461	10092	37	90	285	0	10504
15462	268	28	82	10248	0	10626
15463	124	46	10260	278	0	10708
15464	106	47	227	10337	0	10717
15465	88	41	124	10491	0	10744
15466	10344	35	109	321	0	10809
15467	10428	31	87	183	0	10729
15468	10316	29	84	141	0	10570
15469	300	9928	89	107	0	10424
15470	141	9944	84	101	0	10270
15471	9883	220	80	110	0	10293
15472	253	82	9865	90	0	10290
15473	104	65	9523	85	0	9777
15474	121	296	240	8549	0	9206
15475	68	35	8627	178	0	8908
15476	53	28	8227	90	0	8398
15477	7862	41	228	88	0	8219
15478	7926	19	100	68	0	8113
15479	186	7898	76	55	0	8215
15480	98	8064	49	66	0	8277
15481	85	168	62	7142	0	7457
15482	62	7999	51	133	0	8245
15483	8180	154	42	75	0	8451
15484	170	63	40	7907	0	8180
15485	80	8150	39	156	0	8425
15486	8330	140	43	70	0	8583
15487	166	58	8344	73	0	8641
15488	74	49	8271	45	0	8439
15489	8234	21	188	77	0	8520
15490	170	34	8156	45	0	8405
15491	8138	29	154	60	0	8381
15492	193	29	65	8175	0	8462
15493	78	29	8200	151	0	8458
15494	57	7974	167	74	0	8272
15495	52	8164	81	56	0	8353
15496	7387	114	68	40	0	7609
15497	113	7507	29	33	0	7682
15498	7132	84	29	22	0	7267
15499	7097	27	33	32	0	7189
15500	97	7039	21	21	0	7178
15501	47	87	24	6999	0	7157
15502	32	20	7146	78	0	7276
15503	22	7384	83	22	0	7511
15504	34	232	38	7279	0	7583
15505	25	44	16	7766	0	7851
15506	7559	9	8	112	0	7688
15507	98	4	13	7528	0	7643
15508	30	10	7505	98	0	7643
15509	15	7516	86	38	0	7655
15510	21	84	28	7586	0	7719
15511	7675	27	17	104	0	7823
15512	7863	13	9	52	0	7937
15513	123	13	14	7879	0	8029
15514	8121	14	13	111	0	8259
15515	109	12	8185	41	0	8347
15516	63	12	103	8160	0	8338
15517	28	7	8323	112	0	8470
15518	28	13	106	8886	0	9033
15519	28	4	44	8939	0	9015
15520	26	14	25	8987	0	9052
15521	27	11	13	9038	0	9089
15522	24	5	15	9029	0	9073
15523	8925	8	12	200	0	9145
15524	9031	7	14	84	0	9136
15525	164	8990	10	66	0	9230
15526	9113	116	20	53	0	9302
15527	156	50	9	9110	0	9325
15528	65	12	19	9296	0	9392
15529	57	14	8	9269	0	9348
15530	45	18	9306	179	0	9548
15531	51	12	126	8932	0	9121
15532	35	9208	44	157	0	9444
15533	9225	125	28	94	0	9472
15534	9251	44	15	72	0	9382
15535	173	13	9158	44	0	9388
15536	61	9149	125	59	0	9394
15537	43	125	50	9152	0	9370
15538	39	50	9224	161	0	9474
15539	56	25	131	8795	0	9007
15540	26	9099	56	158	0	9339
15541	8901	132	36	89	0	9158
15542	155	8998	23	62	0	9238
15543	69	149	8983	62	0	9263
15544	57	60	8933	56	0	9106
15545	42	8834	164	46	0	9086
15546	28	8864	53	57	0	9002
15547	8622	166	38	51	0	8877
15548	8657	62	33	47	0	8799
15549	166	33	29	8636	0	8864
15550	66	35	8605	154	0	8860
15551	58	34	133	8555	0	8780
15552	63	26	46	8631	0	8766
15553	8514	30	33	200	0	8777
15554	8478	30	33	90	0	8631
15555	179	21	30	8801	0	9031
15556	72	29	8881	162	0	9144
15557	39	8928	137	94	0	9198
15558	8945	151	54	55	0	9205
15559	173	9216	29	54	0	9472
15560	79	161	31	9390	0	9661
15561	46	71	33	9730	0	9880
15562	40	36	39	9668	0	9783
15563	45	43	36	9521	0	9645
15564	9342	48	21	240	0	9651
15565	187	28	24	9338	0	9577
15566	95	9214	23	199	0	9531
15567	65	149	22	9311	0	9547
15568	9101	63	38	213	0	9415
15569	176	9135	34	105	0	9450
15570	83	161	22	9193	0	9459
15571	63	61	8992	199	0	9315
15572	8867	42	143	102	0	9154
15573	176	51	49	8956	0	9232
15574	89	34	8795	201	0	9119
15575	72	49	8630	93	0	8844
15576	80	82	184	8582	0	8928
15577	8578	44	109	186	0	8917
15578	8634	31	51	110	0	8826
15579	184	8761	31	92	0	9068
15580	8665	132	28	106	0	8931
15581	8730	55	29	108	0	8922
15582	8735	31	31	90	0	8887
15583	8647	20	24	91	0	8782
15584	215	46	22	8530	0	8813
15585	121	40	20	8591	0	8772
15586	99	29	8271	193	0	8592
15587	70	7885	127	107	0	8189
15588	56	8094	58	97	0	8305
15589	63	147	8055	88	0	8353
15590	7909	61	137	73	0	8180
15591	144	42	67	8030	0	8283
15592	8056	42	46	170	0	8314
15593	8074	34	37	87	0	8232
15594	190	49	7931	65	0	8235
15595	110	34	125	7913	0	8182
15596	8022	24	63	147	0	8256
15597	176	30	36	7948	0	8190
15598	89	40	7956	168	0	8253
15599	77	221	133	7537	0	7968
15600	63	7985	59	152	0	8259
15601	64	8122	38	85	0	8309
15602	62	148	7859	55	0	8124
15603	48	7571	113	66	0	7798
15604	7048	146	96	77	0	7367
15605	6885	37	50	46	0	7018
15606	119	27	17	6824	0	6987
15607	68	19	25	6891	0	7003
15608	44	18	25	6929	0	7016
15609	6791	21	19	127	0	6958
15610	105	6781	18	70	0	6974
15611	6689	80	14	35	0	6818
15612	6578	43	13	34	0	6668
15613	116	6575	17	38	0	6746
15614	6271	67	13	27	0	6378
15615	99	6306	12	20	0	6437
15616	6302	70	11	35	0	6418
15617	85	22	6261	36	0	6404
15618	5495	58	77	30	0	5660
15619	56	5639	16	16	0	5727
15620	60	54	31	5579	0	5724
15621	24	18	4	5787	0	5833
15622	17	11	5	5817	0	5850
15623	5953	3	10	77	0	6043
15624	59	7	3	6031	0	6100
15625	29	12	5947	63	0	6051
15626	5814	12	53	31	0	5910
15627	59	11	5928	19	0	6017
15628	30	19	59	5903	0	6011
15629	28	10	6031	62	0	6131
15630	18	29	52	5827	0	5926
15631	9	5915	20	65	0	6009
15632	17	51	18	5862	0	5948
15633	19	5897	8	67	0	5991
15634	28	55	8	5965	0	6056
15635	5985	16	11	72	0	6084
15636	63	15	12	6150	0	6240
15637	6144	4	7	78	0	6233
15638	76	12	5990	20	0	6098
15639	6024	10	48	31	0	6113
15640	6126	10	18	17	0	6171
15641	6144	8	12	25	0	6189
15642	83	6	9	6171	0	6269
15643	6058	9	10	70	0	6147
15644	72	16	5947	17	0	6052
15645	5903	5	54	31	0	5993
15646	73	11	5916	22	0	6022
15647	5957	3	55	21	0	6036
15648	81	11	12	6120	0	6224
15649	30	13	6205	60	0	6308
15650	35	6	53	6172	0	6266
15651	25	3	28	6252	0	6308
15652	33	4	6247	74	0	6358
15653	5882	5	60	46	0	5993
15654	69	6298	24	23	0	6414
15655	6148	48	21	27	0	6244
15656	58	6033	12	19	0	6122
15657	5940	51	9	23	0	6023
15658	57	11	5869	15	0	5952
15659	5331	58	74	25	0	5488
15660	38	5425	18	15	0	5496
15661	34	23	15	5321	0	5393
15662	11	7	4	5481	0	5503
15663	17	4	6	5506	0	5533
15664	12	3	5524	38	0	5577
15665	15	5	32	5491	0	5543
15666	12	4	5749	36	0	5801
15667	5947	7	27	19	0	6000
15668	6392	3	14	18	0	6427
15669	70	8	9	6538	0	6625
15670	19	5	6610	65	0	6699
15671	6505	0	57	29	0	6591
15672	60	3	7832	14	0	7909
15673	29	0	69	7784	0	7882
15674	19	2	17	8050	0	8088
15675	18	1	14	8244	0	8277
15676	18	4	10	8339	0	8371
15677	8127	4	13	117	0	8261
15678	83	8180	8	39	0	8310
15679	31	68	7945	21	0	8065
15680	20	7976	71	21	0	8088
15681	8037	71	22	21	0	8151
15682	90	20	12	8036	0	8158
15683	8118	11	12	102	0	8243
15684	95	7	14	8156	0	8272
15685	36	10	12	8185	0	8243
15686	27	5	7	8203	0	8242
15687	15	14	8097	121	0	8247
15688	25	8008	79	53	0	8165
15689	17	77	8175	35	0	8304
15690	27	20	79	8199	0	8325
15691	8311	13	30	109	0	8463
15692	8256	14	19	62	0	8351
15693	8351	8	15	50	0	8424
15694	105	8313	18	36	0	8472
15695	8477	86	6	40	0	8609
15696	100	18	22	8502	0	8642
15697	36	25	9	8611	0	8681
15698	45	10	18	8558	0	8631
15699	29	8573	16	124	0	8742
15700	42	80	12	8206	0	8340
15701	22	8408	19	103	0	8552
15702	8372	85	14	55	0	8526
15703	8405	24	17	52	0	8498
15704	127	18	11	8413	0	8569
15705	50	22	8293	110	0	8475
15706	8229	18	88	53	0	8388
15707	106	17	21	8434	0	8578
15708	44	24	8394	114	0	8576
15709	8173	11	85	67	0	8336
15710	114	17	21	8496	0	8648
15711	8482	16	26	120	0	8644
15712	110	8465	13	56	0	8644
15713	56	98	19	8360	0	8533
15714	45	8621	19	107	0	8792
15715	50	119	12	8643	0	8824
15716	30	8688	18	124	0	8860
15717	38	83	24	8758	0	8903
15718	40	37	8595	109	0	8781
15719	7333	24	86	81	0	7524
15720	100	8517	25	45	0	8687
15721	43	82	8338	36	0	8499
15722	8219	20	82	56	0	8377
15723	106	28	21	8467	0	8622
15724	40	21	8443	98	0	8602
15725	30	8495	82	41	0	8648
15726	34	80	16	8582	0	8712
15727	28	29	8637	98	0	8792
15728	34	28	71	8616	0	8749
15729	31	26	20	8726	0	8803
15730	34	15	8863	101	0	9013
15731	29	32	73	8897	0	9031
15732	19	26	9034	109	0	9188
15733	31	26	83	9071	0	9211
15734	29	15	9301	122	0	9467
15735	34	19	87	9285	0	9425
15736	42	18	39	9248	0	9347
15737	28	20	30	9159	0	9237
15738	34	9110	28	112	0	9284
15739	9133	80	33	71	0	9317
15740	9250	26	27	80	0	9383
15741	109	22	29	9325	0	9485
15742	9356	16	31	132	0	9535
15743	95	18	9348	73	0	9534
15744	37	9416	82	65	0	9600
15745	9488	74	36	87	0	9685
15746	94	9554	30	54	0	9732
15747	41	90	21	9660	0	9812
15748	31	33	27	9697	0	9788
15749	9404	31	26	127	0	9588
15750	98	22	18	9480	0	9618
15751	55	17	9395	107	0	9574
15752	46	9306	80	54	0	9486
15753	9452	82	26	69	0	9629
15754	99	24	25	9375	0	9523
15755	37	9515	20	112	0	9684
15756	52	78	20	9405	0	9555
15757	29	9628	21	106	0	9784
15758	9597	91	28	74	0	9790
15759	9558	38	16	75	0	9687
15760	107	28	9447	50	0	9632
15761	61	23	9289	49	0	9422
15762	52	23	83	9337	0	9495
15763	32	9467	33	95	0	9627
15764	47	77	34	9594	0	9752
15765	9543	27	17	131	0	9718
15766	86	29	9358	54	0	9527
15767	41	40	58	8990	0	9129
15768	22	16	8839	72	0	8949
15769	39	18	8433	34	0	8524
15770	27	8821	50	24	0	8922
15771	108	166	44	8339	0	8657
15772	7533	26	26	62	0	7647
15773	31	4	7567	14	0	7616
15774	14	7429	25	17	0	7485
15775	7327	18	12	22	0	7379
15776	22	13	3	7379	0	7417
15777	7589	0	6	50	0	7645
15778	7591	6	3	26	0	7626
15779	7659	6	4	18	0	7687
15780	28	3	8036	3	0	8070
15781	7776	4	21	18	0	7819
15782	8082	4	15	16	0	8117
15783	37	8171	4	10	0	8222
15784	22	23	6	8239	0	8290
15785	10	14	6	8204	0	8234
15786	12	4	3	8383	0	8402
15787	8488	3	2	39	0	8532
15788	8282	2	2	36	0	8322
15789	46	5	8381	5	0	8437
15790	25	3	22	8317	0	8367
15791	10	8280	18	31	0	8339
15792	8348	23	3	37	0	8411
15793	35	15	8393	6	0	8449
15794	33	4	21	8227	0	8285
15795	11	4	14	8254	0	8283
15796	12	8258	5	39	0	8314
15797	18	24	6	8282	0	8330
15798	20	21	9	7966	0	8016
15799	14	3	6	8323	0	8346
15800	8253	7	8	64	0	8332
15801	35	4	6	8202	0	8247
15802	29	3	6	8220	0	8258
15803	8329	9	7	65	0	8410
15804	36	4	6	8301	0	8347
15805	29	8890	6	43	0	8968
15806	9275	60	2	55	0	9392
15807	9711	30	2	36	0	9779
15808	10060	8	3	42	0	10113
15809	10963	5	3	38	0	11009
15810	170	11874	8	21	0	12073
15811	13322	142	2	43	0	13509
15812	13541	60	6	29	0	13636
15813	303	31	3	13391	0	13728
15814	108	34	13210	228	0	13580
15815	112	12	203	13155	0	13482
15816	90	11	54	13301	0	13456
15817	68	14	32	13217	0	13331
15818	63	3	34	13254	0	13354
15819	41	6	20	13331	0	13398
15820	12915	11	18	378	0	13322
15821	251	9	10	13077	0	13347
15822	86	9	12993	328	0	13416
15823	61	6	215	12768	0	13050
15824	52	12827	61	281	0	13221
15825	47	218	34	12906	0	13205
15826	36	72	12906	281	0	13295
15827	11985	33	231	148	0	12397
15828	12605	39	79	107	0	12830
15829	291	22	12844	83	0	13240
15830	115	12749	235	49	0	13148
15831	12896	220	77	69	0	13262
15832	12965	65	52	65	0	13147
15833	13017	34	46	55	0	13152
15834	12822	36	18	51	0	12927
15835	398	17	22	12506	0	12943
15836	176	26	12539	249	0	12990
15837	171	22	225	12665	0	13083
15838	145	17	76	13020	0	13258
15839	92	33	12750	356	0	13231
15840	80	37	12781	153	0	13051
15841	12629	14	308	135	0	13086
15842	293	12809	128	111	0	13341
15843	143	245	97	12841	0	13326
15844	103	75	12718	336	0	13232
15845	12373	41	283	189	0	12886
15846	298	43	12646	135	0	13122
15847	12473	24	305	163	0	12965
15848	310	12622	133	144	0	13209
15849	177	247	80	12714	0	13218
15850	122	85	12559	342	0	13108
15851	12269	68	264	199	0	12800
15852	333	12321	127	134	0	12915
15853	150	12930	90	117	0	13287
15854	138	317	93	12820	0	13368
15855	134	120	78	13254	0	13586
15856	13475	113	63	392	0	14043
15857	368	13499	60	197	0	14124
15858	201	319	74	13795	0	14389
15859	13779	112	59	419	0	14369
15860	14293	79	69	191	0	14632
15861	14653	69	42	182	0	14946
15862	514	65	14720	174	0	15473
15863	291	53	15089	138	0	15571
15864	15907	32	387	186	0	16512
15865	499	15884	175	164	0	16722
15866	232	16253	132	176	0	16793
15867	201	434	105	15395	0	16135
15868	148	16069	115	475	0	16807
15869	16102	439	119	234	0	16894
15870	494	181	110	16078	0	16863
15871	212	154	15909	495	0	16770
15872	16001	126	435	233	0	16795
15873	16362	111	193	203	0	16869
15874	623	124	138	16008	0	16893
15875	352	99	130	16228	0	16809
15876	270	115	116	16348	0	16849
15877	270	91	113	16200	0	16674
15878	221	115	15320	649	0	16305
15879	225	15230	419	324	0	16198
15880	238	404	165	14143	0	14950
15881	203	15082	136	519	0	15940
15882	209	451	124	14011	0	14795
15883	166	14896	123	498	0	15683
15884	14864	468	91	321	0	15744
15885	14958	225	88	277	0	15548
15886	537	14706	120	291	0	15654
15887	14750	457	133	226	0	15566
15888	621	191	108	14697	0	15617
15889	14543	215	104	508	0	15370
15890	572	14548	122	259	0	15501
15891	14655	492	101	182	0	15430
15892	14990	213	102	182	0	15487
15893	718	179	118	14425	0	15440
15894	361	179	14411	463	0	15414
15895	309	14347	411	234	0	15301
15896	265	485	173	14466	0	15389
15897	14568	222	137	508	0	15435
15898	521	214	14300	289	0	15324
15899	308	173	398	14242	0	15121
15900	275	167	164	14588	0	15194
15901	14467	129	134	611	0	15341
15902	14644	121	124	349	0	15238
15903	14454	131	107	299	0	14991
15904	624	14071	134	265	0	15094
15905	13654	372	86	244	0	14356
15906	534	179	12915	234	0	13862
15907	308	140	12437	207	0	13092
15908	241	128	12278	212	0	12859
15909	300	605	487	10524	0	11916
15910	196	74	10196	311	0	10777
15911	8808	68	192	114	0	9182
15912	246	64	71	8869	0	9250
15913	167	63	8979	197	0	9406
15914	9159	60	184	117	0	9520
15915	274	49	81	9211	0	9615
15916	132	65	101	9403	0	9701
15917	9451	40	69	245	0	9805
15918	217	45	96	9632	0	9990
15919	133	49	9616	239	0	10037
15920	121	45	199	9723	0	10088
15921	102	51	9795	259	0	10207
15922	119	29	220	9721	0	10089
15923	9680	29	96	257	0	10062
15924	218	9360	81	175	0	9834
15925	145	9628	70	133	0	9976
15926	132	196	58	9559	0	9945
15927	127	86	56	9538	0	9807
15928	94	9318	53	296	0	9761
15929	118	9332	73	128	0	9651
15930	80	195	71	9235	0	9581
15931	84	78	82	9304	0	9548
15932	9049	57	77	284	0	9467
15933	209	8977	64	148	0	9398
15934	98	8860	60	141	0	9159
15935	109	9235	47	99	0	9490
15936	8898	216	64	124	0	9302
15937	190	99	8910	106	0	9305
15938	8760	83	173	130	0	9146
15939	206	67	76	8768	0	9117
15940	103	8390	53	215	0	8761
15941	90	8775	46	133	0	9044
15942	8698	178	46	112	0	9034
15943	192	97	50	8493	0	8832
15944	116	9171	59	190	0	9536
15945	9329	179	64	115	0	9687
15946	9453	97	53	102	0	9705
15947	224	78	9245	95	0	9642
15948	9389	57	137	83	0	9666
15949	9577	72	82	90	0	9821
15950	225	81	42	9353	0	9701
15951	133	9178	43	195	0	9549
15952	93	9407	28	141	0	9669
15953	95	238	41	9162	0	9536
15954	8925	110	25	202	0	9262
15955	219	72	8164	110	0	8565
15956	142	62	8253	80	0	8537
15957	156	51	8032	49	0	8288
15958	141	43	8161	62	0	8407
15959	70	8089	156	50	0	8365
15960	75	8011	94	67	0	8247
15961	134	168	7391	64	0	7757
15962	83	128	7075	67	0	7353
15963	38	6379	111	38	0	6566
15964	47	44	61	5895	0	6047
15965	8	31	6131	33	0	6203
15966	15	12	27	5951	0	6005
15967	13	7	28	6284	0	6332
15968	12	8	16	6391	0	6427
15969	10	6	5	6622	0	6643
15970	7	10	6568	76	0	6661
15971	10	3	44	6432	0	6489
15972	6536	5	33	62	0	6636
15973	49	10	6480	29	0	6568
15974	6588	4	43	29	0	6664
15975	59	6	34	6734	0	6833
15976	33	6	6792	52	0	6883
15977	6751	4	45	37	0	6837
15978	60	5	36	6870	0	6971
15979	6954	7	21	59	0	7041
15980	64	5	13	6904	0	6986
15981	34	6882	14	72	0	7002
15982	22	44	7107	41	0	7214
15983	19	32	52	7165	0	7268
15984	7199	26	35	66	0	7326
15985	7230	14	15	55	0	7314
15986	7249	9	18	43	0	7319
15987	7188	12	15	22	0	7237
15988	7143	9	9	27	0	7188
15989	89	7125	15	23	0	7252
15990	7188	51	12	28	0	7279
15991	70	37	7085	17	0	7209
15992	7107	22	54	29	0	7212
15993	73	18	38	6896	0	7025
15994	38	15	7077	59	0	7189
15995	31	20	7004	37	0	7092
15996	30	12	87	7036	0	7165
15997	7144	9	55	64	0	7272
15998	73	7100	23	40	0	7236
15999	7175	54	19	34	0	7282
16000	75	7206	18	19	0	7318
16001	56	67	19	7374	0	7516
16002	39	38	13	7483	0	7573
16003	7475	21	16	95	0	7607
16004	71	12	15	7534	0	7632
16005	56	13	7502	75	0	7646
16006	7444	13	58	54	0	7569
16007	75	6	39	7633	0	7753
16008	68	10	19	7591	0	7688
16009	39	10	7567	97	0	7713
16010	7053	11	58	74	0	7196
16011	7503	12	45	32	0	7592
16012	93	7521	23	30	0	7667
16013	67	54	7383	22	0	7526
16014	29	35	7252	25	0	7341
16015	38	56	85	7171	0	7350
16016	37	23	51	7149	0	7260
16017	26	7182	24	86	0	7318
16018	26	49	7003	81	0	7159
16019	31	33	60	6863	0	6987
16020	30	13	7050	57	0	7150
16021	31	9	61	6824	0	6925
16022	20	6980	38	65	0	7103
16023	29	53	19	7142	0	7243
16024	22	28	11	7148	0	7209
16025	23	15	17	7099	0	7154
16026	7049	8	19	95	0	7171
16027	63	13	7028	50	0	7154
16028	46	7183	60	28	0	7317
16029	25	60	34	7551	0	7670
16030	7795	27	26	83	0	7931
16031	80	17	20	7966	0	8083
16032	8003	7	14	99	0	8123
16033	100	14	8118	50	0	8282
16034	8118	14	85	31	0	8248
16035	103	12	35	8402	0	8552
16036	48	13	8364	98	0	8523
16037	34	8291	81	58	0	8464
16038	29	76	36	8243	0	8384
16039	24	39	23	8395	0	8481
16040	8258	16	27	120	0	8421
16041	87	8197	22	58	0	8364
16042	47	7994	14	37	0	8092
16043	34	8238	18	23	0	8313
16044	7699	96	22	31	0	7848
16045	85	7665	16	25	0	7791
16046	46	82	12	7595	0	7735
16047	33	28	20	7598	0	7679
16048	7519	18	19	109	0	7665
16049	82	7446	17	43	0	7588
16050	38	75	16	7531	0	7660
16051	7644	30	8	104	0	7786
16052	7629	8	15	50	0	7702
16053	7595	14	10	35	0	7654
16054	102	7549	13	28	0	7692
16055	7395	73	14	27	0	7509
16056	86	42	9	7285	0	7422
16057	32	7135	14	88	0	7269
16058	21	7291	14	32	0	7358
16059	44	95	14	7221	0	7374
16060	7142	22	13	94	0	7271
16061	7231	11	6	38	0	7286
16062	88	16	9	7037	0	7150
16063	28	6965	16	76	0	7085
16064	6988	79	9	28	0	7104
16065	77	20	6830	24	0	6951
16066	32	19	6634	24	0	6709
16067	6554	18	62	25	0	6659
16068	58	20	6582	21	0	6681
16069	25	31	51	6220	0	6327
16070	6281	9	14	61	0	6365
16071	57	5	9	6411	0	6482
16072	22	14	6417	54	0	6507
16073	15	6475	44	22	0	6556
16074	17	53	11	6577	0	6658
16075	12	10	6552	52	0	6626
16076	6294	19	43	22	0	6378
16077	53	8	11	6505	0	6577
16078	20	10	6508	47	0	6585
16079	17	11	42	6412	0	6482
16080	16	6344	13	55	0	6428
16081	13	53	5	6658	0	6729
16082	17	13	5	6535	0	6570
16083	11	8	6	6425	0	6450
16084	10	6432	8	62	0	6512
16085	6535	55	5	33	0	6628
16086	54	14	8	6579	0	6655
16087	20	13	8	6607	0	6648
16088	28	6	7	6642	0	6683
16089	18	12	6596	65	0	6691
16090	12	6	47	6627	0	6692
16091	6719	7	13	72	0	6811
16092	60	6733	13	23	0	6829
16093	21	52	14	6901	0	6988
16094	13	22	7	6938	0	6980
16095	6861	12	10	80	0	6963
16096	61	6964	8	45	0	7078
16097	7051	57	8	33	0	7149
16098	7157	24	3	35	0	7219
16099	96	12	13	7070	0	7191
16100	7051	17	7	81	0	7156
16101	74	6853	3	39	0	6969
16102	6901	67	11	27	0	7006
16103	84	26	6	7077	0	7193
16104	7470	16	1	90	0	7577
16105	7658	10	7	44	0	7719
16106	120	16	7381	28	0	7545
16107	7757	20	65	29	0	7871
16108	7964	13	10	27	0	8014
16109	8142	17	12	34	0	8205
16110	161	10	8618	20	0	8809
16111	54	8715	130	25	0	8924
16112	62	132	34	8752	0	8980
16113	8718	40	23	152	0	8933
16114	158	8558	15	53	0	8784
16115	8540	150	15	45	0	8750
16116	182	49	12	8671	0	8914
16117	76	34	8663	157	0	8930
16118	8925	18	137	64	0	9144
16119	202	22	37	9138	0	9399
16120	80	12	9226	156	0	9474
16121	9353	13	157	67	0	9590
16122	204	14	9609	36	0	9863
16123	97	20	176	9995	0	10288
16124	63	17	69	10485	0	10634
16125	10336	15	48	265	0	10664
16126	10444	11	25	116	0	10596
16127	283	10298	24	74	0	10679
16128	10387	196	28	61	0	10672
16129	273	62	9906	32	0	10273
16130	119	31	9766	37	0	9953
16131	9591	37	232	37	0	9897
16132	220	9678	94	35	0	10027
16133	9440	170	67	25	0	9702
16134	211	9405	50	25	0	9691
16135	9352	196	33	25	0	9606
16136	249	68	27	9245	0	9589
16137	106	47	9239	186	0	9578
16138	87	28	184	9260	0	9559
16139	75	27	60	9545	0	9707
16140	9397	16	46	250	0	9709
16141	208	18	9273	108	0	9607
16142	9170	20	197	82	0	9469
16143	231	9223	68	53	0	9575
16144	9273	169	50	51	0	9543
16145	251	65	42	9130	0	9488
16146	121	51	9110	188	0	9470
16147	106	38	185	9149	0	9478
16148	9207	37	80	237	0	9561
16149	238	23	52	9253	0	9566
16150	119	30	37	9226	0	9412
16151	76	8941	43	257	0	9317
16152	65	177	30	9151	0	9423
16153	69	59	9032	249	0	9409
16154	70	36	190	9046	0	9342
16155	67	32	78	9219	0	9396
16156	9010	32	49	286	0	9377
16157	230	29	37	9066	0	9362
16158	117	31	8917	245	0	9310
16159	78	8932	192	134	0	9336
16160	88	170	81	8996	0	9335
16161	69	66	61	9113	0	9309
16162	8979	45	40	276	0	9340
16163	221	8812	37	138	0	9208
16164	105	195	30	8975	0	9305
16165	8782	80	30	258	0	9150
16166	8993	56	34	133	0	9216
16167	281	39	37	8938	0	9295
16168	131	34	8950	265	0	9380
16169	9029	30	179	139	0	9377
16170	258	25	72	9327	0	9682
16171	9275	25	61	277	0	9638
16172	9348	28	45	137	0	9558
16173	295	9009	44	109	0	9457
16174	9019	188	36	91	0	9334
16175	275	9077	33	85	0	9470
16176	156	227	30	9031	0	9444
16177	126	105	30	8992	0	9253
16178	87	8991	46	259	0	9383
16179	9088	213	35	140	0	9476
16180	9066	89	23	108	0	9286
16181	287	65	8752	98	0	9202
16182	142	43	8800	82	0	9067
16183	121	44	232	8827	0	9224
16184	8849	31	161	256	0	9297
16185	271	34	61	8902	0	9268
16186	137	29	48	9110	0	9324
16187	106	32	8942	298	0	9378
16188	90	41	8900	150	0	9181
16189	78	33	9130	122	0	9363
16190	8835	31	263	112	0	9241
16191	8938	49	130	94	0	9211
16192	287	8662	71	76	0	9096
16193	138	8864	56	74	0	9132
16194	124	226	57	8729	0	9136
16195	86	96	8793	234	0	9209
16196	8621	65	199	116	0	9001
16197	234	51	8906	95	0	9286
16198	131	32	205	8785	0	9153
16199	87	29	82	9036	0	9234
16200	76	29	73	9057	0	9235
16201	80	27	54	9201	0	9362
16202	8995	20	51	320	0	9386
16203	238	23	46	8954	0	9261
16204	98	24	8702	249	0	9073
16205	8388	22	169	139	0	8718
16206	206	19	8622	103	0	8950
16207	109	32	8488	62	0	8691
16208	83	8443	220	81	0	8827
16209	151	163	142	7713	0	8169
16210	7576	48	99	127	0	7850
16211	128	25	29	7608	0	7790
16212	61	19	7580	137	0	7797
16213	51	16	112	7665	0	7844
16214	7604	16	54	152	0	7826
16215	117	7627	31	87	0	7862
16216	7514	97	22	70	0	7703
16217	130	7431	21	57	0	7639
16218	7357	106	27	59	0	7549
16219	121	7231	19	39	0	7410
16220	66	7159	25	38	0	7288
16221	53	106	6872	18	0	7049
16222	46	6764	84	27	0	6921
16223	6077	64	58	31	0	6230
16224	55	25	8	6002	0	6090
16225	6059	16	7	42	0	6124
16226	43	6177	5	26	0	6251
16227	6140	46	9	27	0	6222
16228	52	31	6234	7	0	6324
16229	33	13	46	6183	0	6275
16230	17	6368	18	45	0	6448
16231	25	53	11	6571	0	6660
16232	21	26	4	6596	0	6647
16233	7186	15	6	94	0	7301
16234	76	7343	7	41	0	7467
16235	7511	77	12	26	0	7626
16236	96	51	7618	24	0	7789
16237	58	18	7427	11	0	7514
16238	21	7623	125	19	0	7788
16239	31	88	47	7637	0	7803
16240	18	52	7690	94	0	7854
16241	34	21	95	7367	0	7517
16242	19	20	56	7844	0	7939
16243	18	13	7550	135	0	7716
16244	16	15	7608	60	0	7699
16245	11	18	7832	36	0	7897
16246	15	15	7892	28	0	7950
16247	16	8121	138	32	0	8307
16248	29	95	65	8103	0	8292
16249	14	56	35	8342	0	8447
16250	15	23	8256	139	0	8433
16251	16	19	114	8179	0	8328
16252	12	23	8487	116	0	8638
16253	14	15	116	8455	0	8600
16254	19	9	67	8410	0	8505
16255	10	8457	31	154	0	8652
16256	15	94	24	8565	0	8698
16257	15	48	30	8512	0	8605
16258	19	21	25	8548	0	8613
16259	17	26	8372	161	0	8576
16260	8	8335	106	88	0	8537
16261	8347	101	54	58	0	8560
16262	8412	57	25	58	0	8552
16263	143	27	23	8345	0	8538
16264	64	31	16	8299	0	8410
16265	33	8414	24	142	0	8613
16266	8409	98	29	92	0	8628
16267	107	8570	23	48	0	8748
16268	8410	110	12	40	0	8572
16269	108	59	8229	34	0	8430
16270	7959	36	91	46	0	8132
16271	97	8224	47	38	0	8406
16272	67	95	23	8275	0	8460
16273	44	51	27	8251	0	8373
16274	27	8277	20	115	0	8439
16275	8346	94	15	82	0	8537
16276	102	56	18	8467	0	8643
16277	54	31	13	8694	0	8792
16278	8733	26	10	143	0	8912
16279	8874	29	10	93	0	9006
16280	150	23	8870	40	0	9083
16281	8998	17	102	42	0	9159
16282	126	26	57	9043	0	9252
16283	80	20	9058	118	0	9276
16284	52	20	107	9028	0	9207
16285	35	19	8889	121	0	9064
16286	35	18	9004	85	0	9142
16287	27	16	145	9095	0	9283
16288	27	25	9245	123	0	9420
16289	23	9299	117	97	0	9536
16290	31	100	77	9342	0	9550
16291	26	52	42	9613	0	9733
16292	25	25	9564	164	0	9778
16293	17	9488	131	91	0	9727
16294	9566	103	67	80	0	9816
16295	112	59	40	9701	0	9912
16296	9715	38	35	143	0	9931
16297	119	9644	35	92	0	9890
16298	70	108	9761	59	0	9998
16299	40	70	124	9685	0	9919
16300	9660	42	71	136	0	9909
16301	119	27	9631	90	0	9867
16302	9306	24	127	77	0	9534
16303	138	9424	72	57	0	9691
16304	65	9340	37	45	0	9487
16305	9172	132	46	43	0	9393
16306	124	66	31	9082	0	9303
16307	80	37	27	8960	0	9104
16308	38	9051	26	139	0	9254
16309	45	100	23	9161	0	9329
16310	36	54	14	9220	0	9324
16311	9074	38	13	174	0	9299
16312	111	25	23	9054	0	9213
16313	60	15	8965	138	0	9178
16314	42	11	106	8992	0	9151
16315	35	25	58	9110	0	9228
16316	35	25	9015	154	0	9229
16317	24	25	105	9043	0	9197
16318	8867	19	54	145	0	9085
16319	8691	16	30	99	0	8836
16320	8755	13	31	78	0	8877
16321	143	16	26	8742	0	8927
16322	71	24	8734	140	0	8969
16323	48	8747	96	87	0	8978
16324	50	93	52	8824	0	9019
16325	40	42	8823	126	0	9031
16326	46	27	92	8644	0	8809
16327	39	21	54	8715	0	8829
16328	8466	10	26	168	0	8670
16329	93	8597	32	89	0	8811
16330	67	89	8348	44	0	8548
16331	7903	46	88	71	0	8108
16332	102	8204	57	49	0	8412
16333	41	7675	23	31	0	7770
16334	7772	73	70	28	0	7943
16335	77	32	18	7784	0	7911
16336	37	29	8306	62	0	8434
16337	31	27	64	8211	0	8333
16338	17	8318	38	78	0	8451
16339	8499	62	19	54	0	8634
16340	64	40	12	8555	0	8671
16341	8689	20	13	88	0	8810
16342	87	15	9	8579	0	8690
16343	39	8834	16	75	0	8964
16344	9033	61	14	58	0	9166
16345	9024	29	10	41	0	9104
16346	99	9061	7	26	0	9193
16347	8897	72	11	30	0	9010
16348	98	43	10	8720	0	8871
16349	39	8741	12	75	0	8867
16350	8779	75	12	43	0	8909
16351	85	8863	10	36	0	8994
16352	8852	81	9	29	0	8971
16353	98	40	6	8865	0	9009
16354	8953	28	9	89	0	9079
16355	8946	19	8	57	0	9030
16356	9043	14	9	44	0	9110
16357	119	19	8	8980	0	9126
16358	65	17	8	9067	0	9157
16359	9038	18	7	112	0	9175
16360	96	17	9147	54	0	9314
16361	58	19	66	9126	0	9269
16362	40	9279	30	83	0	9432
16363	45	73	15	9417	0	9550
16364	34	30	9	9472	0	9545
16365	26	27	9314	106	0	9473
16366	40	21	67	9631	0	9759
16367	31	10074	25	106	0	10236
16368	41	107	16	10345	0	10509
16369	30	50	11058	146	0	11284
16370	51	37	132	11213	0	11433
16371	42	20	53	11656	0	11771
16372	11515	22	38	240	0	11815
16373	11543	14	25	129	0	11711
16374	232	24	14	11399	0	11669
16375	115	11106	16	205	0	11442
16376	83	11303	13	102	0	11501
16377	50	186	11142	70	0	11448
16378	58	162	141	10980	0	11341
16379	10949	57	71	195	0	11272
16380	158	49	41	10965	0	11213
16381	84	28	10966	184	0	11262
16382	58	19	146	10980	0	11203
16383	52	24	73	11070	0	11219
16384	53	18	38	11205	0	11314
16385	31	25	10962	243	0	11261
16386	27	10870	153	139	0	11189
16387	10737	145	70	101	0	11053
16388	10650	69	41	86	0	10846
16389	327	48	37	10377	0	10789
16390	108	21	10469	177	0	10775
16391	75	10512	149	94	0	10830
16392	68	187	59	10149	0	10463
16393	40	10341	48	146	0	10575
16394	28	10566	35	89	0	10718
16395	10287	193	40	83	0	10603
16396	165	100	10324	44	0	10633
16397	74	64	10235	47	0	10420
16398	75	50	189	10228	0	10542
16399	42	46	91	10460	0	10639
16400	31	25	10492	203	0	10751
16401	42	27	154	10285	0	10508
16402	26	34	10405	191	0	10656
16403	9932	16	164	120	0	10232
16404	154	21	81	10369	0	10625
16405	77	18	10579	177	0	10851
16406	63	24	158	10171	0	10416
16407	49	10763	71	181	0	11064
16408	10762	134	57	119	0	11072
16409	150	10823	35	89	0	11097
16410	10851	161	34	78	0	11124
16411	185	81	10711	45	0	11022
16412	10790	57	133	56	0	11036
16413	199	40	71	10904	0	11214
16414	88	27	10934	169	0	11218
16415	79	41	156	10850	0	11126
16416	53	23	10768	185	0	11029
16417	10245	31	172	123	0	10571
16418	157	10799	78	80	0	11114
16419	86	131	65	10534	0	10816
16420	62	10962	51	144	0	11219
16421	10907	160	35	122	0	11224
16422	10919	68	46	72	0	11105
16423	197	10936	28	78	0	11239
16424	113	160	25	10969	0	11267
16425	92	80	28	11000	0	11200
16426	63	67	26	11035	0	11191
16427	10846	38	32	261	0	11177
16428	149	10809	31	147	0	11136
16429	86	153	23	10764	0	11026
16430	62	71	38	10831	0	11002
16431	10615	58	33	252	0	10958
16432	167	40	10455	132	0	10794
16433	82	36	10224	125	0	10467
16434	9866	26	188	97	0	10177
16435	160	18	10027	76	0	10281
16436	78	28	9343	56	0	9505
16437	86	48	196	9150	0	9480
16438	9331	18	135	164	0	9648
16439	140	15	71	9327	0	9553
16440	78	13	9268	166	0	9525
16441	8938	12	148	105	0	9203
16442	149	25	9175	59	0	9408
16443	78	9194	154	47	0	9473
16444	94	167	103	9259	0	9623
16445	9257	60	68	167	0	9552
16446	129	42	37	9298	0	9506
16447	75	23	37	9365	0	9500
16448	9434	19	34	190	0	9677
16449	130	17	29	9518	0	9694
16450	72	8	25	9705	0	9810
16451	49	19	9526	182	0	9776
16452	36	14	111	9482	0	9643
16453	9525	16	62	177	0	9780
16454	9487	12	39	125	0	9663
16455	9514	14	29	94	0	9651
16456	198	11	22	9378	0	9609
16457	99	9347	22	136	0	9604
16458	9411	98	24	82	0	9615
16459	133	9479	26	62	0	9700
16460	9399	126	21	51	0	9597
16461	152	55	15	9401	0	9623
16462	9321	43	18	133	0	9515
16463	9249	20	25	78	0	9372
16464	9319	18	21	62	0	9420
16465	173	9181	23	31	0	9408
16466	86	8928	15	37	0	9066
16467	8450	90	17	34	0	8591
16468	93	8499	11	24	0	8627
16469	23	7836	8	13	0	7880
16470	23	7650	14	16	0	7703
16471	7464	41	41	18	0	7564
16472	32	13	3	7424	0	7472
16473	9	6	0	7499	0	7514
16474	7558	2	1	43	0	7604
16475	29	3	7708	10	0	7750
16476	15	3	25	8345	0	8388
16477	17	1	6	8409	0	8433
16478	10	3	5	9107	0	9125
16479	9	0	0	9536	0	9545
16480	1	9503	6	141	0	9651
16481	4	11340	7	52	0	11403
16482	11766	197	2	43	0	12008
16483	206	55	2	11874	0	12137
16484	76	34	2	12098	0	12210
16485	44	21	11925	249	0	12239
16486	37	13	189	12052	0	12291
16487	17	27	12197	258	0	12499
16488	29	8	231	12353	0	12621
16489	11	8	12862	266	0	13147
16490	2	12878	263	110	0	13253
16491	24	216	91	13081	0	13412
16492	13154	61	48	289	0	13552
16493	13245	38	35	110	0	13428
16494	312	31	17	13145	0	13505
16495	104	25	13123	268	0	13520
16496	77	15	13056	89	0	13237
16497	12638	11	279	98	0	13026
16498	250	12906	107	66	0	13329
16499	13029	233	76	64	0	13402
16500	13048	66	42	78	0	13234
16501	320	54	12930	36	0	13340
16502	144	29	251	12844	0	13268
16503	114	19	93	12913	0	13139
16504	79	33	49	13433	0	13594
16505	58	20	48	13074	0	13200
16506	80	21	38	12830	0	12969
16507	46	18	12474	417	0	12955
16508	29	11	12469	227	0	12736
16509	52	12	318	12577	0	12959
16510	44	19	133	12828	0	13024
16511	53	17	85	13001	0	13156
16512	12613	24	67	424	0	13128
16513	305	16	40	12719	0	13080
16514	12857	23	46	374	0	13300
16515	329	18	44	13219	0	13610
16516	13357	13	28	401	0	13799
16517	13612	11	35	184	0	13842
16518	13386	15	39	152	0	13592
16519	13464	13	33	135	0	13645
16520	13459	14	41	102	0	13616
16521	462	14	41	13115	0	13632
16522	13136	13	42	345	0	13536
16523	386	13027	28	161	0	13602
16524	13169	261	40	143	0	13613
16525	378	87	37	13283	0	13785
16526	174	52	13201	368	0	13795
16527	130	44	272	13390	0	13836
16528	120	38	13364	397	0	13919
16529	105	23	326	13404	0	13858
16530	111	18	124	13755	0	14008
16531	86	16	13461	465	0	14028
16532	87	14	13508	241	0	13850
16533	96	18	396	13587	0	14097
16534	13487	19	165	433	0	14104
16535	346	10	13542	234	0	14132
16536	170	13631	342	156	0	14299
16537	137	290	13942	128	0	14497
16538	13860	87	348	138	0	14433
16539	378	56	149	13953	0	14536
16540	13955	34	112	400	0	14501
16541	14149	24	86	208	0	14467
16542	465	28	89	13899	0	14481
16543	224	29	13604	399	0	14256
16544	202	22	323	13530	0	14077
16545	133	29	146	13704	0	14012
16546	13242	25	111	509	0	13887
16547	371	13433	89	241	0	14134
16548	196	272	81	13554	0	14103
16549	127	96	13338	433	0	13994
16550	12942	64	325	248	0	13579
16551	354	13230	162	180	0	13926
16552	189	278	106	13365	0	13938
16553	138	108	80	13528	0	13854
16554	145	62	78	13653	0	13938
16555	13235	36	75	519	0	13865
16556	13530	32	78	279	0	13919
16557	458	29	68	13481	0	14036
16558	214	41	13295	447	0	13997
16559	170	13267	302	243	0	13982
16560	13368	280	126	200	0	13974
16561	13697	110	104	166	0	14077
16562	466	60	74	13426	0	14026
16563	249	37	78	13774	0	14138
16564	195	36	13562	481	0	14274
16565	140	13621	313	260	0	14334
16566	14010	292	134	190	0	14626
16567	13923	104	91	180	0	14298
16568	441	13682	72	170	0	14365
16569	13604	316	53	135	0	14108
16570	466	121	57	13427	0	14071
16571	224	76	13340	397	0	14037
16572	163	63	333	13520	0	14079
16573	141	50	13339	434	0	13964
16574	13137	41	355	239	0	13772
16575	379	13109	155	163	0	13806
16576	190	326	82	12483	0	13081
16577	118	84	12372	394	0	12968
16578	107	56	11997	163	0	12323
16579	11196	92	318	141	0	11747
16580	275	11159	136	124	0	11694
16581	9396	181	242	78	0	9897
16582	9151	56	94	59	0	9360
16583	9146	36	27	57	0	9266
16584	198	35	55	8967	0	9255
16585	103	21	8937	160	0	9221
16586	67	8917	126	69	0	9179
16587	75	160	72	8786	0	9093
16588	64	52	8739	148	0	9003
16589	50	34	8136	55	0	8275
16590	60	45	121	7963	0	8189
16591	30	20	7888	115	0	8053
16592	7637	9	104	77	0	7827
16593	107	19	53	7909	0	8088
16594	53	19	37	8085	0	8194
16595	7978	15	30	138	0	8161
16596	104	7907	37	63	0	8111
16597	8212	82	26	63	0	8383
16598	115	42	29	8148	0	8334
16599	86	20	32	8224	0	8362
16600	51	24	25	8290	0	8390
16601	44	18	28	8133	0	8223
16602	8011	11	23	151	0	8196
16603	106	21	7987	65	0	8179
16604	72	7881	86	50	0	8089
16605	49	76	42	7929	0	8096
16606	7657	39	35	98	0	7829
16607	7908	25	24	75	0	8032
16608	111	7878	29	58	0	8076
16609	7724	73	23	49	0	7869
16610	90	7748	30	41	0	7909
16611	44	8029	26	46	0	8145
16612	50	101	26	8054	0	8231
16613	39	40	8106	92	0	8277
16614	41	55	78	7842	0	8016
16615	7636	23	30	106	0	7795
16616	101	7555	26	44	0	7726
16617	51	81	15	7626	0	7773
16618	38	37	8033	100	0	8208
16619	8028	20	75	65	0	8188
16620	8323	19	32	57	0	8431
16621	8372	20	28	49	0	8469
16622	118	11	8174	40	0	8343
16623	7961	14	75	34	0	8084
16624	94	8153	28	27	0	8302
16625	46	75	15	7874	0	8010
16626	28	8082	20	70	0	8200
16627	8120	75	16	32	0	8243
16628	7861	27	15	46	0	7949
16629	84	29	8231	22	0	8366
16630	38	8188	63	26	0	8315
16631	32	68	25	8168	0	8293
16632	32	22	17	8192	0	8263
16633	29	19	12	8116	0	8176
16634	22	23	17	8150	0	8212
16635	37	12	19	8257	0	8325
16636	28	20	8008	94	0	8150
16637	26	7917	75	45	0	8063
16638	7873	73	22	39	0	8007
16639	90	20	8168	33	0	8311
16640	39	8300	79	23	0	8441
16641	8364	76	27	28	0	8495
16642	95	33	8754	29	0	8911
16643	8517	19	94	37	0	8667
16644	8462	24	25	30	0	8541
16645	8677	22	17	28	0	8744
16646	113	8701	18	26	0	8858
16647	45	90	8634	26	0	8795
16648	37	8814	80	21	0	8952
16649	67	113	24	7618	0	7822
16650	16	8793	16	87	0	8912
16651	8825	92	23	42	0	8982
16652	9122	25	13	34	0	9194
16653	9009	18	12	29	0	9068
16654	124	26	9131	28	0	9309
16655	45	9438	101	26	0	9610
16656	37	112	30	10025	0	10204
16657	10689	36	28	132	0	10885
16658	171	10688	17	41	0	10917
16659	83	158	14	10666	0	10921
16660	55	50	10948	157	0	11210
16661	10999	38	166	58	0	11261
16662	187	40	11663	41	0	11931
16663	64	23	12037	34	0	12158
16664	11500	17	239	42	0	11798
16665	234	24	11658	10	0	11926
16666	11044	17	243	29	0	11333
16667	231	11163	88	13	0	11495
16668	11481	176	67	25	0	11749
16669	257	43	59	11519	0	11878
16670	122	51	46	11519	0	11738
16671	106	26	45	11737	0	11914
16672	11638	17	40	273	0	11968
16673	11599	20	37	119	0	11775
16674	11632	23	30	101	0	11786
16675	305	11407	23	44	0	11779
16676	159	192	18	11483	0	11852
16677	105	60	11407	220	0	11792
16678	84	52	191	11095	0	11422
16679	61	11055	62	259	0	11437
16680	84	186	62	11147	0	11479
16681	86	61	31	11321	0	11499
16682	11191	70	25	271	0	11557
16683	249	42	22	11265	0	11578
16684	86	36	11183	295	0	11600
16685	93	26	11107	128	0	11354
16686	87	35	248	11228	0	11598
16687	11217	27	103	255	0	11602
16688	241	32	92	11224	0	11589
16689	109	34	55	11524	0	11722
16690	101	26	11374	309	0	11810
16691	66	11289	231	163	0	11749
16692	73	184	101	11433	0	11791
16693	11220	67	91	261	0	11639
16694	236	11176	66	125	0	11603
16695	111	208	40	11301	0	11660
16696	113	63	11190	282	0	11648
16697	82	71	206	11035	0	11394
16698	10895	47	88	313	0	11343
16699	211	10806	91	135	0	11243
16700	107	199	10948	133	0	11387
16701	113	83	198	10986	0	11380
16702	85	78	11079	269	0	11511
16703	10861	57	248	155	0	11321
16704	11104	37	106	148	0	11395
16705	286	51	11061	88	0	11486
16706	161	45	227	11061	0	11494
16707	137	54	11266	239	0	11696
16708	92	11227	258	130	0	11707
16709	73	220	130	11417	0	11840
16710	81	61	11405	271	0	11818
16711	97	116	269	10768	0	11250
16712	82	11004	111	271	0	11468
16713	100	196	95	11066	0	11457
16714	54	77	11017	294	0	11442
16715	10633	71	248	156	0	11108
16716	203	10949	122	137	0	11411
16717	11119	217	105	110	0	11551
16718	279	77	10758	100	0	11214
16719	10586	87	213	96	0	10982
16720	259	67	10687	100	0	11113
16721	10579	51	265	107	0	11002
16722	10977	51	135	78	0	11241
16723	315	53	97	10795	0	11260
16724	183	44	81	11025	0	11333
16725	10962	50	65	290	0	11367
16726	284	10954	60	163	0	11461
16727	11108	219	68	140	0	11535
16728	313	75	88	11016	0	11492
16729	166	10980	68	262	0	11476
16730	158	221	55	11235	0	11669
16731	108	85	58	11513	0	11764
16732	107	65	59	11378	0	11609
16733	82	11182	62	359	0	11685
16734	11229	226	49	193	0	11697
16735	276	86	55	11287	0	11704
16736	135	82	11054	285	0	11556
16737	100	59	10852	162	0	11173
16738	64	42	10989	166	0	11261
16739	10768	34	299	155	0	11256
16740	10882	53	163	96	0	11194
16741	285	57	10694	88	0	11124
16742	164	50	239	10102	0	10555
16743	127	38	98	10365	0	10628
16744	68	48	10570	283	0	10969
16745	72	35	10506	162	0	10775
16746	80	28	266	10556	0	10930
16747	10522	40	136	248	0	10946
16748	10394	37	110	116	0	10657
16749	10382	21	81	134	0	10618
16750	297	10114	66	120	0	10597
16751	146	10291	75	89	0	10601
16752	115	217	76	10120	0	10528
16753	10130	89	74	226	0	10519
16754	232	77	9850	119	0	10278
16755	9230	41	188	122	0	9581
16756	221	8909	68	96	0	9294
16757	79	8368	31	47	0	8525
16758	8254	141	59	43	0	8497
16759	138	8147	43	33	0	8361
16760	46	7866	27	45	0	7984
16761	7427	201	140	122	0	7890
16762	83	7407	16	21	0	7527
16763	25	62	17	7081	0	7185
16764	17	15	12	7104	0	7148
16765	7065	11	8	71	0	7155
16766	7073	5	8	23	0	7109
16767	61	7041	8	15	0	7125
16768	27	7054	10	6	0	7097
16769	13	60	6997	8	0	7078
16770	6961	26	65	11	0	7063
16771	7287	13	15	17	0	7332
16772	7493	2	7	16	0	7518
16773	83	3	7	7573	0	7666
16774	33	7	6	7899	0	7945
16775	8032	9	8	84	0	8133
16776	84	6	5	8113	0	8208
16777	30	7	8172	84	0	8293
16778	32	10	70	8231	0	8343
16779	14	8523	18	82	0	8637
16780	24	83	13	8670	0	8790
16781	17	26	5	8932	0	8980
16782	19	16	4	8957	0	8996
16783	8860	6	8	130	0	9004
16784	86	8786	12	39	0	8923
16785	36	82	5	8929	0	9052
16786	22	27	8936	97	0	9082
16787	15	19	8596	32	0	8662
16788	18	12	103	8796	0	8929
16789	22	9	32	8795	0	8858
16790	8657	10	11	115	0	8793
16791	100	17	5	8484	0	8606
16792	28	8477	10	103	0	8618
16793	18	88	8678	34	0	8818
16794	20	25	94	8770	0	8909
16795	18	17	8830	104	0	8969
16796	24	12	106	8821	0	8963
16797	8852	7	21	126	0	9006
16798	8919	13	14	51	0	8997
16799	114	8802	17	29	0	8962
16800	41	90	17	8808	0	8956
16801	8975	23	14	112	0	9124
16802	9049	15	18	43	0	9125
16803	9109	9	13	45	0	9176
16804	9099	5	14	27	0	9145
16805	8961	12	10	39	0	9022
16806	121	8827	18	24	0	8990
16807	8746	85	12	39	0	8882
16808	120	27	8676	20	0	8843
16809	44	16	91	8677	0	8828
16810	8749	11	20	99	0	8879
16811	8746	10	17	43	0	8816
16812	8692	10	10	39	0	8751
16813	118	16	8643	26	0	8803
16814	48	11	82	8776	0	8917
16815	8907	12	22	115	0	9056
16816	98	8838	16	37	0	8989
16817	9041	86	9	40	0	9176
16818	8940	24	11	33	0	9008
16819	8978	18	17	25	0	9038
16820	116	13	16	9029	0	9174
16821	9095	13	9	115	0	9232
16822	120	18	8932	41	0	9111
16823	40	24	8847	38	0	8949
16824	8907	14	95	36	0	9052
16825	107	26	8979	25	0	9137
16826	8594	12	78	35	0	8719
16827	98	11	8840	28	0	8977
16828	47	38	80	8718	0	8883
16829	8597	3	36	95	0	8731
16830	85	8385	18	44	0	8532
16831	8646	62	13	41	0	8762
16832	86	8444	18	30	0	8578
16833	44	8788	14	24	0	8870
16834	42	70	21	8925	0	9058
16835	38	19	14	8931	0	9002
16836	36	12	24	8869	0	8941
16837	36	8	8734	96	0	8874
16838	8623	17	66	54	0	8760
16839	9092	18	33	36	0	9179
16840	9137	13	17	32	0	9199
16841	9123	18	15	42	0	9198
16842	9160	14	10	43	0	9227
16843	133	8	8442	34	0	8617
16844	69	18	8754	27	0	8868
16845	61	10	84	8963	0	9118
16846	51	13	8860	87	0	9011
16847	9050	12	75	35	0	9172
16848	112	9500	23	31	0	9666
16849	63	86	17	10135	0	10301
16850	10415	19	20	118	0	10572
16851	171	17	21	10693	0	10902
16852	78	12	10717	144	0	10951
16853	78	10	10836	54	0	10978
16854	60	13	162	11148	0	11383
16855	48	13	11202	142	0	11405
16856	10948	10	159	68	0	11185
16857	166	16	63	11156	0	11401
16858	76	15	11142	152	0	11385
16859	57	11173	148	59	0	11437
16860	54	132	53	11473	0	11712
16861	53	41	11554	145	0	11793
16862	56	25	154	11291	0	11526
16863	57	20	60	11478	0	11615
16864	46	9	11575	197	0	11827
16865	41	20	161	11543	0	11765
16866	44	12	66	11316	0	11438
16867	45	6	48	11607	0	11706
16868	11268	10	35	228	0	11541
16869	159	11086	33	96	0	11374
16870	79	11354	33	63	0	11529
16871	56	170	11115	45	0	11386
16872	10738	63	136	43	0	10980
16873	154	36	10887	40	0	11117
16874	60	19	10673	24	0	10776
16875	41	43	153	10411	0	10648
16876	10413	9	59	153	0	10634
16877	138	10430	40	71	0	10679
16878	10335	115	35	50	0	10535
16879	10215	41	20	43	0	10319
16880	166	10317	27	21	0	10531
16881	10203	113	23	41	0	10380
16882	10170	40	29	25	0	10264
16883	149	10259	20	21	0	10449
16884	73	126	19	10369	0	10587
16885	59	45	21	10557	0	10682
16886	10630	24	20	143	0	10817
16887	129	10846	23	74	0	11072
16888	11099	129	8	49	0	11285
16889	11182	48	12	37	0	11279
16890	11677	16	17	34	0	11744
16891	205	20	8	11628	0	11861
16892	87	16	9	11881	0	11993
16893	11732	16	18	189	0	11955
16894	11923	11	10	86	0	12030
16895	12027	12	9	45	0	12093
16896	240	15	16	12237	0	12508
16897	90	12	12362	182	0	12646
16898	61	9	157	12616	0	12843
16899	51	14	62	13575	0	13702
16900	34	12	13425	245	0	13716
16901	41	11	14385	120	0	14557
16902	45	14	286	14703	0	15048
16903	45	14	14809	263	0	15131
16904	14939	7	274	146	0	15366
16905	257	15	121	15068	0	15461
16906	140	12	68	15372	0	15592
16907	15446	8	38	369	0	15861
16908	286	14	42	15393	0	15735
16909	150	12	33	15555	0	15750
16910	97	8	33	15682	0	15820
16911	70	15	35	15740	0	15860
16912	49	13	15273	425	0	15760
16913	52	7	240	15444	0	15743
16914	44	10	15111	350	0	15515
16915	44	15246	272	178	0	15740
16916	58	250	108	15276	0	15692
16917	52	100	15058	306	0	15516
16918	14377	54	264	212	0	14907
16919	268	14900	129	121	0	15418
16920	15029	247	75	99	0	15450
16921	324	117	41	14733	0	15215
16922	135	14746	58	293	0	15232
16923	14852	249	37	177	0	15315
16924	281	14926	36	124	0	15367
16925	15040	290	41	83	0	15454
16926	348	127	38	14997	0	15510
16927	15050	79	29	315	0	15473
16928	327	15147	47	155	0	15676
16929	15229	285	29	110	0	15653
16930	348	128	14987	76	0	15539
16931	182	78	266	15077	0	15603
16932	15002	38	109	323	0	15472
16933	15206	40	73	176	0	15495
16934	443	37	38	14957	0	15475
16935	201	40	14926	337	0	15504
16936	119	14270	269	176	0	14834
16937	86	15108	131	120	0	15445
16938	15111	356	83	120	0	15670
16939	339	136	50	14963	0	15488
16940	192	74	56	15168	0	15490
16941	14995	40	48	415	0	15498
16942	14971	44	48	243	0	15306
16943	414	39	14831	124	0	15408
16944	230	53	273	14838	0	15394
16945	131	29	14707	359	0	15226
16946	113	14600	283	212	0	15208
16947	14110	251	138	172	0	14671
16948	283	14091	89	139	0	14602
16949	140	13972	61	114	0	14287
16950	172	296	64	13565	0	14097
16951	13191	137	45	302	0	13675
16952	236	13147	48	191	0	13622
16953	12983	218	60	150	0	13411
16954	265	12864	62	100	0	13291
16955	147	248	40	12926	0	13361
16956	12891	119	53	272	0	13335
16957	253	92	12860	160	0	13365
16958	167	83	200	12851	0	13301
16959	111	75	12695	269	0	13150
16960	112	12051	230	178	0	12571
16961	85	12530	110	139	0	12864
16962	12212	295	88	133	0	12728
16963	230	12439	49	130	0	12848
16964	12408	257	66	109	0	12840
16965	12575	133	48	102	0	12858
16966	300	107	12225	94	0	12726
16967	12288	66	198	102	0	12654
16968	278	93	12475	95	0	12941
16969	192	12479	224	105	0	13000
16970	12562	219	130	88	0	12999
16971	273	12444	85	96	0	12898
16972	187	249	59	12531	0	13026
16973	12566	123	63	264	0	13016
16974	285	106	45	12522	0	12958
16975	197	75	12562	272	0	13106
16976	139	85	198	12597	0	13019
16977	98	90	110	12769	0	13067
16978	12580	68	70	335	0	13053
16979	278	75	12415	186	0	12954
16980	12420	76	232	126	0	12854
16981	12909	58	110	117	0	13194
16982	353	60	91	12803	0	13307
16983	226	65	52	12834	0	13177
16984	12602	54	45	347	0	13048
16985	300	12626	76	158	0	13160
16986	197	232	56	12481	0	12966
16987	143	114	12127	241	0	12625
16988	107	108	11517	155	0	11887
16989	110	12018	221	107	0	12456
16990	135	230	124	11511	0	12000
16991	93	126	65	11629	0	11913
16992	11383	77	48	292	0	11800
16993	252	70	45	11315	0	11682
16994	11002	62	35	235	0	11334
16995	256	10757	42	147	0	11202
16996	125	10544	26	108	0	10803
16997	100	10782	33	92	0	11007
16998	10403	248	89	115	0	10855
16999	9545	126	73	72	0	9816
17000	211	9294	24	61	0	9590
17001	8170	66	33	27	0	8296
17002	81	7994	13	8	0	8096
17003	33	74	8	7819	0	7934
17004	15	7783	7	55	0	7860
17005	7806	89	13	49	0	7957
17006	7771	28	7	21	0	7827
17007	87	17	1	7578	0	7683
17008	7576	10	2	80	0	7668
17009	79	6	4	7560	0	7649
17010	30	7691	6	63	0	7790
17011	26	83	4	7711	0	7824
17012	10	7677	11	64	0	7762
17013	7631	62	4	33	0	7730
17014	67	23	7513	13	0	7616
17015	7238	10	40	20	0	7308
17016	56	10	14	7429	0	7509
17017	23	9	7395	47	0	7474
17018	7163	6	42	24	0	7235
17019	59	9	7644	15	0	7727
17020	25	3	46	7498	0	7572
17021	25	7	14	7639	0	7685
17022	15	6	7	7562	0	7590
17023	13	9	6	7623	0	7651
17024	5	7451	12	79	0	7547
17025	12	61	3	7943	0	8019
17026	7924	18	5	90	0	8037
17027	69	12	7912	31	0	8024
17028	28	8189	53	19	0	8289
17029	8458	76	17	26	0	8577
17030	8940	31	8	24	0	9003
17031	143	14	11	9837	0	10005
17032	47	21	9849	145	0	10062
17033	36	24	138	9795	0	9993
17034	37	7	55	10601	0	10700
17035	17	4	10627	220	0	10868
17036	18	11335	180	82	0	11615
17037	11700	201	65	51	0	12017
17038	11945	93	19	34	0	12091
17039	12284	37	15	49	0	12385
17040	374	27	22	12008	0	12431
17041	193	19	9	12575	0	12796
17042	12836	10	16	350	0	13212
17043	328	8	16	12447	0	12799
17044	149	12717	14	307	0	13187
17045	13279	242	16	180	0	13717
17046	13503	108	21	124	0	13756
17047	14365	47	25	80	0	14517
17048	14489	33	16	95	0	14633
17049	484	30	13800	60	0	14374
17050	253	24	13831	50	0	14158
17051	166	36	361	13828	0	14391
17052	157	23	154	14153	0	14487
17053	119	20	13933	395	0	14467
17054	106	28	13992	175	0	14301
17055	116	20	402	13979	0	14517
17056	14038	16	174	365	0	14593
17057	367	12	109	13978	0	14466
17058	174	18	14155	372	0	14719
17059	116	14351	322	204	0	14993
17060	14629	274	156	159	0	15218
17061	14918	119	102	118	0	15257
17062	14968	59	94	113	0	15234
17063	14977	41	94	93	0	15205
17064	509	48	14296	77	0	14930
17065	294	24	303	14397	0	15018
17066	14596	29	158	346	0	15129
17067	413	35	103	14554	0	15105
17068	273	30	104	14253	0	14660
17069	161	14011	89	446	0	14707
17070	171	266	44	14442	0	14923
17071	14246	121	59	410	0	14836
17072	354	14161	79	241	0	14835
17073	14182	305	63	177	0	14727
17074	403	14141	67	120	0	14731
17075	275	335	44	13645	0	14299
17076	215	13716	57	329	0	14317
17077	163	14272	55	196	0	14686
17078	14066	386	64	155	0	14671
17079	378	208	13851	142	0	14579
17080	230	117	13599	150	0	14096
17081	188	111	13454	113	0	13866
17082	12908	124	412	161	0	13605
17083	348	13210	221	145	0	13924
17084	223	13589	147	124	0	14083
17085	13183	400	103	146	0	13832
17086	409	13116	90	96	0	13711
17087	260	13675	83	96	0	14114
17088	216	441	85	13591	0	14333
17089	158	255	13595	348	0	14356
17090	188	168	13706	207	0	14269
17091	164	158	396	13774	0	14492
17092	13774	145	196	382	0	14497
17093	405	13850	149	230	0	14634
17094	258	345	144	13965	0	14712
17095	216	198	13819	381	0	14614
17096	205	142	13599	236	0	14182
17097	212	125	420	13672	0	14429
17098	13675	137	240	384	0	14436
17099	13871	115	161	262	0	14409
17100	539	105	13522	173	0	14339
17101	13500	116	365	166	0	14147
17102	465	108	13751	157	0	14481
17103	317	76	425	13341	0	14159
17104	227	13635	276	353	0	14491
17105	14040	305	210	233	0	14788
17106	464	164	155	14117	0	14900
17107	312	123	157	13793	0	14385
17108	245	113	129	14411	0	14898
17109	220	92	149	14363	0	14824
17110	198	80	13780	544	0	14602
17111	199	13633	378	339	0	14549
17112	193	319	234	13950	0	14696
17113	13887	161	161	458	0	14667
17114	445	116	157	13961	0	14679
17115	300	87	153	14084	0	14624
17116	234	105	13628	548	0	14515
17117	190	100	13024	371	0	13685
17118	190	13199	455	258	0	14102
17119	167	13672	239	251	0	14329
17120	171	389	176	13759	0	14495
17121	13619	223	143	469	0	14454
17122	389	146	13596	319	0	14450
17123	277	13767	309	246	0	14599
17124	209	346	211	13403	0	14169
17125	161	13569	144	392	0	14266
17126	177	387	122	13142	0	13828
17127	138	13333	112	399	0	13982
17128	168	376	89	12966	0	13599
17129	12558	223	75	399	0	13255
17130	295	12100	87	258	0	12740
17131	167	387	60	10933	0	11547
17132	10804	167	83	263	0	11317
17133	213	10714	49	189	0	11165
17134	120	9805	45	136	0	10106
17135	120	9895	56	108	0	10179
17136	139	227	115	8999	0	9480
17137	57	90	48	8794	0	8989
17138	39	8613	21	138	0	8811
17139	52	117	21	8585	0	8775
17140	38	77	8579	105	0	8799
17141	33	8423	72	62	0	8590
17142	41	385	28	7806	0	8260
17143	31	8176	21	64	0	8292
17144	44	60	7832	50	0	7986
17145	22	7734	47	38	0	7841
17146	6935	85	46	70	0	7136
17147	29	19	6	6861	0	6915
17148	6842	5	8	32	0	6887
17149	31	9	6788	9	0	6837
17150	7	2	17	6908	0	6934
17151	4	7	6980	20	0	7011
17152	10	13	17	7010	0	7050
17153	7243	3	5	50	0	7301
17154	26	3	5	7271	0	7305
17155	7346	5	3	39	0	7393
17156	17	7416	6	10	0	7449
17157	7376	17	5	27	0	7425
17158	17	5	7492	11	0	7525
17159	5	7494	18	15	0	7532
17160	11	16	2	7589	0	7618
17161	14	4	1	7547	0	7566
17162	6	8	7490	16	0	7520
17163	7	7407	17	10	0	7441
17164	6	17	3	7530	0	7556
17165	9	7530	6	22	0	7567
17166	6	19	4	7517	0	7546
17167	3	7514	1	22	0	7540
17168	7448	18	3	25	0	7494
17169	20	7	7	7543	0	7577
17170	7	7	7573	23	0	7610
17171	3	7537	13	10	0	7563
17172	4	7730	4	7	0	7745
17173	6	18	7712	3	0	7739
17174	3	7752	16	7	0	7778
17175	8	12	1	7723	0	7744
17176	5	4	7851	15	0	7875
17177	5	4	12	7740	0	7761
17178	5	5	2	7897	0	7909
17179	5	3	7958	13	0	7979
17180	7543	3	16	24	0	7586
17181	13	4	1	8142	0	8160
17182	7	4	8543	14	0	8568
17183	2	8586	12	7	0	8607
17184	8685	9	6	23	0	8723
17185	14	8645	5	3	0	8667
17186	7	13	1	8761	0	8782
17187	8566	1	2	25	0	8594
17188	14	3	2	8484	0	8503
17189	6	5	8642	15	0	8668
17190	7	1	15	8588	0	8611
17191	4	5	8594	14	0	8617
17192	8262	4	18	23	0	8307
17193	20	3	8646	4	0	8673
17194	8574	2	15	23	0	8614
17195	8769	0	6	27	0	8802
17196	22	2	8905	3	0	8932
17197	15	4	8557	2	0	8578
17198	7	9009	20	5	0	9041
17199	9293	18	8	21	0	9340
17200	22	5	5	9500	0	9532
17201	15	4	0	9383	0	9402
17202	9844	0	5	57	0	9906
17203	9924	2	5	33	0	9964
17204	9920	3	1	30	0	9954
17205	9890	1	3	17	0	9911
17206	25	0	2	9854	0	9881
17207	9912	2	3	39	0	9956
17208	22	2	1	9977	0	10002
17209	11	0	5	9913	0	9929
17210	10	3	2	9992	0	10007
17211	9	7	9886	27	0	9929
17212	3	9678	17	14	0	9712
17213	8	9805	3	10	0	9826
17214	11	24	3	9999	0	10037
17215	9995	6	1	36	0	10038
17216	25	2	3	9968	0	9998
17217	9915	1	2	38	0	9956
17218	18	4	10265	9	0	10296
17219	10037	3	19	27	0	10086
17220	25	2	5	10515	0	10547
17221	10731	2	6	53	0	10792
17222	10532	3	2	27	0	10564
17223	10661	3	3	37	0	10704
17224	31	2	3	10699	0	10735
17225	12	12	10665	21	0	10710
17226	13	2	24	10647	0	10686
17227	10832	2	12	39	0	10885
17228	37	9	11630	7	0	11683
17229	25	4	25	12157	0	12211
17230	12508	2	11	70	0	12591
17231	42	5	12670	14	0	12731
17232	12996	4	35	37	0	13072
17233	13469	3	16	32	0	13520
17234	75	2	9	13638	0	13724
17235	37	5	8	13769	0	13819
17236	13790	4	2	90	0	13886
17237	61	4	5	14158	0	14228
17238	14115	1	7	88	0	14211
17239	70	14221	6	46	0	14343
17240	32	14315	5	25	0	14377
17241	20	83	7	14328	0	14438
17242	18	33	14620	68	0	14739
17243	12	14547	62	36	0	14657
17244	14410	67	28	39	0	14544
17245	65	14326	17	32	0	14440
17246	30	85	14363	9	0	14487
17247	42	34	65	14322	0	14463
17248	16	19	14642	73	0	14750
17249	5	14868	76	33	0	14982
17250	22	66	31	14782	0	14901
17251	9	14767	15	66	0	14857
17252	10	77	14747	19	0	14853
17253	20	40	75	14531	0	14666
17254	11	29	14738	67	0	14845
17255	24	18	83	14594	0	14719
17256	14583	11	37	102	0	14733
17257	71	17	14463	38	0	14589
17258	13584	10	79	57	0	13730
17259	81	12	14140	23	0	14256
17260	51	7	91	14089	0	14238
17261	30	8	14713	77	0	14828
17262	40	10	81	14656	0	14787
17263	29	5	42	14836	0	14912
17264	34	6	21	14586	0	14647
17265	22	3	27	14865	0	14917
17266	19	13	15429	123	0	15584
17267	15009	7	80	92	0	15188
17268	85	13	31	16257	0	16386
17269	16337	8	23	130	0	16498
17270	16584	6	17	89	0	16696
17271	16921	4	16	65	0	17006
17272	145	7	16	17104	0	17272
17273	79	6	11	17241	0	17337
17274	32	18888	20	139	0	19079
17275	20556	139	16	89	0	20800
17276	21671	80	10	82	0	21843
17277	22041	39	12	62	0	22154
17278	399	41	21997	43	0	22480
17279	262	20	229	21907	0	22418
17280	134	31	21969	236	0	22370
17281	21604	15	272	152	0	22043
17282	21918	12	157	109	0	22196
17283	414	9	87	21611	0	22121
17284	224	18	70	21098	0	21410
17285	136	21720	48	363	0	22267
17286	21998	236	40	199	0	22473
17287	22076	125	25	148	0	22374
17288	402	21885	35	94	0	22416
17289	22078	267	27	96	0	22468
17290	367	140	29	22027	0	22563
17291	237	73	33	22277	0	22620
17292	22223	57	23	416	0	22719
17293	343	45	21979	200	0	22567
17294	21823	29	226	182	0	22260
17295	22133	23	123	140	0	22419
17296	417	21721	70	89	0	22297
17297	22028	239	43	118	0	22428
17298	391	153	21692	45	0	22281
17299	295	73	246	21689	0	22303
17300	21748	53	129	284	0	22214
17301	381	45	82	21704	0	22212
17302	231	34	20993	326	0	21584
17303	176	30	268	20563	0	21037
17304	120	21946	176	355	0	22597
17305	148	241	92	22464	0	22945
17306	128	128	75	22794	0	23125
17307	129	67	47	22521	0	22764
17308	105	63	42	22824	0	23034
17309	70	65	22328	517	0	22980
17310	120	51	250	22518	0	22939
17311	22344	37	136	464	0	22981
17312	301	22225	83	276	0	22885
17313	211	255	61	22839	0	23366
17314	122	152	22857	388	0	23519
17315	126	70	275	23162	0	23633
17316	23225	56	139	436	0	23856
17317	23304	56	98	295	0	23753
17318	22934	43	70	188	0	23235
17319	538	35	64	22810	0	23447
17320	322	45	22597	348	0	23312
17321	247	22310	277	229	0	23063
17322	22668	268	175	186	0	23297
17323	391	142	115	22457	0	23105
17324	280	97	92	22618	0	23087
17325	196	74	22305	455	0	23030
17326	203	21757	293	284	0	22537
17327	162	22450	170	218	0	23000
17328	162	439	134	21492	0	22227
17329	145	207	21021	397	0	21770
17330	19920	122	300	287	0	20629
17331	347	102	19536	200	0	20185
17332	19606	84	268	205	0	20163
17333	369	20661	170	164	0	21364
17334	264	265	20405	160	0	21094
17335	19927	151	294	177	0	20549
17336	367	20243	173	121	0	20904
17337	20700	292	109	130	0	21231
17338	397	177	20700	89	0	21363
17339	262	20740	266	113	0	21381
17340	21117	292	148	113	0	21670
17341	413	178	20946	99	0	21636
17342	20858	91	300	119	0	21368
17343	423	74	185	20846	0	21528
17344	21061	77	135	318	0	21591
17345	441	60	102	21038	0	21641
17346	21030	69	91	383	0	21573
17347	404	71	21063	253	0	21791
17348	264	62	267	21244	0	21837
17349	169	66	169	21229	0	21633
17350	146	57	21126	489	0	21818
17351	125	56	305	21198	0	21684
17352	145	17208	261	457	0	18071
17353	111	252	126	22397	0	22886
17354	112	155	112	23299	0	23678
17355	120	96	95	25359	0	25670
17356	119	88	25087	685	0	25979
17357	24698	76	417	440	0	25631
17358	543	53	229	27052	0	27877
17359	278	45	27728	646	0	28697
17360	27430	59	560	392	0	28441
17361	28521	57	273	245	0	29096
17362	29315	67	150	215	0	29747
17363	914	62	130	29111	0	30217
17364	503	63	123	32139	0	32828
17365	359	61	104	31668	0	32192
17366	239	31891	94	996	0	33220
17367	31869	611	74	559	0	33113
17368	31734	254	76	378	0	32442
17369	991	158	84	31402	0	32635
17370	537	103	30756	752	0	32148
17371	368	100	30723	449	0	31640
17372	219	29384	867	301	0	30771
17373	204	30825	378	280	0	31687
17374	28014	892	426	410	0	29742
17375	609	27481	99	147	0	28336
17376	26908	522	119	124	0	27673
17377	26941	195	67	135	0	27338
17378	26884	103	74	118	0	27179
17379	766	93	51	26582	0	27492
17380	388	75	45	28011	0	28519
17381	28435	68	39	728	0	29270
17382	683	64	44	28914	0	29705
17383	296	62	28787	661	0	29806
17384	29091	55	538	321	0	30005
17385	713	62	193	29082	0	30050
17386	353	70	103	29600	0	30126
17387	276	59	62	29955	0	30352
17388	189	79	29025	850	0	30143
17389	27620	54	574	413	0	28661
17390	684	67	28944	231	0	29926
17391	379	60	624	28767	0	29830
17392	231	70	29221	672	0	30194
17393	225	56	639	28805	0	29725
17394	200	71	264	29594	0	30129
17395	165	50	29773	875	0	30863
17396	238	80	641	27947	0	28906
17397	190	29742	258	698	0	30888
17398	29822	559	178	398	0	30957
17399	30334	211	126	298	0	30969
17400	884	105	105	30019	0	31113
17401	366	76	30018	757	0	31217
17402	255	28866	657	393	0	30171
17403	193	30254	291	280	0	31018
17404	28958	736	173	277	0	30144
17405	735	282	28565	221	0	29803
17406	28606	149	642	267	0	29664
17407	816	94	287	28671	0	29868
17408	409	88	190	29253	0	29940
17409	28362	82	163	945	0	29552
17410	687	28398	155	484	0	29724
17411	375	601	28741	327	0	30044
17412	314	228	656	28489	0	29687
17413	227	136	28842	784	0	29989
17414	206	28474	736	433	0	29849
17415	245	607	318	28729	0	29899
17416	28507	259	223	833	0	29822
17417	28911	187	168	462	0	29728
17418	876	146	28422	331	0	29775
17419	445	28326	696	279	0	29746
17420	28306	624	343	259	0	29532
17421	781	28455	216	257	0	29709
17422	443	693	169	28312	0	29617
17423	28354	307	164	795	0	29620
17424	803	185	150	28612	0	29750
17425	439	182	28095	810	0	29526
17426	352	146	675	28533	0	29706
17427	269	182	28326	848	0	29625
17428	327	155	698	28309	0	29489
17429	28134	142	346	898	0	29520
17430	785	28138	245	486	0	29654
17431	28316	611	222	389	0	29538
17432	853	308	212	28062	0	29435
17433	437	232	191	28368	0	29228
17434	321	237	24503	989	0	26050
17435	298	172	27700	508	0	28678
17436	313	27860	794	369	0	29336
17437	310	663	27745	304	0	29022
17438	26518	286	756	354	0	27914
17439	754	27168	389	337	0	28648
17440	422	27672	267	316	0	28677
17441	296	27958	237	301	0	28792
17442	286	886	208	27467	0	28847
17443	263	388	27814	801	0	29266
17444	272	27896	727	444	0	29339
17445	296	755	324	26263	0	27638
17446	249	27951	240	748	0	29188
17447	27515	730	211	421	0	28877
17448	27986	337	197	356	0	28876
17449	897	271	235	27478	0	28881
17450	462	203	204	27701	0	28570
17451	26737	196	200	955	0	28088
17452	709	26234	198	517	0	27658
17453	402	26517	199	357	0	27475
17454	376	938	178	24821	0	26313
17455	195	274	23107	613	0	24189
17456	154	22770	501	363	0	23788
17457	21363	492	307	268	0	22430
17458	450	20646	195	207	0	21498
17459	224	20276	132	188	0	20820
17460	19109	489	215	156	0	19969
17461	368	19586	111	132	0	20197
17462	254	412	18888	129	0	19683
17463	159	18657	352	155	0	19323
17464	15678	308	234	100	0	16320
17465	190	15451	64	50	0	15755
17466	15126	217	105	70	0	15518
17467	212	98	43	15023	0	15376
17468	100	75	34	15286	0	15495
17469	70	71	15293	199	0	15633
17470	63	15358	153	101	0	15675
17471	69	172	55	15489	0	15785
17472	15417	76	46	221	0	15760
17473	15365	58	39	121	0	15583
17474	207	15605	46	73	0	15931
17475	97	201	38	15589	0	15925
17476	15594	83	39	232	0	15948
17477	15653	68	65	96	0	15882
17478	244	67	15218	56	0	15585
17479	122	69	14383	51	0	14625
17480	81	54	14241	48	0	14424
17481	43	13819	155	48	0	14065
17482	13051	137	161	47	0	13396
17483	118	12940	34	26	0	13118
17484	12730	116	42	45	0	12933
17485	98	13249	23	28	0	13398
17486	55	106	25	13465	0	13651
17487	13543	53	16	122	0	13734
17488	110	32	13575	37	0	13754
17489	13384	31	104	40	0	13559
17490	13686	21	39	42	0	13788
17491	129	13667	16	27	0	13839
17492	49	13745	17	27	0	13838
17493	14093	124	50	44	0	14311
17494	129	49	14355	20	0	14553
17495	13539	81	114	45	0	13779
17496	13789	34	41	39	0	13903
17497	139	28	16	13609	0	13792
17498	13851	22	17	102	0	13992
17499	135	30	9	13972	0	14146
17500	70	22	11	14238	0	14341
17501	51	19	10	13918	0	13998
17502	39	13946	19	124	0	14128
17503	14088	90	18	60	0	14256
17504	14180	34	20	38	0	14272
17505	128	23	15	14187	0	14353
17506	77	24	16	13981	0	14098
17507	44	14007	16	108	0	14175
17508	14016	107	15	51	0	14189
17509	123	39	13875	35	0	14072
17510	58	33	91	13959	0	14141
17511	45	24	13746	110	0	13925
17512	56	25	93	13737	0	13911
17513	39	28	13748	109	0	13924
17514	63	20	90	13499	0	13672
17515	13637	24	30	122	0	13813
17516	122	18	13919	56	0	14115
17517	13534	21	109	56	0	13720
17518	131	14443	35	42	0	14651
17519	70	98	32	14700	0	14900
17520	58	35	18	14853	0	14964
17521	15166	23	27	139	0	15355
17522	128	23	27	15431	0	15609
17523	63	30	15372	115	0	15580
17524	15195	20	82	89	0	15386
17525	15836	27	20	68	0	15951
17526	15799	19	21	69	0	15908
17527	15745	18	19	66	0	15848
17528	136	15646	18	55	0	15855
17529	76	98	18	15795	0	15987
17530	15688	27	14	140	0	15869
17531	137	26	16	15549	0	15728
17532	15382	26	16	128	0	15552
17533	134	17	15092	52	0	15295
17534	70	22	14909	32	0	15033
17535	61	231	88	14355	0	14735
17536	40	14675	39	96	0	14850
17537	36	14999	24	59	0	15118
17538	14733	90	48	81	0	14952
17539	93	26	14716	40	0	14875
17540	13626	15	81	59	0	13781
17541	84	14484	43	37	0	14648
17542	14509	62	21	59	0	14651
17543	88	27	18	14319	0	14452
17544	45	37	14512	78	0	14672
17545	52	19	70	14439	0	14580
17546	56	12	22	14421	0	14511
17547	37	14365	21	87	0	14510
17548	38	14663	15	41	0	14757
17549	41	67	19	14631	0	14758
17550	51	14712	20	83	0	14866
17551	35	72	14568	47	0	14722
17552	42	28	14104	41	0	14215
17553	13516	24	84	53	0	13677
17554	14382	16	27	59	0	14484
17555	109	14221	23	30	0	14383
17556	57	68	15	14232	0	14372
17557	47	27	16	14320	0	14410
17558	35	31	14325	89	0	14480
17559	53	14	74	13745	0	13886
17560	36	14080	24	97	0	14237
17561	29	80	13627	47	0	13783
17562	37	27	13452	33	0	13549
17563	41	12924	96	36	0	13097
17564	38	81	13679	28	0	13826
17565	40	34	74	13565	0	13713
17566	76	35	48	12141	0	12300
17567	35	25	13842	96	0	13998
17568	56	44	85	13532	0	13717
17569	30	13235	33	84	0	13382
17570	30	13815	33	42	0	13920
17571	38	104	22	13681	0	13845
17572	29	27	13960	88	0	14104
17573	12	14071	79	47	0	14209
17574	48	109	42	13976	0	14175
17575	26	25	13763	80	0	13894
17576	12949	14	64	61	0	13088
17577	13624	17	22	52	0	13715
17578	13659	18	11	41	0	13729
17579	76	18	11	13484	0	13589
17580	33	9	19	13521	0	13582
17581	28	16	13986	74	0	14104
17582	41	13	57	13863	0	13974
17583	32	11	22	14066	0	14131
17584	24	8	14036	78	0	14146
17585	12154	9	61	72	0	12296
17586	68	13174	22	21	0	13285
17587	13124	55	12	53	0	13244
17588	50	13136	14	18	0	13218
17589	30	62	17	13218	0	13327
17590	27	21	13354	58	0	13460
17591	42	36	59	12976	0	13113
17592	16	25	13025	68	0	13134
17593	11315	11	55	72	0	11453
17594	45	3	12290	18	0	12356
17595	23	7	51	12038	0	12119
17596	10	10	12323	54	0	12397
17597	10	12597	51	30	0	12688
17598	35	47	27	12818	0	12927
17599	25	18	19	12765	0	12827
17600	24	10	10	13384	0	13428
17601	15	13	13427	95	0	13550
17602	12	17	13698	43	0	13770
17603	25	10	100	13911	0	14046
17604	28	6	35	15829	0	15898
17605	16	7	25	16919	0	16967
17606	17512	2	21	289	0	17824
17607	238	4	20	18412	0	18674
17608	84	18	19644	266	0	20012
17609	20997	4	266	128	0	21395
17610	360	13	98	22122	0	22593
17611	23345	8	63	384	0	23800
17612	23986	7	32	206	0	24231
17613	556	8	28	23989	0	24581
17614	24137	7	27	455	0	24626
17615	24275	4	29	238	0	24546
17616	588	8	23682	112	0	24390
17617	280	23843	361	99	0	24583
17618	222	339	158	23000	0	23719
17619	171	145	70	23929	0	24315
17620	23710	74	51	559	0	24394
17621	23504	47	47	283	0	23881
17622	23525	30	33	199	0	23787
17623	621	31	22554	125	0	23331
17624	315	22761	380	93	0	23549
17625	22838	361	168	108	0	23475
17626	494	22938	98	88	0	23618
17627	23196	435	61	76	0	23768
17628	558	195	42	22968	0	23763
17629	23089	108	49	449	0	23695
17630	23295	79	53	239	0	23666
17631	23462	60	30	176	0	23728
17632	697	47	22937	119	0	23800
17633	23402	36	354	135	0	23927
17634	608	23420	153	93	0	24274
17635	24008	375	86	116	0	24585
17636	24327	172	69	97	0	24665
17637	24765	106	52	102	0	25025
17638	791	72	49	23706	0	24618
17639	416	23962	48	407	0	24833
17640	24124	424	39	229	0	24816
17641	610	199	23974	150	0	24933
17642	373	24143	418	108	0	25042
17643	337	464	176	22580	0	23557
17644	233	24045	103	380	0	24761
17645	24033	503	86	222	0	24844
17646	24845	261	64	143	0	25313
17647	749	151	68	24471	0	25439
17648	401	122	24111	516	0	25150
17649	293	24301	434	264	0	25292
17650	415	495	222	20210	0	21342
17651	255	239	119	25098	0	25711
17652	244	141	80	25988	0	26453
17653	25705	93	76	759	0	26633
17654	26019	92	80	380	0	26571
17655	26213	95	65	244	0	26617
17656	26471	92	49	214	0	26826
17657	919	93	59	25871	0	26942
17658	525	87	25992	574	0	27178
17659	396	78	478	26321	0	27273
17660	351	63	224	26465	0	27103
17661	332	82	124	26627	0	27165
17662	333	75	94	26766	0	27268
17663	26169	74	89	919	0	27251
17664	747	69	103	26390	0	27309
17665	26315	73	123	797	0	27308
17666	26607	76	112	500	0	27295
17667	940	89	25842	354	0	27225
17668	624	69	25502	286	0	26481
17669	499	80	26399	293	0	27271
17670	497	98	689	25916	0	27200
17671	446	71	26260	683	0	27460
17672	468	75	627	25769	0	26939
17673	413	101	345	26078	0	26937
17674	26036	107	241	892	0	27276
17675	788	117	186	25760	0	26851
17676	522	26077	179	816	0	27594
17677	26703	511	147	504	0	27865
17678	824	26771	145	355	0	28095
17679	566	593	26761	335	0	28255
17680	419	27021	566	317	0	28323
17681	26662	650	297	286	0	27895
17682	859	342	189	26489	0	27879
17683	601	279	26222	613	0	27715
17684	26376	205	580	419	0	27580
17685	862	200	294	26437	0	27793
17686	594	186	26487	686	0	27953
17687	554	140	572	26629	0	27895
17688	489	134	299	26942	0	27864
17689	481	110	234	26758	0	27583
17690	436	26341	179	878	0	27834
17691	26846	550	176	498	0	28070
17692	854	298	168	26425	0	27745
17693	561	26574	155	694	0	27984
17694	499	614	98	26835	0	28046
17695	411	343	26458	763	0	27975
17696	410	26679	537	440	0	28066
17697	26493	614	273	363	0	27743
17698	26530	335	216	311	0	27392
17699	911	255	169	25918	0	27253
17700	524	250	151	26174	0	27099
17701	25934	206	147	864	0	27151
17702	25384	197	174	505	0	26260
17703	885	25446	129	355	0	26815
17704	23687	455	118	303	0	24563
17705	658	223	22539	253	0	23673
17706	480	168	21851	205	0	22704
17707	301	20993	425	233	0	21952
17708	213	20326	230	158	0	20927
17709	17953	414	465	139	0	18971
17710	263	17921	78	103	0	18365
17711	16986	205	92	96	0	17379
17712	16653	87	61	79	0	16880
17713	16496	65	50	90	0	16701
17714	279	45	38	16358	0	16720
17715	16440	53	36	238	0	16767
17716	244	52	16213	107	0	16616
17717	138	45	16089	76	0	16348
17718	121	16200	215	69	0	16605
17719	86	172	16367	70	0	16695
17720	117	73	205	16019	0	16414
17721	75	51	16314	218	0	16658
17722	71	48	16131	93	0	16343
17723	68	45	231	16196	0	16540
17724	16311	50	105	233	0	16699
17725	16454	43	63	131	0	16691
17726	244	40	16682	71	0	17037
17727	16367	43	202	95	0	16707
17728	237	30	16902	71	0	17240
17729	16678	33	207	92	0	17010
17730	17256	32	96	87	0	17471
17731	278	30	68	17061	0	17437
17732	150	35	50	16674	0	16909
17733	94	16267	64	238	0	16663
17734	83	16670	50	111	0	16914
17735	108	223	58	16257	0	16646
17736	80	85	53	16386	0	16604
17737	15767	56	34	250	0	16107
17738	213	15730	35	109	0	16087
17739	15554	164	39	107	0	15864
17740	183	15709	41	89	0	16022
17741	99	180	15386	61	0	15726
17742	107	104	159	15300	0	15670
17743	15436	52	69	199	0	15756
17744	15935	36	36	102	0	16109
17745	238	16055	42	68	0	16403
17746	111	16314	48	51	0	16524
17747	59	16729	36	58	0	16882
17748	112	321	34	17672	0	18139
17749	71	77	18295	243	0	18686
17750	44	18227	245	81	0	18597
17751	109	283	59	18279	0	18730
17752	53	64	39	18659	0	18815
17753	33	46	18375	280	0	18734
17754	40	30	18068	85	0	18223
17755	18035	29	274	92	0	18430
17756	246	17	18830	49	0	19142
17757	18574	26	262	63	0	18925
17758	18412	39	79	52	0	18582
17759	18512	30	56	62	0	18660
17760	18461	24	29	79	0	18593
17761	323	19	17980	36	0	18358
17762	111	18132	241	38	0	18522
17763	130	245	69	17933	0	18377
17764	68	67	18250	240	0	18625
17765	76	53	256	17824	0	18209
17766	68	16243	100	271	0	16682
17767	88	263	60	18269	0	18680
17768	94	63	40	18403	0	18600
17769	107	53	46	17993	0	18199
17770	18023	54	28	347	0	18452
17771	309	44	29	18027	0	18409
17772	118	32	24	18200	0	18374
17773	96	34	57	17963	0	18150
17774	45	17404	50	338	0	17837
17775	17280	254	36	136	0	17706
17776	258	16551	52	112	0	16973
17777	78	16774	40	79	0	16971
17778	104	271	54	16773	0	17202
17779	92	82	43	16989	0	17206
17780	16861	47	37	353	0	17298
17781	288	36	44	17081	0	17449
17782	17250	37	35	332	0	17654
17783	20086	36	27	141	0	20290
17784	524	33	49	19977	0	20583
17785	220	48	41	20057	0	20366
17786	93	20497	44	511	0	21145
17787	21209	414	39	252	0	21914
17788	477	22005	36	133	0	22651
17789	22091	482	48	119	0	22740
17790	572	183	21643	92	0	22490
17791	21704	92	439	147	0	22382
17792	22657	69	158	139	0	23023
17793	679	61	68	22060	0	22868
17794	281	81	22143	522	0	23027
17795	186	22233	483	215	0	23117
17796	171	518	166	22740	0	23595
17797	131	215	22866	549	0	23761
17798	171	138	504	22787	0	23600
17799	22596	67	209	642	0	23514
17800	598	75	22506	254	0	23433
17801	238	21979	525	196	0	22938
17802	150	22738	237	143	0	23268
17803	232	686	137	20013	0	21068
17804	118	22271	90	432	0	22911
17805	22090	544	94	229	0	22957
17806	22266	208	81	201	0	22756
17807	22379	137	60	142	0	22718
17808	732	107	21623	104	0	22566
17809	21992	104	492	146	0	22734
17810	622	117	193	21744	0	22676
17811	308	91	94	22000	0	22493
17812	219	92	74	22156	0	22541
17813	196	77	79	22175	0	22527
17814	145	97	21553	738	0	22533
17815	159	84	21506	319	0	22068
17816	127	78	21447	238	0	21890
17817	20591	72	648	204	0	21515
17818	588	20946	243	193	0	21970
17819	286	518	126	20996	0	21926
17820	20914	189	116	648	0	21867
17821	565	21095	112	309	0	22081
17822	265	21639	108	226	0	22238
17823	21302	663	108	166	0	22239
17824	21644	287	92	154	0	22177
17825	724	21428	97	153	0	22402
17826	380	559	65	20270	0	21274
17827	236	21097	74	530	0	21937
17828	20912	570	90	268	0	21840
17829	20966	261	84	195	0	21506
17830	20981	194	70	154	0	21399
17831	782	20333	80	177	0	21372
17832	393	519	82	20524	0	21518
17833	224	263	20398	598	0	21483
17834	214	182	483	20415	0	21294
17835	221	126	203	20941	0	21491
17836	196	140	20359	689	0	21384
17837	20220	131	504	312	0	21167
17838	613	122	219	20606	0	21560
17839	324	143	139	20536	0	21142
17840	241	20372	102	677	0	21392
17841	20420	538	108	337	0	21403
17842	644	250	87	20033	0	21014
17843	290	20132	108	582	0	21112
17844	19521	496	94	316	0	20427
17845	571	19445	93	216	0	20325
17846	18646	509	113	217	0	19485
17847	581	219	18316	194	0	19310
17848	271	144	16538	157	0	17110
17849	182	116	16189	109	0	16596
17850	139	16179	514	143	0	16975
17851	218	467	365	14426	0	15476
17852	148	15126	112	307	0	15693
17853	15353	425	86	186	0	16050
17854	421	184	15444	132	0	16181
17855	15141	120	393	94	0	15748
17856	15467	117	192	93	0	15869
17857	515	112	115	15135	0	15877
17858	15309	113	77	389	0	15888
17859	488	84	78	15297	0	15947
17860	239	93	15153	404	0	15889
17861	14949	80	363	217	0	15609
17862	434	15076	186	125	0	15821
17863	239	349	121	15203	0	15912
17864	15222	183	68	395	0	15868
17865	460	120	59	15217	0	15856
17866	230	98	14903	426	0	15657
17867	187	80	345	14801	0	15413
17868	142	14923	179	403	0	15647
17869	15002	359	116	219	0	15696
17870	431	173	76	14941	0	15621
17871	15033	110	70	417	0	15630
17872	472	72	70	15022	0	15636
17873	236	66	64	14816	0	15182
17874	156	14840	62	474	0	15532
17875	14864	360	51	276	0	15551
17876	405	15335	60	163	0	15963
17877	245	383	49	14564	0	15241
17878	132	14785	58	373	0	15348
17879	14652	358	44	226	0	15280
17880	14499	203	54	171	0	14927
17881	14466	116	41	155	0	14778
17882	503	13804	55	122	0	14484
17883	114	11227	23	53	0	11417
17884	10988	189	45	58	0	11280
17885	182	11147	25	52	0	11406
17886	117	350	52	10276	0	10795
17887	90	64	9894	135	0	10183
17888	9059	51	102	49	0	9261
17889	9132	17	19	55	0	9223
17890	9068	29	18	35	0	9150
17891	107	9127	11	27	0	9272
17892	8978	81	8	30	0	9097
17893	109	34	9243	13	0	9399
17894	44	9053	68	22	0	9187
17895	44	156	21	8526	0	8747
17896	19	8543	12	35	0	8609
17897	8146	48	10	28	0	8232
17898	40	8273	3	10	0	8326
17899	22	30	5	8199	0	8256
17900	12	8244	6	30	0	8292
17901	14	31	2	8396	0	8443
17902	12	14	4	8232	0	8262
17903	13	12	8266	37	0	8328
17904	20	11	28	8083	0	8142
17905	8067	7	11	52	0	8137
17906	8062	5	10	15	0	8092
17907	45	4	7	8113	0	8169
17908	15	8	8063	38	0	8124
17909	18	6	31	7980	0	8035
17910	7995	10	6	49	0	8060
17911	8225	6	8	32	0	8271
17912	8302	9	3	31	0	8345
17913	42	8583	6	13	0	8644
17914	8634	28	5	33	0	8700
17915	49	10	8527	10	0	8596
17916	9039	9	34	40	0	9122
17917	49	7	12	9420	0	9488
17918	23	12	7	9450	0	9492
17919	16	9	4	9488	0	9517
17920	9230	5	2	70	0	9307
17921	9045	6	5	38	0	9094
17922	58	5	6	9063	0	9132
17923	29	10	9220	48	0	9307
17924	29	5	34	9170	0	9238
17925	23	9	10	9061	0	9103
17926	22	6	9072	53	0	9153
17927	13	9049	40	32	0	9134
17928	24	39	14	9225	0	9302
17929	9380	15	10	59	0	9464
17930	53	10	6	9423	0	9492
17931	26	14	3	9497	0	9540
17932	9498	5	8	77	0	9588
17933	50	9430	9	31	0	9520
17934	20	9575	9	23	0	9627
17935	9544	48	8	25	0	9625
17936	50	23	9527	18	0	9618
17937	9160	16	40	43	0	9259
17938	55	13	9977	16	0	10061
17939	21	10073	43	17	0	10154
17940	10163	36	25	41	0	10265
17941	10281	11	9	39	0	10340
17942	10353	16	5	33	0	10407
17943	10416	8	5	41	0	10470
17944	63	15	10482	10	0	10570
17945	49	13	39	10379	0	10480
17946	10514	11	15	55	0	10595
17947	58	12	10854	17	0	10941
17948	26	9	10645	16	0	10696
17949	24	10695	50	9	0	10778
17950	10722	41	28	30	0	10821
17951	60	17	15	10702	0	10794
17952	10854	12	9	52	0	10927
17953	55	11074	5	17	0	11151
17954	29	41	4	11600	0	11674
17955	23	12	11	11603	0	11649
17956	22	6	7	11954	0	11989
17957	13	13	12135	78	0	12239
17958	14	12324	64	30	0	12432
17959	13198	72	22	38	0	13330
17960	118	25	13	13240	0	13396
17961	13275	16	6	121	0	13418
17962	13162	6	7	56	0	13231
17963	152	10	7	13198	0	13367
17964	61	16	13419	120	0	13616
17965	50	7	103	13307	0	13467
17966	18	13511	38	116	0	13683
17967	26	94	22	13736	0	13878
17968	20	40	13679	119	0	13858
17969	13557	21	104	70	0	13752
17970	119	10	38	13867	0	14034
17971	13762	7	22	130	0	13921
17972	131	14	13642	56	0	13843
17973	13147	7	102	66	0	13322
17974	132	12	13651	20	0	13815
17975	13111	8	106	61	0	13286
17976	123	13222	43	29	0	13417
17977	51	13588	24	29	0	13692
17978	36	135	14	13628	0	13813
17979	60	47	17	12539	0	12663
17980	33	28	12	13705	0	13778
17981	13726	12	13	175	0	13926
17982	124	13	10	13896	0	14043
17983	59	13	13896	123	0	14091
17984	13383	10	107	91	0	13591
17985	120	13957	32	51	0	14160
17986	14043	106	31	45	0	14225
17987	13847	42	15	55	0	13959
17988	162	27	13919	20	0	14128
17989	90	18	108	13812	0	14028
17990	45	11	44	14461	0	14561
17991	41	21	14560	162	0	14784
17992	30	14453	123	85	0	14691
17993	14245	116	51	61	0	14473
17994	14405	50	30	64	0	14549
17995	195	27	17	14607	0	14846
17996	84	20	22	14648	0	14774
17997	55	18	20	15310	0	15403
17998	15074	16	20	248	0	15358
17999	147	15426	20	100	0	15693
18000	15669	144	12	94	0	15919
18001	15678	58	16	70	0	15822
18002	223	35	16343	43	0	16644
18003	131	21	170	15943	0	16265
18004	61	16685	66	205	0	17017
18005	65	171	35	17009	0	17280
18006	64	75	26	17545	0	17710
18007	56	45	17761	267	0	18129
18008	18227	26	214	150	0	18617
18009	19927	21	85	97	0	20130
18010	20885	22	49	102	0	21058
18011	415	32	27	20646	0	21120
18012	178	47	32	20493	0	20750
18013	91	20346	38	407	0	20882
18014	76	21187	45	179	0	21487
18015	20957	373	34	120	0	21484
18016	378	20727	34	68	0	21207
18017	178	338	20612	69	0	21197
18018	128	126	303	20981	0	21538
18019	21203	74	120	387	0	21784
18020	358	57	21076	171	0	21662
18021	173	70	21023	96	0	21362
18022	21212	49	425	88	0	21774
18023	21337	42	163	100	0	21642
18024	495	45	85	21030	0	21655
18025	203	45	21017	383	0	21648
18026	137	43	351	21090	0	21621
18027	125	57	19801	406	0	20389
18028	114	56	20953	172	0	21295
18029	103	21144	410	119	0	21776
18030	21206	331	173	115	0	21825
18031	21321	122	107	132	0	21682
18032	462	21089	93	104	0	21748
18033	240	334	92	20977	0	21643
18034	160	153	80	21211	0	21604
18035	138	91	73	21438	0	21740
18036	21049	69	70	525	0	21713
18037	395	20889	56	230	0	21570
18038	20585	341	56	170	0	21152
18039	20608	146	68	123	0	20945
18040	491	98	20022	117	0	20728
18041	228	20024	345	111	0	20708
18042	200	344	153	20114	0	20811
18043	140	164	20104	350	0	20758
18044	19797	115	341	200	0	20453
18045	20246	81	150	129	0	20606
18046	20260	63	101	126	0	20550
18047	20025	62	72	133	0	20292
18048	549	43	85	19557	0	20234
18049	250	54	19412	391	0	20107
18050	200	56	345	19437	0	20038
18051	19452	40	165	399	0	20056
18052	19366	45	89	185	0	19685
18053	509	18800	62	120	0	19491
18054	18590	292	56	133	0	19071
18055	413	141	18382	113	0	19049
18056	227	80	18278	96	0	18681
18057	17779	98	432	113	0	18422
18058	417	17730	176	72	0	18395
18059	259	284	68	16439	0	17050
18060	166	16865	60	259	0	17350
18061	143	283	67	16988	0	17481
18062	139	125	60	17092	0	17416
18063	136	80	60	17447	0	17723
18064	16764	67	63	415	0	17309
18065	17209	72	47	204	0	17532
18066	17036	79	46	130	0	17291
18067	427	68	16676	103	0	17274
18068	16818	55	286	120	0	17279
18069	399	45	149	17158	0	17751
18070	238	37	95	17837	0	18207
18071	164	49	17745	405	0	18363
18072	183	54	300	19287	0	19824
18073	19928	41	153	438	0	20560
18074	427	39	19932	215	0	20613
18075	253	36	371	20006	0	20666
18076	20069	36	156	466	0	20727
18077	20080	30	112	244	0	20466
18078	532	52	20022	172	0	20778
18079	305	40	20334	99	0	20778
18080	219	48	488	20388	0	21143
18081	20594	46	228	452	0	21320
18082	20830	45	127	219	0	21221
18083	571	56	98	19935	0	20660
18084	277	20434	92	426	0	21229
18085	20450	333	110	209	0	21102
18086	450	20555	107	180	0	21292
18087	290	375	91	20644	0	21400
18088	227	141	20431	429	0	21228
18089	174	90	20035	212	0	20511
18090	152	80	20322	136	0	20690
18091	184	59	491	19782	0	20516
18092	168	56	233	20144	0	20601
18093	19802	51	147	523	0	20523
18094	423	19604	113	252	0	20392
18095	19788	321	117	189	0	20415
18096	499	127	120	18926	0	19672
18097	227	18893	95	365	0	19580
18098	174	19478	78	200	0	19930
18099	179	430	59	19100	0	19768
18100	18885	180	64	398	0	19527
18101	409	18905	76	187	0	19577
18102	17893	302	82	164	0	18441
18103	388	18237	81	112	0	18818
18104	17916	342	91	108	0	18457
18105	408	136	17480	112	0	18136
18106	233	116	17085	88	0	17522
18107	171	16807	314	73	0	17365
18108	15357	443	397	111	0	16308
18109	245	14474	103	53	0	14875
18110	125	13364	41	53	0	13583
18111	227	284	58	13448	0	14017
18112	13361	96	77	170	0	13704
18113	178	13463	40	80	0	13761
18114	13075	166	41	75	0	13357
18115	186	13001	25	32	0	13244
18116	12698	185	23	53	0	12959
18117	189	12543	28	34	0	12794
18118	92	12560	17	35	0	12704
18119	88	241	36	11953	0	12318
18120	58	12289	34	122	0	12503
18121	12132	185	25	68	0	12410
18122	165	75	12070	49	0	12359
18123	88	65	127	12071	0	12351
18124	70	64	12208	129	0	12471
18125	48	44	149	12066	0	12307
18126	58	39	51	12226	0	12374
18127	45	47	11744	188	0	12024
18128	10877	31	163	118	0	11189
18129	154	11503	78	84	0	11819
18130	11631	141	62	58	0	11892
18131	192	11729	48	50	0	12019
18132	85	174	33	11762	0	12054
18133	11336	65	443	175	0	12019
18134	11775	69	36	81	0	11961
18135	11859	45	34	83	0	12021
18136	241	41	36	11767	0	12085
18137	130	55	33	11792	0	12010
18138	93	12052	37	190	0	12372
18139	12182	161	31	100	0	12474
18140	12292	64	28	89	0	12473
18141	12243	70	37	58	0	12408
18142	12119	49	33	72	0	12273
18143	238	11823	32	50	0	12143
18144	128	172	36	11964	0	12300
18145	119	68	11887	156	0	12230
18146	11606	77	149	92	0	11924
18147	12174	53	52	98	0	12377
18148	245	47	12096	44	0	12432
18149	124	69	12147	55	0	12395
18150	125	51	180	12190	0	12546
18151	70	62	97	12485	0	12714
18152	96	49	66	12620	0	12831
18153	12446	60	48	247	0	12801
18154	198	49	47	12497	0	12791
18155	96	52	12217	213	0	12578
18156	92	48	164	12410	0	12714
18157	88	40	12529	226	0	12883
18158	68	54	183	12546	0	12851
18159	93	40	62	13200	0	13395
18160	58	64	13267	241	0	13630
18161	12572	44	186	167	0	12969
18162	185	13444	79	98	0	13806
18163	13659	173	72	77	0	13981
18164	243	94	39	14153	0	14529
18165	14267	80	30	243	0	14620
18166	249	14675	43	116	0	15083
18167	123	15478	30	96	0	15727
18168	152	484	39	15905	0	16580
18169	107	159	16456	236	0	16958
18170	79	108	15761	123	0	16071
18171	85	15948	294	109	0	16436
18172	13900	279	193	107	0	14479
18173	195	102	84	13696	0	14077
18174	13535	64	62	199	0	13860
18175	212	13373	64	112	0	13761
18176	105	13785	58	78	0	14026
18177	116	278	47	13769	0	14210
18178	13688	144	29	202	0	14063
18179	13660	90	8	124	0	13882
18180	268	67	13444	82	0	13861
18181	156	72	13039	59	0	13326
18182	13078	63	206	65	0	13412
18183	200	13253	131	50	0	13634
18184	13182	167	84	44	0	13477
18185	256	99	69	13040	0	13464
18186	165	62	12967	154	0	13348
18187	12455	43	201	111	0	12810
18188	211	12692	117	66	0	13086
18189	136	12998	82	57	0	13273
18190	162	254	65	12879	0	13360
18191	13023	121	52	202	0	13398
18192	224	77	52	13059	0	13412
18193	13310	67	49	239	0	13665
18194	232	77	12786	120	0	13215
18195	12967	77	145	117	0	13306
18196	13258	72	58	92	0	13480
18197	304	46	12791	87	0	13228
18198	12557	26	164	93	0	12840
18199	298	12536	99	65	0	12998
18200	202	161	89	12507	0	12959
18201	173	12679	69	141	0	13062
18202	12894	199	60	97	0	13250
18203	263	114	62	12594	0	13033
18204	161	12486	56	182	0	12885
18205	142	203	43	12541	0	12929
18206	81	12690	31	227	0	13029
18207	107	232	25	12761	0	13125
18208	12755	138	27	244	0	13164
18209	222	112	25	12744	0	13103
18210	138	91	12478	263	0	12970
18211	12355	80	159	179	0	12773
18212	225	70	81	12597	0	12973
18213	159	69	12324	239	0	12791
18214	126	43	11774	173	0	12116
18215	117	36	12464	129	0	12746
18216	143	27	276	12334	0	12780
18217	107	31	177	12751	0	13066
18218	99	42	128	12795	0	13064
18219	81	41	111	12888	0	13121
18220	12758	49	113	318	0	13238
18221	12968	33	87	215	0	13303
18222	13052	49	67	186	0	13354
18223	13271	44	39	173	0	13527
18224	308	50	37	13125	0	13520
18225	210	47	13267	262	0	13786
18226	13263	38	150	198	0	13649
18227	13758	46	98	130	0	14032
18228	358	37	76	13564	0	14035
18229	248	33	52	13794	0	14127
18230	13887	36	65	315	0	14303
18231	275	30	73	13452	0	13830
18232	193	13348	75	283	0	13899
18233	13722	159	70	196	0	14147
18234	13607	84	53	174	0	13918
18235	330	68	13868	148	0	14414
18236	232	43	181	13931	0	14387
18237	159	50	105	14257	0	14571
18238	14107	59	91	318	0	14575
18239	14229	46	65	197	0	14537
18240	352	45	53	14190	0	14640
18241	238	21	14054	279	0	14592
18242	176	12	14004	207	0	14399
18243	157	24	250	14254	0	14685
18244	177	30	134	14342	0	14683
18245	14128	32	81	313	0	14554
18246	285	13814	81	201	0	14381
18247	185	13695	76	166	0	14122
18248	131	14133	95	130	0	14489
18249	132	232	84	13977	0	14425
18250	13848	118	67	268	0	14301
18251	13814	89	24	181	0	14108
18252	298	13810	22	118	0	14248
18253	13929	225	20	102	0	14276
18254	259	129	34	13850	0	14272
18255	188	88	13815	222	0	14313
18256	184	60	156	13628	0	14028
18257	172	58	75	13690	0	13995
18258	156	56	58	13593	0	13863
18259	13083	44	53	306	0	13486
18260	216	81	57	12668	0	13022
18261	127	12584	58	287	0	13056
18262	12276	128	110	237	0	12751
18263	185	12086	41	182	0	12494
18264	131	11552	30	138	0	11851
18265	102	11699	37	119	0	11957
18266	125	151	10745	81	0	11102
18267	59	10274	107	80	0	10520
18268	89	87	9205	57	0	9438
18269	8455	48	59	31	0	8593
18270	8756	12	20	27	0	8815
18271	36	8	9009	20	0	9073
18272	8899	4	32	27	0	8962
18273	9258	5	11	35	0	9309
18274	39	13	9313	10	0	9375
18275	21	9552	28	13	0	9614
18276	19	54	8	9548	0	9629
18277	9618	11	5	46	0	9680
18278	36	11	7	9498	0	9552
18279	9875	4	12	42	0	9933
18280	9780	14	2	26	0	9822
18281	38	11	9894	11	0	9954
18282	9677	12	28	23	0	9740
18283	39	10142	14	13	0	10208
18284	10211	31	10	27	0	10279
18285	46	11	3	10284	0	10344
18286	25	10	10211	31	0	10277
18287	23	6	32	10119	0	10180
18288	10107	11	14	53	0	10185
18289	38	10092	9	17	0	10156
18290	21	36	10092	16	0	10165
18291	23	16	30	9854	0	9923
18292	15	14	10148	40	0	10217
18293	15	10077	33	28	0	10153
18294	10081	35	14	21	0	10151
18295	46	11	10	10095	0	10162
18296	20	16	10179	35	0	10250
18297	25	15	9673	19	0	9732
18298	10237	12	38	33	0	10320
18299	51	16	21	10333	0	10421
18300	21	17	9	10391	0	10438
18301	23	13	10430	44	0	10510
18302	11	16	10348	27	0	10402
18303	21	10726	60	11	0	10818
18304	23	43	24	10796	0	10886
18305	19	20	41	10745	0	10825
18306	26	10738	6	61	0	10831
18307	24	45	10665	28	0	10762
18308	10474	17	47	28	0	10566
18309	56	16	22	10910	0	11004
18310	32	15	11081	50	0	11178
18311	26	18	44	10774	0	10862
18312	29	11037	24	67	0	11157
18313	28	44	11019	30	0	11121
18314	10611	21	54	37	0	10723
18315	58	23	11107	13	0	11201
18316	33	22	10799	16	0	10870
18317	30	16	10673	19	0	10738
18318	24	12	11387	22	0	11445
18319	30	20	81	11634	0	11765
18320	19	20	12135	72	0	12246
18321	34	14	87	11835	0	11970
18322	12	12130	36	92	0	12270
18323	12971	86	20	40	0	13117
18324	129	29	15	13395	0	13568
18325	60	16	13421	135	0	13632
18326	30	13464	136	62	0	13692
18327	40	140	52	13536	0	13768
18328	13516	50	34	165	0	13765
18329	124	13613	20	69	0	13826
18330	67	145	18	13745	0	13975
18331	13802	49	17	162	0	14030
18332	147	36	13678	62	0	13923
18333	13520	14	155	67	0	13756
18334	167	17	13904	17	0	14105
18335	13199	14	170	33	0	13416
18336	13318	9	57	45	0	13429
18337	190	11	13157	11	0	13369
18338	79	13057	123	16	0	13275
18339	83	145	56	12656	0	12940
18340	29	44	13267	127	0	13467
18341	32	44	141	12832	0	13049
18342	33	15	59	13023	0	13130
18343	19	10	13141	183	0	13353
18344	22	10	12996	86	0	13114
18345	26	6	178	13179	0	13389
18346	13332	7	88	155	0	13582
18347	135	13163	33	73	0	13404
18348	66	13312	24	36	0	13438
18349	13331	168	23	41	0	13563
18350	13540	73	20	35	0	13668
18351	192	34	24	13478	0	13728
18352	91	18	20	13547	0	13676
18353	50	12	11	13686	0	13759
18354	13403	13	9	227	0	13652
18355	141	12938	20	100	0	13199
18356	63	13324	17	58	0	13462
18357	49	184	17	13347	0	13597
18358	39	70	16	13528	0	13653
18359	20	32	15	13638	0	13705
18360	13438	13	12	237	0	13700
18361	152	13600	8	101	0	13861
18362	13766	149	10	73	0	13998
18363	190	64	13847	30	0	14131
18364	67	14135	148	39	0	14389
18365	54	165	66	14196	0	14481
18366	14206	60	38	201	0	14505
18367	183	42	14274	92	0	14591
18368	82	24	14183	55	0	14344
18369	59	23	243	14322	0	14647
18370	39	22	91	14431	0	14583
18371	41	24	50	14235	0	14350
18372	34	23	39	13767	0	13863
18373	34	24	17	13842	0	13917
18374	30	13470	30	286	0	13816
18375	37	176	33	13513	0	13759
18376	13302	65	27	253	0	13647
18377	180	13453	24	122	0	13779
18378	13466	194	23	86	0	13769
18379	219	78	13146	57	0	13500
18380	85	48	13235	58	0	13426
18381	73	39	231	13639	0	13982
18382	44	28	15595	237	0	15904
18383	53	24	301	15480	0	15858
18384	66	21	120	15424	0	15631
18385	16240	24	57	414	0	16735
18386	16388	24	48	190	0	16650
18387	416	16960	46	103	0	17525
18388	175	17735	40	72	0	18022
18389	118	442	40	17667	0	18267
18390	17802	189	35	398	0	18424
18391	370	95	17914	182	0	18561
18392	203	51	357	17953	0	18564
18393	111	42	157	18199	0	18509
18394	76	36	17978	519	0	18609
18395	53	17927	372	278	0	18630
18396	81	371	158	17786	0	18396
18397	63	160	18112	447	0	18782
18398	67	88	383	18006	0	18544
18399	17490	60	174	482	0	18206
18400	353	17464	110	243	0	18170
18401	159	17888	58	152	0	18257
18402	121	475	59	17642	0	18297
18403	17337	198	64	431	0	18030
18404	362	17480	52	222	0	18116
18405	17612	385	69	177	0	18243
18406	441	175	17517	122	0	18255
18407	198	115	18038	142	0	18493
18408	158	79	494	17706	0	18437
18409	128	78	208	18462	0	18876
18410	18002	78	114	561	0	18755
18411	489	75	67	18147	0	18778
18412	224	108	17886	506	0	18724
18413	177	103	388	17848	0	18516
18414	134	86	181	18356	0	18757
18415	116	78	17639	604	0	18437
18416	17104	71	437	331	0	17943
18417	426	71	219	17762	0	18478
18418	17154	59	146	533	0	17892
18419	433	16573	134	296	0	17436
18420	16373	367	114	247	0	17101
18421	412	16162	103	206	0	16883
18422	199	16349	121	187	0	16856
18423	256	503	153	15067	0	15979
18424	14856	198	154	394	0	15602
18425	14923	151	61	215	0	15350
18426	427	123	65	14675	0	15290
18427	14684	106	67	410	0	15267
18428	14788	105	48	242	0	15183
18429	494	109	66	14668	0	15337
18430	14294	98	71	391	0	14854
18431	420	14472	98	232	0	15222
18432	14563	326	98	184	0	15171
18433	417	174	13849	189	0	14629
18434	14668	97	271	219	0	15255
18435	445	66	164	14692	0	15367
18436	252	58	130	14958	0	15398
18437	184	67	110	14960	0	15321
18438	169	76	95	14915	0	15255
18439	130	75	106	14861	0	15172
18440	133	13713	116	549	0	14511
18441	141	14543	95	342	0	15121
18442	14530	367	78	270	0	15245
18443	400	193	14384	205	0	15182
18444	14289	161	311	196	0	14957
18445	437	130	14412	173	0	15152
18446	270	138	355	14274	0	15037
18447	186	149	160	14773	0	15268
18448	14465	115	90	532	0	15202
18449	470	112	14322	289	0	15193
18450	321	97	302	14512	0	15232
18451	230	107	14812	447	0	15596
18452	239	15129	350	254	0	15972
18453	228	339	153	15484	0	16204
18454	15516	152	109	480	0	16257
18455	15261	104	94	289	0	15748
18456	15654	120	82	218	0	16074
18457	581	15247	102	214	0	16144
18458	322	15816	114	200	0	16452
18459	14491	430	98	243	0	15262
18460	400	15667	88	230	0	16385
18461	203	15797	80	268	0	16348
18462	223	421	15334	241	0	16219
18463	145	15039	310	242	0	15736
18464	153	15093	153	213	0	15612
18465	148	436	110	14965	0	15659
18466	158	257	14928	399	0	15742
18467	160	156	14579	243	0	15138
18468	14407	114	398	194	0	15113
18469	411	115	14853	153	0	15532
18470	15075	104	369	156	0	15704
18471	416	102	205	14966	0	15689
18472	280	15065	143	382	0	15870
18473	15642	312	133	242	0	16329
18474	16129	158	115	221	0	16623
18475	475	100	116	16025	0	16716
18476	316	81	113	16163	0	16673
18477	236	95	100	16244	0	16675
18478	15863	86	71	559	0	16579
18479	14562	84	94	317	0	15057
18480	15897	104	65	209	0	16275
18481	522	15105	66	173	0	15866
18482	13289	197	49	102	0	13637
18483	269	12942	38	74	0	13323
18484	162	12898	29	67	0	13156
18485	177	518	127	11627	0	12449
18486	93	11926	46	152	0	12217
18487	11154	133	38	80	0	11405
18488	166	71	18	11020	0	11275
18489	10772	41	16	129	0	10958
18490	133	10478	19	57	0	10687
18491	58	10764	19	36	0	10877
18492	10878	102	16	56	0	11052
18493	113	11067	14	38	0	11232
18494	73	122	22	11075	0	11292
18495	78	42	17	11146	0	11283
18496	11162	27	7	133	0	11329
18497	121	25	8	11262	0	11416
18498	51	20	11517	126	0	11714
18499	48	24	109	11611	0	11792
18500	11883	23	23	152	0	12081
18501	116	12198	18	62	0	12394
18502	12816	123	13	50	0	13002
18503	12501	38	15	55	0	12609
18504	13039	36	6	32	0	13113
18505	196	29	12825	22	0	13072
18506	77	32	12449	21	0	12579
18507	12351	22	134	35	0	12542
18508	152	12533	44	30	0	12759
18509	62	140	36	12647	0	12885
18510	51	40	18	12638	0	12747
18511	39	12279	17	154	0	12489
18512	30	12599	19	62	0	12710
18513	41	153	23	12595	0	12812
18514	38	53	16	12682	0	12789
18515	30	37	12397	168	0	12632
18516	33	35	12023	62	0	12153
18517	12241	27	156	65	0	12489
18518	12697	21	52	53	0	12823
18519	170	25	46	12630	0	12871
18520	81	16	12618	151	0	12866
18521	58	19	147	12521	0	12745
18522	12454	24	48	193	0	12719
18523	169	21	12467	70	0	12727
18524	72	22	151	12587	0	12832
18525	52	27	12550	161	0	12790
18526	48	12430	159	87	0	12724
18527	46	143	12502	50	0	12741
18528	56	80	167	12331	0	12634
18529	12400	24	71	184	0	12679
18530	170	25	54	12497	0	12746
18531	12327	25	34	191	0	12577
18532	12523	21	26	87	0	12657
18533	12350	27	24	78	0	12479
18534	206	26	12086	43	0	12361
18535	12245	21	141	59	0	12466
18536	204	23	52	12262	0	12541
18537	99	26	44	12379	0	12548
18538	70	25	12220	180	0	12495
18539	60	39	148	12239	0	12486
18540	12272	21	56	205	0	12554
18541	164	12278	41	86	0	12569
18542	12450	139	34	74	0	12697
18543	12525	40	23	93	0	12681
18544	12660	40	22	65	0	12787
18545	224	24	29	12555	0	12832
18546	103	25	12637	168	0	12933
18547	92	11	157	12875	0	13135
18548	71	22	51	13015	0	13159
18549	12879	14	57	214	0	13164
18550	12629	15	37	124	0	12805
18551	194	21	12277	77	0	12569
18552	100	30	145	12331	0	12606
18553	81	17	12460	182	0	12740
18554	12760	24	179	91	0	13054
18555	209	13946	61	75	0	14291
18556	14054	198	55	52	0	14359
18557	254	14466	44	50	0	14814
18558	14355	241	39	56	0	14691
18559	277	14483	41	48	0	14849
18560	139	249	38	14450	0	14876
18561	106	71	30	14815	0	15022
18562	14668	59	25	302	0	15054
18563	14612	40	25	120	0	14797
18564	14692	28	34	108	0	14862
18565	14251	35	15	84	0	14385
18566	14534	28	28	54	0	14644
18567	384	32	23	14108	0	14547
18568	168	14105	32	250	0	14555
18569	159	230	22	13843	0	14254
18570	101	13839	33	267	0	14240
18571	112	268	15	13546	0	13941
18572	91	13666	20	262	0	14039
18573	98	277	14	13425	0	13814
18574	97	83	13000	287	0	13467
18575	12679	70	217	135	0	13101
18576	287	12924	56	102	0	13369
18577	12983	228	63	86	0	13360
18578	313	78	12866	67	0	13324
18579	12758	68	213	78	0	13117
18580	299	56	13240	65	0	13660
18581	139	63	256	13211	0	13669
18582	100	14002	81	271	0	14454
18583	80	270	14137	99	0	14586
18584	75	102	275	14308	0	14760
18585	13608	99	119	320	0	14146
18586	306	63	93	14391	0	14853
18587	168	43	62	14626	0	14899
18588	162	44	51	14776	0	15033
18589	106	50	14379	404	0	14939
18590	121	33	269	14245	0	14668
18591	82	14011	102	370	0	14565
18592	90	252	83	14032	0	14457
18593	85	102	60	14114	0	14361
18594	13772	78	43	399	0	14292
18595	311	64	37	14088	0	14500
18596	142	44	14021	383	0	14590
18597	122	36	13927	191	0	14276
18598	81	28	13907	156	0	14172
18599	65	13822	368	113	0	14368
18600	13424	285	247	124	0	14080
18601	269	13241	115	77	0	13702
18602	12852	290	80	82	0	13304
18603	313	117	59	12681	0	13170
18604	139	97	12886	277	0	13399
18605	111	71	12664	121	0	12967
18606	85	13111	292	114	0	13602
18607	78	273	154	13027	0	13532
18608	88	111	110	13186	0	13495
18609	78	100	70	13336	0	13584
18610	63	58	13057	388	0	13566
18611	12462	48	270	211	0	12991
18612	280	53	13075	151	0	13559
18613	170	56	314	12950	0	13490
18614	162	52	131	13359	0	13704
18615	90	52	13130	378	0	13650
18616	12669	45	286	236	0	13236
18617	291	13149	122	178	0	13740
18618	13177	269	120	135	0	13701
18619	349	125	68	12919	0	13461
18620	143	13124	66	323	0	13656
18621	137	267	71	13313	0	13788
18622	13248	115	57	390	0	13810
18623	326	107	48	13209	0	13690
18624	157	65	12969	388	0	13579
18625	12850	46	283	187	0	13366
18626	13148	58	123	163	0	13492
18627	388	57	12868	121	0	13434
18628	236	50	277	12863	0	13426
18629	13093	56	138	335	0	13622
18630	334	49	120	12944	0	13447
18631	183	56	78	12995	0	13312
18632	169	55	52	12991	0	13267
18633	106	58	68	13016	0	13248
18634	84	49	12565	491	0	13189
18635	114	33	281	12680	0	13108
18636	100	41	12534	429	0	13104
18637	12371	39	338	246	0	12994
18638	12703	34	153	225	0	13115
18639	12684	25	153	171	0	13033
18640	12767	26	112	146	0	13051
18641	458	32	92	12369	0	12951
18642	12301	37	76	364	0	12778
18643	390	30	12135	208	0	12763
18644	189	20	12053	196	0	12458
18645	11707	19	325	186	0	12237
18646	315	11519	199	137	0	12170
18647	151	11547	137	143	0	11978
18648	177	311	108	11354	0	11950
18649	117	153	11369	302	0	11941
18650	11046	101	283	177	0	11607
18651	323	62	11316	148	0	11849
18652	173	10735	289	110	0	11307
18653	171	217	10551	91	0	11030
18654	118	9900	252	104	0	10374
18655	8686	264	204	101	0	9255
18656	197	8531	101	74	0	8903
18657	97	8112	54	56	0	8319
18658	107	196	58	7967	0	8328
18659	43	105	7880	170	0	8198
18660	50	76	156	7683	0	7965
18661	56	48	86	7807	0	7997
18662	49	44	7677	213	0	7983
18663	49	42	166	7534	0	7791
18664	46	7416	88	215	0	7765
18665	42	135	84	7734	0	7995
18666	7677	73	54	207	0	8011
18667	163	67	40	7753	0	8023
18668	94	37	7721	202	0	8054
18669	93	38	147	7807	0	8085
18670	59	34	7762	217	0	8072
18671	7681	35	182	119	0	8017
18672	180	28	90	7860	0	8158
18673	7858	26	71	211	0	8166
18674	208	21	7828	117	0	8174
18675	7596	19	169	120	0	7904
18676	196	7914	93	71	0	8274
18677	114	140	7998	71	0	8323
18678	92	124	176	7814	0	8206
18679	66	59	7978	175	0	8278
18680	57	7442	188	106	0	7793
18681	62	7656	86	98	0	7902
18682	6814	140	68	60	0	7082
18683	129	7143	42	43	0	7357
18684	7188	128	39	53	0	7408
18685	160	49	50	7256	0	7515
18686	61	42	7211	132	0	7446
18687	48	7241	121	68	0	7478
18688	70	136	53	7165	0	7424
18689	39	54	39	7406	0	7538
18690	57	44	24	7528	0	7653
18691	35	38	25	7504	0	7602
18692	32	7183	28	178	0	7421
18693	30	7530	25	81	0	7666
18694	7268	128	36	73	0	7505
18695	120	7200	24	43	0	7387
18696	48	136	22	6845	0	7051
18697	34	44	6824	127	0	7029
18698	27	6762	104	44	0	6937
18699	36	111	30	6561	0	6738
18700	26	52	31	6564	0	6673
18701	19	6560	12	127	0	6718
18702	6364	110	22	52	0	6548
18703	108	40	6365	29	0	6542
18704	5911	25	84	46	0	6066
18705	98	6183	31	29	0	6341
18706	5812	92	25	15	0	5944
18707	92	5954	8	10	0	6064
18708	40	105	19	6217	0	6381
18709	19	29	10	6334	0	6392
18710	6261	20	6	122	0	6409
18711	100	18	9	6318	0	6445
18712	40	12	6246	106	0	6404
18713	19	6018	81	40	0	6158
18714	16	6176	22	28	0	6242
18715	12	109	19	6069	0	6209
18716	13	36	6115	92	0	6256
18717	8	33	84	6012	0	6137
18718	13	14	30	6100	0	6157
18719	10	16	5990	116	0	6132
18720	12	16	5806	39	0	5873
18721	8	5942	95	26	0	6071
18722	5983	95	30	27	0	6135
18723	88	32	12	5927	0	6059
18724	27	5776	16	91	0	5910
18725	5946	90	14	48	0	6098
18726	87	38	11	5954	0	6090
18727	35	21	10	5970	0	6036
18728	13	5883	7	120	0	6023
18729	13	92	7	5865	0	5977
18730	5903	37	8	110	0	6058
18731	94	15	9	5973	0	6091
18732	38	21	10	6022	0	6091
18733	24	27	5897	125	0	6073
18734	23	19	5602	49	0	5693
18735	5803	19	102	44	0	5968
18736	90	26	35	5881	0	6032
18737	36	14	16	5946	0	6012
18738	21	21	16	5971	0	6029
18739	22	21	5847	137	0	6027
18740	5781	17	92	58	0	5948
18741	103	17	37	5814	0	5971
18742	43	20	22	5883	0	5968
18743	5738	17	16	132	0	5903
18744	97	5760	15	62	0	5934
18745	40	94	5773	43	0	5950
18746	32	43	78	5582	0	5735
18747	22	5675	36	115	0	5848
18748	29	93	20	5766	0	5908
18749	5683	36	21	122	0	5862
18750	104	24	14	5681	0	5823
18751	5613	25	19	128	0	5785
18752	5628	26	21	74	0	5749
18753	110	31	23	5552	0	5716
18754	49	5447	21	120	0	5637
18755	26	5654	18	74	0	5772
18756	20	108	5624	53	0	5805
18757	35	48	96	5329	0	5508
18758	31	21	40	5648	0	5740
18759	29	30	22	5698	0	5779
18760	5598	23	19	146	0	5786
18761	99	30	13	5632	0	5774
18762	52	32	5682	123	0	5889
18763	5722	26	86	83	0	5917
18764	110	20	33	6016	0	6179
18765	43	25	18	6158	0	6244
18766	29	20	6047	157	0	6253
18767	5925	24	93	85	0	6127
18768	115	21	39	6096	0	6271
18769	45	23	6286	144	0	6498
18770	41	15	94	6321	0	6471
18771	37	18	45	6047	0	6147
18772	35	6363	32	131	0	6561
18773	6334	85	23	71	0	6513
18774	6264	32	29	67	0	6392
18775	124	6217	21	53	0	6415
18776	6132	86	20	66	0	6304
18777	6086	37	21	58	0	6202
18778	127	18	15	6079	0	6239
18779	51	19	5876	123	0	6069
18780	42	18	5656	64	0	5780
18781	33	12	5664	52	0	5761
18782	26	16	5753	45	0	5840
18783	42	107	103	5334	0	5586
18784	32	15	50	5534	0	5631
18785	24	8	19	5485	0	5536
18786	23	9	17	5610	0	5659
18787	5596	11	16	127	0	5750
18788	85	5764	22	65	0	5936
18789	6030	59	14	40	0	6143
18790	87	29	6048	24	0	6188
18791	49	17	6273	24	0	6363
18792	41	32	93	6413	0	6579
18793	6457	9	88	105	0	6659
18794	6284	7	25	59	0	6375
18795	106	6347	13	36	0	6502
18796	42	6484	15	24	0	6565
18797	33	75	12	6531	0	6651
18798	6515	37	14	91	0	6657
18799	75	6567	14	49	0	6705
18800	6667	60	9	41	0	6777
18801	6657	31	3	36	0	6727
18802	6667	19	9	30	0	6725
18803	111	20	6669	12	0	6812
18804	55	6711	65	15	0	6846
18805	6626	53	38	29	0	6746
18806	6583	31	17	30	0	6661
18807	94	6390	12	23	0	6519
18808	44	6171	7	6	0	6228
18809	6211	70	9	17	0	6307
18810	65	36	5	6188	0	6294
18811	33	13	6257	55	0	6358
18812	6139	12	44	29	0	6224
18813	61	22	18	6375	0	6476
18814	41	6576	9	48	0	6674
18815	24	54	8	6727	0	6813
18816	17	30	6778	58	0	6883
18817	23	9	57	6727	0	6816
18818	7035	11	26	70	0	7142
18819	64	11	13	7062	0	7150
18820	42	10	5	7135	0	7192
18821	16	13	7221	84	0	7334
18822	17	16	50	7027	0	7110
18823	17	7219	22	69	0	7327
18824	7251	49	13	42	0	7355
18825	7122	23	10	24	0	7179
18826	86	13	7263	13	0	7375
18827	39	8	54	7138	0	7239
18828	14	7113	29	54	0	7210
18829	11	7312	13	28	0	7364
18830	7261	64	18	27	0	7370
18831	67	33	6	7428	0	7534
18832	42	12	7410	62	0	7526
18833	22	11	7284	37	0	7354
18834	10	9	73	7495	0	7587
18835	7502	9	39	72	0	7622
18836	7492	5	17	44	0	7558
18837	90	14	10	7794	0	7908
18838	45	14	7939	61	0	8059
18839	26	7913	53	37	0	8029
18840	7940	52	43	29	0	8064
18841	53	8037	16	23	0	8129
18842	8066	67	14	23	0	8170
18843	75	38	6	8080	0	8199
18844	50	23	8063	60	0	8196
18845	23	17	55	8010	0	8105
18846	8063	11	40	75	0	8189
18847	62	14	8116	34	0	8226
18848	40	8114	63	31	0	8248
18849	29	56	31	8207	0	8323
18850	8256	25	17	72	0	8370
18851	73	15	8274	46	0	8408
18852	43	11	74	8317	0	8445
18853	20	20	33	8457	0	8530
18854	31	17	8444	87	0	8579
18855	32	18	68	8330	0	8448
18856	24	12	8428	74	0	8538
18857	8201	7	76	59	0	8343
18858	68	11	44	8724	0	8847
18859	40	5	9091	81	0	9217
18860	29	9196	69	48	0	9342
18861	9425	63	42	40	0	9570
18862	9846	45	18	38	0	9947
18863	118	20	17	10563	0	10718
18864	66	10680	17	111	0	10874
18865	10769	123	17	55	0	10964
18866	144	49	7	10807	0	11007
18867	64	24	10811	139	0	11038
18868	10434	26	127	72	0	10659
18869	147	10605	41	43	0	10836
18870	68	120	32	10699	0	10919
18871	10689	44	17	147	0	10897
18872	136	34	10528	60	0	10758
18873	64	25	10636	27	0	10752
18874	50	24	143	10545	0	10762
18875	39	15	10912	130	0	11096
18876	49	11	140	10745	0	10945
18877	24	10600	60	142	0	10826
18878	24	131	45	11197	0	11397
18879	11091	36	30	180	0	11337
18880	138	21	11187	70	0	11416
18881	50	11223	146	38	0	11457
18882	49	134	36	11167	0	11386
18883	24	47	11426	150	0	11647
18884	36	59	132	10987	0	11214
18885	30	11081	47	122	0	11280
18886	16	11408	35	58	0	11517
18887	11124	137	26	59	0	11346
18888	108	11199	33	40	0	11380
18889	29	127	10777	21	0	10954
18890	10027	56	140	45	0	10268
18891	118	35	10627	8	0	10788
18892	51	19	97	10136	0	10303
18893	24	19	10592	97	0	10732
18894	17	10554	108	30	0	10709
18895	25	88	37	10546	0	10696
18896	18	28	23	10534	0	10603
18897	18	17	18	10441	0	10494
18898	12	23	10460	132	0	10627
18899	21	13	100	10262	0	10396
18900	18	14	26	10518	0	10576
18901	10327	6	25	148	0	10506
18902	10382	11	20	70	0	10483
18903	116	11	10440	41	0	10608
18904	42	10302	103	35	0	10482
18905	29	96	10462	30	0	10617
18906	31	29	108	10499	0	10667
18907	26	19	10695	105	0	10845
18908	24	12	117	10654	0	10807
18909	14	15	49	10863	0	10941
18910	8	12	10797	141	0	10958
18911	9868	7	117	87	0	10079
18912	93	10836	48	48	0	11025
18913	41	100	25	10906	0	11072
18914	21	35	11017	114	0	11187
18915	32	25	10564	41	0	10662
18916	10415	20	124	43	0	10602
18917	96	10878	43	29	0	11046
18918	34	103	31	10857	0	11025
18919	11122	27	34	121	0	11304
18920	110	15	26	11181	0	11332
18921	45	18	18	11425	0	11506
18922	25	20	11394	142	0	11581
18923	10845	14	94	88	0	11041
18924	11505	9	36	59	0	11609
18925	135	12	29	11519	0	11695
18926	11527	6	24	129	0	11686
18927	135	8	22	11523	0	11688
18928	54	11311	22	153	0	11540
18929	48	11793	22	59	0	11922
18930	38	134	16	11916	0	12104
18931	11716	46	14	137	0	11913
18932	112	28	10	11779	0	11929
18933	11854	13	12	163	0	12042
18934	11927	23	12	67	0	12029
18935	148	12	14	11902	0	12076
18936	69	12	9	12107	0	12197
18937	50	9	11764	149	0	11972
18938	43	11	11755	64	0	11873
18939	40	7	135	11913	0	12095
18940	30	17	12421	138	0	12606
18941	12308	11	142	71	0	12532
18942	124	9	50	13102	0	13285
18943	44	11	13742	152	0	13949
18944	13687	10	173	75	0	13945
18945	14947	6	57	71	0	15081
18946	236	15738	48	38	0	16060
18947	150	178	27	16089	0	16444
18948	89	70	16414	181	0	16754
18949	16249	50	182	129	0	16610
18950	16781	26	88	86	0	16981
18951	262	26	16731	44	0	17063
18952	16767	16	203	60	0	17046
18953	278	15	90	16695	0	17078
18954	153	11	58	16876	0	17098
18955	16782	9	45	277	0	17113
18956	16796	7	34	154	0	16991
18957	298	56	35	16651	0	17040
18958	164	25	16579	241	0	17009
18959	103	16209	174	142	0	16628
18960	98	167	16272	79	0	16616
18961	89	75	16029	59	0	16252
18962	79	15721	271	59	0	16130
18963	97	179	180	14704	0	15160
18964	61	73	87	14855	0	15076
18965	33	47	14792	178	0	15050
18966	61	30	148	14606	0	14845
18967	14745	20	81	210	0	15056
18968	148	15	14901	109	0	15173
18969	14826	13	142	107	0	15088
18970	15113	8	91	83	0	15295
18971	15193	14	65	74	0	15346
18972	266	9	14952	32	0	15259
18973	165	18	14942	31	0	15156
18974	113	27	196	14953	0	15289
18975	101	17	127	14585	0	14830
18976	54	15040	84	183	0	15361
18977	15003	116	73	137	0	15329
18978	14905	66	67	104	0	15142
18979	217	14972	47	71	0	15307
18980	14971	135	34	76	0	15216
18981	202	14807	33	59	0	15101
18982	15001	152	36	70	0	15259
18983	237	83	25	14669	0	15014
18984	135	63	14717	150	0	15065
18985	109	35	14516	86	0	14746
18986	82	45	191	14523	0	14841
18987	84	19	122	14645	0	14870
18988	50	23	14463	207	0	14743
18989	54	25	181	14229	0	14489
18990	55	30	112	14056	0	14253
18991	14278	25	68	261	0	14632
18992	14349	20	59	173	0	14601
18993	14123	31	45	129	0	14328
18994	257	19	13903	83	0	14262
18995	155	13910	143	69	0	14277
18996	129	124	85	14086	0	14424
18997	96	67	14293	140	0	14596
18998	80	14307	164	89	0	14640
18999	14447	134	104	98	0	14783
19000	174	76	82	14452	0	14784
19001	116	48	62	14646	0	14872
19002	14461	31	64	234	0	14790
19003	184	31	37	14534	0	14786
19004	140	27	41	14621	0	14829
19005	14580	23	32	262	0	14897
19006	188	34	14390	160	0	14772
19007	137	14308	145	100	0	14690
19008	14319	140	79	105	0	14643
19009	197	93	14445	55	0	14790
19010	14239	66	153	80	0	14538
19011	198	14689	110	50	0	15047
19012	14497	146	89	68	0	14800
19013	14490	79	55	95	0	14719
19014	14246	53	64	85	0	14448
19015	249	43	48	14050	0	14390
19016	166	63	40	14013	0	14282
19017	122	13933	36	229	0	14320
19018	94	13981	48	140	0	14263
19019	88	13928	38	100	0	14154
19020	13852	174	26	114	0	14166
19021	164	105	13671	63	0	14003
19022	129	69	132	13543	0	13873
19023	94	58	84	13609	0	13845
19024	73	13609	65	189	0	13936
19025	89	142	47	13662	0	13940
19026	79	77	61	13517	0	13734
19027	59	13688	42	218	0	14007
19028	13544	143	38	160	0	13885
19029	146	13601	23	103	0	13873
19030	97	153	13361	82	0	13693
19031	13229	88	121	94	0	13532
19032	158	13532	60	68	0	13818
19033	13422	133	53	64	0	13672
19034	178	86	38	13324	0	13626
19035	124	57	42	13313	0	13536
19036	86	49	13257	181	0	13573
19037	77	53	13098	110	0	13338
19038	79	92	166	13079	0	13416
19039	13009	28	103	183	0	13323
19040	12637	21	62	124	0	12844
19041	183	12836	42	63	0	13124
19042	114	12484	29	63	0	12690
19043	67	12200	22	50	0	12339
19044	272	306	120	11337	0	12035
19045	11088	51	176	148	0	11463
19046	10909	9	7	58	0	10983
19047	10830	10	5	43	0	10888
19048	120	13	10704	7	0	10844
19049	42	12345	98	21	0	12506
19050	44	107	32	14144	0	14327
19051	14604	37	16	191	0	14848
19052	231	18	5	15238	0	15492
19053	84	12	4	16152	0	16252
19054	16133	10	15	319	0	16477
19055	17512	18	10	125	0	17665
19056	378	21	17664	60	0	18123
19057	187	13	298	17800	0	18298
19058	84	13	17799	331	0	18227
19059	86	16	354	17828	0	18284
19060	24	16	17823	387	0	18250
19061	75	35	360	17726	0	18196
19062	17392	12	127	407	0	17938
19063	334	17283	74	155	0	17846
19064	116	18047	42	96	0	18301
19065	151	422	35	16435	0	17043
19066	48	18158	37	309	0	18552
19067	18013	385	34	131	0	18563
19068	17879	127	29	116	0	18151
19069	450	79	17582	45	0	18156
19070	174	17552	328	56	0	18110
19071	133	324	120	17603	0	18180
19072	46	122	17677	354	0	18199
19073	17498	69	350	147	0	18064
19074	408	55	121	17605	0	18189
19075	161	34	17726	349	0	18270
19076	101	34	361	17727	0	18223
19077	17667	39	131	434	0	18271
19078	373	32	17590	157	0	18152
19079	17480	29	366	105	0	17980
19080	17926	22	139	71	0	18158
19081	506	23	78	17542	0	18149
19082	187	30	17436	364	0	18017
19083	116	34	17370	159	0	17679
19084	17278	24	445	110	0	17857
19085	17745	19	173	92	0	18029
19086	491	31	17543	78	0	18143
19087	240	22	366	17576	0	18204
19088	172	18	147	17373	0	17710
19089	98	17560	112	464	0	18234
19090	127	345	83	17735	0	18290
19091	17675	117	65	452	0	18309
19092	448	62	52	17764	0	18326
19093	180	41	17587	443	0	18251
19094	17401	34	389	227	0	18051
19095	419	28	162	17515	0	18124
19096	188	51	17468	426	0	18133
19097	140	17215	382	198	0	17935
19098	16898	349	146	195	0	17588
19099	399	17287	129	122	0	17937
19100	17288	406	69	125	0	17888
19101	477	162	16981	108	0	17728
19102	211	16549	382	106	0	17248
19103	153	17224	161	112	0	17650
19104	168	466	124	16613	0	17371
19105	125	196	87	17048	0	17456
19106	121	96	16656	500	0	17373
19107	130	59	399	16855	0	17443
19108	16619	59	196	497	0	17371
19109	414	77	16437	228	0	17156
19110	215	72	413	16429	0	17129
19111	139	68	16205	468	0	16880
19112	15878	76	459	224	0	16637
19113	412	16201	204	177	0	16994
19114	16188	384	135	177	0	16884
19115	16636	155	104	137	0	17032
19116	16738	105	106	134	0	17083
19117	582	91	16017	110	0	16800
19118	289	16067	393	119	0	16868
19119	233	393	184	16126	0	16936
19120	155	165	149	16891	0	17360
19121	17092	103	120	541	0	17856
19122	530	62	100	17316	0	18008
19123	17441	78	103	549	0	18171
19124	17604	75	160	246	0	18085
19125	17732	65	91	235	0	18123
19126	17811	62	110	161	0	18144
19127	718	52	87	17177	0	18034
19128	17302	56	84	507	0	17949
19129	602	50	16712	254	0	17618
19130	16892	50	445	205	0	17592
19131	17340	51	197	145	0	17733
19132	672	69	16510	322	0	17573
19133	16908	62	427	126	0	17523
19134	17349	51	210	132	0	17742
19135	668	54	157	16783	0	17662
19136	390	53	112	17062	0	17617
19137	16602	282	101	570	0	17555
19138	576	56	93	16776	0	17501
19139	343	41	107	16593	0	17084
19140	214	16029	109	598	0	16950
19141	193	345	88	16152	0	16778
19142	15776	130	79	552	0	16537
19143	508	90	79	15670	0	16347
19144	288	40	87	15409	0	15824
19145	218	14525	89	567	0	15399
19146	201	338	63	14303	0	14905
19147	229	152	80	14095	0	14556
19148	13502	101	73	507	0	14183
19149	478	218	42	11411	0	12149
19150	211	29	9738	315	0	10293
19151	122	8891	202	165	0	9380
19152	76	8483	98	105	0	8762
19153	7788	204	89	85	0	8166
19154	204	7806	41	67	0	8118
19155	6447	113	130	54	0	6744
19156	134	6347	24	33	0	6538
19157	6365	103	34	40	0	6542
19158	130	43	7	6385	0	6565
19159	67	39	3	6439	0	6548
19160	47	6421	11	141	0	6620
19161	53	109	7	6512	0	6681
19162	36	48	6488	130	0	6702
19163	6291	27	85	74	0	6477
19164	105	6774	41	47	0	6967
19165	6711	106	22	52	0	6891
19166	6782	53	11	30	0	6876
19167	6879	23	13	32	0	6947
19168	182	13	14	6732	0	6941
19169	92	19	11	6707	0	6829
19170	48	6699	9	161	0	6917
19171	6688	115	6	79	0	6888
19172	146	6748	6	51	0	6951
19173	6767	122	2	44	0	6935
19174	151	56	6860	33	0	7100
19175	7153	32	107	41	0	7333
19176	173	23	50	7214	0	7460
19177	89	20	7210	148	0	7467
19178	54	28	7255	73	0	7410
19179	55	19	170	7246	0	7490
19180	42	26	7308	156	0	7532
19181	60	12	155	7210	0	7437
19182	7021	15	68	174	0	7278
19183	168	12	38	7074	0	7292
19184	77	17	6956	175	0	7225
19185	53	6750	134	90	0	7027
19186	40	6964	66	55	0	7125
19187	69	185	46	6722	0	7022
19188	6735	67	58	170	0	7030
19189	163	32	17	6737	0	6949
19190	86	28	18	6861	0	6993
19191	55	23	19	6912	0	7009
19192	37	19	25	6956	0	7037
19193	30	19	6780	225	0	7054
19194	28	18	6708	99	0	6853
19195	6693	9	166	89	0	6957
19196	6888	15	67	64	0	7034
19197	190	18	34	6826	0	7068
19198	87	18	38	6919	0	7062
19199	46	16	6724	200	0	6986
19200	43	6727	139	96	0	7005
19201	6713	133	62	70	0	6978
19202	6849	61	36	52	0	6998
19203	197	32	22	6762	0	7013
19204	83	26	6786	167	0	7062
19205	62	23	131	6674	0	6890
19206	43	6756	58	178	0	7035
19207	51	126	6777	83	0	7037
19208	6754	56	153	61	0	7024
19209	166	31	70	6847	0	7114
19210	6906	26	39	167	0	7138
19211	162	22	6740	96	0	7020
19212	6808	23	143	65	0	7039
19213	181	16	72	6770	0	7039
19214	6734	25	42	172	0	6973
19215	184	19	27	6631	0	6861
19216	97	6456	28	165	0	6746
19217	57	6656	30	101	0	6844
19218	62	204	39	6446	0	6751
19219	36	53	6321	159	0	6569
19220	43	6176	120	68	0	6407
19221	94	140	61	5616	0	5911
19222	5441	38	50	120	0	5649
19223	5457	14	18	66	0	5555
19224	135	22	21	5383	0	5561
19225	53	15	23	5395	0	5486
19226	48	5194	15	125	0	5382
19227	30	5411	23	54	0	5518
19228	5370	113	15	49	0	5547
19229	98	34	16	5372	0	5520
19230	53	29	10	5436	0	5528
19231	26	28	5347	144	0	5545
19232	27	20	99	5308	0	5454
19233	25	17	48	5335	0	5425
19234	24	26	20	5369	0	5439
19235	22	17	5286	147	0	5472
19236	34	20	96	5317	0	5467
19237	5292	13	37	142	0	5484
19238	109	11	5205	82	0	5407
19239	5417	8	105	68	0	5598
19240	109	27	46	5481	0	5663
19241	54	26	19	5659	0	5758
19242	41	10	18	5793	0	5862
19243	29	6	5653	159	0	5847
19244	5554	10	110	89	0	5763
19245	106	5839	57	49	0	6051
19246	5908	90	22	60	0	6080
19247	118	5991	24	57	0	6190
19248	58	107	19	6075	0	6259
19249	6058	41	25	144	0	6268
19250	126	22	5982	74	0	6204
19251	5904	18	109	44	0	6075
19252	127	16	6078	44	0	6265
19253	77	27	107	5919	0	6130
19254	36	11	5932	125	0	6104
19255	27	5824	108	64	0	6023
19256	67	126	59	5537	0	5789
19257	5356	59	37	122	0	5574
19258	111	14	16	5285	0	5426
19259	45	5215	18	100	0	5378
19260	45	80	14	5225	0	5364
19261	5187	41	12	105	0	5345
19262	5070	14	16	67	0	5167
19263	125	5027	16	36	0	5204
19264	41	4709	19	25	0	4794
19265	38	90	17	4519	0	4664
19266	29	18	28	4512	0	4587
19267	4473	11	10	87	0	4581
19268	4437	8	18	43	0	4506
19269	69	4483	13	15	0	4580
19270	30	63	3	4394	0	4490
19271	31	30	8	4435	0	4504
19272	21	17	4379	83	0	4500
19273	14	4311	53	34	0	4412
19274	14	4194	16	26	0	4250
19275	16	68	6	3930	0	4020
19276	11	10	3896	42	0	3959
19277	8	6	3836	15	0	3865
19278	8	11	47	3882	0	3948
19279	7	10	14	3933	0	3964
19280	3	6	3921	56	0	3986
19281	11	3	35	3967	0	4016
19282	8	10	4040	42	0	4100
19283	4156	8	41	25	0	4230
19284	58	3	12	4218	0	4291
19285	16	3	4345	59	0	4423
19286	14	5	4406	20	0	4445
19287	14	10	71	4685	0	4780
19288	3	6	4993	77	0	5079
19289	8	7	5110	28	0	5153
19290	6	5047	85	25	0	5163
19291	5196	58	33	15	0	5302
19292	66	19	5401	11	0	5497
19293	24	13	67	5392	0	5496
19294	21	9	28	5442	0	5500
19295	8	3	24	5553	0	5588
19296	10	14	5419	98	0	5541
19297	16	6	66	5349	0	5437
19298	5353	9	23	95	0	5480
19299	75	6	20	5332	0	5433
19300	22	5	5347	89	0	5463
19301	20	1	67	5336	0	5424
19302	5418	2	31	99	0	5550
19303	5465	4	21	46	0	5536
19304	5414	6	15	34	0	5469
19305	103	5	14	5397	0	5519
19306	5425	4	12	80	0	5521
19307	5410	2	9	49	0	5470
19308	5403	5	13	34	0	5455
19309	96	5254	12	24	0	5386
19310	5338	57	11	27	0	5433
19311	102	17	17	5318	0	5454
19312	42	16	5309	69	0	5436
19313	34	5285	63	38	0	5420
19314	5342	66	24	37	0	5469
19315	81	26	24	5331	0	5462
19316	41	16	15	5270	0	5342
19317	26	5199	12	97	0	5334
19318	23	5339	16	48	0	5426
19319	5161	81	17	37	0	5296
19320	77	5184	13	26	0	5300
19321	5040	84	11	24	0	5159
19322	89	5029	12	23	0	5153
19323	5018	81	13	29	0	5141
19324	78	5053	13	26	0	5170
19325	39	5260	12	12	0	5323
19326	5222	92	13	14	0	5341
19327	86	36	5189	14	0	5325
19328	35	5224	68	20	0	5347
19329	42	75	29	5221	0	5367
19330	25	33	17	5380	0	5455
19331	21	25	18	5308	0	5372
19332	22	21	11	5370	0	5424
19333	23	15	5380	112	0	5530
19334	5333	8	79	55	0	5475
19335	79	10	33	5571	0	5693
19336	5606	16	16	104	0	5742
19337	5844	8	18	41	0	5911
19338	5903	8	14	49	0	5974
19339	5787	8	12	38	0	5845
19340	121	15	5778	28	0	5942
19341	70	19	90	5728	0	5907
19342	45	9	5782	107	0	5943
19343	35	5733	101	45	0	5914
19344	60	109	53	5254	0	5476
19345	29	46	27	5556	0	5658
19346	33	20	24	5627	0	5704
19347	24	15	17	5546	0	5602
19348	16	14	5454	134	0	5618
19349	32	9	85	5475	0	5601
19350	23	12	44	5578	0	5657
19351	5542	15	26	139	0	5722
19352	5720	12	19	76	0	5827
19353	145	5	14	5833	0	5997
19354	68	10	19	5882	0	5979
19355	43	15	17	5939	0	6014
19356	5912	11	15	173	0	6111
19357	6017	9	19	88	0	6133
19358	5778	14	17	63	0	5872
19359	6013	16	8	47	0	6084
19360	158	5920	10	45	0	6133
19361	6023	97	14	47	0	6181
19362	6089	34	11	47	0	6181
19363	156	23	14	5944	0	6137
19364	86	18	11	5943	0	6058
19365	5843	13	7	145	0	6008
19366	137	5718	7	72	0	5934
19367	70	5864	9	46	0	5989
19368	6019	112	7	56	0	6194
19369	141	42	9	6058	0	6250
19370	56	29	11	6127	0	6223
19371	57	20	2	6194	0	6273
19372	51	13	4	6177	0	6245
19373	39	20	7	6112	0	6178
19374	33	5952	4	160	0	6149
19375	34	98	5	5928	0	6065
19376	5945	30	2	141	0	6118
19377	113	16	5	5930	0	6064
19378	42	19	5	5970	0	6036
19379	5847	13	11	148	0	6019
19380	121	5878	3	65	0	6067
19381	44	130	6	5829	0	6009
19382	39	5868	5	103	0	6015
19383	45	131	7	5675	0	5858
19384	46	30	5598	103	0	5777
19385	5177	34	82	64	0	5357
19386	91	5337	25	33	0	5486
19387	5063	67	15	33	0	5178
19388	80	22	4896	21	0	5019
19389	35	57	53	4522	0	4667
19390	13	4542	24	70	0	4649
19391	22	4671	11	33	0	4737
19392	4496	70	21	26	0	4613
19393	67	25	1	4548	0	4641
19394	30	9	4761	64	0	4864
19395	14	14	54	4820	0	4902
19396	8	4	4828	80	0	4920
19397	4607	11	56	41	0	4715
19398	66	9	4852	24	0	4951
19399	27	9	65	4833	0	4934
19400	22	4948	18	67	0	5055
19401	17	65	4	4950	0	5036
19402	18	4958	9	71	0	5056
19403	5084	63	9	36	0	5192
19404	81	18	3	5276	0	5378
19405	30	10	5299	83	0	5422
19406	16	15	5131	33	0	5195
19407	5261	3	70	26	0	5360
19408	5494	7	17	25	0	5543
19409	5462	9	11	22	0	5504
19410	5435	7	7	27	0	5476
19411	98	5368	11	21	0	5498
19412	5443	64	6	26	0	5539
19413	5494	24	10	20	0	5548
19414	90	11	5358	29	0	5488
19415	36	16	60	5350	0	5462
19416	5446	7	15	86	0	5554
19417	76	14	5344	36	0	5470
19418	36	8	65	5345	0	5454
19419	22	9	5471	85	0	5587
19420	23	7	65	5443	0	5538
19421	17	5567	28	68	0	5680
19422	5637	68	5	40	0	5750
19423	77	22	5528	26	0	5653
19424	5442	10	61	21	0	5534
19425	79	10	16	5495	0	5600
19426	5533	11	7	77	0	5628
19427	85	2	8	5519	0	5614
19428	5835	12	3	90	0	5940
19429	76	11	5733	28	0	5848
19430	5960	13	58	28	0	6059
19431	83	6	17	6052	0	6158
19432	32	8	13	6097	0	6150
19433	5973	5	10	99	0	6087
19434	81	10	8	5979	0	6078
19435	22	6	5880	69	0	5977
19436	21	29	52	5809	0	5911
19437	5606	13	16	65	0	5700
19438	53	5475	10	28	0	5566
19439	19	5446	7	16	0	5488
19440	5303	43	8	21	0	5375
19441	50	5517	6	12	0	5585
19442	29	42	13	5353	0	5437
19443	5368	9	16	50	0	5443
19444	5341	4	5	16	0	5366
19445	5327	3	3	12	0	5345
19446	42	9	5347	8	0	5406
19447	13	25	34	5283	0	5355
19448	4	5348	6	28	0	5386
19449	8	36	6	5397	0	5447
19450	7	7	5512	38	0	5564
19451	10	5248	31	10	0	5299
19452	17	55	7	5332	0	5411
19453	5224	4	7	19	0	5254
19454	18	5219	3	7	0	5247
19455	7	16	5435	2	0	5460
19456	12	2	20	5366	0	5400
19457	8	3	5433	22	0	5466
19458	8	1	23	5324	0	5356
19459	5500	1	14	29	0	5544
19460	25	2	6	5477	0	5510
19461	5500	4	5	33	0	5542
19462	5549	1	3	13	0	5566
19463	29	5655	5	7	0	5696
19464	5735	24	4	13	0	5776
19465	25	5729	4	6	0	5764
19466	16	20	5883	4	0	5923
19467	17	11	23	5805	0	5856
19468	12	3	11	6070	0	6096
19469	11	4	5962	37	0	6014
19470	7	5926	33	12	0	5978
19471	6028	26	9	24	0	6087
19472	6201	12	6	20	0	6239
19473	50	3	3	6325	0	6381
19474	23	6	0	6330	0	6359
19475	14	0	4	6449	0	6467
19476	6373	2	7	46	0	6428
19477	34	5	6292	20	0	6351
19478	18	3	6254	12	0	6287
19479	11	5	38	6403	0	6457
19480	5	3	6339	39	0	6386
19481	6	6	6302	19	0	6333
19482	15	1	42	6210	0	6268
19483	15	8	6551	36	0	6610
19484	5	6518	39	24	0	6586
19485	15	31	16	6607	0	6669
19486	15	11	6706	39	0	6771
19487	16	5	34	6644	0	6699
19488	3	6455	20	41	0	6519
19489	11	29	9	6639	0	6688
19490	10	16	6700	42	0	6768
19491	6	12	38	6528	0	6584
19492	6678	3	17	58	0	6756
19493	35	4	6621	18	0	6678
19494	6247	3	41	25	0	6316
19495	40	6556	14	9	0	6619
19496	6620	31	6	21	0	6678
19497	40	20	14	6678	0	6752
19498	19	6701	2	47	0	6769
19499	6945	41	7	21	0	7014
19500	48	17	10	7070	0	7145
19501	22	7	7172	54	0	7255
19502	10	7244	53	23	0	7330
19503	23	42	27	7273	0	7365
19504	7136	19	14	63	0	7232
19505	7028	12	8	37	0	7085
19506	78	10	8	7003	0	7099
19507	32	3	6941	65	0	7041
19508	6614	6	54	41	0	6715
19509	57	20	6936	15	0	7028
19510	38	6	55	6922	0	7021
19511	6982	6	30	69	0	7087
19512	62	6970	16	31	0	7079
19513	7009	50	5	34	0	7098
19514	61	26	6919	18	0	7024
19515	7002	8	60	18	0	7088
19516	68	10	29	7107	0	7214
19517	37	5	21	7211	0	7274
19518	29	7	7214	73	0	7323
19519	25	13	52	7026	0	7116
19520	7112	9	28	79	0	7228
19521	69	5	21	7156	0	7251
19522	39	7217	13	64	0	7333
19523	21	55	18	7225	0	7319
19524	18	7277	13	71	0	7379
19525	16	57	7178	38	0	7289
19526	6997	31	56	29	0	7113
19527	72	11	25	7257	0	7365
19528	36	11	6946	71	0	7064
19529	26	6882	59	36	0	7003
19530	23	50	29	6833	0	6935
19531	18	29	12	6900	0	6959
19532	6847	14	23	91	0	6975
19533	73	11	11	6923	0	7018
19534	6986	9	12	89	0	7096
19535	6996	14	19	46	0	7075
19536	92	7077	12	20	0	7201
19537	7209	64	7	30	0	7310
19538	81	33	14	7684	0	7812
19539	47	13	7737	77	0	7874
19540	7710	12	72	59	0	7853
19541	91	8	34	7628	0	7761
19542	51	9	7625	82	0	7767
19543	7315	16	199	50	0	7580
19544	96	9	28	7686	0	7819
19545	52	7846	17	89	0	8004
19546	39	70	18	7699	0	7826
19547	30	7836	17	94	0	7977
19548	7793	76	13	55	0	7937
19549	82	44	8004	33	0	8163
19550	47	7945	82	51	0	8125
19551	49	86	35	7948	0	8118
19552	21	40	8035	98	0	8194
19553	34	26	7731	50	0	7841
19554	25	7888	104	34	0	8051
19555	49	120	40	7787	0	7996
19556	23	26	41	7980	0	8070
19557	28	28	19	8981	0	9056
19558	9455	15	13	204	0	9687
19559	173	23	10284	74	0	10554
19560	67	10449	206	57	0	10779
19561	42	219	70	10535	0	10866
19562	41	65	48	10961	0	11115
19563	31	41	10744	292	0	11108
19564	27	45	222	10780	0	11074
19565	35	17	10741	281	0	11074
19566	24	19	10402	109	0	10554
19567	18	21	10585	65	0	10689
19568	55	21	279	10180	0	10535
19569	17	16	115	10528	0	10676
19570	24	18	55	10784	0	10881
19571	10469	8	39	326	0	10842
19572	214	10369	41	118	0	10742
19573	10696	211	44	71	0	11022
19574	10581	67	22	89	0	10759
19575	11005	42	28	54	0	11129
19576	283	11006	19	60	0	11368
19577	11111	211	35	56	0	11413
19578	11313	74	22	49	0	11458
19579	324	48	27	11076	0	11475
19580	136	32	28	11333	0	11529
19581	100	11	25	11491	0	11627
19582	51	23	11247	329	0	11650
19583	10873	21	223	151	0	11268
19584	255	21	69	11163	0	11508
19585	11038	20	58	292	0	11408
19586	269	11022	43	120	0	11454
19587	113	220	28	11169	0	11530
19588	86	69	34	11398	0	11587
19589	11191	45	43	325	0	11604
19590	266	39	33	11253	0	11591
19591	10814	26	30	314	0	11184
19592	11329	26	24	145	0	11524
19593	300	10902	21	104	0	11327
19594	110	11246	15	90	0	11461
19595	105	296	23	10922	0	11346
19596	58	11187	40	231	0	11516
19597	76	276	15	11116	0	11483
19598	57	92	11009	283	0	11441
19599	50	63	10570	118	0	10801
19600	10296	59	260	85	0	10700
19601	10559	31	101	91	0	10782
19602	283	10423	60	63	0	10829
19603	10441	208	37	70	0	10756
19604	264	10790	42	63	0	11159
19605	124	215	45	10866	0	11250
19606	87	85	38	11045	0	11255
19607	61	55	33	11121	0	11270
19608	59	46	24	11202	0	11331
19609	10957	28	36	354	0	11375
19610	223	10948	38	200	0	11409
19611	11035	211	37	134	0	11417
19612	11220	72	39	104	0	11435
19613	307	45	10979	81	0	11412
19614	10794	42	203	84	0	11123
19615	308	10894	66	63	0	11331
19616	137	233	50	10936	0	11356
19617	121	86	33	10846	0	11086
19618	72	10683	25	286	0	11066
19619	10941	232	32	157	0	11362
19620	250	92	10776	106	0	11224
19621	10647	62	220	117	0	11046
19622	296	49	10845	111	0	11301
19623	161	38	259	10888	0	11346
19624	111	62	122	11132	0	11427
19625	98	59	88	11271	0	11516
19626	11198	49	75	387	0	11709
19627	263	47	11266	227	0	11803
19628	11255	56	253	174	0	11738
19629	11552	46	122	169	0	11889
19630	11556	43	118	159	0	11876
19631	11559	19	112	138	0	11828
19632	358	40	89	11354	0	11841
19633	176	42	11263	305	0	11786
19634	164	42	229	11241	0	11676
19635	145	36	11229	319	0	11729
19636	121	57	10984	180	0	11342
19637	126	11030	245	143	0	11544
19638	162	245	91	10282	0	10780
19639	142	98	67	10696	0	11003
19640	159	92	44	9218	0	9513
19641	143	69	33	10590	0	10835
19642	10530	51	44	322	0	10947
19643	10603	41	38	158	0	10840
19644	342	49	26	10382	0	10799
19645	181	25	10153	333	0	10692
19646	142	34	200	10282	0	10658
19647	102	30	82	10544	0	10758
19648	96	27	10277	366	0	10766
19649	106	20	205	10131	0	10462
19650	10145	40	83	322	0	10590
19651	10252	44	40	180	0	10516
19652	10251	43	29	161	0	10484
19653	342	39	20	10084	0	10485
19654	10044	48	24	285	0	10401
19655	9988	26	29	173	0	10216
19656	335	29	9695	133	0	10192
19657	134	19	8183	66	0	8402
19658	105	14	8027	54	0	8200
19659	7036	20	62	26	0	7144
19660	47	7084	34	21	0	7186
19661	6984	23	39	15	0	7061
19662	42	7288	10	6	0	7346
19663	29	31	12	7228	0	7300
19664	18	14	11	7291	0	7334
19665	20	6	6	7271	0	7303
19666	16	3	7209	54	0	7282
19667	6867	3	31	45	0	6946
19668	41	9	15	7184	0	7249
19669	21	3	7138	38	0	7200
19670	19	2	6809	21	0	6851
19671	6831	4	43	14	0	6892
19672	35	7123	20	19	0	7197
19673	6931	29	16	17	0	6993
19674	6845	12	6	16	0	6879
19675	41	6818	4	13	0	6876
19676	6647	29	6	12	0	6694
19677	41	13	6859	8	0	6921
19678	26	7	6585	3	0	6621
19679	20	6	6802	7	0	6835
19680	12	27	45	6723	0	6807
19681	11	1	6818	22	0	6852
19682	6564	2	22	13	0	6601
19683	6742	1	10	12	0	6765
19684	30	4	6845	2	0	6881
19685	23	3	21	6770	0	6817
19686	6803	1	11	30	0	6845
19687	25	7072	7	11	0	7115
19688	13	7145	5	7	0	7170
19689	7111	29	5	13	0	7158
19690	24	12	7172	2	0	7210
19691	23	52	17	6871	0	6963
19692	11	5	11	6890	0	6917
19693	4	0	6	6968	0	6978
19694	1	6866	2	28	0	6897
19695	17	21	3	6386	0	6427
19696	7241	4	1	40	0	7286
19697	33	9	3	7542	0	7587
19698	11	7628	3	40	0	7682
19699	7796	39	5	8	0	7848
19700	45	6	4	7832	0	7887
19701	18	11	2	8120	0	8151
19702	8239	7	1	56	0	8303
19703	8321	9	1	23	0	8354
19704	65	3	0	8309	0	8377
19705	8575	1	1	85	0	8662
19706	8652	0	4	28	0	8684
19707	88	8825	2	18	0	8933
19708	8901	73	0	27	0	9001
19709	96	8874	3	10	0	8983
19710	42	78	3	8873	0	8996
19711	34	27	9015	75	0	9151
19712	36	14	68	8918	0	9036
19713	17	15	16	9008	0	9056
19714	20	7	8	9251	0	9286
19715	9122	9	13	111	0	9255
19716	87	9131	4	55	0	9277
19717	9409	74	5	42	0	9530
19718	103	9663	6	28	0	9800
19719	9856	95	6	31	0	9988
19720	9910	38	7	28	0	9983
19721	9993	15	6	25	0	10039
19722	9851	24	6	26	0	9907
19723	141	11	9776	23	0	9951
19724	85	8	91	9796	0	9980
19725	50	13	23	10071	0	10157
19726	37	14	9891	131	0	10073
19727	9656	22	109	56	0	9843
19728	140	12	21	9854	0	10027
19729	52	13	9724	141	0	9930
19730	43	9	9672	43	0	9767
19731	56	12	131	9942	0	10141
19732	36	5	10186	133	0	10360
19733	36	10	129	10012	0	10187
19734	37	10	42	10121	0	10210
19735	34	9	9886	157	0	10086
19736	9633	12	127	60	0	9832
19737	143	11	36	9880	0	10070
19738	55	21	9975	134	0	10185
19739	42	4	131	10036	0	10213
19740	10045	4	42	160	0	10251
19741	137	4	9997	65	0	10203
19742	9806	6	129	60	0	10001
19743	10227	16	42	54	0	10339
19744	172	7	32	10169	0	10380
19745	68	15	37	10129	0	10249
19746	57	10	10061	159	0	10287
19747	49	18	132	10043	0	10242
19748	63	9	53	9249	0	9374
19749	40	7	33	10154	0	10234
19750	30	6	9908	180	0	10124
19751	9681	6	134	93	0	9914
19752	10019	8	49	83	0	10159
19753	10271	5	34	75	0	10385
19754	10489	11	36	61	0	10597
19755	210	11	26	10491	0	10738
19756	10449	12	26	169	0	10656
19757	10553	7	29	82	0	10671
19758	8370	40	40	115	0	8565
19759	10493	7	31	70	0	10601
19760	195	10440	21	55	0	10711
19761	10524	116	37	54	0	10731
19762	10505	32	32	45	0	10614
19763	205	10488	25	60	0	10778
19764	10614	145	24	60	0	10843
19765	207	35	25	10644	0	10911
19766	102	19	28	10749	0	10898
19767	10622	17	24	198	0	10861
19768	190	10414	20	81	0	10705
19769	83	10536	23	58	0	10700
19770	78	163	32	10694	0	10967
19771	72	49	10793	162	0	11076
19772	80	31	130	10596	0	10837
19773	71	21	43	10842	0	10977
19774	10636	16	30	214	0	10896
19775	10697	22	30	89	0	10838
19776	209	16	23	10653	0	10901
19777	95	18	10545	188	0	10846
19778	81	22	140	10682	0	10925
19779	10841	19	54	193	0	11107
19780	196	20	11258	88	0	11562
19781	97	11325	174	69	0	11665
19782	11689	152	61	71	0	11973
19783	221	50	42	11754	0	12067
19784	106	28	31	11768	0	11933
19785	82	20	18	12008	0	12128
19786	67	18	11606	253	0	11944
19787	10713	18	164	138	0	11033
19788	217	18	11240	77	0	11552
19789	102	11168	192	73	0	11535
19790	82	167	78	11309	0	11636
19791	85	66	45	11486	0	11682
19792	72	28	39	11949	0	12088
19793	68	26	11736	283	0	12113
19794	72	15	11538	136	0	11761
19795	52	21	11902	96	0	12071
19796	54	11949	256	78	0	12337
19797	71	193	128	12036	0	12428
19798	12200	56	56	241	0	12553
19799	12961	32	41	106	0	13140
19800	299	25	13621	70	0	14015
19801	126	13713	230	67	0	14136
19802	85	227	13697	54	0	14063
19803	64	14106	248	66	0	14484
19804	13582	301	189	117	0	14189
19805	13583	93	65	69	0	13810
19806	314	13474	47	47	0	13882
19807	13432	250	35	50	0	13767
19808	303	98	39	13274	0	13714
19809	162	56	43	13555	0	13816
19810	13464	51	39	312	0	13866
19811	13246	47	34	131	0	13458
19812	13279	47	30	85	0	13441
19813	357	12874	30	80	0	13341
19814	168	13467	21	75	0	13731
19815	13412	277	28	71	0	13788
19816	328	119	13234	48	0	13729
19817	178	145	224	12913	0	13460
19818	12691	69	115	237	0	13112
19819	284	12411	52	113	0	12860
19820	152	12802	37	66	0	13057
19821	12781	289	46	65	0	13181
19822	296	118	12492	56	0	12962
19823	12222	100	232	71	0	12625
19824	298	78	12293	47	0	12716
19825	163	63	12346	34	0	12606
19826	120	74	277	12329	0	12800
19827	97	61	12591	213	0	12962
19828	12406	37	260	110	0	12813
19829	12769	46	130	66	0	13011
19830	12964	36	95	59	0	13154
19831	12890	38	82	53	0	13063
19832	344	48	69	12493	0	12954
19833	12586	35	58	232	0	12911
19834	321	12427	48	110	0	12906
19835	206	198	53	12086	0	12543
19836	160	12586	38	209	0	12993
19837	13015	222	39	119	0	13395
19838	13010	104	45	80	0	13239
19839	351	78	41	12831	0	13301
19840	12976	64	49	242	0	13331
19841	13100	61	43	126	0	13330
19842	351	63	44	12903	0	13361
19843	219	48	32	12984	0	13283
19844	172	46	39	13137	0	13394
19845	128	51	12768	327	0	13274
19846	130	40	12231	168	0	12569
19847	129	47	12676	113	0	12965
19848	124	40	296	12756	0	13216
19849	113	41	12973	278	0	13405
19850	108	40	268	12888	0	13304
19851	111	40	13616	279	0	14046
19852	102	40	13245	153	0	13540
19853	12781	38	327	139	0	13285
19854	258	13064	157	122	0	13601
19855	13324	205	123	105	0	13757
19856	305	92	100	13188	0	13685
19857	162	64	93	13348	0	13667
19858	128	63	13330	292	0	13813
19859	131	13291	223	157	0	13802
19860	116	234	114	13483	0	13947
19861	116	98	13455	264	0	13933
19862	86	13181	232	132	0	13631
19863	113	205	110	13136	0	13564
19864	13004	97	106	252	0	13459
19865	13016	92	74	136	0	13318
19866	305	57	75	12986	0	13423
19867	13038	56	64	264	0	13422
19868	275	13027	67	152	0	13521
19869	174	204	57	13166	0	13601
19870	128	103	13191	246	0	13668
19871	135	55	214	13250	0	13654
19872	112	60	13269	267	0	13708
19873	13099	56	224	155	0	13534
19874	275	50	96	13495	0	13916
19875	141	13537	94	260	0	14032
19876	134	219	81	14042	0	14476
19877	107	82	13875	277	0	14341
19878	110	77	13492	139	0	13818
19879	108	63	13374	112	0	13657
19880	12664	102	319	123	0	13208
19881	214	12956	140	94	0	13404
19882	102	180	87	12801	0	13170
19883	12767	72	91	214	0	13144
19884	205	12832	86	108	0	13231
19885	13238	178	74	108	0	13598
19886	13364	82	67	85	0	13598
19887	13528	67	58	83	0	13736
19888	13673	52	60	87	0	13872
19889	288	38	13354	65	0	13745
19890	12998	36	174	70	0	13278
19891	266	37	12946	47	0	13296
19892	12490	36	163	62	0	12751
19893	249	45	101	12839	0	13234
19894	152	29	12703	140	0	13024
19895	102	12416	153	84	0	12755
19896	157	667	108	11540	0	12472
19897	88	11938	59	121	0	12206
19898	69	12013	51	68	0	12201
19899	10891	111	93	124	0	11219
19900	91	26	10418	35	0	10570
19901	30	10043	52	31	0	10156
19902	9712	56	70	26	0	9864
19903	42	9878	15	7	0	9942
19904	9841	35	10	20	0	9906
19905	45	13	7	9819	0	9884
19906	9844	5	9	42	0	9900
19907	43	5	9	9720	0	9777
19908	9767	5	10	41	0	9823
19909	43	8	7	9716	0	9774
19910	14	9936	5	40	0	9995
19911	16	39	6	10106	0	10167
19912	10109	9	2	53	0	10173
19913	34	10013	10	18	0	10075
19914	18	39	6	10001	0	10064
19915	10089	11	5	44	0	10149
19916	40	10	6	10134	0	10190
19917	15	12	5	10139	0	10171
19918	16	8	10214	39	0	10277
19919	16	7	9930	18	0	9971
19920	18	6	40	9996	0	10060
19921	13	12	10357	35	0	10417
19922	16	7	37	10291	0	10351
19923	32	12	15	9227	0	9286
19924	16	16	5	10323	0	10360
19925	8	14	10256	52	0	10330
19926	27	6	29	9859	0	9921
19927	14	8	7	10022	0	10051
19928	13	10036	7	41	0	10097
19929	14	31	6	10073	0	10124
19930	10025	14	5	51	0	10095
19931	39	9	2	10150	0	10200
19932	10	10	10931	50	0	11001
19933	10558	7	80	33	0	10678
19934	87	11644	53	25	0	11809
19935	68	94	34	11888	0	12084
19936	56	49	11712	109	0	11926
19937	11014	48	99	77	0	11238
19938	104	11562	60	66	0	11792
19939	11671	108	53	41	0	11873
19940	160	57	23	11627	0	11867
19941	11617	49	19	125	0	11810
19942	163	25	11607	60	0	11855
19943	77	11435	100	68	0	11680
19944	63	12156	58	37	0	12314
19945	12274	134	50	37	0	12495
19946	12277	92	19	37	0	12425
19947	165	63	12214	17	0	12459
19948	11978	22	107	34	0	12141
19949	12264	15	53	23	0	12355
19950	12297	14	53	30	0	12394
19951	202	11631	24	13	0	11870
19952	120	11802	21	18	0	11961
19953	11831	137	14	26	0	12008
19954	11891	90	11	27	0	12019
19955	162	11975	10	19	0	12166
19956	115	116	13	12048	0	12292
19957	76	77	12003	97	0	12253
19958	11650	60	98	67	0	11875
19959	10959	41	70	111	0	11181
19960	12185	20	51	45	0	12301
19961	191	12053	28	18	0	12290
19962	117	106	12108	14	0	12345
19963	12335	60	105	26	0	12526
19964	146	59	54	12459	0	12718
19965	96	22	47	12484	0	12649
19966	87	19	28	12709	0	12843
19967	47	20	12532	189	0	12788
19968	49	18	106	12329	0	12502
19969	43	25	12426	167	0	12661
19970	26	12162	138	90	0	12416
19971	12009	106	71	77	0	12263
19972	113	11996	51	33	0	12193
19973	69	12066	24	24	0	12183
19974	11995	156	33	37	0	12221
19975	121	12113	21	17	0	12272
19976	80	152	10	11801	0	12043
19977	64	11697	18	96	0	11875
19978	11648	143	4	70	0	11865
19979	123	11775	6	46	0	11950
19980	71	164	3	12005	0	12243
19981	55	81	11953	111	0	12200
19982	40	75	98	12135	0	12348
19983	35	12060	58	180	0	12333
19984	33	121	50	12276	0	12480
19985	20	95	26	12026	0	12167
19986	41	55	22	11593	0	11711
19987	29	30	16	12191	0	12266
19988	31	19	16	12310	0	12376
19989	27	27	10	12431	0	12495
19990	21	19	12446	276	0	12762
19991	12174	25	135	179	0	12513
19992	153	19	83	13387	0	13642
19993	103	15	13525	217	0	13860
19994	62	25	13508	162	0	13757
19995	58	23	279	13763	0	14123
19996	13856	19	184	257	0	14316
19997	198	18	13683	150	0	14049
19998	13504	26	236	139	0	13905
19999	289	25	14048	71	0	14433
20000	172	24	279	13952	0	14427
20001	146	25	160	14316	0	14647
20002	89	33	14147	292	0	14561
20003	13480	31	228	230	0	13969
20004	236	20	147	13952	0	14355
20005	151	30	13948	240	0	14369
20006	134	22	13924	179	0	14259
20007	86	24	308	13389	0	13807
20008	70	13930	226	226	0	14452
20009	14116	180	155	155	0	14606
20010	14080	117	85	145	0	14427
20011	319	103	14102	80	0	14604
20012	252	49	225	13911	0	14437
20013	14250	40	151	254	0	14695
20014	278	32	14183	165	0	14658
20015	13909	23	242	160	0	14334
20016	314	13800	168	106	0	14388
20017	192	181	139	14319	0	14831
20018	166	113	105	14478	0	14862
20019	14819	85	79	361	0	15344
20020	263	55	71	14940	0	15329
20021	204	39	67	14808	0	15118
20022	155	37	55	14987	0	15234
20023	14646	30	56	483	0	15215
20024	265	35	14532	310	0	15142
20025	14539	24	235	227	0	15025
20026	14641	24	141	179	0	14985
20027	14955	29	124	129	0	15237
20028	443	24	78	14687	0	15232
20029	318	27	14814	278	0	15437
20030	191	14294	271	206	0	14962
20031	159	14456	157	184	0	14956
20032	98	14416	110	119	0	14743
20033	109	270	14385	98	0	14862
20034	107	244	221	15596	0	16168
20035	16080	73	127	382	0	16662
20036	17706	51	88	257	0	18102
20037	499	46	55	18510	0	19110
20038	313	36	18318	448	0	19115
20039	211	28	18379	253	0	18871
20040	143	24	493	18627	0	19287
20041	122	26	18755	465	0	19368
20042	123	24	499	18820	0	19466
20043	113	17	257	18565	0	18952
20044	74	18483	211	613	0	19381
20045	104	341	147	18968	0	19560
20046	90	178	104	19602	0	19974
20047	19045	127	114	696	0	19982
20048	454	81	108	19313	0	19956
20049	284	40	82	19488	0	19894
20050	18859	40	115	720	0	19734
20051	470	18671	122	451	0	19714
20052	18940	360	101	362	0	19763
20053	572	198	18671	245	0	19686
20054	18662	140	431	241	0	19474
20055	18717	85	285	252	0	19339
20056	679	66	18263	184	0	19192
20057	419	67	18185	190	0	18861
20058	355	66	620	17742	0	18783
20059	17868	45	400	532	0	18845
20060	571	48	17690	318	0	18627
20061	392	34	548	17592	0	18566
20062	297	44	17581	578	0	18500
20063	245	40	638	17432	0	18355
20064	199	30	383	17875	0	18487
20065	17399	41	312	775	0	18527
20066	17257	61	235	533	0	18086
20067	17837	48	166	435	0	18486
20068	789	62	17401	308	0	18560
20069	476	61	17455	291	0	18283
20070	383	62	626	17374	0	18445
20071	324	69	401	17521	0	18315
20072	292	77	295	17886	0	18550
20073	17177	50	226	818	0	18271
20074	557	17024	208	543	0	18332
20075	17015	388	188	444	0	18035
20076	16881	211	150	349	0	17591
20077	807	16340	181	262	0	17590
20078	499	16892	188	276	0	17855
20079	16885	527	154	296	0	17862
20080	614	308	148	16315	0	17385
20081	429	16241	139	687	0	17496
20082	460	425	120	16424	0	17429
20083	400	242	15965	714	0	17321
20084	346	183	456	16369	0	17354
20085	16073	125	362	800	0	17360
20086	561	90	15955	532	0	17138
20087	417	75	15764	462	0	16718
20088	410	443	707	14557	0	16117
20089	323	14768	460	636	0	16187
20090	275	14631	287	500	0	15693
20091	264	15186	215	471	0	16136
20092	14222	569	237	429	0	15457
20093	14225	273	154	420	0	15072
20094	13768	176	133	379	0	14456
20095	633	13617	155	395	0	14800
20096	13940	328	146	424	0	14838
20097	13933	201	143	336	0	14613
20098	671	237	13463	245	0	14616
20099	506	13092	411	248	0	14257
20100	448	396	319	13240	0	14403
20101	13263	238	271	470	0	14242
20102	612	192	13026	350	0	14180
20103	397	141	481	12726	0	13745
20104	344	12866	348	541	0	14099
20105	326	339	259	12995	0	13919
20106	350	188	218	13220	0	13976
20107	13045	155	263	685	0	14148
20108	13201	131	219	541	0	14092
20109	647	101	222	13134	0	14104
20110	408	131	12825	617	0	13981
20111	373	123	12798	475	0	13769
20112	13079	95	515	404	0	14093
20113	698	116	13100	273	0	14187
20114	539	148	516	11880	0	13083
20115	403	12317	367	461	0	13548
20116	12367	355	376	305	0	13403
20117	554	12311	260	368	0	13493
20118	12476	411	219	411	0	13517
20119	612	200	215	12357	0	13384
20120	435	193	165	12599	0	13392
20121	12442	197	155	626	0	13420
20122	12749	159	174	397	0	13479
20123	746	190	140	12437	0	13513
20124	548	216	125	12598	0	13487
20125	434	200	12082	542	0	13258
20126	346	179	12061	380	0	12966
20127	12010	173	486	388	0	13057
20128	502	204	11369	310	0	12385
20129	11682	141	444	382	0	12649
20130	11848	110	298	370	0	12626
20131	678	117	11361	325	0	12481
20132	486	10764	406	277	0	11933
20133	406	11019	305	198	0	11928
20134	210	185	9460	91	0	9946
20135	375	682	440	7841	0	9338
20136	7080	165	264	276	0	7785
20137	6860	30	34	65	0	6989
20138	7531	22	17	62	0	7632
20139	8601	18	19	66	0	8704
20140	8867	20	20	41	0	8948
20141	256	9079	30	39	0	9404
20142	8899	180	26	32	0	9137
20143	227	8796	24	29	0	9076
20144	8629	192	26	14	0	8861
20145	233	47	8390	8	0	8678
20146	105	29	172	8099	0	8405
20147	81	18	39	7998	0	8136
20148	38	8111	20	197	0	8366
20149	8174	191	10	56	0	8431
20150	8346	64	12	40	0	8462
20151	260	43	10	8105	0	8418
20152	95	22	27	8291	0	8435
20153	8171	16	25	257	0	8469
20154	206	14	12	8228	0	8460
20155	75	29	14	8362	0	8480
20156	8218	26	9	242	0	8495
20157	247	12	6	8236	0	8501
20158	8258	8	9	234	0	8509
20159	8374	9	8	112	0	8503
20160	260	13	8163	60	0	8496
20161	8264	12	160	73	0	8509
20162	8314	12	34	73	0	8433
20163	8362	12	26	49	0	8449
20164	282	11	7981	41	0	8315
20165	121	12	177	7964	0	8274
20166	110	10	39	8158	0	8317
20167	71	21	7948	224	0	8264
20168	7911	9	195	70	0	8185
20169	265	10	53	7861	0	8189
20170	105	8	7782	218	0	8113
20171	73	13	7976	73	0	8135
20172	68	9	222	7979	0	8278
20173	56	15	8063	238	0	8372
20174	63	10	213	8014	0	8300
20175	74	6	67	8167	0	8314
20176	56	11	7988	266	0	8321
20177	58	11	206	7781	0	8056
20178	49	7642	87	212	0	7990
20179	40	8087	61	110	0	8298
20180	7951	205	61	66	0	8283
20181	8026	50	36	68	0	8180
20182	237	7898	26	88	0	8249
20183	7927	197	48	56	0	8228
20184	8106	55	34	61	0	8256
20185	276	48	21	7908	0	8253
20186	110	55	27	8105	0	8297
20187	7906	41	16	254	0	8217
20188	264	7723	22	90	0	8099
20189	111	7953	21	71	0	8156
20190	121	218	26	7837	0	8202
20191	101	68	7854	221	0	8244
20192	7693	38	191	123	0	8045
20193	7945	29	47	112	0	8133
20194	7773	30	35	77	0	7915
20195	284	7751	36	55	0	8126
20196	150	207	22	7627	0	8006
20197	108	67	27	7890	0	8092
20198	7676	47	42	272	0	8037
20199	284	7621	36	99	0	8040
20200	169	197	19	7546	0	7931
20201	148	70	27	7739	0	7984
20202	135	67	21	7735	0	7958
20203	7604	51	20	309	0	7984
20204	275	7542	28	155	0	8000
20205	148	251	24	7314	0	7737
20206	113	7579	30	229	0	7951
20207	7510	224	37	133	0	7904
20208	278	71	7374	132	0	7855
20209	7293	63	185	160	0	7701
20210	288	41	7161	103	0	7593
20211	165	161	205	6728	0	7259
20212	6759	45	67	269	0	7140
20213	247	60	6675	119	0	7101
20214	6705	40	175	101	0	7021
20215	6907	23	81	110	0	7121
20216	7012	20	65	98	0	7195
20217	286	16	57	6738	0	7097
20218	147	20	49	6789	0	7005
20219	158	19	39	6856	0	7072
20220	6659	17	47	282	0	7005
20221	251	6660	47	147	0	7105
20222	6719	148	54	84	0	7005
20223	6876	41	42	92	0	7051
20224	279	33	6594	93	0	6999
20225	6655	30	168	97	0	6950
20226	6917	26	69	100	0	7112
20227	280	17	67	6752	0	7116
20228	138	44	50	6813	0	7045
20229	134	33	42	6868	0	7077
20230	6681	29	65	236	0	7011
20231	6630	24	62	130	0	6846
20232	6445	15	53	115	0	6628
20233	240	5985	59	87	0	6371
20234	93	5467	53	79	0	5692
20235	51	5575	34	98	0	5758
20236	5422	143	90	105	0	5760
20237	176	45	5339	88	0	5648
20238	87	37	4496	70	0	4690
20239	3277	29	84	35	0	3425
20240	55	2	3366	13	0	3436
20241	12	1	13	2761	0	2787
20242	2	2693	7	12	0	2714
20243	2882	14	6	11	0	2913
20244	2891	4	1	3	0	2899
20245	2914	1	2	4	0	2921
20246	16	1	0	3082	0	3099
20247	8	5	3133	9	0	3155
20248	3	2	3055	4	0	3064
20249	3115	1	10	7	0	3133
20250	3178	0	5	4	0	3187
20251	3152	0	1	4	0	3157
20252	19	1	3	3210	0	3233
20253	8	1	1	3221	0	3231
20254	5	2	3224	13	0	3244
20255	3192	1	9	8	0	3210
20256	13	1	4	3300	0	3318
20257	10	0	0	3281	0	3291
20258	5	2	0	3260	0	3267
20259	2	3254	3	14	0	3273
20260	1	10	1	3226	0	3238
20261	5	3	1	3220	0	3229
20262	3202	2	1	17	0	3222
20263	14	1	3137	6	0	3158
20264	3054	3	12	7	0	3076
20265	3192	4	4	5	0	3205
20266	17	6	0	3155	0	3178
20267	8	1	3	3164	0	3176
20268	3153	0	4	13	0	3170
20269	12	2	3114	4	0	3132
20270	8	3129	11	5	0	3153
20271	7	9	4	3078	0	3098
20272	3080	1	5	11	0	3097
20273	12	2	3	3005	0	3022
20274	9	2	3005	7	0	3023
20275	9	0	2953	4	0	2966
20276	3006	0	8	8	0	3022
20277	14	2	4	3110	0	3130
20278	4	2	3071	14	0	3091
20279	3007	0	7	9	0	3023
20280	3245	2	3	5	0	3255
20281	12	0	1	3269	0	3282
20282	5	1	0	3260	0	3266
20283	7	3266	4	8	0	3285
20284	3371	6	1	9	0	3387
20285	16	3	1	3376	0	3396
20286	7	1	2	3425	0	3435
20287	7	0	3483	9	0	3499
20288	3266	3	3	10	0	3282
20289	3412	1	2	11	0	3426
20290	13	3360	1	6	0	3380
20291	5	6	3260	5	0	3276
20292	1	3	3255	4	0	3263
20293	12	9	10	3207	0	3238
20294	3328	7	10	11	0	3356
20295	8	2	3	3325	0	3338
20296	3425	1	3	7	0	3436
20297	3444	1	2	6	0	3453
20298	3488	1	1	8	0	3498
20299	4	4	0	3540	0	3548
20300	5	2	1	3557	0	3565
20301	3581	2	1	9	0	3593
20302	6	0	3625	3	0	3634
20303	3398	2	3	4	0	3407
20304	3465	0	1	4	0	3470
20305	5	0	3559	3	0	3567
20306	5	0	3477	0	0	3482
20307	2	3529	4	1	0	3536
20308	2	8	4	3576	0	3590
20309	3461	0	1	7	0	3469
20310	4	0	1	3598	0	3603
20311	2	0	3660	3	0	3665
20312	1	3590	2	0	0	3593
20313	1	3579	0	1	0	3581
20314	1	3	1	3680	0	3685
20315	3	0	1	3573	0	3577
20316	1	3526	0	5	0	3532
20317	0	3	3524	3	0	3530
20318	3331	0	2	8	0	3341
20319	3629	0	0	5	0	3634
20320	3	3653	2	2	0	3660
20321	3563	5	0	1	0	3569
20322	4	3	0	3504	0	3511
20323	3467	0	1	9	0	3477
20324	5	0	1	3443	0	3449
20325	0	3634	0	4	0	3638
20326	0	9	3633	1	0	3643
20327	6	0	6	3924	0	3936
20328	6	3	3	3800	0	3812
20329	2	2	1	4149	0	4154
20330	4315	1	0	18	0	4334
20331	22	1	0	4351	0	4374
20332	16	3	4636	21	0	4676
20333	4	2	4841	16	0	4863
20334	5058	4	40	8	0	5110
20335	39	2	5195	2	0	5238
20336	5190	0	42	9	0	5241
20337	48	1	11	5578	0	5638
20338	22	2	8	5704	0	5736
20339	11	1	7	5995	0	6014
20340	12	1	3	6104	0	6120
20341	6104	0	4	99	0	6207
20342	77	0	6198	19	0	6294
20343	36	5	72	6055	0	6168
20344	6	6327	22	77	0	6432
20345	6373	76	8	26	0	6483
20346	85	15	7	6232	0	6339
20347	6171	5	5	97	0	6278
20348	93	5	6140	26	0	6264
20349	32	2	84	5941	0	6059
20350	14	6108	20	80	0	6222
20351	6158	76	13	29	0	6276
20352	96	17	6114	25	0	6252
20353	26	11	82	6054	0	6173
20354	29	2	21	6186	0	6238
20355	6100	4	15	107	0	6226
20356	95	5	6046	40	0	6186
20357	25	16	6107	19	0	6167
20358	24	6	98	6104	0	6232
20359	18	7	6102	92	0	6219
20360	19	1	6197	34	0	6251
20361	30	5	110	6148	0	6293
20362	23	3	34	6272	0	6332
20363	17	8	26	6447	0	6498
20364	6353	5	20	133	0	6511
20365	98	6411	26	49	0	6584
20366	6491	84	25	37	0	6637
20367	111	20	23	6459	0	6613
20368	40	6510	19	119	0	6688
20369	22	91	21	6722	0	6856
20370	6886	22	18	132	0	7058
20371	105	7185	17	60	0	7367
20372	47	106	16	7453	0	7622
20373	32	26	7489	129	0	7676
20374	7440	21	121	56	0	7638
20375	136	25	30	7519	0	7710
20376	54	15	25	7592	0	7686
20377	46	17	7417	164	0	7644
20378	47	14	7368	75	0	7504
20379	7218	14	150	71	0	7453
20380	140	7204	48	53	0	7445
20381	48	128	51	7285	0	7512
20382	7285	30	37	154	0	7506
20383	153	27	7289	64	0	7533
20384	52	7235	141	60	0	7488
20385	44	121	48	7276	0	7489
20386	7297	32	44	175	0	7548
20387	7137	25	43	81	0	7286
20388	7325	16	31	73	0	7445
20389	161	7194	36	73	0	7464
20390	73	125	7212	63	0	7473
20391	80	38	136	7297	0	7551
20392	82	31	59	6453	0	6625
20393	39	32	42	7397	0	7510
20394	44	22	41	7406	0	7513
20395	7254	20	28	199	0	7501
20396	7222	26	37	96	0	7381
20397	175	24	7073	76	0	7348
20398	72	18	7038	70	0	7198
20399	6932	16	156	63	0	7167
20400	7073	23	54	70	0	7220
20401	181	18	49	6845	0	7093
20402	77	6920	50	154	0	7201
20403	6949	120	52	64	0	7185
20404	162	6793	29	88	0	7072
20405	66	6866	32	74	0	7038
20406	70	152	38	7004	0	7264
20407	57	45	35	7115	0	7252
20408	56	46	30	7105	0	7237
20409	52	42	40	7110	0	7244
20410	54	24	6898	202	0	7178
20411	6771	32	131	92	0	7026
20412	6954	26	42	92	0	7114
20413	179	23	41	6814	0	7057
20414	78	29	41	6882	0	7030
20415	6818	36	29	186	0	7069
20416	177	29	6362	96	0	6664
20417	6754	31	111	84	0	6980
20418	6830	29	45	82	0	6986
20419	186	16	6679	69	0	6950
20420	6836	26	135	70	0	7067
20421	187	26	49	6894	0	7156
20422	82	15	46	7011	0	7154
20423	75	17	52	7002	0	7146
20424	84	18	40	7009	0	7151
20425	6679	18	21	206	0	6924
20426	169	32	31	6590	0	6822
20427	71	16	31	6263	0	6381
20428	63	5822	30	176	0	6091
20429	55	5995	28	83	0	6161
20430	52	115	18	5890	0	6075
20431	5801	30	11	163	0	6005
20432	159	36	28	5445	0	5668
20433	62	26	5045	114	0	5247
20434	50	17	4749	50	0	4866
20435	4683	18	87	56	0	4844
20436	111	4761	31	55	0	4958
20437	4390	73	56	50	0	4569
20438	109	23	4435	23	0	4590
20439	73	164	72	3973	0	4282
20440	3924	20	40	64	0	4048
20441	71	3918	19	22	0	4030
20442	3807	42	30	34	0	3913
20443	64	10	4034	30	0	4138
20444	34	23	45	3908	0	4010
20445	25	19	17	3987	0	4048
20446	4075	10	17	60	0	4162
20447	4078	6	19	35	0	4138
20448	4127	11	13	36	0	4187
20449	4114	11	9	28	0	4162
20450	4149	13	6	26	0	4194
20451	67	4118	6	26	0	4217
20452	46	37	11	4165	0	4259
20453	4215	14	7	56	0	4292
20454	60	15	9	4205	0	4289
20455	33	10	6	4215	0	4264
20456	38	5	5	4225	0	4273
20457	28	4115	6	61	0	4210
20458	4171	37	7	41	0	4256
20459	48	8	13	4146	0	4215
20460	4045	11	5	66	0	4127
20461	3985	8	5	38	0	4036
20462	52	3933	9	27	0	4021
20463	3927	30	7	31	0	3995
20464	68	9	3842	20	0	3939
20465	3766	16	41	11	0	3834
20466	63	28	30	3754	0	3875
20467	29	10	3843	39	0	3921
20468	23	3791	37	23	0	3874
20469	35	32	3749	23	0	3839
20470	15	3506	25	10	0	3556
20471	3174	43	43	26	0	3286
20472	3133	7	7	13	0	3160
20473	3077	2	3	8	0	3090
20474	13	3069	3	19	0	3104
20475	3074	9	0	7	0	3090
20476	12	3	3080	4	0	3099
20477	8	2	3050	2	0	3062
20478	8	9	5	3063	0	3085
20479	3	1	9	3218	0	3231
20480	1	3218	0	9	0	3228
20481	3285	7	1	10	0	3303
20482	9	2	0	3318	0	3329
20483	2	3312	0	11	0	3325
20484	3	9	2	3382	0	3396
20485	3372	3	0	17	0	3392
20486	3284	2	1	10	0	3297
20487	12	1	3212	3	0	3228
20488	6	1	8	3255	0	3270
20489	3	4	3243	10	0	3260
20490	5	2	10	3283	0	3300
20491	5	3	3300	14	0	3322
20492	5	3	15	3282	0	3305
20493	1	2	3325	15	0	3343
20494	6	2	14	3317	0	3339
20495	3	5	3400	16	0	3424
20496	5	0	16	3381	0	3402
20497	5	1	6	3456	0	3468
20498	3	3480	9	25	0	3517
20499	2	18	5	3620	0	3645
20500	2	2	3587	26	0	3617
20501	7	1	20	3562	0	3590
20502	5	2	5	3587	0	3599
20503	3576	3	4	36	0	3619
20504	24	2	5	3620	0	3651
20505	5	2	5	3565	0	3577
20506	4	3	3456	26	0	3489
20507	3408	2	19	21	0	3450
20508	22	1	4	3542	0	3569
20509	10	3	3	3544	0	3560
20510	9	3	5	3565	0	3582
20511	3566	1	3	35	0	3605
20512	24	2	3	3603	0	3632
20513	8	0	1	3630	0	3639
20514	3577	1	4	43	0	3625
20515	25	3598	1	18	0	3642
20516	11	16	6	3556	0	3589
20517	9	4	2	3607	0	3622
20518	5	5	3501	29	0	3540
20519	3103	2	20	34	0	3159
20520	21	4	4	3462	0	3491
20521	5	5	3366	31	0	3407
20522	3422	4	24	14	0	3464
20523	26	0	5	3556	0	3587
20524	6	2	8	3660	0	3676
20525	8	2	5	3693	0	3708
20526	10	4	3	3750	0	3767
20527	5	2	3958	45	0	4010
20528	8	0	38	4002	0	4048
20529	8	2	11	4784	0	4805
20530	10	0	5501	79	0	5590
20531	5846	0	102	32	0	5980
20532	6134	1	39	39	0	6213
20533	6247	1	31	24	0	6303
20534	197	6	29	6111	0	6343
20535	6232	1	19	134	0	6386
20536	6405	0	6	56	0	6467
20537	225	0	11	6349	0	6585
20538	6340	4	3	174	0	6521
20539	6407	3	8	81	0	6499
20540	6469	0	5	67	0	6541
20541	6480	2	11	59	0	6552
20542	242	1	4	6245	0	6492
20543	145	5926	5	141	0	6217
20544	114	5996	10	55	0	6175
20545	97	6124	11	47	0	6279
20546	5992	170	3	57	0	6222
20547	6161	91	5	37	0	6294
20548	188	82	5993	27	0	6290
20549	6164	55	121	34	0	6374
20550	222	33	40	6216	0	6511
20551	116	21	35	6297	0	6469
20552	92	16	36	6345	0	6489
20553	6223	10	24	203	0	6460
20554	181	8	13	6228	0	6430
20555	75	6103	10	217	0	6405
20556	76	126	9	6253	0	6464
20557	70	43	6350	198	0	6661
20558	53	40	119	6466	0	6678
20559	6476	48	43	210	0	6777
20560	170	24	6465	105	0	6764
20561	81	14	156	6512	0	6763
20562	75	16	57	6567	0	6715
20563	71	6	49	6622	0	6748
20564	54	6526	48	207	0	6835
20565	46	128	26	6681	0	6881
20566	6601	42	13	247	0	6903
20567	6569	38	21	128	0	6756
20568	208	43	6433	92	0	6776
20569	90	29	6556	89	0	6764
20570	112	17	160	6540	0	6829
20571	85	13	81	6741	0	6920
20572	56	16	6699	200	0	6971
20573	45	18	182	6408	0	6653
20574	47	6554	71	203	0	6875
20575	6824	135	56	144	0	7159
20576	6874	50	48	96	0	7068
20577	6844	40	38	97	0	7019
20578	237	47	6808	51	0	7143
20579	139	27	148	6883	0	7197
20580	125	16	6782	174	0	7097
20581	6659	12	172	87	0	6930
20582	191	6701	87	74	0	7053
20583	91	137	70	6680	0	6978
20584	6717	48	48	198	0	7011
20585	209	50	42	6695	0	6996
20586	88	42	23	6914	0	7067
20587	77	25	6726	242	0	7070
20588	6539	16	144	141	0	6840
20589	192	6714	60	117	0	7083
20590	106	137	51	6816	0	7110
20591	6790	44	52	190	0	7076
20592	227	50	31	6782	0	7090
20593	6740	46	29	224	0	7039
20594	221	6742	23	124	0	7110
20595	6861	143	19	102	0	7125
20596	253	53	6827	86	0	7219
20597	6888	54	148	75	0	7165
20598	6931	48	65	54	0	7098
20599	6979	41	54	47	0	7121
20600	285	21	44	6744	0	7094
20601	176	27	38	6429	0	6670
20602	161	29	23	6734	0	6947
20603	112	6643	22	220	0	6997
20604	6752	152	16	156	0	7076
20605	208	51	13	6770	0	7042
20606	128	48	19	6851	0	7046
20607	98	42	24	6876	0	7040
20608	6728	34	23	258	0	7043
20609	200	18	22	6809	0	7049
20610	91	19	6606	278	0	6994
20611	74	6681	132	171	0	7058
20612	102	137	49	6793	0	7081
20613	64	65	45	6939	0	7113
20614	60	53	35	6990	0	7138
20615	47	55	6758	265	0	7125
20616	46	23	6781	178	0	7028
20617	42	22	183	6884	0	7131
20618	52	23	7114	239	0	7428
20619	48	20	198	7233	0	7499
20620	7269	13	98	256	0	7636
20621	7536	9	71	171	0	7787
20622	7530	18	54	129	0	7731
20623	237	28	7273	99	0	7637
20624	7224	23	147	85	0	7479
20625	261	18	68	7329	0	7676
20626	143	11	7216	186	0	7556
20627	117	10	7083	85	0	7295
20628	93	6910	183	105	0	7291
20629	64	6371	77	68	0	6580
20630	5342	106	180	61	0	5689
20631	67	20	17	5151	0	5255
20632	15	15	5219	44	0	5293
20633	21	7	35	5245	0	5308
20634	5283	4	14	59	0	5360
20635	42	0	5541	26	0	5609
20636	5502	4	49	28	0	5583
20637	5751	6	9	16	0	5782
20638	5643	1	12	13	0	5669
20639	72	5619	9	9	0	5709
20640	5728	49	3	16	0	5796
20641	68	11	5	5789	0	5873
20642	32	12	5	5741	0	5790
20643	25	4	3	5837	0	5869
20644	20	3	6	5791	0	5820
20645	5687	1	8	80	0	5776
20646	62	5578	1	35	0	5676
20647	23	5457	9	17	0	5506
20648	20	5564	4	14	0	5602
20649	5543	63	14	16	0	5636
20650	5542	18	11	14	0	5585
20651	5495	10	5	14	0	5524
20652	5525	8	4	18	0	5555
20653	77	5	2	5524	0	5608
20654	31	5	3	5520	0	5559
20655	5496	1	5	70	0	5572
20656	47	5465	9	32	0	5553
20657	5264	48	4	19	0	5335
20658	5446	17	0	18	0	5481
20659	62	10	5	5383	0	5460
20660	27	5427	3	55	0	5512
20661	21	48	7	5532	0	5608
20662	5474	15	5	77	0	5571
20663	69	16	5540	20	0	5645
20664	24	2	51	5435	0	5512
20665	22	5521	16	49	0	5608
20666	5527	54	11	18	0	5610
20667	5520	14	8	24	0	5566
20668	63	17	5508	16	0	5604
20669	32	5415	50	11	0	5508
20670	27	57	5480	6	0	5570
20671	10	37	60	5321	0	5428
20672	16	10	5281	48	0	5355
20673	17	3	5215	12	0	5247
20674	10	5186	47	12	0	5255
20675	5135	44	15	7	0	5201
20676	5240	7	8	17	0	5272
20677	59	5290	4	11	0	5364
20678	20	5250	11	7	0	5288
20679	19	53	5099	7	0	5178
20680	10	18	4998	6	0	5032
20681	17	9	5155	6	0	5187
20682	17	6	54	5159	0	5236
20683	9	8	5191	52	0	5260
20684	10	8	50	5076	0	5144
20685	13	4	16	5032	0	5065
20686	14	5	5124	56	0	5199
20687	8	5121	50	17	0	5196
20688	15	44	16	5127	0	5202
20689	5121	20	11	49	0	5201
20690	55	9	6	5132	0	5202
20691	24	11	5152	54	0	5241
20692	10	5121	56	17	0	5204
20693	13	5377	15	16	0	5421
20694	16	63	14	5279	0	5372
20695	5230	17	11	64	0	5322
20696	5200	10	9	20	0	5239
20697	63	7	8	5167	0	5245
20698	26	5340	5	54	0	5425
20699	18	60	6	5418	0	5502
20700	20	18	2	5607	0	5647
20701	14	10	10	5631	0	5665
20702	5893	11	7	93	0	6004
20703	82	5988	9	27	0	6106
20704	6033	78	9	26	0	6146
20705	6182	26	8	25	0	6241
20706	6182	11	9	23	0	6225
20707	6363	10	9	21	0	6403
20708	124	17	4	6281	0	6426
20709	51	8	6304	90	0	6453
20710	29	6339	80	38	0	6486
20711	6383	94	34	27	0	6538
20712	6493	27	14	32	0	6566
20713	6578	18	8	29	0	6633
20714	132	15	6433	19	0	6599
20715	6398	10	91	15	0	6514
20716	6518	9	30	15	0	6572
20717	148	15	8	6440	0	6611
20718	49	11	6169	96	0	6325
20719	32	6122	86	38	0	6278
20720	32	101	29	6020	0	6182
20721	5923	28	24	105	0	6080
20722	111	11	8	5915	0	6045
20723	46	7	9	6106	0	6168
20724	6256	9	9	129	0	6403
20725	112	10	6201	37	0	6360
20726	6283	7	90	20	0	6400
20727	6284	4	36	19	0	6343
20728	6314	8	15	16	0	6353
20729	6321	7	11	12	0	6351
20730	150	12	6140	8	0	6310
20731	62	11	97	6084	0	6254
20732	34	6	6132	108	0	6280
20733	36	18	100	6035	0	6189
20734	21	8	6042	113	0	6184
20735	5597	9	103	46	0	5755
20736	110	5510	37	27	0	5684
20737	42	5681	17	17	0	5757
20738	45	108	15	5901	0	6069
20739	36	37	15	6106	0	6194
20740	28	6219	14	121	0	6382
20741	6240	112	7	47	0	6406
20742	6539	40	10	32	0	6621
20743	6859	16	7	24	0	6906
20744	7280	9	13	18	0	7320
20745	197	11	11	7278	0	7497
20746	97	9	13	7559	0	7678
20747	7665	11	14	198	0	7888
20748	177	9	8	7654	0	7848
20749	91	8	7479	174	0	7752
20750	52	13	7541	82	0	7688
20751	49	11	188	7601	0	7849
20752	40	7	7610	165	0	7822
20753	7554	4	172	92	0	7822
20754	179	16	81	7587	0	7863
20755	7639	6	46	185	0	7876
20756	187	8	7698	86	0	7979
20757	101	10	159	7710	0	7980
20758	67	2	7715	167	0	7951
20759	46	7683	178	91	0	7998
20760	7578	153	90	70	0	7891
20761	7681	56	47	39	0	7823
20762	228	7528	32	40	0	7828
20763	7530	148	38	30	0	7746
20764	208	73	25	7429	0	7735
20765	115	31	21	7530	0	7697
20766	7428	17	23	209	0	7677
20767	194	7284	20	100	0	7598
20768	103	7393	21	63	0	7580
20769	71	198	18	7284	0	7571
20770	7247	84	25	175	0	7531
20771	7376	48	16	92	0	7532
20772	7384	30	22	47	0	7483
20773	257	32	7149	35	0	7473
20774	126	27	7172	38	0	7363
20775	84	7137	197	32	0	7450
20776	7088	160	77	40	0	7365
20777	209	76	40	6961	0	7286
20778	7024	37	34	163	0	7258
20779	7075	26	23	88	0	7212
20780	271	30	21	6877	0	7199
20781	142	24	6887	169	0	7222
20782	6947	20	149	102	0	7218
20783	224	19	68	6937	0	7248
20784	125	17	6929	186	0	7257
20785	6932	16	160	110	0	7218
20786	7014	9	92	63	0	7178
20787	257	13	65	6848	0	7183
20788	128	10	6830	196	0	7164
20789	95	15	174	6708	0	6992
20790	81	6827	87	185	0	7180
20791	79	141	6846	105	0	7171
20792	69	6915	161	78	0	7223
20793	6761	165	89	49	0	7064
20794	6874	73	53	59	0	7059
20795	6898	41	51	55	0	7045
20796	6892	32	41	40	0	7005
20797	295	32	35	6633	0	6995
20798	6572	22	33	167	0	6794
20799	237	24	25	6421	0	6707
20800	6277	18	25	195	0	6515
20801	216	6113	33	113	0	6475
20802	119	140	22	5733	0	6014
20803	84	5763	17	150	0	6014
20804	5747	145	30	83	0	6005
20805	5707	69	30	61	0	5867
20806	197	5592	17	50	0	5856
20807	123	121	24	5452	0	5720
20808	85	62	5406	135	0	5688
20809	80	53	114	5358	0	5605
20810	75	27	5340	141	0	5583
20811	54	41	134	4986	0	5215
20812	52	5108	68	138	0	5366
20813	5075	106	50	77	0	5308
20814	5141	63	27	63	0	5294
20815	181	41	29	5069	0	5320
20816	5267	26	19	133	0	5445
20817	163	34	18	5232	0	5447
20818	111	26	19	5272	0	5428
20819	82	20	20	5315	0	5437
20820	5222	18	17	193	0	5450
20821	5275	12	20	115	0	5422
20822	5281	19	21	71	0	5392
20823	187	5033	15	65	0	5300
20824	4887	98	21	50	0	5056
20825	157	4794	12	46	0	5009
20826	4837	108	19	36	0	5000
20827	169	55	22	4729	0	4975
20828	93	37	23	4796	0	4949
20829	4711	28	20	138	0	4897
20830	4757	29	18	79	0	4883
20831	167	4636	17	60	0	4880
20832	4658	91	12	46	0	4807
20833	155	41	9	4532	0	4737
20834	110	24	11	4596	0	4741
20835	4557	22	5	144	0	4728
20836	139	23	4487	73	0	4722
20837	85	4353	81	48	0	4567
20838	66	91	33	4013	0	4203
20839	44	39	3758	84	0	3925
20840	58	116	66	3516	0	3756
20841	3554	13	42	77	0	3686
20842	79	3298	18	62	0	3457
20843	41	2997	12	36	0	3086
20844	27	2676	15	18	0	2736
20845	77	104	59	2301	0	2541
20846	2228	18	67	58	0	2371
20847	30	3	2	2168	0	2203
20848	2140	3	2	31	0	2176
20849	2153	2	2	13	0	2170
20850	30	3	1	2142	0	2176
20851	2112	2	2	28	0	2144
20852	30	6	2	2130	0	2168
20853	11	2	2146	27	0	2186
20854	2148	4	23	11	0	2186
20855	31	1	2406	9	0	2447
20856	2308	2	22	11	0	2343
20857	32	1	2321	7	0	2361
20858	13	0	14	2196	0	2223
20859	6	1	4	2245	0	2256
20860	2294	2	2	21	0	2319
20861	21	1	4	2361	0	2387
20862	2391	1	2	22	0	2416
20863	15	2421	3	9	0	2448
20864	2496	17	1	11	0	2525
20865	19	4	0	2548	0	2571
20866	9	2	1	2557	0	2569
20867	6	2	4	2562	0	2574
20868	11	2	2	2544	0	2559
20869	5	4	2521	24	0	2554
20870	7	2	2445	6	0	2460
20871	6	2	18	2518	0	2544
20872	2	0	2550	24	0	2576
20873	2	2533	13	13	0	2561
20874	6	14	3	2550	0	2573
20875	4	3	2612	19	0	2638
20876	6	2	2595	7	0	2610
20877	4	6	21	2690	0	2721
20878	5	1	5	2721	0	2732
20879	2	2735	2	24	0	2763
20880	1	18	2	2778	0	2799
20881	0	3	2812	27	0	2842
20882	2758	0	22	13	0	2793
20883	23	2	9	2865	0	2899
20884	2919	1	5	27	0	2952
20885	2948	3	3	14	0	2968
20886	3015	3	4	15	0	3037
20887	22	3	3046	6	0	3077
20888	13	1	3002	5	0	3021
20889	2871	0	32	9	0	2912
20890	23	1	3055	5	0	3084
20891	11	0	21	2900	0	2932
20892	10	1	8	2954	0	2973
20893	4	7	2983	25	0	3019
20894	4	2958	23	11	0	2996
20895	2955	21	11	7	0	2994
20896	24	2963	7	2	0	2996
20897	6	3088	3	8	0	3105
20898	3084	24	6	11	0	3125
20899	25	6	3146	4	0	3181
20900	12	5	3166	8	0	3191
20901	8	2	27	3144	0	3181
20902	3189	3	10	20	0	3222
20903	23	3213	5	8	0	3249
20904	3244	19	10	3	0	3276
20905	23	5	3364	7	0	3399
20906	9	3579	26	8	0	3622
20907	8	27	13	3682	0	3730
20908	9	11	3709	26	0	3755
20909	12	6	28	3738	0	3784
20910	20	7	18	3255	0	3300
20911	9	7	4	3762	0	3782
20912	10	5	4	3777	0	3796
20913	3743	3	7	41	0	3794
20914	3702	3	9	21	0	3735
20915	39	1	3770	14	0	3824
20916	3596	3	30	13	0	3642
20917	34	3643	13	14	0	3704
20918	3655	26	7	14	0	3702
20919	37	12	3712	9	0	3770
20920	23	17	28	3658	0	3726
20921	6	5	3710	35	0	3756
20922	12	2	3700	18	0	3732
20923	13	9	36	3665	0	3723
20924	11	5	17	3699	0	3732
20925	6	1	3681	45	0	3733
20926	6	3600	35	25	0	3666
20927	9	3664	14	17	0	3704
20928	11	34	11	3702	0	3758
20929	3668	11	8	39	0	3726
20930	32	3833	7	20	0	3892
20931	16	32	3846	9	0	3903
20932	14	12	3720	9	0	3755
20933	10	13	3808	7	0	3838
20934	8	8	42	3764	0	3822
20935	3818	4	23	31	0	3876
20936	32	3762	15	19	0	3828
20937	13	34	3755	16	0	3818
20938	9	3763	35	15	0	3822
20939	15	31	27	3825	0	3898
20940	10	20	3821	31	0	3882
20941	9	3868	34	18	0	3929
20942	8	32	18	3852	0	3910
20943	11	16	12	3922	0	3961
20944	9	16	3952	40	0	4017
20945	13	8	35	3881	0	3937
20946	11	3903	24	39	0	3977
20947	8	35	3921	22	0	3986
20948	3863	18	32	20	0	3933
20949	39	7	19	3961	0	4026
20950	19	7	20	3941	0	3987
20951	13	3967	12	40	0	4032
20952	3923	29	12	27	0	3991
20953	31	14	3875	11	0	3931
20954	3794	15	26	17	0	3852
20955	36	23	12	3670	0	3741
20956	14	3689	17	20	0	3740
20957	10	24	10	3708	0	3752
20958	8	16	6	3804	0	3834
20959	3761	5	15	34	0	3815
20960	3785	2	11	22	0	3820
20961	30	11	4	3794	0	3839
20962	15	3	3746	29	0	3793
20963	3499	8	30	18	0	3555
20964	23	3718	16	14	0	3771
20965	19	25	10	3735	0	3789
20966	13	7	12	3820	0	3852
20967	14	11	6	3838	0	3869
20968	4	13	3804	40	0	3861
20969	11	7	29	3754	0	3801
20970	4	3798	27	35	0	3864
20971	10	28	11	3765	0	3814
20972	6	3790	12	25	0	3833
20973	10	32	8	3773	0	3823
20974	3	17	3757	37	0	3814
20975	3514	9	24	20	0	3567
20976	24	7	13	3727	0	3771
20977	11	7	3689	30	0	3737
20978	6	3680	28	18	0	3732
20979	3659	23	10	24	0	3716
20980	27	13	3635	11	0	3686
20981	3561	14	31	17	0	3623
20982	26	15	13	3664	0	3718
20983	16	4	9	3649	0	3678
20984	6	3641	12	23	0	3682
20985	3611	18	10	18	0	3657
20986	3530	6	5	14	0	3555
20987	20	3663	3	14	0	3700
20988	9	24	9	3717	0	3759
20989	7	13	6	3722	0	3748
20990	11	5	5	3700	0	3721
20991	6	4	3669	31	0	3710
20992	3569	5	27	21	0	3622
20993	22	6	7	3661	0	3696
20994	8	10	5	3669	0	3692
20995	8	5	3613	30	0	3656
20996	10	6	3530	17	0	3563
20997	14	9	24	3637	0	3684
20998	7	1	3705	30	0	3743
20999	3565	5	27	23	0	3620
21000	23	6	10	3687	0	3726
21001	12	4	9	3734	0	3759
21002	8	10	3876	28	0	3922
21003	10	13	23	3907	0	3953
21004	6	0	3916	37	0	3959
21005	9	3789	25	12	0	3835
21006	3524	25	20	27	0	3596
21007	3510	3	7	11	0	3531
21008	20	3498	6	6	0	3530
21009	8	19	6	3604	0	3637
21010	4	4	3656	19	0	3683
21011	6	7	17	3645	0	3675
21012	3657	0	7	26	0	3690
21013	16	3672	6	9	0	3703
21014	3705	17	6	9	0	3737
21015	21	7	2	3679	0	3709
21016	3673	4	3	21	0	3701
21017	21	3651	1	7	0	3680
21018	3670	18	3	16	0	3707
21019	18	7	3598	5	0	3628
21020	5	3669	17	7	0	3698
21021	6	20	5	3679	0	3710
21022	3835	3	2	22	0	3862
21023	3858	4	3	8	0	3873
21024	26	2	0	3877	0	3905
21025	3911	0	3	32	0	3946
21026	3905	6	4	8	0	3923
21027	3979	2	1	16	0	3998
21028	28	1	4	3992	0	4025
21029	12	6	4031	22	0	4071
21030	6	2	3789	8	0	3805
21031	2	5	3889	8	0	3904
21032	3944	3	23	7	0	3977
21033	25	1	5	4008	0	4039
21034	6	4076	4	29	0	4115
21035	6	22	1	4079	0	4108
21036	7	4191	3	22	0	4223
21037	4278	24	2	11	0	4315
21038	29	7	1	4303	0	4340
21039	10	0	3	4395	0	4408
21040	4458	3	4	35	0	4500
21041	29	2	4	4457	0	4492
21042	9	2	2	4537	0	4550
21043	4610	3	2	34	0	4649
21044	33	3	4699	7	0	4742
21045	8	1	32	4702	0	4743
21046	10	4	4695	35	0	4744
21047	4664	3	32	11	0	4710
21048	39	1	6	4754	0	4800
21049	4739	0	3	45	0	4787
21050	39	3	2	4794	0	4838
21051	7	2	4947	42	0	4998
21052	13	2	32	5045	0	5092
21053	5194	0	7	44	0	5245
21054	38	5244	7	12	0	5301
21055	11	37	5213	8	0	5269
21056	5041	5	37	9	0	5092
21057	44	5180	11	6	0	5241
21058	9	5224	3	5	0	5241
21059	9	5600	1	5	0	5615
21060	13	49	5	5954	0	6021
21061	6051	7	17	62	0	6137
21062	6305	1	5	20	0	6331
21063	77	5	6285	6	0	6373
21064	6164	4	60	12	0	6240
21065	70	6191	10	5	0	6276
21066	27	61	5	6293	0	6386
21067	6512	12	4	63	0	6591
21068	6567	9	3	21	0	6600
21069	6607	6	6	12	0	6631
21070	6577	5	6	15	0	6603
21071	6631	4	7	8	0	6650
21072	94	5	1	6561	0	6661
21073	24	6	6572	76	0	6678
21074	27	8	60	6627	0	6722
21075	30	5	10	6727	0	6772
21076	6682	4	8	85	0	6779
21077	91	6565	7	16	0	6679
21078	6665	65	3	21	0	6754
21079	6786	13	9	26	0	6834
21080	6940	10	12	24	0	6986
21081	6943	4	11	32	0	6990
21082	106	3	6784	23	0	6916
21083	6799	7	65	22	0	6893
21084	6938	6	18	22	0	6984
21085	6022	14	20	47	0	6103
21086	6927	7	7	17	0	6958
21087	109	6	6	6728	0	6849
21088	44	6	6598	81	0	6729
21089	6593	2	70	24	0	6689
21090	103	6694	23	18	0	6838
21091	53	70	16	6595	0	6734
21092	46	6782	9	79	0	6916
21093	48	69	8	6880	0	7005
21094	6937	12	12	93	0	7054
21095	6937	14	15	30	0	6996
21096	6962	11	14	32	0	7019
21097	119	10	6604	17	0	6750
21098	6599	16	56	27	0	6698
21099	103	19	6526	16	0	6664
21100	45	18	6458	19	0	6540
21101	52	13	6560	22	0	6647
21102	56	27	75	6219	0	6377
21103	45	12	27	6479	0	6563
21104	48	9	16	6460	0	6533
21105	49	8	16	6431	0	6504
21106	49	8	19	6202	0	6278
21107	44	6	17	6413	0	6480
21108	30	6420	21	91	0	6562
21109	6318	65	17	43	0	6443
21110	82	6368	19	38	0	6507
21111	36	75	10	6468	0	6589
21112	37	13	10	6550	0	6610
21113	6446	16	10	99	0	6571
21114	86	6425	16	51	0	6578
21115	6479	66	13	42	0	6600
21116	102	25	10	6446	0	6583
21117	51	15	14	6493	0	6573
21118	41	18	21	6481	0	6561
21119	40	16	6369	98	0	6523
21120	43	18	67	6312	0	6440
21121	36	19	6249	92	0	6396
21122	45	14	6046	39	0	6144
21123	54	9	6394	37	0	6494
21124	49	21	73	6464	0	6607
21125	38	8	35	6613	0	6694
21126	50	12	16	6659	0	6737
21127	6694	18	17	118	0	6847
21128	99	20	21	6873	0	7013
21129	6976	12	23	130	0	7141
21130	119	6977	23	42	0	7161
21131	7347	88	15	54	0	7504
21132	7640	22	14	54	0	7730
21133	139	7781	17	46	0	7983
21134	7826	103	13	57	0	7999
21135	7879	22	19	48	0	7968
21136	7991	18	25	45	0	8079
21137	7960	16	19	46	0	8041
21138	162	14	7773	38	0	7987
21139	71	7681	99	36	0	7887
21140	63	116	25	7533	0	7737
21141	7604	22	22	116	0	7764
21142	137	18	7595	43	0	7793
21143	57	7464	105	32	0	7658
21144	69	94	24	7173	0	7360
21145	64	7350	24	96	0	7534
21146	52	120	15	7365	0	7552
21147	54	39	15	7462	0	7570
21148	52	28	7410	127	0	7617
21149	71	19	7306	41	0	7437
21150	7074	28	109	44	0	7255
21151	128	22	7242	29	0	7421
21152	51	24	7186	27	0	7288
21153	60	30	114	7019	0	7223
21154	47	24	31	6963	0	7065
21155	39	6938	36	113	0	7126
21156	35	7399	38	52	0	7524
21157	59	113	7426	42	0	7640
21158	50	90	127	7547	0	7814
21159	39	29	7373	117	0	7558
21160	19	17	6803	31	0	6870
21161	25	6732	117	30	0	6904
21162	37	96	49	6435	0	6617
21163	6500	23	26	96	0	6645
21164	87	15	20	6527	0	6649
21165	6546	10	18	104	0	6678
21166	6504	9	18	35	0	6566
21167	6452	6	16	37	0	6511
21168	110	16	6373	12	0	6511
21169	6348	10	86	31	0	6475
21170	110	11	25	6479	0	6625
21171	6497	5	20	104	0	6626
21172	6544	7	17	40	0	6608
21173	106	6427	18	20	0	6571
21174	6430	83	12	21	0	6546
21175	107	18	6420	14	0	6559
21176	6320	16	83	15	0	6434
21177	6356	9	27	22	0	6414
21178	107	6345	16	17	0	6485
21179	6310	80	14	22	0	6426
21180	112	24	10	6067	0	6213
21181	47	20	10	6059	0	6136
21182	34	6040	15	91	0	6180
21183	32	80	13	6099	0	6224
21184	28	22	10	6172	0	6232
21185	23	19	6089	103	0	6234
21186	21	22	6029	33	0	6105
21187	5957	13	94	40	0	6104
21188	6112	6	33	30	0	6181
21189	117	12	21	6070	0	6220
21190	53	12	6042	90	0	6197
21191	38	6011	91	34	0	6174
21192	41	81	28	5975	0	6125
21193	23	24	6020	100	0	6167
21194	5910	20	92	45	0	6067
21195	106	15	33	6179	0	6333
21196	36	6280	24	108	0	6448
21197	39	94	13	6350	0	6496
21198	26	30	26	6443	0	6525
21199	32	21	18	6484	0	6555
21200	6348	16	20	137	0	6521
21201	120	10	19	6306	0	6455
21202	6344	9	13	132	0	6498
21203	6435	13	16	53	0	6517
21204	142	12	6333	35	0	6522
21205	53	6375	101	36	0	6565
21206	40	99	35	5988	0	6162
21207	35	6655	22	87	0	6799
21208	6755	114	19	52	0	6940
21209	124	40	16	6762	0	6942
21210	52	22	6724	121	0	6919
21211	33	19	6654	48	0	6754
21212	36	19	6711	34	0	6800
21213	6657	9	133	41	0	6840
21214	117	6730	47	34	0	6928
21215	6722	106	31	31	0	6890
21216	135	6816	27	29	0	7007
21217	61	122	20	6803	0	7006
21218	52	38	19	6800	0	6909
21219	34	6869	20	125	0	7048
21220	35	116	6865	57	0	7073
21221	26	6926	119	52	0	7123
21222	6807	127	32	39	0	7005
21223	135	44	27	6565	0	6771
21224	39	31	6452	120	0	6642
21225	38	24	6472	49	0	6583
21226	51	43	125	6401	0	6620
21227	27	19	6258	115	0	6419
21228	32	26	6001	38	0	6097
21229	5667	24	113	36	0	5840
21230	96	5728	46	31	0	5901
21231	5415	85	33	28	0	5561
21232	103	33	5430	17	0	5583
21233	41	5127	96	26	0	5290
21234	28	5195	39	20	0	5282
21235	48	122	65	5089	0	5324
21236	22	31	23	5241	0	5317
21237	15	25	14	5357	0	5411
21238	22	15	5286	111	0	5434
21239	24	10	90	5310	0	5434
21240	18	21	34	5424	0	5497
21241	5361	16	22	116	0	5515
21242	91	5285	19	49	0	5444
21243	35	87	17	5417	0	5556
21244	5410	29	14	119	0	5572
21245	5428	27	10	45	0	5510
21246	118	22	20	5378	0	5538
21247	41	19	5397	122	0	5579
21248	27	10	99	5418	0	5554
21249	19	14	5412	126	0	5571
21250	5482	18	108	47	0	5655
21251	5879	6	35	52	0	5972
21252	149	29	27	6044	0	6249
21253	53	9	6190	131	0	6383
21254	34	6570	119	52	0	6775
21255	24	135	6791	25	0	6975
21256	28	91	131	6224	0	6474
21257	22	6474	47	117	0	6660
21258	6210	115	22	33	0	6380
21259	133	27	17	6070	0	6247
21260	30	6153	19	118	0	6320
21261	6308	116	21	37	0	6482
21262	122	33	13	6257	0	6425
21263	32	6274	18	117	0	6441
21264	30	124	8	6344	0	6506
21265	20	35	6284	130	0	6469
21266	6115	19	112	37	0	6283
21267	6256	20	27	33	0	6336
21268	133	18	6104	20	0	6275
21269	38	6084	115	17	0	6254
21270	6119	116	31	28	0	6294
21271	125	31	21	6085	0	6262
21272	44	15	15	6089	0	6163
21273	27	14	18	6236	0	6295
21274	34	10	14	6242	0	6300
21275	27	13	16	6244	0	6300
21276	6129	12	15	153	0	6309
21277	6229	10	10	55	0	6304
21278	140	11	13	6141	0	6305
21279	43	12	13	6244	0	6312
21280	24	9	6108	144	0	6285
21281	21	11	6085	53	0	6170
21282	6002	10	124	38	0	6174
21283	129	11	28	6094	0	6262
21284	42	12	6057	121	0	6232
21285	26	10	112	6071	0	6219
21286	6136	5	36	142	0	6319
21287	6341	9	22	53	0	6425
21288	140	10	20	6262	0	6432
21289	42	3	23	6356	0	6424
21290	6371	8	15	152	0	6546
21291	135	10	21	6363	0	6529
21292	46	6409	20	126	0	6601
21293	37	109	11	6432	0	6589
21294	51	37	12	6458	0	6558
21295	39	14	6327	141	0	6521
21296	32	10	6141	63	0	6246
21297	27	6284	108	47	0	6466
21298	6216	111	30	48	0	6405
21299	6197	32	20	39	0	6288
21300	6238	20	9	38	0	6305
21301	126	6056	17	38	0	6237
21302	38	6260	21	35	0	6354
21303	6160	110	24	27	0	6321
21304	108	6312	13	29	0	6462
21305	32	103	6186	27	0	6348
21306	34	6266	95	25	0	6420
21307	36	102	6100	18	0	6256
21308	5896	34	100	31	0	6061
21309	6107	20	33	21	0	6181
21310	104	6117	16	23	0	6260
21311	6262	91	15	24	0	6392
21312	6635	27	9	28	0	6699
21313	6733	21	13	27	0	6794
21314	136	16	18	6700	0	6870
21315	6778	13	17	103	0	6911
21316	128	18	6590	40	0	6776
21317	6665	21	86	34	0	6806
21318	124	16	38	6833	0	7011
21319	59	18	6739	105	0	6921
21320	53	10	6767	44	0	6874
21321	44	17	111	6880	0	7052
21322	32	12	49	6992	0	7085
21323	6995	16	26	137	0	7174
21324	116	10	21	6986	0	7133
21325	54	9	6974	123	0	7160
21326	44	7	99	6849	0	6999
21327	28	7127	41	114	0	7310
21328	7242	84	22	64	0	7412
21329	103	32	17	7291	0	7443
21330	57	19	7213	102	0	7391
21331	34	7119	87	60	0	7300
21332	7012	77	41	42	0	7172
21333	94	35	22	7170	0	7321
21334	46	21	7155	92	0	7314
21335	32	7076	87	42	0	7237
21336	7036	89	43	44	0	7212
21337	6986	29	22	32	0	7069
21338	7023	21	14	27	0	7085
21339	120	3	13	6952	0	7088
21340	59	14	12	7021	0	7106
21341	6940	9	18	106	0	7073
21342	79	6895	9	54	0	7037
21343	6972	56	12	42	0	7082
21344	85	28	16	6947	0	7076
21345	7128	16	18	73	0	7235
21346	90	20	9	7141	0	7260
21347	57	11	6	7127	0	7201
21348	44	6	8	7162	0	7220
21349	50	17	9	7130	0	7206
21350	25	18	6835	101	0	6979
21351	32	13	6354	48	0	6447
21352	5929	7	41	35	0	6012
21353	40	5	6332	21	0	6398
21354	22	12	5654	18	0	5706
21355	5519	17	47	20	0	5603
21356	5617	3	51	15	0	5686
21357	35	10	10	5997	0	6052
21358	6073	1	19	30	0	6123
21359	26	6198	10	18	0	6252
21360	6331	12	10	25	0	6378
21361	6238	14	7	18	0	6277
21362	6429	7	6	16	0	6458
21363	41	8	7	6396	0	6452
21364	25	6248	8	26	0	6307
21365	24	6329	3	17	0	6373
21366	6411	19	8	18	0	6456
21367	6445	17	5	17	0	6484
21368	31	10	12	6431	0	6484
21369	27	8	5	6389	0	6429
21370	18	6385	7	27	0	6437
21371	6364	13	1	26	0	6404
21372	26	16	6392	16	0	6450
21373	24	9	12	6333	0	6378
21374	23	10	12	6426	0	6471
21375	15	9	6473	27	0	6524
21376	21	4	10	6408	0	6443
21377	31	4673	29	31	0	4764
21378	15	18	10	6550	0	6593
21379	13	17	9	6497	0	6536
21380	13	5944	11	26	0	5994
21381	12	6539	5	37	0	6593
21382	10	29	8	6597	0	6644
21383	6623	19	5	38	0	6685
21384	15	13	7	6626	0	6661
21385	25	6	7	6663	0	6701
21386	22	6663	5	34	0	6724
21387	7	17	6	6831	0	6861
21388	9	18	5	6776	0	6808
21389	11	10	3	6809	0	6833
21390	6698	7	8	48	0	6761
21391	19	4	3	6721	0	6747
21392	24	5	2	6660	0	6691
21393	17	7	5	6685	0	6714
21394	11	5	6520	42	0	6578
21395	5850	7	14	47	0	5918
21396	19	6444	13	21	0	6497
21397	6534	11	6	23	0	6574
21398	26	12	5	6542	0	6585
21399	20	10	6482	19	0	6531
21400	6045	4	13	35	0	6097
21401	23	9	7366	11	0	7409
21402	31	3	21	7418	0	7473
21403	7625	4	18	43	0	7690
21404	7465	4	11	27	0	7507
21405	7685	3	4	26	0	7718
21406	42	7	4	7684	0	7737
21407	30	4	1	7741	0	7776
21408	21	2	6	7759	0	7788
21409	11	7394	7	40	0	7452
21410	12	7351	1	27	0	7391
21411	13	7248	8	23	0	7292
21412	8	7179	2	9	0	7198
21413	15	13	2	7337	0	7367
21414	5	3	5	7361	0	7374
21415	7270	0	2	24	0	7296
21416	7166	3	1	18	0	7188
21417	7274	2	0	17	0	7293
21418	16	2	0	7261	0	7279
21419	8	4	0	7299	0	7311
21420	7184	3	0	24	0	7211
21421	7043	4	0	24	0	7071
21422	17	2	7017	5	0	7041
21423	7	1	6685	6	0	6699
21424	1	4	6880	4	0	6889
21425	4	4	7228	2	0	7238
21426	6	1	12	7246	0	7265
21427	7192	1	4	19	0	7216
21428	12	7170	2	12	0	7196
21429	14	13	5	7407	0	7439
21430	8	4	7526	11	0	7549
21431	3	7773	10	10	0	7796
21432	3	7	6	7982	0	7998
21433	1	7	7870	17	0	7895
21434	7	1	9	7743	0	7760
21435	5	5	6	7803	0	7819
21436	7874	1	0	30	0	7905
21437	15	1	1	7936	0	7953
21438	3	3	7983	12	0	8001
21439	7	2	9	7922	0	7940
21440	1	8429	10	14	0	8454
21441	4	10	2	8746	0	8762
21442	7	4	0	8787	0	8798
21443	8	3	2	8717	0	8730
21444	8843	0	0	29	0	8872
21445	8799	1	1	28	0	8829
21446	8883	1	1	26	0	8911
21447	8910	2	0	28	0	8940
21448	12	5	8827	3	0	8847
21449	8628	0	13	17	0	8658
21450	8891	4	3	9	0	8907
21451	17	2	8800	6	0	8825
21452	17	5	8999	3	0	9024
21453	8	6	7	9070	0	9091
21454	3	9112	4	8	0	9127
21455	9380	5	1	14	0	9400
21456	9561	2	3	30	0	9596
21457	9432	0	0	17	0	9449
21458	9	1	1	9348	0	9359
21459	5	9423	5	6	0	9439
21460	9738	5	2	22	0	9767
21461	9795	4	4	14	0	9817
21462	15	1	4	9724	0	9744
21463	6	1	9620	5	0	9632
21464	9625	4	7	14	0	9650
21465	12	0	7	9915	0	9934
21466	10025	1	1	27	0	10054
21467	9	4	3	10117	0	10133
21468	6	3	10102	8	0	10119
21469	10483	1	7	28	0	10519
21470	13	3	3	10707	0	10726
21471	18	2	2	10706	0	10728
21472	3	0	2	10734	0	10739
21473	3	0	1	10723	0	10727
21474	10806	1	0	35	0	10842
21475	10	1	1	10797	0	10809
21476	7	10842	2	7	0	10858
21477	4	13	2	11106	0	11125
21478	3	11142	6	23	0	11174
21479	5	19	2	11338	0	11364
21480	8	4	0	11409	0	11421
21481	5	11278	1	23	0	11307
21482	4	13	1	11464	0	11482
21483	8	6	2	11469	0	11485
21484	11442	1	1	42	0	11486
21485	21	1	11640	12	0	11674
21486	17	2	25	11747	0	11791
21487	11810	0	9	59	0	11878
21488	11800	2	2	35	0	11839
21489	11854	2	0	25	0	11881
21490	51	2	11938	5	0	11996
21491	17	10	12033	8	0	12068
21492	20	17	55	12413	0	12505
21493	12632	2	17	73	0	12724
21494	57	6	12464	21	0	12548
21495	12214	1	55	38	0	12308
21496	59	12737	20	9	0	12825
21497	31	50	10	13387	0	13478
21498	21	18	3	13611	0	13653
21499	13682	5	5	93	0	13785
21500	61	3	5	13774	0	13843
21501	13013	4	1	82	0	13100
21502	13070	2	6	48	0	13126
21503	78	2	6	12994	0	13080
21504	32	4	5	13033	0	13074
21505	12910	1	1	108	0	13020
21506	64	7	13325	30	0	13426
21507	13153	2	56	53	0	13264
21508	74	5	13760	9	0	13848
21509	13851	3	53	41	0	13948
21510	14439	2	16	47	0	14504
21511	14214	6	6	53	0	14279
21512	14099	2	6	36	0	14143
21513	88	14058	9	11	0	14166
21514	14384	57	12	30	0	14483
21515	14389	17	5	39	0	14450
21516	84	14790	13	14	0	14901
21517	14924	57	5	39	0	15025
21518	80	22	14717	12	0	14831
21519	14806	7	63	28	0	14904
21520	83	11	14973	10	0	15077
21521	46	8	65	15068	0	15187
21522	32	4	19	15223	0	15278
21523	20	3	15100	82	0	15205
21524	27	3	66	15204	0	15300
21525	217	62	128	9582	0	9989
21526	16020	2	13	113	0	16148
21527	96	5	8	16168	0	16277
21528	49	10	8	16129	0	16196
21529	34	2	9	16142	0	16187
21530	17	15813	16	112	0	15958
21531	33	79	7	15797	0	15916
21532	15878	28	11	121	0	16038
21533	105	10	16111	46	0	16272
21534	67	4	97	16389	0	16557
21535	24	16	16418	121	0	16579
21536	16344	7	108	78	0	16537
21537	136	5	41	17308	0	17490
21538	62	15	21050	149	0	21276
21539	56	6	285	21415	0	21762
21540	60	4	244	21342	0	21650
21541	24	21597	192	555	0	22368
21542	58	301	111	22618	0	23088
21543	60	251	37	24226	0	24574
21544	36	206	23768	788	0	24798
21545	60	112	387	24060	0	24619
21546	62	39	302	24432	0	24835
21547	23670	17	229	860	0	24776
21548	23738	21	137	625	0	24521
21549	642	23696	85	440	0	24863
21550	24315	382	59	296	0	25052
21551	24443	291	74	264	0	25072
21552	824	24859	116	200	0	25999
21553	617	509	73	24917	0	26116
21554	25178	337	35	628	0	26178
21555	25215	252	46	461	0	25974
21556	24710	180	44	390	0	25324
21557	1003	24101	62	268	0	25434
21558	769	474	24528	173	0	25944
21559	25191	349	417	184	0	26141
21560	25329	330	297	215	0	26171
21561	900	25243	234	198	0	26575
21562	25706	509	147	198	0	26560
21563	26273	364	92	179	0	26908
21564	1127	305	75	25540	0	27047
21565	774	245	25628	551	0	27198
21566	613	149	504	26173	0	27439
21567	491	112	368	26353	0	27324
21568	400	110	249	26654	0	27413
21569	310	153	25496	1060	0	27019
21570	356	131	522	25341	0	26350
21571	355	85	343	26148	0	26931
21572	282	89	286	26352	0	27009
21573	269	72	239	26413	0	26993
21574	271	67	119	26354	0	26811
21575	190	25452	97	1400	0	27139
21576	216	493	103	26196	0	27008
21577	196	338	145	26630	0	27309
21578	143	278	25546	1195	0	27162
21579	187	156	490	27410	0	28243
21580	171	101	365	27951	0	28588
21581	175	86	280	28934	0	29475
21582	184	83	209	29465	0	29941
21583	28389	121	137	1640	0	30287
21584	668	109	114	29538	0	30429
21585	518	91	95	29547	0	30251
21586	395	134	27823	1434	0	29786
21587	268	26749	585	1157	0	28759
21588	182	28201	433	930	0	29746
21589	27630	790	383	775	0	29578
21590	601	27938	253	667	0	29459
21591	545	855	159	27588	0	29147
21592	27353	555	128	1119	0	29155
21593	743	406	27166	929	0	29244
21594	559	289	628	27620	0	29096
21595	446	27477	490	1047	0	29460
21596	351	695	352	27208	0	28606
21597	249	27226	235	1305	0	29015
21598	314	904	135	27765	0	29118
21599	27192	632	106	1263	0	29193
21600	800	489	27406	922	0	29617
21601	655	354	664	26872	0	28545
21602	508	27481	484	1072	0	29545
21603	27493	763	402	797	0	29455
21604	825	562	27205	711	0	29303
21605	625	518	649	27304	0	29096
21606	558	360	26626	1018	0	28562
21607	544	223	896	26746	0	28409
21608	377	207	26307	1194	0	28085
21609	293	220	986	26217	0	27716
21610	275	243	633	26568	0	27719
21611	25567	183	507	1439	0	27696
21612	26056	192	396	1039	0	27683
21613	1128	212	281	25511	0	27132
21614	868	25183	249	1131	0	27431
21615	676	702	212	25837	0	27427
21616	428	480	237	25902	0	27047
21617	24561	380	220	1579	0	26740
21618	760	24639	222	1236	0	26857
21619	24764	709	192	991	0	26656
21620	24892	553	173	759	0	26377
21621	1174	23627	168	705	0	25674
21622	823	24695	168	667	0	26353
21623	24347	976	197	735	0	26255
21624	964	657	23601	811	0	26033
21625	23759	498	684	705	0	25646
21626	23816	378	462	650	0	25306
21627	1352	22994	393	564	0	25303
21628	1064	738	270	21113	0	23185
21629	727	22964	271	973	0	24935
21630	22700	1019	267	779	0	24765
21631	23095	730	262	657	0	24744
21632	1226	596	242	22398	0	24462
21633	1014	467	200	22574	0	24255
21634	21799	340	147	1348	0	23634
21635	1026	21229	154	1161	0	23570
21636	817	20699	153	949	0	22618
21637	704	20541	195	643	0	22083
21638	351	16003	124	402	0	16880
21639	297	16246	121	383	0	17047
21640	459	867	196	15108	0	16630
21641	239	399	14584	706	0	15928
21642	274	14416	345	429	0	15464
21643	12855	448	164	289	0	13756
21644	453	279	153	12610	0	13495
21645	12566	215	108	438	0	13327
21646	444	12507	103	268	0	13322
21647	12504	378	127	246	0	13255
21648	469	12525	150	196	0	13340
21649	313	403	172	12456	0	13344
21650	12472	208	151	411	0	13242
21651	12601	195	157	320	0	13273
21652	456	157	144	12493	0	13250
21653	314	156	121	12459	0	13050
21654	274	12174	87	553	0	13088
21655	302	363	80	12342	0	13087
21656	285	212	50	12520	0	13067
21657	261	255	47	12322	0	12885
21658	206	11713	56	631	0	12606
21659	10979	307	38	432	0	11756
21660	352	11009	47	321	0	11729
21661	10695	366	44	226	0	11331
21662	427	10679	56	195	0	11357
21663	344	374	10224	162	0	11104
21664	296	277	257	10076	0	10906
21665	199	232	9881	318	0	10630
21666	215	193	9754	170	0	10332
21667	220	176	345	9638	0	10379
21668	216	136	9671	299	0	10322
21669	245	137	312	9538	0	10232
21670	247	122	200	9607	0	10176
21671	196	133	141	9791	0	10261
21672	9558	152	91	465	0	10266
21673	361	155	71	9645	0	10232
21674	294	137	41	9648	0	10120
21675	9213	91	45	458	0	9807
21676	359	8956	25	365	0	9705
21677	293	8437	24	289	0	9043
21678	272	8611	19	195	0	9097
21679	193	662	58	6753	0	7666
21680	122	136	6775	221	0	7254
21681	5647	175	158	142	0	6122
21682	138	5663	63	92	0	5956
21683	5253	124	33	80	0	5490
21684	5186	86	19	34	0	5325
21685	5198	81	16	34	0	5329
21686	179	62	5103	35	0	5379
21687	108	61	81	5121	0	5371
21688	85	50	54	5198	0	5387
21689	99	42	32	5233	0	5406
21690	80	36	30	5129	0	5275
21691	66	4968	34	154	0	5222
21692	5008	103	22	79	0	5212
21693	108	75	4682	53	0	4918
21694	4443	36	86	47	0	4612
21695	113	133	39	4217	0	4502
21696	70	4181	10	108	0	4369
21697	67	4289	7	64	0	4427
21698	90	301	22	3672	0	4085
21699	38	3798	11	109	0	3956
21700	3184	30	9	47	0	3270
21701	42	22	3086	14	0	3164
21702	19	20	28	2874	0	2941
21703	8	8	11	2924	0	2951
21704	10	5	2	2946	0	2963
21705	10	7	4	2934	0	2955
21706	2913	5	7	37	0	2962
21707	23	2993	5	23	0	3044
21708	3287	23	2	10	0	3322
21709	30	18	3	3384	0	3435
21710	24	5	2	3529	0	3560
21711	9	3656	1	47	0	3713
21712	3769	30	5	25	0	3829
21713	3901	20	6	12	0	3939
21714	56	3888	2	13	0	3959
21715	25	34	2	3648	0	3709
21716	5	3767	1	39	0	3812
21717	3773	31	5	22	0	3831
21718	41	24	3771	11	0	3847
21719	27	11	3616	5	0	3659
21720	3518	6	50	11	0	3585
21721	34	3594	18	24	0	3670
21722	28	31	6	3622	0	3687
21723	15	21	6	3631	0	3673
21724	6	6	3664	54	0	3730
21725	8	5	29	3660	0	3702
21726	10	8	24	3652	0	3694
21727	9	3578	7	76	0	3670
21728	7	34	5	3632	0	3678
21729	13	23	9	3609	0	3654
21730	3566	6	5	63	0	3640
21731	31	3487	6	32	0	3556
21732	20	3539	6	15	0	3580
21733	7	46	6	3563	0	3622
21734	5	23	7	3591	0	3626
21735	12	8	5	3583	0	3608
21736	6	3540	5	57	0	3608
21737	8	34	3	3579	0	3624
21738	14	17	4	3550	0	3585
21739	8	8	2	3583	0	3601
21740	11	6	3	3556	0	3576
21741	2	3454	4	61	0	3521
21742	8	3620	2	39	0	3669
21743	3543	46	0	23	0	3612
21744	3571	23	7	16	0	3617
21745	52	9	1	3554	0	3616
21746	24	11	3591	41	0	3667
21747	16	10	35	3589	0	3650
21748	13	7	14	3573	0	3607
21749	3488	8	3	65	0	3564
21750	41	3575	3	26	0	3645
21751	30	39	4	3594	0	3667
21752	17	22	2	3646	0	3687
21753	13	10	3578	57	0	3658
21754	10	12	3593	26	0	3641
21755	5	15	48	3585	0	3653
21756	11	4	21	3554	0	3590
21757	9	3526	9	56	0	3600
21758	4	3589	12	28	0	3633
21759	3576	49	7	21	0	3653
21760	43	23	3	3615	0	3684
21761	20	7	3682	49	0	3758
21762	7	3655	36	26	0	3724
21763	10	36	18	3708	0	3772
21764	3703	17	6	50	0	3776
21765	33	10	4	3747	0	3794
21766	3652	12	6	54	0	3724
21767	41	3689	6	28	0	3764
21768	3644	39	1	27	0	3711
21769	49	20	4	3708	0	3781
21770	21	17	3875	48	0	3961
21771	10	15	40	3874	0	3939
21772	8	4007	15	51	0	4081
21773	11	51	8	4043	0	4113
21774	11	4226	9	57	0	4303
21775	10	60	7	4337	0	4414
21776	14	24	4242	68	0	4348
21777	7	16	4156	48	0	4227
21778	5	8	4290	30	0	4333
21779	4203	9	67	30	0	4309
21780	54	4227	29	19	0	4329
21781	25	4329	14	19	0	4387
21782	4259	74	9	19	0	4361
21783	4295	29	11	23	0	4358
21784	74	15	11	4301	0	4401
21785	32	9	4291	70	0	4402
21786	15	11	4170	32	0	4228
21787	20	11	70	4189	0	4290
21788	4163	12	22	75	0	4272
21789	60	4169	13	37	0	4279
21790	29	62	12	4211	0	4314
21791	4165	26	11	77	0	4279
21792	4179	14	13	46	0	4252
21793	69	8	4143	30	0	4250
21794	4036	9	52	39	0	4136
21795	65	15	4208	23	0	4311
21796	35	11	4236	22	0	4304
21797	23	18	66	4144	0	4251
21798	28	11	25	4162	0	4226
21799	16	10	15	4237	0	4278
21800	10	8	4152	90	0	4260
21801	4130	11	56	45	0	4242
21802	65	10	20	4300	0	4395
21803	4262	8	12	77	0	4359
21804	4274	19	7	45	0	4345
21805	79	4289	11	29	0	4408
21806	36	4412	13	24	0	4485
21807	19	4386	15	22	0	4442
21808	31	93	16	4005	0	4145
21809	16	26	3978	52	0	4072
21810	12	115	44	3665	0	3836
21811	10	3703	14	57	0	3784
21812	8	3704	10	21	0	3743
21813	16	52	9	3599	0	3676
21814	3508	15	7	56	0	3586
21815	50	3472	8	17	0	3547
21816	12	3523	5	17	0	3557
21817	3600	50	15	11	0	3676
21818	58	13	4	3603	0	3678
21819	14	13	1	3634	0	3662
21820	16	10	3	3689	0	3718
21821	3603	9	5	64	0	3681
21822	3639	3	8	24	0	3674
21823	58	3	5	3631	0	3697
21824	19	6	3540	56	0	3621
21825	3533	4	50	16	0	3603
21826	53	7	10	3609	0	3679
21827	13	4	3605	58	0	3680
21828	13	7	3582	15	0	3617
21829	12	8	55	3696	0	3771
21830	9	5	3871	63	0	3948
21831	15	7	51	4092	0	4165
21832	22	10	23	3996	0	4051
21833	16	9	14	4423	0	4462
21834	4408	5	12	89	0	4514
21835	68	7	7	4440	0	4522
21836	24	10	8	4487	0	4529
21837	13	13	6	4491	0	4523
21838	14	8	10	4500	0	4532
21839	14	7	4363	93	0	4477
21840	10	4352	56	45	0	4463
21841	7	58	22	4282	0	4369
21842	10	21	17	4229	0	4277
21843	10	4131	8	74	0	4223
21844	10	4281	10	30	0	4331
21845	4220	70	15	30	0	4335
21846	64	4152	8	23	0	4247
21847	25	59	9	4141	0	4234
21848	20	25	4166	69	0	4280
21849	4049	13	56	35	0	4153
21850	64	11	4076	25	0	4176
21851	4008	8	60	22	0	4098
21852	4070	6	20	25	0	4121
21853	81	2	4100	17	0	4200
21854	31	7	60	3957	0	4055
21855	19	3975	18	74	0	4086
21856	16	53	24	4239	0	4332
21857	4356	18	12	79	0	4465
21858	4455	15	9	42	0	4521
21859	73	4408	11	34	0	4526
21860	4471	64	11	26	0	4572
21861	86	16	7	4362	0	4471
21862	4357	11	7	85	0	4460
21863	4433	17	10	34	0	4494
21864	83	11	8	4388	0	4490
21865	4397	10	6	86	0	4499
21866	4325	8	14	41	0	4388
21867	69	8	4348	43	0	4468
21868	4262	10	67	37	0	4376
21869	79	20	4279	21	0	4399
21870	23	11	4091	19	0	4144
21871	21	4145	63	25	0	4254
21872	20	56	24	3941	0	4041
21873	15	14	3987	56	0	4072
21874	20	10	3839	19	0	3888
21875	3905	7	52	23	0	3987
21876	45	16	17	3939	0	4017
21877	24	9	10	4009	0	4052
21878	13	6	7	4057	0	4083
21879	17	12	8	4043	0	4080
21880	21	9	6	4078	0	4114
21881	11	6	4039	66	0	4122
21882	17	14	3995	21	0	4047
21883	20	6	52	4039	0	4117
21884	4001	5	21	62	0	4089
21885	61	3960	9	22	0	4052
21886	26	46	9	3971	0	4052
21887	3975	12	10	57	0	4054
21888	60	3980	6	24	0	4070
21889	21	42	8	4030	0	4101
21890	18	10	13	4054	0	4095
21891	26	10	8	4053	0	4097
21892	4028	7	10	69	0	4114
21893	56	7	3977	33	0	4073
21894	3971	7	52	27	0	4057
21895	56	7	15	3999	0	4077
21896	27	5	13	3908	0	3953
21897	16	3946	16	70	0	4048
21898	17	40	3918	32	0	4007
21899	3927	13	45	29	0	4014
21900	4018	8	21	30	0	4077
21901	63	8	3982	24	0	4077
21902	3832	6	48	26	0	3912
21903	47	3945	22	29	0	4043
21904	35	3981	11	19	0	4046
21905	14	3997	15	18	0	4044
21906	3848	53	14	28	0	3943
21907	55	30	3881	14	0	3980
21908	31	55	46	3744	0	3876
21909	20	3718	23	51	0	3812
21910	18	3785	9	24	0	3836
21911	14	3757	11	21	0	3803
21912	41	79	17	2950	0	3087
21913	3585	15	9	43	0	3652
21914	41	3628	7	27	0	3703
21915	28	30	8	3657	0	3723
21916	14	14	8	3684	0	3720
21917	3573	6	11	51	0	3641
21918	46	5	7	3568	0	3626
21919	19	12	8	3624	0	3663
21920	16	5	3598	53	0	3672
21921	13	11	34	3580	0	3638
21922	15	6	14	3680	0	3715
21923	3641	4	11	51	0	3707
21924	3630	4	11	26	0	3671
21925	53	6	4	3646	0	3709
21926	3505	6	6	54	0	3571
21927	3605	5	5	27	0	3642
21928	49	3598	5	12	0	3664
21929	21	32	3524	14	0	3591
21930	16	3362	32	17	0	3427
21931	42	100	18	3058	0	3218
21932	2954	5	27	23	0	3009
21933	21	2929	3	11	0	2964
21934	10	17	4	2929	0	2960
21935	2898	8	4	29	0	2939
21936	2888	1	3	16	0	2908
21937	25	1	2	2890	0	2918
21938	8	6	2963	19	0	2996
21939	10	0	15	2999	0	3024
21940	8	3	4	3054	0	3069
21941	3	1	3044	29	0	3077
21942	10	2	12	3013	0	3037
21943	2	5	12	3038	0	3057
21944	3134	2	4	23	0	3163
21945	16	1	3	3172	0	3192
21946	10	1	2	3169	0	3182
21947	3116	7	2	24	0	3149
21948	3059	3	3	13	0	3078
21949	3059	5	0	9	0	3073
21950	23	4	3043	6	0	3076
21951	11	5	20	3029	0	3065
21952	10	3060	6	12	0	3088
21953	7	16	3	3133	0	3159
21954	6	12	3160	15	0	3193
21955	8	12	14	3004	0	3038
21956	8	4	3038	21	0	3071
21957	2835	8	27	14	0	2884
21958	2860	0	4	10	0	2874
21959	14	1	2	2927	0	2944
21960	4	1	3	2892	0	2900
21961	5	1	0	2870	0	2876
21962	4	2943	2	15	0	2964
21963	2930	11	0	8	0	2949
21964	2972	4	2	9	0	2987
21965	16	0	1	2947	0	2964
21966	4	2	2	2917	0	2925
21967	4	1	1	2923	0	2929
21968	6	2	1	2925	0	2934
21969	2	1	2902	18	0	2923
21970	0	1	14	2892	0	2907
21971	2829	0	4	22	0	2855
21972	2823	2	1	9	0	2835
21973	17	1	1	2766	0	2785
21974	6	2	2707	14	0	2729
21975	2615	0	9	14	0	2638
21976	16	3	4	2728	0	2751
21977	6	2681	2	15	0	2704
21978	2	2757	2	5	0	2766
21979	2807	11	6	9	0	2833
21980	17	3	1	2858	0	2879
21981	5	1	2	2886	0	2894
21982	5	1	0	3046	0	3052
21983	1	0	1	3098	0	3100
21984	4	0	2	3307	0	3313
21985	2	0	3342	26	0	3370
21986	3	0	3287	14	0	3304
21987	6	1	3337	8	0	3352
21988	5	1	31	3325	0	3362
21989	7	1	3384	32	0	3424
21990	2	0	35	3388	0	3425
21991	5	2	10	3389	0	3406
21992	0	3	8	3499	0	3510
21993	3552	1	9	48	0	3610
21994	26	1	7	3610	0	3644
21995	6	3	8	3695	0	3712
21996	3641	0	6	49	0	3696
21997	34	3683	6	20	0	3743
21998	4	3810	3	18	0	3835
21999	3834	32	2	19	0	3887
22000	34	3937	3	17	0	3991
22001	3905	35	3	19	0	3962
22002	3933	9	2	18	0	3962
22003	3924	7	3	13	0	3947
22004	3883	9	1	11	0	3904
22005	3910	4	2	10	0	3926
22006	44	3909	2	6	0	3961
22007	3888	33	4	10	0	3935
22008	3937	10	3	11	0	3961
22009	45	4030	7	11	0	4093
22010	4309	35	3	9	0	4356
22011	4396	10	4	12	0	4422
22012	4759	10	3	13	0	4785
22013	4980	8	5	11	0	5004
22014	95	10	5272	4	0	5381
22015	52	11	59	5682	0	5804
22016	38	5	22	5850	0	5915
22017	24	10	5775	106	0	5915
22018	27	7	5677	45	0	5756
22019	5744	8	101	36	0	5889
22020	106	7	45	5851	0	6009
22021	47	7	5905	93	0	6052
22022	36	10	5835	36	0	5917
22023	5844	8	113	34	0	5999
22024	5969	6	53	30	0	6058
22025	5988	3	31	20	0	6042
22026	135	18	5977	16	0	6146
22027	73	3	91	6009	0	6176
22028	56	2	6023	89	0	6170
22029	5972	2	100	45	0	6119
22030	113	4	6093	32	0	6242
22031	58	3	112	6034	0	6207
22032	57	5	55	6028	0	6145
22033	28	6109	40	118	0	6295
22034	6214	84	35	61	0	6394
22035	115	27	6200	36	0	6378
22036	6218	20	117	27	0	6382
22037	135	13	6412	30	0	6590
22038	76	6	125	6294	0	6501
22039	47	11	64	6385	0	6507
22040	59	6	48	6394	0	6507
22041	6320	6	44	148	0	6518
22042	141	7	32	6237	0	6417
22043	79	7	29	6361	0	6476
22044	53	6158	28	163	0	6402
22045	44	87	37	6267	0	6435
22046	6200	30	30	151	0	6411
22047	138	19	6171	58	0	6386
22048	75	15	113	6167	0	6370
22049	57	16	6157	141	0	6371
22050	45	6063	129	82	0	6319
22051	35	96	6161	71	0	6363
22052	6104	39	147	62	0	6352
22053	6219	26	71	42	0	6358
22054	159	11	71	6099	0	6340
22055	6165	9	57	137	0	6368
22056	6191	13	46	77	0	6327
22057	166	15	45	6191	0	6417
22058	104	8	46	6302	0	6460
22059	86	11	6179	154	0	6430
22060	75	6148	120	88	0	6431
22061	6207	98	56	70	0	6431
22062	146	6096	52	61	0	6355
22063	87	116	43	6092	0	6338
22064	78	38	41	6152	0	6309
22065	82	27	46	6155	0	6310
22066	56	26	46	6172	0	6300
22067	42	16	6016	197	0	6271
22068	5878	28	131	108	0	6145
22069	6110	23	61	78	0	6272
22070	174	16	53	6040	0	6283
22071	6070	14	38	158	0	6280
22072	167	15	35	6104	0	6321
22073	84	20	6048	165	0	6317
22074	87	17	113	6001	0	6218
22075	63	6012	63	171	0	6309
22076	59	97	45	5969	0	6170
22077	56	6024	44	159	0	6283
22078	50	122	34	5849	0	6055
22079	45	5913	33	171	0	6162
22080	5803	121	30	101	0	6055
22081	131	59	5795	83	0	6068
22082	62	5490	110	90	0	5752
22083	54	5607	60	74	0	5795
22084	93	114	69	5300	0	5576
22085	58	47	36	5283	0	5424
22086	55	28	45	5272	0	5400
22087	46	20	43	5346	0	5455
22088	46	5236	31	168	0	5481
22089	46	86	34	5229	0	5395
22090	53	41	25	5258	0	5377
22091	5145	31	29	146	0	5351
22092	124	26	21	5212	0	5383
22093	65	24	5083	150	0	5322
22094	46	30	4949	93	0	5118
22095	4792	20	105	82	0	4999
22096	98	4926	50	54	0	5128
22097	55	4945	36	59	0	5095
22098	61	102	39	4800	0	5002
22099	43	50	26	4836	0	4955
22100	29	40	4646	141	0	4856
22101	4525	35	79	88	0	4727
22102	4702	32	32	83	0	4849
22103	104	20	4785	78	0	4987
22104	56	12	4663	69	0	4800
22105	4744	21	103	64	0	4932
22106	4912	17	47	68	0	5044
22107	4919	25	38	44	0	5026
22108	4862	16	20	60	0	4958
22109	129	4607	24	56	0	4816
22110	4375	67	23	41	0	4506
22111	102	28	4213	45	0	4388
22112	45	21	3802	27	0	3895
22113	34	19	3832	25	0	3910
22114	68	261	120	3013	0	3462
22115	2933	3	54	26	0	3016
22116	2919	2	8	5	0	2934
22117	30	2	1	2939	0	2972
22118	11	3	3	2823	0	2840
22119	6	3	3	2978	0	2990
22120	3	3109	3	25	0	3140
22121	3117	21	2	13	0	3153
22122	3140	5	3	13	0	3161
22123	3145	4	2	14	0	3165
22124	3121	3	3	12	0	3139
22125	3147	1	0	7	0	3155
22126	31	1	2	3022	0	3056
22127	7	2989	4	26	0	3026
22128	12	19	5	2876	0	2912
22129	7	7	4	2961	0	2979
22130	2911	4	0	25	0	2940
22131	25	1	2851	11	0	2888
22132	7	2	2765	7	0	2781
22133	10	4	2804	1	0	2819
22134	2935	1	14	6	0	2956
22135	3004	0	13	5	0	3022
22136	14	8	4	3075	0	3101
22137	10	1	1	2994	0	3006
22138	6	1	1	3101	0	3109
22139	1	1	3120	17	0	3139
22140	8	1	9	3072	0	3090
22141	1	1	3292	14	0	3308
22142	4	1	12	3289	0	3306
22143	4	0	5	3287	0	3296
22144	4	1	3	3366	0	3374
22145	3359	0	3	20	0	3382
22146	3394	0	2	14	0	3410
22147	18	6	3432	5	0	3461
22148	3422	0	10	6	0	3438
22149	3483	2	6	7	0	3498
22150	16	0	3	3497	0	3516
22151	3586	1	1	16	0	3604
22152	16	0	2	3627	0	3645
22153	8	0	1	3657	0	3666
22154	5	0	3616	16	0	3637
22155	3483	0	10	12	0	3505
22156	14	1	6	3644	0	3665
22157	5	1	3706	13	0	3725
22158	7	3	3798	8	0	3816
22159	9	1	12	3769	0	3791
22160	3	0	10	3811	0	3824
22161	3880	0	4	18	0	3902
22162	12	1	2	3916	0	3931
22163	7	0	1	3909	0	3917
22164	8	0	2	3956	0	3966
22165	4	2	2	4139	0	4147
22166	4297	0	2	29	0	4328
22167	4309	0	7	22	0	4338
22168	4452	0	3	15	0	4470
22169	4530	0	2	13	0	4545
22170	36	0	3	4724	0	4763
22171	4800	0	5	36	0	4841
22172	35	2	2	4795	0	4834
22173	4820	0	2	39	0	4861
22174	46	2	1	4811	0	4860
22175	24	0	2	4806	0	4832
22176	10	4807	4	39	0	4860
22177	10	28	4	4830	0	4872
22178	4815	12	2	39	0	4868
22179	4771	4	0	24	0	4799
22180	50	1	4806	10	0	4867
22181	23	4820	30	6	0	4879
22182	4842	27	17	18	0	4904
22183	32	4910	6	9	0	4957
22184	4909	31	9	13	0	4962
22185	36	5080	4	6	0	5126
22186	16	32	5134	9	0	5191
22187	7	5056	31	94	0	5188
22188	7	5151	14	12	0	5184
22189	7	39	4	5289	0	5339
22190	5369	17	2	49	0	5437
22191	37	5	1	5411	0	5454
22192	28	1	4	5416	0	5449
22193	5348	3	3	58	0	5412
22194	5438	2	3	32	0	5475
22195	55	4	3	5460	0	5522
22196	31	2	2	5455	0	5490
22197	19	3	2	5441	0	5465
22198	5372	4	1	62	0	5439
22199	40	5	5382	22	0	5449
22200	26	4	31	5384	0	5445
22201	15	3	5490	39	0	5547
22202	11	5375	35	29	0	5450
22203	12	32	5327	16	0	5387
22204	12	17	36	5288	0	5353
22205	10	7	5308	41	0	5366
22206	5143	3	35	35	0	5216
22207	42	3	17	5309	0	5371
22208	25	5433	12	39	0	5509
22209	15	32	6	5470	0	5523
22210	8	5440	3	46	0	5497
22211	9	5415	6	20	0	5450
22212	10	5465	8	14	0	5497
22213	11	51	4	5214	0	5280
22214	10	5278	5	45	0	5338
22215	5227	35	3	28	0	5293
22216	45	18	5166	11	0	5240
22217	22	8	4991	16	0	5037
22218	16	6	5165	10	0	5197
22219	13	4	42	5250	0	5309
22220	22	2	12	5047	0	5083
22221	21	5	2	5053	0	5081
22222	17	3	5	5093	0	5118
22223	15	9	0	4985	0	5009
22224	17	5147	4	58	0	5226
22225	23	40	5101	26	0	5190
22226	20	17	4991	17	0	5045
22227	9	5192	45	19	0	5265
22228	7	41	21	5247	0	5316
22229	20	18	8	5291	0	5337
22230	16	10	3	5268	0	5297
22231	5195	6	7	62	0	5270
22232	41	10	5159	37	0	5247
22233	5073	6	38	22	0	5139
22234	5107	13	18	27	0	5165
22235	55	5052	11	20	0	5138
22236	23	5101	5	19	0	5148
22237	5168	56	7	28	0	5259
22238	49	26	6	5173	0	5254
22239	31	13	5	5334	0	5383
22240	21	6	5474	63	0	5564
22241	15	13	5362	24	0	5414
22242	17	8	62	5499	0	5586
22243	5621	15	24	63	0	5723
22244	55	16	5901	28	0	6000
22245	6080	15	57	32	0	6184
22246	75	10	27	6292	0	6404
22247	28	7	16	6607	0	6658
22248	19	13	13	6789	0	6834
22249	12	14	6779	107	0	6912
22250	17	6612	77	39	0	6745
22251	17	6937	23	30	0	7007
22252	6961	90	14	39	0	7104
22253	7175	26	12	27	0	7240
22254	113	15	8	7191	0	7327
22255	7239	6	14	101	0	7360
22256	100	12	7142	41	0	7295
22257	27	11	7066	30	0	7134
22258	33	11	100	6934	0	7078
22259	7077	8	38	105	0	7228
22260	96	8	19	7126	0	7249
22261	39	9	20	7318	0	7386
22262	7258	10	20	121	0	7409
22263	7418	9	20	50	0	7497
22264	110	7670	13	41	0	7834
22265	7718	88	17	38	0	7861
22266	116	57	15	7604	0	7792
22267	32	7703	18	110	0	7863
22268	7675	95	17	44	0	7831
22269	110	7709	10	40	0	7869
22270	38	115	22	7575	0	7750
22271	7545	20	10	107	0	7682
22272	101	16	7461	36	0	7614
22273	36	15	7416	32	0	7499
22274	43	29	99	7387	0	7558
22275	30	17	27	7509	0	7583
22276	31	15	21	7375	0	7442
22277	23	7535	12	107	0	7677
22278	7793	96	12	47	0	7948
22279	7828	22	15	40	0	7905
22280	7882	27	10	36	0	7955
22281	136	8152	18	37	0	8343
22282	61	112	12	8844	0	9029
22283	53	36	12	8924	0	9025
22284	49	23	12	8992	0	9076
22285	8656	21	14	174	0	8865
22286	134	8592	17	67	0	8810
22287	64	116	10	8646	0	8836
22288	37	33	16	8732	0	8818
22289	38	18	8470	175	0	8701
22290	23	8421	113	74	0	8631
22291	46	129	31	8420	0	8626
22292	39	39	16	8529	0	8623
22293	43	25	13	8497	0	8578
22294	8205	32	10	182	0	8429
22295	142	8233	14	87	0	8476
22296	8335	128	13	66	0	8542
22297	150	43	11	8341	0	8545
22298	8351	29	9	168	0	8557
22299	145	37	8260	72	0	8514
22300	8299	18	118	79	0	8514
22301	8457	26	33	56	0	8572
22302	166	28	8393	50	0	8637
22303	71	27	125	8444	0	8667
22304	69	17	36	8347	0	8469
22305	8633	22	34	183	0	8872
22306	157	28	19	8680	0	8884
22307	81	22	18	8663	0	8784
22308	55	23	19	8707	0	8804
22309	52	21	8467	190	0	8730
22310	8202	20	127	100	0	8449
22311	162	8617	35	67	0	8881
22312	74	119	30	8556	0	8779
22313	57	8518	26	164	0	8765
22314	49	8857	25	86	0	9017
22315	50	151	27	8915	0	9143
22316	41	57	8858	191	0	9147
22317	44	42	8914	95	0	9095
22318	50	31	143	8976	0	9200
22319	52	27	8950	195	0	9224
22320	8933	34	149	93	0	9209
22321	166	25	52	9167	0	9410
22322	57	31	35	9302	0	9425
22323	52	9227	40	211	0	9530
22324	52	135	31	9241	0	9459
22325	46	51	28	9216	0	9341
22326	49	9080	24	212	0	9365
22327	47	149	28	9244	0	9468
22328	49	38	29	9246	0	9362
22329	44	9147	28	207	0	9426
22330	9170	142	34	107	0	9453
22331	169	46	9114	89	0	9418
22332	61	42	9004	85	0	9192
22333	70	62	147	9025	0	9304
22334	52	39	52	9176	0	9319
22335	48	30	9032	212	0	9322
22336	45	33	8837	107	0	9022
22337	8426	46	141	90	0	8703
22338	130	8781	63	92	0	9066
22339	8688	133	47	77	0	8945
22340	138	41	8690	85	0	8954
22341	59	8674	132	67	0	8932
22342	54	183	52	8778	0	9067
22343	33	41	8864	182	0	9120
22344	40	40	8532	73	0	8685
22345	47	109	145	8554	0	8855
22346	49	22	8527	160	0	8758
22347	24	8266	131	64	0	8485
22348	35	131	59	8121	0	8346
22349	24	42	8212	147	0	8425
22350	26	8238	130	59	0	8453
22351	8095	125	51	50	0	8321
22352	123	41	8045	48	0	8257
22353	40	7990	125	48	0	8203
22354	45	128	59	7872	0	8104
22355	34	42	36	8130	0	8242
22356	8038	32	40	164	0	8274
22357	120	32	27	8027	0	8206
22358	54	17	24	8048	0	8143
22359	7875	23	39	170	0	8107
22360	125	35	26	7873	0	8059
22361	46	21	7616	156	0	7839
22362	33	54	120	7571	0	7778
22363	33	16	7517	145	0	7711
22364	26	12	7067	77	0	7182
22365	22	18	7124	49	0	7213
22366	53	41	145	6740	0	6979
22367	25	9	81	6916	0	7031
22368	6848	7	39	143	0	7037
22369	87	15	30	6692	0	6824
22370	51	6862	22	123	0	7058
22371	31	85	37	7084	0	7237
22372	23	44	33	7028	0	7128
22373	13	7013	24	142	0	7192
22374	6979	88	34	90	0	7191
22375	6941	34	21	58	0	7054
22376	112	6828	29	54	0	7023
22377	36	6709	24	38	0	6807
22378	63	249	26	6431	0	6769
22379	6566	49	44	107	0	6766
22380	87	30	6546	54	0	6717
22381	41	27	5962	45	0	6075
22382	5381	19	58	24	0	5482
22383	54	5593	34	20	0	5701
22384	26	67	19	5605	0	5717
22385	23	26	11	5494	0	5554
22386	21	20	7	5642	0	5690
22387	17	8	17	5691	0	5733
22388	13	5622	18	82	0	5735
22389	24	51	12	5720	0	5807
22390	5717	28	13	74	0	5832
22391	56	21	6	5783	0	5866
22392	24	11	9	5822	0	5866
22393	5838	10	7	97	0	5952
22394	5859	7	8	59	0	5933
22395	5935	10	8	38	0	5991
22396	5944	9	10	41	0	6004
22397	96	12	7	5871	0	5986
22398	5892	9	6	82	0	5989
22399	79	8	10	5848	0	5945
22400	5786	3	12	87	0	5888
22401	5771	5	15	43	0	5834
22402	91	8	9	5755	0	5863
22403	49	9	5835	75	0	5968
22404	5856	4	54	48	0	5962
22405	5925	8	20	40	0	5993
22406	5926	9	9	36	0	5980
22407	6005	4	9	34	0	6052
22408	107	12	7	5993	0	6119
22409	49	12	5975	73	0	6109
22410	40	3	5838	34	0	5915
22411	5859	9	70	33	0	5971
22412	5985	7	26	26	0	6044
22413	87	5879	22	13	0	6001
22414	49	5846	8	23	0	5926
22415	5942	64	12	23	0	6041
22416	64	26	15	5834	0	5939
22417	39	16	19	5982	0	6056
22418	5938	6	15	83	0	6042
22419	61	6018	12	37	0	6128
22420	6129	53	7	40	0	6229
22421	71	32	5990	15	0	6108
22422	5991	19	52	25	0	6087
22423	75	8	23	6017	0	6123
22424	32	5	6141	72	0	6250
22425	32	6149	55	33	0	6269
22426	33	61	21	6236	0	6351
22427	26	23	6507	67	0	6623
22428	26	15	66	6463	0	6570
22429	6704	8	29	90	0	6831
22430	72	4	6695	41	0	6812
22431	6531	6	66	38	0	6641
22432	85	6781	30	25	0	6921
22433	42	62	21	6900	0	7025
22434	29	33	7235	63	0	7360
22435	31	17	66	7239	0	7353
22436	24	7	7338	82	0	7451
22437	22	7234	71	47	0	7374
22438	7175	57	40	39	0	7311
22439	65	7344	24	14	0	7447
22440	40	70	11	7221	0	7342
22441	27	39	17	7204	0	7287
22442	25	20	6961	91	0	7097
22443	6113	11	61	67	0	6252
22444	61	6646	32	27	0	6766
22445	38	6379	13	16	0	6446
22446	16	6444	8	16	0	6484
22447	34	114	19	6178	0	6345
22448	11	6232	12	52	0	6307
22449	14	59	12	6102	0	6187
22450	8	6091	14	44	0	6157
22451	8	52	6	6004	0	6070
22452	7	6139	2	35	0	6183
22453	6103	40	6	19	0	6168
22454	36	23	6080	9	0	6148
22455	5858	14	42	16	0	5930
22456	6075	5	11	17	0	6108
22457	6194	6	8	15	0	6223
22458	47	6194	7	7	0	6255
22459	6269	33	7	12	0	6321
22460	6275	12	3	15	0	6305
22461	6419	11	4	8	0	6442
22462	51	7	6351	4	0	6413
22463	23	6	29	6494	0	6552
22464	15	4	6654	35	0	6708
22465	14	7	35	6545	0	6601
22466	6581	2	15	54	0	6652
22467	38	6626	8	16	0	6688
22468	21	37	7186	13	0	7257
22469	28	19	47	7232	0	7326
22470	13	11	17	7607	0	7648
22471	9	6	8247	76	0	8338
22472	8236	5	82	38	0	8361
22473	8614	6	26	24	0	8670
22474	8826	4	16	16	0	8862
22475	137	2	12	8822	0	8973
22476	62	8564	10	96	0	8732
22477	30	9035	7	37	0	9109
22478	35	118	8	9000	0	9161
22479	23	46	10	8959	0	9038
22480	15	8918	5	136	0	9074
22481	8900	109	9	54	0	9072
22482	99	8895	8	46	0	9048
22483	48	111	9	8768	0	8936
22484	29	50	8709	108	0	8896
22485	33	28	96	8635	0	8792
22486	8715	25	33	123	0	8896
22487	103	25	8690	51	0	8869
22488	8732	16	99	43	0	8890
22489	8930	10	46	46	0	9032
22490	9043	15	23	34	0	9115
22491	9054	11	20	25	0	9110
22492	9290	13	9	24	0	9336
22493	174	12	9039	15	0	9240
22494	82	10	8994	13	0	9099
22495	9731	10	123	26	0	9890
22496	10088	8	51	20	0	10167
22497	178	12	32	10510	0	10732
22498	80	10663	27	146	0	10916
22499	71	137	19	10890	0	11117
22500	11147	47	16	177	0	11387
22501	188	34	12	10848	0	11082
22502	78	11172	13	173	0	11436
22503	11150	151	11	93	0	11405
22504	11052	52	11	65	0	11180
22505	11070	37	15	56	0	11178
22506	221	10868	18	38	0	11145
22507	120	152	11	10879	0	11162
22508	105	54	10	10782	0	10951
22509	66	10461	11	194	0	10732
22510	59	165	11	10720	0	10955
22511	10620	62	6	217	0	10905
22512	10700	49	8	101	0	10858
22513	218	10505	15	72	0	10810
22514	104	166	6	10576	0	10852
22515	99	60	9	10606	0	10774
22516	71	48	12	10664	0	10795
22517	10319	37	5	249	0	10610
22518	179	32	10184	122	0	10517
22519	9972	31	146	92	0	10241
22520	204	32	10111	77	0	10424
22521	117	34	159	9855	0	10165
22522	92	9850	72	176	0	10190
22523	70	10224	44	88	0	10426
22524	10009	192	32	78	0	10311
22525	9972	76	34	87	0	10169
22526	218	9750	17	76	0	10061
22527	109	9710	18	63	0	9900
22528	9824	190	36	59	0	10109
22529	10033	83	13	48	0	10177
22530	244	10081	23	39	0	10387
22531	10276	195	15	51	0	10537
22532	253	76	10110	39	0	10478
22533	10186	71	143	46	0	10446
22534	10101	69	47	56	0	10273
22535	273	56	42	9884	0	10255
22536	143	9858	33	182	0	10216
22537	124	175	27	9926	0	10252
22538	10063	65	26	204	0	10358
22539	235	59	28	9825	0	10147
22540	131	69	17	10002	0	10219
22541	120	53	9893	244	0	10310
22542	97	32	153	9989	0	10271
22543	114	46	42	10208	0	10410
22544	10070	43	49	272	0	10434
22545	221	36	9982	136	0	10375
22546	10023	33	183	106	0	10345
22547	223	40	62	10097	0	10422
22548	133	40	48	10157	0	10378
22549	107	43	45	10091	0	10286
22550	96	9769	31	256	0	10152
22551	100	9981	26	150	0	10257
22552	87	190	32	9904	0	10213
22553	9892	76	24	242	0	10234
22554	9961	83	21	121	0	10186
22555	270	68	23	9852	0	10213
22556	9843	52	22	229	0	10146
22557	281	44	15	9750	0	10090
22558	160	47	30	9882	0	10119
22559	9458	26	31	268	0	9783
22560	260	9758	21	133	0	10172
22561	9717	173	26	118	0	10034
22562	9748	73	17	121	0	9959
22563	9571	50	17	89	0	9727
22564	271	9394	14	85	0	9764
22565	153	213	25	9433	0	9824
22566	132	72	27	9590	0	9821
22567	103	59	9214	254	0	9630
22568	91	101	136	8768	0	9096
22569	75	39	8432	240	0	8786
22570	88	7973	144	111	0	8316
22571	62	7181	62	86	0	7391
22572	54	7096	56	77	0	7283
22573	131	139	85	7091	0	7446
22574	54	67	41	7114	0	7276
22575	37	45	13	7044	0	7139
22576	29	38	16	7088	0	7171
22577	29	52	7051	165	0	7297
22578	34	45	8276	101	0	8456
22579	42	30	129	8645	0	8846
22580	53	25	8787	185	0	9050
22581	8824	21	153	98	0	9096
22582	8982	20	50	86	0	9138
22583	167	18	8897	95	0	9177
22584	83	18	155	8994	0	9250
22585	89	20	55	9115	0	9279
22586	79	21	39	9183	0	9322
22587	72	18	45	9078	0	9213
22588	78	20	36	9171	0	9305
22589	6288	90	40	267	0	6685
22590	8927	24	24	138	0	9113
22591	169	8859	21	113	0	9162
22592	78	125	8490	101	0	8794
22593	64	8422	123	82	0	8691
22594	59	8514	51	69	0	8693
22595	7925	127	26	67	0	8145
22596	120	7783	36	35	0	7974
22597	39	7188	22	29	0	7278
22598	7055	115	40	43	0	7253
22599	91	35	6974	23	0	7123
22600	6688	36	74	25	0	6823
22601	100	26	26	6845	0	6997
22602	49	14	15	6678	0	6756
22603	34	21	13	6725	0	6793
22604	24	15	6599	114	0	6752
22605	20	6584	82	57	0	6743
22606	6677	64	27	51	0	6819
22607	87	21	25	6710	0	6843
22608	32	6748	20	105	0	6905
22609	36	84	26	7017	0	7163
22610	25	32	7011	110	0	7178
22611	32	27	84	7114	0	7257
22612	23	33	32	7233	0	7321
22613	35	17	17	7282	0	7351
22614	7226	17	16	154	0	7413
22615	91	24	19	7354	0	7488
22616	39	9	7276	153	0	7477
22617	31	7264	99	76	0	7470
22618	35	86	27	7379	0	7527
22619	35	31	28	7356	0	7450
22620	27	37	7264	148	0	7476
22621	41	25	7049	58	0	7173
22622	7039	28	155	81	0	7303
22623	7013	38	66	81	0	7198
22624	135	7072	71	58	0	7336
22625	7108	89	41	50	0	7288
22626	145	41	7032	46	0	7264
22627	77	24	6847	68	0	7016
22628	6835	36	146	113	0	7130
22629	6708	23	67	114	0	6912
22630	122	15	6510	117	0	6764
22631	6343	19	114	111	0	6587
22632	131	25	6452	88	0	6696
22633	6417	21	104	48	0	6590
22634	6451	45	47	43	0	6586
22635	128	76	48	6110	0	6362
22636	57	6585	57	102	0	6801
22637	4669	155	79	68	0	4971
22638	107	80	6585	45	0	6817
22639	74	6594	98	41	0	6807
22640	6652	153	43	47	0	6895
22641	6441	77	29	67	0	6614
22642	141	6425	55	67	0	6688
22643	91	92	71	6467	0	6721
22644	82	40	6382	146	0	6650
22645	46	32	110	6487	0	6675
22646	47	42	6362	185	0	6636
22647	48	35	121	6429	0	6633
22648	47	44	79	6450	0	6620
22649	55	74	6325	133	0	6587
22650	68	6344	110	108	0	6630
22651	48	109	46	6355	0	6558
22652	56	71	4511	162	0	4800
22653	6297	41	96	113	0	6547
22654	112	30	69	6435	0	6646
22655	68	23	47	6537	0	6675
22656	6417	34	47	194	0	6692
22657	146	29	33	6409	0	6617
22658	103	32	34	6302	0	6471
22659	58	6260	64	162	0	6544
22660	84	110	60	6231	0	6485
22661	48	71	6153	149	0	6421
22662	58	37	104	6056	0	6255
22663	65	5977	61	155	0	6258
22664	53	6035	99	90	0	6277
22665	63	109	74	6026	0	6272
22666	6098	56	46	122	0	6322
22667	156	51	44	6073	0	6324
22668	6094	84	46	117	0	6341
22669	166	37	53	6138	0	6394
22670	6158	32	100	127	0	6417
22671	6308	41	76	77	0	6502
22672	193	35	46	6223	0	6497
22673	149	228	76	5972	0	6425
22674	98	6007	77	143	0	6325
22675	112	6159	58	88	0	6417
22676	95	85	6147	85	0	6412
22677	108	5906	97	91	0	6202
22678	4428	94	103	74	0	4699
22679	87	40	33	4316	0	4476
22680	36	4123	30	61	0	4250
22681	4262	46	20	38	0	4366
22682	65	24	14	4278	0	4381
22683	39	17	22	4162	0	4240
22684	35	20	26	4224	0	4305
22685	29	32	31	4244	0	4336
22686	30	4318	25	64	0	4437
22687	36	4527	27	33	0	4623
22688	4636	53	12	37	0	4738
22689	76	4747	14	29	0	4866
22690	31	51	23	4738	0	4843
22691	32	21	15	4782	0	4850
22692	32	17	11	4788	0	4848
22693	36	13	8	4815	0	4872
22694	4761	21	14	79	0	4875
22695	4823	13	12	53	0	4901
22696	70	17	4767	37	0	4891
22697	43	16	51	4815	0	4925
22698	34	21	4895	66	0	5016
22699	35	19	57	4866	0	4977
22700	25	21	24	4952	0	5022
22701	4971	17	19	87	0	5094
22702	74	13	22	5021	0	5130
22703	26	19	5102	86	0	5233
22704	38	14	4852	51	0	4955
22705	5063	16	69	48	0	5196
22706	59	14	5143	44	0	5260
22707	20	32	54	4994	0	5100
22708	23	13	5121	64	0	5221
22709	17	32	46	4955	0	5050
22710	11	4939	23	64	0	5037
22711	17	47	20	4942	0	5026
22712	14	4897	13	60	0	4984
22713	4	4947	14	35	0	5000
22714	15	71	9	4863	0	4958
22715	4855	18	9	51	0	4933
22716	34	4905	6	34	0	4979
22717	17	43	4	4917	0	4981
22718	4955	15	5	51	0	5026
22719	5012	11	2	36	0	5061
22720	5101	14	5	21	0	5141
22721	53	10	2	5059	0	5124
22722	29	9	5	5105	0	5148
22723	5127	9	5	62	0	5203
22724	5120	8	6	34	0	5168
22725	5192	4	6	32	0	5234
22726	56	9	3	5169	0	5237
22727	29	8	5045	46	0	5128
22728	5059	5	28	33	0	5125
22729	50	8	13	5042	0	5113
22730	24	5096	11	46	0	5177
22731	26	45	15	5064	0	5150
22732	22	5084	7	39	0	5152
22733	21	37	6	5174	0	5238
22734	13	12	5101	54	0	5180
22735	13	5047	31	29	0	5120
22736	16	36	12	4879	0	4943
22737	12	10	9	4877	0	4908
22738	17	10	6	4826	0	4859
22739	4903	5	10	55	0	4973
22740	39	5015	3	26	0	5083
22741	16	42	12	5121	0	5191
22742	5227	19	5	64	0	5315
22743	5261	14	7	32	0	5314
22744	73	9	6	5285	0	5373
22745	24	13	5462	71	0	5570
22746	21	8	50	5402	0	5481
22747	15	5477	18	63	0	5573
22748	16	56	10	5574	0	5656
22749	5517	13	9	81	0	5620
22750	68	13	9	5755	0	5845
22751	21	11	5918	82	0	6032
22752	21	6142	56	34	0	6253
22753	6239	65	17	36	0	6357
22754	75	20	6331	26	0	6452
22755	6409	12	79	25	0	6525
22756	88	8	19	6623	0	6738
22757	22	13	16	6692	0	6743
22758	30	6678	11	94	0	6813
22759	6968	71	14	40	0	7093
22760	89	21	9	7040	0	7159
22761	35	16	13	7184	0	7248
22762	39	10	16	7332	0	7397
22763	24	12	7303	111	0	7450
22764	18	6	77	7330	0	7431
22765	7420	11	19	113	0	7563
22766	7529	12	12	59	0	7612
22767	105	10	11	7505	0	7631
22768	37	8	8	7552	0	7605
22769	7452	8	1	121	0	7582
22770	85	12	7338	44	0	7479
22771	7213	8	72	46	0	7339
22772	98	6	7195	34	0	7333
22773	35	8	7236	30	0	7309
22774	40	7	84	7283	0	7414
22775	25	8	7422	92	0	7547
22776	7399	6	80	52	0	7537
22777	95	7	31	7674	0	7807
22778	37	4	7657	87	0	7785
22779	7489	5	76	44	0	7614
22780	7674	4	36	43	0	7757
22781	102	4	7880	31	0	8017
22782	58	26	78	7628	0	7790
22783	34	7910	27	82	0	8053
22784	8043	59	15	39	0	8156
22785	96	22	8060	28	0	8206
22786	7569	27	69	35	0	7700
22787	89	7879	18	33	0	8019
22788	7697	63	59	23	0	7842
22789	7713	12	14	24	0	7763
22790	7817	13	12	28	0	7870
22791	89	20	13	7817	0	7939
22792	39	7825	14	74	0	7952
22793	32	66	7760	38	0	7896
22794	21	7883	62	29	0	7995
22795	35	73	22	7341	0	7471
22796	28	7772	12	59	0	7871
22797	16	7880	18	30	0	7944
22798	7733	69	20	29	0	7851
22799	77	32	7727	22	0	7858
22800	36	16	7782	18	0	7852
22801	25	15	7760	14	0	7814
22802	28	7921	66	29	0	8044
22803	7890	58	30	36	0	8014
22804	7876	26	17	25	0	7944
22805	7804	17	9	30	0	7860
22806	78	7794	16	22	0	7910
22807	34	52	12	8080	0	8178
22808	24	19	8055	71	0	8169
22809	22	16	7942	38	0	8018
22810	8014	13	61	42	0	8130
22811	8296	10	22	35	0	8363
22812	8308	6	18	29	0	8361
22813	84	8	8205	30	0	8327
22814	8163	5	60	48	0	8276
22815	94	6	27	8240	0	8367
22816	44	4	27	8253	0	8328
22817	41	9	8529	84	0	8663
22818	32	8514	61	33	0	8640
22819	40	55	25	8605	0	8725
22820	25	18	8509	80	0	8632
22821	8223	10	77	53	0	8363
22822	72	11	42	8596	0	8721
22823	41	3	28	8648	0	8720
22824	8579	6	31	99	0	8715
22825	87	6	26	8563	0	8682
22826	8558	4	13	97	0	8672
22827	8550	6	24	52	0	8632
22828	99	8	19	8566	0	8692
22829	53	10	22	8621	0	8706
22830	8600	12	25	95	0	8732
22831	90	6	26	8718	0	8840
22832	8736	13	24	100	0	8873
22833	8746	15	23	42	0	8826
22834	8718	11	19	42	0	8790
22835	109	12	18	8669	0	8808
22836	75	16	16	8671	0	8778
22837	8685	6	19	95	0	8805
22838	85	8567	23	41	0	8716
22839	48	8425	16	21	0	8510
22840	8349	47	17	31	0	8444
22841	73	18	8231	17	0	8339
22842	8174	10	31	27	0	8242
22843	50	13	17	8546	0	8626
22844	28	11	8551	39	0	8629
22845	8377	7	43	32	0	8459
22846	60	8	13	8560	0	8641
22847	28	11	11	8711	0	8761
22848	34	8	6	8852	0	8900
22849	35	8	6	8842	0	8891
22850	8678	4	9	63	0	8754
22851	40	8448	9	23	0	8520
22852	8090	21	3	19	0	8133
22853	28	8	8094	6	0	8136
22854	15	6	7716	4	0	7741
22855	16	8101	15	9	0	8141
22856	34	71	31	7954	0	8090
22857	10	7	7986	17	0	8020
22858	6	7288	17	10	0	7321
22859	3	13	7604	3	0	7623
22860	10	4	8	7507	0	7529
22861	4	3	5	7420	0	7432
22862	7451	0	2	25	0	7478
22863	8	1	2	7393	0	7404
22864	7384	2	2	25	0	7413
22865	14	0	7496	2	0	7512
22866	1	7579	10	5	0	7595
22867	8	10	2	7857	0	7877
22868	8	1	2	8245	0	8256
22869	2	4	8313	13	0	8332
22870	12	5	7800	4	0	7821
22871	7940	2	12	22	0	7976
22872	8393	1	2	13	0	8409
22873	12	2	1	8355	0	8370
22874	10	3	2	8311	0	8326
22875	4	8154	1	16	0	8175
22876	5	15	1	8394	0	8415
22877	8363	3	2	36	0	8404
22878	8431	2	4	23	0	8460
22879	13	8548	7	15	0	8583
22880	8635	14	0	26	0	8675
22881	8561	5	1	12	0	8579
22882	25	1	2	9290	0	9318
22883	8	9287	1	61	0	9357
22884	13	51	1	9422	0	9487
22885	6	8	2	9550	0	9566
22886	6	4	9413	69	0	9492
22887	9407	2	57	29	0	9495
22888	74	3	11	10105	0	10193
22889	29	4	1	10518	0	10552
22890	7	11555	6	117	0	11685
22891	19	139	0	12489	0	12647
22892	12875	33	3	202	0	13113
22893	13936	27	2	75	0	14040
22894	266	27	13894	42	0	14229
22895	83	24	14091	38	0	14236
22896	87	17	258	14381	0	14743
22897	80	5	77	14914	0	15076
22898	53	4	14829	306	0	15192
22899	51	8	14875	96	0	15030
22900	63	15	339	14442	0	14859
22901	34	3	14956	308	0	15301
22902	42	13	14929	103	0	15087
22903	35	4	370	14761	0	15170
22904	14959	5	137	338	0	15439
22905	15262	3	130	126	0	15521
22906	333	3	100	15164	0	15600
22907	113	4	80	15206	0	15403
22908	14869	2	83	375	0	15329
22909	323	3	61	14763	0	15150
22910	14644	7	55	375	0	15081
22911	14811	7	45	161	0	15024
22912	394	3	31	14677	0	15105
22913	176	9	29	14900	0	15114
22914	14600	5	29	416	0	15050
22915	350	14306	35	188	0	14879
22916	154	14545	29	166	0	14894
22917	143	274	28	14251	0	14696
22918	115	82	14064	352	0	14613
22919	99	59	271	14143	0	14572
22920	14137	47	84	391	0	14659
22921	318	44	68	14200	0	14630
22922	14204	54	73	386	0	14717
22923	321	47	14099	201	0	14668
22924	14189	35	302	154	0	14680
22925	354	22	100	14392	0	14868
22926	187	17	65	14704	0	14973
22927	133	20	14627	404	0	15184
22928	145	24	289	14630	0	15088
22929	116	15	110	14972	0	15213
22930	111	21	81	15055	0	15268
22931	14628	19	76	485	0	15208
22932	332	23	14472	251	0	15078
22933	150	24	14338	207	0	14719
22934	14292	14	343	209	0	14858
22935	14680	12	147	200	0	15039
22936	396	21	14644	168	0	15229
22937	203	24	330	14358	0	14915
22938	157	14632	162	345	0	15296
22939	140	251	146	15023	0	15560
22940	14918	68	132	420	0	15538
22941	15121	38	124	222	0	15505
22942	403	45	129	14810	0	15387
22943	180	14605	111	417	0	15313
22944	179	268	115	14309	0	14871
22945	163	14584	105	393	0	15245
22946	14615	286	97	266	0	15264
22947	14117	104	99	224	0	14544
22948	14431	69	92	204	0	14796
22949	426	13726	84	196	0	14432
22950	228	14274	78	189	0	14769
22951	200	335	81	14292	0	14908
22952	194	127	76	14511	0	14908
22953	194	84	66	14395	0	14739
22954	200	76	54	14593	0	14923
22955	163	79	13902	501	0	14645
22956	13626	68	307	299	0	14300
22957	398	79	14103	246	0	14826
22958	14355	53	325	271	0	15004
22959	413	64	14595	223	0	15295
22960	14638	57	343	243	0	15281
22961	431	55	14890	210	0	15586
22962	14732	49	379	203	0	15363
22963	473	38	198	14977	0	15686
22964	15186	48	137	438	0	15809
22965	482	41	130	15070	0	15723
22966	268	50	110	15141	0	15569
22967	226	35	120	14723	0	15104
22968	213	14119	113	497	0	14942
22969	14197	293	89	315	0	14894
22970	14280	99	73	259	0	14711
22971	473	14093	77	241	0	14884
22972	243	333	73	14248	0	14897
22973	190	115	13967	471	0	14743
22974	13945	76	304	281	0	14606
22975	14341	79	123	224	0	14767
22976	14242	61	107	222	0	14632
22977	518	61	105	13630	0	14314
22978	272	13473	89	425	0	14259
22979	245	297	101	13479	0	14122
22980	13449	96	99	432	0	14076
22981	529	73	85	12902	0	13589
22982	228	12387	90	363	0	13068
22983	12226	270	78	226	0	12800
22984	404	120	12099	175	0	12798
22985	273	98	11846	166	0	12383
22986	187	11821	298	154	0	12460
22987	175	11704	129	144	0	12152
22988	301	312	10971	119	0	11703
22989	258	169	10340	136	0	10903
22990	209	665	274	8205	0	9353
22991	8422	54	121	170	0	8767
22992	186	42	8229	54	0	8511
22993	52	7470	94	35	0	7651
22994	7200	77	79	43	0	7399
22995	80	7090	16	24	0	7210
22996	6716	42	21	22	0	6801
22997	51	6675	12	12	0	6750
22998	25	6719	10	11	0	6765
22999	26	60	19	6767	0	6872
23000	32	31	9	6713	0	6785
23001	18	8	6389	46	0	6461
23002	18	9	34	6308	0	6369
23003	6312	9	16	55	0	6392
23004	6365	6	4	32	0	6407
23005	43	9	8	6291	0	6351
23006	23	4	6217	42	0	6286
23007	9	8	6056	28	0	6101
23008	20	8	42	6217	0	6287
23009	16	8	6322	42	0	6388
23010	19	5	34	6293	0	6351
23011	17	6	18	6210	0	6251
23012	7	13	6810	48	0	6878
23013	6588	8	62	31	0	6689
23014	6830	7	31	24	0	6892
23015	74	7	7001	12	0	7094
23016	27	7	7215	14	0	7263
23017	24	4	100	7481	0	7609
23018	24	4	44	8164	0	8236
23019	21	9	16	8408	0	8454
23020	24	5	10	8379	0	8418
23021	8433	8	15	147	0	8603
23022	8889	7	13	64	0	8973
23023	149	7	10	9482	0	9648
23024	67	15	10	9992	0	10084
23025	28	9	10718	185	0	10940
23026	34	11	158	11268	0	11471
23027	34	4	79	12010	0	12127
23028	12608	7	35	338	0	12988
23029	250	13625	19	158	0	14052
23030	129	263	10	13805	0	14207
23031	57	109	19	14061	0	14246
23032	43	43	14	13972	0	14072
23033	37	12534	22	450	0	13043
23034	25	13658	16	205	0	13904
23035	35	358	12	13659	0	14064
23036	40	133	17	13720	0	13910
23037	44	65	14	13837	0	13960
23038	13101	43	15	521	0	13680
23039	276	13279	10	251	0	13816
23040	13419	292	14	147	0	13872
23041	13671	138	13	122	0	13944
23042	429	70	11	13321	0	13831
23043	184	13244	19	349	0	13796
23044	13336	303	7	209	0	13855
23045	360	143	11	13357	0	13871
23046	13549	76	14	392	0	14031
23047	384	60	7	13700	0	14151
23048	187	52	13525	394	0	14158
23049	102	40	13806	226	0	14174
23050	90	41	379	13807	0	14317
23051	72	45	146	14031	0	14294
23052	80	37	68	13834	0	14019
23053	74	13156	51	483	0	13764
23054	66	13968	41	256	0	14331
23055	13728	392	37	158	0	14315
23056	13713	163	36	143	0	14055
23057	420	13388	33	120	0	13961
23058	185	13027	30	102	0	13344
23059	98	13567	16	101	0	13782
23060	12869	413	25	121	0	13428
23061	295	13046	25	117	0	13483
23062	157	358	20	13047	0	13582
23063	12974	170	20	340	0	13504
23064	13122	108	23	178	0	13431
23065	416	82	17	12779	0	13294
23066	199	80	12541	358	0	13178
23067	111	73	12745	181	0	13110
23068	96	72	345	12779	0	13292
23069	80	77	12953	347	0	13457
23070	99	52	313	13002	0	13466
23071	84	56	135	13078	0	13353
23072	83	51	12856	448	0	13438
23073	70	63	12996	215	0	13344
23074	78	50	409	12925	0	13462
23075	74	50	187	13366	0	13677
23076	12852	44	97	484	0	13477
23077	295	12721	73	279	0	13368
23078	143	13332	72	187	0	13734
23079	12995	393	56	160	0	13604
23080	13361	180	47	160	0	13748
23081	422	12943	65	158	0	13588
23082	208	13288	66	141	0	13703
23083	13208	407	45	146	0	13806
23084	360	196	50	13140	0	13746
23085	13038	127	58	385	0	13608
23086	378	13035	44	244	0	13701
23087	13121	351	44	189	0	13705
23088	413	176	12901	165	0	13655
23089	12953	109	280	161	0	13503
23090	410	114	13049	140	0	13713
23091	231	97	325	12892	0	13545
23092	12842	72	156	412	0	13482
23093	380	73	12562	267	0	13282
23094	227	91	314	12700	0	13332
23095	12599	95	153	408	0	13255
23096	384	100	12556	256	0	13296
23097	243	75	314	12707	0	13339
23098	12514	82	148	443	0	13187
23099	373	12383	95	274	0	13125
23100	223	344	73	12626	0	13266
23101	188	179	63	12560	0	12990
23102	149	113	68	12743	0	13073
23103	133	12511	63	536	0	13243
23104	144	338	42	12998	0	13522
23105	150	179	57	13157	0	13543
23106	150	124	56	13183	0	13513
23107	166	95	43	13570	0	13874
23108	157	86	13110	561	0	13914
23109	12771	82	318	321	0	13492
23110	13233	74	146	240	0	13693
23111	481	13117	90	165	0	13853
23112	237	304	66	12747	0	13354
23113	167	147	59	12892	0	13265
23114	127	12625	71	479	0	13302
23115	103	284	63	12674	0	13124
23116	12104	142	70	421	0	12737
23117	300	11813	62	254	0	12429
23118	11447	275	67	177	0	11966
23119	313	138	58	11328	0	11837
23120	144	94	11163	365	0	11766
23121	98	11162	235	226	0	11721
23122	10601	279	160	157	0	11197
23123	256	9937	57	113	0	10363
23124	137	9765	42	84	0	10028
23125	8558	225	164	85	0	9032
23126	196	82	8348	75	0	8701
23127	63	7586	115	45	0	7809
23128	6133	247	262	142	0	6784
23129	5510	38	55	43	0	5646
23130	46	5495	6	9	0	5556
23131	32	33	5	5622	0	5692
23132	11	13	5705	36	0	5765
23133	14	16	34	5663	0	5727
23134	13	6	9	5550	0	5578
23135	17	10	8	5835	0	5870
23136	6	11	5821	54	0	5892
23137	11	8	32	5705	0	5756
23138	13	8	5803	47	0	5871
23139	7	6	5498	20	0	5531
23140	5258	6	33	25	0	5322
23141	31	5623	16	10	0	5680
23142	14	5673	11	7	0	5705
23143	24	37	13	5808	0	5882
23144	6149	13	10	43	0	6215
23145	6215	12	7	21	0	6255
23146	6007	5	2	21	0	6035
23147	6097	5	2	7	0	6111
23148	5885	6	5	13	0	5909
23149	47	5	5729	6	0	5787
23150	27	2	29	5742	0	5800
23151	13	5602	13	32	0	5660
23152	15	29	7	5742	0	5793
23153	5859	12	1	35	0	5907
23154	31	5790	2	18	0	5841
23155	15	30	4	5953	0	6002
23156	5985	13	4	41	0	6043
23157	6090	9	2	28	0	6129
23158	51	5	2	6059	0	6117
23159	25	4	5	5951	0	5985
23160	21	6	7	6001	0	6035
23161	8	2	5952	48	0	6010
23162	9	6	5917	23	0	5955
23163	11	6	40	6078	0	6135
23164	18	3	12	6120	0	6153
23165	6122	9	10	53	0	6194
23166	6127	13	3	29	0	6172
23167	6205	4	4	30	0	6243
23168	6299	3	7	23	0	6332
23169	6208	9	1	15	0	6233
23170	55	6244	4	21	0	6324
23171	6419	32	5	21	0	6477
23172	6406	15	7	19	0	6447
23173	6394	9	6	21	0	6430
23174	65	8	6	6583	0	6662
23175	28	16	6511	43	0	6598
23176	33	7	36	6668	0	6744
23177	26	9	6968	51	0	7054
23178	27	9	48	6741	0	6825
23179	14	6958	14	56	0	7042
23180	7027	42	9	29	0	7107
23181	7287	22	7	29	0	7345
23182	70	11	7	7384	0	7472
23183	33	11	8	7585	0	7637
23184	26	6	6	7587	0	7625
23185	17	7621	7	68	0	7713
23186	7631	41	8	37	0	7717
23187	7662	19	4	36	0	7721
23188	71	7667	10	20	0	7768
23189	41	49	4	7714	0	7808
23190	33	19	6	7624	0	7682
23191	17	7684	7	57	0	7765
23192	7773	44	7	35	0	7859
23193	7792	26	4	22	0	7844
23194	74	14	7	7804	0	7899
23195	34	13	7807	65	0	7919
23196	26	12	7489	23	0	7550
23197	22	6	51	7981	0	8060
23198	27	7	27	7977	0	8038
23199	22	5	12	8138	0	8177
23200	8097	8	16	84	0	8205
23201	8199	3	10	52	0	8264
23202	77	8524	5	27	0	8633
23203	8604	50	10	39	0	8703
23204	80	22	8544	28	0	8674
23205	52	14	8502	21	0	8589
23206	22	8864	72	19	0	8977
23207	8518	70	49	30	0	8667
23208	55	8505	10	14	0	8584
23209	8438	46	11	21	0	8516
23210	55	20	8489	15	0	8579
23211	30	11	8370	13	0	8424
23212	24	13	56	8425	0	8518
23213	24	13	8665	50	0	8752
23214	30	6	48	8723	0	8807
23215	44	8	25	7818	0	7895
23216	10	8762	15	72	0	8859
23217	13	46	17	8905	0	8981
23218	15	18	16	8975	0	9024
23219	9197	10	13	91	0	9311
23220	61	9156	12	38	0	9267
23221	39	56	10	9338	0	9443
23222	22	23	9313	76	0	9434
23223	8529	16	58	54	0	8657
23224	72	14	9287	24	0	9397
23225	42	23	63	9116	0	9244
23226	22	9490	25	70	0	9607
23227	22	78	14	9499	0	9613
23228	9715	28	11	87	0	9841
23229	9726	14	14	45	0	9799
23230	104	10053	18	20	0	10195
23231	10282	87	15	48	0	10432
23232	10358	23	14	43	0	10438
23233	10312	19	14	38	0	10383
23234	10635	21	10	26	0	10692
23235	9971	16	9	70	0	10066
23236	109	14	10411	29	0	10563
23237	55	20	90	10375	0	10540
23238	53	15	39	10056	0	10163
23239	40	17	14	10395	0	10466
23240	38	10390	11	114	0	10553
23241	38	93	9	10393	0	10533
23242	32	28	10435	104	0	10599
23243	24	10106	90	43	0	10263
23244	34	9993	31	30	0	10088
23245	49	103	25	9970	0	10147
23246	22	23	18	10003	0	10066
23247	29	21	19	9899	0	9968
23248	24	9631	16	124	0	9795
23249	19	9887	17	53	0	9976
23250	9872	92	16	46	0	10026
23251	9871	44	12	41	0	9968
23252	103	9945	22	28	0	10098
23253	10126	88	12	39	0	10265
23254	10399	26	14	54	0	10493
23255	115	26	13	10476	0	10630
23256	55	25	15	10728	0	10823
23257	37	23	18	10728	0	10806
23258	36	22	10681	115	0	10854
23259	38	26	10540	50	0	10654
23260	36	11164	101	41	0	11342
23261	11425	96	37	43	0	11601
23262	111	42	11523	36	0	11712
23263	11491	32	103	44	0	11670
23264	127	25	12218	42	0	12412
23265	12262	19	131	33	0	12445
23266	145	12851	53	34	0	13083
23267	12943	123	43	40	0	13149
23268	150	57	29	12797	0	13033
23269	95	39	24	13042	0	13200
23270	65	34	12886	165	0	13150
23271	45	13197	114	83	0	13439
23272	59	135	49	13350	0	13593
23273	44	57	13292	144	0	13537
23274	12457	48	142	79	0	12726
23275	148	13072	44	58	0	13322
23276	12933	138	34	52	0	13157
23277	142	12643	32	42	0	12859
23278	69	144	30	12682	0	12925
23279	12525	49	34	137	0	12745
23280	107	12690	28	72	0	12897
23281	65	118	27	12708	0	12918
23282	41	46	12518	151	0	12756
23283	12008	38	119	78	0	12243
23284	136	40	40	12487	0	12703
23285	58	42	12420	131	0	12651
23286	52	12413	105	66	0	12636
23287	55	114	46	12457	0	12672
23288	39	47	12506	131	0	12723
23289	51	55	124	12191	0	12421
23290	41	12463	48	127	0	12679
23291	44	12677	35	60	0	12816
23292	45	130	12604	47	0	12826
23293	55	65	110	12489	0	12719
23294	30	43	12642	136	0	12851
23295	12312	33	131	80	0	12556
23296	131	49	49	12415	0	12644
23297	59	12133	45	128	0	12365
23298	48	12628	30	65	0	12771
23299	12464	135	28	58	0	12685
23300	117	12763	29	32	0	12941
23301	12745	128	31	49	0	12953
23302	133	57	12433	30	0	12653
23303	11815	38	96	55	0	12004
23304	122	12173	36	29	0	12360
23305	12151	117	38	43	0	12349
23306	115	12025	27	27	0	12194
23307	61	132	23	11949	0	12165
23308	60	51	17	12246	0	12374
23309	29	45	12228	138	0	12440
23310	11545	25	107	84	0	11761
23311	109	34	12111	43	0	12297
23312	12215	27	116	42	0	12400
23313	131	29	47	12227	0	12434
23314	55	21	32	12449	0	12557
23315	42	12636	18	155	0	12851
23316	35	138	20	13045	0	13238
23317	47	49	23	13287	0	13406
23318	27	47	13235	160	0	13469
23319	12288	22	125	87	0	12522
23320	127	12826	48	52	0	13053
23321	12893	111	36	46	0	13086
23322	146	50	16	12862	0	13074
23323	60	45	24	12940	0	13069
23324	12801	29	17	178	0	13025
23325	121	12954	27	70	0	13172
23326	12651	115	21	50	0	12837
23327	135	12518	24	32	0	12709
23328	50	12458	22	27	0	12557
23329	12401	127	56	30	0	12614
23330	149	64	38	12031	0	12282
23331	55	38	12068	101	0	12262
23332	42	24	97	11926	0	12089
23333	50	24	38	11871	0	11983
23334	29	11943	34	137	0	12143
23335	41	120	14	12126	0	12301
23336	35	54	18	12090	0	12197
23337	31	39	20	12215	0	12305
23338	45	22	18	12364	0	12449
23339	25	36	12236	171	0	12468
23340	26	28	12381	83	0	12518
23341	29	39	135	12718	0	12921
23342	24	23	12748	151	0	12946
23343	29	27	12645	72	0	12773
23344	42	22	151	12954	0	13169
23345	30	29	13402	147	0	13608
23346	47	24	144	13042	0	13257
23347	26	13393	51	163	0	13633
23348	13895	134	40	89	0	14158
23349	140	58	14622	65	0	14885
23350	82	41	168	14672	0	14963
23351	49	23	15008	184	0	15264
23352	44	29	191	15583	0	15847
23353	45	23	63	15969	0	16100
23354	15932	30	52	249	0	16263
23355	202	26	29	16359	0	16616
23356	15844	29	39	254	0	16166
23357	16174	14	35	140	0	16363
23358	240	16025	48	84	0	16397
23359	15924	199	32	68	0	16223
23360	226	15589	36	54	0	15905
23361	86	15914	20	72	0	16092
23362	15536	241	58	90	0	15925
23363	228	87	15534	59	0	15908
23364	88	39	15053	50	0	15230
23365	14448	101	305	74	0	14928
23366	14565	25	105	48	0	14743
23367	221	14616	33	42	0	14912
23368	14888	176	19	45	0	15128
23369	15007	67	28	50	0	15152
23370	14882	35	34	44	0	14995
23371	250	36	27	14675	0	14988
23372	14627	18	26	190	0	14861
23373	200	14896	36	77	0	15209
23374	105	171	27	15167	0	15470
23375	84	64	20	15158	0	15326
23376	46	15144	25	225	0	15440
23377	59	170	21	15260	0	15510
23378	15102	64	22	221	0	15409
23379	15179	37	25	101	0	15342
23380	244	14692	27	72	0	15035
23381	107	15006	20	56	0	15189
23382	14939	220	19	57	0	15235
23383	218	89	14831	51	0	15189
23384	105	45	14772	62	0	14984
23385	93	43	214	14632	0	14982
23386	88	34	70	14934	0	15126
23387	67	35	14730	233	0	15065
23388	76	14063	181	101	0	14421
23389	92	190	70	13727	0	14079
23390	72	95	14750	182	0	15099
23391	84	52	184	14677	0	14997
23392	81	44	83	14754	0	14962
23393	64	15036	51	239	0	15390
23394	71	190	40	15039	0	15340
23395	67	91	37	15147	0	15342
23396	84	56	36	15156	0	15332
23397	15033	43	43	255	0	15374
23398	228	44	42	14688	0	15002
23399	115	14818	38	226	0	15197
23400	14708	179	34	121	0	15042
23401	213	88	14359	89	0	14749
23402	110	65	14166	73	0	14414
23403	14361	38	213	80	0	14692
23404	222	39	89	14564	0	14914
23405	107	44	14694	217	0	15062
23406	100	50	168	14619	0	14937
23407	69	45	78	15033	0	15225
23408	14833	47	54	269	0	15203
23409	14827	53	37	137	0	15054
23410	267	15006	37	91	0	15401
23411	138	188	48	14956	0	15330
23412	78	89	14984	196	0	15347
23413	71	15290	178	113	0	15652
23414	15110	176	86	100	0	15472
23415	186	15288	59	80	0	15613
23416	15060	205	52	81	0	15398
23417	217	83	15015	80	0	15395
23418	14794	37	179	67	0	15077
23419	15429	40	85	99	0	15653
23420	260	44	15807	79	0	16190
23421	134	59	189	15559	0	15941
23422	73	15334	88	206	0	15701
23423	69	16284	51	110	0	16514
23424	66	16419	37	87	0	16609
23425	97	287	50	16038	0	16472
23426	61	94	16270	233	0	16658
23427	83	62	189	16140	0	16474
23428	79	65	69	16469	0	16682
23429	65	58	16340	263	0	16726
23430	62	16273	199	125	0	16659
23431	80	202	79	16131	0	16492
23432	16344	71	58	236	0	16709
23433	229	51	55	16396	0	16731
23434	127	45	38	16323	0	16533
23435	67	16224	45	272	0	16608
23436	16405	192	44	151	0	16792
23437	235	84	34	16694	0	17047
23438	102	66	16552	233	0	16953
23439	58	16484	167	129	0	16838
23440	16182	190	78	99	0	16549
23441	206	70	16250	69	0	16595
23442	15896	51	195	73	0	16215
23443	229	78	72	15935	0	16314
23444	94	16063	45	179	0	16381
23445	15798	184	44	101	0	16127
23446	15876	71	45	75	0	16067
23447	214	16038	45	59	0	16356
23448	117	168	31	15812	0	16128
23449	79	70	27	15379	0	15555
23450	14988	38	30	199	0	15255
23451	153	14996	38	76	0	15263
23452	82	187	20	14242	0	14531
23453	32	13941	24	116	0	14113
23454	31	13794	19	54	0	13898
23455	69	129	34	13273	0	13505
23456	13223	32	44	116	0	13415
23457	81	13289	12	45	0	13427
23458	33	95	14	13279	0	13421
23459	33	35	10	13279	0	13357
23460	21	25	13164	99	0	13309
23461	21	21	12353	41	0	12436
23462	11	12936	81	34	0	13062
23463	22	83	12740	34	0	12879
23464	17	37	87	12766	0	12907
23465	23	27	12844	79	0	12973
23466	16	24	86	13128	0	13254
23467	17	16	26	13245	0	13304
23468	20	18	21	13230	0	13289
23469	12956	13	12	139	0	13120
23470	89	11	14	12897	0	13011
23471	27	20	14	12924	0	12985
23472	25	12850	9	113	0	12997
23473	33	86	11	12749	0	12879
23474	12830	24	14	136	0	13004
23475	79	13017	11	51	0	13158
23476	13104	81	11	68	0	13264
23477	90	39	13135	23	0	13287
23478	37	30	13206	30	0	13303
23479	44	15	88	13643	0	13790
23480	27	26	31	13911	0	13995
23481	17	13927	25	115	0	14084
23482	38	92	21	13038	0	13189
23483	13878	35	15	128	0	14056
23484	13847	24	10	75	0	13956
23485	114	27	13	14133	0	14287
23486	51	27	14771	117	0	14966
23487	50	16	95	14896	0	15057
23488	39	10	34	15382	0	15465
23489	29	24	25	15486	0	15564
23490	26	16	23	15361	0	15426
23491	27	20	13	15183	0	15243
23492	18	15175	22	160	0	15375
23493	15014	110	19	94	0	15237
23494	15309	35	15	88	0	15447
23495	15460	26	21	71	0	15578
23496	143	15701	20	62	0	15926
23497	15612	126	13	79	0	15830
23498	138	15654	18	45	0	15855
23499	53	145	15547	38	0	15783
23500	56	54	118	15360	0	15588
23501	47	36	15714	138	0	15935
23502	24	15789	131	81	0	16025
23503	15698	137	39	86	0	15960
23504	133	60	16140	49	0	16382
23505	57	44	16549	45	0	16695
23506	42	17357	172	45	0	17616
23507	72	165	86	17539	0	17862
23508	44	64	18355	178	0	18641
23509	68	48	177	17902	0	18195
23510	58	39	85	19736	0	19918
23511	51	34	52	20818	0	20955
23512	21582	17	38	350	0	21987
23513	21667	29	35	157	0	21888
23514	349	27	24	21915	0	22315
23515	22136	22	27	363	0	22548
23516	342	27	21943	140	0	22452
23517	140	14	21709	106	0	21969
23518	110	25	21833	97	0	22065
23519	86	29	21899	101	0	22115
23520	94	21371	352	121	0	21938
23521	153	270	174	20999	0	21596
23522	89	72	21496	264	0	21921
23523	20327	39	318	155	0	20839
23524	21341	35	160	109	0	21645
23525	341	21108	142	104	0	21695
23526	21151	255	137	80	0	21623
23527	352	88	136	21112	0	21688
23528	128	82	21520	283	0	22013
23529	147	64	328	20547	0	21086
23530	78	21576	168	292	0	22114
23531	21002	276	127	158	0	21563
23532	21491	114	90	137	0	21832
23533	382	21459	93	98	0	22032
23534	21597	293	76	110	0	22076
23535	21628	125	72	108	0	21933
23536	406	21501	89	74	0	22070
23537	246	293	82	20864	0	21485
23538	138	21236	73	297	0	21744
23539	21353	325	62	156	0	21896
23540	400	190	71	21240	0	21901
23541	21316	117	52	344	0	21829
23542	412	107	57	21172	0	21748
23543	218	111	20951	329	0	21609
23544	20555	106	267	167	0	21095
23545	391	99	20914	124	0	21528
23546	254	95	291	20729	0	21369
23547	173	97	20546	326	0	21142
23548	176	79	321	20560	0	21136
23549	145	71	20569	370	0	21155
23550	19967	63	335	223	0	20588
23551	344	20397	168	162	0	21071
23552	20421	281	130	157	0	20989
23553	383	105	117	20290	0	20895
23554	20112	65	132	366	0	20675
23555	379	19858	128	169	0	20534
23556	185	19779	116	142	0	20222
23557	148	20451	130	114	0	20843
23558	20368	362	100	146	0	20976
23559	374	171	110	20248	0	20903
23560	205	123	79	20437	0	20844
23561	162	111	19898	385	0	20556
23562	157	108	19648	200	0	20113
23563	180	118	320	19929	0	20547
23564	177	119	20136	322	0	20754
23565	123	20019	310	178	0	20630
23566	19766	304	162	163	0	20395
23567	333	157	20171	127	0	20788
23568	166	121	20117	154	0	20558
23569	125	113	412	20016	0	20666
23570	20317	78	204	372	0	20971
23571	338	92	158	20532	0	21120
23572	20415	57	149	421	0	21042
23573	370	81	160	20427	0	21038
23574	206	81	20545	353	0	21185
23575	159	20207	371	193	0	20930
23576	150	281	20485	145	0	21061
23577	131	20381	387	134	0	21033
23578	166	376	206	20047	0	20795
23579	19841	122	159	390	0	20512
23580	346	95	19909	183	0	20533
23581	203	78	321	19842	0	20444
23582	158	85	176	20373	0	20792
23583	20641	93	137	416	0	21287
23584	376	89	127	20277	0	20869
23585	170	20469	122	367	0	21128
23586	19898	305	119	225	0	20547
23587	332	170	19742	162	0	20406
23588	19171	107	315	166	0	19759
23589	343	19586	141	154	0	20224
23590	232	342	110	18855	0	19539
23591	161	19718	75	335	0	20289
23592	19604	291	89	207	0	20191
23593	368	155	19621	151	0	20295
23594	19042	166	294	153	0	19655
23595	353	19623	121	133	0	20230
23596	218	292	123	19594	0	20227
23597	19729	154	83	325	0	20291
23598	19901	113	96	180	0	20290
23599	406	112	79	19743	0	20340
23600	216	112	99	19848	0	20275
23601	188	19664	84	344	0	20280
23602	197	328	85	19649	0	20259
23603	159	21134	84	314	0	21691
23604	138	22139	67	233	0	22577
23605	200	748	82	20299	0	21329
23606	145	21235	63	357	0	21800
23607	177	344	21464	152	0	22137
23608	278	188	22236	164	0	22866
23609	109	22835	446	162	0	23552
23610	152	349	22938	93	0	23532
23611	78	228	22679	87	0	23072
23612	64	114	21409	63	0	21650
23613	33	21062	484	51	0	21630
23614	20243	369	341	92	0	21045
23615	246	20170	124	34	0	20574
23616	150	326	20136	12	0	20624
23617	104	176	311	19795	0	20386
23618	19842	103	183	285	0	20413
23619	275	69	19846	144	0	20334
23620	182	51	306	19829	0	20368
23621	100	58	20202	271	0	20631
23622	84	38	365	19898	0	20385
23623	19787	35	209	359	0	20390
23624	278	40	20090	184	0	20592
23625	158	20096	340	122	0	20716
23626	128	288	193	19721	0	20330
23627	20385	162	119	305	0	20971
23628	300	95	20107	166	0	20668
23629	219	65	317	19021	0	19622
23630	102	20007	197	267	0	20573
23631	20283	280	134	182	0	20879
23632	20828	175	92	134	0	21229
23633	449	105	90	20489	0	21133
23634	242	20542	87	324	0	21195
23635	128	21515	83	209	0	21935
23636	21959	414	80	140	0	22593
23637	404	249	76	21569	0	22298
23638	210	22020	78	353	0	22661
23639	22093	394	68	220	0	22775
23640	415	215	55	22192	0	22877
23641	243	134	64	22483	0	22924
23642	143	100	21403	511	0	22157
23643	101	21732	323	285	0	22441
23644	85	22666	178	169	0	23098
23645	92	504	107	22608	0	23311
23646	22576	238	74	443	0	23331
23647	383	22653	66	231	0	23333
23648	22717	416	69	177	0	23379
23649	451	22720	72	103	0	23346
23650	249	476	48	22698	0	23471
23651	22745	241	62	416	0	23464
23652	448	161	57	22741	0	23407
23653	248	114	22622	457	0	23441
23654	173	100	373	21788	0	22434
23655	113	22403	183	451	0	23150
23656	22255	415	121	249	0	23040
23657	390	22302	87	179	0	22958
23658	241	475	61	21890	0	22667
23659	177	255	57	22386	0	22875
23660	112	174	21820	532	0	22638
23661	108	123	21779	307	0	22317
23662	119	134	514	21787	0	22554
23663	97	118	21757	447	0	22419
23664	96	21515	452	265	0	22328
23665	21457	428	241	207	0	22333
23666	403	239	21766	139	0	22547
23667	21437	179	420	158	0	22194
23668	22028	127	233	142	0	22530
23669	22025	112	156	126	0	22419
23670	22021	118	129	126	0	22394
23671	656	108	113	21510	0	22387
23672	374	107	97	20972	0	21550
23673	212	20956	123	521	0	21812
23674	20926	416	110	313	0	21765
23675	455	250	20626	191	0	21522
23676	294	165	407	20485	0	21351
23677	226	133	252	20719	0	21330
23678	149	108	20246	565	0	21068
23679	141	20323	415	338	0	21217
23680	171	422	261	19391	0	20245
23681	172	250	165	20745	0	21332
23682	20286	176	131	609	0	21202
23683	428	20145	115	382	0	21070
23684	294	407	105	19955	0	20761
23685	177	20045	115	472	0	20809
23686	188	459	98	20335	0	21080
23687	19980	245	89	554	0	20868
23688	20278	169	98	342	0	20887
23689	579	127	97	20012	0	20815
23690	19916	129	88	513	0	20646
23691	19901	109	87	333	0	20430
23692	596	19606	87	234	0	20523
23693	395	391	71	19151	0	20008
23694	241	19494	85	445	0	20265
23695	223	460	67	19465	0	20215
23696	19337	256	75	517	0	20185
23697	486	187	47	19318	0	20038
23698	327	149	64	19502	0	20042
23699	230	146	18759	615	0	19750
23700	213	17868	325	372	0	18778
23701	159	18839	182	256	0	19436
23702	18397	487	123	234	0	19241
23703	427	365	75	16574	0	17441
23704	15616	158	48	365	0	16187
23705	383	15107	43	250	0	15783
23706	219	14207	42	203	0	14671
23707	146	14517	43	149	0	14855
23708	12015	364	273	135	0	12787
23709	181	11925	52	97	0	12255
23710	10791	176	159	113	0	11239
23711	10408	53	36	64	0	10561
23712	10629	31	16	57	0	10733
23713	161	33	13	11058	0	11265
23714	64	37	11	11285	0	11397
23715	54	28	12	11332	0	11426
23716	43	32	14	11217	0	11306
23717	11129	20	17	220	0	11386
23718	163	10976	10	89	0	11238
23719	76	132	11	10985	0	11204
23720	11043	49	14	171	0	11277
23721	178	23	9	10905	0	11115
23722	76	26	16	10990	0	11108
23723	10831	23	8	216	0	11078
23724	172	28	10604	74	0	10878
23725	63	22	129	10606	0	10820
23726	37	21	10689	179	0	10926
23727	40	21	133	10482	0	10676
23728	37	42	40	10475	0	10594
23729	10239	19	29	199	0	10486
23730	148	10001	19	78	0	10246
23731	39	9909	16	56	0	10020
23732	9528	121	8	46	0	9703
23733	129	9633	11	28	0	9801
23734	9496	110	41	51	0	9698
23735	130	34	9298	24	0	9486
23736	8579	42	75	31	0	8727
23737	8794	7	17	27	0	8845
23738	8844	7	9	27	0	8887
23739	86	11	4	8708	0	8809
23740	40	9	3	8700	0	8752
23741	22	8664	0	73	0	8759
23742	21	116	9	8614	0	8760
23743	8614	15	0	90	0	8719
23744	61	8520	6	30	0	8617
23745	19	8479	5	23	0	8526
23746	8454	61	8	24	0	8547
23747	67	19	8371	9	0	8466
23748	30	18	54	8248	0	8350
23749	16	8	8376	63	0	8463
23750	23	4	57	8254	0	8338
23751	8	8280	13	64	0	8365
23752	12	57	8	8438	0	8515
23753	8362	10	4	77	0	8453
23754	66	10	8	8381	0	8465
23755	14	17	8589	72	0	8692
23756	8134	7	64	41	0	8246
23757	72	8665	17	12	0	8766
23758	21	9177	10	20	0	9228
23759	9535	80	4	34	0	9653
23760	10042	24	6	28	0	10100
23761	105	22	10093	11	0	10231
23762	9848	12	84	18	0	9962
23763	105	10086	23	14	0	10228
23764	10249	89	9	28	0	10375
23765	114	28	8	9919	0	10069
23766	39	9497	10	86	0	9632
23767	9654	94	1	47	0	9796
23768	108	31	9638	20	0	9797
23769	51	22	88	9729	0	9890
23770	9921	15	25	120	0	10081
23771	119	17	9871	30	0	10037
23772	9913	10	96	40	0	10059
23773	120	15	25	9870	0	10030
23774	59	17	12	10030	0	10118
23775	37	13	10057	125	0	10232
23776	34	10	99	10050	0	10193
23777	10165	11	33	141	0	10350
23778	114	10054	25	49	0	10242
23779	10132	100	18	53	0	10303
23780	10219	29	8	49	0	10305
23781	146	20	8	10174	0	10348
23782	50	16	10307	124	0	10497
23783	46	14	107	10278	0	10445
23784	10344	8	29	144	0	10525
23785	110	10292	23	52	0	10477
23786	10590	103	14	54	0	10761
23787	150	35	11	10579	0	10775
23788	70	18	7	10806	0	10901
23789	33	18	25	10866	0	10942
23790	38	11	10696	175	0	10920
23791	38	10	120	10767	0	10935
23792	32	26	10696	147	0	10901
23793	32	21	10702	61	0	10816
23794	51	16	140	11477	0	11684
23795	33	11	11693	171	0	11908
23796	12677	23	153	78	0	12931
23797	205	11	59	13368	0	13643
23798	124	4	44	13385	0	13557
23799	42	13838	37	281	0	14198
23800	14030	192	32	130	0	14384
23801	14430	81	27	109	0	14647
23802	297	14477	22	63	0	14859
23803	161	222	22	14489	0	14894
23804	85	105	14488	231	0	14909
23805	14302	43	212	142	0	14699
23806	14779	40	98	94	0	15011
23807	339	28	50	14186	0	14603
23808	161	42	13866	237	0	14306
23809	104	13741	218	115	0	14178
23810	13651	225	95	92	0	14063
23811	278	112	13752	67	0	14209
23812	140	13552	244	59	0	13995
23813	13065	228	163	69	0	13525
23814	13154	94	68	66	0	13382
23815	337	54	47	12900	0	13338
23816	166	13014	37	217	0	13434
23817	134	214	26	13595	0	13969
23818	92	109	49	13865	0	14115
23819	98	70	43	13604	0	13815
23820	85	55	41	13927	0	14108
23821	67	42	13695	361	0	14165
23822	78	43	220	13934	0	14275
23823	78	57	98	14167	0	14400
23824	87	27	13837	353	0	14304
23825	54	13849	229	191	0	14323
23826	13780	236	102	157	0	14275
23827	13979	111	65	133	0	14288
23828	328	55	40	13958	0	14381
23829	14014	37	41	311	0	14403
23830	306	41	41	14199	0	14587
23831	156	32	14226	336	0	14750
23832	93	33	14133	201	0	14460
23833	65	14192	301	148	0	14706
23834	14022	234	148	114	0	14518
23835	278	128	14715	83	0	15204
23836	191	68	263	14249	0	14771
23837	147	45	132	15099	0	15423
23838	124	34	87	15593	0	15838
23839	109	39	63	15613	0	15824
23840	98	35	74	15657	0	15864
23841	74	35	15242	517	0	15868
23842	81	49	296	15409	0	15835
23843	15155	46	166	414	0	15781
23844	324	15089	97	254	0	15764
23845	15101	261	79	191	0	15632
23846	322	15174	75	156	0	15727
23847	15246	309	55	178	0	15788
23848	15534	168	52	157	0	15911
23849	465	84	64	15265	0	15878
23850	263	65	59	15492	0	15879
23851	15225	54	61	502	0	15842
23852	15063	54	60	298	0	15475
23853	15222	60	53	204	0	15539
23854	470	14581	58	145	0	15254
23855	265	14815	53	139	0	15272
23856	184	375	14649	111	0	15319
23857	177	266	260	14346	0	15049
23858	145	98	14115	348	0	14706
23859	117	13723	289	248	0	14377
23860	132	271	186	13181	0	13770
23861	139	136	68	13282	0	13625
23862	127	88	56	13488	0	13759
23863	13121	76	46	457	0	13700
23864	13146	79	61	270	0	13556
23865	376	13153	54	175	0	13758
23866	237	246	58	13248	0	13789
23867	131	165	13163	313	0	13772
23868	109	100	12817	234	0	13260
23869	12940	95	354	165	0	13554
23870	13079	68	189	163	0	13499
23871	395	51	103	12986	0	13535
23872	13047	49	81	348	0	13525
23873	367	63	12845	228	0	13503
23874	254	12840	253	163	0	13510
23875	158	258	154	12891	0	13461
23876	121	164	13109	322	0	13716
23877	123	104	295	13183	0	13705
23878	123	76	180	13402	0	13781
23879	124	53	13282	428	0	13887
23880	13012	50	257	321	0	13640
23881	13503	36	183	218	0	13940
23882	383	13703	109	196	0	14391
23883	14152	265	86	176	0	14679
23884	14495	169	80	166	0	14910
23885	469	100	14323	161	0	15053
23886	14406	76	274	163	0	14919
23887	401	14973	184	141	0	15699
23888	15116	304	96	154	0	15670
23889	15488	159	92	144	0	15883
23890	15879	106	79	113	0	16177
23891	15103	95	60	130	0	15388
23892	15877	85	49	113	0	16124
23893	602	15457	50	120	0	16229
23894	14964	283	64	110	0	15421
23895	444	14588	56	98	0	15186
23896	209	12997	54	96	0	13356
23897	131	13403	53	63	0	13650
23898	12953	308	194	77	0	13532
23899	12891	128	62	61	0	13142
23900	330	79	12401	50	0	12860
23901	12963	70	184	60	0	13277
23902	13106	43	91	67	0	13307
23903	339	52	13140	71	0	13602
23904	181	35	238	13100	0	13554
23905	139	47	124	12688	0	12998
23906	103	41	49	13543	0	13736
23907	96	36	49	13601	0	13782
23908	103	25	46	13656	0	13830
23909	96	38	13231	358	0	13723
23910	90	13189	223	166	0	13668
23911	12960	224	104	105	0	13393
23912	280	12994	54	84	0	13412
23913	13002	239	55	75	0	13371
23914	13030	114	48	71	0	13263
23915	362	69	12711	56	0	13198
23916	195	109	216	11843	0	12363
23917	127	12219	100	206	0	12652
23918	12289	216	60	116	0	12681
23919	12304	110	53	85	0	12552
23920	12482	67	38	67	0	12654
23921	355	12354	38	49	0	12796
23922	12372	202	58	48	0	12680
23923	12478	97	33	61	0	12669
23924	12510	64	23	51	0	12648
23925	371	58	38	12141	0	12608
23926	224	54	21	12301	0	12600
23927	160	41	22	12429	0	12652
23928	12225	58	19	285	0	12587
23929	288	12230	20	141	0	12679
23930	12228	195	24	78	0	12525
23931	12041	111	27	55	0	12234
23932	11695	63	26	50	0	11834
23933	11830	53	21	45	0	11949
23934	368	11406	23	129	0	11926
23935	10803	179	19	44	0	11045
23936	280	10523	15	40	0	10858
23937	144	10372	12	25	0	10553
23938	10218	179	52	32	0	10481
23939	211	10010	18	24	0	10263
23940	112	10228	10	26	0	10376
23941	10186	187	53	42	0	10468
23942	10229	91	8	31	0	10359
23943	243	54	7	10048	0	10352
23944	130	51	15	10188	0	10384
23945	10156	44	19	202	0	10421
23946	10454	40	13	83	0	10590
23947	10061	46	14	62	0	10183
23948	239	38	10026	32	0	10335
23949	10408	36	126	48	0	10618
23950	229	41	53	10362	0	10685
23951	134	32	24	10515	0	10705
23952	100	38	21	10557	0	10716
23953	88	33	26	10579	0	10726
23954	87	25	10208	223	0	10543
23955	78	36	10240	110	0	10464
23956	81	32	180	10256	0	10549
23957	81	39	10210	193	0	10523
23958	88	31	10171	100	0	10390
23959	82	34	186	10295	0	10597
23960	85	30	77	10527	0	10719
23961	87	32	46	10751	0	10916
23962	85	38	49	10492	0	10664
23963	10690	37	34	247	0	11008
23964	10978	42	34	124	0	11178
23965	249	47	33	10732	0	11061
23966	149	41	31	10817	0	11038
23967	135	32	19	10791	0	10977
23968	103	33	32	10763	0	10931
23969	116	32	22	10697	0	10867
23970	89	10566	21	261	0	10937
23971	10547	150	26	146	0	10869
23972	197	10579	30	115	0	10921
23973	10619	178	12	92	0	10901
23974	10643	85	20	94	0	10842
23975	10628	62	18	66	0	10774
23976	284	53	8	10171	0	10516
23977	10215	42	17	180	0	10454
23978	246	46	17	10064	0	10373
23979	167	59	9	10004	0	10239
23980	9966	41	14	227	0	10248
23981	226	9662	17	124	0	10029
23982	128	9392	5	81	0	9606
23983	9117	137	10	59	0	9323
23984	180	66	8888	42	0	9176
23985	8493	53	107	47	0	8700
23986	194	132	37	8384	0	8747
23987	99	7828	16	105	0	8048
23988	83	7933	8	66	0	8090
23989	7905	117	40	66	0	8128
23990	109	69	6	7829	0	8013
23991	58	8050	6	97	0	8211
23992	7941	77	18	58	0	8094
23993	7955	26	6	48	0	8035
23994	8003	21	7	34	0	8065
23995	8015	21	4	34	0	8074
23996	122	7716	0	30	0	7868
23997	48	7535	0	15	0	7598
23998	7629	59	11	29	0	7728
23999	7777	29	5	25	0	7836
24000	76	22	7625	15	0	7738
24001	37	7381	41	6	0	7465
24002	7306	44	27	14	0	7391
24003	7538	11	6	18	0	7573
24004	55	8	7650	7	0	7720
24005	7826	4	49	11	0	7890
24006	75	9	8185	7	0	8276
24007	14	11	8760	6	0	8791
24008	35	26	90	8346	0	8497
24009	15	8487	35	84	0	8621
24010	9291	93	15	39	0	9438
24011	111	25	8	9290	0	9434
24012	44	18	8	9368	0	9438
24013	41	4	8	9447	0	9500
24014	9344	7	12	155	0	9518
24015	115	3	5	9329	0	9452
24016	35	7	7	9572	0	9621
24017	27	9	9537	134	0	9707
24018	9314	4	102	82	0	9502
24019	9583	10	31	44	0	9668
24020	143	10	9540	25	0	9718
24021	9324	7	101	39	0	9471
24022	135	4	39	9291	0	9469
24023	54	9334	27	119	0	9534
24024	56	103	17	9405	0	9581
24025	9375	30	16	137	0	9558
24026	133	9390	6	63	0	9592
24027	47	110	15	9500	0	9672
24028	56	41	10	9639	0	9746
24029	40	22	6	9654	0	9722
24030	40	9	8	9388	0	9445
24031	24	9659	14	156	0	9853
24032	9721	112	10	85	0	9928
24033	9834	43	10	62	0	9949
24034	150	10072	10	53	0	10285
24035	10845	127	9	46	0	11027
24036	11366	50	8	38	0	11462
24037	11326	32	8	46	0	11412
24038	240	19	11015	35	0	11309
24039	115	22	156	11004	0	11297
24040	84	12	10741	175	0	11012
24041	10812	22	157	80	0	11071
24042	201	10988	44	53	0	11286
24043	10907	162	42	44	0	11155
24044	222	11074	25	29	0	11350
24045	109	185	29	10756	0	11079
24046	89	57	30	11051	0	11227
24047	57	54	10990	213	0	11314
24048	63	11140	171	97	0	11471
24049	11128	202	50	66	0	11446
24050	218	76	11169	48	0	11511
24051	11188	64	180	56	0	11488
24052	241	37	73	11227	0	11578
24053	92	40	11314	223	0	11669
24054	86	11266	206	88	0	11646
24055	69	195	80	11278	0	11622
24056	75	82	11355	208	0	11720
24057	67	54	11399	93	0	11613
24058	64	11344	236	80	0	11724
24059	90	196	90	11139	0	11515
24060	72	73	62	11049	0	11256
24061	54	11009	54	220	0	11337
24062	11160	196	49	136	0	11541
24063	222	86	45	10962	0	11315
24064	97	10983	65	204	0	11349
24065	11139	204	48	116	0	11507
24066	11131	91	43	106	0	11371
24067	11284	57	54	78	0	11473
24068	282	11147	42	70	0	11541
24069	11276	211	39	88	0	11614
24070	11357	87	39	75	0	11558
24071	284	79	37	11168	0	11568
24072	11261	60	23	236	0	11580
24073	294	71	27	11234	0	11626
24074	144	53	11097	252	0	11546
24075	129	51	11286	113	0	11579
24076	100	55	219	11433	0	11807
24077	121	43	11506	230	0	11900
24078	11403	46	225	138	0	11812
24079	267	37	92	11648	0	12044
24080	138	37	81	11774	0	12030
24081	115	37	11582	295	0	12029
24082	93	11267	238	135	0	11733
24083	94	11723	102	104	0	12023
24084	95	235	79	11519	0	11928
24085	94	97	64	11684	0	11939
24086	89	70	11388	290	0	11837
24087	64	53	11521	154	0	11792
24088	78	62	249	11583	0	11972
24089	62	64	11426	260	0	11812
24090	11236	64	236	131	0	11667
24091	250	63	96	11303	0	11712
24092	11410	54	79	273	0	11816
24093	269	56	59	11363	0	11747
24094	126	52	83	11586	0	11847
24095	119	49	11370	304	0	11842
24096	83	11462	232	182	0	11959
24097	104	215	104	11509	0	11932
24098	80	95	11471	248	0	11894
24099	91	11272	215	146	0	11724
24100	110	195	114	11384	0	11803
24101	11356	89	86	275	0	11806
24102	234	61	11334	151	0	11780
24103	10760	41	236	123	0	11160
24104	245	57	10761	85	0	11148
24105	9914	48	230	94	0	10286
24106	221	9988	104	82	0	10395
24107	78	9668	78	53	0	9877
24108	98	291	67	9109	0	9565
24109	57	9036	48	169	0	9310
24110	9062	138	60	108	0	9368
24111	169	58	49	9084	0	9360
24112	69	59	41	9174	0	9343
24113	70	44	30	9230	0	9374
24114	36	47	9024	202	0	9309
24115	42	60	139	8962	0	9203
24116	35	41	8873	190	0	9139
24117	47	8679	156	86	0	8968
24118	8445	122	63	81	0	8711
24119	139	8681	60	70	0	8950
24120	8865	126	48	89	0	9128
24121	8964	46	43	76	0	9129
24122	8968	39	45	66	0	9118
24123	8833	32	38	72	0	8975
24124	161	45	8645	49	0	8900
24125	77	40	128	8632	0	8877
24126	79	49	53	8302	0	8483
24127	64	43	41	8726	0	8874
24128	8042	33	42	201	0	8318
24129	8157	34	35	98	0	8324
24130	168	8578	39	72	0	8857
24131	81	108	8409	47	0	8645
24132	60	32	8272	61	0	8425
24133	51	8177	139	66	0	8433
24134	47	8177	66	66	0	8356
24135	187	173	158	7061	0	7579
24136	49	33	25	6722	0	6829
24137	6902	24	12	92	0	7030
24138	76	6893	18	48	0	7035
24139	44	64	28	7048	0	7184
24140	36	24	7170	82	0	7312
24141	26	28	75	7376	0	7505
24142	26	16	24	7487	0	7553
24143	23	12	25	7586	0	7646
24144	33	15	22	7437	0	7507
24145	28	13	7286	110	0	7437
24146	21	6976	77	46	0	7120
24147	23	7110	27	37	0	7197
24148	6850	66	24	33	0	6973
24149	59	6845	13	30	0	6947
24150	29	7070	13	21	0	7133
24151	30	66	11	7069	0	7176
24152	34	18	15	7087	0	7154
24153	33	6	17	7101	0	7157
24154	16	19	7016	73	0	7124
24155	22	6990	50	33	0	7095
24156	23	64	23	6845	0	6955
24157	12	6963	13	53	0	7041
24158	6861	62	13	37	0	6973
24159	57	6886	11	31	0	6985
24160	6861	55	11	47	0	6974
24161	59	22	6822	29	0	6932
24162	6838	25	65	22	0	6950
24163	63	23	15	6987	0	7088
24164	25	22	7051	64	0	7162
24165	6874	21	57	38	0	6990
24166	7025	14	20	31	0	7090
24167	7010	25	12	32	0	7079
24168	83	19	4	6999	0	7105
24169	24	17	7063	70	0	7174
24170	7101	11	53	47	0	7212
24171	59	17	17	7314	0	7407
24172	25	17	21	7337	0	7400
24173	33	13	7459	74	0	7579
24174	15	7413	57	37	0	7522
24175	23	75	13	7203	0	7314
24176	14	7320	14	60	0	7408
24177	7212	55	26	40	0	7333
24178	7193	15	8	27	0	7243
24179	65	21	11	7132	0	7229
24180	7135	9	7	69	0	7220
24181	52	7114	12	32	0	7210
24182	7120	46	13	32	0	7211
24183	60	7169	11	16	0	7256
24184	31	63	7	7236	0	7337
24185	26	19	11	7149	0	7205
24186	22	7168	10	63	0	7263
24187	23	54	14	7143	0	7234
24188	19	24	7117	55	0	7215
24189	15	6983	39	28	0	7065
24190	6761	42	22	24	0	6849
24191	43	6753	13	23	0	6832
24192	21	43	5	6723	0	6792
24193	14	19	6772	48	0	6853
24194	24	19	38	6758	0	6839
24195	22	7	14	6758	0	6801
24196	6584	7	9	74	0	6674
24197	49	16	6590	32	0	6687
24198	30	6628	42	16	0	6716
24199	23	50	6908	17	0	6998
24200	10	14	6869	21	0	6914
24201	7	7	6899	21	0	6934
24202	36	74	62	6834	0	7006
24203	7166	4	40	63	0	7273
24204	56	7168	12	16	0	7252
24205	7342	66	11	14	0	7433
24206	7568	18	4	17	0	7607
24207	81	9	8	7409	0	7507
24208	18	7466	7	70	0	7561
24209	7418	64	9	24	0	7515
24210	68	7464	3	18	0	7553
24211	25	72	5	7336	0	7438
24212	17	18	1	7612	0	7648
24213	12	7600	8	74	0	7694
24214	11	71	5	7650	0	7737
24215	8	19	7508	76	0	7611
24216	5	14	7486	22	0	7527
24217	16	9	77	7586	0	7688
24218	16	9	20	7682	0	7727
24219	9	8	7361	84	0	7462
24220	12	6	7188	26	0	7232
24221	6823	9	73	27	0	6932
24222	68	7132	22	12	0	7234
24223	16	7511	17	15	0	7559
24224	16	79	12	7311	0	7418
24225	14	21	6	7398	0	7439
24226	9	15	7	7461	0	7492
24227	11	10	7372	83	0	7476
24228	9	9	7286	26	0	7330
24229	12	14	78	7472	0	7576
24230	9	10	7377	70	0	7466
24231	5	7298	70	23	0	7396
24232	7276	66	23	29	0	7394
24233	70	15	7268	19	0	7372
24234	19	7	7281	17	0	7324
24235	24	17	79	7382	0	7502
24236	12	9	7880	74	0	7975
24237	9	7988	83	27	0	8107
24238	20	79	22	8098	0	8219
24239	13	26	8175	70	0	8284
24240	7	7990	79	28	0	8104
24241	7855	67	31	18	0	7971
24242	72	21	17	7847	0	7957
24243	21	13	14	7884	0	7932
24244	7830	17	12	90	0	7949
24245	72	7834	7	31	0	7944
24246	7881	70	6	38	0	7995
24247	7873	21	13	33	0	7940
24248	7881	22	7	21	0	7931
24249	101	15	3	7758	0	7877
24250	7543	8	11	88	0	7650
24251	81	7248	14	31	0	7374
24252	41	7434	9	26	0	7510
24253	7759	85	8	25	0	7877
24254	97	33	4	7856	0	7990
24255	42	13	8	7911	0	7974
24256	40	17	10	7948	0	8015
24257	22	19	7729	111	0	7881
24258	26	7749	75	44	0	7894
24259	22	78	22	7924	0	8046
24260	7959	27	16	109	0	8111
24261	92	16	16	7980	0	8104
24262	36	24	7859	104	0	8023
24263	24	7887	77	51	0	8039
24264	7883	80	32	46	0	8041
24265	7872	31	25	41	0	7969
24266	7938	27	18	41	0	8024
24267	116	25	13	8016	0	8170
24268	49	20	7986	105	0	8160
24269	38	22	8177	43	0	8280
24270	32	8440	127	29	0	8628
24271	44	115	41	8415	0	8615
24272	40	34	26	8553	0	8653
24273	8251	20	20	160	0	8451
24274	124	21	24	8394	0	8563
24275	8664	16	20	166	0	8866
24276	140	24	8580	62	0	8806
24277	63	25	8696	40	0	8824
24278	46	17	144	8669	0	8876
24279	38	14	48	8778	0	8878
24280	46	11	37	8957	0	9051
24281	9029	15	35	187	0	9266
24282	9500	14	31	83	0	9628
24283	202	12	31	9661	0	9906
24284	73	15	9525	208	0	9821
24285	49	14	9831	103	0	9997
24286	52	8	224	9879	0	10163
24287	10084	19	73	229	0	10405
24288	208	12	43	10019	0	10282
24289	86	14	43	10253	0	10396
24290	43	9	10099	272	0	10423
24291	43	10	10120	119	0	10292
24292	9905	10	243	88	0	10246
24293	202	11	10083	68	0	10364
24294	101	21	216	9808	0	10146
24295	63	16	88	10078	0	10245
24296	9939	10	57	267	0	10273
24297	208	9826	54	106	0	10194
24298	9725	175	60	83	0	10043
24299	205	9489	43	63	0	9800
24300	9258	167	41	71	0	9537
24301	217	62	9131	58	0	9468
24302	8558	63	239	68	0	8928
24303	8671	23	77	54	0	8825
24304	243	35	40	8537	0	8855
24305	110	17	8429	176	0	8732
24306	82	27	178	8130	0	8417
24307	70	17	78	8192	0	8357
24308	64	8111	57	215	0	8447
24309	68	158	45	7966	0	8237
24310	64	8058	34	192	0	8348
24311	57	159	25	8141	0	8382
24312	8037	64	33	220	0	8354
24313	194	40	38	8081	0	8353
24314	104	38	8008	199	0	8349
24315	8009	33	164	108	0	8314
24316	196	25	8228	85	0	8534
24317	8244	16	185	92	0	8537
24318	8428	23	76	96	0	8623
24319	255	8327	50	80	0	8712
24320	109	8718	45	77	0	8949
24321	8637	206	61	72	0	8976
24322	8900	74	57	69	0	9100
24323	8772	39	47	76	0	8934
24324	8774	37	46	77	0	8934
24325	8797	33	30	89	0	8949
24326	289	34	40	8588	0	8951
24327	159	35	37	8780	0	9011
24328	113	30	8639	245	0	9027
24329	8606	24	177	105	0	8912
24330	250	30	80	8616	0	8976
24331	145	31	51	8763	0	8990
24332	86	40	8686	248	0	9060
24333	103	8362	205	123	0	8793
24334	111	8697	76	87	0	8971
24335	8565	218	60	96	0	8939
24336	8225	75	48	83	0	8431
24337	276	7760	35	78	0	8149
24338	115	7877	42	52	0	8086
24339	7845	208	43	53	0	8149
24340	8091	79	34	57	0	8261
24341	261	48	30	7885	0	8224
24342	129	35	32	8041	0	8237
24343	94	33	32	8171	0	8330
24344	7940	24	33	262	0	8259
24345	8124	32	27	108	0	8291
24346	275	36	31	8109	0	8451
24347	8405	36	36	208	0	8685
24348	245	37	8448	110	0	8840
24349	144	37	173	8522	0	8876
24350	93	47	8520	226	0	8886
24351	89	8440	196	112	0	8837
24352	116	204	87	8383	0	8790
24353	8266	77	50	236	0	8629
24354	231	39	31	8244	0	8545
24355	136	23	41	8305	0	8505
24356	93	29	8145	263	0	8530
24357	85	37	8114	138	0	8374
24358	80	8234	204	89	0	8607
24359	8226	183	83	78	0	8570
24360	8326	74	43	66	0	8509
24361	8337	49	32	71	0	8489
24362	8422	31	43	69	0	8565
24363	302	28	42	8184	0	8556
24364	150	30	29	8177	0	8386
24365	109	8272	27	240	0	8648
24366	8316	169	30	114	0	8629
24367	8309	65	34	74	0	8482
24368	262	45	7991	68	0	8366
24369	7356	27	150	66	0	7599
24370	207	7481	73	48	0	7809
24371	130	273	35	7108	0	7546
24372	89	7464	25	161	0	7739
24373	7394	173	22	105	0	7694
24374	184	7387	25	62	0	7658
24375	103	154	22	7058	0	7337
24376	63	66	18	7159	0	7306
24377	64	34	13	7031	0	7142
24378	58	6876	26	195	0	7155
24379	68	204	26	6851	0	7149
24380	59	111	24	6832	0	7026
24381	38	6285	19	188	0	6530
24382	35	6121	11	69	0	6236
24383	5702	108	17	45	0	5872
24384	113	5743	7	42	0	5905
24385	5470	84	13	40	0	5607
24386	109	31	5388	28	0	5556
24387	52	5198	66	16	0	5332
24388	5175	75	37	31	0	5318
24389	5180	29	10	27	0	5246
24390	93	26	5120	18	0	5257
24391	61	13	62	5112	0	5248
24392	33	19	5191	74	0	5317
24393	25	5111	66	43	0	5245
24394	5041	65	36	32	0	5174
24395	69	5024	15	26	0	5134
24396	28	74	12	5025	0	5139
24397	20	36	10	5133	0	5199
24398	24	18	5097	85	0	5224
24399	24	16	4892	36	0	4968
24400	4904	19	76	37	0	5036
24401	5061	17	25	30	0	5133
24402	5061	12	16	20	0	5109
24403	5060	14	13	25	0	5112
24404	89	5097	12	15	0	5213
24405	56	64	8	5107	0	5235
24406	40	27	10	5131	0	5208
24407	28	5204	10	93	0	5335
24408	5312	60	10	46	0	5428
24409	5364	25	8	35	0	5432
24410	93	23	5345	17	0	5478
24411	5333	14	65	28	0	5440
24412	87	22	31	5338	0	5478
24413	38	18	5338	69	0	5463
24414	35	32	80	5278	0	5425
24415	36	12	5363	80	0	5491
24416	19	13	5185	34	0	5251
24417	29	43	75	5008	0	5155
24418	13	5045	34	57	0	5149
24419	5005	54	19	33	0	5111
24420	4863	27	12	35	0	4937
24421	79	5079	12	13	0	5183
24422	42	5101	9	18	0	5170
24423	5163	68	19	25	0	5275
24424	5155	29	13	19	0	5216
24425	5181	15	7	16	0	5219
24426	5168	14	4	10	0	5196
24427	91	20	6	5186	0	5303
24428	50	7	5179	52	0	5288
24429	28	5161	45	28	0	5262
24430	5078	53	29	22	0	5182
24431	57	5240	10	13	0	5320
24432	5188	48	10	15	0	5261
24433	5186	25	9	10	0	5230
24434	67	14	5295	10	0	5386
24435	38	5411	41	6	0	5496
24436	26	42	18	5380	0	5466
24437	18	24	11	5442	0	5495
24438	21	14	11	5241	0	5287
24439	5339	13	5	64	0	5421
24440	5206	12	5	34	0	5257
24441	5241	8	6	22	0	5277
24442	60	5241	3	17	0	5321
24443	5167	35	5	17	0	5224
24444	42	5229	5	12	0	5288
24445	25	42	5177	13	0	5257
24446	12	5123	24	11	0	5170
24447	47	77	41	4736	0	4901
24448	16	6	9	4625	0	4656
24449	8	8	4605	22	0	4643
24450	11	8	17	4496	0	4532
24451	9	6	6	4548	0	4569
24452	4603	4	6	28	0	4641
24453	4541	3	10	17	0	4571
24454	4591	7	4	13	0	4615
24455	34	4621	6	9	0	4670
24456	4594	24	5	15	0	4638
24457	4497	10	8	13	0	4528
24458	28	4613	3	11	0	4655
24459	20	18	14	4613	0	4665
24460	17	15	7	4626	0	4665
24461	4645	12	3	35	0	4695
24462	26	8	4576	17	0	4627
24463	15	4481	22	13	0	4531
24464	14	57	8	4320	0	4399
24465	12	4280	5	21	0	4318
24466	13	4308	2	9	0	4332
24467	4333	21	5	17	0	4376
24468	4330	10	2	8	0	4350
24469	32	9	3	4347	0	4391
24470	18	5	4	4240	0	4267
24471	8	11	5	4250	0	4274
24472	12	8	6	4232	0	4258
24473	8	8	4163	31	0	4210
24474	4	7	3976	19	0	4006
24475	7	5	27	4240	0	4279
24476	13	5	4464	26	0	4508
24477	10	4535	26	12	0	4583
24478	4561	27	9	15	0	4612
24479	4621	8	5	16	0	4650
24480	34	6	4	4671	0	4715
24481	15	8	4	4700	0	4727
24482	21	6	2	4740	0	4769
24483	19	4802	3	32	0	4856
24484	4807	30	2	21	0	4860
24485	4821	12	0	18	0	4851
24486	46	5	4807	8	0	4866
24487	22	5	37	5108	0	5172
24488	6	13	5266	47	0	5332
24489	9	7	48	5647	0	5711
24490	16	9	8	5610	0	5643
24491	15	7	5	5584	0	5611
24492	17	6	9	5812	0	5844
24493	5827	7	4	92	0	5930
24494	5954	2	3	51	0	6010
24495	6103	6	2	39	0	6150
24496	95	3	1	6097	0	6196
24497	39	5	6003	78	0	6125
24498	5927	4	66	28	0	6025
24499	83	6	21	6082	0	6192
24500	6102	1	13	76	0	6192
24501	75	7	10	6063	0	6155
24502	28	5936	8	79	0	6051
24503	15	6232	8	30	0	6285
24504	32	83	9	6190	0	6314
24505	22	27	10	6195	0	6254
24506	19	20	5	6211	0	6255
24507	12	6125	5	100	0	6242
24508	6067	65	6	45	0	6183
24509	74	6086	5	29	0	6194
24510	29	69	6098	18	0	6214
24511	27	25	63	6073	0	6188
24512	15	6221	19	74	0	6329
24513	16	73	14	6210	0	6313
24514	18	21	10	6254	0	6303
24515	17	13	6207	97	0	6334
24516	5928	8	67	52	0	6055
24517	71	6391	23	33	0	6518
24518	6432	67	10	38	0	6547
24519	6557	21	11	22	0	6611
24520	6578	11	4	28	0	6621
24521	99	12	6261	24	0	6396
24522	53	6	73	6161	0	6293
24523	36	7	19	6225	0	6287
24524	27	12	6105	92	0	6236
24525	5763	8	78	48	0	5897
24526	85	10	6136	35	0	6266
24527	26	10	6059	33	0	6128
24528	16	6124	83	24	0	6247
24529	33	84	28	6080	0	6225
24530	19	16	6102	83	0	6220
24531	5794	15	77	40	0	5926
24532	5911	13	22	32	0	5978
24533	94	14	5999	16	0	6123
24534	39	13	77	5970	0	6099
24535	23	8	5995	81	0	6107
24536	24	6031	79	32	0	6166
24537	6264	71	30	26	0	6391
24538	6387	24	15	26	0	6452
24539	6478	14	12	24	0	6528
24540	113	10	10	6457	0	6590
24541	43	10	14	6581	0	6648
24542	32	4	6479	107	0	6622
24543	6429	12	84	43	0	6568
24544	105	5	26	6522	0	6658
24545	6460	9	17	100	0	6586
24546	107	6	6510	33	0	6656
24547	41	6	6641	23	0	6711
24548	30	10	103	6499	0	6642
24549	29	5	39	6752	0	6825
24550	21	8	6709	110	0	6848
24551	6524	9	93	49	0	6675
24552	98	5	33	6602	0	6738
24553	32	6814	25	99	0	6970
24554	6961	85	26	43	0	7115
24555	102	7007	18	24	0	7151
24556	7074	91	14	36	0	7215
24557	114	26	7233	24	0	7397
24558	52	16	7056	19	0	7143
24559	35	7168	116	16	0	7335
24560	7189	97	38	31	0	7355
24561	117	25	7147	20	0	7309
24562	6974	17	105	31	0	7127
24563	117	7149	42	21	0	7329
24564	59	98	31	7268	0	7456
24565	38	24	19	7255	0	7336
24566	27	6984	24	113	0	7148
24567	7415	96	19	50	0	7580
24568	7580	26	20	37	0	7663
24569	7778	17	18	35	0	7848
24570	134	21	7756	29	0	7940
24571	61	10	102	7760	0	7933
24572	32	11	41	7880	0	7964
24573	38	17	22	8002	0	8079
24574	35	16	7836	130	0	8017
24575	30	7681	102	50	0	7863
24576	7493	93	38	35	0	7659
24577	117	31	7557	25	0	7730
24578	7381	23	106	33	0	7543
24579	112	7536	46	21	0	7715
24580	7577	95	23	30	0	7725
24581	123	43	26	7488	0	7680
24582	7647	24	28	101	0	7800
24583	127	22	19	7658	0	7826
24584	51	18	7811	109	0	7989
24585	49	76	97	7685	0	7907
24586	30	20	7727	103	0	7880
24587	7127	16	84	51	0	7278
24588	83	7281	37	38	0	7439
24589	39	94	19	6743	0	6895
24590	27	7062	21	66	0	7176
24591	6959	64	32	41	0	7096
24592	6876	22	25	39	0	6962
24593	77	6834	16	16	0	6943
24594	6796	56	17	36	0	6905
24595	6837	22	20	28	0	6907
24596	78	11	12	6771	0	6872
24597	29	16	12	6816	0	6873
24598	6913	13	13	82	0	7021
24599	7033	9	15	31	0	7088
24600	86	14	13	6967	0	7080
24601	49	13	8	7363	0	7433
24602	7491	9	15	87	0	7602
24603	79	9	7441	36	0	7565
24604	7126	20	59	38	0	7243
24605	84	10	7339	20	0	7453
24606	43	7251	70	20	0	7384
24607	43	58	34	7237	0	7372
24608	32	23	7381	60	0	7496
24609	30	7467	66	26	0	7589
24610	7361	64	28	47	0	7500
24611	64	29	7460	22	0	7575
24612	7254	20	66	26	0	7366
24613	7501	23	22	28	0	7574
24614	7589	13	15	25	0	7642
24615	91	15	18	7309	0	7433
24616	54	7409	19	54	0	7536
24617	7316	57	11	46	0	7430
24618	84	20	7410	20	0	7534
24619	6844	10	54	49	0	6957
24620	82	11	7396	20	0	7509
24621	35	7307	50	27	0	7419
24622	30	51	23	7387	0	7491
24623	32	20	26	7340	0	7418
24624	25	7266	25	59	0	7375
24625	34	58	16	7386	0	7494
24626	30	27	7418	67	0	7542
24627	26	7385	60	30	0	7501
24628	23	67	26	7309	0	7425
24629	7294	32	15	75	0	7416
24630	7556	22	20	38	0	7636
24631	92	21	15	7697	0	7825
24632	44	7876	18	69	0	8007
24633	43	59	17	7834	0	7953
24634	37	25	14	7771	0	7847
24635	37	15	7507	87	0	7646
24636	32	7514	58	44	0	7648
24637	27	61	23	7410	0	7521
24638	22	26	7320	64	0	7432
24639	13	7262	50	36	0	7361
24640	35	53	22	7292	0	7402
24641	7263	25	23	71	0	7382
24642	62	7363	16	27	0	7468
24643	41	54	10	7429	0	7534
24644	7537	28	12	71	0	7648
24645	7607	17	8	49	0	7681
24646	7557	17	9	52	0	7635
24647	7461	19	12	33	0	7525
24648	91	18	7	7397	0	7513
24649	43	9	7425	75	0	7552
24650	41	27	55	7251	0	7374
24651	33	7349	20	61	0	7463
24652	7438	52	14	40	0	7544
24653	65	23	7236	34	0	7358
24654	6941	16	44	40	0	7041
24655	57	18	7054	19	0	7148
24656	48	22	49	6987	0	7106
24657	29	21	7000	46	0	7096
24658	30	17	47	6953	0	7047
24659	24	18	6992	52	0	7086
24660	34	10	42	6927	0	7013
24661	7023	9	29	59	0	7120
24662	53	7315	18	41	0	7427
24663	34	47	20	7365	0	7466
24664	35	22	24	7317	0	7398
24665	32	15	7430	63	0	7540
24666	32	21	7095	34	0	7182
24667	6998	13	61	47	0	7119
24668	47	7170	33	36	0	7286
24669	7043	33	51	33	0	7160
24670	7081	18	29	32	0	7160
24671	62	12	22	7063	0	7159
24672	29	7257	24	49	0	7359
24673	7431	41	21	51	0	7544
24674	7524	27	16	28	0	7595
24675	7582	14	14	48	0	7658
24676	7608	21	13	28	0	7670
24677	7512	12	18	31	0	7573
24678	70	15	7390	25	0	7500
24679	7364	14	44	21	0	7443
24680	79	14	7439	20	0	7552
24681	53	16	49	7297	0	7415
24682	47	18	19	7511	0	7595
24683	41	17	7370	60	0	7488
24684	7290	11	50	46	0	7397
24685	75	8	31	7553	0	7667
24686	43	12	19	7709	0	7783
24687	36	19	20	7799	0	7874
24688	40	8	19	7773	0	7840
24689	39	11	18	7860	0	7928
24690	25	13	7857	96	0	7991
24691	32	9	69	7827	0	7937
24692	23	12	7964	89	0	8088
24693	24	14	7750	52	0	7840
24694	7943	9	82	46	0	8080
24695	8214	4	45	42	0	8305
24696	8695	3	26	41	0	8765
24697	119	8	8964	38	0	9129
24698	51	15	9075	30	0	9171
24699	45	4	9259	34	0	9342
24700	31	9561	146	37	0	9775
24701	55	150	122	9533	0	9860
24702	9928	41	44	144	0	10157
24703	133	15	21	10465	0	10634
24704	67	10655	28	127	0	10877
24705	10798	119	22	84	0	11023
24706	148	55	26	10714	0	10943
24707	84	10845	25	137	0	11091
24708	40	123	37	10936	0	11136
24709	37	50	31	10921	0	11039
24710	10758	25	31	202	0	11016
24711	155	17	26	10719	0	10917
24712	84	28	10603	159	0	10874
24713	62	17	144	10485	0	10708
24714	42	10263	70	179	0	10554
24715	41	10599	50	91	0	10781
24716	45	179	38	10351	0	10613
24717	32	91	33	10348	0	10504
24718	32	10190	33	223	0	10478
24719	37	10215	25	134	0	10411
24720	48	10436	30	75	0	10589
24721	59	218	17	9815	0	10109
24722	48	10395	18	168	0	10629
24723	10296	172	25	134	0	10627
24724	163	101	10411	107	0	10782
24725	104	84	140	10174	0	10502
24726	62	10505	74	178	0	10819
24727	10388	165	36	153	0	10742
24728	162	117	10470	91	0	10840
24729	88	10427	144	98	0	10757
24730	10253	180	82	92	0	10607
24731	158	10094	35	78	0	10365
24732	73	10218	44	75	0	10410
24733	63	229	44	10072	0	10408
24734	34	10236	29	184	0	10483
24735	10155	196	22	123	0	10496
24736	151	136	33	10147	0	10467
24737	88	92	10051	180	0	10411
24738	61	83	10002	112	0	10258
24739	42	109	175	10040	0	10366
24740	49	99	10187	157	0	10492
24741	53	85	144	10187	0	10469
24742	9967	79	81	199	0	10326
24743	159	86	10025	111	0	10381
24744	107	81	138	9827	0	10153
24745	56	9785	99	169	0	10109
24746	49	175	62	10036	0	10322
24747	56	125	42	10032	0	10255
24748	64	9846	59	200	0	10169
24749	42	173	60	10216	0	10491
24750	43	137	48	10289	0	10517
24751	52	81	10134	225	0	10492
24752	35	10066	151	133	0	10385
24753	10074	183	90	106	0	10453
24754	149	116	58	10179	0	10502
24755	92	81	10192	191	0	10556
24756	67	72	168	10167	0	10474
24757	30	66	10129	219	0	10444
24758	9779	58	184	162	0	10183
24759	145	10070	117	93	0	10425
24760	100	155	64	10225	0	10544
24761	70	102	70	10373	0	10615
24762	9955	62	52	269	0	10338
24763	165	53	66	10062	0	10346
24764	90	62	9937	220	0	10309
24765	59	61	173	9685	0	9978
24766	46	9532	99	213	0	9890
24767	41	9803	59	166	0	10069
24768	39	9959	52	139	0	10189
24769	48	232	52	9843	0	10175
24770	59	127	9699	217	0	10102
24771	43	9640	145	171	0	9999
24772	9406	170	113	128	0	9817
24773	137	9528	67	120	0	9852
24774	9554	169	50	121	0	9894
24775	9528	106	64	117	0	9815
24776	198	71	9476	98	0	9843
24777	9682	70	154	113	0	10019
24778	10032	54	114	116	0	10316
24779	9504	71	59	126	0	9760
24780	10014	73	46	103	0	10236
24781	188	75	9895	104	0	10262
24782	9895	75	142	96	0	10208
24783	10218	75	84	97	0	10474
24784	201	10414	55	85	0	10755
24785	119	182	42	10217	0	10560
24786	81	137	33	10186	0	10437
24787	75	10200	37	205	0	10517
24788	10112	169	49	124	0	10454
24789	157	10197	59	69	0	10482
24790	9980	166	45	59	0	10250
24791	10056	112	45	57	0	10270
24792	224	10075	40	33	0	10372
24793	158	161	32	10044	0	10395
24794	94	101	10113	136	0	10444
24795	104	9866	135	96	0	10201
24796	117	269	78	9106	0	9570
24797	67	9240	50	99	0	9456
24798	72	9797	20	60	0	9949
24799	103	283	49	9189	0	9624
24800	45	83	9447	121	0	9696
24801	34	9045	121	76	0	9276
24802	28	8913	72	36	0	9049
24803	8116	137	67	27	0	8347
24804	98	55	8	8206	0	8367
24805	59	28	6	8282	0	8375
24806	22	17	5	8456	0	8500
24807	15	14	8412	155	0	8596
24808	20	16	101	8495	0	8632
24809	7	8671	53	125	0	8856
24810	8968	120	13	65	0	9166
24811	118	57	9	9010	0	9194
24812	51	20	8973	134	0	9178
24813	9121	19	119	68	0	9327
24814	137	22	55	9431	0	9645
24815	62	21	9966	127	0	10176
24816	25	19	9988	66	0	10098
24817	10182	22	186	40	0	10430
24818	10611	15	71	45	0	10742
24819	10582	17	30	32	0	10661
24820	10757	11	26	32	0	10826
24821	222	21	10601	27	0	10871
24822	96	10702	143	25	0	10966
24823	10718	145	63	47	0	10973
24824	159	10693	28	30	0	10910
24825	10702	155	21	30	0	10908
24826	172	10717	17	35	0	10941
24827	91	162	24	10670	0	10947
24828	46	79	20	10704	0	10849
24829	45	27	19	10639	0	10730
24830	34	10411	25	219	0	10689
24831	31	10548	24	109	0	10712
24832	51	198	19	10232	0	10500
24833	33	10343	27	158	0	10561
24834	35	168	10308	74	0	10585
24835	47	78	152	10273	0	10550
24836	35	37	10356	168	0	10596
24837	10106	42	161	99	0	10408
24838	10285	34	84	42	0	10445
24839	229	38	10246	29	0	10542
24840	108	29	10160	31	0	10328
24841	53	38	207	10092	0	10390
24842	45	33	10197	169	0	10444
24843	43	35	169	9815	0	10062
24844	38	9062	92	169	0	9361
24845	37	193	32	10164	0	10426
24846	31	96	33	10248	0	10408
24847	31	41	29	10261	0	10362
24848	19	52	9948	252	0	10271
24849	35	39	163	9878	0	10115
24850	35	41	78	9926	0	10080
24851	32	33	48	9740	0	9853
24852	35	9851	40	220	0	10146
24853	9858	165	36	120	0	10179
24854	9903	81	44	76	0	10104
24855	9924	28	49	59	0	10060
24856	248	31	40	9731	0	10050
24857	108	29	9628	187	0	9952
24858	103	26	9518	117	0	9764
24859	47	9646	216	63	0	9972
24860	9431	161	100	73	0	9765
24861	162	9551	48	59	0	9820
24862	9576	169	40	75	0	9860
24863	173	9548	45	60	0	9826
24864	9495	182	36	64	0	9777
24865	182	9851	39	67	0	10139
24866	116	175	30	9911	0	10232
24867	59	111	9777	197	0	10144
24868	69	55	9917	116	0	10157
24869	65	44	223	9816	0	10148
24870	52	50	96	9926	0	10124
24871	56	48	49	10056	0	10209
24872	55	39	9865	253	0	10212
24873	56	37	174	9758	0	10025
24874	9561	43	105	216	0	9925
24875	9658	34	44	133	0	9869
24876	240	9501	48	68	0	9857
24877	9332	165	39	75	0	9611
24878	186	9237	42	66	0	9531
24879	9217	182	46	57	0	9502
24880	9239	110	42	57	0	9448
24881	9063	51	40	64	0	9218
24882	249	58	8967	47	0	9321
24883	119	43	8817	59	0	9038
24884	8619	38	224	59	0	8940
24885	8885	25	108	75	0	9093
24886	246	35	66	8798	0	9145
24887	140	23	47	9067	0	9277
24888	88	29	40	9263	0	9420
24889	66	29	44	9391	0	9530
24890	69	34	50	9619	0	9772
24891	9414	45	31	272	0	9762
24892	207	41	32	9504	0	9784
24893	129	45	9377	204	0	9755
24894	9164	40	151	141	0	9496
24895	9444	38	94	83	0	9659
24896	252	9297	38	78	0	9665
24897	121	9324	32	76	0	9553
24898	8498	131	32	45	0	8706
24899	112	8740	18	44	0	8914
24900	8501	127	63	46	0	8737
24901	9061	49	16	43	0	9169
24902	9102	24	17	40	0	9183
24903	187	25	14	8816	0	9042
24904	89	8834	21	136	0	9080
24905	8936	97	19	71	0	9123
24906	143	60	19	8877	0	9099
24907	85	26	13	8685	0	8809
24908	8360	15	17	162	0	8554
24909	117	8237	16	86	0	8456
24910	75	107	11	8108	0	8301
24911	8166	61	6	127	0	8360
24912	131	8244	4	62	0	8441
24913	8257	96	5	51	0	8409
24914	145	56	7600	28	0	7829
24915	7630	30	60	32	0	7752
24916	126	7786	27	19	0	7958
24917	7618	88	41	24	0	7771
24918	7591	40	5	24	0	7660
24919	127	7686	6	19	0	7838
24920	7615	81	0	26	0	7722
24921	118	7498	5	13	0	7634
24922	7660	98	1	19	0	7778
24923	124	51	7	7653	0	7835
24924	82	31	3	7636	0	7752
24925	56	18	3	7696	0	7773
24926	31	23	7457	135	0	7646
24927	41	15	77	7516	0	7649
24928	28	21	7491	116	0	7656
24929	40	20	96	7463	0	7619
24930	30	7496	41	109	0	7676
24931	38	89	27	7617	0	7771
24932	30	52	7581	113	0	7776
24933	31	34	7695	60	0	7820
24934	33	25	105	7712	0	7875
24935	7678	14	57	101	0	7850
24936	7723	16	23	81	0	7843
24937	136	7724	22	45	0	7927
24938	89	86	10	7797	0	7982
24939	46	50	7879	105	0	8080
24940	39	32	84	7907	0	8062
24941	25	23	7921	126	0	8095
24942	7774	23	105	85	0	7987
24943	114	15	49	7971	0	8149
24944	67	21	7837	108	0	8033
24945	59	15	94	7870	0	8038
24946	39	20	57	7973	0	8089
24947	36	13	7908	163	0	8120
24948	38	20	102	7921	0	8081
24949	7901	14	56	140	0	8111
24950	8019	15	35	83	0	8152
24951	146	14	20	8097	0	8277
24952	8134	16	18	128	0	8296
24953	139	21	8101	74	0	8335
24954	72	24	7989	55	0	8140
24955	8103	9	135	61	0	8308
24956	8337	10	78	48	0	8473
24957	157	10	44	8197	0	8408
24958	91	12	31	8324	0	8458
24959	64	14	8210	155	0	8443
24960	42	23	103	7950	0	8118
24961	33	8156	64	133	0	8386
24962	8242	95	41	72	0	8450
24963	8805	51	28	57	0	8941
24964	166	8798	30	52	0	9046
24965	8533	117	19	44	0	8713
24966	8565	59	26	40	0	8690
24967	188	8600	22	38	0	8848
24968	8596	127	19	50	0	8792
24969	167	8622	31	41	0	8861
24970	8687	139	27	44	0	8897
24971	171	67	8613	33	0	8884
24972	102	43	127	8634	0	8906
24973	76	22	57	8871	0	9026
24974	50	28	49	9161	0	9288
24975	9084	19	25	247	0	9375
24976	171	17	32	9368	0	9588
24977	100	15	9321	195	0	9631
24978	9371	25	153	106	0	9655
24979	199	21	64	9349	0	9633
24980	109	9138	47	189	0	9483
24981	67	9475	31	108	0	9681
24982	60	194	30	9331	0	9615
24983	62	84	31	9359	0	9536
24984	50	47	35	9447	0	9579
24985	52	30	9043	255	0	9380
24986	39	8929	149	136	0	9253
24987	8739	141	65	95	0	9040
24988	8618	68	49	74	0	8809
24989	196	8410	37	70	0	8713
24990	90	8416	33	51	0	8590
24991	121	209	53	8117	0	8500
24992	53	75	8060	159	0	8347
24993	7739	63	146	80	0	8028
24994	7900	34	57	60	0	8051
24995	181	21	38	7821	0	8061
24996	82	22	29	7843	0	7976
24997	7600	13	17	195	0	7825
24998	155	15	7532	90	0	7792
24999	7274	20	124	77	0	7495
25000	162	7277	52	50	0	7541
25001	54	94	20	6569	0	6737
25002	33	6647	15	98	0	6793
25003	6710	97	23	54	0	6884
25004	115	30	20	6606	0	6771
25005	60	22	12	6560	0	6654
25006	26	6528	14	116	0	6684
25007	6558	96	7	54	0	6715
25008	6594	37	7	36	0	6674
25009	127	27	6514	32	0	6700
25010	57	15	6304	30	0	6406
25011	6273	14	100	26	0	6413
25012	106	17	6274	19	0	6416
25013	52	14	6006	20	0	6092
25014	5919	11	115	30	0	6075
25015	91	15	6369	16	0	6491
25016	52	9	112	6409	0	6582
25017	32	7	48	6522	0	6609
25018	6838	3	34	161	0	7036
25019	149	8	7016	57	0	7230
25020	7420	13	142	40	0	7615
25021	178	16	54	7516	0	7764
25022	7566	11	37	163	0	7777
25023	7674	5	26	69	0	7774
25024	7708	6	16	51	0	7781
25025	249	8	25	7541	0	7823
25026	7677	6	15	173	0	7871
25027	243	2	17	7646	0	7908
25028	138	8	15	7705	0	7866
25029	109	4	15	7743	0	7871
25030	100	8	7	7772	0	7887
25031	7598	7	10	268	0	7883
25032	7660	12	16	132	0	7820
25033	233	8	7579	115	0	7935
25034	7707	6	154	89	0	7956
25035	7862	3	55	96	0	8016
25036	253	3	42	7675	0	7973
25037	138	7617	19	207	0	7981
25038	7741	148	31	92	0	8012
25039	248	43	27	7536	0	7854
25040	7533	39	19	195	0	7786
25041	241	7457	34	86	0	7818
25042	7603	166	17	80	0	7866
25043	252	66	13	7479	0	7810
25044	114	7438	7	206	0	7765
25045	7590	179	13	92	0	7874
25046	226	7431	16	81	0	7754
25047	102	7750	10	70	0	7932
25048	7780	194	13	64	0	8051
25049	211	108	7594	57	0	7970
25050	7725	76	150	47	0	7998
25051	266	45	49	7602	0	7962
25052	115	52	7630	188	0	7985
25053	125	48	173	7542	0	7888
25054	111	44	65	7790	0	8010
25055	99	30	7690	239	0	8058
25056	7684	21	180	136	0	8021
25057	246	23	82	7733	0	8084
25058	138	17	61	7874	0	8090
25059	105	18	33	7878	0	8034
25060	7691	21	39	323	0	8074
25061	228	16	7533	178	0	7955
25062	123	13	7566	140	0	7842
25063	98	27	174	7136	0	7435
25064	86	21	7044	209	0	7360
25065	6914	13	185	132	0	7244
25066	199	6961	75	120	0	7355
25067	6915	136	93	91	0	7235
25068	242	58	61	6727	0	7088
25069	122	6814	58	173	0	7167
25070	106	180	59	6793	0	7138
25071	93	6851	44	205	0	7193
25072	99	193	39	6891	0	7222
25073	98	77	6741	212	0	7128
25074	61	81	6443	116	0	6701
25075	72	6490	147	109	0	6818
25076	6179	128	85	102	0	6494
25077	151	78	58	6123	0	6410
25078	84	66	42	6156	0	6348
25079	6099	62	42	175	0	6378
25080	6120	39	37	115	0	6311
25081	189	36	49	6091	0	6365
25082	105	35	6021	155	0	6316
25083	115	6011	130	74	0	6330
25084	93	116	49	6120	0	6378
25085	77	49	63	6087	0	6276
25086	85	6193	41	177	0	6496
25087	6271	134	33	130	0	6568
25088	177	52	6270	96	0	6595
25089	82	60	125	6244	0	6511
25090	61	53	60	6268	0	6442
25091	45	54	6226	210	0	6535
25092	63	44	131	6300	0	6538
25093	6344	39	61	222	0	6666
25094	6344	39	80	105	0	6568
25095	6404	26	66	105	0	6601
25096	200	6265	57	97	0	6619
25097	6558	113	55	93	0	6819
25098	212	54	46	6501	0	6813
25099	122	48	48	6512	0	6730
25100	112	6980	39	190	0	7321
25101	7508	145	37	125	0	7815
25102	7916	82	21	100	0	8119
25103	8000	66	26	87	0	8179
25104	8140	70	34	89	0	8333
25105	8195	45	25	93	0	8358
25106	289	44	7983	85	0	8401
25107	8170	44	172	79	0	8465
25108	8313	57	70	81	0	8521
25109	8266	31	80	59	0	8436
25110	336	13	55	8029	0	8433
25111	206	21	46	8100	0	8373
25112	161	19	7865	227	0	8272
25113	6978	24	163	152	0	7317
25114	219	7695	84	124	0	8122
25115	134	7370	54	79	0	7637
25116	116	145	7177	65	0	7503
25117	88	7041	108	64	0	7301
25118	59	6853	66	55	0	7033
25119	125	251	96	5927	0	6399
25120	23	6035	35	95	0	6188
25121	5922	103	9	35	0	6069
25122	5861	42	18	37	0	5958
25123	119	39	10	5809	0	5977
25124	80	19	5780	76	0	5955
25125	5704	13	77	37	0	5831
25126	105	17	5815	39	0	5976
25127	60	7	5852	26	0	5945
25128	65	11	106	5640	0	5822
25129	49	5	48	5812	0	5914
25130	34	7	5843	110	0	5994
25131	31	5668	84	61	0	5844
25132	25	5940	45	54	0	6064
25133	5896	98	48	39	0	6081
25134	5954	48	22	24	0	6048
25135	104	30	5839	14	0	5987
25136	5818	21	70	22	0	5931
25137	6068	16	30	19	0	6133
25138	115	18	23	5977	0	6133
25139	74	10	17	6033	0	6134
25140	54	15	11	6063	0	6143
25141	6008	13	7	115	0	6143
25142	6055	6	8	67	0	6136
25143	6106	2	13	44	0	6165
25144	136	8	6	6036	0	6186
25145	87	9	5909	71	0	6076
25146	5866	7	68	42	0	5983
25147	5852	8	33	36	0	5929
25148	117	15	26	5754	0	5912
25149	81	5826	20	71	0	5998
25150	62	67	8	5818	0	5955
25151	41	5904	18	79	0	6042
25152	47	90	12	5767	0	5916
25153	40	5937	12	84	0	6073
25154	5821	79	18	47	0	5965
25155	89	51	12	5802	0	5954
25156	50	5781	13	82	0	5926
25157	30	84	5772	37	0	5923
25158	5662	41	68	38	0	5809
25159	85	42	28	5707	0	5862
25160	52	5694	24	73	0	5843
25161	40	77	15	5599	0	5731
25162	36	5547	10	74	0	5667
25163	33	5812	12	36	0	5893
25164	5796	86	16	39	0	5937
25165	5874	51	15	33	0	5973
25166	90	40	5863	14	0	6007
25167	5807	13	67	27	0	5914
25168	5865	19	38	23	0	5945
25169	101	5785	26	18	0	5930
25170	62	63	19	5782	0	5926
25171	52	35	13	5765	0	5865
25172	29	29	5708	86	0	5852
25173	42	21	5601	42	0	5706
25174	5688	11	84	38	0	5821
25175	5807	13	50	21	0	5891
25176	5806	6	31	27	0	5870
25177	120	7	5701	20	0	5848
25178	70	7	69	5652	0	5798
25179	5701	12	39	78	0	5830
25180	94	9	20	5703	0	5826
25181	55	6	5608	83	0	5752
25182	5423	10	60	60	0	5553
25183	81	12	5803	30	0	5926
25184	56	5656	73	31	0	5816
25185	5693	59	44	22	0	5818
25186	70	34	5614	31	0	5749
25187	52	28	63	5545	0	5688
25188	5575	15	41	62	0	5693
25189	78	14	23	5613	0	5728
25190	5654	16	16	82	0	5768
25191	84	13	10	5574	0	5681
25192	5675	12	16	84	0	5787
25193	5621	12	7	64	0	5704
25194	5622	12	5	36	0	5675
25195	5565	12	6	32	0	5615
25196	116	37	16	5533	0	5702
25197	62	15	5351	58	0	5486
25198	56	10	5333	33	0	5432
25199	34	5295	71	25	0	5425
25200	20	4824	35	19	0	4898
25201	4226	65	109	15	0	4415
25202	28	10	17	4050	0	4105
25203	8	3	4109	16	0	4136
25204	3	4	4119	9	0	4135
25205	10	17	22	4127	0	4176
25206	4112	2	8	25	0	4147
25207	18	4139	5	11	0	4173
25208	4286	14	2	10	0	4312
25209	22	8	4	4336	0	4370
25210	13	0	3	4342	0	4358
25211	7	1	5	4348	0	4361
25212	5	3	4339	23	0	4370
25213	6	3	4250	7	0	4266
25214	3	4277	20	12	0	4312
25215	7	18	6	4354	0	4385
25216	4292	7	2	28	0	4329
25217	21	3	4213	6	0	4243
25218	9	3	4235	6	0	4253
25219	6	3	25	4317	0	4351
25220	6	3	9	4423	0	4441
25221	7	0	5	4466	0	4478
25222	10	2	4	4788	0	4804
25223	4895	3	4	56	0	4958
25224	51	1	2	5007	0	5061
25225	5055	2	1	68	0	5126
25226	56	2	5121	15	0	5194
25227	12	5191	51	11	0	5265
25228	13	48	12	5212	0	5285
25229	7	9	5268	65	0	5349
25230	9	1	5205	20	0	5235
25231	12	5218	61	11	0	5302
25232	18	49	10	5083	0	5160
25233	12	10	4	5090	0	5116
25234	9	2	5097	57	0	5165
25235	4963	5	63	19	0	5050
25236	56	6	13	5108	0	5183
25237	15	5	6	5040	0	5066
25238	4	3	5128	67	0	5202
25239	8	5066	61	22	0	5157
25240	7	5546	9	13	0	5575
25241	5684	74	5	21	0	5784
25242	78	11	10	5743	0	5842
25243	5978	8	10	88	0	6084
25244	90	9	5970	28	0	6097
25245	30	8	88	5999	0	6125
25246	6030	8	26	99	0	6163
25247	6131	6	8	34	0	6179
25248	117	9	7	6078	0	6211
25249	33	6	6017	100	0	6156
25250	15	4	6137	30	0	6186
25251	16	9	93	6047	0	6165
25252	21	7	6059	89	0	6176
25253	5797	2	88	44	0	5931
25254	94	5996	24	29	0	6143
25255	6065	82	17	20	0	6184
25256	6138	27	18	27	0	6210
25257	113	6	16	6128	0	6263
25258	28	12	28	6193	0	6261
25259	6171	16	14	119	0	6320
25260	103	11	14	6171	0	6299
25261	33	7	6149	99	0	6288
25262	22	6130	99	39	0	6290
25263	24	92	28	6050	0	6194
25264	32	23	11	6067	0	6133
25265	34	6	13	6093	0	6146
25266	18	11	5964	128	0	6121
25267	25	5896	93	51	0	6065
25268	21	88	29	5995	0	6133
25269	15	21	5941	111	0	6088
25270	21	13	107	5935	0	6076
25271	5960	23	26	111	0	6120
25272	108	14	15	6018	0	6155
25273	39	13	5967	107	0	6126
25274	5872	9	92	68	0	6041
25275	102	6055	41	26	0	6224
25276	33	6271	23	39	0	6366
25277	6347	87	24	49	0	6507
25278	112	25	6460	29	0	6626
25279	46	14	99	6427	0	6586
25280	34	14	30	6605	0	6683
25281	26	18	6580	122	0	6746
25282	28	6532	105	58	0	6723
25283	47	88	32	6021	0	6188
25284	21	26	6477	108	0	6632
25285	30	18	109	6468	0	6625
25286	6486	26	37	119	0	6668
25287	114	14	6605	50	0	6783
25288	47	16	92	6662	0	6817
25289	28	15	33	6717	0	6793
25290	35	22	6566	130	0	6753
25291	39	18	95	6410	0	6562
25292	31	5803	46	130	0	6010
25293	39	91	44	6102	0	6276
25294	29	6480	33	121	0	6663
25295	6491	95	26	69	0	6681
25296	6376	30	42	59	0	6507
25297	115	16	6395	67	0	6593
25298	39	23	6312	47	0	6421
25299	29	21	6204	47	0	6301
25300	28	6216	116	51	0	6411
25301	32	111	62	6340	0	6545
25302	36	30	6413	107	0	6586
25303	43	17	104	6158	0	6322
25304	34	22	46	6265	0	6367
25305	42	12	6336	138	0	6528
25306	41	26	107	6329	0	6503
25307	27	22	40	6229	0	6318
25308	30	6138	42	128	0	6338
25309	36	91	32	6271	0	6430
25310	19	31	36	6468	0	6554
25311	30	22	6340	140	0	6532
25312	30	23	98	6292	0	6443
25313	21	17	6340	138	0	6516
25314	27	26	6255	65	0	6373
25315	6170	9	123	76	0	6378
25316	91	33	63	6101	0	6288
25317	29	6346	36	124	0	6535
25318	29	6485	41	55	0	6610
25319	28	134	46	6460	0	6668
25320	24	30	6447	139	0	6640
25321	34	6433	122	56	0	6645
25322	25	93	42	6158	0	6318
25323	25	26	6217	87	0	6355
25324	21	6182	68	45	0	6316
25325	6421	78	40	45	0	6584
25326	6402	33	30	36	0	6501
25327	6392	21	19	44	0	6476
25328	91	11	28	6833	0	6963
25329	37	17	30	6887	0	6971
25330	19	13	24	6928	0	6984
25331	13	15	6880	124	0	7032
25332	6900	19	84	66	0	7069
25333	93	12	44	6889	0	7038
25334	26	24	6690	93	0	6833
25335	6932	15	73	57	0	7077
25336	7145	11	42	51	0	7249
25337	106	44	5698	51	0	5899
25338	6985	9	55	61	0	7110
25339	85	7212	42	38	0	7377
25340	21	56	6939	20	0	7036
25341	6601	36	81	27	0	6745
25342	59	6725	24	29	0	6837
25343	16	47	12	6437	0	6512
25344	10	6497	10	52	0	6569
25345	11	48	11	6525	0	6595
25346	10	10	6555	57	0	6632
25347	6044	6	49	35	0	6134
25348	44	5	6615	21	0	6685
25349	19	6422	47	15	0	6503
25350	12	6481	16	33	0	6542
25351	6431	50	12	12	0	6505
25352	45	15	6429	21	0	6510
25353	16	17	51	6379	0	6463
25354	16	2	6481	49	0	6548
25355	10	6532	52	22	0	6616
25356	8	43	18	6161	0	6230
25357	6	6511	16	42	0	6575
25358	6616	56	9	25	0	6706
25359	6665	15	6	26	0	6712
25360	6666	10	14	13	0	6703
25361	63	8	6588	7	0	6666
25362	19	7	6419	14	0	6459
25363	6426	11	59	14	0	6510
25364	50	14	6704	6	0	6774
25365	24	6	57	6404	0	6491
25366	10	6616	21	47	0	6694
25367	6781	49	13	29	0	6872
25368	6761	11	17	25	0	6814
25369	6938	15	7	20	0	6980
25370	62	5	12	6967	0	7046
25371	22	9	11	7001	0	7043
25372	6973	2	14	72	0	7061
25373	57	6910	8	32	0	7007
25374	6864	48	13	19	0	6944
25375	60	10	10	6778	0	6858
25376	22	9	9	6733	0	6773
25377	6564	5	6	64	0	6639
25378	50	6459	11	26	0	6546
25379	6469	46	5	27	0	6547
25380	56	6508	11	11	0	6586
25381	6445	46	10	13	0	6514
25382	62	15	7	7223	0	7307
25383	7345	9	5	55	0	7414
25384	7529	3	4	28	0	7564
25385	8075	7	2	29	0	8113
25386	83	8340	4	9	0	8436
25387	32	74	8206	6	0	8318
25388	8186	22	66	12	0	8286
25389	8352	17	23	15	0	8407
25390	99	8293	13	12	0	8417
25391	53	67	5	8389	0	8514
25392	32	31	9	8451	0	8523
25393	8441	16	7	92	0	8556
25394	89	17	7	8542	0	8655
25395	44	14	8529	82	0	8669
25396	29	10	8412	41	0	8492
25397	8638	10	88	30	0	8766
25398	98	7	27	8642	0	8774
25399	51	7	16	8713	0	8787
25400	32	12	14	8789	0	8847
25401	20	4	8878	110	0	9012
25402	33	7	73	8819	0	8932
25403	23	5	34	9016	0	9078
25404	19	7	20	9063	0	9109
25405	8875	4	13	137	0	9029
25406	96	8	13	8949	0	9066
25407	43	8	9086	114	0	9251
25408	9158	7	89	72	0	9326
25409	108	9	9486	38	0	9641
25410	9652	5	112	33	0	9802
25411	9732	6	41	44	0	9823
25412	157	7	22	9884	0	10070
25413	68	9925	9	140	0	10142
25414	45	110	18	10091	0	10264
25415	51	63	18	10160	0	10292
25416	35	10210	22	164	0	10431
25417	10175	106	22	80	0	10383
25418	123	10169	22	45	0	10359
25419	10191	123	11	39	0	10364
25420	10249	53	7	47	0	10356
25421	169	27	8	10142	0	10346
25422	77	18	9	10126	0	10230
25423	35	23	9794	171	0	10023
25424	39	14	9507	73	0	9633
25425	9338	21	141	56	0	9556
25426	9493	13	55	50	0	9611
25427	163	9136	29	39	0	9367
25428	91	94	25	8878	0	9088
25429	46	38	9199	121	0	9404
25430	57	95	118	9093	0	9363
25431	9026	23	59	130	0	9238
25432	8810	18	32	64	0	8924
25433	140	8822	18	47	0	9027
25434	75	93	15	8814	0	8997
25435	45	47	12	8883	0	8987
25436	38	35	12	8860	0	8945
25437	34	17	8491	162	0	8704
25438	7926	21	94	105	0	8146
25439	8319	18	45	57	0	8439
25440	155	14	8370	38	0	8577
25441	77	8328	94	40	0	8539
25442	8321	88	47	50	0	8506
25443	8349	44	25	57	0	8475
25444	152	22	8166	42	0	8382
25445	68	12	8419	47	0	8546
25446	59	28	143	8404	0	8634
25447	58	23	8515	105	0	8701
25448	8354	20	108	62	0	8544
25449	8436	27	58	47	0	8568
25450	8576	22	36	39	0	8673
25451	166	10	28	8357	0	8561
25452	85	8728	46	109	0	8968
25453	8898	92	26	73	0	9089
25454	8833	40	26	60	0	8959
25455	169	27	8687	41	0	8924
25456	98	27	8438	42	0	8605
25457	8502	18	121	54	0	8695
25458	145	19	53	8670	0	8887
25459	95	24	8610	116	0	8845
25460	62	8589	117	60	0	8828
25461	67	97	59	8667	0	8890
25462	8637	51	43	116	0	8847
25463	119	8868	33	75	0	9095
25464	79	108	33	8780	0	9000
25465	70	8725	33	120	0	8948
25466	50	8925	41	77	0	9093
25467	54	129	34	8894	0	9111
25468	61	58	34	8882	0	9035
25469	56	8941	31	150	0	9178
25470	8924	110	33	79	0	9146
25471	153	57	8953	47	0	9210
25472	8905	40	100	56	0	9101
25473	147	36	52	9134	0	9369
25474	86	31	39	9211	0	9367
25475	74	29	35	9227	0	9365
25476	76	24	45	9196	0	9341
25477	64	22	9185	166	0	9437
25478	62	19	120	9189	0	9390
25479	61	28	58	9242	0	9389
25480	54	9385	37	168	0	9644
25481	50	104	9566	97	0	9817
25482	51	9829	111	71	0	10062
25483	63	118	9945	58	0	10184
25484	40	10078	110	60	0	10288
25485	112	175	77	9392	0	9756
25486	9474	42	42	115	0	9673
25487	109	9498	32	50	0	9689
25488	76	110	25	9714	0	9925
25489	59	43	9837	112	0	10051
25490	41	10011	122	55	0	10229
25491	9935	118	54	61	0	10168
25492	10005	52	38	58	0	10153
25493	146	10005	42	27	0	10220
25494	76	119	9880	36	0	10111
25495	9707	47	113	44	0	9911
25496	142	43	56	10017	0	10258
25497	9991	33	35	147	0	10206
25498	142	10106	29	67	0	10344
25499	75	10353	22	43	0	10493
25500	57	148	10223	43	0	10471
25501	10134	76	131	48	0	10389
25502	135	72	58	10268	0	10533
25503	10297	34	32	115	0	10478
25504	128	10300	33	58	0	10519
25505	10376	115	32	54	0	10577
25506	10313	53	28	54	0	10448
25507	152	36	10343	41	0	10572
25508	71	9909	86	33	0	10099
25509	51	10061	36	28	0	10176
25510	59	157	33	9384	0	9633
25511	28	9279	28	70	0	9405
25512	9392	101	13	38	0	9544
25513	73	9392	15	45	0	9525
25514	41	118	10	9178	0	9347
25515	30	9168	8	70	0	9276
25516	32	8994	11	29	0	9066
25517	25	9196	10	33	0	9264
25518	46	103	21	9092	0	9262
25519	26	45	12	9124	0	9207
25520	29	35	9	9047	0	9120
25521	20	8959	7	89	0	9075
25522	21	70	8876	42	0	9009
25523	21	36	8701	34	0	8792
25524	8729	30	68	39	0	8866
25525	69	30	36	8957	0	9092
25526	33	27	9094	59	0	9213
25527	28	27	8997	38	0	9090
25528	22	9346	68	28	0	9464
25529	23	74	30	8921	0	9048
25530	18	46	23	9100	0	9187
25531	9049	35	21	94	0	9199
25532	68	24	16	9060	0	9168
25533	31	32	8	9050	0	9121
25534	26	33	9249	93	0	9401
25535	23	24	57	9223	0	9327
25536	25	26	26	9513	0	9590
25537	19	17	9510	96	0	9642
25538	12	25	9497	50	0	9584
25539	15	9481	82	50	0	9628
25540	9	67	9490	36	0	9602
25541	18	39	83	9401	0	9541
25542	56	40	64	7538	0	7698
25543	17	25	9606	90	0	9738
25544	16	9480	75	53	0	9624
25545	9171	61	35	64	0	9331
25546	55	9359	23	42	0	9479
25547	26	67	30	9386	0	9509
25548	25	47	24	9445	0	9541
25549	25	9411	17	99	0	9552
25550	12	63	19	9411	0	9505
25551	17	40	23	9414	0	9494
25552	12	30	9015	105	0	9162
25553	16	8972	71	65	0	9124
25554	13	69	38	9036	0	9156
25555	14	31	9006	92	0	9143
25556	25	32	78	8962	0	9097
25557	23	35	39	8933	0	9030
25558	14	22	42	9088	0	9166
25559	22	23	32	9047	0	9124
25560	20	25	17	8940	0	9002
25561	14	9002	15	120	0	9151
25562	8917	66	22	84	0	9089
25563	63	36	8750	55	0	8904
25564	8103	42	67	68	0	8280
25565	70	26	9058	43	0	9197
25566	36	9329	73	52	0	9490
25567	28	72	9277	40	0	9417
25568	23	9391	88	46	0	9548
25569	31	105	49	8802	0	8987
25570	21	45	39	9176	0	9281
25571	12	9264	24	104	0	9404
25572	11	9597	24	74	0	9706
25573	9625	97	14	70	0	9806
25574	9791	50	18	69	0	9928
25575	9842	35	19	56	0	9952
25576	9943	29	18	47	0	10037
25577	121	20	18	9850	0	10009
25578	53	9850	18	85	0	10006
25579	9892	78	12	48	0	10030
25580	84	38	26	9733	0	9881
25581	9504	38	12	91	0	9645
25582	9222	16	17	56	0	9311
25583	82	8885	16	41	0	9024
25584	37	8517	14	26	0	8594
25585	26	8830	13	14	0	8883
25586	29	150	35	8248	0	8462
25587	10	8540	15	40	0	8605
25588	8395	42	9	36	0	8482
25589	8528	16	3	31	0	8578
25590	8476	11	3	27	0	8517
25591	8645	8	3	23	0	8679
25592	8702	4	9	25	0	8740
25593	55	11	9096	9	0	9171
25594	9098	2	50	18	0	9168
25595	59	7	9273	8	0	9347
25596	9172	11	51	16	0	9250
25597	69	8	28	9208	0	9313
25598	34	13	8733	51	0	8831
25599	21	5	9192	25	0	9243
25600	12	9678	63	12	0	9765
25601	9758	66	36	21	0	9881
25602	10039	27	12	22	0	10100
25603	96	10806	7	13	0	10922
25604	61	94	10	12206	0	12371
25605	13289	43	4	143	0	13479
25606	164	29	13553	68	0	13814
25607	80	13449	143	27	0	13699
25608	13270	151	70	38	0	13529
25609	166	13483	29	18	0	13696
25610	112	169	18	12987	0	13286
25611	52	13520	19	133	0	13724
25612	48	205	19	13100	0	13372
25613	34	13180	14	156	0	13384
25614	29	13597	10	78	0	13714
25615	13312	227	10	58	0	13607
25616	13551	123	9	55	0	13738
25617	229	67	13441	41	0	13778
25618	118	53	13173	31	0	13375
25619	74	51	13518	24	0	13667
25620	73	52	240	13541	0	13906
25621	53	52	13749	161	0	14015
25622	81	38	198	13566	0	13883
25623	47	45	110	13584	0	13786
25624	34	13588	68	252	0	13942
25625	13661	179	46	140	0	14026
25626	156	13786	44	83	0	14069
25627	111	211	27	13965	0	14314
25628	67	112	30	14045	0	14254
25629	74	59	28	14089	0	14250
25630	64	53	13921	264	0	14302
25631	62	53	190	13853	0	14158
25632	73	38	115	14034	0	14260
25633	61	42	72	14157	0	14332
25634	27	39	13672	320	0	14058
25635	30	13575	199	175	0	13979
25636	13477	191	94	131	0	13893
25637	13286	108	49	132	0	13575
25638	231	13679	36	96	0	14042
25639	145	211	33	13619	0	14008
25640	85	136	34	13873	0	14128
25641	76	85	13661	282	0	14104
25642	69	13558	186	164	0	13977
25643	69	206	101	13683	0	14059
25644	52	117	13716	240	0	14125
25645	55	80	211	13634	0	13980
25646	43	56	118	13631	0	13848
25647	32	65	13577	319	0	13993
25648	56	61	218	13460	0	13795
25649	71	78	116	13319	0	13584
25650	73	56	13563	300	0	13992
25651	80	60	206	13595	0	13941
25652	69	54	125	13253	0	13501
25653	45	47	81	13745	0	13918
25654	32	36	13535	354	0	13957
25655	40	50	219	13540	0	13849
25656	13363	41	122	331	0	13857
25657	13415	42	85	237	0	13779
25658	231	13412	81	170	0	13894
25659	13607	191	61	166	0	14025
25660	226	97	13937	142	0	14402
25661	138	61	226	13944	0	14369
25662	87	64	106	14165	0	14422
25663	79	51	77	14311	0	14518
25664	13786	40	73	358	0	14257
25665	181	13636	66	223	0	14106
25666	105	196	47	13152	0	13500
25667	61	13371	65	285	0	13782
25668	13249	205	70	205	0	13729
25669	188	13301	51	151	0	13691
25670	13139	215	46	137	0	13537
25671	231	12903	52	103	0	13289
25672	133	12891	52	102	0	13178
25673	113	266	55	12765	0	13199
25674	68	127	73	12786	0	13054
25675	60	83	53	12844	0	13040
25676	51	74	53	12794	0	12972
25677	49	77	12500	339	0	12965
25678	50	12433	181	210	0	12874
25679	45	214	86	12018	0	12363
25680	45	12316	65	275	0	12701
25681	44	212	12252	175	0	12683
25682	77	126	173	12229	0	12605
25683	66	88	103	12545	0	12802
25684	70	79	12291	287	0	12727
25685	47	12052	197	185	0	12481
25686	52	193	109	12128	0	12482
25687	43	101	11976	281	0	12401
25688	25	11939	199	230	0	12393
25689	35	190	112	11801	0	12138
25690	44	106	11681	287	0	12118
25691	52	83	11354	155	0	11644
25692	49	11246	220	123	0	11638
25693	39	11736	107	119	0	12001
25694	67	278	102	11944	0	12391
25695	66	137	69	12777	0	13049
25696	30	90	12650	311	0	13081
25697	12411	72	203	208	0	12894
25698	12604	81	196	156	0	13037
25699	269	82	12699	134	0	13184
25700	118	12174	218	111	0	12621
25701	82	12167	127	93	0	12469
25702	62	11885	85	91	0	12123
25703	97	9457	121	137	0	9812
25704	239	496	138	9233	0	10106
25705	52	72	28	10649	0	10801
25706	16	45	8	10860	0	10929
25707	17	36	13	11206	0	11272
25708	9	11349	9	324	0	11691
25709	17	185	8	11436	0	11646
25710	7	11414	17	308	0	11746
25711	27	222	13	11606	0	11868
25712	11452	133	7	261	0	11853
25713	192	75	11	11520	0	11798
25714	95	11457	14	266	0	11832
25715	61	195	6	11733	0	11995
25716	49	128	7	11882	0	12066
25717	38	65	11	11985	0	12099
25718	11510	58	5	432	0	12005
25719	198	56	7	11815	0	12076
25720	110	69	11432	353	0	11964
25721	55	11669	181	272	0	12177
25722	69	243	98	12075	0	12485
25723	65	134	63	12482	0	12744
25724	81	99	37	12635	0	12852
25725	12172	90	24	471	0	12757
25726	249	75	11873	276	0	12473
25727	162	70	196	11659	0	12087
25728	87	11758	111	370	0	12326
25729	92	263	47	11974	0	12376
25730	11445	160	46	382	0	12033
25731	220	11700	42	294	0	12256
25732	133	283	40	11783	0	12239
25733	92	170	12	11909	0	12183
25734	48	11638	30	506	0	12222
25735	62	271	25	11981	0	12339
25736	68	173	30	12106	0	12377
25737	47	117	11608	487	0	12259
25738	32	11611	222	336	0	12201
25739	11637	287	121	267	0	12312
25740	246	177	11573	238	0	12234
25741	11483	103	245	249	0	12080
25742	304	113	11576	231	0	12224
25743	185	108	272	11738	0	12303
25744	11533	82	158	482	0	12255
25745	302	113	77	11833	0	12325
25746	11720	125	58	502	0	12405
25747	11836	93	63	392	0	12384
25748	11823	138	66	283	0	12310
25749	423	11650	57	260	0	12390
25750	285	303	52	11683	0	12323
25751	180	189	62	11962	0	12393
25752	175	137	79	11984	0	12375
25753	127	95	11565	583	0	12370
25754	138	74	277	11877	0	12366
25755	11647	87	172	524	0	12430
25756	11871	61	107	388	0	12427
25757	453	75	11513	299	0	12340
25758	11754	87	289	232	0	12362
25759	11882	94	164	247	0	12387
25760	489	105	97	11337	0	12028
25761	11301	109	87	476	0	11973
25762	11409	79	58	404	0	11950
25763	506	97	66	11301	0	11970
25764	11298	73	105	488	0	11964
25765	11367	85	85	375	0	11912
25766	529	101	70	11200	0	11900
25767	343	113	8340	452	0	9248
25768	10839	94	198	318	0	11449
25769	407	111	11071	245	0	11834
25770	325	77	11055	271	0	11728
25771	249	10935	387	250	0	11821
25772	231	278	213	10946	0	11668
25773	265	159	123	11252	0	11799
25774	240	93	106	11200	0	11639
25775	222	97	10962	548	0	11829
25776	260	107	10894	339	0	11600
25777	236	10904	388	292	0	11820
25778	222	269	239	10860	0	11590
25779	237	152	174	11184	0	11747
25780	210	79	179	11307	0	11775
25781	179	73	10902	582	0	11736
25782	223	10766	310	379	0	11678
25783	205	254	200	10962	0	11621
25784	215	137	10937	465	0	11754
25785	239	103	10973	313	0	11628
25786	10898	82	425	251	0	11656
25787	10952	96	269	246	0	11563
25788	11104	83	168	250	0	11605
25789	498	83	131	10800	0	11512
25790	314	58	10596	487	0	11455
25791	237	10389	312	361	0	11299
25792	211	10775	209	320	0	11515
25793	225	300	9874	229	0	10628
25794	266	354	352	8949	0	9921
25795	187	206	234	8267	0	8894
25796	196	8109	158	335	0	8798
25797	203	8257	122	229	0	8811
25798	8019	259	121	190	0	8589
25799	8129	135	110	141	0	8515
25800	8179	83	95	154	0	8511
25801	8045	61	87	182	0	8375
25802	7798	55	80	131	0	8064
25803	444	7274	71	139	0	7928
25804	211	6175	45	118	0	6549
25805	114	4996	35	54	0	5199
25806	4467	132	222	69	0	4890
25807	175	124	78	4045	0	4422
25808	45	20	22	3895	0	3982
25809	3834	15	12	82	0	3943
25810	69	3827	25	47	0	3968
25811	43	43	25	3859	0	3970
25812	36	30	24	3879	0	3969
25813	39	14	18	3910	0	3981
25814	3796	16	20	78	0	3910
25815	71	6	20	3850	0	3947
25816	48	6	3719	62	0	3835
25817	3684	9	51	40	0	3784
25818	74	29	20	3724	0	3847
25819	43	9	3730	66	0	3848
25820	26	3652	50	46	0	3774
25821	19	3518	27	37	0	3601
25822	3215	86	74	40	0	3415
25823	3122	11	21	28	0	3182
25824	35	3224	11	17	0	3287
25825	24	34	5	3361	0	3424
25826	3472	4	9	52	0	3537
25827	39	8	11	3742	0	3800
25828	25	11	5	3919	0	3960
25829	22	8	3	3940	0	3973
25830	14	2	6	3944	0	3966
25831	14	3866	9	74	0	3963
25832	15	46	9	3902	0	3972
25833	12	12	5	3933	0	3962
25834	17	16	4	3917	0	3954
25835	12	11	3790	87	0	3900
25836	5	3834	41	52	0	3932
25837	10	53	13	3875	0	3951
25838	7	18	3818	68	0	3911
25839	8	21	3638	35	0	3702
25840	8	3785	46	37	0	3876
25841	3725	52	27	31	0	3835
25842	45	20	23	3765	0	3853
25843	3745	21	16	58	0	3840
25844	50	3819	11	27	0	3907
25845	23	50	7	3843	0	3923
25846	3718	20	10	61	0	3809
25847	3771	19	11	34	0	3835
25848	63	16	3	3755	0	3837
25849	32	13	7	3734	0	3786
25850	26	10	3701	75	0	3812
25851	19	12	46	3692	0	3769
25852	17	15	15	3773	0	3820
25853	3689	10	19	77	0	3795
25854	55	3703	10	47	0	3815
25855	24	44	3605	38	0	3711
25856	3563	12	36	35	0	3646
25857	51	3686	14	29	0	3780
25858	32	45	17	3668	0	3762
25859	3633	21	8	59	0	3721
25860	48	18	7	3602	0	3675
25861	29	9	9	3627	0	3674
25862	24	13	3568	67	0	3672
25863	11	10	39	3617	0	3677
25864	3604	4	11	78	0	3697
25865	48	11	16	3602	0	3677
25866	3539	10	11	76	0	3636
25867	55	3449	14	40	0	3558
25868	27	3576	10	41	0	3654
25869	33	50	6	3583	0	3672
25870	23	20	9	3587	0	3639
25871	3488	23	8	72	0	3591
25872	50	3517	4	43	0	3614
25873	3527	48	7	48	0	3630
25874	3570	15	9	40	0	3634
25875	59	25	7	3541	0	3632
25876	3541	17	7	61	0	3626
25877	71	12	3419	33	0	3535
25878	39	11	37	3464	0	3551
25879	40	16	3488	56	0	3600
25880	24	18	48	3536	0	3626
25881	3520	8	19	76	0	3623
25882	3589	10	22	34	0	3655
25883	58	3582	13	43	0	3696
25884	42	46	9	3572	0	3669
25885	39	14	14	3596	0	3663
25886	29	3591	9	64	0	3693
25887	33	52	8	3674	0	3767
25888	27	17	4	3682	0	3730
25889	22	3628	7	72	0	3729
25890	3532	51	13	56	0	3652
25891	3544	25	12	46	0	3627
25892	62	19	7	3545	0	3633
25893	37	14	7	3570	0	3628
25894	39	21	3489	64	0	3613
25895	31	20	40	3446	0	3537
25896	24	3407	13	78	0	3522
25897	3490	44	21	48	0	3603
25898	55	23	11	3512	0	3601
25899	26	23	8	3456	0	3513
25900	3379	15	8	87	0	3489
25901	53	3405	5	46	0	3509
25902	32	47	9	3481	0	3569
25903	36	18	3	3482	0	3539
25904	26	3440	3	78	0	3547
25905	3448	48	10	48	0	3554
25906	59	21	3399	48	0	3527
25907	22	25	3415	44	0	3506
25908	35	22	48	3454	0	3559
25909	21	17	3461	58	0	3557
25910	3386	11	51	46	0	3494
25911	60	11	22	3469	0	3562
25912	27	11	3578	62	0	3678
25913	34	9	3537	37	0	3617
25914	23	3622	56	37	0	3738
25915	3623	49	24	31	0	3727
25916	55	3718	19	30	0	3822
25917	3730	51	21	21	0	3823
25918	3727	26	16	26	0	3795
25919	49	3630	17	21	0	3717
25920	3614	42	16	23	0	3695
25921	3624	21	9	24	0	3678
25922	73	21	3570	17	0	3681
25923	53	160	36	3331	0	3580
25924	23	3256	19	38	0	3336
25925	24	3184	14	15	0	3237
25926	57	98	26	2955	0	3136
25927	2760	22	18	57	0	2857
25928	27	4	1	2696	0	2728
25929	8	5	2	2755	0	2770
25930	7	0	1	2828	0	2836
25931	4	2925	2	26	0	2957
25932	7	23	1	3116	0	3147
25933	9	7	3346	27	0	3389
25934	3280	7	30	16	0	3333
25935	3540	3	9	11	0	3563
25936	39	3462	5	11	0	3517
25937	3534	36	3	7	0	3580
25938	48	11	4	3576	0	3639
25939	18	6	3548	38	0	3610
25940	3466	1	30	19	0	3516
25941	30	3574	12	6	0	3622
25942	21	32	6	3600	0	3659
25943	3726	11	2	37	0	3776
25944	35	3691	6	15	0	3747
25945	17	3759	1	9	0	3786
25946	3725	46	2	12	0	3785
25947	42	17	3653	4	0	3716
25948	3703	10	33	5	0	3751
25949	49	10	10	3703	0	3772
25950	18	5	4	3739	0	3766
25951	11	9	3701	49	0	3770
25952	9	5	3664	21	0	3699
25953	11	6	46	3764	0	3827
25954	6	2	3705	45	0	3758
25955	8	5	3724	18	0	3755
25956	13	4	48	3751	0	3816
25957	15	3	21	3789	0	3828
25958	3794	4	10	56	0	3864
25959	43	7	16	3809	0	3875
25960	3800	7	7	48	0	3862
25961	49	3829	8	23	0	3909
25962	21	37	10	3907	0	3975
25963	20	14	3978	43	0	4055
25964	3915	9	37	33	0	3994
25965	4053	10	14	16	0	4093
25966	4071	9	10	9	0	4099
25967	4038	6	8	10	0	4062
25968	3985	10	12	6	0	4013
25969	69	10	6	3931	0	4016
25970	32	4	3904	46	0	3986
25971	18	5	3845	24	0	3892
25972	20	4	3904	21	0	3949
25973	3827	5	52	15	0	3899
25974	3987	4	22	18	0	4031
25975	59	2	23	3912	0	3996
25976	22	4009	12	52	0	4095
25977	15	41	18	4089	0	4163
25978	18	17	4091	48	0	4174
25979	17	9	3994	22	0	4042
25980	3900	4	51	19	0	3974
25981	60	10	4148	11	0	4229
25982	25	7	40	4160	0	4232
25983	4286	6	23	49	0	4364
25984	4063	10	15	28	0	4116
25985	4350	5	12	19	0	4386
25986	4341	3	17	15	0	4376
25987	75	6	4256	5	0	4342
25988	4201	2	41	17	0	4261
25989	63	4254	22	14	0	4353
25990	44	44	10	4302	0	4400
25991	26	19	4303	53	0	4401
25992	20	13	53	4307	0	4393
25993	23	9	4359	50	0	4441
25994	20	10	54	4337	0	4421
25995	12	7	33	4406	0	4458
25996	26	6	4345	62	0	4439
25997	23	7	46	4332	0	4408
25998	4409	8	28	60	0	4505
25999	59	9	11	4438	0	4517
26000	27	7	15	4516	0	4565
26001	4434	5	27	72	0	4538
26002	63	4462	15	34	0	4574
26003	4523	47	15	24	0	4609
26004	64	4566	13	24	0	4667
26005	4703	50	17	30	0	4800
26006	69	17	4649	20	0	4755
26007	32	14	53	4646	0	4745
26008	38	7	24	4712	0	4781
26009	4662	13	18	74	0	4767
26010	65	4638	20	28	0	4751
26011	35	46	19	4605	0	4705
26012	32	18	10	4569	0	4629
26013	16	4430	17	76	0	4539
26014	4427	49	12	34	0	4522
26015	53	4425	9	35	0	4522
26016	26	49	16	4368	0	4459
26017	21	20	11	4282	0	4334
26018	21	4218	8	70	0	4317
26019	4198	44	16	39	0	4297
26020	59	22	4144	23	0	4248
26021	4055	9	48	22	0	4134
26022	65	4168	23	19	0	4275
26023	24	54	8	4234	0	4320
26024	4291	14	6	65	0	4376
26025	57	12	17	4289	0	4375
26026	33	12	8	4357	0	4410
26027	4416	14	10	66	0	4506
26028	63	4314	11	35	0	4423
26029	33	4451	14	14	0	4512
26030	4398	55	13	27	0	4493
26031	61	13	4382	23	0	4479
26032	27	4123	48	17	0	4215
26033	35	73	29	4055	0	4192
26034	15	12	4607	32	0	4666
26035	16	18	47	4478	0	4559
26036	4541	7	17	54	0	4619
26037	51	4632	15	19	0	4717
26038	27	49	8	4438	0	4522
26039	11	4587	8	44	0	4650
26040	4663	50	7	20	0	4740
26041	4811	14	3	21	0	4849
26042	65	4840	4	13	0	4922
26043	33	50	3	4771	0	4857
26044	18	4933	4	48	0	5003
26045	5010	63	4	19	0	5096
26046	5084	23	9	19	0	5135
26047	87	12	4	5022	0	5125
26048	39	17	6	5063	0	5125
26049	27	14	4970	89	0	5100
26050	4731	16	55	46	0	4848
26051	76	16	4932	26	0	5050
26052	45	10	63	4931	0	5049
26053	4915	6	23	82	0	5026
26054	72	5030	20	36	0	5158
26055	4852	66	15	27	0	4960
26056	83	37	4525	20	0	4665
26057	4831	23	44	26	0	4924
26058	84	5009	16	23	0	5132
26059	5056	64	10	21	0	5151
26060	87	5110	8	26	0	5231
26061	55	72	20	5068	0	5215
26062	33	34	4988	79	0	5134
26063	29	26	4843	30	0	4928
26064	32	27	75	4907	0	5041
26065	39	16	4955	75	0	5085
26066	31	25	69	4932	0	5057
26067	25	14	34	5002	0	5075
26068	19	17	5108	94	0	5238
26069	4535	17	77	56	0	4685
26070	5071	12	35	36	0	5154
26071	99	4990	23	23	0	5135
26072	5051	66	10	33	0	5160
26073	86	30	12	5054	0	5182
26074	43	18	5188	71	0	5320
26075	46	15	73	5170	0	5304
26076	26	14	39	5227	0	5306
26077	5145	15	24	94	0	5278
26078	76	5028	22	53	0	5179
26079	30	5117	15	48	0	5210
26080	34	71	18	5159	0	5282
26081	25	36	18	5065	0	5144
26082	35	4983	13	82	0	5113
26083	30	72	6	4942	0	5050
26084	37	40	12	4917	0	5006
26085	15	4878	5	96	0	4994
26086	4876	61	10	65	0	5012
26087	58	30	20	4885	0	4993
26088	30	4913	17	89	0	5049
26089	27	58	9	4973	0	5067
26090	4906	33	13	92	0	5044
26091	63	4962	7	49	0	5081
26092	5032	68	8	41	0	5149
26093	5089	32	16	39	0	5176
26094	95	31	5	5167	0	5298
26095	5256	14	8	91	0	5369
26096	5355	25	3	48	0	5431
26097	5399	29	3	42	0	5473
26098	5382	18	7	31	0	5438
26099	114	9	13	5353	0	5489
26100	51	15	4	5410	0	5480
26101	41	13	5310	100	0	5464
26102	48	11	54	5340	0	5453
26103	42	19	22	5372	0	5455
26104	38	24	5216	90	0	5368
26105	5093	14	56	65	0	5228
26106	78	12	23	5318	0	5431
26107	43	19	5382	88	0	5532
26108	5249	7	60	77	0	5393
26109	94	18	5877	42	0	6031
26110	53	5951	74	36	0	6114
26111	55	6195	31	33	0	6314
26112	32	88	25	6448	0	6593
26113	39	46	6927	95	0	7107
26114	6953	17	90	84	0	7144
26115	7332	19	51	57	0	7459
26116	115	25	7289	41	0	7470
26117	7293	17	84	41	0	7435
26118	7433	16	46	45	0	7540
26119	136	7392	45	38	0	7611
26120	7463	73	28	26	0	7590
26121	135	38	41	7387	0	7601
26122	81	31	7410	83	0	7605
26123	62	37	82	7115	0	7296
26124	39	7373	42	110	0	7564
26125	35	7551	38	67	0	7691
26126	7494	93	27	47	0	7661
26127	7432	52	22	45	0	7551
26128	7441	28	44	36	0	7549
26129	152	25	24	7348	0	7549
26130	93	46	20	7138	0	7297
26131	59	7165	24	106	0	7354
26132	7176	82	24	73	0	7355
26133	124	7201	31	56	0	7412
26134	6593	56	32	35	0	6716
26135	106	6611	26	27	0	6770
26136	6592	77	32	33	0	6734
26137	6450	50	17	23	0	6540
26138	140	64	18	6423	0	6645
26139	91	6609	21	57	0	6778
26140	84	61	6320	46	0	6511
26141	6119	46	44	61	0	6270
26142	78	5987	33	28	0	6126
26143	58	63	6239	33	0	6393
26144	57	44	6265	23	0	6389
26145	44	56	50	6057	0	6207
26146	64	33	23	5991	0	6111
26147	47	6240	6	58	0	6351
26148	6379	57	6	36	0	6478
26149	90	36	5	6290	0	6421
26150	59	6429	9	69	0	6566
26151	46	6677	11	41	0	6775
26152	44	58	6592	35	0	6729
26153	53	53	6517	23	0	6646
26154	6408	48	50	21	0	6527
26155	75	43	6583	16	0	6717
26156	70	31	49	6489	0	6639
26157	51	30	29	6664	0	6774
26158	33	35	6641	76	0	6785
26159	52	43	44	6519	0	6658
26160	52	24	41	6180	0	6297
26161	6533	29	33	75	0	6670
26162	6616	42	31	52	0	6741
26163	72	35	42	6583	0	6732
26164	48	6493	49	64	0	6654
26165	29	6701	44	50	0	6824
26166	6727	64	33	55	0	6879
26167	71	43	6733	35	0	6882
26168	54	33	50	6679	0	6816
26169	6840	33	36	99	0	7008
26170	6880	49	39	52	0	7020
26171	87	33	29	6888	0	7037
26172	45	30	6872	80	0	7027
26173	56	39	6469	42	0	6606
26174	6438	34	85	46	0	6603
26175	6684	25	66	51	0	6826
26176	96	6730	39	53	0	6918
26177	66	6880	32	59	0	7037
26178	7032	67	49	60	0	7208
26179	7100	35	42	78	0	7255
26180	108	40	26	7216	0	7390
26181	94	32	32	7302	0	7460
26182	79	32	22	7329	0	7462
26183	7315	28	29	116	0	7488
26184	110	42	29	7333	0	7514
26185	90	38	7343	72	0	7543
26186	7281	30	59	57	0	7427
26187	101	36	44	7378	0	7559
26188	66	42	7388	78	0	7574
26189	7214	46	60	61	0	7381
26190	6710	41	47	49	0	6847
26191	100	7540	37	59	0	7736
26192	76	7650	45	38	0	7809
26193	70	64	7189	46	0	7369
26194	7406	50	54	59	0	7569
26195	95	7662	38	43	0	7838
26196	77	79	7239	39	0	7434
26197	7352	45	55	42	0	7494
26198	116	7939	22	48	0	8125
26199	66	72	7858	58	0	8054
26200	7617	49	64	64	0	7794
26201	107	7904	33	50	0	8094
26202	65	62	26	7893	0	8046
26203	7890	39	19	99	0	8047
26204	81	7873	23	137	0	8114
26205	60	84	32	7888	0	8064
26206	7862	26	30	90	0	8008
26207	74	21	7812	59	0	7966
26208	47	7609	63	40	0	7759
26209	70	49	7333	32	0	7484
26210	34	69	53	7091	0	7247
26211	23	25	7066	46	0	7160
26212	25	6734	46	19	0	6824
26213	22	6382	18	17	0	6439
26214	27	44	17	6257	0	6345
26215	12	14	13	6017	0	6056
26216	12	14	4	6080	0	6110
26217	11	4	6224	38	0	6277
26218	14	5	27	6247	0	6293
26219	6248	9	10	50	0	6317
26220	6229	6	6	32	0	6273
26221	42	6	6423	10	0	6481
26222	19	6359	27	12	0	6417
26223	6344	24	9	23	0	6400
26224	29	6359	11	9	0	6408
26225	6394	29	4	23	0	6450
26226	6393	13	10	17	0	6433
26227	35	12	6358	6	0	6411
26228	21	6469	24	12	0	6526
26229	18	24	10	6510	0	6562
26230	8	12	6521	30	0	6571
26231	6278	15	30	16	0	6339
26232	35	6	13	6493	0	6547
26233	13	7	6410	31	0	6461
26234	6187	4	24	32	0	6247
26235	38	7	6561	10	0	6616
26236	16	2	40	6658	0	6716
26237	6928	5	15	42	0	6990
26238	41	7108	11	13	0	7173
26239	16	38	7244	9	0	7307
26240	7195	13	36	19	0	7263
26241	7760	8	12	20	0	7800
26242	55	7908	16	10	0	7989
26243	41	49	3	7954	0	8047
26244	27	14	4	7891	0	7936
26245	7829	13	10	70	0	7922
26246	71	7	3	7896	0	7977
26247	22	4	7948	66	0	8040
26248	23	2	55	7861	0	7941
26249	7912	6	13	70	0	8001
26250	52	7827	14	28	0	7921
26251	20	49	9	7643	0	7721
26252	20	7774	7	50	0	7851
26253	7930	63	5	26	0	8024
26254	64	16	8	8407	0	8495
26255	30	18	3	8634	0	8685
26256	21	8698	6	82	0	8807
26257	11	77	8588	35	0	8711
26258	16	23	68	8553	0	8660
26259	18	13	20	8662	0	8713
26260	17	9	17	8622	0	8665
26261	10	8594	6	110	0	8720
26262	13	65	8594	40	0	8712
26263	10	25	8612	31	0	8678
26264	8632	16	92	34	0	8774
26265	8856	11	29	37	0	8933
26266	97	16	8906	21	0	9040
26267	8690	9	79	27	0	8805
26268	92	15	9085	11	0	9203
26269	8813	7	86	37	0	8943
26270	88	9147	31	19	0	9285
26271	9296	80	29	19	0	9424
26272	102	23	9382	24	0	9531
26273	30	21	9492	29	0	9572
26274	47	7	101	10157	0	10312
26275	10385	16	44	138	0	10583
26276	131	11080	33	47	0	11291
26277	46	135	12397	29	0	12607
26278	64	42	207	12752	0	13065
26279	50	31	56	13194	0	13331
26280	12978	16	45	263	0	13302
26281	13120	14	25	105	0	13264
26282	274	15	28	12988	0	13305
26283	13027	16	19	244	0	13306
26284	255	19	12772	81	0	13127
26285	119	14	193	12662	0	12988
26286	76	15	63	13024	0	13178
26287	12894	15	46	290	0	13245
26288	12907	15	36	117	0	13075
26289	287	15	32	12770	0	13104
26290	12795	8	25	258	0	13086
26291	253	24	12529	99	0	12905
26292	99	12385	210	85	0	12779
26293	74	196	12513	64	0	12847
26294	85	93	222	12530	0	12930
26295	12370	29	84	260	0	12743
26296	235	12254	53	99	0	12641
26297	118	204	27	12133	0	12482
26298	88	62	52	11801	0	12003
26299	47	11937	38	276	0	12298
26300	58	208	38	12070	0	12374
26301	68	80	29	12094	0	12271
26302	80	46	28	12177	0	12331
26303	67	34	26	12144	0	12271
26304	72	28	21	11965	0	12086
26305	63	11687	36	334	0	12120
26306	70	212	38	11833	0	12153
26307	64	71	34	11887	0	12056
26308	58	42	11517	322	0	11939
26309	60	11423	211	174	0	11868
26310	72	224	68	11552	0	11916
26311	82	68	56	11623	0	11829
26312	78	54	43	11553	0	11728
26313	60	11276	44	350	0	11730
26314	59	222	11297	183	0	11761
26315	79	71	217	11516	0	11883
26316	56	57	11425	311	0	11849
26317	67	35	11265	168	0	11535
26318	68	47	273	11326	0	11714
26319	11334	38	108	314	0	11794
26320	244	49	67	11370	0	11730
26321	106	40	67	11235	0	11448
26322	74	11167	54	333	0	11628
26323	69	226	62	11410	0	11767
26324	75	82	56	11569	0	11782
26325	50	47	11289	375	0	11761
26326	61	11239	220	193	0	11713
26327	55	236	83	11386	0	11760
26328	11079	89	68	341	0	11577
26329	226	64	11079	179	0	11548
26330	84	53	236	11162	0	11535
26331	75	49	94	11332	0	11550
26332	11006	48	71	369	0	11494
26333	226	10988	50	209	0	11473
26334	10905	212	39	198	0	11354
26335	234	10822	36	172	0	11264
26336	102	250	36	10831	0	11219
26337	10665	97	35	343	0	11140
26338	229	68	10459	208	0	10964
26339	99	10137	224	164	0	10624
26340	65	10303	95	146	0	10609
26341	9741	243	93	139	0	10216
26342	225	102	57	9490	0	9874
26343	99	9389	62	281	0	9831
26344	87	9688	49	159	0	9983
26345	76	238	51	9623	0	9988
26346	88	101	37	9747	0	9973
26347	9417	88	47	328	0	9880
26348	215	9427	54	179	0	9875
26349	99	246	54	9397	0	9796
26350	82	96	9304	275	0	9757
26351	67	9246	201	168	0	9682
26352	59	210	9103	148	0	9520
26353	62	9070	220	114	0	9466
26354	119	260	135	8469	0	8983
26355	69	74	37	8361	0	8541
26356	53	8267	42	264	0	8626
26357	49	211	8259	144	0	8663
26358	8236	102	163	131	0	8632
26359	197	65	70	8495	0	8827
26360	82	64	56	8665	0	8867
26361	53	61	8475	285	0	8874
26362	53	88	171	8544	0	8856
26363	42	62	8430	280	0	8814
26364	55	69	195	8458	0	8777
26365	40	64	8495	258	0	8857
26366	39	8563	189	167	0	8958
26367	30	211	8752	147	0	9140
26368	61	103	201	8776	0	9141
26369	8654	81	73	290	0	9098
26370	200	8545	55	146	0	8946
26371	89	266	44	8451	0	8850
26372	65	81	8242	265	0	8653
26373	41	8255	204	142	0	8642
26374	45	292	79	7409	0	7825
26375	35	86	7365	197	0	7683
26376	28	6525	144	83	0	6780
26377	4816	150	157	99	0	5222
26378	4380	30	43	59	0	4512
26379	65	11	4	4342	0	4422
26380	4345	7	10	64	0	4426
26381	55	3	3	4290	0	4351
26382	12	3	3	4382	0	4400
26383	11	5	4372	63	0	4451
26384	5	7	48	4316	0	4376
26385	11	8	12	4379	0	4410
26386	4290	7	8	68	0	4373
26387	4250	4	4	28	0	4286
26388	61	4248	9	14	0	4332
26389	16	55	4266	10	0	4347
26390	22	15	49	4227	0	4313
26391	10	10	4162	51	0	4233
26392	3897	9	50	22	0	3978
26393	53	4	4012	14	0	4083
26394	18	10	50	3894	0	3972
26395	7	3929	13	54	0	4003
26396	9	47	8	3926	0	3990
26397	3	16	10	3946	0	3975
26398	3	9	3945	66	0	4023
26399	13	4	54	3929	0	4000
26400	3910	8	8	62	0	3988
26401	3939	5	9	17	0	3970
26402	3956	3	7	13	0	3979
26403	3935	4	5	17	0	3961
26404	61	3857	5	13	0	3936
26405	18	3878	10	12	0	3918
26406	15	46	8	3585	0	3654
26407	9	11	10	3871	0	3901
26408	7	3711	6	60	0	3784
26409	5	40	4	3869	0	3918
26410	9	13	9	3899	0	3930
26411	15	10	6	3883	0	3914
26412	9	6	12	3894	0	3921
26413	9	8	7	3915	0	3939
26414	3825	4	10	64	0	3903
26415	48	3744	9	20	0	3821
26416	21	44	3721	17	0	3803
26417	14	19	48	3707	0	3788
26418	8	15	15	3746	0	3784
26419	13	11	9	3700	0	3733
26420	3690	12	12	70	0	3784
26421	46	4017	8	33	0	4104
26422	23	66	7	4165	0	4261
26423	14	4373	9	84	0	4480
26424	19	101	4	4309	0	4433
26425	18	4336	11	109	0	4474
26426	14	106	4710	44	0	4874
26427	22	36	110	5040	0	5208
26428	16	20	5920	149	0	6105
26429	20	19	159	5987	0	6185
26430	20	11	42	6599	0	6672
26431	6536	16	30	235	0	6817
26432	6676	13	12	104	0	6805
26433	6733	13	11	74	0	6831
26434	6725	13	18	46	0	6802
26435	6757	11	12	54	0	6834
26436	257	14	22	6407	0	6700
26437	98	6511	16	200	0	6825
26438	75	176	16	6495	0	6762
26439	42	64	6300	233	0	6639
26440	6360	37	168	91	0	6656
26441	6646	17	51	67	0	6781
26442	250	19	38	6470	0	6777
26443	112	13	17	6485	0	6627
26444	86	6288	15	242	0	6631
26445	57	167	17	6446	0	6687
26446	45	61	16	6475	0	6597
26447	43	6332	21	258	0	6654
26448	43	188	15	6481	0	6727
26449	5974	56	25	268	0	6323
26450	188	53	6209	98	0	6548
26451	6194	17	179	98	0	6488
26452	229	23	6247	70	0	6569
26453	92	27	195	6212	0	6526
26454	75	18	54	6159	0	6306
26455	56	6007	43	258	0	6364
26456	49	6294	23	131	0	6497
26457	64	227	18	6085	0	6394
26458	64	82	6097	213	0	6456
26459	5927	46	178	95	0	6246
26460	199	30	58	5945	0	6232
26461	75	5901	47	215	0	6238
26462	66	178	32	5979	0	6255
26463	54	79	22	5975	0	6130
26464	40	5780	23	249	0	6092
26465	59	186	20	5660	0	5925
26466	39	56	5276	234	0	5605
26467	43	64	5109	83	0	5299
26468	33	52	158	5093	0	5336
26469	22	5278	68	174	0	5542
26470	30	162	44	5302	0	5538
26471	5298	59	18	216	0	5591
26472	5446	48	20	97	0	5611
26473	5288	29	25	69	0	5411
26474	199	5186	25	55	0	5465
26475	80	143	5166	55	0	5444
26476	5143	47	156	65	0	5411
26477	5312	50	57	54	0	5473
26478	196	5159	35	55	0	5445
26479	93	161	23	5187	0	5464
26480	5191	67	15	177	0	5450
26481	5277	47	23	83	0	5430
26482	5336	35	21	55	0	5447
26483	242	26	23	5107	0	5398
26484	5239	26	29	168	0	5462
26485	208	25	34	5188	0	5455
26486	97	24	19	5348	0	5488
26487	5223	35	16	234	0	5508
26488	192	35	20	5207	0	5454
26489	5197	24	22	230	0	5473
26490	236	22	27	5205	0	5490
26491	111	21	26	5370	0	5528
26492	5206	26	15	255	0	5502
26493	209	31	5164	134	0	5538
26494	114	24	144	5316	0	5598
26495	111	21	53	5362	0	5547
26496	90	26	43	5371	0	5530
26497	81	26	22	5430	0	5559
26498	80	24	17	5276	0	5397
26499	71	5142	32	273	0	5518
26500	77	155	26	5280	0	5538
26501	66	59	5168	240	0	5533
26502	78	44	157	5282	0	5561
26503	75	23	58	5407	0	5563
26504	68	22	32	5491	0	5613
26505	52	37	5216	294	0	5599
26506	42	36	5223	178	0	5479
26507	5159	41	188	126	0	5514
26508	5344	25	86	108	0	5563
26509	206	5455	55	104	0	5820
26510	112	162	31	5657	0	5962
26511	79	68	37	5862	0	6046
26512	49	54	32	5933	0	6068
26513	5771	33	35	284	0	6123
26514	5930	25	44	148	0	6147
26515	218	31	40	5876	0	6165
26516	109	29	32	5956	0	6126
26517	85	38	23	5987	0	6133
26518	50	41	22	5985	0	6098
26519	5691	31	31	302	0	6055
26520	187	31	5541	155	0	5914
26521	68	4849	127	125	0	5169
26522	63	4741	39	91	0	4934
26523	4531	112	33	72	0	4748
26524	140	144	31	4409	0	4724
26525	59	42	4441	156	0	4698
26526	44	31	3959	87	0	4121
26527	25	4002	88	84	0	4199
26528	3129	33	55	30	0	3247
26529	39	7	3024	19	0	3089
26530	2558	17	27	4	0	2606
26531	15	5	3	2618	0	2641
26532	5	4	1	2626	0	2636
26533	4	2590	1	13	0	2608
26534	3	2558	0	9	0	2570
26535	2648	9	3	4	0	2664
26536	2649	3	4	3	0	2659
26537	10	2680	1	3	0	2694
26538	5	8	2674	4	0	2691
26539	1	6	2677	3	0	2687
26540	5	4	11	2721	0	2741
26541	2777	0	7	10	0	2794
26542	13	2789	1	6	0	2809
26543	5	11	0	2896	0	2912
26544	2933	7	2	12	0	2954
26545	14	0	2	2969	0	2985
26546	6	0	2	3052	0	3060
26547	3047	2	1	18	0	3068
26548	11	3061	3	6	0	3081
26549	4	3193	3	5	0	3205
26550	6	14	3256	7	0	3283
26551	4	4	12	3294	0	3314
26552	6	4	4	3271	0	3285
26553	2	1	3340	20	0	3363
26554	2984	1	14	9	0	3008
26555	3168	2	5	10	0	3185
26556	17	3	3356	4	0	3380
26557	2979	3	12	14	0	3008
26558	13	4	3496	3	0	3516
26559	6	3648	13	2	0	3669
26560	5	11	9	3787	0	3812
26561	2	6	2	3844	0	3854
26562	3845	2	1	19	0	3867
26563	3807	2	2	10	0	3821
26564	3800	1	1	3	0	3805
26565	3832	2	2	8	0	3844
26566	3820	0	5	7	0	3832
26567	18	2	3755	5	0	3780
26568	7	3777	14	7	0	3805
26569	5	16	4	3826	0	3851
26570	3	3814	1	15	0	3833
26571	2	3831	1	6	0	3840
26572	11	12	2	3825	0	3850
26573	4	3	4	3846	0	3857
26574	5	2	3795	13	0	3815
26575	3524	3	10	12	0	3549
26576	3743	2	4	3	0	3752
26577	15	3714	0	4	0	3733
26578	3741	8	1	5	0	3755
26579	3896	4	1	13	0	3914
26580	14	2	2	3911	0	3929
26581	6	3	4033	10	0	4052
26582	4	3	3961	5	0	3973
26583	4002	2	9	4	0	4017
26584	4015	1	3	7	0	4026
26585	13	3997	2	2	0	4014
26586	5	4160	2	3	0	4170
26587	4	14	1	4264	0	4283
26588	4278	6	2	18	0	4304
26589	13	3	4302	6	0	4324
26590	10	0	11	4366	0	4387
26591	4473	2	7	19	0	4501
26592	4493	2	0	12	0	4507
26593	20	2	1	4601	0	4624
26594	4602	3	1	19	0	4625
26595	16	3	4502	9	0	4530
26596	11	3	4660	3	0	4677
26597	9	2	17	4645	0	4673
26598	4	2	8	4860	0	4874
26599	2	2	1	4869	0	4874
26600	3	4710	2	18	0	4733
26601	3	4852	1	10	0	4866
26602	3	20	1	4910	0	4934
26603	4965	7	4	19	0	4995
26604	14	1	4	5022	0	5041
26605	14	0	1	5041	0	5056
26606	4	5008	3	17	0	5032
26607	3	5132	3	9	0	5147
26608	4	19	1	5180	0	5204
26609	5	10	0	4965	0	4980
26610	4846	1	1	31	0	4879
26611	12	4874	2	10	0	4898
26612	4897	10	5	6	0	4918
26613	14	10	1	4982	0	5007
26614	12	2	4980	14	0	5008
26615	4	1	4845	14	0	4864
26616	5031	0	25	9	0	5065
26617	12	5	10	5248	0	5275
26618	13	3	1	5266	0	5283
26619	3	1	3	5305	0	5312
26620	4	2	5361	24	0	5391
26621	6	1	12	5430	0	5449
26622	3	5327	10	18	0	5358
26623	5	14	1	5595	0	5615
26624	5	9	2	5579	0	5595
26625	1	5579	5	28	0	5613
26626	6	15	4	5791	0	5816
26627	5688	8	1	33	0	5730
26628	24	5670	2	16	0	5712
26629	5948	24	3	10	0	5985
26630	5993	13	0	10	0	6016
26631	47	4	2	5988	0	6041
26632	21	2	3	5929	0	5955
26633	15	0	2	6033	0	6050
26634	6	6	5919	46	0	5977
26635	6	5751	29	28	0	5814
26636	5	5955	12	13	0	5985
26637	4	40	2	5874	0	5920
26638	5816	10	5	38	0	5869
26639	34	5	1	5779	0	5819
26640	14	8	5840	40	0	5902
26641	11	5682	29	22	0	5744
26642	8	5852	8	15	0	5883
26643	5830	34	4	26	0	5894
26644	5859	10	12	15	0	5896
26645	37	6160	8	20	0	6225
26646	6277	35	4	22	0	6338
26647	44	16	6228	3	0	6291
26648	15	10	6108	11	0	6144
26649	6245	8	54	10	0	6317
26650	6459	4	16	17	0	6496
26651	60	7	10	6454	0	6531
26652	6432	6	7	56	0	6501
26653	54	9	6545	15	0	6623
26654	29	6	6842	10	0	6887
26655	23	4	56	7341	0	7424
26656	16	8	17	8235	0	8276
26657	19	4	10	8583	0	8616
26658	21	6	12	8560	0	8599
26659	25	8	8	9205	0	9246
26660	14	3	9055	187	0	9259
26661	24	6	115	9087	0	9232
26662	9076	7	43	194	0	9320
26663	140	3	25	9174	0	9342
26664	9121	3	16	200	0	9340
26665	149	7	21	9194	0	9371
26666	9378	5	13	208	0	9604
26667	9696	8	16	129	0	9849
26668	198	4	23	9636	0	9861
26669	103	5	20	9771	0	9899
26670	9647	7	14	238	0	9906
26671	9654	4	28	125	0	9811
26672	212	10	9644	92	0	9958
26673	141	5	116	9722	0	9984
26674	100	0	42	9986	0	10128
26675	9912	6	25	217	0	10160
26676	10030	7	19	134	0	10190
26677	230	4	15	10034	0	10283
26678	142	7	24	10115	0	10288
26679	89	10	21	10031	0	10151
26680	79	5	16	9961	0	10061
26681	60	9276	30	380	0	9746
26682	57	9653	17	163	0	9890
26683	62	144	26	9683	0	9915
26684	53	9655	23	211	0	9942
26685	59	140	17	9848	0	10064
26686	46	52	9583	245	0	9926
26687	48	39	9272	155	0	9514
26688	26	9659	155	152	0	9992
26689	46	154	61	9647	0	9908
26690	26	85	9630	217	0	9958
26691	40	58	143	9527	0	9768
26692	33	49	70	9777	0	9929
26693	9580	47	51	265	0	9943
26694	177	29	51	9789	0	10046
26695	81	37	9889	233	0	10240
26696	78	28	9784	146	0	10036
26697	57	9723	189	139	0	10108
26698	62	10267	101	117	0	10547
26699	10434	164	71	127	0	10796
26700	192	61	10925	123	0	11301
26701	104	36	172	10993	0	11305
26702	11044	27	78	240	0	11389
26703	11053	21	58	169	0	11301
26704	225	11176	66	100	0	11567
26705	132	161	51	10804	0	11148
26706	99	79	46	11484	0	11708
26707	93	54	42	11435	0	11624
26708	11259	45	42	292	0	11638
26709	184	48	11186	167	0	11585
26710	105	11355	147	153	0	11760
26711	100	166	68	11278	0	11612
26712	72	79	43	11609	0	11803
26713	66	67	11318	275	0	11726
26714	69	50	151	11292	0	11562
26715	50	46	66	11526	0	11688
26716	63	42	54	11508	0	11667
26717	58	39	50	11446	0	11593
26718	45	54	11160	323	0	11582
26719	49	40	180	11229	0	11498
26720	35	46	11227	306	0	11614
26721	24	11137	197	224	0	11582
26722	51	131	98	11291	0	11571
26723	64	56	86	11457	0	11663
26724	46	41	11219	339	0	11645
26725	62	11026	172	248	0	11508
26726	74	175	91	11022	0	11362
26727	74	69	10987	259	0	11389
26728	63	10867	165	188	0	11283
26729	63	149	94	10900	0	11206
26730	73	80	10824	250	0	11227
26731	102	59	152	10814	0	11127
26732	91	47	99	10739	0	10976
26733	60	52	80	11100	0	11292
26734	10874	52	59	307	0	11292
26735	168	10800	58	191	0	11217
26736	10884	151	63	169	0	11267
26737	180	80	10889	169	0	11318
26738	11105	52	160	197	0	11514
26739	11685	45	73	200	0	12003
26740	210	45	60	11695	0	12010
26741	11819	37	52	284	0	12192
26742	11905	54	52	204	0	12215
26743	12067	51	43	188	0	12349
26744	235	50	32	12012	0	12329
26745	143	49	52	11740	0	11984
26746	103	48	11369	254	0	11774
26747	95	31	10817	168	0	11111
26748	10990	38	242	158	0	11428
26749	160	112	99	11222	0	11593
26750	104	11285	78	189	0	11656
26751	11334	112	79	150	0	11675
26752	135	11212	56	148	0	11551
26753	77	11137	60	145	0	11419
26754	104	165	10681	132	0	11082
26755	47	58	10507	86	0	10698
26756	95	255	156	10064	0	10570
26757	41	25	10475	83	0	10624
26758	20	28	9614	34	0	9696
26759	9299	8	29	41	0	9377
26760	9746	4	18	24	0	9792
26761	25	2	8	9907	0	9942
26762	12	4	8	9980	0	10004
26763	14	3	10181	24	0	10222
26764	11	10282	21	11	0	10325
26765	7	22	8	10277	0	10314
26766	10506	5	9	59	0	10579
26767	24	7	4	10469	0	10504
26768	10	10540	8	38	0	10596
26769	13	24	10481	10	0	10528
26770	8	10725	22	14	0	10769
26771	10819	27	6	45	0	10897
26772	10648	7	7	38	0	10700
26773	32	6	8	10677	0	10723
26774	13	7	10805	21	0	10846
26775	17	13	10017	17	0	10064
26776	9	10727	25	30	0	10791
26777	26	25	13	10355	0	10419
26778	15	8	8	10845	0	10876
26779	11	6	10796	32	0	10845
26780	18	7	19	10647	0	10691
26781	5	11162	11	37	0	11215
26782	12	36	10	11287	0	11345
26783	11	11	8	11321	0	11351
26784	4	17	11325	58	0	11404
26785	19	7	49	11123	0	11198
26786	11183	4	14	74	0	11275
26787	49	5	11144	20	0	11218
26788	21	7	10842	8	0	10878
26789	8	11288	62	12	0	11370
26790	19	53	23	11588	0	11683
26791	8	15	17	12046	0	12086
26792	6	11	11859	70	0	11946
26793	11361	3	60	62	0	11486
26794	71	10	31	11871	0	11983
26795	30	6	11716	66	0	11818
26796	28	9	67	11396	0	11500
26797	8	8	11687	75	0	11778
26798	9	7	11347	42	0	11405
26799	3	11346	93	26	0	11468
26800	27	63	40	10832	0	10962
26801	9	11088	19	72	0	11188
26802	10873	65	17	47	0	11002
26803	62	34	11001	19	0	11116
26804	29	10750	64	18	0	10861
26805	18	59	41	10800	0	10918
26806	10735	31	22	93	0	10881
26807	57	10728	18	43	0	10846
26808	37	65	14	10844	0	10960
26809	20	35	14	10783	0	10852
26810	10	10840	25	94	0	10969
26811	10950	80	12	71	0	11113
26812	82	36	19	11755	0	11892
26813	47	20	21	12360	0	12448
26814	20	20	12338	161	0	12539
26815	15	12945	118	86	0	13164
26816	24	140	64	13220	0	13448
26817	36	64	35	14379	0	14514
26818	11	14643	36	211	0	14901
26819	32	189	18	14833	0	15072
26820	48	76	23	15364	0	15511
26821	48	46	13	15703	0	15810
26822	5	15685	20	307	0	16017
26823	15559	206	19	165	0	15949
26824	210	80	15646	94	0	16030
26825	15160	61	202	99	0	15522
26826	235	15635	89	63	0	16022
26827	104	207	59	15621	0	15991
26828	56	101	15679	243	0	16079
26829	50	68	218	15702	0	16038
26830	50	50	81	15783	0	15964
26831	35	42	58	16048	0	16183
26832	34	38	15744	344	0	16160
26833	37	15529	221	193	0	15980
26834	21	226	15758	117	0	16122
26835	22	15889	260	102	0	16273
26836	28	264	16075	76	0	16443
26837	51	104	267	15973	0	16395
26838	15600	79	109	312	0	16100
26839	205	15698	84	163	0	16150
26840	85	232	15758	105	0	16180
26841	55	15694	227	87	0	16063
26842	35	277	15779	77	0	16168
26843	51	124	271	15341	0	15787
26844	45	91	126	15193	0	15455
26845	32	15382	93	311	0	15818
26846	32	15816	62	166	0	16076
26847	15712	301	61	144	0	16218
26848	233	167	62	15873	0	16335
26849	102	130	15923	274	0	16429
26850	94	68	263	15839	0	16264
26851	52	63	15991	347	0	16453
26852	46	72	15923	168	0	16209
26853	62	62	311	15407	0	15842
26854	30	15566	167	266	0	16029
26855	15261	264	105	168	0	15798
26856	256	126	78	15176	0	15636
26857	120	99	70	14938	0	15227
26858	67	15140	86	347	0	15640
26859	14903	276	68	204	0	15451
26860	14991	130	76	160	0	15357
26861	316	100	63	14648	0	15127
26862	157	14489	85	294	0	15025
26863	90	15041	67	186	0	15384
26864	14771	317	76	151	0	15315
26865	245	181	14764	108	0	15298
26866	14341	118	273	112	0	14844
26867	14481	95	134	112	0	14822
26868	14379	76	93	114	0	14662
26869	351	14206	67	113	0	14737
26870	192	286	55	14243	0	14776
26871	14296	145	59	297	0	14797
26872	14289	115	55	167	0	14626
26873	327	14282	75	117	0	14801
26874	14434	235	59	120	0	14848
26875	329	131	64	14397	0	14921
26876	167	124	52	14375	0	14718
26877	114	14275	54	338	0	14781
26878	96	262	53	14518	0	14929
26879	114	132	52	14527	0	14825
26880	81	14337	47	363	0	14828
26881	92	271	41	13686	0	14090
26882	72	14062	55	311	0	14500
26883	13995	274	49	190	0	14508
26884	13691	153	43	156	0	14043
26885	283	13688	47	131	0	14149
26886	166	243	13487	110	0	14006
26887	112	181	200	13417	0	13910
26888	85	112	13326	252	0	13775
26889	65	12884	234	169	0	13352
26890	76	13117	105	120	0	13418
26891	12528	259	73	97	0	12957
26892	230	12793	56	60	0	13139
26893	138	250	45	12463	0	12896
26894	105	12530	55	194	0	12884
26895	80	12781	39	120	0	13020
26896	12602	280	40	104	0	13026
26897	232	144	49	12496	0	12921
26898	131	105	12414	215	0	12865
26899	96	102	12265	120	0	12583
26900	71	12539	228	111	0	12949
26901	12483	220	110	113	0	12926
26902	205	12691	72	73	0	13041
26903	117	280	42	12924	0	13363
26904	13023	139	36	235	0	13433
26905	255	100	40	13147	0	13542
26906	113	84	54	13280	0	13531
26907	100	13256	46	284	0	13686
26908	106	234	36	13383	0	13759
26909	62	140	13436	259	0	13897
26910	13380	108	208	141	0	13837
26911	227	13741	78	137	0	14183
26912	89	13781	64	61	0	13995
26913	13129	201	31	87	0	13448
26914	216	103	13305	46	0	13670
26915	12584	112	195	70	0	12961
26916	174	13955	56	46	0	14231
26917	58	14883	62	30	0	15033
26918	42	240	15395	28	0	15705
26919	30	15539	234	38	0	15841
26920	81	279	103	14194	0	14657
26921	48	90	42	14432	0	14612
26922	7	14694	21	239	0	14961
26923	32	213	16	14778	0	15039
26924	14812	106	11	246	0	15175
26925	199	68	14736	99	0	15102
26926	14703	45	192	81	0	15021
26927	15094	32	77	66	0	15269
26928	15031	41	50	59	0	15181
26929	326	46	14894	33	0	15299
26930	154	53	220	14905	0	15332
26931	84	42	15007	235	0	15368
26932	14687	32	260	129	0	15108
26933	14763	31	98	90	0	14982
26934	313	14840	54	50	0	15257
26935	176	229	36	14644	0	15085
26936	91	15085	47	206	0	15429
26937	77	254	15211	93	0	15635
26938	90	114	241	15162	0	15607
26939	15082	72	100	272	0	15526
26940	15243	45	55	125	0	15468
26941	331	43	50	14692	0	15116
26942	157	14737	35	251	0	15180
26943	86	243	15030	102	0	15461
26944	69	108	15144	76	0	15397
26945	14706	69	321	72	0	15168
26946	286	49	15124	50	0	15509
26947	127	15026	297	50	0	15500
26948	91	254	118	14925	0	15388
26949	67	114	15122	268	0	15571
26950	98	61	285	14839	0	15283
26951	62	41	14990	292	0	15385
26952	14538	44	301	142	0	15025
26953	300	36	143	14562	0	15041
26954	130	14331	94	273	0	14828
26955	82	14853	70	125	0	15130
26956	77	316	69	14644	0	15106
26957	72	141	57	14581	0	14851
26958	50	14555	72	350	0	15027
26959	59	267	14529	166	0	15021
26960	57	125	277	14589	0	15048
26961	49	89	14694	307	0	15139
26962	58	58	14461	140	0	14717
26963	13821	54	361	114	0	14350
26964	257	14096	164	85	0	14602
26965	14106	292	97	69	0	14564
26966	335	126	73	13777	0	14311
26967	128	14137	79	295	0	14639
26968	103	305	63	14280	0	14751
26969	63	143	83	14245	0	14534
26970	65	14149	77	368	0	14659
26971	60	300	14040	190	0	14590
26972	84	158	303	14090	0	14635
26973	14037	97	145	333	0	14612
26974	314	94	85	13916	0	14409
26975	160	71	80	13982	0	14293
26976	100	82	13677	405	0	14264
26977	79	13586	305	193	0	14163
26978	88	300	139	13567	0	14094
26979	77	142	13541	346	0	14106
26980	58	134	13508	169	0	13869
26981	13135	106	380	154	0	13775
26982	280	13425	193	146	0	14044
26983	13312	317	125	144	0	13898
26984	316	13279	112	129	0	13836
26985	167	13544	94	140	0	13945
26986	13338	378	93	151	0	13960
26987	347	192	104	13012	0	13655
26988	192	13318	115	322	0	13947
26989	173	303	97	13515	0	14088
26990	13474	146	109	348	0	14077
26991	380	118	13423	177	0	14098
26992	194	101	13111	131	0	13537
26993	13033	95	365	137	0	13630
26994	331	13176	212	105	0	13824
26995	188	330	13184	99	0	13801
26996	143	13139	326	114	0	13722
26997	128	341	170	12998	0	13637
26998	106	181	13155	322	0	13764
26999	110	124	320	13045	0	13599
27000	93	95	12949	358	0	13495
27001	12341	96	344	213	0	12994
27002	314	12672	207	135	0	13328
27003	12550	310	110	120	0	13090
27004	354	163	102	12339	0	12958
27005	148	13079	121	302	0	13650
27006	12886	331	126	169	0	13512
27007	12364	157	132	144	0	12797
27008	365	114	12968	116	0	13563
27009	175	90	13014	92	0	13371
27010	11868	97	384	87	0	12436
27011	286	11923	176	87	0	12472
27012	125	11656	123	79	0	11983
27013	266	563	148	10724	0	11701
27014	95	145	10860	241	0	11341
27015	87	10262	237	130	0	10716
27016	64	9335	106	103	0	9608
27017	339	270	112	6887	0	7608
27018	6822	35	37	106	0	7000
27019	6816	28	15	35	0	6894
27020	6915	18	12	24	0	6969
27021	105	21	6885	14	0	7025
27022	6809	19	75	21	0	6924
27023	6898	22	23	29	0	6972
27024	6984	12	17	12	0	7025
27025	118	14	20	6757	0	6909
27026	39	6777	16	78	0	6910
27027	6770	77	17	29	0	6893
27028	88	6735	14	14	0	6851
27029	39	75	14	6697	0	6825
27030	19	35	6881	69	0	7004
27031	36	26	73	6792	0	6927
27032	28	17	23	6891	0	6959
27033	16	23	6876	88	0	7003
27034	18	6792	80	31	0	6921
27035	27	73	22	6454	0	6576
27036	6360	24	14	76	0	6474
27037	72	6256	17	22	0	6367
27038	6172	65	4	23	0	6264
27039	71	39	10	6021	0	6141
27040	36	6173	6	55	0	6270
27041	6201	67	3	19	0	6290
27042	71	6280	12	18	0	6381
27043	23	59	6075	10	0	6167
27044	6028	40	57	17	0	6142
27045	6158	31	17	13	0	6219
27046	73	6151	10	13	0	6247
27047	26	70	6003	14	0	6113
27048	22	6239	66	12	0	6339
27049	101	98	27	4322	0	4548
27050	15	32	16	6460	0	6523
27051	15	17	11	6473	0	6516
27052	15	6442	9	100	0	6566
27053	26	83	5	6470	0	6584
27054	21	30	7	6514	0	6572
27055	6387	29	8	98	0	6522
27056	92	13	6	6399	0	6510
27057	35	11	4	6496	0	6546
27058	6392	14	5	109	0	6520
27059	93	6448	9	35	0	6585
27060	6497	83	6	41	0	6627
27061	6507	27	9	19	0	6562
27062	6575	19	5	19	0	6618
27063	110	18	7	6505	0	6640
27064	44	13	14	6601	0	6672
27065	35	18	6396	100	0	6549
27066	30	25	6273	41	0	6369
27067	40	12	6259	33	0	6344
27068	6097	22	105	25	0	6249
27069	108	23	6282	20	0	6433
27070	47	6338	91	28	0	6504
27071	36	98	32	6365	0	6531
27072	27	40	39	6278	0	6384
27073	35	6458	25	101	0	6619
27074	25	107	6566	41	0	6739
27075	27	6656	91	36	0	6810
27076	6642	109	34	31	0	6816
27077	100	50	6698	26	0	6874
27078	44	6664	106	34	0	6848
27079	42	117	6734	25	0	6918
27080	39	47	91	6717	0	6894
27081	33	21	6808	105	0	6967
27082	42	29	99	6683	0	6853
27083	6821	17	32	116	0	6986
27084	113	21	6816	48	0	6998
27085	43	6828	97	42	0	7010
27086	6906	100	36	37	0	7079
27087	126	36	7002	32	0	7196
27088	40	29	7049	37	0	7155
27089	44	18	110	7004	0	7176
27090	41	28	7019	110	0	7198
27091	6741	25	111	56	0	6933
27092	105	6907	40	50	0	7102
27093	51	95	37	7055	0	7238
27094	25	7337	28	116	0	7506
27095	7429	110	24	57	0	7620
27096	112	35	7457	52	0	7656
27097	50	37	7617	40	0	7744
27098	44	32	121	7585	0	7782
27099	41	26	42	7692	0	7801
27100	49	30	32	7780	0	7891
27101	42	34	26	7815	0	7917
27102	34	25	7830	156	0	8045
27103	34	7734	107	60	0	7935
27104	33	111	31	7348	0	7523
27105	21	33	7011	102	0	7167
27106	20	6941	89	35	0	7085
27107	6878	89	50	34	0	7051
27108	129	38	26	6816	0	7009
27109	6633	19	22	87	0	6761
27110	76	6635	14	34	0	6759
27111	6670	71	14	38	0	6793
27112	87	25	6867	15	0	6994
27113	40	51	71	6671	0	6833
27114	24	6841	26	77	0	6968
27115	18	81	6776	37	0	6912
27116	10	6727	76	31	0	6844
27117	60	117	35	4856	0	5068
27118	6403	25	18	75	0	6521
27119	70	6399	19	27	0	6515
27120	6353	68	10	25	0	6456
27121	77	23	6333	14	0	6447
27122	28	14	6217	19	0	6278
27123	6260	11	76	21	0	6368
27124	72	14	33	6318	0	6437
27125	33	17	12	6402	0	6464
27126	23	9	6422	80	0	6534
27127	14	6	6350	26	0	6396
27128	12	6587	86	18	0	6703
27129	6453	70	47	27	0	6597
27130	6319	19	18	12	0	6368
27131	73	6263	13	14	0	6363
27132	33	59	12	6422	0	6526
27133	6514	17	17	70	0	6618
27134	60	14	15	6506	0	6595
27135	6587	12	8	67	0	6674
27136	6643	9	16	28	0	6696
27137	6784	13	10	20	0	6827
27138	76	17	7	6666	0	6766
27139	31	5	6	6944	0	6986
27140	6792	10	11	76	0	6889
27141	6864	8	7	31	0	6910
27142	6832	7	17	11	0	6867
27143	78	6730	12	19	0	6839
27144	6548	41	10	15	0	6614
27145	45	6513	9	16	0	6583
27146	6480	46	10	11	0	6547
27147	56	16	6477	11	0	6560
27148	5906	23	53	20	0	6002
27149	33	6019	15	5	0	6072
27150	12	6002	7	3	0	6024
27151	6100	21	11	16	0	6148
27152	23	12	5	6136	0	6176
27153	10	9	1	6280	0	6300
27154	10	6283	3	30	0	6326
27155	5	6563	5	11	0	6584
27156	6685	31	6	19	0	6741
27157	33	13	6864	4	0	6914
27158	11	1	29	7173	0	7214
27159	7328	4	7	46	0	7385
27160	41	1	7349	14	0	7405
27161	9	7896	38	10	0	7953
27162	8386	55	6	9	0	8456
27163	87	12	8722	7	0	8828
27164	24	17	95	9131	0	9267
27165	14	7	9453	101	0	9575
27166	9188	5	113	42	0	9348
27167	108	9596	24	23	0	9751
27168	9700	106	31	15	0	9852
27169	9716	26	3	12	0	9757
27170	144	13	6	9699	0	9862
27171	9782	4	6	129	0	9921
27172	133	8	4	9813	0	9958
27173	42	5	4	9893	0	9944
27174	25	8	9673	127	0	9833
27175	12	9604	95	43	0	9754
27176	21	109	22	9727	0	9879
27177	17	21	11	9811	0	9860
27178	12	16	4	9834	0	9866
27179	10	6	9689	137	0	9842
27180	5	9608	103	40	0	9756
27181	14	103	20	9738	0	9875
27182	21	24	18	9831	0	9894
27183	6	18	9690	133	0	9847
27184	19	5	102	9534	0	9660
27185	9618	4	20	132	0	9774
27186	99	9595	17	37	0	9748
27187	9460	103	7	33	0	9603
27188	123	24	9479	7	0	9633
27189	34	18	100	9502	0	9654
27190	9689	7	22	117	0	9835
27191	9614	5	19	42	0	9680
27192	135	3	9638	26	0	9802
27193	49	8	108	9576	0	9741
27194	24	6	9491	110	0	9631
27195	9090	5	111	40	0	9246
27196	107	9304	28	90	0	9529
27197	9708	98	23	17	0	9846
27198	9749	25	10	17	0	9801
27199	134	9762	12	10	0	9918
27200	9947	111	14	22	0	10094
27201	135	29	9838	25	0	10027
27202	9837	18	110	20	0	9985
27203	144	12	29	9895	0	10080
27204	44	11	10010	121	0	10186
27205	37	6	119	9973	0	10135
27206	42	12	30	9740	0	9824
27207	31	13	27	10026	0	10097
27208	30	9901	20	146	0	10097
27209	10013	123	14	56	0	10206
27210	139	27	10	10039	0	10215
27211	45	9922	21	134	0	10122
27212	30	117	14	9722	0	9883
27213	34	9733	18	138	0	9923
27214	25	126	9789	46	0	9986
27215	26	41	123	9786	0	9976
27216	35	25	32	9862	0	9954
27217	26	17	9779	152	0	9974
27218	9189	16	120	85	0	9410
27219	130	9711	34	52	0	9927
27220	49	116	31	9829	0	10025
27221	48	39	20	9725	0	9832
27222	38	28	19	9717	0	9802
27223	31	9672	18	164	0	9885
27224	9651	122	24	75	0	9872
27225	149	34	9650	47	0	9880
27226	48	34	9376	51	0	9509
27227	36	21	148	9472	0	9677
27228	35	20	46	9608	0	9709
27229	9521	13	34	173	0	9741
27230	125	9425	33	81	0	9664
27231	53	124	21	9547	0	9745
27232	9422	36	25	159	0	9642
27233	137	26	29	9336	0	9528
27234	9339	28	32	169	0	9568
27235	160	16	9081	64	0	9321
27236	53	9209	132	48	0	9442
27237	9278	133	37	35	0	9483
27238	151	37	9230	43	0	9461
27239	8953	27	128	54	0	9162
27240	162	21	9056	33	0	9272
27241	9008	23	143	39	0	9213
27242	175	19	47	9088	0	9329
27243	9142	21	39	154	0	9356
27244	158	14	19	9159	0	9350
27245	66	9	28	9184	0	9287
27246	9091	27	23	175	0	9316
27247	149	9042	11	74	0	9276
27248	63	132	26	9209	0	9430
27249	9270	44	24	162	0	9500
27250	9522	35	13	73	0	9643
27251	175	19	20	9466	0	9680
27252	78	26	22	9678	0	9804
27253	9839	23	16	193	0	10071
27254	181	20	25	10018	0	10244
27255	75	18	17	10033	0	10143
27256	9917	12	18	221	0	10168
27257	194	18	18	9790	0	10020
27258	62	16	9157	182	0	9417
27259	9011	17	139	92	0	9259
27260	173	13	9294	42	0	9522
27261	66	15	8623	43	0	8747
27262	8009	67	226	30	0	8332
27263	102	7882	57	18	0	8059
27264	62	82	37	7497	0	7678
27265	18	26	14	7427	0	7485
27266	23	3	8	7825	0	7859
27267	25	7	5	8013	0	8050
27268	7728	9	4	135	0	7876
27269	8446	4	4	50	0	8504
27270	8645	6	4	29	0	8684
27271	139	4	9053	23	0	9219
27272	72	2	116	9627	0	9817
27273	38	4	46	9889	0	9977
27274	34	1	12	9645	0	9692
27275	15	9322	17	241	0	9595
27276	18	9513	10	120	0	9661
27277	9932	204	8	62	0	10206
27278	185	85	8	9953	0	10231
27279	99	36	10	10431	0	10576
27280	45	25	5	10629	0	10704
27281	35	21	10283	296	0	10635
27282	33	15	10080	156	0	10284
27283	10154	13	255	96	0	10518
27284	10540	13	110	71	0	10734
27285	285	14	48	10312	0	10659
27286	130	10349	35	204	0	10718
27287	86	182	25	10456	0	10749
27288	70	97	19	10512	0	10698
27289	41	27	10225	314	0	10607
27290	10292	25	183	171	0	10671
27291	208	16	96	10654	0	10974
27292	133	12	34	10586	0	10765
27293	10337	15	37	328	0	10717
27294	226	10563	30	155	0	10974
27295	10802	205	12	110	0	11129
27296	268	110	11	10609	0	10998
27297	125	10245	17	263	0	10650
27298	10323	223	16	144	0	10706
27299	267	117	17	10239	0	10640
27300	10183	43	16	269	0	10511
27301	10106	40	23	159	0	10328
27302	10150	31	16	87	0	10284
27303	354	9720	9	92	0	10175
27304	170	9796	19	82	0	10067
27305	114	287	20	9571	0	9992
27306	82	9692	22	230	0	10026
27307	9893	247	12	140	0	10292
27308	275	125	16	9888	0	10304
27309	9922	66	17	273	0	10278
27310	10071	46	21	172	0	10310
27311	365	46	14	9818	0	10243
27312	196	33	25	10139	0	10393
27313	10025	37	21	362	0	10445
27314	10160	42	12	189	0	10403
27315	10384	42	9	128	0	10563
27316	10468	45	9	112	0	10634
27317	10618	30	9	105	0	10762
27318	426	36	8	10321	0	10791
27319	236	25	20	10460	0	10741
27320	157	23	11	10586	0	10777
27321	10350	27	9	392	0	10778
27322	315	28	9	10288	0	10640
27323	188	10134	11	339	0	10672
27324	127	226	17	10410	0	10780
27325	10220	121	10	310	0	10661
27326	10341	48	10	208	0	10607
27327	380	56	10052	129	0	10617
27328	226	68	204	9874	0	10372
27329	138	10078	86	291	0	10593
27330	10237	211	32	193	0	10673
27331	303	10266	36	125	0	10730
27332	200	258	23	10364	0	10845
27333	10453	136	26	286	0	10901
27334	10590	75	22	177	0	10864
27335	384	10413	19	128	0	10944
27336	226	238	13	10431	0	10908
27337	169	125	10284	294	0	10872
27338	10170	70	200	196	0	10636
27339	319	62	10328	123	0	10832
27340	10449	45	223	123	0	10840
27341	10625	57	120	112	0	10914
27342	421	41	55	10480	0	10997
27343	10649	51	34	324	0	11058
27344	10880	42	30	206	0	11158
27345	10988	48	30	130	0	11196
27346	471	50	24	10656	0	11201
27347	10789	42	25	285	0	11141
27348	379	36	19	10723	0	11157
27349	252	33	28	10721	0	11034
27350	164	10433	24	391	0	11012
27351	178	195	34	10148	0	10555
27352	142	10122	22	299	0	10585
27353	9871	217	27	167	0	10282
27354	9783	124	16	134	0	10057
27355	347	69	15	9594	0	10025
27356	225	63	11	9596	0	9895
27357	9378	41	23	330	0	9772
27358	274	43	9121	202	0	9640
27359	9183	34	156	128	0	9501
27360	299	36	86	9033	0	9454
27361	193	33	8573	239	0	9038
27362	8627	37	156	169	0	8989
27363	8837	24	83	120	0	9064
27364	336	29	8684	96	0	9145
27365	8717	28	172	98	0	9015
27366	271	22	8480	82	0	8855
27367	188	8394	173	67	0	8822
27368	8348	151	182	74	0	8755
27369	8132	92	70	79	0	8373
27370	273	7726	41	61	0	8101
27371	155	7288	39	54	0	7536
27372	6653	105	107	48	0	6913
27373	6616	40	24	28	0	6708
27374	153	36	11	6700	0	6900
27375	68	23	6518	99	0	6708
27376	55	21	6297	57	0	6430
27377	6441	25	77	40	0	6583
27378	117	17	6508	32	0	6674
27379	6186	52	95	33	0	6366
27380	97	12	24	6139	0	6272
27381	50	10	17	6192	0	6269
27382	45	9	6276	83	0	6413
27383	6297	10	64	45	0	6416
27384	96	7	21	6380	0	6504
27385	43	1	26	6913	0	6983
27386	6807	4	16	97	0	6924
27387	6847	4	16	44	0	6911
27388	6788	2	15	54	0	6859
27389	104	6893	16	26	0	7039
27390	55	45	6615	22	0	6737
27391	6510	15	45	24	0	6594
27392	6628	13	16	25	0	6682
27393	82	6470	9	12	0	6573
27394	6285	26	19	25	0	6355
27395	59	8	7	6220	0	6294
27396	20	7	6424	30	0	6481
27397	6318	12	27	22	0	6379
27398	6490	5	10	25	0	6530
27399	6546	4	7	20	0	6577
27400	6568	5	6	12	0	6591
27401	42	4	3	6574	0	6623
27402	29	6	8	6571	0	6614
27403	6630	1	6	34	0	6671
27404	39	2	3	6623	0	6667
27405	19	0	6	6584	0	6609
27406	20	6525	3	52	0	6600
27407	17	26	7	6649	0	6699
27408	16	6	4	6675	0	6701
27409	20	4	4	6698	0	6726
27410	19	6	2	6769	0	6796
27411	13	6705	4	51	0	6773
27412	16	26	3	6636	0	6681
27413	19	12	4	6511	0	6546
27414	13	12	6441	44	0	6510
27415	6	8	6148	26	0	6188
27416	5	6352	24	29	0	6410
27417	6975	28	14	29	0	7046
27418	46	7196	9	11	0	7262
27419	26	46	9	7694	0	7775
27420	10	22	8406	55	0	8493
27421	9031	2	70	43	0	9146
27422	95	14	30	9321	0	9460
27423	9267	5	15	109	0	9396
27424	9423	6	8	34	0	9471
27425	123	9393	5	20	0	9541
27426	9433	77	5	34	0	9549
27427	104	9689	6	16	0	9815
27428	71	106	4	9882	0	10063
27429	32	9953	8	88	0	10081
27430	33	98	9934	35	0	10100
27431	25	10050	85	26	0	10186
27432	34	120	27	9850	0	10031
27433	9914	51	12	130	0	10107
27434	97	10061	16	44	0	10218
27435	54	112	13	10114	0	10293
27436	29	53	4	10308	0	10394
27437	26	26	10335	153	0	10540
27438	41	29	109	10329	0	10508
27439	10	28	10362	144	0	10544
27440	10080	12	132	95	0	10319
27441	128	19	10637	38	0	10822
27442	58	10704	133	37	0	10932
27443	43	125	50	10713	0	10931
27444	44	39	42	10689	0	10814
27445	43	28	33	10726	0	10830
27446	10773	30	23	188	0	11014
27447	157	26	14	10588	0	10785
27448	69	10591	20	152	0	10832
27449	10458	134	12	90	0	10694
27450	136	10440	21	63	0	10660
27451	80	146	14	10439	0	10679
27452	10440	71	14	170	0	10695
27453	137	10274	14	92	0	10517
27454	73	10649	21	43	0	10786
27455	10577	170	16	55	0	10818
27456	10680	71	8	69	0	10828
27457	184	52	10547	44	0	10827
27458	10707	43	126	51	0	10927
27459	190	52	10884	44	0	11170
27460	106	24	146	11032	0	11308
27461	66	32	11075	160	0	11333
27462	62	33	173	11074	0	11342
27463	61	33	11150	177	0	11421
27464	58	31	170	10918	0	11177
27465	50	28	71	11217	0	11366
27466	10976	26	52	234	0	11288
27467	157	38	10916	115	0	11226
27468	10552	30	162	102	0	10846
27469	172	30	10811	91	0	11104
27470	82	25	10852	71	0	11030
27471	77	45	189	10772	0	11083
27472	10807	31	96	178	0	11112
27473	172	10821	41	95	0	11129
27474	10726	145	52	76	0	10999
27475	10762	74	43	59	0	10938
27476	206	10690	44	71	0	11011
27477	10746	150	39	58	0	10993
27478	188	76	10838	42	0	11144
27479	126	47	152	10820	0	11145
27480	10888	37	71	175	0	11171
27481	191	10891	52	91	0	11225
27482	106	143	57	10748	0	11054
27483	85	64	34	10821	0	11004
27484	55	40	51	10918	0	11064
27485	70	36	29	10978	0	11113
27486	10781	29	35	242	0	11087
27487	10874	38	37	132	0	11081
27488	10862	32	34	107	0	11035
27489	10659	27	32	99	0	10817
27490	231	29	10640	78	0	10978
27491	10621	24	154	69	0	10868
27492	10857	32	78	61	0	11028
27493	247	10644	49	53	0	10993
27494	131	10826	44	49	0	11050
27495	112	188	52	10585	0	10937
27496	110	80	33	10636	0	10859
27497	83	52	10499	198	0	10832
27498	73	10572	153	106	0	10904
27499	82	153	70	10379	0	10684
27500	65	10606	57	184	0	10912
27501	64	176	39	10803	0	11082
27502	63	72	51	10817	0	11003
27503	48	10967	36	221	0	11272
27504	48	161	43	11136	0	11388
27505	62	76	11195	212	0	11545
27506	56	54	11097	120	0	11327
27507	10941	43	198	98	0	11280
27508	11345	33	91	87	0	11556
27509	214	11245	68	78	0	11605
27510	11281	151	44	67	0	11543
27511	239	66	45	11240	0	11590
27512	11271	42	35	187	0	11535
27513	221	11238	33	92	0	11584
27514	171	179	11123	59	0	11532
27515	11018	77	198	71	0	11364
27516	225	54	11424	65	0	11768
27517	117	34	10511	52	0	10714
27518	73	45	10404	58	0	10580
27519	57	10050	166	39	0	10312
27520	9084	213	255	72	0	9624
27521	8767	35	51	42	0	8895
27522	130	23	21	8634	0	8808
27523	62	26	28	8542	0	8658
27524	49	8695	27	105	0	8876
27525	8770	81	27	62	0	8940
27526	106	8716	24	33	0	8879
27527	53	8513	18	23	0	8607
27528	8267	83	29	32	0	8411
27529	115	39	22	8168	0	8344
27530	46	22	11	8201	0	8280
27531	43	20	13	8232	0	8308
27532	26	8169	10	97	0	8302
27533	8058	74	12	45	0	8189
27534	96	51	13	7923	0	8083
27535	34	7685	10	70	0	7799
27536	19	7630	15	33	0	7697
27537	32	91	9	7315	0	7447
27538	19	7428	7	62	0	7516
27539	32	76	5	7393	0	7506
27540	7243	22	11	82	0	7358
27541	57	15	7078	26	0	7176
27542	23	7086	47	18	0	7174
27543	24	65	14	7112	0	7215
27544	12	23	7297	57	0	7389
27545	7132	18	61	30	0	7241
27546	75	24	11	7302	0	7412
27547	7284	6	14	73	0	7377
27548	7225	12	5	34	0	7276
27549	65	7514	4	23	0	7606
27550	7592	59	7	24	0	7682
27551	7577	13	8	29	0	7627
27552	7608	19	1	19	0	7647
27553	77	9	6	7485	0	7577
27554	41	6	6	7438	0	7491
27555	31	6	7	7478	0	7522
27556	13	10	7404	79	0	7506
27557	15	7325	50	32	0	7422
27558	7179	55	14	27	0	7275
27559	53	7103	9	13	0	7178
27560	30	50	11	7046	0	7137
27561	18	20	6989	45	0	7072
27562	6560	3	45	36	0	6644
27563	50	6949	9	16	0	7024
27564	23	46	8	6943	0	7020
27565	23	11	5	6887	0	6926
27566	17	9	6843	45	0	6914
27567	8	6812	43	21	0	6884
27568	18	41	8	6839	0	6906
27569	11	16	3	6882	0	6912
27570	13	9	9	6700	0	6731
27571	6569	12	6	68	0	6655
27572	46	11	6535	18	0	6610
27573	16	6477	45	15	0	6553
27574	6427	42	12	34	0	6515
27575	42	6512	11	13	0	6578
27576	14	43	11	6447	0	6515
27577	12	6552	4	41	0	6609
27578	6356	38	8	23	0	6425
27579	6504	13	4	31	0	6552
27580	54	12	7	6645	0	6718
27581	27	14	9	6680	0	6730
27582	20	10	4	6914	0	6948
27583	13	8	7042	71	0	7134
27584	14	7302	66	25	0	7407
27585	24	79	9	8189	0	8301
27586	19	13	12	8435	0	8479
27587	27	16	7	8611	0	8661
27588	34	11	6	8682	0	8733
27589	11	15	8624	149	0	8799
27590	9	9262	95	72	0	9438
27591	28	127	25	9786	0	9966
27592	24	47	12	10661	0	10744
27593	13	28	10578	203	0	10822
27594	31	27	139	10325	0	10522
27595	13	10300	52	189	0	10554
27596	9	10587	22	117	0	10735
27597	27	227	26	10463	0	10743
27598	9	73	10227	206	0	10515
27599	9556	48	148	143	0	9895
27600	138	10130	68	86	0	10422
27601	60	173	9953	67	0	10253
27602	28	70	9891	72	0	10061
27603	22	9886	214	45	0	10167
27604	32	178	10039	42	0	10291
27605	59	183	187	9688	0	10117
27606	9682	43	103	187	0	10015
27607	9807	37	59	102	0	10005
27608	9814	50	50	72	0	9986
27609	10045	39	56	71	0	10211
27610	211	10227	39	55	0	10532
27611	10325	173	33	62	0	10593
27612	201	10434	53	47	0	10735
27613	112	181	10338	53	0	10684
27614	88	102	165	10069	0	10424
27615	59	10445	92	150	0	10746
27616	74	185	46	10178	0	10483
27617	10077	116	56	188	0	10437
27618	190	67	55	9956	0	10268
27619	90	10167	42	194	0	10493
27620	10219	183	52	101	0	10555
27621	198	93	10201	55	0	10547
27622	130	61	163	10159	0	10513
27623	85	58	90	10345	0	10578
27624	9999	55	45	259	0	10358
27625	216	9967	41	105	0	10329
27626	106	183	9868	78	0	10235
27627	94	93	162	9908	0	10257
27628	82	51	10011	194	0	10338
27629	60	9782	172	114	0	10128
27630	63	10027	83	92	0	10265
27631	9902	229	62	82	0	10275
27632	186	102	9881	82	0	10251
27633	10001	78	182	85	0	10346
27634	187	80	96	9874	0	10237
27635	96	10044	61	210	0	10411
27636	10011	182	58	116	0	10367
27637	179	96	10151	88	0	10514
27638	116	77	167	10080	0	10440
27639	91	59	89	10188	0	10427
27640	70	75	76	10084	0	10305
27641	69	9991	52	266	0	10378
27642	9741	177	80	157	0	10155
27643	183	9761	56	102	0	10102
27644	88	9806	41	94	0	10029
27645	84	226	73	9745	0	10128
27646	9774	115	52	210	0	10151
27647	9722	72	62	123	0	9979
27648	9724	84	41	95	0	9944
27649	230	9378	40	80	0	9728
27650	148	185	42	9374	0	9749
27651	92	123	9350	172	0	9737
27652	109	78	152	9286	0	9625
27653	86	66	76	9295	0	9523
27654	70	9345	56	227	0	9698
27655	9442	183	34	139	0	9798
27656	198	110	54	9302	0	9664
27657	112	9437	37	206	0	9792
27658	9442	183	39	136	0	9800
27659	188	111	9306	94	0	9699
27660	9215	88	142	103	0	9548
27661	209	9415	77	89	0	9790
27662	9537	206	48	66	0	9857
27663	9573	117	47	59	0	9796
27664	244	86	9463	73	0	9866
27665	9451	81	164	64	0	9760
27666	239	64	9724	69	0	10096
27667	156	55	9794	57	0	10062
27668	9717	75	203	45	0	10040
27669	9896	57	99	65	0	10117
27670	266	50	10002	47	0	10365
27671	134	57	187	9906	0	10284
27672	117	39	109	9920	0	10185
27673	108	10203	66	191	0	10568
27674	9804	175	67	113	0	10159
27675	10305	87	68	93	0	10553
27676	257	75	10163	70	0	10565
27677	10257	50	162	80	0	10549
27678	10527	66	102	54	0	10749
27679	292	10275	59	51	0	10677
27680	155	175	72	10211	0	10613
27681	143	81	71	9869	0	10164
27682	133	58	46	10024	0	10261
27683	9650	50	51	221	0	9972
27684	193	9326	50	114	0	9683
27685	110	160	42	8333	0	8645
27686	64	8172	45	125	0	8406
27687	72	425	31	7569	0	8097
27688	57	7740	25	119	0	7941
27689	48	7832	41	75	0	7996
27690	6822	193	83	102	0	7200
27691	6663	56	75	76	0	6870
27692	51	23	9	6146	0	6229
27693	22	8	4	6110	0	6144
27694	21	4	4	6151	0	6180
27695	10	7	3	6165	0	6185
27696	9	7	5	6070	0	6091
27697	9	6006	5	41	0	6061
27698	15	27	5	6099	0	6146
27699	14	7	3	6156	0	6180
27700	6110	7	7	41	0	6165
27701	42	5	2	6118	0	6167
27702	11	5	5	6114	0	6135
27703	9	9	6133	37	0	6188
27704	16	8	29	5969	0	6022
27705	11	8	9	6137	0	6165
27706	12	9	6158	39	0	6218
27707	16	6164	30	17	0	6227
27708	10	29	6263	15	0	6317
27709	11	5	6108	13	0	6137
27710	3	5970	22	12	0	6007
27711	6108	19	18	24	0	6169
27712	6016	12	8	13	0	6049
27713	27	3	3	5970	0	6003
27714	6072	4	3	26	0	6105
27715	30	5	6241	9	0	6285
27716	16	2	22	6323	0	6363
27717	14	2	6696	27	0	6739
27718	8	6	26	6736	0	6776
27719	6	1	9	6728	0	6744
27720	8	3	9	6766	0	6786
27721	6721	3	2	54	0	6780
27722	29	2	7	6796	0	6834
27723	6751	6	4	46	0	6807
27724	6802	4	1	28	0	6835
27725	29	6812	6	17	0	6864
27726	6889	25	6	26	0	6946
27727	31	7032	3	15	0	7081
27728	17	34	5	6987	0	7043
27729	27	8	2	7061	0	7098
27730	11	9	6	7140	0	7166
27731	10	1	6995	60	0	7066
27732	6	6932	39	22	0	6999
27733	2	33	9	6761	0	6805
27734	11	10	11	6780	0	6812
27735	5	6880	7	45	0	6937
27736	6916	31	7	30	0	6984
27737	37	6736	1	26	0	6800
27738	6727	37	1	18	0	6783
27739	45	6847	4	21	0	6917
27740	21	44	1	6761	0	6827
27741	14	6960	5	41	0	7020
27742	7113	42	5	30	0	7190
27743	7173	15	6	26	0	7220
27744	7115	14	4	28	0	7161
27745	7095	7	3	32	0	7137
27746	44	12	7089	19	0	7164
27747	7120	5	31	27	0	7183
27748	7293	9	11	23	0	7336
27749	7265	7	6	19	0	7297
27750	54	14	7198	14	0	7280
27751	7119	9	32	22	0	7182
27752	45	7353	14	18	0	7430
27753	7416	33	6	21	0	7476
27754	46	22	7756	11	0	7835
27755	7676	18	39	36	0	7769
27756	7845	10	11	25	0	7891
27757	50	7	11	7802	0	7870
27758	33	13	7689	35	0	7770
27759	7717	3	32	34	0	7786
27760	55	8	9	7903	0	7975
27761	37	5	13	8011	0	8066
27762	27	8	7999	46	0	8080
27763	7560	8	36	38	0	7642
27764	8030	6	12	27	0	8075
27765	46	8077	13	23	0	8159
27766	32	34	5	8069	0	8140
27767	18	14	12	8016	0	8060
27768	24	10	3	8004	0	8041
27769	20	8009	11	47	0	8087
27770	7932	39	10	31	0	8012
27771	49	11	5	7942	0	8007
27772	29	12	6	7933	0	7980
27773	7732	4	9	65	0	7810
27774	7698	9	2	40	0	7749
27775	53	3	6	7788	0	7850
27776	29	12	8	7654	0	7703
27777	19	8	7409	50	0	7486
27778	6952	5	26	43	0	7026
27779	38	7451	11	25	0	7525
27780	27	37	8	7737	0	7809
27781	29	11	7	7862	0	7909
27782	19	8122	9	58	0	8208
27783	32	52	1	8422	0	8507
27784	8984	30	7	100	0	9121
27785	88	13	5	10352	0	10458
27786	52	14	1	10762	0	10829
27787	37	14	0	11049	0	11100
27788	13	11	10885	261	0	11170
27789	40	9	117	10996	0	11162
27790	16	9	10870	220	0	11115
27791	21	10630	148	164	0	10963
27792	26	116	115	10700	0	10957
27793	27	77	62	10961	0	11127
27794	26	39	44	11230	0	11339
27795	23	36	38	11288	0	11385
27796	19	35	20	11482	0	11556
27797	11094	18	19	336	0	11467
27798	123	17	11196	196	0	11532
27799	88	10920	122	147	0	11277
27800	40	11508	86	122	0	11756
27801	54	179	42	11873	0	12148
27802	53	106	42	12065	0	12266
27803	27	59	42	11941	0	12069
27804	18	11918	26	271	0	12233
27805	26	153	26	12027	0	12232
27806	9	115	11809	239	0	12172
27807	6	11699	118	175	0	11998
27808	23	172	79	11832	0	12106
27809	11614	106	46	241	0	12007
27810	130	49	27	11696	0	11902
27811	100	48	31	11559	0	11738
27812	47	11189	29	261	0	11526
27813	41	11700	25	178	0	11944
27814	59	197	17	11692	0	11965
27815	39	112	10	11664	0	11825
27816	30	62	11469	273	0	11834
27817	32	62	117	11233	0	11444
27818	19	45	79	11355	0	11498
27819	30	44	51	11310	0	11435
27820	18	30	46	11482	0	11576
27821	11186	34	42	329	0	11591
27822	11320	26	25	250	0	11621
27823	217	23	25	11538	0	11803
27824	132	20	13	11935	0	12100
27825	11736	16	16	367	0	12135
27826	217	25	14	12193	0	12449
27827	132	18	12176	339	0	12665
27828	75	12189	152	260	0	12676
27829	74	154	111	12492	0	12831
27830	62	95	76	12678	0	12911
27831	12546	58	62	373	0	13039
27832	172	53	61	12807	0	13093
27833	114	60	40	12995	0	13209
27834	12847	42	29	421	0	13339
27835	203	40	16	13048	0	13307
27836	137	12984	25	357	0	13503
27837	89	171	23	13581	0	13864
27838	81	114	25	14001	0	14221
27839	87	69	22	13916	0	14094
27840	66	59	41	13966	0	14132
27841	49	70	13487	418	0	14024
27842	28	84	13153	298	0	13563
27843	26	68	233	13431	0	13758
27844	28	49	126	13305	0	13508
27845	30	13269	69	418	0	13786
27846	48	182	77	13098	0	13405
27847	30	13157	77	359	0	13623
27848	13123	221	61	262	0	13667
27849	172	13649	47	220	0	14088
27850	121	248	35	13840	0	14244
27851	81	162	23	14051	0	14317
27852	59	106	13657	409	0	14231
27853	13217	79	168	300	0	13764
27854	13268	85	109	227	0	13689
27855	259	13259	72	206	0	13796
27856	160	199	63	13149	0	13571
27857	101	131	13681	293	0	14206
27858	93	13781	201	251	0	14326
27859	13703	212	119	201	0	14235
27860	13711	153	66	182	0	14112
27861	284	91	13278	171	0	13824
27862	13370	74	188	158	0	13790
27863	296	63	105	13411	0	13875
27864	204	13402	61	285	0	13952
27865	13351	180	60	216	0	13807
27866	267	126	69	13269	0	13731
27867	13418	63	47	291	0	13819
27868	13892	69	33	260	0	14254
27869	343	67	39	13758	0	14207
27870	195	65	13792	329	0	14381
27871	13860	44	192	250	0	14346
27872	14267	45	103	188	0	14603
27873	14382	34	56	170	0	14642
27874	366	14454	58	165	0	15043
27875	230	194	58	14501	0	14983
27876	169	115	50	15094	0	15428
27877	131	79	14848	396	0	15454
27878	113	84	188	14705	0	15090
27879	79	14590	104	335	0	15108
27880	14229	214	57	275	0	14775
27881	213	14217	54	219	0	14703
27882	149	205	13908	158	0	14420
27883	79	13915	219	155	0	14368
27884	79	14114	165	113	0	14471
27885	210	201	147	12040	0	12598
27886	12004	60	63	144	0	12271
27887	11943	26	11	76	0	12056
27888	11792	18	11	48	0	11869
27889	136	11997	17	30	0	12180
27890	56	114	11879	33	0	12082
27891	11789	50	110	51	0	12000
27892	12036	18	41	44	0	12139
27893	148	11954	16	23	0	12141
27894	12160	114	16	40	0	12330
27895	139	55	14	12205	0	12413
27896	59	36	12649	113	0	12857
27897	12573	22	107	86	0	12788
27898	12588	22	40	56	0	12706
27899	12971	22	21	34	0	13048
27900	173	14	12	12759	0	12958
27901	76	15	11	13096	0	13198
27902	51	14	20	13603	0	13688
27903	44	13650	10	189	0	13893
27904	95	161	17	13841	0	14114
27905	49	59	13	15560	0	15681
27906	42	46	15630	265	0	15983
27907	50	20	202	15668	0	15940
27908	37	28	64	16100	0	16229
27909	48	25	43	16110	0	16226
27910	53	10	21	16038	0	16122
27911	38	15866	29	311	0	16244
27912	47	213	20	16034	0	16314
27913	51	65	17	16050	0	16183
27914	15768	41	33	364	0	16206
27915	227	32	15758	165	0	16182
27916	91	32	15523	124	0	15770
27917	15385	29	259	110	0	15783
27918	15906	28	99	86	0	16119
27919	304	29	53	15007	0	15393
27920	124	15662	37	235	0	16058
27921	15703	219	48	116	0	16086
27922	288	71	30	15421	0	15810
27923	114	15591	37	234	0	15976
27924	15466	178	35	121	0	15800
27925	237	15457	20	73	0	15787
27926	15167	228	16	65	0	15476
27927	14852	76	27	74	0	15029
27928	269	14562	18	50	0	14899
27929	156	207	13	14445	0	14821
27930	94	80	14380	220	0	14774
27931	74	104	185	14201	0	14564
27932	14190	42	60	252	0	14544
27933	227	43	14070	95	0	14435
27934	93	13916	183	79	0	14271
27935	114	249	69	13669	0	14101
27936	65	85	13578	207	0	13935
27937	32	13408	187	107	0	13734
27938	13180	200	86	105	0	13571
27939	214	71	59	13318	0	13662
27940	93	51	34	13409	0	13587
27941	72	36	41	13278	0	13427
27942	34	13232	41	262	0	13569
27943	13178	199	25	153	0	13555
27944	195	13032	39	99	0	13365
27945	72	13392	27	72	0	13563
27946	13351	235	13	91	0	13690
27947	13385	96	11	99	0	13591
27948	242	61	13041	61	0	13405
27949	12764	58	164	87	0	13073
27950	12849	48	56	62	0	13015
27951	277	36	45	12645	0	13003
27952	130	50	12613	200	0	12993
27953	104	48	173	12607	0	12932
27954	12730	29	65	252	0	13076
27955	240	26	13009	98	0	13373
27956	126	36	201	13555	0	13918
27957	130	26	71	14400	0	14627
27958	92	24	53	15718	0	15887
27959	15832	21	39	446	0	16338
27960	334	16086	45	173	0	16638
27961	16186	329	30	136	0	16681
27962	417	110	16302	89	0	16918
27963	168	75	336	15930	0	16509
27964	107	16429	125	371	0	17032
27965	16565	344	66	184	0	17159
27966	412	114	52	16589	0	17167
27967	151	89	16287	390	0	16917
27968	114	64	314	15988	0	16480
27969	15704	48	118	452	0	16322
27970	354	15723	97	175	0	16349
27971	182	384	47	14623	0	15236
27972	92	15548	48	355	0	16043
27973	15433	372	34	168	0	16007
27974	15242	128	27	151	0	15548
27975	402	15061	48	93	0	15604
27976	14839	325	44	93	0	15301
27977	432	127	33	14339	0	14931
27978	162	14730	31	304	0	15227
27979	14687	333	28	144	0	15192
27980	14953	145	29	120	0	15247
27981	454	14358	36	65	0	14913
27982	212	14600	29	82	0	14923
27983	14364	382	13	60	0	14819
27984	410	169	17	14232	0	14828
27985	14417	111	22	349	0	14899
27986	419	89	21	14350	0	14879
27987	184	84	14202	359	0	14829
27988	181	63	279	14422	0	14945
27989	14280	70	78	402	0	14830
27990	379	79	14385	143	0	14986
27991	192	38	302	14467	0	14999
27992	150	43	97	14851	0	15141
27993	101	49	14506	418	0	15074
27994	14174	42	304	210	0	14730
27995	364	28	131	14391	0	14914
27996	129	41	13813	384	0	14367
27997	13229	46	321	171	0	13767
27998	336	13715	117	141	0	14309
27999	138	13730	93	123	0	14084
28000	103	13979	66	119	0	14267
28001	85	348	13321	84	0	13838
28002	130	277	294	12718	0	13419
28003	77	84	12710	327	0	13198
28004	77	340	274	11236	0	11927
28005	39	10965	100	266	0	11370
28006	39	10931	62	105	0	11137
28007	91	257	50	10652	0	11050
28008	10672	99	41	255	0	11067
28009	240	63	24	10818	0	11145
28010	87	50	26	10819	0	10982
28011	54	10742	36	265	0	11097
28012	10675	210	18	140	0	11043
28013	231	10804	24	80	0	11139
28014	92	240	23	10795	0	11150
28015	82	111	25	10720	0	10938
28016	53	10682	33	266	0	11034
28017	65	216	36	10756	0	11073
28018	10668	99	23	296	0	11086
28019	263	99	14	10705	0	11081
28020	132	71	22	10751	0	10976
28021	93	10596	30	285	0	11004
28022	87	219	39	10734	0	11079
28023	10361	85	33	289	0	10768
28024	10598	85	26	149	0	10858
28025	10748	80	11	117	0	10956
28026	328	73	21	10619	0	11041
28027	142	62	10457	282	0	10943
28028	121	59	10462	138	0	10780
28029	109	53	245	10629	0	11036
28030	10709	71	87	269	0	11136
28031	256	63	55	10798	0	11172
28032	11017	57	32	307	0	11413
28033	303	61	31	11130	0	11525
28034	170	42	23	11426	0	11661
28035	11307	49	26	312	0	11694
28036	279	69	10996	139	0	11483
28037	10996	61	201	117	0	11375
28038	313	43	11061	89	0	11506
28039	155	49	217	10983	0	11404
28040	11195	42	81	252	0	11570
28041	292	38	11291	119	0	11740
28042	130	63	11282	81	0	11556
28043	11208	50	268	91	0	11617
28044	287	42	11392	100	0	11821
28045	143	11323	256	85	0	11807
28046	97	209	107	11845	0	12258
28047	12418	69	87	323	0	12897
28048	264	45	12513	149	0	12971
28049	12515	30	243	128	0	12916
28050	12888	36	120	96	0	13140
28051	12881	21	107	102	0	13111
28052	12838	26	66	108	0	13038
28053	334	101	72	12414	0	12921
28054	150	12425	66	265	0	12906
28055	12139	219	58	137	0	12553
28056	259	64	11520	87	0	11930
28057	97	10116	126	37	0	10376
28058	9156	84	74	34	0	9348
28059	86	8563	28	19	0	8696
28060	33	8734	17	20	0	8804
28061	209	89	85	8469	0	8852
28062	30	22	19	8648	0	8719
28063	16	14	7	8632	0	8669
28064	8728	8	9	71	0	8816
28065	8905	7	8	38	0	8958
28066	90	8	7	9120	0	9225
28067	43	7	7	9588	0	9645
28068	20	9	9950	99	0	10078
28069	9827	16	97	44	0	9984
28070	10220	8	28	28	0	10284
28071	131	12	22	10173	0	10338
28072	55	11	6	10248	0	10320
28073	33	6	10172	137	0	10348
28074	28	13	101	10155	0	10297
28075	19	6	10502	130	0	10657
28076	24	10449	123	55	0	10651
28077	27	93	10592	38	0	10750
28078	35	39	124	10340	0	10538
28079	17	16	10821	121	0	10975
28080	13	9	10342	45	0	10409
28081	10649	12	133	41	0	10835
28082	131	13	61	11276	0	11481
28083	40	12	11337	121	0	11510
28084	10625	13	120	60	0	10818
28085	121	18	11478	37	0	11654
28086	43	11	12318	26	0	12398
28087	35	12573	142	40	0	12790
28088	41	100	48	12545	0	12734
28089	19	26	12537	114	0	12696
28090	20	20	12090	34	0	12164
28091	35	14	133	12321	0	12503
28092	38	11	64	12327	0	12440
28093	21	12400	45	137	0	12603
28094	22	98	30	12499	0	12649
28095	12701	25	28	150	0	12904
28096	12656	22	26	69	0	12773
28097	12913	7	33	64	0	13017
28098	157	18	23	12625	0	12823
28099	62	12827	25	118	0	13032
28100	12878	102	27	66	0	13073
28101	123	12900	23	50	0	13096
28102	50	12717	25	36	0	12828
28103	42	12843	23	38	0	12946
28104	12941	123	27	46	0	13137
28105	118	42	19	12899	0	13078
28106	44	31	39	12868	0	12982
28107	36	12920	28	122	0	13106
28108	12696	111	26	86	0	12919
28109	110	44	12771	43	0	12968
28110	51	39	121	12814	0	13025
28111	12816	22	41	133	0	13012
28112	123	13261	46	52	0	13482
28113	13702	99	32	76	0	13909
28114	145	38	22	13897	0	14102
28115	55	14201	22	125	0	14403
28116	43	115	14053	37	0	14248
28117	13957	40	115	61	0	14173
28118	127	40	44	14406	0	14617
28119	14533	32	36	141	0	14742
28120	133	37	30	14468	0	14668
28121	53	14479	29	144	0	14705
28122	43	102	14782	63	0	14990
28123	36	42	14664	59	0	14801
28124	42	102	129	14806	0	15079
28125	14980	30	75	149	0	15234
28126	15001	20	44	55	0	15120
28127	150	19	26	14876	0	15071
28128	81	24	21	14947	0	15073
28129	15095	22	20	156	0	15293
28130	137	24	29	15137	0	15327
28131	15176	18	35	153	0	15382
28132	127	15057	28	64	0	15276
28133	14906	108	21	73	0	15108
28134	142	45	15215	38	0	15440
28135	73	35	112	15154	0	15374
28136	61	25	50	15394	0	15530
28137	54	24	40	15451	0	15569
28138	57	15078	31	155	0	15321
28139	55	13138	36	97	0	13326
28140	44	116	28	15158	0	15346
28141	44	52	14986	134	0	15216
28142	46	40	108	14837	0	15031
28143	42	31	53	15100	0	15226
28144	36	14857	37	197	0	15127
28145	14718	111	38	86	0	14953
28146	107	14306	33	62	0	14508
28147	42	14383	37	51	0	14513
28148	56	137	39	14196	0	14428
28149	67	46	40	14279	0	14432
28150	52	33	26	14218	0	14329
28151	45	34	24	14277	0	14380
28152	14140	27	20	169	0	14356
28153	106	14109	39	71	0	14325
28154	14263	109	33	86	0	14491
28155	14562	45	33	79	0	14719
28156	132	38	29	14459	0	14658
28157	61	28	25	14663	0	14777
28158	14616	22	24	175	0	14837
28159	14772	16	17	102	0	14907
28160	137	24	18	14462	0	14641
28161	73	31	11	14557	0	14672
28162	82	29	14499	131	0	14741
28163	56	14184	79	69	0	14388
28164	55	14651	27	66	0	14799
28165	14212	92	29	78	0	14411
28166	105	31	14679	50	0	14865
28167	40	31	13826	30	0	13927
28168	12957	29	102	35	0	13123
28169	13544	11	47	39	0	13641
28170	51	14460	17	24	0	14552
28171	17	14874	19	23	0	14933
28172	30	38	8	15175	0	15251
28173	15704	16	6	83	0	15809
28174	15767	16	7	53	0	15843
28175	15808	12	7	48	0	15875
28176	52	14	7	15745	0	15818
28177	24	19	5	15884	0	15932
28178	23	12	15741	55	0	15831
28179	25	12	14732	34	0	14803
28180	24	17	15693	24	0	15758
28181	28	147	56	15533	0	15764
28182	15371	5	30	73	0	15479
28183	52	11	15777	19	0	15859
28184	30	7	44	15705	0	15786
28185	15	15932	17	44	0	16008
28186	16	42	7	15503	0	15568
28187	15	11	9	15584	0	15619
28188	14	10	16040	60	0	16124
28189	24	6	64	15904	0	15998
28190	16761	2	15	94	0	16872
28191	101	11	17445	29	0	17586
28192	48	6	106	17502	0	17662
28193	16	13	18277	112	0	18418
28194	17	18460	134	51	0	18662
28195	27	128	18665	29	0	18849
28196	55	42	153	17627	0	17877
28197	23	27	68	18731	0	18849
28198	17	32	19211	177	0	19437
28199	33	18	159	18738	0	18948
28200	24	23	61	18684	0	18792
28201	11	18798	45	200	0	19054
28202	10	132	19079	92	0	19313
28203	46	42	162	18945	0	19195
28204	39	28	62	19336	0	19465
28205	17	19350	46	218	0	19631
28206	29	154	37	19626	0	19846
28207	19616	56	31	240	0	19943
28208	169	36	35	19691	0	19931
28209	44	34	19809	224	0	20111
28210	19424	25	161	147	0	19757
28211	20832	29	68	117	0	21046
28212	259	19	20800	76	0	21154
28213	20162	10	231	107	0	20510
28214	242	21093	85	75	0	21495
28215	118	218	57	21469	0	21862
28216	104	88	47	23485	0	23724
28217	90	47	32	23219	0	23388
28218	67	43	49	23992	0	24151
28219	62	34	29	23991	0	24116
28220	23688	32	27	524	0	24271
28221	310	26	23437	248	0	24021
28222	22485	19	296	231	0	23031
28223	339	29	23086	170	0	23624
28224	201	19	333	23002	0	23555
28225	23147	29	160	414	0	23750
28226	398	18	110	22982	0	23508
28227	181	23237	102	396	0	23916
28228	23961	290	85	236	0	24572
28229	400	114	77	24573	0	25164
28230	182	78	22775	448	0	23483
28231	23113	52	255	267	0	23687
28232	369	24736	123	210	0	25438
28233	200	312	25138	149	0	25799
28234	164	133	340	24829	0	25466
28235	162	65	171	24210	0	24608
28236	123	24766	121	463	0	25473
28237	109	327	24885	241	0	25562
28238	119	152	341	24844	0	25456
28239	98	92	25381	464	0	26035
28240	103	76	393	25210	0	25782
28241	102	63	177	25418	0	25760
28242	97	70	25195	561	0	25923
28243	115	57	394	25200	0	25766
28244	217	87	286	20041	0	20631
28245	137	58	147	26082	0	26424
28246	99	41	157	26180	0	26477
28247	25240	50	135	734	0	26159
28248	412	44	25126	409	0	25991
28249	25711	47	412	361	0	26531
28250	500	59	229	26716	0	27504
28251	269	53	175	27229	0	27726
28252	195	55	141	27010	0	27401
28253	166	26625	145	771	0	27707
28254	26886	415	121	439	0	27861
28255	472	186	122	28800	0	29580
28256	242	28807	130	609	0	29788
28257	151	415	96	29277	0	29939
28258	29188	174	104	697	0	30163
28259	29114	141	98	460	0	29813
28260	29008	121	108	380	0	29617
28261	597	28860	120	328	0	29905
28262	317	413	28843	275	0	29848
28263	28505	200	418	350	0	29473
28264	29277	129	219	317	0	29942
28265	622	29254	160	270	0	30306
28266	29037	409	123	314	0	29883
28267	28503	215	139	274	0	29131
28268	29180	136	110	311	0	29737
28269	691	29419	113	282	0	30505
28270	429	429	109	29122	0	30089
28271	29068	198	104	613	0	29983
28272	29495	151	94	371	0	30111
28273	28663	131	93	305	0	29192
28274	29130	111	80	304	0	29625
28275	767	102	70	28566	0	29505
28276	434	114	28312	597	0	29457
28277	404	88	420	28126	0	29038
28278	324	28436	195	609	0	29564
28279	336	435	140	29145	0	30056
28280	292	201	29266	649	0	30408
28281	29248	147	465	385	0	30245
28282	658	129	216	29777	0	30780
28283	29458	129	155	661	0	30403
28284	29525	125	120	424	0	30194
28285	772	111	113	29489	0	30485
28286	466	102	29308	646	0	30522
28287	400	109	28067	344	0	28920
28288	27498	101	559	296	0	28454
28289	650	28031	261	262	0	29204
28290	388	27427	160	202	0	28177
28291	314	26912	138	215	0	27579
28292	305	27651	134	196	0	28286
28293	26483	552	289	210	0	27534
28294	26486	253	114	193	0	27046
28295	26384	180	82	174	0	26820
28296	26443	147	67	183	0	26840
28297	663	165	57	25742	0	26627
28298	380	25403	70	418	0	26271
28299	25445	375	83	245	0	26148
28300	570	173	25201	165	0	26109
28301	352	25059	348	158	0	25917
28302	314	363	25111	159	0	25947
28303	24723	190	375	180	0	25468
28304	25293	135	186	176	0	25790
28305	25313	146	136	154	0	25749
28306	620	129	102	24960	0	25811
28307	379	118	24863	384	0	25744
28308	312	24748	345	217	0	25622
28309	24170	323	173	207	0	24873
28310	496	24003	123	163	0	24785
28311	318	23085	76	148	0	23627
28312	268	22638	80	129	0	23115
28313	251	22577	90	133	0	23051
28314	220	370	21508	107	0	22205
28315	191	21417	292	129	0	22029
28316	19301	270	127	96	0	19794
28317	277	114	51	19273	0	19715
28318	178	78	40	19414	0	19710
28319	19234	72	37	268	0	19611
28320	242	19067	55	126	0	19490
28321	142	191	19393	91	0	19817
28322	151	109	184	19205	0	19649
28323	145	78	73	19620	0	19916
28324	125	75	54	19758	0	20012
28325	108	75	19456	237	0	19876
28326	96	79	19233	131	0	19539
28327	134	64	220	19177	0	19595
28328	117	71	18882	190	0	19260
28329	130	65	17841	90	0	18126
28330	16737	63	231	110	0	17141
28331	221	17850	109	103	0	18283
28332	120	17211	68	59	0	17458
28333	112	17417	58	62	0	17649
28334	151	284	73	16815	0	17323
28335	83	17807	49	144	0	18083
28336	18016	198	61	123	0	18398
28337	226	106	18490	66	0	18888
28338	18924	66	207	92	0	19289
28339	271	55	86	19133	0	19545
28340	145	44	62	19508	0	19759
28341	89	20244	74	274	0	20681
28342	20310	263	49	147	0	20769
28343	20539	87	109	101	0	20836
28344	377	21948	49	59	0	22433
28345	164	426	58	21525	0	22173
28346	106	111	22081	331	0	22629
28347	81	89	22372	109	0	22651
28348	81	22801	407	71	0	23360
28349	22470	451	143	129	0	23193
28350	368	109	22609	33	0	23119
28351	177	59	351	22302	0	22889
28352	22723	47	114	387	0	23271
28353	23181	33	58	156	0	23428
28354	449	26466	59	61	0	27035
28355	154	27896	56	56	0	28162
28356	27879	588	48	62	0	28577
28357	546	194	27999	37	0	28776
28358	27880	115	503	70	0	28568
28359	28522	85	158	60	0	28825
28360	709	54	104	28053	0	28920
28361	254	65	28738	497	0	29554
28362	176	64	28636	135	0	29011
28363	28265	58	636	108	0	29067
28364	587	61	29153	73	0	29874
28365	28251	52	614	77	0	28994
28366	28989	47	196	81	0	29313
28367	698	28853	118	44	0	29713
28368	265	523	28782	37	0	29607
28369	174	28454	527	48	0	29203
28370	28005	537	223	77	0	28842
28371	595	203	27908	28	0	28734
28372	295	136	563	27095	0	28089
28373	172	88	27751	497	0	28508
28374	174	56	27936	160	0	28326
28375	130	56	27999	85	0	28270
28376	155	61	27965	62	0	28243
28377	127	27276	757	42	0	28202
28378	133	513	27187	50	0	27883
28379	119	26720	620	75	0	27534
28380	112	509	26463	49	0	27133
28381	26137	186	618	62	0	27003
28382	595	128	270	24689	0	25682
28383	255	26442	185	396	0	27278
28384	26228	514	165	159	0	27066
28385	26451	213	151	125	0	26940
28386	24885	140	180	119	0	25324
28387	26261	128	174	76	0	26639
28388	722	26034	173	58	0	26987
28389	25139	512	156	85	0	25892
28390	26266	223	147	120	0	26756
28391	700	25445	171	106	0	26422
28392	341	586	24115	68	0	25110
28393	300	255	527	24261	0	25343
28394	242	25401	292	438	0	26373
28395	217	573	25457	186	0	26433
28396	207	270	25676	115	0	26268
28397	213	25164	734	99	0	26210
28398	226	25503	381	80	0	26190
28399	239	26479	276	102	0	27096
28400	238	26367	218	105	0	26928
28401	26639	794	211	122	0	27766
28402	27121	364	204	110	0	27799
28403	858	257	27309	93	0	28517
28404	472	230	27737	77	0	28516
28405	393	205	806	27072	0	28476
28406	337	218	396	27614	0	28565
28407	329	224	290	27881	0	28724
28408	27574	204	244	752	0	28774
28409	760	27459	264	306	0	28789
28410	423	28296	288	189	0	29196
28411	359	29078	280	170	0	29887
28412	28666	895	253	153	0	29967
28413	29270	435	297	136	0	30138
28414	1020	279	297	28667	0	30263
28415	29570	256	305	642	0	30773
28416	30015	245	294	259	0	30813
28417	1101	291	273	29370	0	31035
28418	29721	285	281	721	0	31008
28419	1017	29387	349	282	0	31035
28420	589	750	361	29251	0	30951
28421	512	366	29247	666	0	30791
28422	418	29186	914	297	0	30815
28423	421	798	29606	244	0	31069
28424	487	429	932	27954	0	29802
28425	404	29511	575	647	0	31137
28426	465	766	525	29278	0	31034
28427	417	445	472	29891	0	31225
28428	424	360	29531	846	0	31161
28429	399	314	30885	372	0	31970
28430	400	295	1049	30575	0	32319
28431	425	296	626	29537	0	30884
28432	361	30905	509	802	0	32577
28433	29869	866	431	409	0	31575
28434	900	30407	436	291	0	32034
28435	529	30921	373	273	0	32096
28436	382	1001	29801	226	0	31410
28437	307	29716	836	255	0	31114
28438	380	936	540	27440	0	29296
28439	349	29034	416	627	0	30426
28440	329	919	327	27638	0	29213
28441	263	28102	330	685	0	29380
28442	27688	845	288	349	0	29170
28443	748	27908	315	237	0	29208
28444	437	796	203	24906	0	26342
28445	347	26206	207	492	0	27252
28446	25744	736	273	229	0	26982
28447	25466	407	137	225	0	26235
28448	767	25128	142	162	0	26199
28449	24490	654	141	161	0	25446
28450	742	684	186	23368	0	24980
28451	393	296	23724	501	0	24914
28452	366	301	23563	249	0	24479
28453	280	23738	608	236	0	24862
28454	19194	393	391	142	0	20120
28455	18906	168	101	126	0	19301
28456	375	128	18693	121	0	19317
28457	183	119	18263	102	0	18667
28458	17968	119	328	104	0	18519
28459	18541	108	129	117	0	18895
28460	354	108	18145	93	0	18700
28461	17011	118	261	114	0	17504
28462	285	17355	147	102	0	17889
28463	151	17897	99	82	0	18229
28464	157	371	140	17290	0	17958
28465	110	192	94	17537	0	17933
28466	17521	146	102	326	0	18095
28467	17399	135	72	170	0	17776
28468	17402	105	104	118	0	17729
28469	335	119	89	17240	0	17783
28470	173	127	74	17270	0	17644
28471	144	16596	72	320	0	17132
28472	129	16754	60	170	0	17113
28473	123	17349	81	115	0	17668
28474	124	365	77	16604	0	17170
28475	129	17091	61	246	0	17527
28476	119	338	16541	129	0	17127
28477	15710	197	228	132	0	16267
28478	293	167	16680	97	0	17237
28479	153	150	16447	122	0	16872
28480	16150	163	257	82	0	16652
28481	289	16680	146	86	0	17201
28482	16801	303	86	110	0	17300
28483	16938	159	68	135	0	17300
28484	348	172	16410	74	0	17004
28485	210	129	16748	91	0	17178
28486	160	17221	279	98	0	17758
28487	154	305	17385	89	0	17933
28488	175	167	270	17403	0	18015
28489	214	139	165	14415	0	14933
28490	138	17368	137	280	0	17923
28491	163	17862	105	143	0	18273
28492	17846	368	93	114	0	18421
28493	18387	234	98	108	0	18827
28494	392	174	105	18332	0	19003
28495	219	137	110	18616	0	19082
28496	18354	112	115	318	0	18899
28497	18393	132	106	169	0	18800
28498	356	18516	109	130	0	19111
28499	17743	278	93	94	0	18208
28500	341	17140	69	88	0	17638
28501	188	17639	83	81	0	17991
28502	17565	286	92	109	0	18052
28503	17321	171	73	111	0	17676
28504	363	150	58	17066	0	17637
28505	17099	108	61	220	0	17488
28506	364	102	16861	107	0	17434
28507	204	16977	177	111	0	17469
28508	16832	221	87	118	0	17258
28509	271	95	16881	112	0	17359
28510	152	250	192	15756	0	16350
28511	134	15855	101	157	0	16247
28512	145	16015	71	70	0	16301
28513	16000	199	101	72	0	16372
28514	215	97	15742	45	0	16099
28515	15110	54	166	55	0	15385
28516	215	58	89	15352	0	15714
28517	137	49	15313	120	0	15619
28518	14999	54	143	77	0	15273
28519	186	15776	76	40	0	16078
28520	91	16355	68	38	0	16552
28521	16435	196	58	64	0	16753
28522	16375	96	46	91	0	16608
28523	16675	65	26	94	0	16860
28524	245	53	18	16532	0	16848
28525	159	56	33	16597	0	16845
28526	128	38	16528	134	0	16828
28527	94	28	15901	100	0	16123
28528	73	16205	119	87	0	16484
28529	64	174	74	15204	0	15516
28530	15087	33	22	80	0	15222
28531	83	15082	21	39	0	15225
28532	40	77	16	15174	0	15307
28533	15159	36	18	79	0	15292
28534	70	15003	27	47	0	15147
28535	45	15388	7	25	0	15465
28536	41	92	14964	13	0	15110
28537	14613	49	81	35	0	14778
28538	15109	20	24	38	0	15191
28539	79	27	14970	11	0	15087
28540	14182	22	60	29	0	14293
28541	75	18	14954	15	0	15062
28542	34	14727	53	20	0	14834
28543	68	71	31	14547	0	14717
28544	14503	25	33	63	0	14624
28545	63	14347	19	25	0	14454
28546	34	14429	17	18	0	14498
28547	14143	48	13	25	0	14229
28548	45	34	14775	11	0	14865
28549	14197	26	43	53	0	14319
28550	45	15020	20	11	0	15096
28551	29	48	14579	5	0	14661
28552	14248	19	40	22	0	14329
28553	14708	12	16	13	0	14749
28554	67	9	13	14662	0	14751
28555	33	8	9	14801	0	14851
28556	13	14617	12	48	0	14690
28557	20	42	14523	16	0	14601
28558	35	18	41	14680	0	14774
28559	14	22	15346	53	0	15435
28560	24	18	15252	21	0	15315
28561	32	11	72	16169	0	16284
28562	18	13	16548	89	0	16668
28563	23	14	16019	35	0	16091
28564	40	6	118	15866	0	16030
28565	14	12	16314	100	0	16440
28566	15279	18	118	56	0	15471
28567	99	15976	44	27	0	16146
28568	39	90	16426	18	0	16573
28569	29	38	16985	18	0	17070
28570	50	19	135	16222	0	16426
28571	17496	14	52	135	0	17697
28572	17565	15	33	56	0	17669
28573	17457	14	28	39	0	17538
28574	17548	17	27	42	0	17634
28575	152	11	21	17211	0	17395
28576	65	16	17387	99	0	17567
28577	17217	11	104	70	0	17402
28578	17482	6	35	46	0	17569
28579	17573	6	31	48	0	17658
28580	144	14	17149	16	0	17323
28581	16550	10	98	43	0	16701
28582	144	13	44	17611	0	17812
28583	63	17766	34	100	0	17963
28584	72	141	36	17323	0	17572
28585	35	17641	31	123	0	17830
28586	17679	120	37	69	0	17905
28587	141	37	17883	33	0	18094
28588	57	38	140	17420	0	17655
28589	32	17697	68	121	0	17918
28590	39	18111	46	48	0	18244
28591	18076	153	31	56	0	18316
28592	17826	57	38	47	0	17968
28593	171	38	17178	33	0	17420
28594	17243	34	150	49	0	17476
28595	183	18	62	17397	0	17660
28596	92	20	17819	136	0	18067
28597	79	21	17608	54	0	17762
28598	100	14	164	18174	0	18452
28599	19309	18	71	193	0	19591
28600	214	13	57	19257	0	19541
28601	124	9	46	19230	0	19409
28602	84	9	45	19180	0	19318
28603	71	19233	47	315	0	19666
28604	90	163	47	19540	0	19840
28605	19148	66	46	245	0	19505
28606	201	19250	55	128	0	19634
28607	108	194	44	19627	0	19973
28608	19525	94	33	261	0	19913
28609	219	19305	40	134	0	19698
28610	120	19711	32	72	0	19935
28611	83	265	51	19759	0	20158
28612	19359	101	45	280	0	19785
28613	257	68	19331	129	0	19785
28614	137	69	19030	85	0	19321
28615	19433	53	279	85	0	19850
28616	20137	52	121	107	0	20417
28617	340	20639	95	72	0	21146
28618	195	241	71	20053	0	20560
28619	115	120	20295	252	0	20782
28620	112	62	19801	120	0	20095
28621	88	63	21374	78	0	21603
28622	82	21097	404	96	0	21679
28623	91	21397	198	83	0	21769
28624	21310	364	107	86	0	21867
28625	336	156	21297	94	0	21883
28626	21090	84	327	95	0	21596
28627	21486	76	155	103	0	21820
28628	442	66	21728	76	0	22312
28629	216	22216	344	66	0	22842
28630	192	337	154	21862	0	22545
28631	143	155	22755	347	0	23400
28632	115	106	21667	156	0	22044
28633	21755	103	398	130	0	22386
28634	365	22501	192	100	0	23158
28635	211	333	127	21888	0	22559
28636	139	187	104	21772	0	22202
28637	95	21917	95	431	0	22538
28638	114	22356	104	178	0	22752
28639	97	22810	104	121	0	23132
28640	138	453	79	23078	0	23748
28641	23573	236	62	414	0	24285
28642	427	144	55	23912	0	24538
28643	217	110	23796	437	0	24560
28644	113	101	23715	236	0	24165
28645	130	84	525	24025	0	24764
28646	112	105	24199	415	0	24831
28647	101	24206	447	228	0	24982
28648	145	411	218	24875	0	25649
28649	26106	202	159	505	0	26972
28650	26296	117	135	272	0	26820
28651	610	26678	110	160	0	27558
28652	26784	502	107	169	0	27562
28653	27348	240	107	171	0	27866
28654	27480	144	90	169	0	27883
28655	703	148	24005	133	0	24989
28656	26306	109	422	157	0	26994
28657	659	26392	177	155	0	27383
28658	330	506	26330	90	0	27256
28659	229	219	26284	114	0	26846
28660	199	25934	605	123	0	26861
28661	25510	538	305	103	0	26456
28662	558	251	183	24602	0	25594
28663	270	24843	130	449	0	25692
28664	25147	489	103	240	0	25979
28665	569	246	104	25241	0	26160
28666	25609	142	121	537	0	26409
28667	609	134	98	25691	0	26532
28668	340	122	25257	528	0	26247
28669	192	130	24883	273	0	25478
28670	172	136	25246	188	0	25742
28671	241	141	619	24509	0	25510
28672	174	129	301	25429	0	26033
28673	170	121	25097	636	0	26024
28674	169	24974	532	311	0	25986
28675	25420	514	262	198	0	26394
28676	25706	245	218	178	0	26347
28677	678	26004	217	144	0	27043
28678	410	579	147	26412	0	27548
28679	254	258	26979	562	0	28053
28680	26537	146	618	297	0	27598
28681	624	166	27076	202	0	28068
28682	374	143	25267	133	0	25917
28683	251	120	26510	125	0	27006
28684	25635	163	784	149	0	26731
28685	661	148	26118	139	0	27066
28686	345	25089	662	139	0	26235
28687	268	26051	394	123	0	26836
28688	277	663	266	25084	0	26290
28689	269	293	208	25561	0	26331
28690	226	184	25293	648	0	26351
28691	24694	173	593	329	0	25789
28692	25841	154	351	199	0	26545
28693	762	159	242	25522	0	26685
28694	25537	120	221	556	0	26434
28695	642	25273	247	349	0	26511
28696	25038	548	194	223	0	26003
28697	651	24371	214	207	0	25443
28698	355	24641	183	166	0	25345
28699	23752	591	186	157	0	24686
28700	23478	288	161	188	0	24115
28701	24169	198	158	136	0	24661
28702	24381	166	157	176	0	24880
28703	758	134	23120	140	0	24152
28704	23089	141	504	147	0	23881
28705	679	166	264	22654	0	23763
28706	360	22965	204	454	0	23983
28707	22906	456	166	229	0	23757
28708	633	22808	147	163	0	23751
28709	22885	499	152	141	0	23677
28710	618	243	164	22627	0	23652
28711	359	204	128	22989	0	23680
28712	267	160	21786	587	0	22800
28713	295	150	22309	254	0	23008
28714	267	22577	527	177	0	23548
28715	22035	475	261	156	0	22927
28716	571	21644	192	129	0	22536
28717	336	21153	143	131	0	21763
28718	289	21815	131	126	0	22361
28719	264	552	20971	126	0	21913
28720	228	21096	459	90	0	21873
28721	19404	479	223	103	0	20209
28722	19404	218	127	90	0	19839
28723	526	168	115	18901	0	19710
28724	257	18683	107	374	0	19421
28725	225	19150	96	178	0	19649
28726	205	465	115	18927	0	19712
28727	212	222	18934	339	0	19707
28728	197	18476	356	165	0	19194
28729	242	482	143	17898	0	18765
28730	17515	213	139	392	0	18259
28731	17609	183	102	189	0	18083
28732	449	17752	105	135	0	18441
28733	17852	407	115	117	0	18491
28734	17936	202	108	110	0	18356
28735	537	163	97	17428	0	18225
28736	263	138	17248	367	0	18016
28737	197	17461	360	197	0	18215
28738	218	495	170	17128	0	18011
28739	173	247	17066	307	0	17793
28740	174	16766	311	152	0	17403
28741	16023	372	176	114	0	16685
28742	16079	184	122	116	0	16501
28743	412	140	76	15834	0	16462
28744	211	15945	100	304	0	16560
28745	174	325	15894	133	0	16526
28746	214	245	301	15555	0	16315
28747	143	160	15783	296	0	16382
28748	132	14699	244	129	0	15204
28749	258	318	173	12927	0	13676
28750	12830	108	73	207	0	13218
28751	181	12636	48	96	0	12961
28752	12445	193	48	78	0	12764
28753	12363	105	39	63	0	12570
28754	254	12495	46	65	0	12860
28755	160	196	43	12474	0	12873
28756	113	128	36	12425	0	12702
28757	87	12075	40	198	0	12400
28758	77	12432	31	113	0	12653
28759	94	221	42	11776	0	12133
28760	76	12135	40	133	0	12384
28761	12153	177	29	72	0	12431
28762	12065	95	34	61	0	12255
28763	212	85	11919	59	0	12275
28764	105	71	11604	64	0	11844
28765	11560	83	164	58	0	11865
28766	11798	57	82	49	0	11986
28767	178	12098	46	40	0	12362
28768	12033	167	55	48	0	12303
28769	11918	91	36	50	0	12095
28770	196	11759	26	55	0	12036
28771	12020	157	32	50	0	12259
28772	199	118	37	13109	0	13463
28773	126	101	38	13649	0	13914
28774	83	69	14324	238	0	14714
28775	68	13793	176	104	0	14141
28776	60	14225	51	68	0	14404
28777	13259	393	145	219	0	14016
28778	13246	83	61	59	0	13449
28779	12660	46	30	82	0	12818
28780	13355	32	18	61	0	13466
28781	215	40	12564	25	0	12844
28782	71	51	13197	20	0	13339
28783	60	13435	171	28	0	13694
28784	71	185	61	13248	0	13565
28785	89	68	28	13178	0	13363
28786	67	13481	25	160	0	13733
28787	86	176	29	13259	0	13550
28788	13239	69	37	185	0	13530
28789	198	13381	39	53	0	13671
28790	81	185	13675	44	0	13985
28791	55	13750	150	45	0	14000
28792	13617	197	57	55	0	13926
28793	186	87	13625	34	0	13932
28794	13340	70	161	61	0	13632
28795	13742	46	56	49	0	13893
28796	214	61	13625	31	0	13931
28797	91	40	13441	26	0	13598
28798	72	52	13347	21	0	13492
28799	12657	43	221	29	0	12950
28800	196	33	13450	19	0	13698
28801	99	13213	187	21	0	13520
28802	13198	158	70	32	0	13458
28803	177	50	13203	9	0	13439
28804	12618	41	189	25	0	12873
28805	194	22	13142	12	0	13370
28806	96	24	13515	16	0	13651
28807	74	13683	213	23	0	13993
28808	58	169	13771	14	0	14012
28809	69	53	13525	16	0	13663
28810	50	11879	233	14	0	12176
28811	13292	153	96	31	0	13572
28812	185	67	13570	13	0	13835
28813	89	47	198	12758	0	13092
28814	57	13570	90	141	0	13858
28815	13688	175	85	52	0	14000
28816	13623	71	68	52	0	13814
28817	211	57	13657	22	0	13947
28818	92	13183	191	28	0	13494
28819	56	13683	102	34	0	13875
28820	67	216	55	13277	0	13615
28821	67	12268	50	151	0	12536
28822	115	201	56	11781	0	12153
28823	93	86	41	13569	0	13789
28824	68	13690	64	179	0	14001
28825	70	199	49	13473	0	13791
28826	60	13562	48	173	0	13843
28827	59	209	13354	78	0	13700
28828	75	110	173	13282	0	13640
28829	63	83	66	13345	0	13557
28830	48	13266	65	222	0	13601
28831	53	13644	43	97	0	13837
28832	54	221	55	13109	0	13439
28833	61	13322	52	192	0	13627
28834	13210	229	62	86	0	13587
28835	203	96	62	13246	0	13607
28836	93	13354	63	184	0	13694
28837	13057	213	53	97	0	13420
28838	193	13065	66	69	0	13393
28839	94	229	13039	64	0	13426
28840	96	115	201	12834	0	13246
28841	13034	93	96	203	0	13426
28842	204	66	13203	105	0	13578
28843	109	103	201	12663	0	13076
28844	105	12848	103	169	0	13225
28845	85	219	12707	72	0	13083
28846	82	12954	231	57	0	13324
28847	12045	214	98	64	0	12421
28848	12745	94	108	40	0	12987
28849	234	12625	95	34	0	12988
28850	12577	193	96	47	0	12913
28851	208	108	12554	39	0	12909
28852	119	87	234	12270	0	12710
28853	98	88	113	12243	0	12542
28854	89	12473	113	188	0	12863
28855	13050	213	95	83	0	13441
28856	13425	112	92	73	0	13702
28857	239	95	13460	36	0	13830
28858	13285	67	215	64	0	13631
28859	13616	87	97	69	0	13869
28860	13651	71	87	49	0	13858
28861	265	81	68	13307	0	13721
28862	142	68	78	13333	0	13621
28863	112	13418	76	191	0	13797
28864	13054	207	80	85	0	13426
28865	13081	96	61	68	0	13306
28866	235	12998	59	54	0	13346
28867	119	254	52	12517	0	12942
28868	82	12676	41	180	0	12979
28869	79	13169	47	84	0	13379
28870	12865	240	65	80	0	13250
28871	218	105	12536	70	0	12929
28872	62	73	11174	27	0	11336
28873	53	11084	120	43	0	11300
28874	10054	97	98	29	0	10278
28875	88	44	10048	14	0	10194
28876	42	9320	77	23	0	9462
28877	9271	67	100	19	0	9457
28878	51	31	9226	14	0	9322
28879	22	26	53	9097	0	9198
28880	9694	15	18	72	0	9799
28881	68	11	9775	27	0	9881
28882	23	17	9979	23	0	10042
28883	28	18	10258	12	0	10316
28884	15	16	10402	7	0	10440
28885	9898	17	95	11	0	10021
28886	10709	7	30	24	0	10770
28887	86	10813	18	12	0	10929
28888	40	76	13	11100	0	11229
28889	34	17	7	11448	0	11506
28890	14	11171	6	96	0	11287
28891	15	93	10	11424	0	11542
28892	10	11740	10	102	0	11862
28893	14	11993	12	34	0	12053
28894	21	129	14	11888	0	12052
28895	10	55	11981	109	0	12155
28896	13	11998	106	39	0	12156
28897	19	121	35	12051	0	12226
28898	12092	44	24	130	0	12290
28899	116	36	11968	47	0	12167
28900	11678	22	127	45	0	11872
28901	12135	17	46	36	0	12234
28902	176	23	30	12434	0	12663
28903	74	24	12971	148	0	13217
28904	42	23	13045	58	0	13168
28905	35	13824	201	41	0	14101
28906	46	192	96	13549	0	13883
28907	24	66	13716	176	0	13982
28908	24	48	13747	74	0	13893
28909	21	14106	234	54	0	14415
28910	14174	183	117	33	0	14507
28911	14480	63	69	30	0	14642
28912	253	59	41	15019	0	15372
28913	119	37	15492	229	0	15877
28914	77	27	15527	88	0	15719
28915	43	16060	311	79	0	16493
28916	32	234	16208	41	0	16515
28917	42	89	16141	43	0	16315
28918	54	86	353	15400	0	15893
28919	20	44	16346	247	0	16657
28920	15800	28	333	90	0	16251
28921	261	26	144	16475	0	16906
28922	97	30	16891	263	0	17281
28923	73	16887	289	117	0	17366
28924	53	231	142	17070	0	17496
28925	32	104	17309	272	0	17717
28926	33	17659	321	104	0	18117
28927	51	297	147	17276	0	17771
28928	24	17947	118	279	0	18368
28929	42	316	92	17993	0	18443
28930	54	128	72	18150	0	18404
28931	28	83	17961	395	0	18467
28932	31	18032	320	172	0	18555
28933	47	305	139	18072	0	18563
28934	45	125	110	18200	0	18480
28935	30	86	103	18417	0	18636
28936	26	64	17963	416	0	18469
28937	25	17840	323	213	0	18401
28938	36	313	145	17940	0	18434
28939	36	124	17866	370	0	18396
28940	27	17859	342	187	0	18415
28941	33	314	174	17913	0	18434
28942	20	152	18066	334	0	18572
28943	23	18057	341	182	0	18603
28944	34	334	174	17858	0	18400
28945	42	150	123	18381	0	18696
28946	19	116	18335	435	0	18905
28947	17140	82	326	280	0	17828
28948	262	18261	162	173	0	18858
28949	18333	328	135	142	0	18938
28950	320	167	18398	127	0	19012
28951	18210	122	355	139	0	18826
28952	346	93	181	18516	0	19136
28953	138	107	133	18970	0	19348
28954	86	89	18614	460	0	19249
28955	17271	101	369	248	0	17989
28956	17705	68	183	218	0	18174
28957	367	17452	138	170	0	18127
28958	158	18223	121	153	0	18655
28959	18072	410	112	123	0	18717
28960	348	203	18062	121	0	18734
28961	158	18597	354	133	0	19242
28962	120	346	171	18767	0	19404
28963	89	165	146	19220	0	19620
28964	76	138	18970	440	0	19624
28965	18379	108	370	248	0	19105
28966	349	94	19367	175	0	19985
28967	19222	96	402	158	0	19878
28968	387	88	20126	131	0	20732
28969	183	20078	426	117	0	20804
28970	20194	359	209	144	0	20906
28971	20314	181	175	137	0	20807
28972	20072	114	136	146	0	20468
28973	20257	101	144	130	0	20632
28974	539	91	103	19984	0	20717
28975	238	110	19890	391	0	20629
28976	222	90	355	19408	0	20075
28977	151	19764	216	373	0	20504
28978	151	319	148	19909	0	20527
28979	104	166	19818	410	0	20498
28980	102	130	19648	224	0	20104
28981	118	126	451	19239	0	19934
28982	18974	76	268	392	0	19710
28983	18444	92	184	209	0	18929
28984	18784	75	119	170	0	19148
28985	481	70	18715	128	0	19394
28986	265	80	18641	117	0	19103
28987	181	18343	438	112	0	19074
28988	153	18727	194	123	0	19197
28989	17981	361	241	115	0	18698
28990	18128	158	116	127	0	18529
28991	389	18443	123	105	0	19060
28992	18085	295	96	108	0	18584
28993	18138	130	106	111	0	18485
28994	412	18152	78	93	0	18735
28995	18342	286	96	109	0	18833
28996	18278	153	86	108	0	18625
28997	409	18458	93	85	0	19045
28998	18548	286	114	96	0	19044
28999	18710	134	103	113	0	19060
29000	427	109	18573	72	0	19181
29001	238	82	18486	87	0	18893
29002	179	17925	331	62	0	18497
29003	127	18035	164	70	0	18396
29004	17531	345	259	118	0	18253
29005	16978	113	94	75	0	17260
29006	16761	72	86	55	0	16974
29007	319	16836	76	36	0	17267
29008	182	216	46	16660	0	17104
29009	141	102	16702	187	0	17132
29010	164	205	210	16041	0	16620
29011	134	16569	98	178	0	16979
29012	15971	157	47	72	0	16247
29013	208	15590	51	35	0	15884
29014	113	154	35	15404	0	15706
29015	16139	53	35	176	0	16403
29016	16041	49	30	82	0	16202
29017	220	52	15792	38	0	16102
29018	15991	54	144	41	0	16230
29019	16850	33	61	57	0	17001
29020	17149	34	50	38	0	17271
29021	254	53	36	16462	0	16805
29022	122	16641	41	148	0	16952
29023	113	171	30	16993	0	17307
29024	82	89	17235	169	0	17575
29025	85	17361	164	76	0	17686
29026	87	166	60	17012	0	17325
29027	61	69	17120	142	0	17392
29028	60	17064	148	61	0	17333
29029	85	166	60	16511	0	16822
29030	60	77	16979	147	0	17263
29031	15584	54	163	108	0	15909
29032	195	52	17224	34	0	17505
29033	99	51	17181	34	0	17365
29034	81	17571	179	34	0	17865
29035	85	173	83	17685	0	18026
29036	80	80	46	17241	0	17447
29037	71	17129	39	184	0	17423
29038	85	175	48	17895	0	18203
29039	18170	72	44	217	0	18503
29040	18204	46	45	111	0	18406
29041	233	58	16951	67	0	17309
29042	18048	63	142	73	0	18326
29043	18553	58	57	70	0	18738
29044	264	42	18606	49	0	18961
29045	122	18626	191	33	0	18972
29046	84	18744	85	43	0	18956
29047	103	235	67	17188	0	17593
29048	76	18556	44	151	0	18827
29049	90	223	16662	66	0	17041
29050	75	85	17861	49	0	18070
29051	71	18523	224	37	0	18855
29052	18292	204	91	52	0	18639
29053	18713	101	60	61	0	18935
29054	18832	80	38	61	0	19011
29055	18845	63	27	58	0	18993
29056	17761	60	40	75	0	17936
29057	267	18390	44	33	0	18734
29058	131	217	18174	28	0	18550
29059	133	90	178	18110	0	18511
29060	17851	57	70	199	0	18177
29061	233	17610	50	78	0	17971
29062	139	232	46	17403	0	17820
29063	98	97	17452	181	0	17828
29064	68	16953	200	77	0	17298
29065	66	17419	76	61	0	17622
29066	16587	338	101	137	0	17163
29067	181	16548	39	48	0	16816
29068	113	181	41	15935	0	16270
29069	15995	61	31	170	0	16257
29070	15958	46	32	60	0	16096
29071	15990	40	33	42	0	16105
29072	216	47	15682	19	0	15964
29073	95	15829	149	22	0	16095
29074	16122	171	42	52	0	16387
29075	191	80	26	16006	0	16303
29076	16134	52	20	194	0	16400
29077	191	16040	30	64	0	16325
29078	16608	173	32	47	0	16860
29079	17846	75	32	50	0	18003
29080	284	49	38	17692	0	18063
29081	146	59	18621	206	0	19032
29082	134	56	209	19016	0	19415
29083	19071	32	86	281	0	19470
29084	19278	43	54	122	0	19497
29085	342	18974	61	68	0	19445
29086	18662	219	61	76	0	19018
29087	304	18851	43	72	0	19270
29088	18965	255	38	95	0	19353
29089	18488	111	45	118	0	18762
29090	326	93	18999	62	0	19480
29091	168	18847	210	65	0	19290
29092	141	257	103	18953	0	19454
29093	134	128	67	19172	0	19501
29094	105	94	61	18672	0	18932
29095	96	18798	55	320	0	19269
29096	88	241	18789	131	0	19249
29097	83	116	18784	97	0	19080
29098	74	21412	303	79	0	21868
29099	21535	323	134	96	0	22088
29100	339	147	21690	58	0	22234
29101	21271	120	336	85	0	21812
29102	382	21661	150	62	0	22255
29103	191	340	21848	53	0	22432
29104	150	170	350	21757	0	22427
29105	103	140	22185	332	0	22760
29106	121	85	22770	148	0	23124
29107	179	75	451	21233	0	21938
29108	135	21850	199	291	0	22475
29109	95	22748	140	125	0	23108
29110	22531	416	119	100	0	23166
29111	362	205	22532	80	0	23179
29112	22475	140	373	80	0	23068
29113	22914	107	192	72	0	23285
29114	449	22958	122	64	0	23593
29115	22196	356	71	48	0	22671
29116	22334	172	40	72	0	22618
29117	21779	108	54	55	0	21996
29118	483	21256	59	55	0	21853
29119	256	19865	54	40	0	20215
29120	169	20840	56	35	0	21100
29121	20630	450	152	50	0	21282
29122	20534	206	73	66	0	20879
29123	416	117	19534	34	0	20101
29124	250	74	19345	20	0	19689
29125	19861	72	324	45	0	20302
29126	20206	69	164	49	0	20488
29127	20443	60	104	56	0	20663
29128	451	43	87	20019	0	20600
29129	268	34	66	20349	0	20717
29130	181	51	71	20593	0	20896
29131	135	68	50	20742	0	20995
29132	118	84	19239	410	0	19851
29133	133	64	19594	198	0	19989
29134	122	54	19594	110	0	19880
29135	118	35	19487	84	0	19724
29136	19416	47	382	72	0	19917
29137	305	19659	183	71	0	20218
29138	191	20176	111	60	0	20538
29139	20011	313	88	82	0	20494
29140	329	185	20107	51	0	20672
29141	192	127	19706	65	0	20090
29142	19699	135	406	85	0	20325
29143	20171	82	204	93	0	20550
29144	374	20181	132	68	0	20755
29145	263	269	104	20083	0	20719
29146	20488	130	95	255	0	20968
29147	20736	117	98	132	0	21083
29148	438	103	75	20572	0	21188
29149	283	21031	70	249	0	21633
29150	21288	286	56	139	0	21769
29151	362	158	20932	123	0	21575
29152	20534	108	304	129	0	21075
29153	374	20895	176	96	0	21541
29154	21152	280	127	105	0	21664
29155	20650	148	113	113	0	21024
29156	384	149	21162	72	0	21767
29157	231	100	20705	76	0	21112
29158	20972	81	427	52	0	21532
29159	21510	80	214	66	0	21870
29160	424	21811	155	36	0	22426
29161	272	315	101	21905	0	22593
29162	234	156	21818	238	0	22446
29163	21571	138	335	124	0	22168
29164	391	89	202	21923	0	22605
29165	266	70	129	22222	0	22687
29166	22079	71	114	360	0	22624
29167	362	22547	82	197	0	23188
29168	22761	292	81	184	0	23318
29169	22757	147	105	108	0	23117
29170	23071	114	83	105	0	23373
29171	497	22749	83	88	0	23417
29172	23054	299	84	73	0	23510
29173	467	169	70	22902	0	23608
29174	309	142	80	22782	0	23313
29175	296	96	22579	359	0	23330
29176	257	68	22103	207	0	22635
29177	181	22342	356	143	0	23022
29178	179	22641	170	96	0	23086
29179	154	303	21434	45	0	21936
29180	107	21490	263	61	0	21921
29181	21088	353	186	128	0	21755
29182	21295	112	65	55	0	21527
29183	21495	77	54	62	0	21688
29184	381	77	38	20671	0	21167
29185	210	51	39	21174	0	21474
29186	138	50	21288	294	0	21770
29187	94	20969	212	162	0	21437
29188	21042	232	105	123	0	21502
29189	265	21055	67	48	0	21435
29190	21069	264	53	51	0	21437
29191	21141	112	29	59	0	21341
29192	392	78	29	20484	0	20983
29193	242	45	52	20584	0	20923
29194	154	46	33	21206	0	21439
29195	127	33	20571	350	0	21081
29196	72	19942	206	203	0	20423
29197	71	20071	104	136	0	20382
29198	34	17547	26	36	0	17643
29199	40	17449	24	23	0	17536
29200	39	17383	24	25	0	17471
29201	16364	158	56	47	0	16625
29202	124	70	16567	28	0	16789
29203	59	16644	112	29	0	16844
29204	33	111	16110	14	0	16268
29205	33	16666	96	23	0	16818
29206	113	207	75	11568	0	11963
29207	42	59	22	15855	0	15978
29208	25	16181	15	126	0	16347
29209	15930	111	17	72	0	16130
29210	122	59	15765	18	0	15964
29211	62	15935	93	34	0	16124
29212	36	111	15636	24	0	15807
29213	47	61	99	15488	0	15695
29214	50	32	49	14760	0	14891
29215	22	15396	24	134	0	15576
29216	38	108	19	15573	0	15738
29217	43	69	21	15611	0	15744
29218	40	15550	25	129	0	15744
29219	50	105	15264	50	0	15469
29220	28	68	15016	34	0	15146
29221	14675	30	130	49	0	14884
29222	15504	24	53	49	0	15630
29223	149	18	26	15054	0	15247
29224	56	44	15041	108	0	15249
29225	39	42	102	14602	0	14785
29226	33	15204	58	115	0	15410
29227	23	121	15141	54	0	15339
29228	22	14948	103	37	0	15110
29229	30	114	14864	27	0	15035
29230	33	14960	104	27	0	15124
29231	14846	123	51	41	0	15061
29232	110	65	34	14722	0	14931
29233	63	40	34	14594	0	14731
29234	29	44	14684	140	0	14897
29235	39	41	14071	73	0	14224
29236	30	14591	131	38	0	14790
29237	14610	111	59	58	0	14838
29238	108	75	27	14501	0	14711
29239	62	47	14768	103	0	14980
29240	43	44	14039	54	0	14180
29241	13119	37	142	56	0	13354
29242	13689	32	71	54	0	13846
29243	137	41	13991	25	0	14194
29244	79	69	99	13477	0	13724
29245	28	13777	51	110	0	13966
29246	13875	109	23	83	0	14090
29247	87	13850	29	43	0	14009
29248	13387	92	33	39	0	13551
29249	86	13385	24	18	0	13513
29250	51	13613	20	16	0	13700
29251	27	98	30	13615	0	13770
29252	31	57	24	13664	0	13776
29253	19	13605	15	128	0	13767
29254	21	92	13322	46	0	13481
29255	23	49	12979	32	0	13083
29256	16	35	13139	18	0	13208
29257	12574	28	104	51	0	12757
29258	13112	38	48	34	0	13232
29259	100	13543	24	31	0	13698
29260	43	100	13346	30	0	13519
29261	28	58	98	13367	0	13551
29262	15	33	14114	100	0	14262
29263	24	30	14393	56	0	14503
29264	36	30	165	15510	0	15741
29265	31	24	73	16496	0	16624
29266	19	33	17816	245	0	18113
29267	17908	26	198	182	0	18314
29268	217	19201	135	114	0	19667
29269	130	20413	103	72	0	20718
29270	119	359	65	20083	0	20626
29271	20607	207	51	288	0	21153
29272	307	20971	57	183	0	21518
29273	21175	361	40	121	0	21697
29274	385	21443	31	85	0	21944
29275	22124	454	31	104	0	22713
29276	470	274	22167	79	0	22990
29277	280	205	22503	73	0	23061
29278	263	232	452	22149	0	23096
29279	167	152	22486	344	0	23149
29280	155	21308	444	165	0	22072
29281	145	21267	260	109	0	21781
29282	21556	486	219	110	0	22371
29283	402	273	187	20923	0	21785
29284	174	21678	163	401	0	22416
29285	21908	423	135	223	0	22689
29286	21702	287	113	140	0	22242
29287	22295	227	79	112	0	22713
29288	675	187	62	21801	0	22725
29289	425	133	58	22192	0	22808
29290	284	141	21946	523	0	22894
29291	246	139	21795	287	0	22467
29292	21752	93	492	229	0	22566
29293	542	86	275	21643	0	22546
29294	300	99	21693	477	0	22569
29295	21391	89	461	321	0	22262
29296	479	22146	322	257	0	23204
29297	22408	373	253	193	0	23227
29298	22690	219	193	163	0	23265
29299	22793	135	154	183	0	23265
29300	740	109	22051	155	0	23055
29301	22130	110	442	109	0	22791
29302	705	127	224	21364	0	22420
29303	472	20971	165	377	0	21985
29304	410	22137	154	225	0	22926
29305	22128	464	153	180	0	22925
29306	22251	246	146	146	0	22789
29307	22484	177	141	155	0	22957
29308	791	156	106	21775	0	22828
29309	513	159	88	22103	0	22863
29310	401	178	85	21500	0	22164
29311	382	21652	89	576	0	22699
29312	21757	411	85	359	0	22612
29313	21969	237	80	298	0	22584
29314	22243	186	81	257	0	22767
29315	793	139	21857	253	0	23042
29316	22521	149	372	233	0	23275
29317	768	187	191	21564	0	22710
29318	514	22147	151	437	0	23249
29319	22353	452	103	251	0	23159
29320	22376	250	112	185	0	22923
29321	850	184	22139	159	0	23332
29322	583	136	425	21735	0	22879
29323	417	22314	214	509	0	23454
29324	22980	479	165	316	0	23940
29325	707	306	122	22880	0	24015
29326	542	207	135	22884	0	23768
29327	441	142	151	23365	0	24099
29328	351	151	126	24026	0	24654
29329	304	162	23397	830	0	24693
29330	310	23389	470	496	0	24665
29331	328	498	216	23690	0	24732
29332	252	307	23741	714	0	25014
29333	23521	227	489	496	0	24733
29334	24211	161	289	425	0	25086
29335	779	181	270	24074	0	25304
29336	24230	181	208	665	0	25284
29337	24580	168	180	408	0	25336
29338	875	160	24020	356	0	25411
29339	587	23858	529	310	0	25284
29340	24324	483	297	282	0	25386
29341	824	239	230	24118	0	25411
29342	24582	187	201	660	0	25630
29343	850	144	209	24240	0	25443
29344	520	196	167	24627	0	25510
29345	420	191	23816	785	0	25212
29346	22878	150	506	543	0	24077
29347	728	23995	256	450	0	25429
29348	742	489	23591	373	0	25195
29349	418	23795	499	394	0	25106
29350	23675	556	298	343	0	24872
29351	755	307	272	23462	0	24796
29352	23485	246	218	611	0	24560
29353	776	23375	189	377	0	24717
29354	23828	580	185	295	0	24888
29355	24028	321	165	275	0	24789
29356	24150	223	140	273	0	24786
29357	23879	165	123	327	0	24494
29358	1022	23300	126	279	0	24727
29359	23432	526	136	230	0	24324
29360	924	332	120	22827	0	24203
29361	709	326	96	22517	0	23648
29362	570	21108	126	608	0	22412
29363	513	20959	83	388	0	21943
29364	432	20670	89	254	0	21445
29365	19192	543	155	264	0	20154
29366	534	17790	70	218	0	18612
29367	313	16011	63	116	0	16503
29368	15436	382	314	158	0	16290
29369	14942	145	70	90	0	15247
29370	413	14830	47	83	0	15373
29371	14626	269	45	98	0	15038
29372	373	144	14095	76	0	14688
29373	13769	95	204	104	0	14172
29374	339	109	13756	95	0	14299
29375	174	12606	162	80	0	13022
29376	136	12593	72	94	0	12895
29377	335	336	148	11715	0	12534
29378	11882	73	59	160	0	12174
29379	11921	66	30	87	0	12104
29380	12079	55	38	64	0	12236
29381	12073	55	39	61	0	12228
29382	11840	68	22	72	0	12002
29383	193	59	11519	64	0	11835
29384	121	64	10968	59	0	11212
29385	11376	65	106	69	0	11616
29386	180	11597	52	56	0	11885
29387	11366	120	40	55	0	11581
29388	11709	71	27	43	0	11850
29389	11948	53	29	57	0	12087
29390	11973	45	37	49	0	12104
29391	11962	71	19	57	0	12109
29392	218	43	11789	46	0	12096
29393	12038	49	111	85	0	12283
29394	12154	52	42	65	0	12313
29395	195	70	11056	56	0	11377
29396	11153	73	91	68	0	11385
29397	11995	73	54	60	0	12182
29398	222	62	12310	47	0	12641
29399	144	72	12147	48	0	12411
29400	149	12475	139	35	0	12798
29401	153	148	55	12473	0	12829
29402	147	65	12568	127	0	12907
29403	12696	57	121	74	0	12948
29404	226	41	82	13189	0	13538
29405	140	65	13438	118	0	13761
29406	13356	47	149	73	0	13625
29407	13605	73	70	66	0	13814
29408	13678	61	44	47	0	13830
29409	245	13862	31	73	0	14211
29410	176	153	34	13636	0	13999
29411	148	13892	45	138	0	14223
29412	14014	151	83	81	0	14329
29413	13990	64	58	41	0	14153
29414	254	66	13789	27	0	14136
29415	149	13112	128	31	0	13420
29416	87	13143	67	33	0	13330
29417	126	146	48	12960	0	13280
29418	122	77	16	13082	0	13297
29419	13025	56	25	140	0	13246
29420	210	12849	27	47	0	13133
29421	139	12843	14	28	0	13024
29422	153	138	12749	16	0	13056
29423	123	13057	83	22	0	13285
29424	12864	123	59	42	0	13088
29425	187	60	12698	33	0	12978
29426	11645	47	97	37	0	11826
29427	142	26	12056	28	0	12252
29428	10896	32	79	42	0	11049
29429	98	12047	29	17	0	12191
29430	12584	94	17	26	0	12721
29431	120	44	12993	9	0	13166
29432	13017	34	107	30	0	13188
29433	13123	14	34	31	0	13202
29434	132	15	13528	7	0	13682
29435	13474	17	94	28	0	13613
29436	13904	10	38	27	0	13979
29437	13705	16	27	23	0	13771
29438	152	13574	18	7	0	13751
29439	13942	99	20	17	0	14078
29440	129	43	13881	50	0	14103
29441	68	14762	85	22	0	14937
29442	15037	130	55	25	0	15247
29443	14987	39	22	30	0	15078
29444	15205	17	23	23	0	15268
29445	196	15120	13	8	0	15337
29446	86	140	11	16715	0	16952
29447	52	42	16898	176	0	17168
29448	50	28	194	16896	0	17168
29449	39	26	17457	222	0	17744
29450	16859	20	217	93	0	17189
29451	220	17646	76	46	0	17988
29452	125	210	37	17497	0	17869
29453	55	18008	34	182	0	18279
29454	77	244	11	18023	0	18355
29455	56	86	14	18127	0	18283
29456	46	18554	19	290	0	18909
29457	59	255	20	18725	0	19059
29458	61	93	21	19347	0	19522
29459	49	19226	23	335	0	19633
29460	30	19793	35	138	0	19996
29461	64	322	36	19661	0	20083
29462	54	135	19604	277	0	20070
29463	47	19820	268	133	0	20268
29464	70	305	111	19840	0	20326
29465	65	112	20507	313	0	20997
29466	40	20632	302	130	0	21104
29467	20521	335	99	115	0	21070
29468	304	149	20469	72	0	20994
29469	20355	74	301	106	0	20836
29470	367	76	102	20371	0	20916
29471	146	76	63	20592	0	20877
29472	120	68	43	20643	0	20874
29473	56	79	20300	443	0	20878
29474	53	76	20038	188	0	20355
29475	19701	84	363	130	0	20278
29476	321	68	136	20331	0	20856
29477	122	60	20599	360	0	21141
29478	20363	74	318	166	0	20921
29479	365	60	133	20659	0	21217
29480	173	65	90	20798	0	21126
29481	137	64	65	20707	0	20973
29482	89	20773	73	436	0	21371
29483	104	326	61	20350	0	20841
29484	89	20308	62	388	0	20847
29485	69	21051	70	192	0	21382
29486	20836	394	60	139	0	21429
29487	19134	153	80	179	0	19546
29488	20638	103	72	122	0	20935
29489	431	20276	68	120	0	20895
29490	20262	335	74	123	0	20794
29491	20523	127	56	139	0	20845
29492	461	85	69	20148	0	20763
29493	201	82	66	20334	0	20683
29494	115	74	19934	470	0	20593
29495	94	20181	325	238	0	20838
29496	19802	347	123	186	0	20458
29497	19933	151	84	153	0	20321
29498	381	19753	83	133	0	20350
29499	19786	355	83	116	0	20340
29500	19863	148	54	132	0	20197
29501	458	136	48	19528	0	20170
29502	218	19170	57	362	0	19807
29503	153	19868	62	185	0	20268
29504	19566	384	54	171	0	20175
29505	401	185	48	19335	0	19969
29506	155	115	19155	403	0	19828
29507	18648	104	307	238	0	19297
29508	378	117	19588	154	0	20237
29509	166	19278	327	122	0	19893
29510	19241	334	135	161	0	19871
29511	386	165	19301	119	0	19971
29512	207	145	311	19598	0	20261
29513	136	129	20061	392	0	20718
29514	126	20199	339	203	0	20867
29515	137	371	136	20256	0	20900
29516	122	174	20157	401	0	20854
29517	19124	137	324	234	0	19819
29518	352	20505	132	164	0	21153
29519	213	327	105	19959	0	20604
29520	127	20695	109	358	0	21289
29521	20471	377	81	206	0	21135
29522	20335	174	91	190	0	20790
29523	387	20407	92	181	0	21067
29524	217	356	100	20033	0	20706
29525	139	20457	99	368	0	21063
29526	20314	343	110	213	0	20980
29527	379	185	20230	133	0	20927
29528	173	162	19828	134	0	20297
29529	154	19826	342	151	0	20473
29530	124	19821	186	109	0	20240
29531	149	350	150	19227	0	19876
29532	19083	147	90	328	0	19648
29533	19167	122	80	182	0	19551
29534	18789	109	59	158	0	19115
29535	398	19352	75	133	0	19958
29536	208	265	84	19031	0	19588
29537	169	19386	58	281	0	19894
29538	19477	295	80	181	0	20033
29539	322	145	80	19214	0	19761
29540	192	111	18692	283	0	19278
29541	121	18448	237	158	0	18964
29542	18122	238	112	132	0	18604
29543	282	123	18082	93	0	18580
29544	17544	117	239	111	0	18011
29545	286	17823	74	122	0	18305
29546	104	16517	39	58	0	16718
29547	16162	170	53	54	0	16439
29548	176	16440	25	38	0	16679
29549	15968	139	42	34	0	16183
29550	147	16071	19	28	0	16265
29551	16197	140	64	43	0	16444
29552	16149	58	35	41	0	16283
29553	174	41	16379	29	0	16623
29554	67	33	15931	25	0	16056
29555	47	16183	123	26	0	16379
29556	15858	108	101	40	0	16107
29557	99	46	15609	14	0	15768
29558	14974	59	92	21	0	15146
29559	82	56	28	15007	0	15173
29560	35	21	15453	60	0	15569
29561	32	18	14669	24	0	14743
29562	38	20	15562	13	0	15633
29563	19	15733	72	14	0	15838
29564	115	187	90	15283	0	15675
29565	15043	9	14	45	0	15111
29566	36	5	2	15270	0	15313
29567	15393	3	6	42	0	15444
29568	47	0	1	15389	0	15437
29569	15588	4	5	70	0	15667
29570	15276	11	7	53	0	15347
29571	16966	3	3	38	0	17010
29572	74	17181	3	6	0	17264
29573	22	70	17322	7	0	17421
29574	15	23	81	17312	0	17431
29575	299	140	120	7911	0	8470
29576	25	6	5	17858	0	17894
29577	24	7	6	17572	0	17609
29578	17	17128	6	131	0	17282
29579	13	91	17083	33	0	17220
29580	9	17396	99	20	0	17524
29581	46	111	34	16225	0	16416
29582	20	49	5	17479	0	17553
29583	19	12	13	17510	0	17554
29584	24	16	7	17458	0	17505
29585	15	17094	10	138	0	17257
29586	19	17219	19	46	0	17303
29587	9	148	17058	30	0	17245
29588	30	39	117	17216	0	17402
29589	20	24	39	17334	0	17417
29590	26	17	13	17673	0	17729
29591	17837	18	15	175	0	18045
29592	118	17798	11	64	0	17991
29593	53	132	17780	28	0	17993
29594	17720	45	119	54	0	17938
29595	143	17	36	17980	0	18176
29596	18319	24	9	177	0	18529
29597	139	20	18	18376	0	18553
29598	18434	22	16	168	0	18640
29599	146	19	16	18355	0	18536
29600	18244	16	14	167	0	18441
29601	144	14	18558	62	0	18778
29602	75	26	114	18412	0	18627
29603	35	18754	45	129	0	18963
29604	35	132	13	19094	0	19274
29605	18967	44	19	189	0	19219
29606	141	18669	16	71	0	18897
29607	71	146	15	19547	0	19779
29608	30	19247	23	166	0	19466
29609	39	178	16	19524	0	19757
29610	51	58	12	19613	0	19734
29611	41	28	19226	226	0	19521
29612	52	23	163	18754	0	18992
29613	27	25	18453	197	0	18702
29614	16	18203	167	97	0	18483
29615	18252	172	56	63	0	18543
29616	167	67	18201	56	0	18491
29617	17835	21	178	66	0	18100
29618	18647	29	55	76	0	18807
29619	222	23	30	18857	0	19132
29620	73	27	19422	198	0	19720
29621	18956	24	185	117	0	19282
29622	20403	20	68	84	0	20575
29623	266	17	40	20220	0	20543
29624	121	22	29	20358	0	20530
29625	65	20374	28	278	0	20745
29626	65	225	21	20269	0	20580
29627	37	20398	27	252	0	20714
29628	49	224	20312	110	0	20695
29629	59	112	188	20018	0	20377
29630	19743	39	78	275	0	20135
29631	19962	33	32	136	0	20163
29632	242	19898	34	71	0	20245
29633	109	198	22	20139	0	20468
29634	20224	77	25	255	0	20581
29635	229	19555	30	118	0	19932
29636	19724	226	15	93	0	20058
29637	274	77	24	20411	0	20786
29638	21258	57	20	278	0	21613
29639	287	60	22989	104	0	23440
29640	126	23115	274	87	0	23602
29641	23312	298	94	103	0	23807
29642	314	24078	52	69	0	24513
29643	24450	327	38	81	0	24896
29644	25005	127	28	94	0	25254
29645	459	69	25037	60	0	25625
29646	212	54	332	24972	0	25570
29647	25504	48	109	389	0	26050
29648	385	42	25246	146	0	25819
29649	25293	63	347	104	0	25807
29650	432	43	114	25310	0	25899
29651	192	50	25071	373	0	25686
29652	151	44	352	24886	0	25433
29653	24500	30	116	451	0	25097
29654	561	47	24585	160	0	25353
29655	198	52	360	24784	0	25394
29656	159	43	123	25079	0	25404
29657	25029	33	96	486	0	25644
29658	24960	30	80	222	0	25292
29659	484	24990	54	186	0	25714
29660	252	355	60	24777	0	25444
29661	185	141	71	24828	0	25225
29662	165	83	54	24588	0	24890
29663	24150	64	72	529	0	24815
29664	24371	66	68	247	0	24752
29665	558	69	62	23901	0	24590
29666	250	23498	68	431	0	24247
29667	241	407	72	23043	0	23763
29668	196	23640	64	421	0	24321
29669	23297	372	75	248	0	23992
29670	448	22918	80	179	0	23625
29671	21856	333	77	158	0	22424
29672	474	148	88	21572	0	22282
29673	21445	91	91	396	0	22023
29674	459	56	21195	223	0	21933
29675	243	21470	341	194	0	22248
29676	21179	322	214	211	0	21926
29677	21333	128	114	176	0	21751
29678	486	111	99	20846	0	21542
29679	279	20850	88	398	0	21615
29680	230	284	79	21487	0	22080
29681	193	112	91	21604	0	22000
29682	194	97	69	21610	0	21970
29683	21379	72	78	537	0	22066
29684	21598	77	67	309	0	22051
29685	499	76	36	21113	0	21724
29686	273	21271	57	422	0	22023
29687	21497	298	47	280	0	22122
29688	411	144	21197	252	0	22004
29689	271	126	251	21491	0	22139
29690	227	98	21354	433	0	22112
29691	214	97	295	21242	0	21848
29692	195	91	21159	457	0	21902
29693	205	104	305	21119	0	21733
29694	21080	117	128	468	0	21793
29695	21030	129	87	269	0	21515
29696	489	20532	76	199	0	21296
29697	20980	332	56	207	0	21575
29698	475	172	61	20728	0	21436
29699	291	145	72	21107	0	21615
29700	21047	103	93	494	0	21737
29701	454	100	20454	277	0	21285
29702	292	103	20328	212	0	20935
29703	249	117	19806	201	0	20373
29704	19923	99	361	207	0	20590
29705	432	98	20382	213	0	21125
29706	276	108	19705	201	0	20290
29707	19146	110	359	230	0	19845
29708	405	19611	166	245	0	20427
29709	259	250	132	19874	0	20515
29710	209	150	109	20217	0	20685
29711	206	100	20020	436	0	20762
29712	19765	74	365	314	0	20518
29713	20013	73	170	264	0	20520
29714	18670	85	138	239	0	19132
29715	448	83	19928	190	0	20649
29716	19592	53	317	232	0	20194
29717	402	69	19076	209	0	19756
29718	241	18942	304	219	0	19706
29719	228	19154	171	207	0	19760
29720	18263	290	152	207	0	18912
29721	349	17851	183	175	0	18558
29722	242	17809	96	156	0	18303
29723	17566	277	119	166	0	18128
29724	328	17620	108	157	0	18213
29725	17520	256	116	158	0	18050
29726	375	123	111	17216	0	17825
29727	230	99	110	17401	0	17840
29728	204	520	117	17447	0	18288
29729	168	91	126	17642	0	18027
29730	173	17550	145	364	0	18232
29731	17866	261	119	212	0	18458
29732	368	18755	113	130	0	19366
29733	260	19410	137	189	0	19996
29734	243	372	19992	143	0	20750
29735	19676	154	430	168	0	20428
29736	481	108	20916	125	0	21630
29737	280	84	21842	130	0	22336
29738	166	21171	484	122	0	21943
29739	78	21267	182	62	0	21589
29740	21765	504	252	122	0	22643
29741	429	22988	89	85	0	23591
29742	270	462	22487	59	0	23278
29743	136	22017	428	59	0	22640
29744	105	477	22064	42	0	22688
29745	85	233	21565	16	0	21899
29746	20770	164	627	42	0	21603
29747	408	105	21146	24	0	21683
29748	249	91	529	20437	0	21306
29749	20315	49	297	409	0	21070
29750	407	20183	208	249	0	21047
29751	241	382	20411	102	0	21136
29752	20294	185	473	76	0	21028
29753	482	110	243	19484	0	20319
29754	266	19291	135	366	0	20058
29755	129	390	19991	191	0	20701
29756	19738	203	447	117	0	20505
29757	462	113	19994	61	0	20630
29758	298	70	495	19774	0	20637
29759	128	45	19841	416	0	20430
29760	143	58	498	19774	0	20473
29761	19394	35	288	529	0	20246
29762	413	19792	184	267	0	20656
29763	20061	381	127	173	0	20742
29764	514	210	19926	96	0	20746
29765	323	109	463	20155	0	21050
29766	176	74	20557	438	0	21245
29767	20403	79	536	246	0	21264
29768	20797	73	285	141	0	21296
29769	657	20616	191	258	0	21722
29770	21042	442	127	100	0	21711
29771	21304	215	123	87	0	21729
29772	750	126	103	20715	0	21694
29773	412	101	20606	426	0	21545
29774	246	20121	462	236	0	21065
29775	231	475	229	20205	0	21140
29776	20358	260	134	482	0	21234
29777	528	163	20212	259	0	21162
29778	285	115	20354	146	0	20900
29779	171	116	20026	110	0	20423
29780	19622	86	742	120	0	20570
29781	523	84	19913	66	0	20586
29782	19581	66	656	76	0	20379
29783	571	80	18302	62	0	19015
29784	321	19258	597	49	0	20225
29785	269	456	332	19019	0	20076
29786	178	243	19266	434	0	20121
29787	143	18650	592	240	0	19625
29788	128	19248	335	135	0	19846
29789	152	645	221	18815	0	19833
29790	18777	350	155	500	0	19782
29791	518	203	171	18929	0	19821
29792	18776	163	158	547	0	19644
29793	581	147	141	18742	0	19611
29794	338	146	18476	590	0	19550
29795	241	106	18694	333	0	19374
29796	18248	91	681	239	0	19259
29797	18474	73	394	187	0	19128
29798	719	91	18084	143	0	19037
29799	17874	89	571	165	0	18699
29800	651	82	17904	92	0	18729
29801	431	16938	622	86	0	18077
29802	311	17009	413	69	0	17802
29803	247	17257	278	100	0	17882
29804	262	666	229	16715	0	17872
29805	16713	379	198	466	0	17756
29806	16992	237	200	267	0	17696
29807	763	196	134	16584	0	17677
29808	422	179	16078	505	0	17184
29809	294	155	502	16147	0	17098
29810	239	112	16092	572	0	17015
29811	242	101	603	15930	0	16876
29812	15717	73	401	635	0	16826
29813	16082	72	279	373	0	16806
29814	16145	64	249	255	0	16713
29815	16193	83	215	203	0	16694
29816	865	72	192	15523	0	16652
29817	541	82	179	15843	0	16645
29818	15707	67	162	687	0	16623
29819	16013	64	148	381	0	16606
29820	848	79	135	15506	0	16568
29821	510	70	123	15828	0	16531
29822	355	79	125	15806	0	16365
29823	291	66	117	15898	0	16372
29824	15271	89	138	807	0	16305
29825	577	94	14963	502	0	16136
29826	410	69	462	14922	0	15863
29827	14757	76	276	642	0	15751
29828	570	59	14509	438	0	15576
29829	443	70	516	14553	0	15582
29830	290	63	14557	578	0	15488
29831	233	13792	584	369	0	14978
29832	282	574	395	12426	0	13677
29833	11834	190	261	438	0	12723
29834	417	276	210	10734	0	11637
29835	321	10304	171	420	0	11216
29836	238	9650	142	287	0	10317
29837	148	7597	97	162	0	8004
29838	153	7080	83	126	0	7442
29839	3704	530	463	448	0	5145
29840	189	192	97	2629	0	3107
29841	29	12	2053	63	0	2157
29842	27	11	47	1909	0	1994
29843	36	5	1890	53	0	1984
29844	1878	6	44	25	0	1953
29845	65	10	22	1861	0	1958
29846	28	9	9	1903	0	1949
29847	23	13	19	1886	0	1941
29848	32	7	4	1897	0	1940
29849	1858	9	13	55	0	1935
29850	1883	13	6	27	0	1929
29851	53	10	16	1848	0	1927
29852	1799	14	6	65	0	1884
29853	52	7	1766	36	0	1861
29854	24	1718	40	40	0	1822
29855	31	36	13	1733	0	1813
29856	27	14	16	1706	0	1763
29857	15	1685	12	73	0	1785
29858	35	31	13	1663	0	1742
29859	24	60	18	1633	0	1735
29860	1643	6	19	66	0	1734
29861	48	11	1582	28	0	1669
29862	16	9	1447	22	0	1494
29863	1389	3	34	27	0	1453
29864	59	2	1307	14	0	1382
29865	754	7	54	10	0	825
29866	620	2	26	13	0	661
29867	27	23	11	493	0	554
29868	6	5	359	9	0	379
29869	254	4	14	7	0	279
29870	10	251	1	6	0	268
29871	137	21	18	6	0	182
29872	98	9	11	10	0	128
29873	57	0	6	3	0	66
29874	58	0	1	0	0	59
29875	60	0	1	0	0	61
29876	57	0	2	0	0	59
29877	61	0	0	0	0	61
29878	57	0	1	0	0	58
29879	56	0	1	1	0	58
29880	58	0	1	0	0	59
29881	58	0	0	0	0	58
29882	54	1	1	0	0	56
29883	51	0	0	0	0	51
29884	45	1	0	0	0	46
29885	50	0	0	0	0	50
29886	58	0	0	0	0	58
29887	58	0	0	0	0	58
29888	53	0	0	0	0	53
29889	49	0	0	0	0	49
29890	54	0	0	0	0	54
29891	51	0	0	0	0	51
29892	58	0	0	0	0	58
29893	54	0	0	0	0	54
29894	57	0	0	0	0	57
29895	55	0	0	0	0	55
29896	54	0	0	0	0	54
29897	53	0	0	0	0	53
29898	53	0	0	0	0	53
29899	55	0	0	0	0	55
29900	55	0	0	0	0	55
29901	51	0	0	0	0	51
29902	46	0	0	0	0	46
29903	27	0	3	0	0	30
