Pos	A	C	G	T	Other	Total
1	0	0	0	0	0	0
2	0	0	0	35	0	35
3	0	0	0	35	0	35
4	88	0	0	0	0	88
5	168	0	0	0	0	168
6	169	0	0	0	0	169
7	0	0	188	0	0	188
8	0	0	188	0	0	188
9	0	0	0	200	0	200
10	0	1	0	243	0	244
11	1	0	0	347	0	348
12	668	0	0	18	0	686
13	5	0	1	1319	0	1325
14	2704	2	0	90	0	2796
15	3	3951	4	2	0	3960
16	6	6996	7	24	0	7033
17	147	40	6	23931	0	24124
18	58	5	5	27323	0	27391
19	34	44652	76	105	0	44867
20	27	51856	75	45	0	52003
21	37	64380	84	467	0	64968
22	74093	29	149	787	0	75058
23	94	250	77783	57	0	78184
24	91	292	79952	57	0	80392
25	106	44	46	88034	0	88230
26	94951	26	39	597	0	95613
27	96305	21	24	412	0	96762
28	44	97625	166	131	0	97966
29	110718	53	62	916	0	111749
30	119746	59	83	795	0	120683
31	122952	28	37	432	0	123449
32	83	125229	170	145	0	125627
33	30	129114	147	152	0	129443
34	134635	50	17	565	0	135267
35	137136	44	32	468	0	137680
36	82	141801	209	133	0	142225
37	129	154102	171	195	0	154597
38	155312	118	32	528	0	155990
39	155337	57	49	460	0	155903
40	101	157392	206	237	0	157936
41	174	107	20	163465	0	163766
42	131	60	31	165092	0	165314
43	120	25	28	165555	0	165728
44	44	165576	183	218	0	166021
45	171	495	160121	119	0	160906
46	146683	134	139	388	0	147344
47	159	37	50	167337	0	167583
48	81	168004	201	185	0	168471
49	112	117	22	170036	0	170287
50	68	170497	183	217	0	170965
51	154	162	42	170888	0	171246
52	167	74	32	173416	0	173689
53	166	425	173737	246	0	174574
54	170	82	142	171581	0	171975
55	172333	46	92	650	0	173121
56	246	401	172982	193	0	173822
57	166297	61	164	488	0	167010
58	240	55	66	176651	0	177012
59	97	177370	202	256	0	177925
60	141	230	34	178862	0	179267
61	176	412	178525	319	0	179432
62	203	77	210	174696	0	175186
63	199	51	100	180143	0	180493
64	67	182354	230	363	0	183014
65	193	203	49	184551	0	184996
66	192	183450	199	409	0	184250
67	145	229	67	185011	0	185452
68	182746	134	86	791	0	183757
69	178675	89	105	681	0	179550
70	181790	78	86	711	0	182665
71	501	186907	219	248	0	187875
72	295	566	182574	162	0	183597
73	177316	189	383	507	0	178395
74	192628	90	189	511	0	193418
75	674	198551	233	258	0	199716
76	480	771	62	184105	0	185418
77	269	376	77	187804	0	188526
78	250	167	114	181284	0	181815
79	183096	81	72	2032	0	185281
80	183063	107	105	1085	0	184360
81	183822	114	75	670	0	184681
82	186128	98	80	541	0	186847
83	1659	90	57	184585	0	186391
84	655	184319	218	1146	0	186338
85	462	1013	55	190111	0	191641
86	331	864	189673	1251	0	192119
87	421	195	1158	193389	0	195163
88	284	409	198553	1574	0	200820
89	351	147	1504	196578	0	198580
90	313	422	201394	1763	0	203892
91	406	349	198925	956	0	200636
92	193	204737	2374	708	0	208012
93	406	1764	893	211273	0	214336
94	475	1097	218504	1802	0	221878
95	382	294	1823	213369	0	215868
96	204	219051	1095	1939	0	222289
97	219531	1815	287	1374	0	223007
98	1764	228479	422	547	0	231212
99	1061	1970	182	224609	0	227822
100	302	229949	448	1894	0	232593
101	400	2257	220521	1073	0	224251
102	623	1313	220893	658	0	223487
103	340	225470	2744	916	0	229470
104	487	1900	1015	228683	0	232085
105	1002	1240	228595	2086	0	232923
106	275	226925	2115	1436	0	230751
107	227535	1855	1024	862	0	231276
108	2084	1007	409	228692	0	232192
109	1225	717	235213	2192	0	239347
110	395	235969	2101	1388	0	239853
111	541	1998	1058	237023	0	240620
112	479	1044	449	238990	0	240962
113	225418	420	457	3378	0	229673
114	2054	759	235351	1293	0	239457
115	1255	374	2004	232920	0	236553
116	625	643	234200	2306	0	237774
117	290	221497	2324	1621	0	225732
118	214772	2021	1113	1020	0	218926
119	1860	210147	745	681	0	213433
120	1144	2263	424	200349	0	204180
121	390	197334	610	2074	0	200408
122	186174	2238	420	1442	0	190274
123	2019	190480	579	714	0	193792
124	1336	2467	182380	582	0	186765
125	415	184213	2248	636	0	187512
126	176468	2285	1198	900	0	180851
127	2334	1516	182466	549	0	186865
128	1446	641	2361	181359	0	185807
129	175584	527	1244	2736	0	180091
130	2708	484	587	169077	0	172856
131	169432	537	510	2995	0	173474
132	170645	495	482	1780	0	173402
133	3666	557	475	167566	0	172264
134	1845	490	368	166354	0	169057
135	161489	461	435	3951	0	166336
136	159229	470	463	2037	0	162199
137	3970	476	403	151796	0	156645
138	152311	455	458	3128	0	156352
139	153096	492	503	1886	0	155977
140	3666	151571	700	950	0	156887
141	1953	2590	508	150735	0	155786
142	152193	1444	500	3374	0	157511
143	154148	720	512	1968	0	157348
144	3945	545	560	152741	0	157791
145	1928	581	502	155903	0	158914
146	152383	483	563	4080	0	157509
147	2731	154518	771	2047	0	160067
148	1956	2590	544	154095	0	159185
149	992	1717	154104	2887	0	159700
150	985	737	2604	149598	0	153924
151	810	151583	1685	3050	0	157128
152	883	2773	151248	1847	0	156751
153	1156	1412	2570	147954	0	153092
154	1160	727	1476	146891	0	150254
155	961	771	150556	3974	0	156262
156	137768	630	2605	2400	0	143403
157	2869	151677	1791	1295	0	157632
158	151667	2586	810	1391	0	156454
159	3150	1660	150248	1201	0	156259
160	1983	913	152275	959	0	156130
161	144761	683	3424	1203	0	150071
162	2941	152070	1693	1185	0	157889
163	151342	2611	749	1245	0	155947
164	3072	152263	790	1120	0	157245
165	2070	3012	150702	1027	0	156811
166	147027	1542	2538	1297	0	152404
167	3233	1108	155029	973	0	160343
168	2222	666	2588	151982	0	157458
169	153237	644	1464	3214	0	158559
170	152524	579	755	2141	0	155999
171	3688	150686	985	1205	0	156564
172	2123	4508	637	144437	0	151705
173	1040	147596	793	2691	0	152120
174	955	2580	143497	1641	0	148673
175	1198	2634	2129	131373	0	137334
176	800	133288	1326	2210	0	137624
177	1008	2036	637	130147	0	133828
178	115623	961	604	2307	0	119495
179	1940	533	411	126008	0	128892
180	1209	126065	580	1990	0	129844
181	1012	1597	408	127312	0	130329
182	857	1015	474	126310	0	128656
183	750	125890	626	2292	0	129558
184	993	1741	475	126360	0	129569
185	1029	1011	122797	1781	0	126618
186	712	121304	1597	1164	0	124777
187	110753	1186	761	768	0	113468
188	1569	849	114158	480	0	117056
189	1003	503	112257	459	0	114222
190	625	110601	1519	511	0	113256
191	1212	1422	1111	106602	0	110347
192	693	685	105213	1093	0	107684
193	576	91662	1048	725	0	94011
194	684	872	557	94147	0	96260
195	533	608	273	96486	0	97900
196	95046	313	250	1456	0	97065
197	987	96355	328	976	0	98646
198	746	1087	90600	451	0	92884
199	452	725	94128	496	0	95801
200	455	348	1252	93628	0	95683
201	455	322	592	122203	0	123572
202	426	370	288	123114	0	124198
203	339	140079	410	3494	0	144322
204	446	2979	143783	1669	0	148877
205	543	1805	2879	141370	0	146597
206	284	150242	1879	3292	0	155697
207	306	157522	805	2061	0	160694
208	484	5189	160184	848	0	166705
209	483	2261	3829	155601	0	162174
210	419	956	171605	4020	0	177000
211	622	580	4466	168643	0	174311
212	487	560	2612	175317	0	178976
213	724	597	172328	6356	0	180005
214	272	171922	4599	3257	0	180050
215	168720	4157	2734	1384	0	176995
216	4229	2681	174545	852	0	182307
217	2362	174392	4621	959	0	182334
218	810	180137	2980	798	0	184725
219	695	6637	173467	723	0	181522
220	167618	3145	4677	804	0	176244
221	4636	1497	2807	154256	0	163196
222	2421	174841	1472	3872	0	182606
223	174472	4562	845	2575	0	182454
224	4675	2952	844	165079	0	173550
225	2590	171989	1004	4705	0	180288
226	172492	4815	951	3084	0	181342
227	4413	3035	167537	1414	0	176399
228	2477	169068	4639	1159	0	177343
229	164196	4732	3007	1105	0	173040
230	3973	167556	1610	1062	0	174201
231	165091	5013	1081	1028	0	172213
232	4642	3248	1080	157516	0	166486
233	2555	160739	1458	4299	0	169051
234	1147	4581	1025	163654	0	170407
235	159365	2904	1275	5239	0	168783
236	4155	1670	158820	3330	0	167975
237	2811	1461	161748	1633	0	167653
238	1541	1175	6741	155659	0	165116
239	1148	1353	3606	159699	0	165806
240	1164	1377	1758	155804	0	160103
241	813	154578	1676	6698	0	163765
242	1052	4862	152452	3467	0	161833
243	1290	3327	4704	144696	0	154017
244	1036	147351	3302	4551	0	156240
245	1321	153598	1668	3078	0	159665
246	1322	6685	151973	1627	0	161607
247	1316	4007	153101	1249	0	159673
248	1410	2351	158765	1106	0	163632
249	1590	1747	7222	151852	0	162411
250	1308	1963	157305	4576	0	165152
251	1730	1681	5428	156130	0	164969
252	1442	1712	160159	5165	0	168478
253	149995	1697	5514	3529	0	160735
254	5136	164976	3574	1972	0	175658
255	3299	177754	1934	1659	0	184646
256	2008	7899	182469	1674	0	194050
257	179477	4157	5877	1885	0	191396
258	187798	2186	3793	1706	0	195483
259	189147	1659	2168	1934	0	194908
260	8810	1625	181204	1898	0	193537
261	4299	1585	186439	2222	0	194545
262	2119	1597	8773	181132	0	193621
263	184341	1625	4762	7036	0	197764
264	186402	1850	2651	4694	0	195597
265	8176	2053	181445	2732	0	194406
266	181010	2148	7011	2391	0	192560
267	6677	2099	5013	178547	0	192336
268	3746	2140	183071	6967	0	195924
269	1703	2072	185432	4556	0	193763
270	173198	1882	10232	3123	0	188435
271	5782	1823	185966	2671	0	196242
272	177742	1625	8659	2732	0	190758
273	6735	1915	185744	2484	0	196878
274	4209	175667	8829	2479	0	191184
275	2386	186423	6208	2125	0	197142
276	2464	9119	3800	176836	0	192219
277	2374	5448	3385	187265	0	198472
278	2352	3100	184005	8743	0	198200
279	2857	2471	8082	175545	0	188955
280	2871	174578	5844	6912	0	190205
281	3101	181291	3813	4461	0	192666
282	3351	188801	3428	2394	0	197974
283	3538	9516	3082	181000	0	197136
284	3177	5313	182955	6455	0	197900
285	3136	2869	185805	4401	0	196211
286	3691	2542	9955	179632	0	195820
287	3598	2271	5670	183333	0	194872
288	4041	2094	3576	168929	0	178640
289	3540	180522	3272	8765	0	196099
290	182175	6463	2971	4930	0	196539
291	182290	4496	2990	2915	0	192691
292	9925	180414	3258	2639	0	196236
293	5934	6804	183331	2328	0	198397
294	184250	4394	7658	2375	0	198677
295	8121	2516	190466	2128	0	203231
296	186261	2181	8462	2283	0	199187
297	188951	2204	5735	2664	0	199554
298	186747	2189	3563	2947	0	195446
299	182461	1955	2962	3358	0	190736
300	9214	179072	3395	3553	0	195234
301	150596	4717	2155	2529	0	159997
302	5207	151392	2390	2466	0	161455
303	130178	4155	1780	1540	0	137653
304	4094	128258	1880	1620	0	135852
305	2478	3678	121375	1126	0	128657
306	1533	7375	3716	107765	0	120389
307	1133	114411	2761	3182	0	121487
308	1137	114900	1519	2197	0	119753
309	107948	4371	3000	2038	0	117357
310	100675	1603	1044	993	0	104315
311	3322	104175	1002	842	0	109341
312	1881	2285	907	98365	0	103438
313	1154	108832	990	1997	0	112973
314	109130	2353	896	1295	0	113674
315	2979	1369	109261	666	0	114275
316	2070	1043	2677	103900	0	109690
317	1334	535	1696	105465	0	109030
318	1290	688	1020	107049	0	110047
319	1203	695	104822	3037	0	109757
320	1173	103474	2554	1480	0	108681
321	1254	107965	1624	654	0	111497
322	1324	3171	912	108040	0	113447
323	1143	1634	110203	2301	0	115281
324	1098	1077	2561	108141	0	112877
325	1058	1026	1561	111348	0	114993
326	1117	944	916	111361	0	114338
327	1101	947	755	111397	0	114200
328	108161	829	819	3549	0	113358
329	2491	109610	977	1850	0	114928
330	109422	2669	953	1113	0	114157
331	2741	1811	109132	980	0	114664
332	1749	1212	109612	892	0	113465
333	1233	1083	3107	104483	0	109906
334	1093	946	1580	105114	0	108733
335	819	111438	1147	3268	0	116672
336	932	2638	112310	1748	0	117628
337	745	113848	2760	1424	0	118777
338	839	2664	114908	1168	0	119579
339	102708	1604	2684	1251	0	108247
340	2494	115154	1617	1156	0	120421
341	1668	2706	115695	979	0	121048
342	1170	1653	2520	113003	0	118346
343	913	1233	116451	2687	0	121284
344	820	115574	2608	1787	0	120789
345	1038	2664	1528	111252	0	116482
346	924	115623	965	2831	0	120343
347	1072	2697	114995	1805	0	120569
348	1162	1517	2295	111553	0	116527
349	111956	957	1253	2721	0	116887
350	2656	111533	836	1568	0	116593
351	1754	2621	108268	872	0	113515
352	1150	3130	2210	101095	0	107585
353	846	922	106312	2259	0	110339
354	663	732	94396	1164	0	96955
355	537	87770	2353	651	0	91311
356	804	1050	916	79281	0	82051
357	293	698	325	80276	0	81592
358	300	398	296	80283	0	81277
359	295	355	81303	1299	0	83252
360	257	343	79839	628	0	81067
361	69015	264	1277	554	0	71110
362	846	336	78956	320	0	80458
363	72454	211	923	353	0	73941
364	808	77369	580	352	0	79109
365	576	913	312	73854	0	75655
366	185	78031	309	814	0	79339
367	142	79872	334	609	0	80957
368	199	1098	77436	348	0	79081
369	255	556	869	75617	0	77297
370	216	398	78614	911	0	80139
371	197	342	74110	559	0	75208
372	71395	255	1107	467	0	73224
373	735	273	77859	360	0	79227
374	433	259	76044	394	0	77130
375	71351	210	1122	473	0	73156
376	719	294	76188	384	0	77585
377	414	369	78736	394	0	79913
378	252	287	1092	73832	0	75463
379	171	79379	654	812	0	81016
380	230	783	382	80045	0	81440
381	192	486	399	79210	0	80287
382	79513	235	392	1351	0	81491
383	776	246	357	77627	0	79006
384	434	81109	440	932	0	82915
385	79762	832	358	718	0	81670
386	804	663	80103	400	0	81970
387	74686	361	995	491	0	76533
388	905	353	85804	341	0	87403
389	525	338	87239	372	0	88474
390	200	89719	1599	433	0	91951
391	89990	1035	842	536	0	92403
392	936	91175	593	544	0	93248
393	623	1191	88520	411	0	90745
394	415	707	1201	79373	0	81696
395	222	90676	852	1025	0	92775
396	91619	1134	506	712	0	93971
397	91007	705	463	405	0	92580
398	1493	92336	536	345	0	94710
399	94564	1189	498	391	0	96642
400	1203	691	510	90869	0	93273
401	560	94172	632	1239	0	96603
402	335	1215	471	97814	0	99835
403	314	722	451	103569	0	105056
404	105850	422	485	1832	0	108589
405	104166	336	483	904	0	105889
406	104133	337	480	486	0	105436
407	2039	390	103387	355	0	106171
408	99256	296	1506	364	0	101422
409	1541	766	1010	103374	0	106691
410	769	381	104456	1346	0	106952
411	448	353	97995	839	0	99635
412	301	99819	1994	511	0	102625
413	91273	1110	894	322	0	93599
414	1008	94450	319	374	0	96151
415	699	1046	230	93872	0	95847
416	427	573	226	95684	0	96910
417	313	244	96816	1401	0	98774
418	391	239	1137	90780	0	92547
419	319	220	97271	1115	0	98925
420	244	212	92917	601	0	93974
421	199	95352	1356	273	0	97180
422	264	799	537	92738	0	94338
423	199	438	195	91714	0	92546
424	92279	183	118	1189	0	93769
425	918	207	92295	543	0	93963
426	547	131	832	93093	0	94603
427	93883	90	528	1062	0	95563
428	950	174	95093	556	0	96773
429	91484	118	964	350	0	92916
430	95301	133	570	268	0	96272
431	1407	219	98170	197	0	99993
432	736	166	985	95503	0	97390
433	372	196	609	98209	0	99386
434	343	221	100827	1336	0	102727
435	95994	140	1012	813	0	97959
436	101591	149	697	428	0	102865
437	98761	172	411	343	0	99687
438	99848	217	330	340	0	100735
439	98340	242	546	386	0	99514
440	1599	405	83320	464	0	85788
441	780	329	100087	359	0	101555
442	398	101135	1406	429	0	103368
443	485	1095	101728	363	0	103671
444	456	703	1152	98532	0	100843
445	646	528	958	75375	0	77507
446	509	308	385	102435	0	103637
447	564	288	356	103727	0	104935
448	582	303	102804	1620	0	105309
449	577	100764	1137	897	0	103375
450	610	105667	799	545	0	107621
451	648	1512	451	99357	0	101968
452	454	107647	425	1167	0	109693
453	107595	1247	347	843	0	110032
454	106833	632	345	679	0	108489
455	1890	112061	426	611	0	114988
456	1221	1128	390	112121	0	114860
457	760	597	450	115190	0	116997
458	724	351	114869	1909	0	117853
459	101572	277	1530	1147	0	104526
460	115175	303	965	619	0	117062
461	2082	118022	670	628	0	121402
462	119529	1445	512	644	0	122130
463	1948	924	122424	574	0	125870
464	1175	121347	1674	612	0	124808
465	752	125892	1035	611	0	128290
466	663	127380	654	629	0	129326
467	778	2324	495	125166	0	128763
468	125313	972	534	2158	0	128977
469	2162	476	638	127495	0	130771
470	1619	437	129384	2201	0	133641
471	1113	400	2193	128278	0	131984
472	953	502	133546	2351	0	137352
473	825	462	2467	126845	0	130599
474	937	556	1400	120459	0	123352
475	657	131960	962	2603	0	136182
476	134496	2133	827	1522	0	138978
477	2361	1202	764	127716	0	132043
478	1366	133012	727	2287	0	137392
479	133776	2134	656	1504	0	138070
480	118519	1344	825	1062	0	121750
481	134250	664	683	1108	0	136705
482	2882	133472	836	1122	0	138312
483	1441	2176	133093	998	0	137708
484	882	1157	2359	133488	0	137886
485	880	944	1412	129992	0	133228
486	819	133700	926	3032	0	138477
487	870	2273	131799	1454	0	136396
488	842	1121	129512	957	0	132432
489	121677	548	2587	817	0	125629
490	2477	919	1131	125561	0	130088
491	1377	509	129053	2062	0	133001
492	814	131883	2032	1348	0	136077
493	1033	1943	1113	121544	0	125633
494	823	132909	833	1655	0	136220
495	882	1919	130172	1084	0	134057
496	120411	938	1969	864	0	124182
497	129404	504	1151	870	0	131929
498	2454	129937	748	908	0	134047
499	1284	1745	461	128379	0	131869
500	1020	1001	128362	1891	0	132274
501	884	126696	1831	1102	0	130513
502	122236	1730	912	742	0	125620
503	1608	118168	424	492	0	120692
504	741	118227	389	446	0	119803
505	638	2008	422	114092	0	117160
506	340	117595	349	1427	0	119711
507	116671	1618	316	866	0	119471
508	1656	881	263	115372	0	118172
509	723	521	112250	1501	0	114995
510	409	496	107203	754	0	108862
511	489	562	1716	107035	0	109802
512	314	109759	754	1405	0	112232
513	109899	1483	422	803	0	112607
514	1481	794	330	107592	0	110197
515	739	558	107259	1443	0	109999
516	455	404	1351	105807	0	108017
517	379	413	678	106858	0	108328
518	104179	411	394	1835	0	106819
519	1413	375	341	103665	0	105794
520	716	479	103187	1392	0	105774
521	450	440	103816	765	0	105471
522	475	361	1705	105160	0	107701
523	468	400	782	108301	0	109951
524	366	487	109613	1874	0	112340
525	95389	424	1479	1176	0	98468
526	1479	516	108466	591	0	111052
527	717	107186	1528	527	0	109958
528	522	1414	718	107900	0	110554
529	414	852	108716	1470	0	111452
530	383	515	107421	838	0	109157
531	407	428	1805	103270	0	105910
532	103923	346	908	1667	0	106844
533	1437	434	105756	898	0	108525
534	692	103867	1526	535	0	106620
535	105417	1420	781	677	0	108295
536	1429	799	106743	562	0	109533
537	101023	372	1497	578	0	103470
538	106749	327	789	629	0	108494
539	1771	109957	549	605	0	112882
540	915	1363	479	101322	0	104079
541	438	108348	502	1329	0	110617
542	425	1488	106111	826	0	108850
543	102174	749	1530	677	0	105130
544	109110	472	810	600	0	110992
545	1909	437	109270	445	0	112061
546	951	396	107990	436	0	109773
547	457	112245	2032	445	0	115179
548	114336	1512	931	545	0	117324
549	1738	837	539	112523	0	115637
550	928	393	475	106307	0	108103
551	414	111790	559	1796	0	114559
552	109975	1472	543	909	0	112899
553	1536	859	112606	506	0	115507
554	838	330	1525	122380	0	125073
555	123040	325	910	2408	0	126683
556	2425	124663	584	1286	0	128958
557	1176	2405	134625	456	0	138662
558	571	1123	138434	335	0	140463
559	642	1545	3844	127634	0	133665
560	296	136221	1357	2609	0	140483
561	511	3126	137497	1030	0	142164
562	424	1243	3094	133360	0	138121
563	137532	351	1217	3143	0	142243
564	3124	415	141219	1090	0	145848
565	1273	697	3450	139721	0	145141
566	536	337	143927	3239	0	148039
567	413	334	146954	1159	0	148860
568	649	1095	4273	141044	0	147061
569	495	338	145955	3148	0	149936
570	118805	241	3412	1420	0	123878
571	2969	274	141739	397	0	145379
572	129208	147	3153	377	0	132885
573	2944	136339	1336	300	0	140919
574	139583	2805	467	517	0	143372
575	2921	143106	533	333	0	146893
576	1267	2999	325	141536	0	146127
577	545	1137	347	147993	0	150022
578	401	433	144513	3993	0	149340
579	324	398	146085	1399	0	148206
580	405	222	4203	145298	0	150128
581	406	333	148965	3240	0	152944
582	431	304	3582	137915	0	142232
583	330	143437	1780	3030	0	148577
584	457	150243	1016	1406	0	153122
585	496	4150	727	145650	0	151023
586	581	1501	645	148761	0	151488
587	381	650	145931	4151	0	151113
588	448	457	3353	140729	0	144987
589	370	142741	1631	3356	0	148098
590	305	145092	1017	1618	0	148032
591	390	146865	832	1035	0	149122
592	508	4147	808	133104	0	138567
593	371	138917	999	3073	0	143360
594	136800	3236	880	1586	0	142502
595	3285	1349	955	136435	0	142024
596	1411	710	136692	3497	0	142310
597	733	551	3599	135547	0	140430
598	595	668	138640	3676	0	143579
599	549	647	139379	1719	0	142294
600	610	550	142756	1012	0	144928
601	541	139018	4731	1080	0	145370
602	564	3412	141751	905	0	146632
603	138799	1453	3836	1040	0	145128
604	143321	813	1912	1028	0	147074
605	145533	686	1188	1067	0	148474
606	4476	656	984	141965	0	148081
607	141950	658	1110	3837	0	147555
608	3356	138099	1192	1976	0	144623
609	1468	146494	1110	1270	0	150342
610	144699	4226	1136	1191	0	151252
611	3462	1909	148159	1082	0	154612
612	1569	1007	3799	146731	0	153106
613	761	1016	151603	3761	0	157141
614	620	1027	153867	2039	0	157553
615	480	152809	4829	1328	0	159446
616	697	3709	2243	144137	0	150786
617	739	1778	1287	154829	0	158633
618	151814	1009	1049	4859	0	158731
619	3379	152660	1290	2453	0	159782
620	1719	157662	1244	1467	0	162092
621	1340	4753	155193	1354	0	162640
622	788	158850	4086	1143	0	164867
623	153951	3956	2352	1435	0	161694
624	155529	1966	1731	1380	0	160606
625	4352	1353	158834	1211	0	165750
626	1732	1208	161092	1317	0	165349
627	1080	1009	5452	150416	0	157957
628	1046	1012	2876	152859	0	157793
629	983	156169	1965	4735	0	163852
630	1254	3836	1552	155137	0	161779
631	1240	1887	1560	155257	0	159944
632	1092	155798	1701	4947	0	163538
633	1255	3659	1520	155869	0	162303
634	1002	1967	1735	151185	0	155889
635	953	149519	1784	5071	0	157327
636	1130	3697	149946	2308	0	157081
637	1237	1908	4404	152444	0	159993
638	153516	1329	2299	4219	0	161363
639	152714	1211	1626	2133	0	157684
640	4905	1435	150597	1291	0	158228
641	146665	1375	3871	1463	0	153374
642	151505	1341	1921	1602	0	156369
643	4456	150235	1510	1747	0	157948
644	1980	3804	146571	1579	0	153934
645	971	2069	148711	1587	0	153338
646	1041	1836	5038	152378	0	160293
647	157819	1033	2629	4240	0	165721
648	164987	1087	1613	2226	0	169913
649	5013	1200	1381	170092	0	177686
650	183568	1122	1143	4753	0	190586
651	187699	1145	1268	2509	0	192621
652	179941	1083	1457	1744	0	184225
653	5836	1129	180270	1529	0	188764
654	2229	866	173434	999	0	177528
655	165597	600	4282	1097	0	171576
656	3415	763	172173	927	0	177278
657	1290	162230	2739	534	0	166793
658	1083	2571	2255	157743	0	163652
659	574	1194	167756	2162	0	171686
660	570	588	164932	1042	0	167132
661	736	1031	3018	157490	0	162275
662	478	359	164511	2190	0	167538
663	464	369	160521	1157	0	162511
664	352	146830	2702	562	0	150446
665	290	157443	1195	286	0	159214
666	156286	2434	652	384	0	159756
667	2004	1018	295	153177	0	156494
668	152999	299	359	1857	0	155514
669	2046	312	152550	860	0	155768
670	1070	220	1831	149866	0	152987
671	507	182	929	154126	0	155744
672	146886	175	400	2730	0	150191
673	1912	153003	383	1253	0	156551
674	1119	1805	143617	422	0	146963
675	819	1014	148859	292	0	150984
676	346	150972	2563	462	0	154343
677	418	1777	150108	232	0	152535
678	248	149866	1960	288	0	152362
679	290	141872	1066	289	0	143517
680	588	2394	138834	204	0	142020
681	130709	964	1800	221	0	133694
682	1775	311	906	142559	0	145551
683	883	147476	446	1638	0	150443
684	469	1601	338	144267	0	146675
685	145390	752	333	1807	0	148282
686	144043	277	308	1011	0	145639
687	143780	195	329	492	0	144796
688	2413	278	140918	239	0	143848
689	1065	219	1739	134926	0	137949
690	357	142948	1068	1494	0	145867
691	148931	1560	468	1131	0	152090
692	1773	831	362	149549	0	152515
693	1068	341	316	149316	0	151041
694	526	247	324	154521	0	155618
695	408	378	152683	2516	0	155985
696	134192	290	1834	1506	0	137822
697	1881	154192	1046	529	0	157648
698	1223	1697	451	153447	0	156818
699	698	828	431	154803	0	156760
700	147709	370	552	2667	0	151298
701	2102	472	146902	1078	0	150554
702	1169	392	154091	446	0	156098
703	584	151651	2733	506	0	155474
704	475	1992	156244	406	0	159117
705	138336	1010	2421	576	0	142343
706	1917	155611	1417	621	0	159566
707	1098	2155	153507	445	0	157205
708	138557	1105	2219	592	0	142473
709	2233	636	162384	489	0	165742
710	1200	163042	2406	496	0	167144
711	830	2031	1249	161782	0	165892
712	787	1103	634	165777	0	168301
713	698	596	162607	2786	0	166687
714	714	517	159426	1356	0	162013
715	577	159026	3046	752	0	163401
716	154601	2016	1428	790	0	158835
717	2137	163704	974	601	0	167416
718	1428	2221	677	160801	0	165127
719	754	1328	162326	2280	0	166688
720	142003	564	2655	1359	0	146581
721	2392	513	1503	155887	0	160295
722	1269	155881	1057	2132	0	160339
723	566	163712	1014	1315	0	166607
724	711	2933	781	161694	0	166119
725	653	1420	737	164406	0	167216
726	160665	756	750	3168	0	165339
727	2407	656	723	166208	0	169994
728	1330	812	166769	2624	0	171535
729	159229	509	2603	1738	0	164079
730	168732	556	1470	1114	0	171872
731	3259	757	169986	745	0	174747
732	163091	545	2704	756	0	167096
733	2803	613	1493	177742	0	182651
734	1642	711	771	180336	0	183460
735	1023	620	703	182286	0	184632
736	917	584	656	175477	0	177634
737	657	179646	836	3716	0	184855
738	182756	2584	844	1900	0	188084
739	187300	1539	742	1142	0	190723
740	3866	979	190302	928	0	196075
741	191307	704	2867	994	0	195872
742	201172	665	1698	918	0	204453
743	202978	638	811	934	0	205361
744	206316	547	783	913	0	208559
745	4855	202633	837	771	0	209096
746	2094	3661	492	191153	0	197400
747	1054	1645	193629	3066	0	199394
748	875	819	182933	1475	0	186102
749	161200	2089	4845	1091	0	169225
750	167985	654	2319	644	0	171602
751	2993	164163	512	392	0	168060
752	166082	1995	297	519	0	168893
753	2381	166130	388	372	0	169271
754	1456	2269	219	163996	0	167940
755	167965	1048	338	2513	0	171864
756	165755	373	356	1359	0	167843
757	165482	279	203	711	0	166675
758	3192	162899	372	478	0	166941
759	162002	2008	250	594	0	164854
760	2643	1011	287	162554	0	166495
761	165556	335	317	2300	0	168508
762	2745	426	161929	1052	0	166152
763	1518	163231	2189	527	0	167465
764	162839	2022	1034	560	0	166455
765	2530	1185	164868	334	0	168917
766	1476	503	2065	160858	0	164902
767	818	434	166668	2115	0	170035
768	846	383	165134	1059	0	167422
769	921	465	2898	161905	0	166189
770	880	510	169029	2122	0	172541
771	859	369	2288	166331	0	169847
772	890	359	1092	169437	0	171778
773	170180	312	503	3178	0	174173
774	2581	170978	581	1521	0	175661
775	1507	174331	479	753	0	177070
776	945	179115	580	492	0	181132
777	1461	3501	177096	411	0	182469
778	1004	1477	2448	173871	0	178800
779	843	747	181978	2535	0	186103
780	165325	451	2708	1553	0	170037
781	178859	396	1298	799	0	181352
782	3504	181399	697	782	0	186382
783	1898	2564	513	175487	0	180462
784	953	183460	610	2329	0	187352
785	183290	2638	499	1414	0	187841
786	3130	1261	472	182196	0	187059
787	1757	840	182993	2695	0	188285
788	942	181260	2720	1643	0	186565
789	1013	2762	183772	740	0	188287
790	985	1338	2867	180219	0	185409
791	820	752	181106	2828	0	185506
792	165882	545	2926	1806	0	171159
793	3069	758	182019	821	0	186667
794	1633	182176	2991	793	0	187593
795	1089	2706	1562	180931	0	186288
796	986	1495	876	185142	0	188499
797	182830	727	770	3889	0	188216
798	183097	596	803	1938	0	186434
799	3739	180950	975	1088	0	186752
800	1941	2698	180313	784	0	185736
801	1184	1678	178268	713	0	181843
802	172627	765	3690	946	0	178028
803	3048	890	180844	759	0	185541
804	1860	845	175587	697	0	178989
805	1160	852	177195	759	0	179966
806	1111	851	177080	731	0	179773
807	935	177822	3972	836	0	183565
808	178698	2743	1970	966	0	184377
809	3239	1735	1048	172266	0	178288
810	173909	860	975	2846	0	178590
811	3139	172306	1088	1563	0	178096
812	171629	2790	985	1124	0	176528
813	3058	177955	1206	901	0	183120
814	2151	2965	1010	173256	0	179382
815	1121	188003	1174	2763	0	193061
816	1306	3390	185309	1589	0	191594
817	1053	191785	3433	970	0	197241
818	1229	3399	1910	206337	0	212875
819	207931	1853	1133	3531	0	214448
820	3833	1057	1055	208410	0	214355
821	2283	1112	208270	3639	0	215304
822	1438	873	3695	197537	0	203543
823	1052	207509	2442	3468	0	214471
824	1137	3667	207038	1916	0	213758
825	201088	1915	3937	1202	0	208142
826	3994	1026	2306	211871	0	219197
827	210256	852	1379	3906	0	216393
828	207411	887	1176	2385	0	211859
829	4712	208945	1417	1617	0	216691
830	208734	3525	1170	1282	0	214711
831	210928	2043	1126	1211	0	215308
832	4759	210787	1426	1030	0	218002
833	2356	3452	1242	209519	0	216569
834	1338	1960	1217	207598	0	212113
835	908	208791	1311	4584	0	215594
836	1232	3606	1033	212010	0	217881
837	1028	2115	209870	3712	0	216725
838	1353	1772	3469	205353	0	211947
839	1213	994	205378	3703	0	211288
840	940	900	192328	1864	0	196032
841	801	191489	4026	1186	0	197502
842	787	192042	1899	980	0	195708
843	846	198877	1277	959	0	201959
844	1588	4003	1000	189826	0	196417
845	746	1826	193241	2734	0	198547
846	183972	785	2994	1669	0	189420
847	2976	670	1608	194518	0	199772
848	1569	840	195911	2738	0	201058
849	896	839	195059	1591	0	198385
850	689	197844	3731	962	0	203226
851	860	3001	1643	192983	0	198487
852	192988	1547	802	2921	0	198258
853	2490	193212	859	1807	0	198368
854	1406	194748	759	930	0	197843
855	696	194767	766	985	0	197214
856	753	3909	750	194641	0	200053
857	476	203504	865	3029	0	207874
858	763	3257	700	215021	0	219741
859	836	1800	732	219248	0	222616
860	655	1100	213987	4782	0	220524
861	181553	817	3655	2738	0	188763
862	3379	995	216781	901	0	222056
863	1881	1092	3592	213327	0	219892
864	811	988	217100	3672	0	222571
865	551	214252	3850	2180	0	220833
866	214242	3689	2338	1314	0	221583
867	3619	2175	972	208687	0	215453
868	2091	856	830	214183	0	217960
869	212693	718	728	4956	0	219095
870	212069	698	851	2485	0	216103
871	216878	721	752	1415	0	219766
872	4902	928	213611	855	0	220296
873	194888	770	3175	1052	0	199885
874	3314	205951	1868	908	0	212041
875	1704	210076	816	921	0	213517
876	1087	4471	649	201975	0	208182
877	946	2064	578	195659	0	199247
878	680	199442	781	4418	0	205321
879	961	3398	545	199378	0	204282
880	193541	1853	650	3918	0	199962
881	3301	1078	198088	2179	0	204646
882	1772	196952	3445	1194	0	203363
883	186913	3325	1815	1230	0	193283
884	2886	194620	1112	1317	0	199935
885	1710	3612	193475	1137	0	199934
886	1093	2086	3290	190337	0	196806
887	873	1285	194982	3563	0	200703
888	810	191860	3474	2264	0	198408
889	1067	3445	1890	190635	0	197037
890	920	2118	190757	3478	0	197273
891	1026	1239	192147	2133	0	196545
892	1101	985	4281	188967	0	195334
893	190747	815	2181	3614	0	197357
894	191385	896	1035	2269	0	195585
895	192130	827	924	1396	0	195277
896	4689	1163	193345	1133	0	200330
897	2091	193366	3428	1200	0	200085
898	1218	3383	1919	191486	0	198006
899	1091	2095	1024	184893	0	189103
900	838	193712	1000	4410	0	199960
901	191977	3442	841	2499	0	198759
902	3514	2086	808	193723	0	200131
903	2152	1315	193492	3758	0	200717
904	1010	193287	3648	2480	0	200425
905	186188	3467	2095	1668	0	193418
906	3125	192323	1409	1516	0	198373
907	2216	3592	1211	187995	0	195014
908	1412	2119	1269	190320	0	195120
909	1293	1194	1295	190102	0	193884
910	1119	1354	188827	4970	0	196270
911	1354	1277	3595	179229	0	185455
912	1142	182831	2548	3827	0	190348
913	1249	181397	1593	2561	0	186800
914	1503	4249	172845	1782	0	180379
915	160176	2093	3193	1823	0	167285
916	169533	1183	2048	1713	0	174477
917	4438	166323	1315	1463	0	173539
918	150023	2543	1160	1380	0	155106
919	149251	1581	912	1280	0	153024
920	3681	154553	1047	1211	0	160492
921	2286	2942	891	155756	0	161875
922	1363	2044	161153	2998	0	167558
923	1258	1344	154257	2024	0	158883
924	154438	1096	3836	1595	0	160965
925	3026	160699	1925	1525	0	167175
926	2146	3092	926	160408	0	166572
927	1382	1878	825	162144	0	166229
928	1409	1104	868	162380	0	165761
929	157195	1118	876	4396	0	163585
930	3581	1061	891	158173	0	163706
931	2315	971	792	156146	0	160224
932	1206	1186	149593	3838	0	155823
933	134750	964	2868	2325	0	140907
934	2803	147355	1987	1296	0	153441
935	146196	2906	979	1272	0	151353
936	2773	145042	1117	1139	0	150071
937	1992	2808	938	140267	0	146005
938	144956	1659	946	3002	0	150563
939	146457	980	950	2034	0	150421
940	3758	1040	145782	1224	0	151804
941	146926	865	2829	1214	0	151834
942	3176	1018	150376	960	0	155530
943	1975	1009	144700	978	0	148662
944	1095	1048	145371	1017	0	148531
945	1033	1026	157708	1029	0	160796
946	1127	1188	4412	159483	0	166210
947	1048	998	163051	3587	0	168684
948	1043	954	3722	160048	0	165767
949	161340	844	1945	4135	0	168264
950	3695	797	1118	160490	0	166100
951	154895	865	962	4223	0	160945
952	3604	156979	1078	2422	0	164083
953	2353	3787	829	156976	0	163945
954	1366	2052	150131	3941	0	157490
955	989	163657	3368	2595	0	170609
956	1365	4500	1708	157845	0	165418
957	1065	1827	159326	3649	0	165867
958	557	152870	3152	1837	0	158416
959	516	155454	1611	943	0	158524
960	1327	4326	152695	708	0	159056
961	776	2422	3399	147770	0	154367
962	458	719	150814	3199	0	155190
963	141439	343	3385	1582	0	146749
964	149436	223	1492	825	0	151976
965	4049	147309	823	519	0	152700
966	148166	2986	429	552	0	152133
967	3536	1427	406	146706	0	152075
968	1564	677	145720	3217	0	151178
969	136128	346	3138	1769	0	141381
970	3266	358	144043	876	0	148543
971	1456	142761	3410	533	0	148160
972	145861	2971	1840	630	0	151302
973	3336	1395	647	145501	0	150879
974	1580	727	147132	3046	0	152485
975	144192	379	3127	1642	0	149340
976	146897	300	1561	822	0	149580
977	148316	305	689	609	0	149919
978	4623	311	437	145054	0	150425
979	2009	283	439	148454	0	151185
980	837	389	146456	4303	0	151985
981	456	145300	3306	1963	0	151025
982	674	3032	1642	142730	0	148078
983	607	1416	758	148818	0	151599
984	491	718	146467	4365	0	152041
985	609	515	146456	1911	0	149491
986	786	348	4443	145479	0	151056
987	142773	387	2028	3530	0	148718
988	3222	145195	1144	1829	0	151390
989	145000	3203	708	1123	0	150034
990	3548	145226	927	845	0	150546
991	1950	3575	143784	637	0	149946
992	1020	1824	147369	655	0	150868
993	141996	840	4830	827	0	148493
994	160923	566	2193	963	0	164645
995	5215	159390	1285	1126	0	167016
996	2629	3843	156724	992	0	164188
997	1687	1925	4109	154728	0	162449
998	1376	920	2287	150591	0	155174
999	990	157647	1383	5415	0	165435
1000	1128	4012	863	158067	0	164070
1001	913	2252	158796	4661	0	166622
1002	153857	1102	4324	2607	0	161890
1003	160480	839	2327	1457	0	165103
1004	161152	773	1322	1136	0	164383
1005	164582	669	1026	1072	0	167349
1006	6689	796	158462	877	0	166824
1007	156352	501	4472	966	0	162291
1008	5363	669	160026	792	0	166850
1009	2998	157496	5094	879	0	166467
1010	1955	4028	2790	159089	0	167862
1011	162620	2137	1676	4374	0	170807
1012	4879	1131	1270	169905	0	177185
1013	2796	943	169830	5243	0	178812
1014	168063	783	5032	2974	0	176852
1015	174409	764	2853	1775	0	179801
1016	7090	689	1583	171468	0	180830
1017	3711	751	1201	175961	0	181624
1018	2013	922	171483	6946	0	181364
1019	1425	172672	5082	3644	0	182823
1020	166082	4492	2692	1975	0	175241
1021	5091	2472	160421	1231	0	169215
1022	155048	1211	4549	1143	0	161951
1023	5506	159198	2955	932	0	168591
1024	158305	4348	1481	958	0	165092
1025	5550	154856	1421	968	0	162795
1026	3217	157358	1400	1069	0	163044
1027	2411	6122	1195	155471	0	165199
1028	1835	2834	1172	160730	0	166571
1029	1739	1456	1079	162965	0	167239
1030	1677	921	1012	164366	0	167976
1031	1441	1029	157941	7160	0	167571
1032	152490	776	4671	3740	0	161677
1033	161935	710	2693	2126	0	167464
1034	165138	707	1625	1709	0	169179
1035	7644	704	1347	158909	0	168604
1036	4448	655	1140	162663	0	168906
1037	160961	689	1094	6603	0	169347
1038	162554	765	1143	3446	0	167908
1039	163349	820	1139	1976	0	167284
1040	7397	1048	1242	153655	0	163342
1041	3977	972	1004	152849	0	158802
1042	2485	850	147792	5880	0	157007
1043	1876	857	146227	2978	0	151938
1044	1683	144985	5688	1845	0	154201
1045	128934	4564	4220	1904	0	139622
1046	127411	1818	1732	1333	0	132294
1047	128682	958	831	1431	0	131902
1048	4837	857	129390	1230	0	136314
1049	127621	651	2986	1535	0	132793
1050	131890	541	1812	1394	0	135637
1051	133901	506	1078	1304	0	136789
1052	5441	408	868	129676	0	136393
1053	3370	466	877	130431	0	135144
1054	2421	483	691	130397	0	133992
1055	1622	539	115825	4616	0	122602
1056	104697	503	2290	2529	0	110019
1057	3199	113156	1604	1386	0	119345
1058	103666	2047	592	903	0	107208
1059	2956	101270	553	910	0	105689
1060	1895	102183	579	957	0	105614
1061	1520	2781	667	100869	0	105837
1062	1360	1527	880	98607	0	102374
1063	1016	99779	600	2884	0	104279
1064	99106	2074	473	1697	0	103350
1065	99610	1260	479	1159	0	102508
1066	3317	590	484	98098	0	102489
1067	2087	497	98529	2471	0	103584
1068	1476	467	95859	1648	0	99450
1069	1470	384	101260	1022	0	104136
1070	1488	372	100571	763	0	103194
1071	94922	472	3346	945	0	99685
1072	97503	277	1370	853	0	100003
1073	3323	317	755	95091	0	99486
1074	1962	441	93343	2371	0	98117
1075	1421	352	1976	91890	0	95639
1076	1185	93051	1271	2239	0	97746
1077	1258	102984	764	1459	0	106465
1078	104696	2542	524	1172	0	108934
1079	105494	1471	427	1003	0	108395
1080	106429	754	452	1029	0	108664
1081	3214	588	518	104499	0	108819
1082	1940	652	502	106782	0	109876
1083	1513	558	434	107486	0	109991
1084	1518	433	328	107591	0	109870
1085	1343	507	105280	3182	0	110312
1086	1268	279	1805	105787	0	109139
1087	109121	219	1274	2694	0	113308
1088	2517	292	870	109928	0	113607
1089	1794	301	699	111131	0	113925
1090	1395	624	721	109124	0	111864
1091	1071	104929	674	3333	0	110007
1092	1006	104377	604	1885	0	107872
1093	927	105495	539	1230	0	108191
1094	987	1707	450	93827	0	96971
1095	760	725	326	95117	0	96928
1096	94368	320	261	2034	0	96983
1097	94476	282	259	1138	0	96155
1098	95471	309	282	737	0	96799
1099	2037	327	294	94036	0	96694
1100	1174	285	279	93519	0	95257
1101	803	92683	340	1798	0	95624
1102	778	96331	292	969	0	98370
1103	95063	1490	222	725	0	97500
1104	1706	640	181	94071	0	96598
1105	93714	215	247	1586	0	95762
1106	95175	188	288	1082	0	96733
1107	1815	220	345	92451	0	94831
1108	917	96492	415	1430	0	99254
1109	97762	1083	203	1042	0	100090
1110	98768	537	165	833	0	100303
1111	1770	324	98938	602	0	101634
1112	90587	180	650	401	0	91818
1113	843	92972	500	278	0	94593
1114	530	642	87	95701	0	96960
1115	105811	354	93	1331	0	107589
1116	1051	140	100	106048	0	107339
1117	646	126	90	106515	0	107377
1118	245	106948	195	1315	0	108703
1119	105998	818	81	757	0	107654
1120	106737	475	68	458	0	107738
1121	1311	106216	178	275	0	107980
1122	598	110151	155	242	0	111146
1123	109654	1088	81	392	0	111215
1124	108654	533	76	328	0	109591
1125	1340	316	105588	238	0	107482
1126	679	247	99855	237	0	101018
1127	371	270	107150	216	0	108007
1128	299	110	1153	107651	0	109213
1129	272	112	490	110118	0	110992
1130	275	240	109220	1188	0	110923
1131	105131	124	771	788	0	106814
1132	112459	122	435	464	0	113480
1133	112963	109	180	341	0	113593
1134	111142	104	105	346	0	111697
1135	1419	296	118612	201	0	120528
1136	118873	147	803	568	0	120391
1137	123143	117	502	585	0	124347
1138	123276	145	191	474	0	124086
1139	124074	146	129	431	0	124780
1140	123394	188	161	464	0	124207
1141	1464	306	125254	337	0	127361
1142	769	124986	867	280	0	126902
1143	538	855	458	125555	0	127406
1144	446	535	197	128649	0	129827
1145	413	459	127270	1300	0	129442
1146	117499	186	852	871	0	119408
1147	1139	182	470	124796	0	126587
1148	803	364	123348	937	0	125452
1149	562	326	118770	649	0	120307
1150	408	125915	1297	417	0	128037
1151	491	841	601	127711	0	129644
1152	446	517	274	129266	0	130503
1153	501	320	220	128734	0	129775
1154	128636	154	214	1587	0	130591
1155	1221	203	211	128704	0	130339
1156	853	349	127765	1107	0	130074
1157	620	307	119116	707	0	120750
1158	583	380	133134	414	0	134511
1159	604	254	1342	134859	0	137059
1160	138028	219	674	1296	0	140217
1161	1234	353	139350	620	0	141557
1162	136003	140	944	585	0	137672
1163	153932	165	612	1129	0	155838
1164	1676	189	325	157004	0	159194
1165	1097	155	256	158074	0	159582
1166	600	158947	413	1529	0	161489
1167	593	1180	157224	825	0	159822
1168	152133	555	1082	698	0	154468
1169	1338	295	619	161213	0	163465
1170	856	161132	463	1171	0	163622
1171	688	1021	251	163638	0	165598
1172	542	835	162775	1258	0	165410
1173	620	397	1133	159390	0	161540
1174	441	161946	802	1264	0	164453
1175	507	954	356	161702	0	163519
1176	160071	555	352	1539	0	162517
1177	1265	282	359	155832	0	157738
1178	773	152509	466	1308	0	155056
1179	453	155782	459	885	0	157579
1180	149447	1301	365	804	0	151917
1181	1287	861	155108	443	0	157699
1182	933	279	1084	153343	0	155639
1183	612	211	651	158495	0	159969
1184	522	526	160264	1556	0	162868
1185	450	160619	1192	1165	0	163426
1186	899	1188	160428	506	0	163021
1187	550	873	1075	155199	0	157697
1188	360	161472	748	1027	0	163607
1189	163989	837	343	924	0	166093
1190	990	163737	446	556	0	165729
1191	580	166053	414	566	0	167613
1192	167527	1133	401	740	0	169801
1193	169804	500	312	931	0	171547
1194	172653	229	236	765	0	173883
1195	1361	177	277	173191	0	175006
1196	658	452	174187	1044	0	176341
1197	168834	234	930	1033	0	171031
1198	184039	174	558	740	0	185511
1199	1729	201	271	188094	0	190295
1200	807	473	188039	1372	0	190691
1201	338	186132	1313	901	0	188684
1202	185575	1217	632	739	0	188163
1203	190593	572	317	906	0	192388
1204	1575	193573	365	452	0	195965
1205	640	198543	377	418	0	199978
1206	198522	1597	182	671	0	200972
1207	197711	680	207	693	0	199291
1208	195595	289	187	625	0	196696
1209	1944	211	210	194169	0	196534
1210	819	501	196522	1347	0	199189
1211	543	275	1189	192273	0	194280
1212	396	523	195313	1412	0	197644
1213	252	191583	1327	838	0	194000
1214	290	193874	660	407	0	195231
1215	495	1286	317	178897	0	180995
1216	371	437	188	183835	0	184831
1217	352	231	144	180380	0	181107
1218	211	183792	301	1229	0	185533
1219	181861	946	167	824	0	183798
1220	179229	497	182	568	0	180476
1221	1229	184580	292	455	0	186556
1222	681	1002	114	180322	0	182119
1223	346	181739	274	984	0	183343
1224	459	1162	102	180790	0	182513
1225	306	182408	260	1029	0	184003
1226	182757	980	154	911	0	184802
1227	1175	459	142	180354	0	182130
1228	658	567	178656	1099	0	180980
1229	172629	201	1011	914	0	174755
1230	177988	236	458	699	0	179381
1231	1392	541	177744	308	0	179985
1232	702	266	1030	176406	0	178404
1233	392	618	180465	1182	0	182657
1234	379	274	993	181002	0	182648
1235	370	628	174303	1216	0	176517
1236	159651	308	1063	938	0	161960
1237	1278	301	447	170489	0	172515
1238	620	173300	360	1201	0	175481
1239	177646	1216	179	942	0	179983
1240	1442	664	161	180388	0	182655
1241	841	358	170	180143	0	181512
1242	507	633	178049	1796	0	180985
1243	602	301	1242	186645	0	188790
1244	557	604	195390	1894	0	198445
1245	594	593	201084	998	0	203269
1246	656	308	2416	206054	0	209434
1247	521	629	222184	2016	0	225350
1248	214829	351	2357	1471	0	219008
1249	252654	329	1118	879	0	254980
1250	253296	422	462	864	0	255044
1251	4892	268906	555	705	0	275058
1252	2465	3888	347	268502	0	275202
1253	1214	2184	401	250691	0	254490
1254	725	274501	542	4951	0	280719
1255	273066	3990	468	2471	0	279995
1256	4304	2044	348	271270	0	277966
1257	2314	995	279464	4199	0	286972
1258	1149	735	266422	2454	0	270760
1259	619	266565	5874	1392	0	274450
1260	269188	4020	2402	1233	0	276843
1261	4410	2412	268728	866	0	276416
1262	244390	720	4444	1186	0	250740
1263	4161	242333	2729	1143	0	250366
1264	2416	3923	252483	817	0	259639
1265	1152	2275	246184	767	0	250378
1266	952	949	256729	681	0	259311
1267	770	246927	6392	925	0	255014
1268	1115	4375	250409	674	0	256573
1269	241038	2147	4628	936	0	248749
1270	4644	902	2369	236684	0	244599
1271	2693	650	906	252969	0	257218
1272	1382	606	628	255602	0	258218
1273	1158	614	615	257253	0	259640
1274	922	924	252824	6658	0	261328
1275	1291	604	4359	250098	0	256352
1276	1218	575	2394	253496	0	257683
1277	250862	559	1172	6584	0	259177
1278	256259	585	999	3409	0	261252
1279	244321	592	999	1758	0	247670
1280	6450	903	249789	1090	0	258232
1281	2926	257215	4752	1154	0	266047
1282	1304	267641	2898	1160	0	273003
1283	245076	6674	1420	1357	0	254527
1284	4451	260189	1417	1101	0	267158
1285	3038	5311	1169	255966	0	265484
1286	1709	2790	1140	262383	0	268022
1287	1208	1547	257749	7013	0	267517
1288	994	253347	5581	3630	0	263552
1289	1110	5198	253685	1527	0	261520
1290	245118	2728	5686	1614	0	255146
1291	256962	1128	3325	1618	0	263033
1292	7307	727	1710	254407	0	264151
1293	3644	776	1449	252790	0	258659
1294	1872	763	1380	253602	0	257617
1295	1901	751	1269	257434	0	261355
1296	1424	969	251770	8130	0	262293
1297	1821	1315	5279	246256	0	254671
1298	1276	919	250534	6166	0	258895
1299	1277	919	243415	3742	0	249353
1300	1120	242897	7701	2214	0	253932
1301	243963	5024	3769	2022	0	254778
1302	5299	251652	2064	1717	0	260732
1303	3528	5984	1529	238678	0	249719
1304	1618	3323	253860	5807	0	264608
1305	241616	1313	6317	3676	0	252922
1306	6281	1287	252338	1815	0	261721
1307	250636	1020	6670	1833	0	260159
1308	255346	990	3891	1805	0	262032
1309	9147	960	1945	260057	0	272109
1310	4626	1030	1799	259133	0	266588
1311	2605	1077	1664	261927	0	267273
1312	1936	1472	252743	9653	0	265804
1313	243747	1163	6755	4918	0	256583
1314	6966	248296	4253	2669	0	262184
1315	4828	6207	2022	243248	0	256305
1316	252254	3554	1757	7382	0	264947
1317	257013	1787	1695	4759	0	265254
1318	258917	1624	1769	2855	0	265165
1319	10655	1876	248532	2477	0	263540
1320	253744	1945	6888	2727	0	265304
1321	258664	1920	4352	3177	0	268113
1322	10114	1809	228532	3161	0	243616
1323	5206	2065	264573	2483	0	274327
1324	3339	1785	10370	259731	0	275225
1325	2734	1544	269147	7968	0	281393
1326	2224	256290	9719	5040	0	273273
1327	2348	270011	6769	2267	0	281395
1328	259927	9786	3589	2239	0	275541
1329	7967	269806	3252	2158	0	283183
1330	5653	7800	2918	267834	0	284205
1331	257240	4247	3088	8387	0	272962
1332	7601	268991	3028	5455	0	285075
1333	4750	7771	2850	268113	0	283484
1334	2694	4200	3287	273517	0	283698
1335	2455	2291	266100	11533	0	282379
1336	2909	1749	8193	265606	0	278457
1337	2632	1945	266548	9754	0	280879
1338	2848	1525	265065	6203	0	275641
1339	3440	1191	9829	254948	0	269408
1340	2947	1083	4788	261467	0	270285
1341	255256	1001	2476	12249	0	270982
1342	7999	279093	2721	7012	0	296825
1343	5589	7490	1998	266802	0	281879
1344	3593	5785	2118	269054	0	280550
1345	252242	1708	1569	12282	0	267801
1346	8642	245851	1984	6386	0	262863
1347	5209	234474	1970	2923	0	244576
1348	2725	224229	1835	2085	0	230874
1349	1464	204464	1538	1499	0	208965
1350	180419	7547	4046	1453	0	193465
1351	180080	3136	1312	1374	0	185902
1352	178607	1338	669	1312	0	181926
1353	178950	1022	696	1237	0	181905
1354	7867	1027	761	172179	0	181834
1355	3327	1083	169792	5458	0	179660
1356	1639	168745	5247	3067	0	178698
1357	1667	4966	2673	165585	0	174891
1358	1396	2608	166732	5358	0	176094
1359	1634	1213	5134	165525	0	173506
1360	1407	835	2653	168169	0	173064
1361	1110	982	165605	7388	0	175085
1362	1307	888	5206	165255	0	172656
1363	1472	947	2702	163754	0	168875
1364	166280	902	1338	7658	0	176178
1365	166703	984	1066	3829	0	172582
1366	167008	975	884	2372	0	171239
1367	166867	1068	952	1972	0	170859
1368	8126	1144	979	159595	0	169844
1369	4168	1073	853	163923	0	170017
1370	2581	1195	860	165667	0	170303
1371	159653	1255	868	8170	0	169946
1372	6385	1176	920	161784	0	170265
1373	4075	1041	901	163831	0	169848
1374	2559	1279	156360	7840	0	168038
1375	2461	1470	5156	150639	0	159726
1376	2068	149430	2944	6181	0	160623
1377	1952	159635	1509	3805	0	166901
1378	152555	6795	971	2314	0	162635
1379	6119	3077	150844	2274	0	162314
1380	3266	146507	5159	2064	0	156996
1381	145253	4866	3051	1928	0	155098
1382	5711	2584	1266	145998	0	155559
1383	3104	1507	145316	5977	0	155904
1384	2100	1481	4919	138945	0	147445
1385	1486	148666	2875	5990	0	159017
1386	146139	4852	1595	3705	0	156291
1387	5339	151655	1418	2410	0	160822
1388	151643	5215	971	2231	0	160060
1389	154275	2680	956	2096	0	160007
1390	7800	1368	893	150509	0	160570
1391	3944	1089	792	145951	0	151776
1392	2095	148522	1148	7560	0	159325
1393	150447	4962	830	4240	0	160479
1394	5896	2865	148206	2510	0	159477
1395	143913	1439	4560	2132	0	152044
1396	144128	1113	2261	2185	0	149687
1397	6940	1004	137921	2265	0	148130
1398	3428	1415	4264	131828	0	140935
1399	133286	1007	2360	5444	0	142097
1400	5088	1129	132319	3332	0	141868
1401	2955	1041	129618	2090	0	135704
1402	120482	984	5592	1866	0	128924
1403	4559	119829	2887	1691	0	128966
1404	2719	117140	1315	1479	0	122653
1405	2418	5499	991	112979	0	121887
1406	1590	2573	113829	4076	0	122068
1407	106845	1346	3823	2783	0	114797
1408	4206	1075	111400	1685	0	118366
1409	2431	103636	3552	1365	0	110984
1410	103623	3541	2048	1409	0	110621
1411	4208	2069	893	103466	0	110636
1412	104645	1110	876	4018	0	110649
1413	4339	965	102197	2553	0	110054
1414	2837	1024	3289	97728	0	104878
1415	1693	103215	1995	3442	0	110345
1416	1634	3791	980	101691	0	108096
1417	1766	2206	816	105007	0	109795
1418	1938	1215	103212	4748	0	111113
1419	1816	98898	3515	2760	0	106989
1420	1703	99708	2209	1661	0	105281
1421	1700	3852	95700	1403	0	102655
1422	88536	1778	3258	1327	0	94899
1423	92613	851	1963	1277	0	96704
1424	4797	963	1211	88938	0	95909
1425	85360	612	1037	3023	0	90032
1426	3327	80567	1149	2036	0	87079
1427	1961	85507	981	1344	0	89793
1428	84861	3447	1004	1271	0	90583
1429	3668	1937	1037	83754	0	90396
1430	85518	745	925	3191	0	90379
1431	87282	639	789	2102	0	90812
1432	4321	830	703	82962	0	88816
1433	2475	891	82605	2959	0	88930
1434	81802	762	2753	1859	0	87176
1435	84571	629	1589	1174	0	87963
1436	4466	707	1033	79511	0	85717
1437	2289	80717	964	3015	0	86985
1438	1519	3080	734	81244	0	86577
1439	1259	1613	79900	3310	0	86082
1440	1282	923	79238	2060	0	83503
1441	1116	77678	3646	1567	0	84007
1442	1848	1453	1174	50561	0	55036
1443	445	704	537	51930	0	53616
1444	453	367	51680	1548	0	54048
1445	49238	283	1172	851	0	51544
1446	52774	272	709	449	0	54204
1447	53175	286	377	399	0	54237
1448	53316	274	313	405	0	54308
1449	1849	50871	318	371	0	53409
1450	963	53101	350	400	0	54814
1451	53921	1587	288	474	0	56270
1452	1520	785	341	55171	0	57817
1453	1024	388	248	55850	0	57510
1454	633	56179	278	1824	0	58914
1455	533	1330	288	56925	0	59076
1456	580	783	253	55296	0	56912
1457	547	55480	333	1882	0	58242
1458	558	1434	55567	981	0	58540
1459	567	784	1326	55570	0	58247
1460	55791	391	770	1534	0	58486
1461	55670	335	350	958	0	57313
1462	2046	321	54217	552	0	57136
1463	1104	307	53339	447	0	55197
1464	682	298	53587	399	0	54966
1465	631	370	1824	51638	0	54463
1466	572	288	52851	1413	0	55124
1467	549	364	52822	860	0	54595
1468	586	712	1786	49235	0	52319
1469	537	52981	893	1297	0	55708
1470	695	1271	52986	889	0	55841
1471	378	54347	1353	517	0	56595
1472	52939	1362	830	557	0	55688
1473	1313	53778	464	477	0	56032
1474	933	1267	343	52396	0	54939
1475	52749	722	325	1464	0	55260
1476	1416	443	345	52811	0	55015
1477	984	296	336	53797	0	55413
1478	534	335	53463	1819	0	56151
1479	503	51079	1316	965	0	53863
1480	493	53021	798	505	0	54817
1481	551	1643	436	48687	0	51317
1482	405	596	336	48859	0	50196
1483	420	266	302	48417	0	49405
1484	313	286	46475	1545	0	48619
1485	280	264	42977	658	0	44179
1486	38931	180	1217	461	0	40789
1487	841	233	42569	347	0	43990
1488	477	230	42318	276	0	43301
1489	220	41390	1190	310	0	43110
1490	436	1055	608	40798	0	42897
1491	302	467	41428	937	0	43134
1492	249	171	919	39795	0	41134
1493	191	185	41758	1030	0	43164
1494	233	134	1006	41541	0	42914
1495	231	213	43897	1065	0	45406
1496	233	148	974	43219	0	44574
1497	245	184	547	42692	0	43668
1498	171	44797	340	1259	0	46567
1499	191	913	259	44242	0	45605
1500	156	45782	322	1029	0	47289
1501	196	971	285	46518	0	47970
1502	186	496	275	47045	0	48002
1503	45513	263	279	1428	0	47483
1504	955	216	253	45814	0	47238
1505	498	244	45026	1187	0	46955
1506	281	170	1005	44987	0	46443
1507	222	202	587	45937	0	46948
1508	186	256	44728	1501	0	46671
1509	190	258	44134	766	0	45348
1510	242	213	1310	42904	0	44669
1511	224	234	613	45161	0	46232
1512	198	265	44630	1519	0	46612
1513	140	42749	1113	858	0	44860
1514	156	45105	666	533	0	46460
1515	43921	1207	386	565	0	46079
1516	986	585	345	44414	0	46330
1517	45197	235	376	1250	0	47058
1518	43659	209	369	808	0	45045
1519	1129	44534	480	532	0	46675
1520	45086	947	367	520	0	46920
1521	45374	473	396	536	0	46779
1522	1225	307	44908	473	0	46913
1523	535	270	1147	44506	0	46458
1524	245	254	46497	1211	0	48207
1525	247	224	1149	46597	0	48217
1526	207	214	46774	1279	0	48474
1527	176	43849	1096	719	0	45840
1528	158	45181	703	449	0	46491
1529	361	1088	352	43750	0	45551
1530	43305	459	274	1113	0	45151
1531	834	195	316	43382	0	44727
1532	454	197	270	43878	0	44799
1533	209	242	43214	1301	0	44966
1534	182	233	43013	738	0	44166
1535	201	231	43696	510	0	44638
1536	219	232	1260	42188	0	43899
1537	237	211	640	40537	0	41625
1538	155	42558	409	1273	0	44395
1539	179	44434	387	746	0	45746
1540	42577	1104	386	604	0	44671
1541	780	43596	390	503	0	45269
1542	452	913	42697	477	0	44539
1543	269	481	985	42052	0	43787
1544	201	273	44271	1174	0	45919
1545	168	44119	1065	810	0	46162
1546	245	1079	627	44576	0	46527
1547	42591	446	413	1169	0	44619
1548	796	278	44303	736	0	46113
1549	416	44386	998	568	0	46368
1550	308	835	44242	460	0	45845
1551	137	43678	904	483	0	45202
1552	427	963	667	40671	0	42728
1553	41148	378	280	880	0	42686
1554	40582	202	241	636	0	41661
1555	826	40453	293	423	0	41995
1556	41130	625	266	446	0	42467
1557	695	364	265	41021	0	42345
1558	41014	233	291	920	0	42458
1559	768	210	41466	622	0	43066
1560	427	256	41687	429	0	42799
1561	290	227	1016	39210	0	40743
1562	235	225	522	43238	0	44220
1563	212	248	42748	1186	0	44394
1564	251	203	849	42796	0	44099
1565	43130	189	487	1071	0	44877
1566	43073	210	314	682	0	44279
1567	1031	41632	329	423	0	43415
1568	492	42190	315	363	0	43360
1569	40879	942	260	379	0	42460
1570	876	436	248	40312	0	41872
1571	40054	266	250	902	0	41472
1572	778	39774	311	519	0	41382
1573	39991	745	254	387	0	41377
1574	842	404	39249	324	0	40819
1575	452	272	39334	311	0	40369
1576	294	341	1002	38670	0	40307
1577	229	264	40142	813	0	41448
1578	291	229	724	38352	0	39596
1579	252	216	403	38348	0	39219
1580	244	255	41052	951	0	42502
1581	282	235	744	40958	0	42219
1582	312	153	441	44138	0	45044
1583	218	210	45167	1118	0	46713
1584	193	199	44895	564	0	45851
1585	43206	155	1156	396	0	44913
1586	873	181	46739	288	0	48081
1587	46906	187	1031	289	0	48413
1588	51009	146	541	269	0	51965
1589	1328	186	51301	225	0	53040
1590	675	165	53055	203	0	54098
1591	329	261	1421	50597	0	52608
1592	286	150	637	49399	0	50472
1593	184	51698	381	1237	0	53500
1594	148	53997	308	634	0	55087
1595	169	1254	52174	327	0	53924
1596	48760	547	1074	329	0	50710
1597	51853	197	605	288	0	52943
1598	1374	176	50640	238	0	52428
1599	665	177	50710	174	0	51726
1600	359	113	1326	48683	0	50481
1601	211	51500	692	902	0	53305
1602	270	926	282	52732	0	54210
1603	250	482	242	53666	0	54640
1604	53410	183	206	1388	0	55187
1605	53496	124	254	688	0	54562
1606	1449	143	226	55081	0	56899
1607	708	168	55429	1079	0	57384
1608	51577	101	1082	683	0	53443
1609	1037	56745	664	306	0	58752
1610	57742	923	313	281	0	59259
1611	55920	473	284	298	0	56975
1612	1263	56864	304	282	0	58713
1613	625	58536	261	294	0	59716
1614	370	1319	253	57668	0	59610
1615	295	590	275	58291	0	59451
1616	238	58506	301	1387	0	60432
1617	301	987	254	58772	0	60314
1618	286	550	304	59694	0	60834
1619	271	281	58709	1501	0	60762
1620	56211	157	1121	783	0	58272
1621	59619	122	693	430	0	60864
1622	60434	125	326	340	0	61225
1623	1682	120	287	58718	0	60807
1624	58045	106	269	1138	0	59558
1625	1196	56815	328	677	0	59016
1626	782	1065	265	52584	0	54696
1627	368	55334	287	944	0	56933
1628	289	58241	282	551	0	59363
1629	58674	1277	265	429	0	60645
1630	59184	567	282	323	0	60356
1631	58838	229	227	308	0	59602
1632	58827	198	254	308	0	59587
1633	58666	177	245	308	0	59396
1634	1598	224	58618	275	0	60715
1635	57532	206	1030	316	0	59084
1636	1263	232	60868	263	0	62626
1637	58196	166	1100	370	0	59832
1638	59872	131	666	367	0	61036
1639	59518	128	375	377	0	60398
1640	1588	195	62175	319	0	64277
1641	890	269	1112	58770	0	61041
1642	468	64799	672	852	0	66791
1643	65892	930	326	583	0	67731
1644	65260	529	296	340	0	66425
1645	1557	65997	342	284	0	68180
1646	67417	964	284	353	0	69018
1647	1287	544	287	65414	0	67532
1648	685	66878	324	1106	0	68993
1649	66888	1004	205	758	0	68855
1650	67034	583	226	421	0	68264
1651	1632	329	249	66492	0	68702
1652	67637	214	352	1172	0	69375
1653	1447	180	361	67781	0	69769
1654	939	185	316	68607	0	70047
1655	630	273	67821	1480	0	70204
1656	580	253	1063	66655	0	68551
1657	519	265	602	68467	0	69853
1658	523	342	68244	1447	0	70556
1659	465	294	67919	695	0	69373
1660	561	184	1303	67971	0	70019
1661	436	271	69472	1074	0	71253
1662	62840	199	1082	734	0	64855
1663	1108	70154	645	419	0	72326
1664	749	965	263	71505	0	73482
1665	491	551	186	73142	0	74370
1666	508	235	141	73237	0	74121
1667	72733	208	140	1473	0	74554
1668	72431	184	146	741	0	73502
1669	73760	200	165	485	0	74610
1670	1540	73368	214	366	0	75488
1671	948	937	114	74118	0	76117
1672	609	542	84	75234	0	76469
1673	74522	302	85	1412	0	76321
1674	74600	262	107	766	0	75735
1675	1548	273	105	74276	0	76202
1676	758	360	74111	1063	0	76292
1677	71653	236	903	759	0	73551
1678	75131	183	471	481	0	76266
1679	1563	295	74975	350	0	77183
1680	68237	173	849	437	0	69696
1681	1177	211	73858	335	0	75581
1682	70866	83	843	383	0	72175
1683	1073	561	505	73522	0	75661
1684	712	77034	300	805	0	78851
1685	561	771	78958	548	0	80838
1686	367	79087	810	304	0	80568
1687	252	75387	500	221	0	76360
1688	77763	775	395	439	0	79372
1689	615	320	73	77186	0	78194
1690	331	76	66	76052	0	76525
1691	79087	45	57	906	0	80095
1692	559	58	57	80267	0	80941
1693	345	60	62	80480	0	80947
1694	190	56	58	80150	0	80454
1695	175	118	50	79759	0	80102
1696	143	152	79521	673	0	80489
1697	161	144	76865	337	0	77507
1698	118	78286	640	188	0	79232
1699	78994	421	248	274	0	79937
1700	583	220	80	80387	0	81270
1701	345	77746	145	530	0	78766
1702	255	591	69	84401	0	85316
1703	218	244	61	85628	0	86151
1704	187	96	76	85922	0	86281
1705	219	84	60	86763	0	87126
1706	208	73	52	85745	0	86078
1707	159	84099	123	712	0	85093
1708	200	448	68	85380	0	86096
1709	198	402	83064	541	0	84205
1710	140	83591	488	500	0	84719
1711	231	466	207	84603	0	85507
1712	178	315	91	84416	0	85000
1713	135	82463	137	724	0	83459
1714	127	84420	139	397	0	85083
1715	82502	531	80	300	0	83413
1716	422	82487	158	221	0	83288
1717	81021	402	93	289	0	81805
1718	80028	207	114	284	0	80633
1719	579	196	84542	165	0	85482
1720	367	83	433	79536	0	80419
1721	179	198	85980	523	0	86880
1722	129	88803	512	402	0	89846
1723	200	549	269	82920	0	83938
1724	181	305	97	89525	0	90108
1725	142	124	65	90733	0	91064
1726	140	90	57	91528	0	91815
1727	141	219	92359	890	0	93609
1728	164	74	494	91375	0	92107
1729	186	206	92533	677	0	93602
1730	169	227	91348	392	0	92136
1731	84964	77	729	462	0	86232
1732	93965	98	300	339	0	94702
1733	95450	90	159	322	0	96021
1734	748	92739	184	245	0	93916
1735	419	542	66	94051	0	95078
1736	219	443	95853	633	0	97148
1737	269	126	548	94616	0	95559
1738	169	242	100224	703	0	101338
1739	97191	101	579	621	0	98492
1740	99165	81	289	389	0	99924
1741	99038	82	163	360	0	99643
1742	849	208	95815	169	0	97041
1743	408	240	96396	169	0	97213
1744	252	157	737	98054	0	99200
1745	207	112	293	98578	0	99190
1746	155	81	114	101854	0	102204
1747	145	218	102033	746	0	103142
1748	159	219	94885	387	0	95650
1749	96943	68	662	385	0	98058
1750	539	64	289	103949	0	104841
1751	321	74	134	104615	0	105144
1752	106126	56	102	951	0	107235
1753	622	78	85	105906	0	106691
1754	112769	66	96	1081	0	114012
1755	116285	49	90	687	0	117111
1756	115633	78	96	442	0	116249
1757	852	269	118527	222	0	119870
1758	351	117286	593	361	0	118591
1759	122339	529	262	553	0	123683
1760	681	259	115	123214	0	124269
1761	409	104	122	122306	0	122941
1762	152	123750	222	821	0	124945
1763	123135	543	95	612	0	124385
1764	121904	287	95	446	0	122732
1765	123120	115	105	424	0	123764
1766	851	123903	191	184	0	125129
1767	130379	563	87	597	0	131626
1768	131110	277	107	461	0	131955
1769	131552	100	98	436	0	132186
1770	934	92	77	129187	0	130290
1771	460	85	94	130917	0	131556
1772	251	321	134275	963	0	135810
1773	285	94	597	131068	0	132044
1774	264	83	305	134276	0	134928
1775	208	311	134291	891	0	135701
1776	125614	87	574	636	0	126911
1777	134927	58	289	472	0	135746
1778	894	130	125	133617	0	134766
1779	395	132312	244	592	0	133543
1780	211	133679	207	433	0	134530
1781	309	961	103	132497	0	133870
1782	246	499	129811	638	0	131194
1783	370	280	483	124919	0	126052
1784	221	262	126332	571	0	127386
1785	205	311	126706	342	0	127564
1786	228	88	522	130332	0	131170
1787	131609	57	210	734	0	132610
1788	128876	38	124	542	0	129580
1789	593	79	88	133176	0	133936
1790	422	56	81	134282	0	134841
1791	238	64	65	133378	0	133745
1792	193	51	77	132846	0	133167
1793	132650	72	82	972	0	133776
1794	131128	68	80	579	0	131855
1795	131630	82	89	496	0	132297
1796	654	241	132004	164	0	133063
1797	435	73	372	130975	0	131855
1798	263	74	209	134507	0	135053
1799	133709	51	106	796	0	134662
1800	472	132453	222	371	0	133518
1801	132144	399	62	498	0	133103
1802	130562	201	82	440	0	131285
1803	129632	84	80	399	0	130195
1804	129089	97	137	422	0	129745
1805	816	275	131860	147	0	133098
1806	499	345	123067	162	0	124073
1807	136157	66	608	500	0	137331
1808	140037	62	256	436	0	140791
1809	139292	80	139	466	0	139977
1810	142438	87	158	406	0	143089
1811	981	288	152261	227	0	153757
1812	477	157120	987	295	0	158879
1813	408	993	453	163575	0	165429
1814	174608	577	184	1763	0	177132
1815	178532	177	145	1066	0	179920
1816	186545	106	111	644	0	187406
1817	188705	84	116	453	0	189358
1818	189987	86	105	454	0	190632
1819	181662	109	364	532	0	182667
1820	2815	375	165786	417	0	169393
1821	1308	347	175305	154	0	177114
1822	683	172	1937	172643	0	175435
1823	470	360	178217	1574	0	180621
1824	396	174327	1737	1013	0	177473
1825	418	177726	1036	390	0	179570
1826	668	2356	344	181368	0	184736
1827	483	1230	187617	1519	0	190849
1828	435	618	179524	944	0	181521
1829	178471	198	2414	644	0	181727
1830	201095	164	1120	561	0	202940
1831	3281	162	422	202114	0	205979
1832	205184	168	305	2791	0	208448
1833	2868	179	304	204187	0	207538
1834	1597	170	263	205546	0	207576
1835	755	479	205936	3622	0	210792
1836	605	452	199165	1610	0	201832
1837	634	262	3524	199603	0	204023
1838	617	413	199836	2743	0	203609
1839	185775	127	2763	1762	0	190427
1840	201765	103	1430	885	0	204183
1841	3990	205517	722	676	0	210905
1842	207727	2490	405	803	0	211425
1843	3428	1559	203345	408	0	208740
1844	199384	317	2836	657	0	203194
1845	205026	174	1612	750	0	207562
1846	207233	196	677	717	0	208823
1847	4644	206	514	197809	0	203173
1848	2122	202823	733	2708	0	208386
1849	205170	2723	475	1765	0	210133
1850	206408	1416	523	984	0	209331
1851	4818	542	460	207644	0	213464
1852	207260	269	569	3663	0	211761
1853	3800	209495	731	2114	0	216140
1854	2528	3054	543	205852	0	211977
1855	1350	1763	202500	3626	0	209239
1856	176509	484	3615	2675	0	183283
1857	3912	602	201567	1046	0	207127
1858	2574	546	3707	200352	0	207179
1859	1321	198831	2200	3678	0	206030
1860	1196	218077	1219	2149	0	222641
1861	1567	5453	769	216027	0	223816
1862	1347	222598	987	4304	0	229236
1863	1672	5408	814	289687	0	297581
1864	1846	2490	800	304294	0	309430
1865	1848	1135	817	309989	0	313789
1866	294627	828	674	11090	0	307219
1867	8479	749	622	299734	0	309584
1868	4721	851	293195	8864	0	307631
1869	2502	293855	7426	4649	0	308432
1870	293951	7328	3215	2360	0	306854
1871	9213	3467	1131	294853	0	308664
1872	5221	1370	867	300121	0	307579
1873	2965	1036	852	305692	0	310545
1874	2516	1247	294049	11551	0	309363
1875	1885	295027	7962	5475	0	310349
1876	294913	7615	3815	3059	0	309402
1877	8707	3886	1685	276046	0	290324
1878	4238	298851	1784	8216	0	313089
1879	297672	8273	1443	4914	0	312302
1880	8678	4415	297116	2541	0	312750
1881	294512	2031	8306	2393	0	307242
1882	9545	1817	303281	2203	0	316846
1883	5093	1736	303194	2326	0	312349
1884	2580	299248	11396	3111	0	316335
1885	2601	8341	4700	289682	0	305324
1886	2468	4278	292354	9536	0	308636
1887	2002	283010	9286	5778	0	300076
1888	2387	8409	4772	273614	0	289182
1889	1725	283515	2803	9224	0	297267
1890	1910	9163	283687	5295	0	300055
1891	2365	4601	8794	282149	0	297909
1892	1992	2583	287550	10181	0	302306
1893	2382	1938	9263	285176	0	298759
1894	2371	1815	4751	292765	0	301702
1895	2252	2090	284025	13042	0	301409
1896	2502	1643	9226	286077	0	299448
1897	276382	1714	4980	11453	0	294529
1898	9156	280474	2830	7371	0	299831
1899	5411	8831	281044	4666	0	299952
1900	276422	4659	9263	4135	0	294479
1901	10463	2495	5130	265213	0	283301
1902	5780	280454	3376	9720	0	299330
1903	285343	9179	2619	6234	0	303375
1904	292351	5289	2697	4032	0	304369
1905	13149	3094	2453	277102	0	295798
1906	6647	2619	2163	284300	0	295729
1907	3652	2502	2276	285719	0	294149
1908	3149	2585	2424	279657	0	287815
1909	2529	271830	2924	14979	0	292262
1910	3611	12408	2600	251441	0	270060
1911	2389	255492	2793	10998	0	271672
1912	2429	254228	2807	7603	0	267067
1913	2173	254844	2847	5399	0	265263
1914	3148	11915	234037	4729	0	253829
1915	2395	241198	9314	4991	0	257898
1916	226578	9308	6095	5489	0	247470
1917	8442	230183	3508	6127	0	248260
1918	5239	9192	3094	210140	0	227665
1919	3366	231098	3464	11087	0	249015
1920	3631	9787	2951	230335	0	246704
1921	3830	5945	3218	237179	0	250172
1922	3257	4356	229072	13575	0	250260
1923	219988	4106	9001	8342	0	241437
1924	231644	3715	5080	6454	0	246893
1925	227954	3278	3462	6579	0	241273
1926	11390	221466	3831	7077	0	243764
1927	5900	8870	3602	218004	0	236376
1928	4197	5674	213394	11740	0	235005
1929	3538	211851	9431	7893	0	232713
1930	4491	9806	5255	169539	0	189091
1931	3362	199182	3801	8360	0	214705
1932	198393	8943	3332	5799	0	216467
1933	203119	5657	3484	4199	0	216459
1934	205611	3870	3960	3620	0	217061
1935	204646	3388	4198	3585	0	215817
1936	11090	3331	4124	196229	0	214774
1937	5646	3709	3888	193633	0	206876
1938	3420	197749	4150	10914	0	216233
1939	3742	8758	3224	201016	0	216740
1940	2770	5675	194993	10713	0	214151
1941	2676	3984	8150	193519	0	208329
1942	2003	4081	190536	11051	0	207671
1943	1895	186719	8917	7877	0	205408
1944	2081	8640	189802	5651	0	206174
1945	2468	5239	9157	189093	0	205957
1946	2231	3684	191946	10551	0	208412
1947	2544	3306	8861	190195	0	204906
1948	2766	3357	5453	192525	0	204101
1949	3196	3217	3706	192945	0	203064
1950	3628	3241	3342	191041	0	201252
1951	182432	3388	2729	11547	0	200096
1952	8093	183467	2906	7060	0	201526
1953	181068	8185	2292	5288	0	196833
1954	8325	5299	175458	4881	0	193963
1955	174479	3542	6406	5092	0	189519
1956	179684	3105	3465	5179	0	191433
1957	11338	3291	171467	4699	0	190795
1958	7276	2726	164843	4511	0	179356
1959	4369	161143	7679	5238	0	178429
1960	3072	153324	3495	4902	0	164793
1961	4406	7447	141437	5173	0	158463
1962	2588	127994	5175	5176	0	140933
1963	3772	4479	2795	69105	0	80151
1964	65975	985	1045	1928	0	69933
1965	1587	546	384	65357	0	67874
1966	65385	527	298	1778	0	67988
1967	64949	512	283	1177	0	66921
1968	1789	65364	406	744	0	68303
1969	64494	1271	293	804	0	66862
1970	64836	775	264	753	0	66628
1971	1814	555	241	63179	0	65789
1972	62713	431	233	1556	0	64933
1973	1381	63301	284	958	0	65924
1974	893	1252	191	62944	0	65280
1975	63323	656	218	1523	0	65720
1976	1265	466	62224	913	0	64868
1977	61153	304	977	500	0	62934
1978	1327	557	579	62102	0	64565
1979	742	382	62371	1001	0	64496
1980	485	353	61340	596	0	62774
1981	59339	566	1506	492	0	61903
1982	59561	178	658	403	0	60800
1983	1131	145	262	58767	0	60305
1984	565	162	189	59120	0	60036
1985	363	167	128	57901	0	58559
1986	264	59054	203	1162	0	60683
1987	58858	803	155	758	0	60574
1988	870	59057	216	420	0	60563
1989	58938	827	188	399	0	60352
1990	986	499	58149	289	0	59923
1991	628	199	773	58493	0	60093
1992	59923	172	423	1021	0	61539
1993	997	142	227	60287	0	61653
1994	630	158	223	59023	0	60034
1995	366	58781	218	1171	0	60536
1996	59292	800	200	681	0	60973
1997	898	62869	261	403	0	64431
1998	593	961	229	63373	0	65156
1999	363	603	62000	985	0	63951
2000	55731	197	938	733	0	57599
2001	1085	249	61292	389	0	63015
2002	56932	114	968	436	0	58450
2003	1087	60850	555	354	0	62846
2004	703	946	227	56771	0	58647
2005	349	60004	227	974	0	61554
2006	60126	1012	175	673	0	61986
2007	1174	543	151	60463	0	62331
2008	704	232	178	61900	0	63014
2009	453	232	59578	1443	0	61706
2010	54248	191	961	834	0	56234
2011	1213	177	524	60562	0	62476
2012	693	234	59318	1123	0	61368
2013	390	58727	1061	699	0	60877
2014	412	950	531	59196	0	61089
2015	59598	551	267	1175	0	61591
2016	1149	267	189	60228	0	61833
2017	706	266	60632	1132	0	62736
2018	63537	175	1020	758	0	65490
2019	1453	155	527	64852	0	66987
2020	811	255	69388	1375	0	71829
2021	486	176	1374	70681	0	72717
2022	446	249	667	67807	0	69169
2023	360	70729	382	1878	0	73349
2024	69878	1408	207	938	0	72431
2025	1510	71190	269	472	0	73441
2026	71204	1528	193	470	0	73395
2027	1704	729	214	67587	0	70234
2028	871	70838	282	1443	0	73434
2029	577	1446	174	70985	0	73182
2030	405	807	69613	1691	0	72516
2031	66767	328	1389	917	0	69401
2032	1614	241	646	67810	0	70311
2033	955	216	310	67756	0	69237
2034	544	242	239	68625	0	69650
2035	419	283	65915	2236	0	68853
2036	442	256	66137	1094	0	67929
2037	400	66280	1986	634	0	69300
2038	460	1377	733	62683	0	65253
2039	62941	633	360	1608	0	65542
2040	1461	64305	302	962	0	67030
2041	871	1563	245	66109	0	68788
2042	67399	735	206	1740	0	70080
2043	67144	345	212	1016	0	68717
2044	2117	67199	300	567	0	70183
2045	72918	1509	210	561	0	75198
2046	79828	779	233	586	0	81426
2047	2658	388	254	80501	0	83801
2048	1232	80465	336	2150	0	84183
2049	721	1974	253	83325	0	86273
2050	82162	1062	249	2485	0	85958
2051	2277	591	82543	1338	0	86749
2052	1365	348	1963	82221	0	85897
2053	771	319	981	84249	0	86320
2054	504	434	82530	3229	0	86697
2055	565	375	2080	83271	0	86291
2056	82699	313	1081	2699	0	86792
2057	77353	307	526	1625	0	79811
2058	2900	298	371	81772	0	85341
2059	1358	308	80278	2641	0	84585
2060	670	326	77870	1581	0	80447
2061	564	78349	2780	1129	0	82822
2062	540	81372	1344	753	0	84009
2063	867	2634	543	76926	0	80970
2064	76660	1132	344	2287	0	80423
2065	1939	77563	466	1378	0	81346
2066	77410	1979	390	789	0	80568
2067	2267	1135	362	76962	0	80726
2068	1342	593	318	77557	0	79810
2069	74641	381	322	3024	0	78368
2070	2165	75169	390	1602	0	79326
2071	76193	1972	299	950	0	79414
2072	2410	1165	73691	733	0	77999
2073	1321	559	72624	674	0	75178
2074	790	582	2521	70488	0	74381
2075	616	455	72292	2161	0	75524
2076	590	433	71827	1335	0	74185
2077	760	442	2562	67666	0	71430
2078	575	400	70613	2176	0	73764
2079	638	302	2134	68666	0	71740
2080	610	281	1162	69550	0	71603
2081	589	354	70651	2881	0	74475
2082	580	339	2019	69957	0	72895
2083	603	388	1182	68124	0	70297
2084	564	69207	708	2883	0	73362
2085	69306	1853	527	1642	0	73328
2086	2029	1236	69463	980	0	73708
2087	1294	499	2006	68899	0	72698
2088	788	409	1183	71029	0	73409
2089	550	483	68803	3030	0	72866
2090	63585	406	2000	1843	0	67834
2091	1995	68533	1279	1118	0	72925
2092	1305	1921	652	68168	0	72046
2093	758	1057	559	68119	0	70493
2094	629	68293	629	2993	0	72544
2095	715	1920	67584	1721	0	71940
2096	568	69025	2239	1076	0	72908
2097	64681	2083	1223	1005	0	68992
2098	1862	1105	64148	789	0	67904
2099	1214	575	1882	63424	0	67095
2100	684	536	65265	2172	0	68657
2101	559	483	64936	1450	0	67428
2102	545	64327	2560	945	0	68377
2103	840	1742	1318	60836	0	64736
2104	62437	928	703	2049	0	66117
2105	62537	498	565	1365	0	64965
2106	2334	62218	715	889	0	66156
2107	1176	1634	607	62765	0	66182
2108	62750	944	551	2100	0	66345
2109	63629	517	538	1363	0	66047
2110	2281	63108	630	963	0	66982
2111	64432	1611	523	813	0	67379
2112	1984	912	523	61986	0	65405
2113	1118	65275	618	1987	0	68998
2114	796	1672	534	66960	0	69962
2115	690	1016	489	67524	0	69719
2116	753	791	469	68019	0	70032
2117	612	521	64924	2558	0	68615
2118	496	496	58732	1259	0	60983
2119	421	59989	1945	816	0	63171
2120	54400	1132	1081	606	0	57219
2121	1133	53839	511	648	0	56131
2122	816	1152	410	53530	0	55908
2123	416	743	56107	1346	0	58612
2124	413	412	1262	54427	0	56514
2125	377	338	839	56422	0	57976
2126	383	362	453	57836	0	59034
2127	56529	333	360	1833	0	59055
2128	1124	317	360	57235	0	59036
2129	722	337	61054	1438	0	63551
2130	57547	264	1230	1095	0	60136
2131	60371	250	787	754	0	62162
2132	62352	250	417	657	0	63676
2133	62596	209	347	588	0	63740
2134	62400	234	349	626	0	63609
2135	1656	61576	429	588	0	64249
2136	946	983	337	57986	0	60252
2137	498	61292	355	1149	0	63294
2138	60724	1014	288	826	0	62852
2139	60289	577	341	554	0	61761
2140	58061	343	263	499	0	59166
2141	1350	56694	349	440	0	58833
2142	685	55783	327	367	0	57162
2143	436	56456	269	316	0	57477
2144	532	1313	54070	332	0	56247
2145	1000	3097	822	44070	0	48989
2146	145	41490	266	405	0	42306
2147	49	40560	72	110	0	40791
2148	55	196	94	40298	0	40643
2149	66	122	34	40093	0	40315
2150	64	94	40156	259	0	40573
2151	37553	48	186	216	0	38003
2152	200	28	88	41666	0	41982
2153	132	28	50	41688	0	41898
2154	89	85	40941	281	0	41396
2155	79	82	39008	172	0	39341
2156	69	43112	298	83	0	43562
2157	106	200	137	43838	0	44281
2158	110	120	48	44409	0	44687
2159	85	113	43432	298	0	43928
2160	38584	59	201	235	0	39079
2161	43009	35	117	157	0	43318
2162	332	125	43759	57	0	44273
2163	42445	56	193	169	0	42863
2164	296	108	44757	82	0	45243
2165	43869	48	236	134	0	44287
2166	45347	72	131	141	0	45691
2167	378	113	47023	90	0	47604
2168	215	45	231	46359	0	46850
2169	131	54	134	47121	0	47440
2170	94	54	69	49550	0	49767
2171	49094	45	60	475	0	49674
2172	48502	53	72	340	0	48967
2173	438	103	49731	112	0	50384
2174	247	131	46509	107	0	46994
2175	49227	43	419	255	0	49944
2176	51454	41	210	170	0	51875
2177	491	90	50726	117	0	51424
2178	275	100	50116	97	0	50588
2179	149	74	463	51064	0	51750
2180	141	104	53045	384	0	53674
2181	116	42	378	50518	0	51054
2182	54024	38	232	518	0	54812
2183	583	76	57262	242	0	58163
2184	53333	43	633	222	0	54231
2185	776	113	63408	149	0	64446
2186	407	47	864	62412	0	63730
2187	234	38	354	65637	0	66263
2188	205	57	118	65715	0	66095
2189	123	66750	153	1234	0	68260
2190	242	866	77	63436	0	64621
2191	235	375	88	67597	0	68295
2192	66480	97	85	1269	0	67931
2193	957	113	65953	472	0	67495
2194	61512	46	872	343	0	62773
2195	1080	109	65425	122	0	66736
2196	57951	50	956	270	0	59227
2197	944	64245	482	213	0	65884
2198	496	812	64420	123	0	65851
2199	259	374	64084	115	0	64832
2200	270	146	1219	56723	0	58358
2201	178	37	481	64266	0	64962
2202	164	91	64971	1142	0	66368
2203	197	90	65017	433	0	65737
2204	185	117	70857	182	0	71341
2205	71912	64	1241	321	0	73538
2206	74846	40	544	271	0	75701
2207	74780	38	276	248	0	75342
2208	1298	39	204	73175	0	74716
2209	574	34	187	73998	0	74793
2210	265	169	77343	1326	0	79103
2211	264	87	916	75382	0	76649
2212	243	88	453	75376	0	76160
2213	75637	75	206	1455	0	77373
2214	75412	73	173	778	0	76436
2215	77377	56	177	479	0	78089
2216	1430	76	198	76770	0	78474
2217	652	76	203	77163	0	78094
2218	361	78	223	77443	0	78105
2219	76326	61	223	1433	0	78043
2220	1072	95	271	74049	0	75487
2221	595	76345	319	949	0	78208
2222	386	852	302	73955	0	75495
2223	237	74262	375	882	0	75756
2224	74371	917	281	613	0	76182
2225	71969	385	327	479	0	73160
2226	1128	73533	406	338	0	75405
2227	561	74912	399	336	0	76208
2228	377	1294	336	73949	0	75956
2229	318	564	70558	1058	0	72498
2230	390	166	1035	68412	0	70003
2231	347	193	70932	1264	0	72736
2232	314	70924	1165	865	0	73268
2233	402	860	606	71740	0	73608
2234	423	422	377	72833	0	74055
2235	403	253	75835	1518	0	78009
2236	440	97	1068	75069	0	76674
2237	397	209	77361	1291	0	79258
2238	74801	104	1186	844	0	76935
2239	78279	87	634	628	0	79628
2240	79137	98	385	610	0	80230
2241	1602	105	292	77964	0	79963
2242	842	117	270	78904	0	80133
2243	502	237	79382	1645	0	81766
2244	488	264	1095	76020	0	77867
2245	383	77795	709	1419	0	80306
2246	438	971	78488	819	0	80716
2247	471	541	76862	520	0	78394
2248	532	491	1405	70940	0	73368
2249	486	355	78470	1255	0	80566
2250	384	364	78168	848	0	79764
2251	70272	231	1352	830	0	72685
2252	1059	83421	752	632	0	85864
2253	86663	949	417	871	0	88900
2254	86961	475	344	755	0	88535
2255	88266	259	424	761	0	89710
2256	1581	201	392	86808	0	88982
2257	863	187	349	88256	0	89655
2258	519	374	87749	1532	0	90174
2259	548	179	1120	85569	0	87416
2260	402	88112	791	1297	0	90602
2261	88598	887	494	896	0	90875
2262	1098	88608	576	533	0	90815
2263	636	89440	513	555	0	91144
2264	543	1294	392	88890	0	91119
2265	483	646	89774	1239	0	92142
2266	479	235	1102	88371	0	90187
2267	418	392	88650	1291	0	90751
2268	390	87675	1194	810	0	90069
2269	87955	830	618	698	0	90101
2270	88614	362	444	631	0	90051
2271	89575	205	323	786	0	90889
2272	1396	345	92651	570	0	94962
2273	717	390	87784	539	0	89430
2274	91322	158	1223	731	0	93434
2275	94686	128	585	743	0	96142
2276	96098	150	314	680	0	97242
2277	1514	167	196	94725	0	96602
2278	857	145	178	96503	0	97683
2279	95843	134	179	1507	0	97663
2280	94763	161	184	976	0	96084
2281	1268	336	95881	562	0	98047
2282	556	267	90154	374	0	91351
2283	87185	101	609	532	0	88427
2284	624	312	91759	288	0	92983
2285	83737	78	352	357	0	84524
2286	352	283	86293	149	0	87077
2287	210	136	221	83221	0	83788
2288	147	234	87954	176	0	88511
2289	198	43	163	87370	0	87774
2290	124	63	104	88559	0	88850
2291	54	90685	139	251	0	91129
2292	90867	137	52	444	0	91500
2293	224	319	92917	102	0	93562
2294	86876	76	196	343	0	87491
2295	217	94498	229	104	0	95048
2296	98144	169	79	361	0	98753
2297	307	113	53	97976	0	98449
2298	233	49	50	99039	0	99371
2299	84	102466	157	457	0	103164
2300	135	283	46	105732	0	106196
2301	123	180	48	106504	0	106855
2302	128	70	47	106936	0	107181
2303	102442	57	70	945	0	103514
2304	97104	33	84	577	0	97798
2305	711	282	96497	187	0	97677
2306	344	97087	488	202	0	98121
2307	222	404	274	99510	0	100410
2308	175	281	81	103426	0	103963
2309	142	306	103910	863	0	105221
2310	167	101	621	99221	0	100110
2311	100561	28	352	990	0	101931
2312	100814	42	155	704	0	101715
2313	101717	54	62	414	0	102247
2314	1138	71	69	101879	0	103157
2315	106713	57	65	1196	0	108031
2316	106930	36	71	762	0	107799
2317	109002	78	79	524	0	109683
2318	1212	50	72	108825	0	110159
2319	612	55	69	110335	0	111071
2320	333	50	53	111070	0	111506
2321	244	93	54	109702	0	110093
2322	263	58	57	109695	0	110073
2323	218	289	107447	1224	0	109178
2324	216	209	106127	666	0	107218
2325	165	104190	1097	369	0	105821
2326	238	702	523	108205	0	109668
2327	219	377	153	109903	0	110652
2328	201	138	82	110806	0	111227
2329	180	278	108674	1307	0	110439
2330	252	82	747	107313	0	108394
2331	195	256	108316	983	0	109750
2332	237	80	805	107162	0	108284
2333	346	287	112269	1006	0	113908
2334	150	112218	865	966	0	114199
2335	273	768	439	110796	0	112276
2336	222	612	109080	974	0	110888
2337	93506	169	828	983	0	95486
2338	803	110548	589	417	0	112357
2339	580	756	171	111735	0	113242
2340	223	112497	254	967	0	113941
2341	252	925	123	112610	0	113910
2342	113944	473	129	1273	0	115819
2343	998	188	126	112200	0	113512
2344	567	113824	228	1067	0	115686
2345	114241	862	120	931	0	116154
2346	1053	564	136	119304	0	121057
2347	668	297	117	122356	0	123438
2348	123800	116	138	2226	0	126280
2349	1549	132	132	135954	0	137767
2350	1013	95	126	167837	0	169071
2351	518	273	168984	4563	0	174338
2352	378	279	167442	1944	0	170043
2353	472	150	5052	164564	0	170238
2354	375	339	168327	3957	0	172998
2355	348	299	165018	1924	0	167589
2356	152776	146	5419	1323	0	159664
2357	4007	311	169033	694	0	174045
2358	1746	168517	4633	643	0	175539
2359	1094	3704	1942	168479	0	175219
2360	174379	1639	922	4178	0	181118
2361	177810	670	563	2213	0	181256
2362	176746	337	425	1322	0	178830
2363	5981	174743	762	791	0	182277
2364	2830	3968	424	173610	0	180832
2365	1329	1828	405	178371	0	181933
2366	169810	784	504	6210	0	177308
2367	176581	368	443	3050	0	180442
2368	178834	270	490	1684	0	181278
2369	6379	482	178517	1015	0	186393
2370	2855	176958	4601	1151	0	185565
2371	1374	203479	2672	975	0	208500
2372	1256	6875	1449	194231	0	203811
2373	1131	3080	947	202918	0	208076
2374	910	1427	199581	8014	0	209932
2375	193777	638	5926	4146	0	204487
2376	203177	589	3136	2044	0	208946
2377	8424	662	1618	199471	0	210175
2378	4382	592	789	203304	0	209067
2379	2358	436	608	205667	0	209069
2380	199831	454	745	9215	0	210245
2381	6533	686	195330	4361	0	206910
2382	3701	763	199546	2122	0	206132
2383	2051	690	7934	194521	0	205196
2384	1341	706	198199	6619	0	206865
2385	192898	420	6590	4013	0	203921
2386	199771	336	3322	2274	0	205703
2387	202291	403	1673	1603	0	205970
2388	9411	191555	1432	1320	0	203718
2389	194652	5588	976	1480	0	202696
2390	7321	3132	834	190384	0	201671
2391	4044	1511	945	193232	0	199732
2392	2504	782	915	197920	0	202121
2393	1584	811	188782	9773	0	200950
2394	1846	669	6224	181722	0	190461
2395	1645	187555	3684	7338	0	200222
2396	182459	5408	1941	4435	0	194243
2397	6131	187599	1483	3361	0	198574
2398	4111	6361	184077	2344	0	196893
2399	2423	185187	6485	2100	0	196195
2400	178948	6349	3804	2214	0	191315
2401	6105	181537	2708	2168	0	192518
2402	4209	6387	1966	156508	0	169070
2403	2237	180892	2034	5768	0	190931
2404	180016	6276	1887	3637	0	191816
2405	183723	3209	1711	2335	0	190978
2406	174796	1754	1812	2088	0	180450
2407	9396	1599	177902	1642	0	190539
2408	4968	1402	176947	1669	0	184986
2409	3190	1386	176739	1958	0	183273
2410	173041	1263	8913	2191	0	185408
2411	7384	1125	4555	171989	0	185053
2412	4770	1080	2424	176470	0	184744
2413	2900	1395	171758	8735	0	184788
2414	2459	1353	6043	173497	0	183352
2415	164849	1427	3571	7781	0	177628
2416	6831	166876	2389	4600	0	180696
2417	171062	6007	1658	2844	0	181571
2418	8003	3697	167322	1943	0	180965
2419	169970	2374	6159	1905	0	180408
2420	173979	1831	3708	1910	0	181428
2421	175030	1831	2193	2052	0	181106
2422	9889	1869	166730	2020	0	180508
2423	6058	1451	5946	166517	0	179972
2424	4019	1390	169134	6497	0	181040
2425	3576	1235	6886	169185	0	180882
2426	2985	1405	171556	7076	0	183022
2427	3103	1207	7159	168510	0	179979
2428	2941	1183	4099	174099	0	182322
2429	170523	913	2733	9015	0	183184
2430	172929	818	2100	5131	0	180978
2431	176171	709	2157	3307	0	182344
2432	10086	848	2243	162601	0	175778
2433	5365	154496	2244	6605	0	168710
2434	3401	166221	1953	4589	0	176164
2435	164477	7220	1715	3065	0	176477
2436	7388	3931	162169	2340	0	175828
2437	162518	1845	6304	2177	0	172844
2438	8022	1506	162863	2027	0	174418
2439	166076	1254	6790	2209	0	176329
2440	163034	1141	3891	2271	0	170337
2441	9378	1168	165655	2157	0	178358
2442	166071	853	6497	2401	0	175822
2443	169275	888	3935	2259	0	176357
2444	169149	1007	2694	1991	0	174841
2445	9648	165712	2260	2279	0	179899
2446	5518	7167	2198	158904	0	173787
2447	3295	3072	160275	6260	0	172902
2448	3127	1817	161139	3861	0	169944
2449	2586	145165	6708	2487	0	156946
2450	1619	116610	2773	1181	0	122183
2451	2723	3207	2424	108669	0	117023
2452	106964	1630	981	2988	0	112563
2453	3171	108763	902	1979	0	114815
2454	2618	2540	668	105285	0	111111
2455	1761	109597	778	2580	0	114716
2456	107650	2671	700	1801	0	112822
2457	3170	1727	678	106883	0	112458
2458	2218	1052	105142	2583	0	110995
2459	1550	101778	2590	1771	0	107689
2460	1220	103093	1963	1025	0	107301
2461	1453	3149	1042	93945	0	99589
2462	1229	101836	1024	2037	0	106126
2463	1329	2617	801	100230	0	104977
2464	101777	1577	666	2740	0	106760
2465	102429	969	738	1660	0	105796
2466	104756	684	669	1074	0	107183
2467	105380	717	714	791	0	107602
2468	4107	824	103766	754	0	109451
2469	2163	97707	2309	668	0	102847
2470	1215	96897	1515	672	0	100299
2471	482	80985	441	306	0	82214
2472	421	82617	450	282	0	83770
2473	81214	1678	927	429	0	84248
2474	80205	677	332	299	0	81513
2475	81688	271	125	339	0	82423
2476	81935	161	135	302	0	82533
2477	1695	252	79693	139	0	81779
2478	85253	136	1023	430	0	86842
2479	87860	145	594	291	0	88890
2480	89056	171	218	298	0	89743
2481	1791	161	132	87342	0	89426
2482	936	153	154	88101	0	89344
2483	88601	169	121	1664	0	90555
2484	1263	203	112	86798	0	88376
2485	768	85961	195	1165	0	88089
2486	473	1054	98	87618	0	89243
2487	349	623	119	87239	0	88330
2488	310	88130	212	1545	0	90197
2489	360	1045	150	88664	0	90219
2490	387	708	129	89152	0	90376
2491	87157	299	135	1624	0	89215
2492	1216	357	84590	803	0	86966
2493	82836	243	998	431	0	84508
2494	1335	326	85253	299	0	87213
2495	877	299	81688	241	0	83105
2496	557	329	83892	193	0	84971
2497	81237	191	1645	383	0	83456
2498	1300	293	87824	200	0	89617
2499	85968	180	1219	368	0	87735
2500	88344	177	608	388	0	89517
2501	88641	168	269	349	0	89427
2502	1650	87653	278	266	0	89847
2503	88305	1048	145	351	0	89849
2504	1218	89442	222	273	0	91155
2505	850	1150	124	89744	0	91868
2506	490	667	138	89445	0	90740
2507	363	89264	209	1522	0	91358
2508	352	90135	227	775	0	91489
2509	355	92756	234	383	0	93728
2510	91405	1589	143	411	0	93548
2511	1175	93360	252	313	0	95100
2512	93704	1210	151	417	0	95482
2513	1488	853	90899	252	0	93492
2514	90902	368	1047	333	0	92650
2515	94082	242	628	409	0	95361
2516	1777	381	90288	219	0	92665
2517	1100	245	1060	89152	0	91557
2518	573	363	91704	1160	0	93800
2519	526	252	1179	90763	0	92720
2520	530	236	667	92225	0	93658
2521	91961	224	321	1779	0	94285
2522	92024	235	180	1010	0	93449
2523	1766	91592	329	424	0	94111
2524	93392	1108	189	477	0	95166
2525	1535	833	92362	282	0	95012
2526	91137	347	1176	428	0	93088
2527	1596	392	95357	266	0	97611
2528	1023	408	93575	253	0	95259
2529	95408	270	1834	445	0	97957
2530	98940	231	928	419	0	100518
2531	2126	470	100311	241	0	103148
2532	1232	307	1350	94966	0	97855
2533	701	278	855	101698	0	103532
2534	634	461	99745	1861	0	102701
2535	669	289	1307	96276	0	98541
2536	551	95705	1010	1357	0	98623
2537	712	1315	362	101773	0	104162
2538	692	853	298	100975	0	102818
2539	700	580	97259	1856	0	100395
2540	88905	299	1307	1200	0	91711
2541	96957	260	809	608	0	98634
2542	96904	230	416	503	0	98053
2543	95992	215	318	505	0	97030
2544	2374	93221	449	407	0	96451
2545	1417	1233	337	90822	0	93809
2546	908	879	89642	1472	0	92901
2547	702	478	88589	923	0	90692
2548	803	322	1760	86174	0	89059
2549	566	404	88851	1510	0	91331
2550	85555	204	1409	1094	0	88262
2551	1544	249	857	88630	0	91280
2552	1092	230	461	89560	0	91343
2553	605	270	347	89851	0	91073
2554	87112	204	377	2286	0	89979
2555	1391	87308	440	1254	0	90393
2556	87341	1177	367	706	0	89591
2557	87116	711	389	659	0	88875
2558	1949	84889	503	436	0	87777
2559	1093	85838	581	393	0	87905
2560	87876	1545	509	511	0	90441
2561	1618	748	525	87383	0	90274
2562	1261	279	469	87465	0	89474
2563	89638	198	520	1824	0	92180
2564	1741	339	88979	874	0	91933
2565	87735	190	1445	562	0	89932
2566	89564	210	919	500	0	91193
2567	2171	90312	503	424	0	93410
2568	93663	1174	263	449	0	95549
2569	92239	744	241	509	0	93733
2570	2074	102675	296	416	0	105461
2571	800	103849	294	320	0	105263
2572	691	2164	352	99853	0	103060
2573	102109	934	147	1716	0	104906
2574	1664	104941	236	975	0	107816
2575	1036	1731	142	106593	0	109502
2576	106783	862	152	2025	0	109822
2577	2067	416	105982	1014	0	109479
2578	1192	195	1819	103309	0	106515
2579	504	295	105078	2034	0	107911
2580	99453	180	2059	1229	0	102921
2581	106393	151	1033	597	0	108174
2582	2846	271	105202	377	0	108696
2583	1248	104087	2063	396	0	107794
2584	638	1817	1049	105436	0	108940
2585	461	1073	106618	1987	0	110139
2586	470	340	2023	106418	0	109251
2587	514	201	1030	110815	0	112560
2588	422	302	108268	2932	0	111924
2589	101048	180	2092	1542	0	104862
2590	108919	198	1057	685	0	110859
2591	3112	324	108745	426	0	112607
2592	1404	108630	2174	596	0	112804
2593	744	2127	1099	103117	0	107087
2594	467	106939	543	1889	0	109838
2595	416	109620	426	1120	0	111582
2596	109741	2891	322	729	0	113683
2597	2404	1261	260	110105	0	114030
2598	1436	474	255	109667	0	111832
2599	685	490	110045	3108	0	114328
2600	570	415	109359	1466	0	111810
2601	648	298	3120	107570	0	111636
2602	680	281	1404	111486	0	113851
2603	546	463	109436	3244	0	113689
2604	503	446	109773	1540	0	112262
2605	572	380	3230	108673	0	112855
2606	109769	325	1524	2719	0	114337
2607	2418	110662	832	1702	0	115614
2608	110714	2381	467	924	0	114486
2609	2800	110952	556	697	0	115005
2610	1527	112785	580	607	0	115499
2611	110198	3352	464	691	0	114705
2612	2746	1681	112288	537	0	117252
2613	1718	639	2554	112712	0	117623
2614	1017	500	1460	117054	0	120031
2615	851	420	705	125113	0	127089
2616	683	596	124186	4154	0	129619
2617	805	470	2980	124598	0	128853
2618	126548	425	1681	3648	0	132302
2619	3361	465	796	129783	0	134405
2620	2015	388	631	134885	0	137919
2621	133280	416	561	5079	0	139336
2622	132002	422	574	2556	0	135554
2623	4704	130589	784	1341	0	137418
2624	2265	3219	132414	902	0	138800
2625	1120	1687	131266	788	0	134861
2626	855	750	133803	846	0	136254
2627	704	127241	5047	851	0	133843
2628	989	3194	2420	123387	0	129990
2629	828	1693	975	127962	0	131458
2630	126133	741	755	4766	0	132395
2631	3629	577	693	125214	0	130113
2632	1929	627	124254	4029	0	130839
2633	1204	412	3528	124962	0	130106
2634	985	454	1945	126489	0	129873
2635	785	567	123987	5148	0	130487
2636	621	122809	3774	2708	0	129912
2637	1042	3347	2031	106745	0	113165
2638	691	122980	1245	3245	0	128161
2639	736	3600	122826	2065	0	129227
2640	120111	1813	3651	1340	0	126915
2641	124564	827	1986	1185	0	128562
2642	125966	676	1081	1160	0	128883
2643	5265	688	898	119893	0	126744
2644	2359	123501	1012	3686	0	130558
2645	123444	3440	869	2266	0	130019
2646	125700	1840	918	1375	0	129833
2647	124613	900	850	1401	0	127764
2648	5109	720	121479	1216	0	128524
2649	117805	554	3532	1272	0	123163
2650	3886	120295	2172	1215	0	127568
2651	119611	3241	1110	1218	0	125180
2652	3739	121770	1075	1161	0	127745
2653	122975	3548	854	1309	0	128686
2654	4032	1963	123516	1043	0	130554
2655	123099	881	3571	1173	0	128724
2656	127088	695	1894	1230	0	130907
2657	114601	688	1224	1194	0	117707
2658	128529	669	864	1005	0	131067
2659	5332	776	123884	1003	0	130995
2660	2816	736	3405	122095	0	129052
2661	121552	597	2038	3680	0	127867
2662	3820	121570	1299	2330	0	129019
2663	2454	3211	807	119837	0	126309
2664	1458	1777	118703	3713	0	125651
2665	1595	1201	3347	118940	0	125083
2666	1287	721	120003	3896	0	125907
2667	1097	114699	3755	2414	0	121965
2668	1027	110707	2015	1217	0	114966
2669	1101	112216	1047	1085	0	115449
2670	1377	3805	787	98432	0	104401
2671	1135	1506	565	99355	0	102561
2672	949	765	96731	3281	0	101726
2673	773	93159	2396	1603	0	97931
2674	88298	2175	1155	869	0	92497
2675	2220	87046	740	704	0	90710
2676	1224	88725	632	634	0	91215
2677	1646	2720	627	84941	0	89934
2678	85097	1176	554	2150	0	88977
2679	86339	571	467	1339	0	88716
2680	2990	416	422	84526	0	88354
2681	83891	416	446	2238	0	86991
2682	2382	426	429	83299	0	86536
2683	1353	537	82061	2298	0	86249
2684	80980	412	1973	1400	0	84765
2685	2334	492	1086	81561	0	85473
2686	1204	510	79913	2095	0	83722
2687	796	566	78767	1128	0	81257
2688	760	542	2474	78569	0	82345
2689	80174	482	1146	2113	0	83915
2690	80177	419	571	1245	0	82412
2691	2588	80188	624	638	0	84038
2692	82412	1891	428	765	0	85496
2693	82674	1012	393	679	0	84758
2694	83238	488	387	662	0	84775
2695	2741	82938	511	558	0	86748
2696	82782	1650	366	724	0	85522
2697	83842	946	361	561	0	85710
2698	2908	486	311	82001	0	85706
2699	78682	376	317	1794	0	81169
2700	2065	77895	445	986	0	81391
2701	1216	80290	435	567	0	82508
2702	885	2026	379	79243	0	82533
2703	861	946	292	79024	0	81123
2704	716	81012	352	2070	0	84150
2705	80016	1561	359	972	0	82908
2706	1824	79311	430	492	0	82057
2707	78124	1494	264	476	0	80358
2708	1894	79322	353	349	0	81918
2709	1284	1620	250	74637	0	77791
2710	702	81232	336	1380	0	83650
2711	80767	1685	815	856	0	84123
2712	78676	942	469	540	0	80627
2713	77969	461	499	510	0	79439
2714	2335	456	73776	368	0	76935
2715	973	395	68148	228	0	69744
2716	465	67114	1304	334	0	69217
2717	503	1104	65997	282	0	67886
2718	370	696	63255	310	0	64631
2719	371	851	957	53864	0	56043
2720	214	202	58039	624	0	59079
2721	156	58869	617	458	0	60100
2722	58500	557	342	282	0	59681
2723	555	58044	186	182	0	58967
2724	353	58754	147	147	0	59401
2725	58942	756	78	326	0	60102
2726	59020	361	103	301	0	59785
2727	750	60814	135	150	0	61849
2728	61662	539	93	281	0	62575
2729	61414	349	97	234	0	62094
2730	61598	166	90	242	0	62096
2731	872	258	58965	148	0	60243
2732	466	278	58282	113	0	59139
2733	285	160	682	59598	0	60725
2734	278	147	301	61803	0	62529
2735	62236	152	132	831	0	63351
2736	604	61073	196	404	0	62277
2737	421	657	140	62568	0	63786
2738	275	312	108	63325	0	64020
2739	248	155	108	64310	0	64821
2740	283	136	120	64727	0	65266
2741	254	212	63738	965	0	65169
2742	219	215	63935	454	0	64823
2743	300	145	881	64972	0	66298
2744	240	217	66420	710	0	67587
2745	62923	123	755	524	0	64325
2746	880	138	389	66769	0	68176
2747	536	197	67038	712	0	68483
2748	60846	123	717	566	0	62252
2749	808	66423	464	232	0	67927
2750	66674	685	148	223	0	67730
2751	850	68326	212	174	0	69562
2752	553	736	139	66787	0	68215
2753	324	465	67416	697	0	68902
2754	321	174	709	64503	0	65707
2755	210	251	65013	788	0	66262
2756	62646	136	746	515	0	64043
2757	863	155	335	66147	0	67500
2758	66820	119	174	874	0	67987
2759	868	232	66516	420	0	68036
2760	66944	122	712	312	0	68090
2761	72196	119	372	274	0	72961
2762	1287	208	72536	168	0	74199
2763	624	144	845	71196	0	72809
2764	290	180	73307	833	0	74610
2765	174	73060	939	448	0	74621
2766	72544	849	748	401	0	74542
2767	72163	350	262	310	0	73085
2768	1183	231	72877	151	0	74442
2769	571	216	72097	126	0	73010
2770	287	142	1126	70129	0	71684
2771	227	91	456	72905	0	73679
2772	72953	87	212	1151	0	74403
2773	844	73201	219	466	0	74730
2774	74529	770	157	351	0	75807
2775	74757	346	150	317	0	75570
2776	1148	242	73047	185	0	74622
2777	70172	73	821	269	0	71335
2778	950	192	73627	195	0	74964
2779	625	98	851	73271	0	74845
2780	327	218	77814	824	0	79183
2781	320	87	921	76889	0	78217
2782	268	176	77874	875	0	79193
2783	74406	68	968	531	0	75973
2784	77180	70	483	302	0	78035
2785	1227	80	273	76595	0	78175
2786	77370	90	250	1007	0	78717
2787	1000	88	230	77504	0	78822
2788	529	78715	311	893	0	80448
2789	78606	720	199	586	0	80111
2790	917	78663	302	267	0	80149
2791	595	778	182	79280	0	80835
2792	390	372	197	78348	0	79307
2793	331	150	187	78075	0	78743
2794	325	109	206	77445	0	78085
2795	268	236	74455	1185	0	76144
2796	65729	138	809	736	0	67412
2797	72971	114	433	390	0	73908
2798	1135	73001	280	296	0	74712
2799	601	712	219	73269	0	74801
2800	408	335	210	73744	0	74697
2801	318	241	71903	1116	0	73578
2802	68414	99	870	653	0	70036
2803	997	103	464	71468	0	73032
2804	491	190	70446	880	0	72007
2805	68593	97	864	677	0	70231
2806	71554	93	459	447	0	72553
2807	71841	88	273	403	0	72605
2808	1235	168	69718	278	0	71399
2809	561	170	65299	303	0	66333
2810	64816	92	856	307	0	66071
2811	813	81	445	66975	0	68314
2812	574	143	216	69269	0	70202
2813	353	168	68644	890	0	70055
2814	65962	98	689	563	0	67312
2815	831	109	351	70220	0	71511
2816	72234	80	229	999	0	73542
2817	72509	84	203	602	0	73398
2818	72702	74	179	457	0	73412
2819	1214	173	73875	288	0	75550
2820	633	96	854	73920	0	75503
2821	73567	67	450	1130	0	75214
2822	958	76063	287	555	0	77863
2823	652	806	173	77109	0	78740
2824	481	383	149	78110	0	79123
2825	76818	124	185	1434	0	78561
2826	76727	96	185	736	0	77744
2827	1431	80	177	75251	0	76939
2828	704	216	75448	1008	0	77376
2829	73471	83	930	705	0	75189
2830	1127	188	80472	317	0	82104
2831	80571	92	1093	400	0	82156
2832	83358	50	611	350	0	84369
2833	1767	163	82472	241	0	84643
2834	918	126	1148	83793	0	85985
2835	456	162	88945	1308	0	90871
2836	351	94277	1403	796	0	96827
2837	503	1391	720	87369	0	89983
2838	341	95644	346	1292	0	97623
2839	406	1405	206	96337	0	98354
2840	360	756	98455	1512	0	101083
2841	275	99272	1571	899	0	102017
2842	246	102349	868	360	0	103823
2843	551	2464	301	101327	0	104643
2844	102728	873	169	1740	0	105510
2845	1788	259	143	110958	0	113148
2846	111482	151	156	2228	0	114017
2847	2101	113197	262	1180	0	116740
2848	122361	2048	169	460	0	125038
2849	2619	1113	126482	319	0	130533
2850	1402	274	2328	124631	0	128635
2851	622	174	1118	126068	0	127982
2852	446	251	125056	3434	0	129187
2853	118272	193	2398	1523	0	122386
2854	123860	185	1178	608	0	125831
2855	3412	123690	557	373	0	128032
2856	1690	2541	333	111079	0	115643
2857	504	121106	403	2172	0	124185
2858	444	2480	121177	1186	0	125287
2859	446	1320	122672	459	0	124897
2860	615	1648	3331	117094	0	122688
2861	117776	294	1315	2423	0	121808
2862	2240	115472	536	1336	0	119584
2863	116963	2263	295	579	0	120100
2864	2538	1275	114193	387	0	118393
2865	114845	385	2314	462	0	118006
2866	118023	300	1174	455	0	119952
2867	3518	389	116094	360	0	120361
2868	1690	319	2364	113054	0	117427
2869	117306	280	1267	2503	0	121356
2870	118508	280	501	1418	0	120707
2871	119184	266	431	636	0	120517
2872	3785	296	356	115751	0	120188
2873	1771	357	115402	2481	0	120011
2874	113391	317	2518	1546	0	117772
2875	2800	401	118015	641	0	121857
2876	1798	344	2601	115543	0	120286
2877	974	350	1450	113455	0	116229
2878	732	116351	676	3453	0	121212
2879	678	2504	116376	1586	0	121144
2880	613	112384	2710	776	0	116483
2881	724	114718	1582	704	0	117728
2882	852	3627	717	112817	0	118013
2883	754	1584	113170	2672	0	118180
2884	912	647	2607	113460	0	117626
2885	829	585	114427	2886	0	118727
2886	985	462	2792	113050	0	117289
2887	924	509	1573	114167	0	117173
2888	873	548	109664	3833	0	114918
2889	961	460	2822	108706	0	112949
2890	860	484	111134	3066	0	115544
2891	958	518	109612	1831	0	112919
2892	807	108395	3906	1099	0	114207
2893	109703	2567	1803	924	0	114997
2894	3067	1577	109212	792	0	114648
2895	104837	682	2957	841	0	109317
2896	3213	591	1771	109837	0	115412
2897	1909	666	108548	3045	0	114168
2898	932	108808	3094	2096	0	114930
2899	1084	2747	1764	108768	0	114363
2900	948	1698	109947	2944	0	115537
2901	1142	832	2965	102157	0	107096
2902	860	109216	1906	2897	0	114879
2903	110613	2803	999	1861	0	116276
2904	3107	1690	908	110504	0	116209
2905	110904	817	887	3295	0	115903
2906	112373	712	847	2167	0	116099
2907	113602	613	883	1314	0	116412
2908	114089	606	860	1278	0	116833
2909	112062	589	900	1192	0	114743
2910	4231	107940	1082	1105	0	114358
2911	2383	2590	879	108890	0	114742
2912	1501	1548	892	110152	0	114093
2913	1431	628	948	110524	0	113531
2914	1141	698	105011	4244	0	111094
2915	1091	104241	3100	2227	0	110659
2916	108590	2581	1876	1253	0	114300
2917	108809	1571	1148	1126	0	112654
2918	4247	106086	1103	1140	0	112576
2919	1999	108442	1185	1168	0	112794
2920	106871	3692	1010	1122	0	112695
2921	3326	1853	104714	985	0	110878
2922	2164	928	3201	100648	0	106941
2923	102180	666	1949	3049	0	107844
2924	3363	611	993	98488	0	103455
2925	1963	100202	1106	3032	0	106303
2926	1386	2746	842	101205	0	106179
2927	1174	1696	100692	3082	0	106644
2928	97027	672	2991	2004	0	102694
2929	102176	543	1794	1214	0	105727
2930	4244	492	862	95157	0	100755
2931	2497	451	736	96503	0	100187
2932	91147	450	694	3687	0	95978
2933	2937	90801	842	1988	0	96568
2934	2024	2164	697	88821	0	93706
2935	1556	1230	596	88604	0	91986
2936	79731	412	518	3243	0	83904
2937	2381	81293	673	1777	0	86124
2938	80279	1953	439	969	0	83640
2939	2610	79012	612	688	0	82922
2940	1454	78855	520	615	0	81444
2941	74831	2486	419	632	0	78368
2942	2039	75103	589	691	0	78422
2943	1347	2849	824	71531	0	76551
2944	708	1127	71342	1937	0	75114
2945	471	449	62009	928	0	63857
2946	307	336	60459	464	0	61566
2947	296	58757	1990	410	0	61453
2948	49885	984	1588	254	0	52711
2949	962	533	298	46456	0	48249
2950	631	216	175	47395	0	48417
2951	282	195	46327	1348	0	48152
2952	44836	123	884	756	0	46599
2953	991	141	505	47700	0	49337
2954	635	140	201	48345	0	49321
2955	327	121	140	48368	0	48956
2956	46397	128	142	1535	0	48202
2957	991	175	45632	739	0	47537
2958	45233	144	849	381	0	46607
2959	1124	182	499	45701	0	47506
2960	714	219	45270	954	0	47157
2961	43881	190	901	652	0	45624
2962	1093	243	45949	329	0	47614
2963	733	296	970	44490	0	46489
2964	397	249	46049	995	0	47690
2965	244	214	44371	616	0	45445
2966	42024	121	1364	404	0	43913
2967	920	179	43622	288	0	45009
2968	660	173	1016	42279	0	44128
2969	42629	175	598	945	0	44347
2970	973	175	290	42803	0	44241
2971	603	215	42063	1018	0	43899
2972	393	190	42455	645	0	43683
2973	270	42425	1216	386	0	44297
2974	330	833	595	41310	0	43068
2975	40306	454	259	1010	0	42029
2976	790	39870	247	696	0	41603
2977	40378	781	196	417	0	41772
2978	1009	466	220	39702	0	41397
2979	39739	217	191	961	0	41108
2980	968	39251	234	676	0	41129
2981	693	800	225	38854	0	40572
2982	39457	482	205	921	0	41065
2983	931	39808	295	592	0	41626
2984	644	828	249	39732	0	41453
2985	367	486	274	39842	0	40969
2986	40499	198	281	1284	0	42262
2987	968	132	272	40711	0	42083
2988	680	106	316	41032	0	42134
2989	392	120	292	42581	0	43385
2990	354	146	41043	1465	0	43008
2991	40285	119	1030	857	0	42291
2992	1131	136	645	50647	0	52559
2993	694	175	52614	1407	0	54890
2994	51311	155	1462	923	0	53851
2995	1458	196	54107	509	0	56270
2996	935	165	1544	51430	0	54074
2997	403	53074	919	1422	0	55818
2998	458	1282	374	54594	0	56708
2999	369	736	54559	1635	0	57299
3000	398	320	56225	964	0	57907
3001	399	197	1994	56042	0	58632
3002	360	256	56226	1608	0	58450
3003	53855	204	1607	977	0	56643
3004	1499	256	55977	545	0	58277
3005	954	223	1582	53923	0	56682
3006	485	201	874	55367	0	56927
3007	425	197	405	55269	0	56296
3008	54221	142	310	2320	0	56993
3009	54884	153	281	1216	0	56534
3010	55907	137	283	732	0	57059
3011	2261	135	285	54417	0	57098
3012	1072	151	289	55313	0	56825
3013	481	139	53141	2269	0	56030
3014	430	140	53457	1121	0	55148
3015	381	52514	2040	629	0	55564
3016	546	1365	956	45284	0	48151
3017	360	506	383	43340	0	44589
3018	219	45784	348	1474	0	47825
3019	45733	1011	255	769	0	47768
3020	1089	46372	299	390	0	48150
3021	46401	1058	292	372	0	48123
3022	1218	556	316	45944	0	48034
3023	46501	167	274	1263	0	48205
3024	1256	118	266	46740	0	48380
3025	665	153	45587	1311	0	47716
3026	356	121	1182	46274	0	47933
3027	45398	97	664	1361	0	47520
3028	1211	104	271	46108	0	47694
3029	721	94	216	46131	0	47162
3030	327	155	45781	1805	0	48068
3031	387	94	1104	46658	0	48243
3032	382	110	610	45460	0	46562
3033	332	45184	303	1741	0	47560
3034	344	1028	192	45926	0	47490
3035	385	493	222	46513	0	47613
3036	450	152	244	45177	0	46023
3037	184	42244	245	1618	0	44291
3038	254	899	172	41315	0	42640
3039	39353	409	196	1158	0	41116
3040	932	38987	217	720	0	40856
3041	493	38100	217	350	0	39160
3042	227	38715	230	401	0	39573
3043	300	1327	264	35291	0	37182
3044	225	35488	542	1127	0	37382
3045	394	37260	459	667	0	38780
3046	37487	1082	608	478	0	39655
3047	1032	516	36910	542	0	39000
3048	36474	349	1125	604	0	38552
3049	985	287	729	36966	0	38967
3050	513	291	36864	1338	0	39006
3051	35709	193	1480	911	0	38293
3052	992	204	36702	773	0	38671
3053	598	214	36699	629	0	38140
3054	37059	122	1702	679	0	39562
3055	1216	160	1071	37859	0	40306
3056	707	155	38119	1626	0	40607
3057	37725	107	1274	1350	0	40456
3058	39019	114	772	1063	0	40968
3059	1789	149	38644	900	0	41482
3060	39862	98	1132	821	0	41913
3061	41048	80	606	804	0	42538
3062	1822	149	38856	857	0	41684
3063	39233	178	1186	952	0	41549
3064	39857	171	878	876	0	41782
3065	1517	277	38571	764	0	41129
3066	762	452	41862	679	0	43755
3067	484	369	1543	42041	0	44437
3068	437	424	42339	1651	0	44851
3069	41886	568	1229	1069	0	44752
3070	1548	482	615	42188	0	44833
3071	1030	598	282	42880	0	44790
3072	808	499	41458	1753	0	44518
3073	739	388	1095	41478	0	43700
3074	747	388	41496	1627	0	44258
3075	41652	238	1184	1260	0	44334
3076	42976	258	764	913	0	44911
3077	1800	256	41892	958	0	44906
3078	42389	199	1242	922	0	44752
3079	43583	167	667	1050	0	45467
3080	1697	191	42651	1166	0	45705
3081	43511	171	1353	1109	0	46144
3082	43423	190	780	1192	0	45585
3083	1520	264	43326	1118	0	46228
3084	42761	374	1171	1106	0	45412
3085	1230	422	44249	1162	0	47063
3086	690	298	1103	43984	0	46075
3087	418	356	578	44879	0	46231
3088	486	455	266	45442	0	46649
3089	400	465	42938	2132	0	45935
3090	39209	374	971	1192	0	41746
3091	1195	553	40607	766	0	43121
3092	411	30960	620	398	0	32389
3093	199	30355	300	244	0	31098
3094	28435	577	268	239	0	29519
3095	607	318	122	28399	0	29446
3096	276	29335	138	502	0	30251
3097	28418	344	126	254	0	29142
3098	28132	148	89	159	0	28528
3099	524	29181	130	119	0	29954
3100	279	370	92	26411	0	27152
3101	139	28097	107	358	0	28701
3102	28609	365	93	225	0	29292
3103	28912	172	99	140	0	29323
3104	595	50	75	28008	0	28728
3105	28260	43	97	458	0	28858
3106	498	52	84	28338	0	28972
3107	269	87	28030	444	0	28830
3108	27149	45	422	249	0	27865
3109	487	103	28572	95	0	29257
3110	259	63	429	27795	0	28546
3111	28368	30	219	447	0	29064
3112	492	65	102	28585	0	29244
3113	269	58	28551	437	0	29315
3114	153	74	28051	205	0	28483
3115	178	81	576	28390	0	29225
3116	28624	24	258	460	0	29366
3117	456	29176	157	213	0	30002
3118	276	370	94	29200	0	29940
3119	162	192	29612	401	0	30367
3120	28934	46	434	247	0	29661
3121	30932	41	229	131	0	31333
3122	608	74	30130	96	0	30908
3123	29872	33	392	146	0	30443
3124	506	57	196	31189	0	31948
3125	247	62	31195	378	0	31882
3126	30681	26	400	213	0	31320
3127	466	44	202	31055	0	31767
3128	263	45	94	31069	0	31471
3129	31333	27	94	540	0	31994
3130	416	29923	117	226	0	30682
3131	243	30685	100	114	0	31142
3132	30665	387	93	159	0	31304
3133	29683	153	100	126	0	30062
3134	519	67	30747	84	0	31417
3135	242	67	30162	103	0	30574
3136	160	73	452	30724	0	31409
3137	31803	22	195	408	0	32428
3138	31492	31	102	258	0	31883
3139	31912	29	101	141	0	32183
3140	495	31369	111	135	0	32110
3141	224	32204	106	102	0	32636
3142	157	404	89	33291	0	33941
3143	179	166	79	33142	0	33566
3144	178	46	87	34220	0	34531
3145	163	82	34139	479	0	34863
3146	171	83	30846	218	0	31318
3147	33090	38	522	139	0	33789
3148	35308	49	237	154	0	35748
3149	594	40	116	35334	0	36084
3150	300	43	91	35345	0	35779
3151	197	58	102	36346	0	36703
3152	153	83	35161	559	0	35956
3153	125	76	34320	275	0	34796
3154	127	128	480	34637	0	35372
3155	116	86	35484	415	0	36101
3156	93	34363	417	278	0	35151
3157	106	35657	220	125	0	36108
3158	35247	461	115	154	0	35977
3159	366	34975	109	96	0	35546
3160	267	351	97	35208	0	35923
3161	159	203	80	35413	0	35855
3162	119	37298	94	541	0	38052
3163	151	437	81	38022	0	38691
3164	135	247	36873	541	0	37796
3165	135	36715	451	325	0	37626
3166	111	404	188	34879	0	35582
3167	123	210	34947	412	0	35692
3168	94	34495	380	249	0	35218
3169	130	377	187	33445	0	34139
3170	114	34771	110	362	0	35357
3171	125	382	69	34836	0	35412
3172	131	192	77	33349	0	33749
3173	90	34383	92	493	0	35058
3174	33132	357	81	250	0	33820
3175	32384	174	83	170	0	32811
3176	491	33389	103	117	0	34100
3177	238	33898	104	177	0	34417
3178	134	508	69	33717	0	34428
3179	108	262	33080	406	0	33856
3180	31460	116	356	310	0	32242
3181	32545	85	200	198	0	33028
3182	546	146	32402	100	0	33194
3183	31422	76	380	173	0	32051
3184	32777	74	209	176	0	33236
3185	554	139	31844	139	0	32676
3186	30365	79	405	168	0	31017
3187	438	115	32572	142	0	33267
3188	247	32916	433	123	0	33719
3189	33442	367	222	176	0	34207
3190	33581	222	114	162	0	34079
3191	534	135	33170	134	0	33973
3192	33221	104	362	184	0	33871
3193	34353	97	224	242	0	34916
3194	543	128	33513	147	0	34331
3195	33804	100	363	197	0	34464
3196	34852	103	212	202	0	35369
3197	575	135	34310	129	0	35149
3198	34536	112	381	177	0	35206
3199	454	114	224	33852	0	34644
3200	283	123	109	34110	0	34625
3201	146	145	33742	568	0	34601
3202	151	116	33252	284	0	33803
3203	168	113	512	33737	0	34530
3204	178	95	249	34448	0	34970
3205	36020	85	139	574	0	36818
3206	507	139	35789	251	0	36686
3207	35683	98	427	169	0	36377
3208	555	95	257	36650	0	37557
3209	265	170	36793	454	0	37682
3210	37659	96	423	337	0	38515
3211	523	103	238	39995	0	40859
3212	312	102	40678	483	0	41575
3213	39475	80	511	315	0	40381
3214	550	66	257	40870	0	41743
3215	41703	48	150	567	0	42468
3216	608	112	43902	255	0	44877
3217	366	88	508	40789	0	41751
3218	178	45007	310	458	0	45953
3219	45581	468	130	347	0	46526
3220	44856	236	135	207	0	45434
3221	710	46256	146	107	0	47219
3222	47008	507	102	197	0	47814
3223	46803	234	113	153	0	47303
3224	46202	91	117	165	0	46575
3225	811	45353	158	135	0	46457
3226	416	500	103	45701	0	46720
3227	246	284	46229	595	0	47354
3228	258	113	564	45008	0	45943
3229	222	78	290	46111	0	46701
3230	177	116	45835	807	0	46935
3231	203	106	44880	348	0	45537
3232	268	77	756	42097	0	43198
3233	170	45794	381	486	0	46831
3234	45742	530	168	337	0	46777
3235	44717	247	139	225	0	45328
3236	816	46065	163	170	0	47214
3237	46482	521	115	223	0	47341
3238	46181	247	140	221	0	46789
3239	867	175	46037	143	0	47222
3240	44652	118	565	219	0	45554
3241	702	47192	299	253	0	48446
3242	419	572	46454	117	0	47562
3243	350	311	45243	125	0	46029
3244	212	45947	711	228	0	47098
3245	45917	492	323	180	0	46912
3246	678	309	46212	158	0	47357
3247	400	108	518	45221	0	46247
3248	230	145	45932	532	0	46839
3249	42539	90	610	361	0	43600
3250	669	152	52046	246	0	53113
3251	360	154	51184	149	0	51847
3252	49952	74	666	233	0	50925
3253	583	52890	370	159	0	54002
3254	54012	478	173	270	0	54933
3255	54519	246	152	236	0	55153
3256	783	190	117	53406	0	54496
3257	361	57718	207	489	0	58775
3258	58459	482	150	458	0	59549
3259	607	370	59117	140	0	60234
3260	56994	122	468	243	0	57827
3261	588	59649	346	144	0	60727
3262	57994	381	133	189	0	58697
3263	57735	202	116	195	0	58248
3264	597	58959	170	104	0	59830
3265	350	366	137	59290	0	60143
3266	59862	202	159	484	0	60707
3267	472	59580	191	234	0	60477
3268	333	433	119	60069	0	60954
3269	61158	212	146	563	0	62079
3270	535	110	145	63442	0	64232
3271	371	107	120	62911	0	63509
3272	202	63405	199	671	0	64477
3273	63623	470	123	436	0	64652
3274	64821	269	141	248	0	65479
3275	65817	122	112	203	0	66254
3276	785	67273	189	131	0	68378
3277	68249	508	134	258	0	69149
3278	68357	267	114	237	0	68975
3279	835	158	91	67529	0	68613
3280	466	112	99	68105	0	68782
3281	285	222	67756	717	0	68980
3282	276	125	506	66329	0	67236
3283	293	149	268	66859	0	67569
3284	275	234	68132	685	0	69326
3285	57222	162	595	610	0	58589
3286	684	219	67745	171	0	68819
3287	467	264	67962	154	0	68847
3288	341	137	685	68119	0	69282
3289	252	126	288	68667	0	69333
3290	228	70146	198	695	0	71267
3291	69832	546	106	464	0	70948
3292	69049	271	114	291	0	69725
3293	819	69749	200	164	0	70932
3294	427	74578	179	221	0	75405
3295	384	904	99	72418	0	73805
3296	233	76482	205	588	0	77508
3297	76446	745	113	514	0	77818
3298	76308	369	129	327	0	77133
3299	1137	163	144	75479	0	76923
3300	559	141	128	76686	0	77514
3301	76100	103	116	1151	0	77470
3302	869	256	74629	458	0	76212
3303	73227	111	735	340	0	74413
3304	926	242	75009	199	0	76376
3305	71558	84	712	318	0	72672
3306	821	200	360	73886	0	75267
3307	496	226	75304	703	0	76729
3308	279	222	73850	398	0	74749
3309	71252	373	1332	295	0	73252
3310	73682	67	402	297	0	74448
3311	884	75848	216	184	0	77132
3312	458	604	79	78557	0	79698
3313	219	324	74	80401	0	81018
3314	79227	98	86	1297	0	80708
3315	861	78537	149	555	0	80102
3316	76925	745	77	321	0	78068
3317	830	76277	116	126	0	77349
3318	399	75540	134	164	0	76237
3319	75198	995	64	242	0	76499
3320	893	541	73966	83	0	75483
3321	529	150	729	73122	0	74530
3322	234	98	363	74562	0	75257
3323	197	208	74682	1121	0	76208
3324	218	71	753	73778	0	74820
3325	238	129	396	68553	0	69316
3326	133	75046	181	1108	0	76468
3327	74409	766	103	654	0	75932
3328	895	503	74937	220	0	76555
3329	71142	130	753	281	0	72306
3330	887	75264	485	200	0	76836
3331	536	784	130	76002	0	77452
3332	78213	401	94	1067	0	79775
3333	956	131	94	78561	0	79742
3334	590	97	86	79099	0	79872
3335	255	207	78405	1264	0	80131
3336	72554	82	853	714	0	74203
3337	77665	95	438	381	0	78579
3338	1326	216	77330	228	0	79100
3339	684	79	833	76462	0	78058
3340	290	227	77439	903	0	78859
3341	74311	90	885	690	0	75976
3342	78744	97	478	370	0	79689
3343	1338	86	169	78073	0	79666
3344	78187	95	124	1091	0	79497
3345	1051	220	82818	562	0	84651
3346	675	122	852	82452	0	84101
3347	339	98	489	83827	0	84753
3348	320	109	160	85876	0	86465
3349	263	121	136	85619	0	86139
3350	77822	98	143	1520	0	79583
3351	991	190	76971	673	0	78825
3352	592	83	862	77562	0	79099
3353	285	196	76707	1023	0	78211
3354	254	194	75380	634	0	76462
3355	250	99	1245	74838	0	76432
3356	252	113	520	76492	0	77377
3357	72969	82	198	1420	0	74669
3358	1003	97	159	73158	0	74417
3359	658	110	137	73331	0	74236
3360	316	93	123	74409	0	74941
3361	73130	92	140	1672	0	75034
3362	73391	101	142	846	0	74480
3363	74447	92	138	457	0	75134
3364	72863	77	144	406	0	73490
3365	1460	78656	249	251	0	80616
3366	753	1076	124	78633	0	80586
3367	424	593	132	80305	0	81454
3368	82272	160	127	1901	0	84460
3369	1359	87646	246	979	0	90230
3370	895	1442	122	91651	0	94110
3371	360	897	96861	1822	0	99940
3372	99067	191	1867	1274	0	102399
3373	2338	106133	1081	464	0	110016
3374	111747	2276	316	415	0	114754
3375	114497	1129	204	399	0	116229
3376	3948	281	150	111688	0	116067
3377	1648	272	110978	2807	0	115705
3378	688	116	2514	114148	0	117466
3379	114386	120	1255	3194	0	118955
3380	2956	111	345	114890	0	118302
3381	114543	99	182	3155	0	117979
3382	3010	112622	337	1626	0	117595
3383	117944	2653	182	750	0	121529
3384	3315	1318	190	117269	0	122092
3385	1841	363	167	124562	0	126933
3386	127617	191	176	4267	0	132251
3387	128253	168	158	2004	0	130583
3388	129571	148	133	840	0	130692
3389	129656	179	141	640	0	130616
3390	129213	160	152	630	0	130155
3391	4900	187	174	124622	0	129883
3392	2147	392	121143	3150	0	126832
3393	829	121768	2734	1873	0	127204
3394	118808	2690	1453	938	0	123889
3395	3240	1470	116182	479	0	121371
3396	115336	445	2695	599	0	119075
3397	3379	116268	1558	498	0	121703
3398	118949	2695	477	621	0	122742
3399	3601	1393	307	117441	0	122742
3400	2137	448	255	119651	0	122491
3401	1083	434	117360	4267	0	123144
3402	1018	267	2767	116953	0	121005
3403	977	416	119780	3401	0	124574
3404	931	420	120059	1874	0	123284
3405	119837	273	3939	1157	0	125206
3406	125877	396	1645	1054	0	128972
3407	4709	524	121579	868	0	127680
3408	119973	284	2771	1023	0	124051
3409	123989	294	1409	987	0	126679
3410	4974	463	119486	815	0	125738
3411	2552	117824	2845	823	0	124044
3412	2128	2668	1582	120774	0	127152
3413	125727	1322	675	3246	0	130970
3414	129841	575	474	2033	0	132923
3415	130768	433	426	1060	0	132687
3416	130631	388	516	897	0	132432
3417	130430	383	625	863	0	132301
3418	5127	644	124818	725	0	131314
3419	2813	649	128160	733	0	132355
3420	2074	637	3782	128111	0	134604
3421	131057	541	1806	3371	0	136775
3422	133134	437	803	2149	0	136523
3423	133167	458	670	1421	0	135716
3424	127910	417	704	1286	0	130317
3425	4641	125951	922	1277	0	132791
3426	2669	132808	932	1355	0	137764
3427	133334	3547	758	1325	0	138964
3428	134467	1504	773	1246	0	137990
3429	4914	132474	891	1104	0	139383
3430	135172	2644	649	1166	0	139631
3431	4423	1634	132398	912	0	139367
3432	3175	582	2877	130856	0	137490
3433	2251	647	133087	3140	0	139125
3434	2288	642	132597	1862	0	137389
3435	2374	486	3820	131092	0	137772
3436	2370	416	1775	137934	0	142495
3437	2327	612	138689	3945	0	145573
3438	2303	549	2915	134483	0	140250
3439	2335	485	1731	140166	0	144717
3440	139300	472	1076	4239	0	145087
3441	140296	458	934	2191	0	143879
3442	5348	548	903	137835	0	144634
3443	3263	709	137187	3128	0	144287
3444	2093	137071	3168	2226	0	144558
3445	134589	2689	1867	1355	0	140500
3446	4383	1652	137573	995	0	144603
3447	2932	133575	3239	1088	0	140834
3448	1991	141240	2197	1077	0	146505
3449	142290	3455	1193	1177	0	148115
3450	144756	1631	998	1078	0	148463
3451	5396	695	1016	141143	0	148250
3452	3181	895	146981	3084	0	154141
3453	2343	563	3337	147316	0	153559
3454	2272	536	2023	149743	0	154574
3455	2190	456	1310	151718	0	155674
3456	148412	524	1072	4550	0	154558
3457	4183	144717	1238	2332	0	152470
3458	2920	151855	1240	1230	0	157245
3459	2168	3868	1046	147544	0	154626
3460	1889	1739	962	152914	0	157504
3461	150301	682	944	4731	0	156658
3462	146422	512	907	2539	0	150380
3463	151616	455	852	1531	0	154454
3464	5460	147698	1203	1108	0	155469
3465	143836	2304	830	1148	0	148118
3466	4075	1990	821	140740	0	147626
3467	2798	814	138956	2916	0	145484
3468	1967	626	130121	1626	0	134340
3469	123496	454	3067	1199	0	128216
3470	2681	476	123239	645	0	127041
3471	1709	505	114943	501	0	117658
3472	103106	174	1577	548	0	105405
3473	1407	350	105992	350	0	108099
3474	811	314	102420	286	0	103831
3475	662	643	1158	97010	0	99473
3476	404	313	102901	728	0	104346
3477	368	170	724	98601	0	99863
3478	357	154	378	99939	0	100828
3479	368	282	103376	869	0	104895
3480	239	104633	712	520	0	106104
3481	104383	522	448	563	0	105916
3482	768	508	106856	195	0	108327
3483	417	353	104477	129	0	105376
3484	86964	158	828	433	0	88383
3485	604	294	99457	223	0	100578
3486	321	95887	579	240	0	97027
3487	260	92273	459	206	0	93198
3488	290	648	195	97912	0	99045
3489	206	337	134	97637	0	98314
3490	99528	122	106	1028	0	100784
3491	98659	86	118	628	0	99491
3492	99301	93	135	398	0	99927
3493	827	89	122	98842	0	99880
3494	99553	91	141	806	0	100591
3495	98382	127	156	597	0	99262
3496	816	238	99282	235	0	100571
3497	461	265	96529	201	0	97456
3498	228	100010	804	223	0	101265
3499	217	468	342	100613	0	101640
3500	101218	290	163	765	0	102436
3501	547	100114	278	430	0	101369
3502	390	487	151	101690	0	102718
3503	100375	266	142	784	0	101567
3504	97331	110	154	589	0	98184
3505	743	97945	270	265	0	99223
3506	97067	485	132	353	0	98037
3507	96737	296	145	445	0	97623
3508	819	119	150	96677	0	97765
3509	458	281	97993	541	0	99273
3510	227	95810	576	464	0	97077
3511	168	97212	395	246	0	98021
3512	92296	624	191	312	0	93423
3513	661	393	177	89677	0	90908
3514	437	297	89838	548	0	91120
3515	169	90559	575	400	0	91703
3516	90790	461	320	346	0	91917
3517	91325	305	123	373	0	92126
3518	799	336	92320	158	0	93613
3519	478	109	534	89346	0	90467
3520	281	113	329	96377	0	97100
3521	206	272	110082	916	0	111476
3522	110850	102	1128	690	0	112770
3523	138212	110	588	449	0	139359
3524	2745	130	302	153653	0	156830
3525	1175	156364	364	2753	0	160656
3526	780	2736	176	164053	0	167745
3527	451	1509	162600	3264	0	167824
3528	158374	485	3080	1734	0	163673
3529	3385	235	1415	166557	0	171592
3530	1666	398	165240	3302	0	170606
3531	157864	243	3188	1834	0	163129
3532	3404	181	1544	162621	0	167750
3533	1860	186	634	164957	0	167637
3534	162196	136	362	4672	0	167366
3535	3262	163173	617	2053	0	169105
3536	162510	3034	338	926	0	166808
3537	3964	1447	232	159851	0	165494
3538	160012	511	318	3625	0	164466
3539	3945	462	160055	1867	0	166329
3540	1882	161152	3369	1007	0	167410
3541	1066	3377	1621	162193	0	168257
3542	164060	1607	637	3786	0	170090
3543	3710	164240	639	2135	0	170724
3544	2287	3529	525	164913	0	171254
3545	167036	1676	453	4001	0	173166
3546	164699	752	491	2391	0	168333
3547	5736	497	495	159951	0	166679
3548	2825	662	158823	4246	0	166556
3549	1295	700	158943	2540	0	163478
3550	156262	429	5030	1523	0	163244
3551	4299	156743	2309	1158	0	164509
3552	2263	155706	1106	1092	0	160167
3553	152709	4647	770	1147	0	159273
3554	4106	156817	762	947	0	162632
3555	2491	3951	640	155283	0	162365
3556	1664	1909	549	160229	0	164351
3557	157257	1111	469	5522	0	164359
3558	156635	774	428	2848	0	160685
3559	157866	720	439	1533	0	160558
3560	6065	976	151655	1102	0	159798
3561	3243	584	3634	152008	0	159469
3562	1877	771	153590	4276	0	160514
3563	1585	777	152924	2454	0	157740
3564	1523	680	156914	1467	0	160584
3565	1616	682	5747	150882	0	158927
3566	1359	831	155494	4354	0	162038
3567	1464	831	158057	2469	0	162821
3568	1470	796	5748	154216	0	162230
3569	156440	695	2675	4670	0	164480
3570	4684	816	157175	2551	0	165226
3571	2951	771	4458	154000	0	162180
3572	2005	741	2435	159531	0	164712
3573	1542	967	157611	5990	0	166110
3574	1835	793	4342	156650	0	163620
3575	1615	948	160193	5016	0	167772
3576	1779	780	4636	156467	0	163662
3577	1670	752	2501	159610	0	164533
3578	1614	664	1440	160940	0	164658
3579	1620	571	1271	159965	0	163427
3580	152992	546	1354	6741	0	161633
3581	154610	564	1351	3507	0	160032
3582	6102	690	151160	2078	0	160030
3583	3039	148047	4878	2311	0	158275
3584	1731	3838	153291	1665	0	160525
3585	1468	1925	153468	1670	0	158531
3586	146898	768	6402	1595	0	155663
3587	4489	151192	3661	1780	0	161122
3588	151987	3907	2103	1802	0	159799
3589	4804	153385	2225	1530	0	161944
3590	153745	4280	1852	1754	0	161631
3591	156474	2051	1700	1750	0	161975
3592	6598	984	1611	149981	0	159174
3593	3041	153020	1724	5230	0	163015
3594	2060	4119	1260	155252	0	162691
3595	1614	2168	1388	158436	0	163606
3596	1455	993	155731	7075	0	165254
3597	1328	156381	5139	3896	0	166744
3598	1528	4167	2866	157064	0	165625
3599	156732	2126	1792	5793	0	166443
3600	163315	925	1540	3650	0	169430
3601	164316	718	1478	2462	0	168974
3602	6839	159656	1823	2100	0	170418
3603	164014	4519	1288	1983	0	171804
3604	5739	169378	1727	1612	0	178456
3605	3659	5226	1359	171935	0	182179
3606	2220	2797	171292	5576	0	181885
3607	1942	1318	5485	167084	0	175829
3608	1645	170392	3375	5740	0	181152
3609	1738	5219	1638	170475	0	179070
3610	1717	2991	1228	170282	0	176218
3611	1440	171252	1453	7469	0	181614
3612	172001	5361	1170	3953	0	182485
3613	5980	2922	1102	171787	0	181791
3614	3336	1641	168839	6233	0	180049
3615	2406	1130	5196	170226	0	178958
3616	2023	1091	2870	175229	0	181213
3617	1601	1382	171589	8086	0	182658
3618	2003	1325	5445	156014	0	164787
3619	1454	167787	3295	6391	0	178927
3620	2084	5336	166570	3554	0	177544
3621	2752	2723	153897	1976	0	161348
3622	1155	143822	6389	1691	0	153057
3623	917	124801	2657	1246	0	129621
3624	678	110944	1243	892	0	113757
3625	102479	3890	2643	1059	0	110071
3626	98876	1496	832	800	0	102004
3627	99081	606	431	800	0	100918
3628	3767	431	476	96492	0	101166
3629	1538	641	94609	2779	0	99567
3630	835	533	2446	94344	0	98158
3631	702	456	1314	95793	0	98265
3632	93918	438	534	3848	0	98738
3633	94566	471	459	1859	0	97355
3634	3416	93988	524	960	0	98888
3635	94768	2420	417	901	0	98506
3636	95800	1253	484	898	0	98435
3637	98297	611	446	1015	0	100369
3638	3740	557	94479	808	0	99584
3639	1594	534	94092	680	0	96900
3640	862	716	3249	91215	0	96042
3641	605	542	92496	2515	0	96158
3642	87417	501	2406	1477	0	91801
3643	90338	460	1314	795	0	92907
3644	3246	506	86965	492	0	91209
3645	84632	370	2035	580	0	87617
3646	2338	85914	1284	464	0	90000
3647	87195	2078	564	567	0	90404
3648	2506	1226	375	85198	0	89305
3649	1560	515	328	82162	0	84565
3650	738	84926	426	2834	0	88924
3651	84936	2058	352	1441	0	88787
3652	85388	1207	346	714	0	87655
3653	2976	84959	438	572	0	88945
3654	1682	2119	283	81943	0	86027
3655	912	1294	318	81913	0	84437
3656	651	82255	436	2946	0	86288
3657	847	2100	373	82212	0	85532
3658	837	1274	362	83787	0	86260
3659	81350	594	338	3132	0	85414
3660	82286	426	351	1620	0	84683
3661	3143	517	80514	807	0	84981
3662	79526	415	2030	774	0	82745
3663	2492	526	80568	631	0	84217
3664	1639	535	2114	78419	0	82707
3665	826	460	79226	2313	0	82825
3666	683	77527	2224	1527	0	81961
3667	966	2146	1313	75113	0	79538
3668	851	1068	490	77108	0	79517
3669	75496	482	369	2766	0	79113
3670	2309	378	357	75046	0	78090
3671	1393	510	73146	2195	0	77244
3672	73603	408	1876	1390	0	77277
3673	75996	387	1109	827	0	78319
3674	77574	471	477	642	0	79164
3675	76464	414	364	712	0	77954
3676	3356	346	358	79204	0	83264
3677	1749	359	317	82158	0	84583
3678	1000	358	330	86203	0	87891
3679	863	310	389	86859	0	88421
3680	83770	299	398	3812	0	88279
3681	84687	291	377	1846	0	87201
3682	3756	276	369	76003	0	80404
3683	1764	80491	535	2379	0	85169
3684	81192	2189	539	1540	0	85460
3685	2714	1357	80241	798	0	85110
3686	1626	80724	2439	693	0	85482
3687	76704	2133	1190	606	0	80633
3688	2379	78383	572	523	0	81857
3689	1491	2216	77861	524	0	82092
3690	78012	1132	2130	585	0	81859
3691	79819	437	1180	539	0	81975
3692	3432	441	77531	585	0	81989
3693	1885	283	2165	78580	0	82913
3694	1089	242	1178	78072	0	80581
3695	819	78349	629	3223	0	83020
3696	1007	2108	345	77853	0	81313
3697	74346	1132	308	2609	0	78395
3698	2432	75018	488	1572	0	79510
3699	1588	1891	247	71113	0	74839
3700	867	1042	227	72212	0	74348
3701	665	475	69430	3028	0	73598
3702	654	69553	1996	1466	0	73669
3703	64254	1889	1000	747	0	67890
3704	1780	58087	365	481	0	60713
3705	1008	57277	269	378	0	58932
3706	56377	1970	438	420	0	59205
3707	1765	839	246	55248	0	58098
3708	1006	322	228	56770	0	58326
3709	55986	201	162	2232	0	58581
3710	1770	232	187	57299	0	59488
3711	1125	205	169	58301	0	59800
3712	58497	185	132	2422	0	61236
3713	1836	207	175	56256	0	58474
3714	1031	56598	247	1734	0	59610
3715	56798	1470	143	1026	0	59437
3716	1767	859	54679	523	0	57828
3717	957	52130	1441	486	0	55014
3718	518	1447	729	50676	0	53370
3719	323	774	50111	1525	0	52733
3720	330	351	50315	869	0	51865
3721	556	1071	1833	47195	0	50655
3722	47644	149	848	1419	0	50060
3723	1305	156	225	47421	0	49107
3724	846	156	138	48375	0	49515
3725	427	176	142	49101	0	49846
3726	331	191	159	49143	0	49824
3727	324	198	147	49479	0	50148
3728	342	236	46639	1861	0	49078
3729	307	235	46441	926	0	47909
3730	351	176	1638	46572	0	48737
3731	336	216	46737	1349	0	48638
3732	278	46612	1286	947	0	49123
3733	336	1194	701	46876	0	49107
3734	316	703	45933	1380	0	48332
3735	40831	263	1195	982	0	43271
3736	1185	44494	685	521	0	46885
3737	669	42612	287	455	0	44023
3738	333	44023	217	426	0	44999
3739	439	1659	185	42252	0	44535
3740	42347	676	147	1326	0	44496
3741	1201	269	165	42821	0	44456
3742	41674	238	171	1396	0	43479
3743	1168	40778	214	898	0	43058
3744	42154	1119	189	522	0	43984
3745	1286	689	146	41966	0	44087
3746	810	326	166	41948	0	43250
3747	354	41490	227	1676	0	43747
3748	357	1086	149	42460	0	44052
3749	331	661	164	43185	0	44341
3750	342	289	174	43365	0	44170
3751	41607	203	184	1947	0	43941
3752	40908	181	201	1057	0	42347
3753	1592	282	41079	541	0	43494
3754	40853	223	1069	555	0	42700
3755	1262	296	42014	485	0	44057
3756	795	230	1156	41270	0	43451
3757	427	228	637	42652	0	43944
3758	327	243	289	43285	0	44144
3759	252	269	41492	1853	0	43866
3760	302	249	1128	42080	0	43759
3761	245	284	42578	1459	0	44566
3762	286	218	1184	42776	0	44464
3763	42308	194	685	1527	0	44714
3764	1156	297	42282	977	0	44712
3765	41980	242	1098	647	0	43967
3766	1272	186	623	42854	0	44935
3767	42729	177	290	1482	0	44678
3768	1157	42310	299	997	0	44763
3769	778	1057	213	43078	0	45126
3770	342	698	44844	1441	0	47325
3771	375	399	1138	44823	0	46735
3772	351	788	660	43258	0	45057
3773	281	43906	329	1709	0	46225
3774	353	1079	43202	901	0	45535
3775	245	43323	1032	558	0	45158
3776	37239	849	539	461	0	39088
3777	741	38339	251	372	0	39703
3778	35067	593	322	285	0	36267
3779	35131	336	134	257	0	35858
3780	35314	113	102	230	0	35759
3781	982	91	94	35054	0	36221
3782	441	118	34721	728	0	36008
3783	169	106	617	33694	0	34586
3784	131	34807	370	751	0	36059
3785	162	608	134	35332	0	36236
3786	34356	325	121	772	0	35574
3787	572	34796	153	444	0	35965
3788	369	552	105	33799	0	34825
3789	166	306	105	34193	0	34770
3790	33440	130	122	974	0	34666
3791	634	133	33445	460	0	34672
3792	357	32644	640	260	0	33901
3793	181	507	259	31246	0	32193
3794	118	267	30966	497	0	31848
3795	108	147	457	29781	0	30493
3796	72	30814	271	525	0	31682
3797	162	487	118	32159	0	32926
3798	111	234	87	31847	0	32279
3799	87	90	59	31968	0	32204
3800	84	91	31020	726	0	31921
3801	29071	73	478	392	0	30014
3802	520	63	230	32914	0	33727
3803	35861	67	96	702	0	36726
3804	36708	61	78	412	0	37259
3805	37165	78	42	195	0	37480
3806	36898	62	70	197	0	37227
3807	37520	48	61	173	0	37802
3808	980	75	54	36334	0	37443
3809	384	35659	97	627	0	36767
3810	199	504	44	34543	0	35290
3811	76	34585	82	582	0	35325
3812	91	472	43	32941	0	33547
3813	32807	212	40	530	0	33589
3814	480	80	28	32637	0	33225
3815	237	99	32207	506	0	33049
3816	29907	40	385	302	0	30634
3817	439	32394	224	141	0	33198
3818	32923	384	102	126	0	33535
3819	32794	196	40	146	0	33176
3820	31855	74	71	119	0	32119
3821	584	33423	69	85	0	34161
3822	308	364	48	33454	0	34174
3823	146	188	23	33870	0	34227
3824	97	132	33505	564	0	34298
3825	148	51	375	31556	0	32130
3826	146	49	179	32487	0	32861
3827	138	37	75	33316	0	33566
3828	92	33482	82	615	0	34271
3829	33804	397	42	330	0	34573
3830	32323	214	34	181	0	32752
3831	591	153	33967	95	0	34806
3832	312	34136	398	118	0	34964
3833	212	393	222	34933	0	35760
3834	169	211	70	35639	0	36089
3835	149	110	53	35669	0	35981
3836	153	58	55	36290	0	36556
3837	152	54	43	36747	0	36996
3838	118	114	35514	730	0	36476
3839	106	131	33370	373	0	33980
3840	35561	65	599	246	0	36471
3841	38175	85	266	179	0	38705
3842	38550	54	115	170	0	38889
3843	856	77	68	38426	0	39427
3844	397	99	37681	604	0	38781
3845	37132	46	536	392	0	38106
3846	38839	65	269	253	0	39426
3847	826	125	37481	147	0	38579
3848	36827	58	555	173	0	37613
3849	774	115	41740	146	0	42775
3850	451	60	621	41740	0	42872
3851	209	134	42559	667	0	43569
3852	40559	53	668	444	0	41724
3853	42794	68	346	260	0	43468
3854	42981	55	168	226	0	43430
3855	42934	51	88	277	0	43350
3856	978	103	44809	168	0	46058
3857	445	44809	647	227	0	46128
3858	45888	600	319	204	0	47011
3859	45990	305	148	209	0	46652
3860	987	167	46152	110	0	47416
3861	520	82	633	44346	0	45581
3862	282	70	330	46832	0	47514
3863	189	122	46046	936	0	47293
3864	42183	73	676	524	0	43456
3865	46581	54	341	318	0	47294
3866	962	46580	218	207	0	47967
3867	48634	614	129	284	0	49661
3868	48998	303	119	241	0	49661
3869	49142	137	145	172	0	49596
3870	47180	91	158	203	0	47632
3871	1218	136	45662	135	0	47151
3872	44373	51	669	195	0	45288
3873	948	259	354	45122	0	46683
3874	532	46700	253	634	0	48119
3875	354	635	45662	395	0	47046
3876	250	46546	705	197	0	47698
3877	313	762	368	44401	0	45844
3878	208	346	45675	543	0	46772
3879	41459	130	610	379	0	42578
3880	674	136	45380	192	0	46382
3881	44350	63	654	153	0	45220
3882	764	54	335	45291	0	46444
3883	472	61	180	45364	0	46077
3884	273	44765	152	788	0	45978
3885	228	46281	192	373	0	47074
3886	239	729	117	47216	0	48301
3887	46506	327	99	639	0	47571
3888	46421	146	100	368	0	47035
3889	46377	85	90	242	0	46794
3890	987	120	46605	142	0	47854
3891	45115	69	573	213	0	45970
3892	783	105	48749	140	0	49777
3893	475	96	46170	107	0	46848
3894	46823	109	843	141	0	47916
3895	49344	61	406	156	0	49967
3896	885	139	49034	106	0	50164
3897	523	60	609	47273	0	48465
3898	362	62	338	50061	0	50823
3899	49883	64	191	773	0	50911
3900	48872	47	170	436	0	49525
3901	875	120	52619	225	0	53839
3902	410	51168	517	175	0	52270
3903	207	49567	295	100	0	50169
3904	49290	502	158	150	0	50100
3905	574	234	118	48942	0	49868
3906	398	91	73	49796	0	50358
3907	237	75	81	50945	0	51338
3908	42526	84	121	750	0	43481
3909	573	80	79	51044	0	51776
3910	51137	70	96	534	0	51837
3911	52639	48	104	338	0	53129
3912	783	55735	147	187	0	56852
3913	492	454	99	60496	0	61541
3914	297	327	60846	597	0	62067
3915	57911	133	619	428	0	59091
3916	60528	68	413	249	0	61258
3917	61045	68	194	196	0	61503
3918	1094	134	62713	140	0	64081
3919	617	80	683	62822	0	64202
3920	64241	59	395	754	0	65449
3921	61428	69	214	475	0	62186
3922	61825	73	129	270	0	62297
3923	1113	61271	167	180	0	62731
3924	610	63649	169	194	0	64622
3925	431	832	110	65108	0	66481
3926	346	440	108	64591	0	65485
3927	290	64849	141	921	0	66201
3928	64342	643	132	533	0	65650
3929	801	486	65654	241	0	67182
3930	567	184	615	65723	0	67089
3931	355	150	377	66110	0	66992
3932	273	216	65374	978	0	66841
3933	60290	132	683	618	0	61723
3934	66268	110	435	329	0	67142
3935	1086	65381	260	231	0	66958
3936	65653	573	163	282	0	66671
3937	907	506	68235	173	0	69821
3938	68740	158	665	360	0	69923
3939	957	196	71190	149	0	72492
3940	69484	178	798	241	0	70701
3941	72274	89	419	292	0	73074
3942	72844	83	264	221	0	73412
3943	72350	76	167	222	0	72815
3944	1072	71529	232	168	0	73001
3945	73259	511	131	261	0	74162
3946	74767	336	133	253	0	75489
3947	1098	261	74189	148	0	75696
3948	73818	131	492	197	0	74638
3949	807	142	321	72802	0	74072
3950	566	187	72323	611	0	73687
3951	71615	117	568	412	0	72712
3952	846	102	354	73428	0	74730
3953	75079	96	206	757	0	76138
3954	80709	116	140	793	0	81758
3955	1038	207	85021	256	0	86522
3956	83432	79	597	327	0	84435
3957	85979	100	391	313	0	86783
3958	86355	103	194	293	0	86945
3959	87438	82	176	280	0	87976
3960	1226	85	200	84632	0	86143
3961	744	85557	257	609	0	87167
3962	84153	561	194	530	0	85438
3963	86443	354	167	320	0	87284
3964	87265	164	157	267	0	87853
3965	1254	172	86303	197	0	87926
3966	735	85820	657	216	0	87428
3967	614	585	436	86108	0	87743
3968	593	333	227	86877	0	88030
3969	570	266	88992	857	0	90685
3970	600	115	752	87548	0	89015
3971	489	240	89747	877	0	91353
3972	516	149	875	88359	0	89899
3973	543	111	449	89914	0	91017
3974	493	257	90118	1176	0	92044
3975	84198	170	846	769	0	85983
3976	91468	156	499	550	0	92673
3977	1354	296	92557	324	0	94531
3978	89585	160	841	441	0	91027
3979	93050	115	528	402	0	94095
3980	1472	254	96865	240	0	98831
3981	974	147	886	94816	0	96823
3982	594	130	549	97514	0	98787
3983	97835	98	339	1325	0	99597
3984	1176	100122	321	755	0	102374
3985	95211	800	332	506	0	96849
3986	99772	429	236	392	0	100829
3987	1487	102278	304	291	0	104360
3988	103610	838	233	365	0	105046
3989	103335	518	211	311	0	104375
3990	1579	102044	301	296	0	104220
3991	1023	840	233	102637	0	104733
3992	662	103808	285	907	0	105662
3993	677	962	244	104362	0	106245
3994	672	649	103599	1040	0	105960
3995	603	388	102450	611	0	104052
3996	100073	202	1295	588	0	102158
3997	105047	221	648	451	0	106367
3998	1642	341	105470	312	0	107765
3999	103798	150	1066	426	0	105440
4000	107577	131	669	444	0	108821
4001	104552	122	421	436	0	105531
4002	1760	106602	426	307	0	109095
4003	1093	858	319	109188	0	111458
4004	109568	467	306	1219	0	111560
4005	108483	195	302	823	0	109803
4006	1788	337	110775	424	0	113324
4007	1125	192	983	108515	0	110815
4008	805	213	596	110311	0	111925
4009	637	110864	414	1362	0	113277
4010	689	118194	332	819	0	120034
4011	711	2098	259	112151	0	115219
4012	494	115563	330	1289	0	117676
4013	111328	1212	208	748	0	113496
4014	1423	115896	286	341	0	117946
4015	117660	1380	166	465	0	119671
4016	1759	763	118256	197	0	120975
4017	118985	295	1419	404	0	121103
4018	124909	153	673	345	0	126080
4019	124519	141	267	323	0	125250
4020	122825	182	181	405	0	123593
4021	2485	121794	255	316	0	124850
4022	1199	1511	165	123806	0	126681
4023	673	753	161	124584	0	126171
4024	507	490	122697	2314	0	126008
4025	525	247	1573	119777	0	122122
4026	487	195	795	123973	0	125450
4027	123969	170	298	2609	0	127046
4028	1803	125540	342	1155	0	128840
4029	1189	1645	213	126716	0	129763
4030	730	843	208	129155	0	130936
4031	575	374	200	130644	0	131793
4032	128577	301	249	2888	0	132015
4033	2125	228	200	129555	0	132108
4034	130402	220	247	2437	0	133306
4035	2310	212	294	130879	0	133695
4036	1376	203	242	132607	0	134428
4037	860	324	124408	2776	0	128368
4038	111803	317	1832	1570	0	115522
4039	2270	123623	1037	677	0	127607
4040	127554	1788	379	717	0	130438
4041	2417	920	263	125759	0	129359
4042	1490	364	213	127595	0	129662
4043	130145	284	207	3030	0	133666
4044	133258	268	209	1558	0	135293
4045	3387	356	158	138800	0	142701
4046	1568	386	139854	2661	0	144469
4047	873	362	138358	1516	0	141109
4048	554	144250	3098	929	0	148831
4049	146002	2358	1415	857	0	150632
4050	145111	1238	432	759	0	147540
4051	3699	556	235	143313	0	147803
4052	1695	148742	349	2661	0	153447
4053	952	2526	204	149992	0	153674
4054	820	1284	206	142939	0	145249
4055	673	136346	416	3714	0	141149
4056	136950	2456	297	1936	0	141639
4057	3008	1363	313	135629	0	140313
4058	1700	138790	461	2771	0	143722
4059	942	145958	446	1596	0	148942
4060	144983	3349	323	1053	0	149708
4061	3173	1627	144180	713	0	149693
4062	144048	711	2458	805	0	148022
4063	3413	559	1247	146164	0	151383
4064	1933	538	487	145902	0	148860
4065	1080	146528	460	4002	0	152070
4066	1203	2890	343	148161	0	152597
4067	1168	1602	147045	3340	0	153155
4068	929	144381	2669	2135	0	150114
4069	827	148072	1415	1146	0	151460
4070	144650	3534	534	1098	0	149816
4071	2796	147549	548	998	0	151891
4072	1811	2871	380	146347	0	151409
4073	1027	148559	450	3135	0	153171
4074	1166	2885	285	149051	0	153387
4075	1119	1608	285	150548	0	153560
4076	924	1030	144927	4409	0	151290
4077	953	730	2543	143982	0	148208
4078	973	692	1380	147207	0	150252
4079	143178	722	716	4420	0	149036
4080	3295	874	142019	2349	0	148537
4081	2253	707	2522	145478	0	150960
4082	1358	822	145415	3704	0	151299
4083	141312	740	2926	2598	0	147576
4084	3239	147011	1638	1867	0	153755
4085	154969	3105	773	1870	0	160717
4086	3915	1712	609	158276	0	164512
4087	2400	1031	477	159450	0	163358
4088	1360	1037	155765	5312	0	163474
4089	139856	872	3122	3268	0	147118
4090	3588	157649	1757	1867	0	164861
4091	149064	3651	739	1699	0	155153
4092	4181	2052	654	153943	0	160830
4093	2394	156602	739	4005	0	163740
4094	154899	3549	608	2791	0	161847
4095	3779	158911	685	1811	0	165186
4096	2365	3796	555	158901	0	165617
4097	1540	2057	546	161746	0	165889
4098	1313	1159	711	160548	0	163731
4099	1144	156778	847	5603	0	164372
4100	1321	3616	658	159397	0	164992
4101	1397	2188	559	161640	0	165784
4102	155421	1334	560	5628	0	162943
4103	156828	1165	579	3196	0	161768
4104	157804	1149	578	2023	0	161554
4105	5462	1283	154381	1747	0	162873
4106	154517	1150	3300	1886	0	160853
4107	158275	1147	1800	1843	0	163065
4108	152904	1130	937	1996	0	156967
4109	5208	1286	141372	1828	0	149694
4110	145277	1054	2468	1680	0	150479
4111	4048	901	1434	148967	0	155350
4112	2330	1140	146352	3871	0	153693
4113	1387	145489	3066	2539	0	152481
4114	1380	4171	1525	136645	0	143721
4115	1026	138107	958	3312	0	143403
4116	1098	140938	746	2152	0	144934
4117	134842	3393	875	1459	0	140569
4118	2902	1661	588	134479	0	139630
4119	135666	792	573	3254	0	140285
4120	3101	760	475	135881	0	140217
4121	135212	839	466	3144	0	139661
4122	3220	823	401	135049	0	139493
4123	134671	768	425	3413	0	139277
4124	3024	944	129824	1881	0	135673
4125	1995	906	2312	130622	0	135835
4126	1270	965	132666	2933	0	137834
4127	1130	860	126974	1901	0	130865
4128	1034	861	131781	1349	0	135025
4129	1150	872	3073	127351	0	132446
4130	902	842	129525	3067	0	134336
4131	126467	560	2354	2027	0	131408
4132	2683	624	1199	128818	0	133324
4133	1619	750	130837	3013	0	136219
4134	1270	502	2176	130396	0	134344
4135	1208	541	1186	131841	0	134776
4136	1167	716	136759	3532	0	142174
4137	1233	510	2308	136585	0	140636
4138	1336	476	1294	134157	0	137263
4139	1224	139057	849	3242	0	144372
4140	139011	2068	609	1842	0	143530
4141	139657	1129	674	1333	0	142793
4142	3393	782	135953	1102	0	141230
4143	130373	420	2044	1182	0	134019
4144	2459	579	127866	1041	0	131945
4145	1397	478	119731	771	0	122377
4146	858	533	120150	803	0	122344
4147	1304	1756	2422	113411	0	118893
4148	699	503	116925	1848	0	119975
4149	654	391	1555	114007	0	116607
4150	709	250	837	116284	0	118080
4151	707	215	436	116181	0	117539
4152	764	272	396	115317	0	116749
4153	113358	279	377	2402	0	116416
4154	113406	246	400	1398	0	115450
4155	2058	116191	554	1018	0	119821
4156	1109	1342	418	116758	0	119627
4157	702	924	118498	1721	0	121845
4158	611	117369	1802	1149	0	120931
4159	756	1818	999	119685	0	123258
4160	595	986	121001	2010	0	124592
4161	611	333	1897	118207	0	121048
4162	479	421	120207	2083	0	123190
4163	504	427	118416	1122	0	120469
4164	559	268	2391	119204	0	122422
4165	552	224	1035	120706	0	122517
4166	119296	159	507	2853	0	122815
4167	1960	163	391	118479	0	120993
4168	116553	182	399	2336	0	119470
4169	1816	116008	471	1321	0	119616
4170	1005	119667	488	761	0	121921
4171	641	2235	363	120259	0	123498
4172	120799	845	369	2070	0	124083
4173	1909	120930	522	1211	0	124572
4174	1188	1722	416	123258	0	126584
4175	129572	777	417	2300	0	133066
4176	130966	272	400	1327	0	132965
4177	130052	194	462	820	0	131528
4178	129967	162	485	770	0	131384
4179	133842	189	502	777	0	135310
4180	2781	331	128495	619	0	132226
4181	1265	317	125747	524	0	127853
4182	464	126464	2380	580	0	129888
4183	766	1854	1275	125122	0	129017
4184	401	876	129941	1731	0	132949
4185	365	405	124559	867	0	126196
4186	406	680	2072	120070	0	123228
4187	287	322	132496	1550	0	134655
4188	309	333	132022	863	0	133527
4189	186	163067	2453	553	0	166259
4190	162149	2698	1025	570	0	166442
4191	2545	174892	493	476	0	178406
4192	1466	3121	298	169998	0	174883
4193	180838	1212	270	3069	0	185389
4194	3139	184160	447	1481	0	189227
4195	1569	3244	279	181266	0	186358
4196	559	1490	184609	3261	0	189919
4197	185189	409	3235	1636	0	190469
4198	192033	242	1340	706	0	194321
4199	195329	231	429	565	0	196554
4200	5187	288	271	193244	0	198990
4201	1879	431	193512	3783	0	199605
4202	569	192485	3765	1750	0	198569
4203	716	3603	1487	190570	0	196376
4204	190793	1429	534	3802	0	196558
4205	3748	671	192955	1514	0	198888
4206	1631	184944	3873	849	0	191297
4207	792	3627	191179	471	0	196069
4208	188388	1441	3823	687	0	194339
4209	198040	491	1645	632	0	200808
4210	197699	327	653	683	0	199362
4211	5333	539	191124	502	0	197498
4212	1994	187820	3870	581	0	194265
4213	1101	3627	1725	189989	0	196442
4214	910	1595	752	194407	0	197664
4215	969	590	565	193375	0	195499
4216	718	649	188384	5232	0	194983
4217	182561	387	3890	2368	0	189206
4218	4158	614	192160	896	0	197828
4219	193847	444	4059	926	0	199276
4220	199383	483	1811	874	0	202551
4221	200556	488	748	899	0	202691
4222	194310	538	677	923	0	196448
4223	5676	697	194220	580	0	201173
4224	2671	638	4014	193156	0	200479
4225	1295	805	192722	4149	0	198971
4226	1215	187866	4225	2184	0	195490
4227	1102	196426	2106	1007	0	200641
4228	196760	5219	876	1086	0	203941
4229	191232	2242	894	986	0	195354
4230	5639	197135	1044	1098	0	204916
4231	200095	4234	853	1109	0	206291
4232	5455	2411	164996	982	0	173844
4233	193534	972	3198	1177	0	198881
4234	5063	199678	2091	915	0	207747
4235	205626	4333	952	1080	0	211991
4236	200903	2252	953	1088	0	205196
4237	7044	948	982	194952	0	203926
4238	3601	870	1044	198911	0	204426
4239	195142	911	1134	6136	0	203323
4240	5603	908	1049	195747	0	203307
4241	196250	786	1177	5213	0	203426
4242	6070	800	1032	196424	0	204326
4243	195310	783	1299	5094	0	202486
4244	193803	832	1162	2710	0	198507
4245	6730	190269	1534	1327	0	199860
4246	3357	196464	1497	1173	0	202491
4247	188075	5951	1288	1297	0	196611
4248	5145	193379	1513	1238	0	201275
4249	3546	5084	1275	188806	0	198711
4250	2562	2433	1278	193296	0	199569
4251	185591	1484	1213	6460	0	194748
4252	5289	187707	1586	3082	0	197664
4253	3510	185148	1501	1711	0	191870
4254	2314	187470	1711	1588	0	193083
4255	2769	6022	179268	1500	0	189559
4256	2560	2992	180702	1352	0	187606
4257	2946	1776	182566	1426	0	188714
4258	2987	3039	6044	156243	0	168313
4259	2597	174472	2795	3993	0	183857
4260	176139	4357	1256	2668	0	184420
4261	5678	2589	173525	1609	0	183401
4262	3724	1484	173012	1807	0	180027
4263	2696	1240	178638	1458	0	184032
4264	3069	1236	5835	172733	0	182873
4265	3063	1075	2755	177566	0	184459
4266	3198	1177	1455	179528	0	185358
4267	177175	1155	1424	5838	0	185592
4268	178112	1357	1515	2759	0	183743
4269	179866	1308	1374	1658	0	184206
4270	7168	1222	1465	172533	0	182388
4271	3698	1357	168347	4355	0	177757
4272	2510	1589	172678	2364	0	179141
4273	2845	1038	5430	170167	0	179480
4274	2742	1081	2603	170147	0	176573
4275	165404	1049	1399	5657	0	173509
4276	5558	163426	1478	2882	0	173344
4277	164308	3862	1142	1759	0	171071
4278	5491	162528	1582	1714	0	171315
4279	3808	4170	999	160994	0	169971
4280	2440	2189	160596	4971	0	170196
4281	2655	1363	4019	160325	0	168362
4282	160996	1004	2010	5188	0	169198
4283	5314	999	158951	2729	0	167993
4284	152339	910	3883	1683	0	158815
4285	5601	1030	151773	1252	0	159656
4286	3939	1160	147726	1044	0	153869
4287	135492	877	4422	1282	0	142073
4288	5005	939	138528	1174	0	145646
4289	1965	583	105331	644	0	108523
4290	1751	103629	4102	780	0	110262
4291	94077	1799	3569	957	0	100402
4292	90661	707	827	590	0	92785
4293	90217	316	422	550	0	91505
4294	1844	406	85658	367	0	88275
4295	81323	227	1197	425	0	83172
4296	1322	84262	694	347	0	86625
4297	81447	1044	258	380	0	83129
4298	1319	640	81182	254	0	83395
4299	927	1250	996	76028	0	79201
4300	328	271	76357	853	0	77809
4301	250	76480	891	525	0	78146
4302	390	743	772	74398	0	76303
4303	349	380	205	76143	0	77077
4304	77451	149	177	1221	0	78998
4305	77395	116	173	642	0	78326
4306	77300	115	210	396	0	78021
4307	77174	127	207	343	0	77851
4308	75963	126	191	348	0	76628
4309	1287	235	75367	214	0	77103
4310	693	84	808	74295	0	75880
4311	369	231	78429	753	0	79782
4312	356	117	880	77851	0	79204
4313	78809	102	519	1016	0	80446
4314	80019	105	259	634	0	81017
4315	80436	126	217	351	0	81130
4316	80897	133	228	318	0	81576
4317	1453	206	82182	178	0	84019
4318	746	179	1006	81352	0	83283
4319	430	250	81843	1060	0	83583
4320	334	82880	1097	660	0	84971
4321	335	83379	725	326	0	84765
4322	488	1505	343	79048	0	81384
4323	364	622	250	87606	0	88842
4324	412	183	226	88763	0	89584
4325	373	114	246	93278	0	94011
4326	90857	97	207	2221	0	93382
4327	1471	90556	326	996	0	93349
4328	87968	1240	162	471	0	89841
4329	1612	685	166	86958	0	89421
4330	976	199	153	84486	0	85814
4331	369	86677	286	1830	0	89162
4332	442	1293	152	87377	0	89264
4333	85709	669	150	1552	0	88080
4334	1452	82445	220	856	0	84973
4335	771	80911	219	319	0	82220
4336	80187	1720	114	335	0	82356
4337	1450	747	126	80066	0	82389
4338	816	80352	235	1354	0	82757
4339	469	1270	180	81621	0	83540
4340	80887	682	171	1641	0	83381
4341	1454	205	149	81336	0	83144
4342	896	166	124	81772	0	82958
4343	80096	138	140	2175	0	82549
4344	1495	133	125	80409	0	82162
4345	882	80249	243	1538	0	82912
4346	513	1295	128	80070	0	82006
4347	323	80093	232	1549	0	82197
4348	368	1437	117	80613	0	82535
4349	79696	739	126	1702	0	82263
4350	80848	305	136	1033	0	82322
4351	2156	218	95	81000	0	83469
4352	1002	299	79355	1505	0	82161
4353	76531	227	1281	1075	0	79114
4354	1547	293	79823	444	0	82107
4355	78337	181	1387	469	0	80374
4356	80260	188	726	480	0	81654
4357	2191	304	77623	369	0	80487
4358	968	76901	1364	401	0	79634
4359	76973	1321	767	479	0	79540
4360	77162	765	201	580	0	78708
4361	1995	399	78747	370	0	81511
4362	78147	245	1274	478	0	80144
4363	78108	213	647	527	0	79495
4364	78629	239	186	451	0	79505
4365	2167	167	106	76976	0	79416
4366	1122	203	126	77355	0	78806
4367	432	77492	188	2070	0	80182
4368	521	1311	106	80000	0	81938
4369	478	795	109	80410	0	81792
4370	397	378	78307	2188	0	81270
4371	421	321	75563	1108	0	77413
4372	70464	210	1931	627	0	73232
4373	75708	223	849	494	0	77274
4374	2136	75167	394	482	0	78179
4375	1194	1404	179	75572	0	78349
4376	577	973	76468	1631	0	79649
4377	544	354	1377	77389	0	79664
4378	535	246	799	78786	0	80366
4379	499	252	252	80428	0	81431
4380	417	79943	285	2519	0	83164
4381	600	1553	152	81779	0	84084
4382	554	936	144	83725	0	85359
4383	489	397	81895	2566	0	85347
4384	472	391	82202	1319	0	84384
4385	77956	257	2267	698	0	81178
4386	82616	242	1013	601	0	84472
4387	2599	239	334	87073	0	90245
4388	1322	290	245	85771	0	87628
4389	670	243	260	87778	0	88951
4390	549	333	82329	3340	0	86551
4391	483	80410	2082	1845	0	84820
4392	519	2083	81488	739	0	84829
4393	79468	1122	2219	623	0	83432
4394	2360	491	82346	594	0	85791
4395	81626	287	2221	613	0	84747
4396	81533	247	1182	656	0	83618
4397	84054	270	430	640	0	85394
4398	3385	236	325	82061	0	86007
4399	1611	353	81546	2429	0	85939
4400	675	83250	2217	1627	0	87769
4401	671	2133	1174	82662	0	86640
4402	662	1159	477	85797	0	88095
4403	570	494	87212	3465	0	91741
4404	466	85550	2584	1901	0	90501
4405	87930	2416	1452	889	0	92687
4406	2794	91174	684	685	0	95337
4407	97539	2892	486	677	0	101594
4408	3721	1580	405	97046	0	102752
4409	2096	585	98754	3334	0	104769
4410	892	99301	3296	1990	0	105479
4411	99582	3094	1824	1093	0	105593
4412	3534	1719	100063	688	0	106004
4413	100352	586	3388	689	0	105015
4414	102685	350	1835	651	0	105521
4415	4966	400	100935	563	0	106864
4416	99615	238	3372	563	0	103788
4417	100852	273	1797	586	0	103508
4418	99363	232	802	549	0	100946
4419	5011	95325	653	558	0	101547
4420	93141	2924	468	557	0	97090
4421	3575	94211	534	567	0	98887
4422	2008	3144	94099	471	0	99722
4423	860	94825	3012	476	0	99173
4424	90662	3045	2060	534	0	96301
4425	92480	1491	617	520	0	95108
4426	94033	610	471	467	0	95581
4427	4470	377	395	89876	0	95118
4428	2236	337	373	92840	0	95786
4429	89125	292	423	4005	0	93845
4430	92264	293	377	1866	0	94800
4431	4405	308	379	89107	0	94199
4432	2046	378	88284	2898	0	93606
4433	975	84473	2747	1580	0	89775
4434	696	88767	1592	709	0	91764
4435	858	3645	691	86839	0	92033
4436	710	1757	87320	2719	0	92506
4437	810	887	2723	81955	0	86375
4438	672	85575	1542	2662	0	90451
4439	829	2623	660	86335	0	90447
4440	791	1493	85971	2926	0	91181
4441	835	684	2736	86391	0	90646
4442	818	576	90333	3084	0	94811
4443	873	480	3041	89778	0	94172
4444	832	527	93095	3115	0	97569
4445	859	541	92975	1628	0	96003
4446	88253	443	3981	898	0	93575
4447	93409	435	1854	637	0	96335
4448	94507	429	849	605	0	96390
4449	4565	91067	776	490	0	96898
4450	2568	2727	490	92449	0	98234
4451	91306	1477	536	2865	0	96184
4452	94733	732	499	1717	0	97681
4453	94955	561	536	920	0	96972
4454	4652	604	91879	748	0	97883
4455	2346	86786	2830	670	0	92632
4456	1341	94001	1692	646	0	97680
4457	92642	3729	884	697	0	97952
4458	3439	1793	660	92211	0	98103
4459	93106	897	646	2980	0	97629
4460	3665	737	91430	1643	0	97475
4461	2367	623	2835	89689	0	95514
4462	1559	524	1645	92295	0	96023
4463	1389	558	875	88496	0	91318
4464	1121	90806	829	3928	0	96684
4465	90961	2793	652	2108	0	96514
4466	92121	1613	689	1087	0	95510
4467	4384	89763	865	775	0	95787
4468	2580	2840	600	88561	0	94581
4469	89750	1579	636	2907	0	94872
4470	3624	842	577	89403	0	94446
4471	89477	662	597	3290	0	94026
4472	3635	88273	725	1886	0	94519
4473	88915	2836	582	996	0	93329
4474	3753	1750	86806	751	0	93060
4475	2294	87278	2778	817	0	93167
4476	1499	2821	88113	711	0	93144
4477	1739	2419	3170	84922	0	92250
4478	85868	834	1847	2825	0	91374
4479	87550	577	892	1637	0	90656
4480	87310	521	625	943	0	89399
4481	4620	451	587	82864	0	88522
4482	84189	420	522	2839	0	87970
4483	3641	453	535	82701	0	87330
4484	82971	402	549	3121	0	87043
4485	84117	515	588	1904	0	87124
4486	4168	619	82114	1079	0	87980
4487	1886	560	77120	628	0	80194
4488	1142	551	77370	592	0	79655
4489	864	514	2942	74163	0	78483
4490	75324	342	1702	2284	0	79652
4491	2409	403	758	76626	0	80196
4492	1560	349	511	78470	0	80890
4493	80571	350	414	3304	0	84639
4494	81217	307	378	1704	0	83606
4495	82053	305	347	1004	0	83709
4496	82703	290	429	776	0	84198
4497	3550	308	387	80179	0	84424
4498	79058	289	411	2266	0	82024
4499	2528	77697	557	1335	0	82117
4500	77174	1725	366	824	0	80089
4501	77009	969	430	759	0	79167
4502	2708	530	72295	447	0	75980
4503	67886	318	1421	501	0	70126
4504	1972	298	67699	431	0	70400
4505	943	209	62996	309	0	64457
4506	644	292	63153	338	0	64427
4507	594	1222	1244	53407	0	56467
4508	286	157	55366	633	0	56442
4509	341	248	617	51781	0	52987
4510	251	119	53344	604	0	54318
4511	204	165	55490	316	0	56175
4512	209	168	633	52976	0	53986
4513	297	66	319	57049	0	57731
4514	210	165	58764	661	0	59800
4515	55289	75	488	437	0	56289
4516	655	68	277	58535	0	59535
4517	424	60	123	59206	0	59813
4518	58860	54	89	807	0	59810
4519	631	62	72	59984	0	60749
4520	404	162	59424	568	0	60558
4521	248	162	56246	315	0	56971
4522	194	168	564	54651	0	55577
4523	175	114	56298	454	0	57041
4524	129	58001	535	293	0	58958
4525	178	370	263	56799	0	57610
4526	57702	185	131	528	0	58546
4527	454	173	58187	251	0	59065
4528	55721	46	429	248	0	56444
4529	501	38	251	60114	0	60904
4530	299	38	129	60909	0	61375
4531	181	32	88	61290	0	61591
4532	165	25	84	61229	0	61503
4533	59881	43	110	838	0	60872
4534	467	64006	154	387	0	65014
4535	358	545	76	65103	0	66082
4536	197	327	83	65314	0	65921
4537	186	84	79	65702	0	66051
4538	167	40	79	65821	0	66107
4539	64560	39	108	1073	0	65780
4540	637	64357	160	584	0	65738
4541	63846	535	74	321	0	64776
4542	638	60579	145	163	0	61525
4543	355	61273	150	198	0	61976
4544	59007	764	97	291	0	60159
4545	687	448	59610	147	0	60892
4546	447	143	621	59820	0	61031
4547	61092	56	370	810	0	62328
4548	61590	47	158	581	0	62376
4549	56794	153	175	452	0	57574
4550	62309	58	96	317	0	62780
4551	990	65275	133	236	0	66634
4552	66223	794	86	300	0	67403
4553	67618	389	83	307	0	68397
4554	1274	70499	167	272	0	72212
4555	594	1088	83	72691	0	74456
4556	265	561	72522	1235	0	74583
4557	262	156	1122	72706	0	74246
4558	70867	122	520	1511	0	73020
4559	1212	190	74992	656	0	77050
4560	581	73386	1250	400	0	75617
4561	307	1245	75492	312	0	77356
4562	305	618	1221	69566	0	71710
4563	170	73263	698	1068	0	75199
4564	74687	1154	174	736	0	76751
4565	1226	75785	212	306	0	77529
4566	705	1268	100	75016	0	77089
4567	370	619	98	77706	0	78793
4568	75678	227	128	1793	0	77826
4569	1328	164	106	74831	0	76429
4570	653	75583	196	1236	0	77668
4571	75524	1163	109	839	0	77635
4572	76127	581	103	451	0	77262
4573	1694	76780	162	290	0	78926
4574	77151	1214	89	351	0	78805
4575	1326	75966	193	261	0	77746
4576	75241	1299	105	358	0	77003
4577	1334	75647	179	275	0	77435
4578	831	1314	176	71718	0	74039
4579	450	683	126	76407	0	77666
4580	75047	278	151	1780	0	77256
4581	77500	210	159	875	0	78744
4582	1732	76666	210	462	0	79070
4583	882	1408	74727	299	0	77316
4584	75547	681	1265	364	0	77857
4585	1487	351	635	76748	0	79221
4586	797	77515	308	1317	0	79937
4587	483	1328	147	78500	0	80458
4588	78110	725	107	1589	0	80531
4589	79061	344	109	923	0	80437
4590	80161	306	110	509	0	81086
4591	2114	267	86	78324	0	80791
4592	990	358	78184	1404	0	80936
4593	72945	282	1225	946	0	75398
4594	76524	270	621	534	0	77949
4595	78173	269	226	457	0	79125
4596	2081	76361	259	307	0	79008
4597	1115	1386	152	76891	0	79544
4598	482	78937	231	1410	0	81060
4599	571	1591	164	79428	0	81754
4600	569	837	125	81348	0	82879
4601	445	531	85302	2112	0	88390
4602	547	357	1429	90829	0	93162
4603	573	297	793	93809	0	95472
4604	92591	278	249	2807	0	95925
4605	1966	93371	281	1281	0	96899
4606	94287	1879	199	610	0	96975
4607	97186	1118	167	512	0	98983
4608	2998	558	182	95429	0	99167
4609	1506	481	96827	2022	0	100836
4610	678	94169	1851	1211	0	97909
4611	537	94987	1017	560	0	97101
4612	92064	2684	351	543	0	95642
4613	2062	93517	312	454	0	96345
4614	1372	2008	183	90659	0	94222
4615	775	1098	187	94158	0	96218
4616	608	549	91497	2755	0	95409
4617	550	485	90802	1255	0	93092
4618	562	91216	2592	543	0	94913
4619	644	2015	1017	90820	0	94496
4620	91374	1107	322	2058	0	94861
4621	2189	503	211	92620	0	95523
4622	1235	569	93245	2229	0	97278
4623	696	384	1860	92951	0	95891
4624	89161	414	958	2414	0	92947
4625	90175	339	323	1455	0	92292
4626	2837	89719	386	698	0	93640
4627	90094	1968	233	704	0	92999
4628	2212	89916	417	540	0	93085
4629	89882	2046	224	567	0	92719
4630	2440	1153	200	87639	0	91432
4631	1435	589	87341	2094	0	91459
4632	814	529	85886	1229	0	88458
4633	632	89169	2642	598	0	93041
4634	731	1855	1082	85520	0	89188
4635	673	1035	299	88576	0	90583
4636	87858	407	242	2738	0	91245
4637	89260	381	226	1338	0	91205
4638	91120	384	241	765	0	92510
4639	2876	406	240	89278	0	92800
4640	1507	435	230	91497	0	93669
4641	816	408	275	92531	0	94030
4642	673	496	89944	2761	0	93874
4643	578	533	88589	1307	0	91007
4644	85777	395	2435	835	0	89442
4645	89538	396	1024	777	0	91735
4646	2676	494	89201	612	0	92983
4647	86259	406	1793	707	0	89165
4648	86443	311	1011	766	0	88531
4649	2707	421	86376	633	0	90137
4650	1294	86447	1914	732	0	90387
4651	925	1756	1040	83884	0	87605
4652	769	1046	86983	1834	0	90632
4653	635	89833	1743	1236	0	93447
4654	844	1743	838	80590	0	84015
4655	517	85428	488	1542	0	87975
4656	632	1540	83046	1099	0	86317
4657	613	1011	84386	618	0	86628
4658	739	744	2158	83615	0	87256
4659	84896	417	952	1675	0	87940
4660	1821	446	365	84852	0	87484
4661	84486	401	308	1773	0	86968
4662	1829	410	299	84902	0	87440
4663	1152	445	83496	1743	0	86836
4664	79659	357	1610	1306	0	82932
4665	1673	459	83690	611	0	86433
4666	82942	332	1625	712	0	85611
4667	1758	387	1060	81480	0	84685
4668	1113	83557	608	1767	0	87045
4669	756	1453	442	83631	0	86282
4670	639	87199	579	1765	0	90182
4671	821	1553	496	80719	0	83589
4672	668	87516	507	1629	0	90320
4673	86157	1510	420	1350	0	89437
4674	87146	960	428	760	0	89294
4675	86576	454	446	774	0	88250
4676	2504	456	85865	596	0	89421
4677	1482	387	1588	85517	0	88974
4678	862	438	87562	1720	0	90582
4679	722	84147	1900	1218	0	87987
4680	675	87048	1260	607	0	89590
4681	84286	2009	646	637	0	87578
4682	1785	1125	84645	588	0	88143
4683	1211	83017	1709	585	0	86522
4684	774	1527	1082	85066	0	88449
4685	84863	961	616	1857	0	88297
4686	1705	85746	612	1247	0	89310
4687	87017	1598	462	857	0	89934
4688	1864	1154	86983	682	0	90683
4689	1326	455	1645	88517	0	91943
4690	829	351	1123	91006	0	93309
4691	753	337	570	92630	0	94290
4692	680	91384	651	2619	0	95334
4693	1004	1675	489	87529	0	90697
4694	754	1147	92928	2091	0	96920
4695	837	395	1779	90465	0	93476
4696	806	303	1206	93117	0	95432
4697	785	318	599	91490	0	93192
4698	631	89592	665	2625	0	93513
4699	809	1536	497	89781	0	92623
4700	942	1032	492	88791	0	91257
4701	402	82053	486	2262	0	85203
4702	76011	1183	259	977	0	78430
4703	1171	76804	313	498	0	78786
4704	680	76814	354	392	0	78240
4705	570	1839	327	75608	0	78344
4706	359	817	74992	1230	0	77398
4707	66748	300	1179	853	0	69080
4708	1196	254	704	73758	0	75912
4709	683	272	72341	1242	0	74538
4710	272	72323	1193	873	0	74661
4711	324	1149	675	72811	0	74959
4712	325	757	73349	1280	0	75711
4713	363	259	1088	71210	0	72920
4714	346	232	667	72404	0	73649
4715	70562	187	262	1813	0	72824
4716	1063	70612	278	948	0	72901
4717	69986	1038	231	517	0	71772
4718	1177	709	71126	393	0	73405
4719	652	71268	1097	416	0	73433
4720	357	1105	71658	326	0	73446
4721	354	799	1064	72668	0	74885
4722	72789	254	692	1288	0	75023
4723	1097	258	243	72644	0	74242
4724	73105	185	190	1337	0	74817
4725	74165	219	189	902	0	75475
4726	1679	255	148	74995	0	77077
4727	850	286	77819	1273	0	80228
4728	346	297	79391	841	0	80875
4729	370	210	1608	80544	0	82732
4730	304	223	777	82841	0	84145
4731	81950	173	326	1959	0	84408
4732	1314	217	220	81837	0	83588
4733	814	80252	316	1467	0	82849
4734	378	1223	254	81674	0	83529
4735	330	839	215	82142	0	83526
4736	79824	314	179	2102	0	82419
4737	1222	80644	313	1086	0	83265
4738	857	1296	168	81149	0	83470
4739	447	811	179	80815	0	82252
4740	286	79718	325	2047	0	82376
4741	365	1310	195	81430	0	83300
4742	312	799	175	80256	0	81542
4743	257	78688	310	2134	0	81389
4744	345	1283	192	79861	0	81681
4745	304	813	220	78752	0	80089
4746	178	77851	331	2153	0	80513
4747	327	1292	199	79315	0	81133
4748	77457	809	162	1856	0	80284
4749	77851	319	168	1286	0	79624
4750	77476	327	174	729	0	78706
4751	76870	253	171	733	0	78027
4752	1858	72707	256	639	0	75460
4753	68392	1077	154	527	0	70150
4754	1210	67038	189	560	0	68997
4755	671	67328	212	399	0	68610
4756	542	1640	283	66635	0	69100
4757	272	815	66725	1279	0	69091
4758	63497	250	1013	895	0	65655
4759	66922	262	599	549	0	68332
4760	1600	285	68680	449	0	71014
4761	67289	180	1044	566	0	69079
4762	70420	226	602	526	0	71774
4763	1649	68567	254	440	0	70910
4764	76943	1083	128	817	0	78971
4765	1346	738	152	76305	0	78541
4766	867	293	114	77412	0	78686
4767	433	191	147	78034	0	78805
4768	389	275	128	77803	0	78595
4769	76658	206	138	2118	0	79120
4770	1308	251	123	75522	0	77204
4771	927	222	121	76116	0	77386
4772	439	373	73825	1877	0	76514
4773	66211	239	1060	1194	0	68704
4774	74229	260	597	645	0	75731
4775	74806	226	194	592	0	75818
4776	1791	72922	237	526	0	75476
4777	842	74932	233	518	0	76525
4778	73918	1567	126	553	0	76164
4779	1357	767	172	74332	0	76628
4780	881	75894	222	1386	0	78383
4781	520	1208	113	75754	0	77595
4782	361	77276	244	1494	0	79375
4783	76500	1304	101	1000	0	78905
4784	1336	78207	203	600	0	80346
4785	972	1287	116	77283	0	79658
4786	552	833	146	79659	0	81190
4787	481	499	81467	1976	0	84423
4788	436	85857	1295	1143	0	88731
4789	534	1768	766	88441	0	91509
4790	484	1103	89575	1898	0	93060
4791	461	510	90377	1203	0	92551
4792	496	313	2452	90505	0	93766
4793	471	231	1216	89809	0	91727
4794	372	86042	474	2824	0	89712
4795	407	91275	283	1528	0	93493
4796	466	2775	147	90786	0	94174
4797	90494	1334	187	2162	0	94177
4798	2048	506	166	94859	0	97579
4799	97645	355	130	2534	0	100664
4800	99704	315	138	1650	0	101807
4801	101241	297	162	859	0	102559
4802	3432	398	99028	571	0	103429
4803	98815	268	1887	653	0	101623
4804	2534	271	1227	99671	0	103703
4805	1759	239	368	101437	0	103803
4806	766	394	98648	3240	0	103048
4807	603	390	98689	1754	0	101436
4808	604	503	2832	95702	0	99641
4809	450	95078	1546	2061	0	99135
4810	527	98739	533	1492	0	101291
4811	607	2850	252	98218	0	101927
4812	97459	1462	298	2288	0	101507
4813	2164	526	280	98752	0	101722
4814	1573	383	235	97517	0	99708
4815	588	97496	377	3240	0	101701
4816	582	1930	242	99757	0	102511
4817	462	1522	100120	2435	0	104539
4818	454	636	96744	1687	0	99521
4819	93237	355	2871	958	0	97421
4820	1977	98342	1587	663	0	102569
4821	98033	1830	463	691	0	101017
4822	97901	1262	308	660	0	100131
4823	3086	529	281	90689	0	94585
4824	1584	95821	409	1804	0	99618
4825	847	1925	253	95442	0	98467
4826	94940	1236	242	2221	0	98639
4827	1903	92768	381	1543	0	96595
4828	90697	1727	253	778	0	93455
4829	1923	91485	367	484	0	94259
4830	92137	1877	243	620	0	94877
4831	91988	1228	240	585	0	94041
4832	2674	89935	377	456	0	93442
4833	1560	1809	235	90481	0	94085
4834	90703	1148	309	2022	0	94182
4835	1874	599	88165	1388	0	92026
4836	1319	495	88416	725	0	90955
4837	742	850	2433	86648	0	90673
4838	89309	321	1257	1895	0	92782
4839	1817	318	447	89873	0	92455
4840	89961	315	312	2121	0	92709
4841	2040	460	90323	1342	0	94165
4842	90856	310	1621	835	0	93622
4843	95670	269	1152	720	0	97811
4844	2852	309	440	93967	0	97568
4845	1652	289	287	95488	0	97716
4846	838	339	250	95686	0	97113
4847	539	94953	425	2847	0	98764
4848	687	1540	320	95611	0	98158
4849	610	1138	329	97243	0	99320
4850	95713	464	305	2878	0	99360
4851	96358	352	289	1791	0	98790
4852	2701	484	94327	759	0	98271
4853	93266	342	1594	793	0	95995
4854	2049	512	94909	634	0	98104
4855	88966	328	1788	830	0	91912
4856	2064	421	93795	667	0	96947
4857	1461	401	92201	615	0	94678
4858	862	409	2432	90012	0	93715
4859	603	378	92038	1908	0	94927
4860	87895	352	1760	1501	0	91508
4861	1783	333	1148	93375	0	96639
4862	95423	287	491	2008	0	98209
4863	96053	282	410	1520	0	98265
4864	90338	273	358	818	0	91787
4865	89513	226	346	691	0	90776
4866	2958	360	88011	576	0	91905
4867	1868	234	1501	87753	0	91356
4868	956	358	89915	1760	0	92989
4869	898	258	1682	88579	0	91417
4870	88202	236	1161	2049	0	91648
4871	1904	237	536	90177	0	92854
4872	90644	269	433	2047	0	93393
4873	2010	257	382	91279	0	93928
4874	1439	282	376	92311	0	94408
4875	91028	287	344	2699	0	94358
4876	1750	90505	502	1571	0	94328
4877	90759	1437	298	879	0	93373
4878	1834	90550	432	645	0	93461
4879	1440	1565	267	90624	0	93896
4880	90419	994	308	1866	0	93587
4881	1747	557	91392	1329	0	95025
4882	1465	255	1375	91563	0	94658
4883	91824	247	1068	1759	0	94898
4884	95403	231	462	1301	0	97397
4885	2849	256	284	93186	0	96575
4886	1634	94094	381	1746	0	97855
4887	778	91838	351	1173	0	94140
4888	846	3311	209	83386	0	87752
4889	83729	850	175	1358	0	86112
4890	1229	81240	200	863	0	83532
4891	664	78898	167	317	0	80046
4892	77073	1311	118	295	0	78797
4893	830	77488	139	174	0	78631
4894	78744	905	153	274	0	80076
4895	1154	560	77	78239	0	80030
4896	719	165	49	78244	0	79177
4897	225	77571	129	1359	0	79284
4898	137	76738	111	697	0	77683
4899	71433	1185	74	276	0	72968
4900	801	74471	107	171	0	75550
4901	502	81190	107	115	0	81914
4902	322	1556	88	80333	0	82299
4903	81930	800	40	1309	0	84079
4904	1283	341	85140	781	0	87545
4905	84403	101	1302	327	0	86133
4906	1617	81	895	90190	0	92783
4907	1071	184	91195	1570	0	94020
4908	391	238	93397	1078	0	95104
4909	275	145	2449	94241	0	97110
4910	217	217	97681	1650	0	99765
4911	94092	128	1805	1308	0	97333
4912	98435	133	1142	532	0	100242
4913	2702	249	98266	248	0	101465
4914	1501	138	1692	97186	0	100517
4915	546	156	1179	98646	0	100527
4916	99772	135	377	2857	0	103141
4917	1816	147	217	94437	0	96617
4918	1239	95726	285	1813	0	99063
4919	96720	1637	144	1300	0	99801
4920	1783	96021	221	496	0	98521
4921	1235	99892	235	398	0	101760
4922	630	2749	188	98571	0	102138
4923	427	1422	111	99721	0	101681
4924	442	471	132	101208	0	102253
4925	359	439	97491	3004	0	101293
4926	89191	272	1748	1785	0	92996
4927	1811	96129	1214	641	0	99795
4928	98342	1809	359	597	0	101107
4929	99191	1261	254	514	0	101220
4930	3049	462	245	98190	0	101946
4931	1601	98452	287	2035	0	102375
4932	831	1815	269	101974	0	104889
4933	640	1261	210	103070	0	105181
4934	103254	496	209	3206	0	107165
4935	102844	336	229	1868	0	105277
4936	3057	462	100127	721	0	104367
4937	102114	277	1662	698	0	104751
4938	2323	104004	1215	565	0	108107
4939	105052	2021	413	610	0	108096
4940	2333	109588	309	554	0	112784
4941	1743	2301	213	107476	0	111733
4942	873	1565	233	107635	0	110306
4943	563	107241	317	3410	0	111531
4944	709	2168	227	110694	0	113798
4945	656	1501	238	111274	0	113669
4946	669	655	215	109291	0	110830
4947	525	107173	388	3787	0	111873
4948	721	2315	245	109454	0	112735
4949	677	1599	228	110045	0	112549
4950	713	755	240	111270	0	112978
4951	610	619	106482	3977	0	111688
4952	99937	504	2127	2501	0	105069
4953	2485	635	107736	1117	0	111973
4954	105354	526	2368	1002	0	109250
4955	2769	627	108197	859	0	112452
4956	106419	504	2464	836	0	110223
4957	109000	493	1537	862	0	111892
4958	3877	619	107494	778	0	112768
4959	2387	545	2284	106061	0	111277
4960	1161	632	103117	2613	0	107523
4961	99881	525	2332	2064	0	104802
4962	2756	628	108726	1099	0	113209
4963	2009	627	106749	962	0	110347
4964	104358	489	3479	1090	0	109416
4965	2621	107230	2107	940	0	112898
4966	2108	2316	807	107974	0	113205
4967	109892	1638	607	2917	0	115054
4968	2887	727	674	110576	0	114864
4969	2234	592	570	112667	0	116063
4970	110381	513	622	4171	0	115687
4971	111149	396	648	2573	0	114766
4972	3992	579	109012	1375	0	114958
4973	2312	549	109079	1187	0	113127
4974	1286	451	3648	109470	0	114855
4975	1058	534	112896	3068	0	117556
4976	1077	466	2744	111650	0	115937
4977	1193	416	1934	111667	0	115210
4978	1206	432	862	115219	0	117719
4979	110352	412	723	4509	0	115996
4980	2711	110692	918	2620	0	116941
4981	110759	2258	553	1753	0	115323
4982	109916	1603	608	1458	0	113585
4983	3729	108834	703	1423	0	114689
4984	105926	2087	464	1205	0	109682
4985	2735	1653	103969	1009	0	109366
4986	1976	979	1787	102991	0	107733
4987	104913	579	1295	2692	0	109479
4988	2378	697	103000	1895	0	107970
4989	102955	456	1800	1283	0	106494
4990	2361	108579	1495	1064	0	113499
4991	122723	1832	705	1051	0	126311
4992	122994	1257	606	955	0	125812
4993	4427	123638	747	858	0	129670
4994	128683	2491	650	993	0	132817
4995	4165	1717	553	129068	0	135503
4996	2811	1010	465	131687	0	135973
4997	129199	652	515	4435	0	134801
4998	122680	527	437	2947	0	126591
4999	4314	127494	565	1875	0	134248
5000	2594	127639	536	1341	0	132110
5001	1498	3381	312	115586	0	120777
5002	931	119672	487	2237	0	123327
5003	843	122747	481	1588	0	125659
5004	115017	3096	564	1052	0	119729
5005	2097	117795	509	802	0	121203
5006	113104	2379	262	634	0	116379
5007	2304	116263	320	516	0	119403
5008	1818	2368	113095	534	0	117815
5009	1059	115880	1653	473	0	119065
5010	113004	2590	1371	698	0	117663
5011	112367	1216	652	623	0	114858
5012	2743	926	111505	363	0	115537
5013	1949	479	1692	107394	0	111514
5014	1314	323	1068	113497	0	116202
5015	857	459	112524	2540	0	116380
5016	811	261	1865	109424	0	112361
5017	547	404	112437	2581	0	115969
5018	560	427	109093	1602	0	111682
5019	106310	231	2575	1156	0	110272
5020	1841	110661	1708	717	0	114927
5021	110799	1645	947	562	0	113953
5022	2493	1146	517	110473	0	114629
5023	1685	901	111132	1689	0	115407
5024	1267	676	1560	105763	0	109266
5025	782	111660	1068	2067	0	115577
5026	113483	1613	692	1419	0	117207
5027	114227	1128	507	1035	0	116897
5028	2855	813	286	113981	0	117935
5029	1920	748	111705	1717	0	116090
5030	105832	460	1554	1217	0	109063
5031	2267	109958	1026	794	0	114045
5032	109942	1717	633	675	0	112967
5033	2844	1155	396	108374	0	112769
5034	108889	874	401	1829	0	111993
5035	2976	825	193	107647	0	111641
5036	1905	845	106565	2275	0	111590
5037	1458	554	102842	1684	0	106538
5038	99710	347	2168	1828	0	104053
5039	2072	106708	1503	1053	0	111336
5040	104962	1579	1095	797	0	108433
5041	104840	1224	545	577	0	107186
5042	2286	105932	404	363	0	108985
5043	104106	2107	240	653	0	107106
5044	2393	1626	108750	578	0	113347
5045	1590	1343	1369	109443	0	113745
5046	1393	1025	839	111203	0	114460
5047	1162	898	653	112419	0	115132
5048	946	912	110357	2575	0	114790
5049	942	852	110067	1687	0	113548
5050	782	748	2252	108017	0	111799
5051	634	108705	1762	1745	0	112846
5052	804	113571	1162	1100	0	116637
5053	113770	2298	678	975	0	117721
5054	113346	1468	614	931	0	116359
5055	2287	117176	792	780	0	121035
5056	1765	1935	445	118533	0	122678
5057	1287	1177	526	120156	0	123146
5058	120734	896	735	2975	0	125340
5059	2163	606	706	124637	0	128112
5060	1553	560	835	124535	0	127483
5061	1409	518	762	125376	0	128065
5062	1257	859	118089	3021	0	123226
5063	1160	878	114907	1988	0	118933
5064	115634	488	2433	1817	0	120372
5065	2217	352	1730	125786	0	130085
5066	1523	558	125849	2367	0	130297
5067	1244	751	121812	1583	0	125390
5068	120140	715	2971	1383	0	125209
5069	2976	699	134698	1002	0	139375
5070	1874	137692	2939	1071	0	143576
5071	1271	2259	1879	145543	0	150952
5072	1217	1645	145172	2576	0	150610
5073	142589	1154	2748	1783	0	148274
5074	3207	956	1622	151188	0	156973
5075	2284	803	149257	3177	0	155521
5076	1598	404	2905	151077	0	155984
5077	1321	449	1825	152719	0	156314
5078	151754	367	1203	4768	0	158092
5079	2985	153303	1318	2599	0	160205
5080	2442	2611	825	151686	0	157564
5081	154551	1716	571	3469	0	160307
5082	155958	1087	513	2272	0	159830
5083	157662	624	451	1617	0	160354
5084	159704	615	609	1324	0	162252
5085	5400	541	602	155602	0	162145
5086	155805	385	700	3166	0	160056
5087	154395	270	787	2410	0	157862
5088	147896	281	609	1967	0	150753
5089	149515	346	674	1805	0	152340
5090	4452	140099	842	1258	0	146651
5091	1188	128961	364	363	0	130876
5092	640	2399	272	127008	0	130319
5093	400	127530	357	1695	0	129982
5094	125342	1726	365	1257	0	128690
5095	1956	988	199	123550	0	126693
5096	123231	224	254	1966	0	125675
5097	123669	190	296	1364	0	125519
5098	2544	175	228	126042	0	128989
5099	1272	181	247	124920	0	126620
5100	491	124334	396	2460	0	127681
5101	125274	1492	252	1440	0	128458
5102	1740	124722	381	563	0	127406
5103	125974	1590	226	722	0	128512
5104	2057	929	183	126464	0	129633
5105	1330	446	124650	1795	0	128221
5106	123318	240	1559	1308	0	126425
5107	120423	209	930	819	0	122381
5108	2748	347	118135	510	0	121740
5109	1487	429	118349	445	0	120710
5110	880	234	2224	114809	0	118147
5111	126641	260	975	2135	0	130011
5112	131847	278	338	1506	0	133969
5113	135924	279	256	917	0	137376
5114	135747	262	265	858	0	137132
5115	3355	133312	411	576	0	137654
5116	138148	2107	257	838	0	141350
5117	2852	1263	265	136608	0	140988
5118	1976	369	297	138675	0	141317
5119	1150	308	278	144546	0	146282
5120	998	310	293	146451	0	148052
5121	142841	326	328	3867	0	147362
5122	2944	331	280	151501	0	155056
5123	1827	542	147290	3160	0	152819
5124	1181	346	2486	151776	0	155789
5125	1083	290	1494	153005	0	155872
5126	1009	289	483	153528	0	155309
5127	1101	274	387	151502	0	153264
5128	146158	284	400	4683	0	151525
5129	3115	145413	512	2210	0	151250
5130	2051	148090	569	1001	0	151711
5131	1234	3876	360	145240	0	150710
5132	145530	1727	367	3253	0	150877
5133	150059	559	398	2128	0	153144
5134	4801	395	364	149351	0	154911
5135	2609	504	145696	3314	0	152123
5136	146149	369	2653	2322	0	151493
5137	3830	411	1560	153045	0	158846
5138	2459	569	152682	3432	0	159142
5139	144506	348	2880	2538	0	150272
5140	3697	151759	1828	1233	0	158517
5141	170646	2836	485	1251	0	175218
5142	4772	175219	579	1024	0	181594
5143	3633	4173	266	173987	0	182059
5144	1574	174501	482	4698	0	181255
5145	1550	4890	295	179932	0	186667
5146	171307	2856	260	5791	0	180214
5147	4663	173920	482	3891	0	182956
5148	3371	4442	173803	1669	0	183285
5149	1780	2937	4147	175220	0	184084
5150	1361	1148	177941	5078	0	185528
5151	1381	708	4662	174697	0	181448
5152	1358	599	2840	180286	0	185083
5153	1124	661	174706	7366	0	183857
5154	156548	459	4470	4628	0	166105
5155	5019	618	173410	1897	0	180944
5156	3533	643	170872	1459	0	176507
5157	1503	170998	6791	1373	0	180665
5158	1431	4277	3193	171092	0	179993
5159	1313	2945	1119	173265	0	178642
5160	1291	1182	684	171658	0	174815
5161	1341	733	549	176362	0	178985
5162	990	787	166899	8143	0	176819
5163	152314	538	4356	4806	0	162014
5164	4934	730	167328	2148	0	175140
5165	3516	438	4526	160966	0	169446
5166	159046	522	2995	4969	0	167532
5167	4439	159873	1471	3885	0	169668
5168	3439	4818	801	154949	0	164007
5169	148458	2706	672	4637	0	156473
5170	4272	142887	867	3286	0	151312
5171	2729	145352	716	1524	0	150321
5172	142213	5551	661	1263	0	149688
5173	3871	144832	694	1050	0	150447
5174	140317	4148	578	1235	0	146278
5175	4108	141907	675	1373	0	148063
5176	144152	4109	593	1153	0	150007
5177	144257	2644	517	1139	0	148557
5178	5895	144979	772	912	0	152558
5179	3454	3861	552	143869	0	151736
5180	1572	2795	141314	4226	0	149907
5181	138973	1132	3705	3242	0	147052
5182	4231	783	2542	139552	0	147108
5183	2864	134058	1188	4362	0	142472
5184	1291	141227	1005	3112	0	146635
5185	1189	5418	649	141085	0	148341
5186	139543	2883	710	4551	0	147687
5187	3968	1386	139428	3287	0	148069
5188	3167	801	3683	141474	0	149125
5189	1627	703	2641	144745	0	149716
5190	1198	664	1087	147772	0	150721
5191	1104	698	802	143973	0	146577
5192	832	139650	974	6993	0	148449
5193	1099	3832	721	143905	0	149557
5194	1012	2974	139399	5132	0	148517
5195	1022	1534	139052	3533	0	145141
5196	993	1267	142697	1896	0	146853
5197	1234	1020	6184	138259	0	146697
5198	136090	1023	3341	4499	0	144953
5199	4363	1065	136686	3258	0	145372
5200	3273	1149	138618	1667	0	144707
5201	1821	945	5982	134958	0	143706
5202	137019	925	3369	4673	0	145986
5203	4190	136419	1819	3508	0	145936
5204	137802	4159	1070	2122	0	145153
5205	5070	3085	900	136245	0	145300
5206	3569	1790	138461	4564	0	148384
5207	2093	1786	4104	130844	0	138827
5208	1322	139854	3199	4685	0	149060
5209	146777	4338	1510	3429	0	156054
5210	4756	3227	146438	2162	0	156583
5211	2918	141599	4132	1736	0	150385
5212	140364	4161	2992	1742	0	149259
5213	4848	3020	1527	140536	0	149931
5214	3321	1339	1150	143603	0	149413
5215	142200	903	966	6854	0	150923
5216	144573	840	1081	4269	0	150763
5217	150572	817	1078	2251	0	154718
5218	7624	991	952	140188	0	149755
5219	3889	139187	1173	4823	0	149072
5220	140092	3961	855	3785	0	148693
5221	4511	141105	1100	2174	0	148890
5222	134644	4270	855	1512	0	141281
5223	4580	132142	1127	1213	0	139062
5224	3363	4218	722	130025	0	138328
5225	132316	2918	664	4404	0	140302
5226	134359	1407	537	3438	0	139741
5227	136495	990	529	1978	0	139992
5228	137360	910	611	1425	0	140306
5229	137146	811	626	1332	0	139915
5230	7094	1029	130379	1148	0	139650
5231	4283	872	3666	129813	0	138634
5232	2252	945	132351	3915	0	139463
5233	1725	968	130765	2912	0	136370
5234	128981	816	5723	1593	0	137113
5235	132261	791	3218	1227	0	137497
5236	133001	854	1360	1025	0	136240
5237	7147	892	777	125407	0	134223
5238	125476	765	748	3987	0	130976
5239	5046	123795	854	3102	0	132797
5240	3597	125326	774	1738	0	131435
5241	1571	113947	473	825	0	116816
5242	104277	3460	723	786	0	109246
5243	2674	106615	477	702	0	110468
5244	105571	2278	459	659	0	108967
5245	104413	1492	288	613	0	106806
5246	3859	704	102004	548	0	107115
5247	2363	529	2059	99747	0	104698
5248	1458	433	1307	105385	0	108583
5249	105210	426	566	3426	0	109628
5250	105943	420	376	1898	0	108637
5251	4079	408	363	104036	0	108886
5252	2348	542	102464	2530	0	107884
5253	1484	539	103257	1714	0	106994
5254	1350	400	3208	104208	0	109166
5255	1376	433	1561	105719	0	109089
5256	1312	425	569	108049	0	110355
5257	103587	489	408	3760	0	108244
5258	103877	506	390	2005	0	106778
5259	4062	102943	539	983	0	108527
5260	2597	2433	368	102847	0	108245
5261	1668	1629	429	102433	0	106159
5262	1266	104238	519	3504	0	109527
5263	1531	2430	458	104883	0	109302
5264	104975	1612	491	2863	0	109941
5265	3357	720	525	104562	0	109164
5266	2651	556	455	105517	0	109179
5267	103458	558	410	3890	0	108316
5268	104179	552	462	2165	0	107358
5269	105336	556	511	1311	0	107714
5270	4834	873	673	101218	0	107598
5271	2748	552	97309	2645	0	103254
5272	1626	618	96607	1839	0	100690
5273	1525	574	96626	1141	0	99866
5274	1425	93617	3352	996	0	99390
5275	91875	2120	2105	1096	0	97196
5276	3010	1411	90252	901	0	95574
5277	88213	579	2053	1028	0	91873
5278	2988	443	1411	87922	0	92764
5279	87171	480	737	2557	0	90945
5280	89619	507	550	1982	0	92658
5281	3531	89531	622	1119	0	94803
5282	91906	1921	464	1312	0	95603
5283	91534	1295	491	1335	0	94655
5284	3704	90784	638	1226	0	96352
5285	2615	1992	423	92970	0	98000
5286	1744	1469	92866	2472	0	98551
5287	1585	675	1931	91895	0	96086
5288	1347	615	1300	94346	0	97608
5289	93297	593	573	3667	0	98130
5290	3062	563	531	92236	0	96392
5291	2228	93853	692	2718	0	99491
5292	1511	2155	485	93965	0	98116
5293	1346	1481	561	96364	0	99752
5294	1433	729	93402	3717	0	99281
5295	1467	91505	2257	2328	0	97557
5296	1499	95060	1518	1328	0	99405
5297	91828	2942	769	1265	0	96804
5298	2812	96256	808	1252	0	101128
5299	2340	2320	738	95380	0	100778
5300	1510	1653	95559	2710	0	101432
5301	1302	96106	2462	2108	0	101978
5302	96090	2247	1625	1193	0	101155
5303	2977	1624	897	95518	0	101016
5304	2385	739	655	97905	0	101684
5305	1468	664	95726	3755	0	101613
5306	1448	606	2122	92752	0	96928
5307	1417	595	1401	95502	0	98915
5308	92160	579	685	3859	0	97283
5309	84391	476	427	2177	0	87471
5310	3386	82925	548	1362	0	88221
5311	78078	1673	329	1105	0	81185
5312	2225	76231	483	1005	0	79944
5313	1617	2027	368	69378	0	73390
5314	896	71778	480	1838	0	74992
5315	768	74222	445	1508	0	76943
5316	70605	2213	813	1128	0	74759
5317	68667	994	367	873	0	70901
5318	1942	67403	394	711	0	70450
5319	68391	1267	379	793	0	70830
5320	68227	829	326	786	0	70168
5321	70143	451	396	824	0	71814
5322	2063	413	316	69986	0	72778
5323	70561	500	287	1608	0	72956
5324	1649	548	67233	1091	0	70521
5325	66512	445	1116	784	0	68857
5326	1638	532	69445	627	0	72242
5327	1201	452	1264	69515	0	72432
5328	778	467	773	72291	0	74309
5329	654	549	71196	1979	0	74378
5330	67231	409	1173	1300	0	70113
5331	70878	355	798	871	0	72902
5332	1979	455	74156	737	0	77327
5333	1182	339	1166	72800	0	75487
5334	784	304	761	74398	0	76247
5335	736	301	330	76056	0	77423
5336	74248	337	293	2094	0	76972
5337	74432	353	329	1213	0	76327
5338	2077	435	259	70116	0	72887
5339	900	66751	276	1126	0	69053
5340	487	65781	220	725	0	67213
5341	61843	1136	189	484	0	63652
5342	970	62583	216	372	0	64141
5343	616	61264	206	369	0	62455
5344	389	920	177	57343	0	58829
5345	294	512	57230	689	0	58725
5346	252	56793	600	439	0	58084
5347	351	699	388	56049	0	57487
5348	212	57063	215	649	0	58139
5349	258	585	179	56328	0	57350
5350	56149	316	95	752	0	57312
5351	566	56699	151	424	0	57840
5352	57065	507	117	371	0	58060
5353	55401	316	95	317	0	56129
5354	767	246	53810	195	0	55018
5355	52675	127	450	302	0	53554
5356	660	231	276	54865	0	56032
5357	371	196	55513	526	0	56606
5358	211	55922	448	358	0	56939
5359	282	471	258	55372	0	56383
5360	213	239	102	55968	0	56522
5361	55706	116	90	687	0	56599
5362	510	132	84	55780	0	56506
5363	359	123	85	56113	0	56680
5364	55731	112	58	705	0	56606
5365	427	55432	110	447	0	56416
5366	54611	412	102	293	0	55418
5367	525	344	54155	181	0	55205
5368	49797	138	413	286	0	50634
5369	606	199	56058	170	0	57033
5370	333	56421	453	167	0	57374
5371	56830	457	221	245	0	57753
5372	54921	271	147	257	0	55596
5373	703	242	55415	151	0	56511
5374	381	200	55792	172	0	56545
5375	288	224	57888	139	0	58539
5376	206	59770	723	187	0	60886
5377	304	508	301	60395	0	61508
5378	268	397	67551	524	0	68740
5379	236	258	65892	341	0	66727
5380	295	109	1072	65763	0	67239
5381	264	257	67568	771	0	68860
5382	64831	103	847	632	0	66413
5383	77177	112	493	373	0	78155
5384	1683	181	75694	201	0	77759
5385	843	75319	1216	288	0	77666
5386	436	1081	704	74378	0	76599
5387	381	753	75846	1147	0	78127
5388	224	75844	1218	826	0	78112
5389	450	1219	686	74669	0	77024
5390	75227	655	283	1276	0	77441
5391	74193	231	165	830	0	75419
5392	1600	76007	248	326	0	78181
5393	887	1098	145	76725	0	78855
5394	390	652	160	77367	0	78569
5395	301	257	125	77360	0	78043
5396	314	130	135	77928	0	78507
5397	241	252	75315	1849	0	77657
5398	306	158	994	74417	0	75875
5399	180	250	73469	1292	0	75191
5400	119	71955	1163	827	0	74064
5401	70996	951	674	455	0	73076
5402	926	74229	331	308	0	75794
5403	658	1065	164	74417	0	76304
5404	363	633	137	74813	0	75946
5405	73689	253	110	1725	0	75777
5406	1016	168	106	73851	0	75141
5407	627	72410	203	1231	0	74471
5408	322	959	105	74151	0	75537
5409	251	624	103	74384	0	75362
5410	72884	237	111	1689	0	74921
5411	1020	272	71065	847	0	73204
5412	630	70736	888	397	0	72651
5413	241	73049	543	259	0	74092
5414	232	1349	183	71972	0	73736
5415	70987	686	100	1094	0	72867
5416	866	71264	152	764	0	73046
5417	667	926	95	72061	0	73749
5418	275	705	71020	1027	0	73027
5419	236	261	895	71355	0	72747
5420	71673	183	566	1207	0	73629
5421	70468	135	270	832	0	71705
5422	1487	145	125	70172	0	71929
5423	71377	128	126	1242	0	72873
5424	70588	128	128	841	0	71685
5425	1513	226	69870	334	0	71943
5426	66877	141	905	370	0	68293
5427	1133	68792	662	290	0	70877
5428	69688	923	222	347	0	71180
5429	1226	702	68084	196	0	70208
5430	839	246	965	68966	0	71016
5431	70704	149	685	1191	0	72729
5432	1205	209	65807	785	0	68006
5433	842	211	66940	337	0	68330
5434	455	154	1609	66079	0	68297
5435	263	225	68782	1177	0	70447
5436	67304	135	1299	866	0	69604
5437	1215	254	70299	344	0	72112
5438	870	111	1280	72373	0	74634
5439	445	139	777	74818	0	76179
5440	76620	126	400	2112	0	79258
5441	1499	212	77235	1098	0	80044
5442	981	208	80795	446	0	82430
5443	511	103	2325	84341	0	87280
5444	325	214	86216	1814	0	88569
5445	83490	130	2075	1219	0	86914
5446	1884	130	1245	84091	0	87350
5447	1176	213	85794	1870	0	89053
5448	581	109	1975	85345	0	88010
5449	490	131	1158	87189	0	88968
5450	86407	132	477	2840	0	89856
5451	1973	231	86292	1384	0	89880
5452	82741	161	1948	695	0	85545
5453	2160	280	89686	525	0	92651
5454	87959	164	2146	552	0	90821
5455	90030	194	1228	505	0	91957
5456	90227	151	496	582	0	91456
5457	2982	86273	480	447	0	90182
5458	87994	1712	260	484	0	90450
5459	88011	1020	276	512	0	89819
5460	3041	326	284	86644	0	90295
5461	1492	289	85670	2116	0	89567
5462	82680	166	1906	1569	0	86321
5463	2101	238	87785	716	0	90840
5464	1418	152	2128	85058	0	88756
5465	733	131	1287	88848	0	90999
5466	87653	143	609	2988	0	91393
5467	1995	89625	604	1529	0	93753
5468	1441	1793	336	89080	0	92650
5469	814	1086	356	90403	0	92659
5470	532	519	89363	3011	0	93425
5471	624	191	1947	89525	0	92287
5472	656	170	1180	92006	0	94012
5473	662	159	503	88463	0	89787
5474	491	87976	527	2980	0	91974
5475	86660	1711	343	1561	0	90275
5476	87696	1014	351	873	0	89934
5477	2841	87440	430	662	0	91373
5478	81540	1555	284	523	0	83902
5479	2128	1051	246	83276	0	86701
5480	1317	364	85890	1871	0	89442
5481	535	85934	1881	1211	0	89561
5482	395	88186	1209	571	0	90361
5483	83137	2019	671	426	0	86253
5484	86598	769	291	391	0	88049
5485	2532	234	248	86645	0	89659
5486	1272	145	243	88821	0	90481
5487	526	133	222	88948	0	89829
5488	85475	119	269	2820	0	88683
5489	1984	223	84332	1187	0	87726
5490	84693	122	1761	636	0	87212
5491	2103	167	984	85759	0	89013
5492	1221	126	372	84557	0	86276
5493	488	84310	384	2611	0	87793
5494	575	1643	278	86904	0	89400
5495	513	869	273	88259	0	89914
5496	597	347	87418	2746	0	91108
5497	454	87751	1851	1378	0	91434
5498	90195	1722	986	830	0	93733
5499	88926	900	408	696	0	90930
5500	92316	279	330	691	0	93616
5501	91409	228	340	666	0	92643
5502	2746	348	87993	479	0	91566
5503	86981	240	1842	589	0	89652
5504	2278	331	89383	529	0	92521
5505	1458	207	1904	85959	0	89528
5506	717	89376	1160	2015	0	93268
5507	814	1755	420	90496	0	93485
5508	812	983	349	91936	0	94080
5509	708	435	90355	2843	0	94341
5510	85755	276	1967	1601	0	89599
5511	89525	320	1119	914	0	91878
5512	2771	87911	617	805	0	92104
5513	1550	1838	88834	766	0	92988
5514	893	1012	1942	89017	0	92864
5515	792	594	90339	2262	0	93987
5516	733	507	89055	1550	0	91845
5517	892	367	2582	88906	0	92747
5518	853	464	90097	2277	0	93691
5519	1039	330	1982	89676	0	93027
5520	925	387	92465	2465	0	96242
5521	966	323	2064	92466	0	95819
5522	92721	319	1176	2657	0	96873
5523	93361	288	546	1872	0	96067
5524	93737	334	450	1160	0	95681
5525	92560	333	468	1093	0	94454
5526	2960	92188	575	948	0	96671
5527	1657	1861	451	91757	0	95726
5528	1021	1046	439	93536	0	96042
5529	867	590	91378	3116	0	95951
5530	893	385	1891	90363	0	93532
5531	763	511	90723	2536	0	94533
5532	748	553	87498	1585	0	90384
5533	84202	348	2636	1005	0	88191
5534	2144	89995	1425	893	0	94457
5535	90756	1852	673	851	0	94132
5536	90371	1010	521	898	0	92800
5537	2924	90201	649	899	0	94673
5538	89670	1586	608	922	0	92786
5539	2326	1000	89136	715	0	93177
5540	1207	88430	1779	680	0	92096
5541	88079	1500	1120	823	0	91522
5542	1857	942	85256	621	0	88676
5543	79963	340	1263	743	0	82309
5544	1452	83500	938	617	0	86507
5545	84197	1189	493	718	0	86597
5546	83707	663	423	634	0	85427
5547	1820	82199	589	558	0	85166
5548	907	81707	518	500	0	83632
5549	534	84377	584	476	0	85971
5550	532	1596	482	84562	0	87172
5551	491	670	509	85652	0	87322
5552	85946	248	517	2010	0	88721
5553	83300	192	513	1189	0	85194
5554	1928	298	83614	626	0	86466
5555	984	369	82055	553	0	83961
5556	631	336	84685	546	0	86198
5557	660	256	1921	83952	0	86789
5558	672	340	86275	1524	0	88811
5559	716	241	1472	85408	0	87837
5560	86469	220	831	1756	0	89276
5561	1731	397	87131	851	0	90110
5562	85539	260	1505	641	0	87945
5563	87605	302	981	651	0	89539
5564	2107	415	89509	528	0	92559
5565	1040	92191	1702	575	0	95508
5566	686	1368	945	93443	0	96442
5567	600	980	93775	1597	0	96952
5568	711	336	1750	92287	0	95084
5569	683	347	1015	99575	0	101620
5570	96938	330	537	2368	0	100173
5571	2069	338	449	97164	0	100020
5572	1285	539	96231	1789	0	99844
5573	859	348	1684	96661	0	99552
5574	97058	303	1000	1939	0	100300
5575	1916	97613	648	1005	0	101182
5576	97271	1586	812	595	0	100264
5577	2068	1123	543	96602	0	100336
5578	1387	553	96796	1600	0	100336
5579	838	435	94672	832	0	96777
5580	760	426	93391	480	0	95057
5581	441	90111	1945	352	0	92849
5582	87772	1528	1430	483	0	91213
5583	1224	85991	409	232	0	87856
5584	82722	990	227	270	0	84209
5585	1054	83190	234	141	0	84619
5586	625	1060	179	84344	0	86208
5587	292	498	172	85719	0	86681
5588	251	179	152	85654	0	86236
5589	134	85563	278	1534	0	87509
5590	280	1051	168	92130	0	93629
5591	299	559	150	105969	0	106977
5592	109768	185	163	2436	0	112552
5593	2218	149	162	113738	0	116267
5594	1005	311	117030	2260	0	120606
5595	114683	129	2213	1277	0	118302
5596	118626	157	1028	557	0	120368
5597	3152	118164	432	416	0	122164
5598	119336	2295	256	468	0	122355
5599	122030	1042	211	521	0	123804
5600	3603	288	214	120077	0	124182
5601	1570	194	215	122949	0	124928
5602	749	182	211	125690	0	126832
5603	123570	166	225	3818	0	127779
5604	125187	196	196	1607	0	127186
5605	3735	337	122935	543	0	127550
5606	121926	221	2448	586	0	125181
5607	124029	218	1105	566	0	125918
5608	124690	175	366	610	0	125841
5609	3837	270	119523	477	0	124107
5610	1641	300	121299	451	0	123691
5611	821	150	3493	121290	0	125754
5612	714	326	125225	2866	0	129131
5613	830	179	2796	122676	0	126481
5614	1056	289	1425	110987	0	113757
5615	737	124772	743	3414	0	129666
5616	125225	2522	600	1640	0	129987
5617	3246	1422	126763	688	0	132119
5618	128827	464	2843	756	0	132890
5619	3838	422	1431	131027	0	136718
5620	128653	391	509	3380	0	132933
5621	3612	125824	637	1919	0	131992
5622	2002	132572	565	1171	0	136310
5623	1330	3975	376	130887	0	136568
5624	1177	1482	371	134088	0	137118
5625	1085	662	130697	4680	0	137124
5626	1288	328	3094	131096	0	135806
5627	127731	296	1611	3785	0	133423
5628	3684	127720	872	2146	0	134422
5629	2357	3008	128154	942	0	134461
5630	1615	1418	3267	127345	0	133645
5631	1231	587	130373	3442	0	135633
5632	1261	404	3585	128899	0	134149
5633	900	450	131756	3793	0	136899
5634	911	450	128987	2125	0	132473
5635	1050	433	4431	127657	0	133571
5636	129771	402	1984	3755	0	135912
5637	130030	459	936	2042	0	133467
5638	127739	508	766	1198	0	130211
5639	4764	125761	921	1003	0	132449
5640	127452	2970	687	1082	0	132191
5641	126640	1477	660	1160	0	129937
5642	4789	753	122768	1094	0	129404
5643	2263	121861	3216	1130	0	128470
5644	1577	3180	1553	121131	0	127441
5645	121469	1614	701	3634	0	127418
5646	3411	121789	918	2179	0	128297
5647	125827	3088	732	1482	0	131129
5648	127051	1539	709	1350	0	130649
5649	127128	719	720	1211	0	129778
5650	126546	672	743	1155	0	129116
5651	4978	567	806	122339	0	128690
5652	123287	528	837	3684	0	128336
5653	3889	537	856	120682	0	125964
5654	2020	118946	1127	3715	0	125808
5655	1437	2673	893	121797	0	126800
5656	120519	1274	1015	3631	0	126439
5657	3649	639	120519	2131	0	126938
5658	2582	371	3093	120841	0	126887
5659	120312	397	1703	3406	0	125818
5660	3782	119342	1033	2033	0	126190
5661	121451	2850	701	1146	0	126148
5662	123151	1458	723	1130	0	126462
5663	4756	123026	976	935	0	129693
5664	122318	2860	797	959	0	126934
5665	3960	1618	115772	808	0	122158
5666	2335	871	114308	850	0	118364
5667	111108	694	3649	956	0	116407
5668	3754	841	114966	871	0	120432
5669	2645	650	2584	105237	0	111116
5670	1751	109539	1538	2470	0	115298
5671	111517	2545	621	1471	0	116154
5672	3549	109352	808	1002	0	114711
5673	2332	108719	739	991	0	112781
5674	1776	3249	624	115296	0	120945
5675	1477	1336	550	116851	0	120214
5676	1439	701	490	116624	0	119254
5677	1385	635	524	117036	0	119580
5678	1200	725	113247	3955	0	119127
5679	1293	565	2434	111250	0	115542
5680	1311	578	1396	113493	0	116778
5681	110988	540	721	3731	0	115980
5682	3206	575	648	111554	0	115983
5683	2015	768	108648	2884	0	114315
5684	103970	623	2356	1690	0	108639
5685	3509	668	1269	107933	0	113379
5686	2102	751	110183	2581	0	115617
5687	1604	748	2560	106290	0	111202
5688	1276	109964	1657	2356	0	115253
5689	109224	2153	1007	1507	0	113891
5690	2875	1173	104927	718	0	109693
5691	1178	89525	1741	541	0	92985
5692	85335	1296	953	475	0	88059
5693	1313	81493	507	413	0	83726
5694	699	78003	322	308	0	79332
5695	76695	1155	546	372	0	78768
5696	982	75266	286	347	0	76881
5697	592	75923	303	333	0	77151
5698	942	1191	334	74310	0	76777
5699	519	495	72913	862	0	74789
5700	355	74922	695	621	0	76593
5701	527	840	302	73429	0	75098
5702	318	73638	222	779	0	74957
5703	72660	646	151	561	0	74018
5704	778	413	71856	407	0	73454
5705	529	294	587	72038	0	73448
5706	73960	165	326	902	0	75353
5707	784	168	169	75999	0	77120
5708	475	236	75667	788	0	77166
5709	69390	157	672	598	0	70817
5710	75642	183	328	426	0	76579
5711	931	78428	275	257	0	79891
5712	531	640	161	77926	0	79258
5713	384	352	161	79747	0	80644
5714	79616	183	176	868	0	80843
5715	77849	221	208	487	0	78765
5716	944	307	79495	246	0	80992
5717	429	76749	563	212	0	77953
5718	76790	371	229	200	0	77590
5719	473	340	108	76540	0	77461
5720	271	186	78320	436	0	79213
5721	140	150	74966	237	0	75493
5722	150	487	459	74495	0	75591
5723	76362	39	220	422	0	77043
5724	267	75591	99	200	0	76157
5725	81323	267	48	352	0	81990
5726	351	133	33	82023	0	82540
5727	203	64	44	82924	0	83235
5728	119	54	52	83560	0	83785
5729	82645	53	46	524	0	83268
5730	267	84221	109	220	0	84817
5731	195	265	47	85465	0	85972
5732	101	150	41	85133	0	85425
5733	113	159	84416	368	0	85056
5734	111	61	244	82743	0	83159
5735	85	158	85308	329	0	85880
5736	58	82834	294	246	0	83432
5737	64	226	111	84557	0	84958
5738	82445	102	41	373	0	82961
5739	266	129	82602	138	0	83135
5740	195	48	234	82381	0	82858
5741	104	96	82322	284	0	82806
5742	75059	31	262	309	0	75661
5743	284	151	82765	80	0	83280
5744	187	57	248	78197	0	78689
5745	80389	33	125	367	0	80914
5746	348	66263	142	200	0	66953
5747	75957	228	36	155	0	76376
5748	334	68605	99	118	0	69156
5749	196	246	40	77032	0	77514
5750	95	203	75411	281	0	75990
5751	130	159	73514	189	0	73992
5752	111	79	317	75826	0	76333
5753	77890	40	148	431	0	78509
5754	77167	53	75	271	0	77566
5755	400	52	57	77512	0	78021
5756	215	49	56	79661	0	79981
5757	76348	50	55	501	0	76954
5758	299	73445	96	225	0	74065
5759	160	79061	84	164	0	79469
5760	79438	378	64	226	0	80106
5761	411	276	76749	127	0	77563
5762	283	78	320	75621	0	76302
5763	128	200	75748	412	0	76488
5764	170	50	291	75844	0	76355
5765	164	127	78393	414	0	79098
5766	154	159	77437	225	0	77975
5767	182	54	446	77794	0	78476
5768	112	74830	289	347	0	75578
5769	79896	343	105	359	0	80703
5770	383	79159	155	193	0	79890
5771	277	363	92	79711	0	80443
5772	80175	177	108	536	0	80996
5773	465	78	108	81682	0	82333
5774	81868	80	108	691	0	82747
5775	82588	91	89	428	0	83196
5776	83190	81	104	294	0	83669
5777	577	80297	139	261	0	81274
5778	85028	368	91	319	0	85806
5779	560	326	108	89095	0	90089
5780	92614	107	104	903	0	93728
5781	730	96	93	96354	0	97273
5782	95945	95	108	1255	0	97403
5783	97657	95	116	680	0	98548
5784	1306	96083	178	387	0	97954
5785	642	974	116	105942	0	107674
5786	335	457	120	104921	0	105833
5787	171	108095	204	1739	0	110209
5788	230	1300	104	111418	0	113052
5789	109652	589	145	1768	0	112154
5790	114713	232	146	1005	0	116096
5791	112535	134	150	572	0	113391
5792	2138	236	115248	324	0	117946
5793	118353	108	1457	467	0	120385
5794	124780	113	713	372	0	125978
5795	126153	112	298	444	0	127007
5796	2404	122591	263	286	0	125544
5797	1158	1563	147	125331	0	128199
5798	554	742	126	128791	0	130213
5799	372	358	130	128573	0	129433
5800	312	350	123002	2590	0	126254
5801	342	143	1607	125455	0	127547
5802	125199	123	841	2282	0	128445
5803	1924	127	309	127743	0	130103
5804	1145	136	190	131609	0	133080
5805	655	267	128826	2762	0	132510
5806	358	125763	1968	1416	0	129505
5807	129965	1853	833	772	0	133423
5808	2169	872	314	129801	0	133156
5809	129249	315	211	2270	0	132045
5810	2300	392	127056	1134	0	130882
5811	118751	137	1888	797	0	121573
5812	2287	128187	952	559	0	131985
5813	1239	1959	126600	435	0	130233
5814	593	971	128333	362	0	130259
5815	675	476	2568	122114	0	125833
5816	509	395	130981	2068	0	133953
5817	388	129987	2104	1173	0	133652
5818	507	1817	866	127899	0	131089
5819	476	860	371	132783	0	134490
5820	418	372	198	133104	0	134092
5821	129000	224	164	3100	0	132488
5822	1977	129726	321	1436	0	133460
5823	1245	1794	177	131581	0	134797
5824	686	860	216	133563	0	135325
5825	128066	362	193	2949	0	131570
5826	2068	127807	334	1571	0	131780
5827	130270	1860	235	1058	0	133423
5828	129847	916	271	787	0	131821
5829	129186	411	235	908	0	130740
5830	3249	402	125062	1164	0	129877
5831	1724	335	1846	122043	0	125948
5832	865	124676	1064	2220	0	128825
5833	740	128071	589	1383	0	130783
5834	858	2757	309	122440	0	126364
5835	674	126321	455	2095	0	129545
5836	131013	2203	333	1655	0	135204
5837	2379	1270	129810	926	0	134385
5838	127106	498	1987	1039	0	130630
5839	133880	373	1032	1017	0	136302
5840	3315	387	525	133854	0	138081
5841	134934	357	393	2696	0	138380
5842	2778	139466	532	1534	0	144310
5843	142675	2115	361	1316	0	146467
5844	143506	1144	445	1130	0	146225
5845	154905	674	447	1234	0	157260
5846	4029	675	153843	876	0	159423
5847	2172	691	155023	970	0	158856
5848	1458	431	3596	154590	0	160075
5849	1094	153731	1858	3111	0	159794
5850	1140	159234	982	1935	0	163291
5851	1148	3703	580	156810	0	162241
5852	157372	1779	475	3752	0	163378
5853	3258	836	561	157988	0	162643
5854	1915	620	536	160139	0	163210
5855	156389	546	556	4674	0	162165
5856	3163	155737	698	2795	0	162393
5857	2108	2885	154399	1581	0	160973
5858	1435	1670	153030	1208	0	157343
5859	156459	788	3748	1262	0	162257
5860	3421	709	1873	155235	0	161238
5861	2014	862	158788	3164	0	164828
5862	1443	569	2969	155398	0	160379
5863	1210	583	1606	158394	0	161793
5864	1128	589	873	161847	0	164437
5865	1115	648	647	157754	0	160164
5866	956	153779	829	4472	0	160036
5867	1049	2838	653	156117	0	160657
5868	154243	1563	695	3876	0	160377
5869	3161	153613	974	2199	0	159947
5870	156077	2989	1363	1691	0	162120
5871	158812	1646	662	1507	0	162627
5872	159802	1014	650	1446	0	162912
5873	4528	1037	153182	1198	0	159945
5874	153331	713	2891	1413	0	158348
5875	158221	683	1506	1222	0	161632
5876	156991	646	767	1294	0	159698
5877	157431	580	600	1289	0	159900
5878	4644	153641	767	1123	0	160175
5879	149725	2746	468	1130	0	154069
5880	3492	1737	146423	867	0	152519
5881	1999	767	2201	141647	0	146614
5882	1490	545	1143	145446	0	148624
5883	146854	440	579	3506	0	151379
5884	2904	144739	592	1885	0	150120
5885	139882	2026	308	1059	0	143275
5886	2613	139856	571	696	0	143736
5887	137015	1973	317	722	0	140027
5888	136127	933	247	690	0	137997
5889	2797	149695	411	601	0	153504
5890	149754	2221	237	638	0	152850
5891	154207	1131	401	619	0	156358
5892	3668	142539	488	473	0	147168
5893	1538	147501	507	432	0	149978
5894	153944	3109	596	683	0	158332
5895	3312	1374	230	155434	0	160350
5896	157161	622	206	3169	0	161158
5897	160627	431	168	1684	0	162910
5898	162945	316	171	953	0	164385
5899	161953	302	189	727	0	163171
5900	4558	154555	398	615	0	160126
5901	1904	159377	432	595	0	162308
5902	160533	3707	342	637	0	165219
5903	3379	1840	159216	351	0	164786
5904	1915	834	2858	154423	0	160030
5905	923	412	1449	160996	0	163780
5906	158997	332	454	4324	0	164107
5907	3046	157933	449	2138	0	163566
5908	1978	2875	340	157791	0	162984
5909	1031	1500	194	164364	0	167089
5910	162553	573	195	4825	0	168146
5911	3670	470	218	164326	0	168684
5912	163188	496	276	3915	0	167875
5913	163826	594	282	2093	0	166795
5914	164628	481	244	1201	0	166554
5915	5557	440	324	161103	0	167424
5916	2772	551	274	163019	0	166616
5917	1659	530	178670	4825	0	185684
5918	1412	615	177142	2195	0	181364
5919	177183	462	5697	1116	0	184458
5920	4948	500	2565	183542	0	191555
5921	3147	590	195295	4589	0	203621
5922	1662	611	197552	2663	0	202488
5923	1505	511	7008	196078	0	205102
5924	1451	706	197545	5221	0	204923
5925	1359	618	5325	195443	0	202745
5926	1471	496	2883	199094	0	203944
5927	1142	689	197697	7677	0	207205
5928	1414	399	4982	199518	0	206313
5929	1453	509	2782	199739	0	204483
5930	1620	419	948	206842	0	209829
5931	1321	903	199302	8419	0	209945
5932	1751	552	4843	205808	0	212954
5933	204188	600	2736	6562	0	214086
5934	5962	203724	1300	3937	0	214923
5935	208680	5134	669	1980	0	216463
5936	6804	3306	202868	1327	0	214305
5937	206542	1038	5375	1344	0	214299
5938	209813	718	3162	1351	0	215044
5939	208997	793	1331	1356	0	212477
5940	9367	760	988	202568	0	213683
5941	5311	689	1016	207099	0	214115
5942	2583	740	192045	8653	0	204021
5943	182800	446	5502	4615	0	193363
5944	6604	186577	3588	2121	0	198890
5945	3512	176318	1478	1666	0	182974
5946	1728	182376	1247	1545	0	186896
5947	2315	7181	1224	173049	0	183769
5948	172806	3079	1007	5771	0	182663
5949	175167	951	1118	3864	0	181100
5950	7654	837	170071	2124	0	180686
5951	4188	644	4997	169435	0	179264
5952	2013	655	2931	173774	0	179373
5953	1571	803	169180	8003	0	179557
5954	1525	796	166967	4376	0	173664
5955	164329	512	7101	2472	0	174414
5956	5427	166955	3650	2133	0	178165
5957	171155	4528	1405	2058	0	179146
5958	172468	2677	1192	1921	0	178258
5959	8448	1000	1066	166865	0	177379
5960	4776	592	985	171666	0	178019
5961	165958	587	1036	8081	0	175662
5962	6339	554	1114	167276	0	175283
5963	4174	593	1213	169234	0	175214
5964	166286	579	1269	8265	0	176399
5965	6414	620	1213	167745	0	175992
5966	169378	606	1248	6752	0	177984
5967	171395	586	1330	4513	0	177824
5968	8054	856	166448	2499	0	177857
5969	168193	670	5529	2456	0	176848
5970	170137	651	3597	2397	0	176782
5971	170321	597	1892	2498	0	175308
5972	8411	821	139039	2437	0	150708
5973	160832	558	4511	2566	0	168467
5974	6068	159652	3327	2503	0	171550
5975	164555	4387	1733	2654	0	173329
5976	166398	2563	1567	2563	0	173091
5977	8271	834	1413	162265	0	172783
5978	4881	586	1323	163069	0	169859
5979	2599	162925	1492	8227	0	175243
5980	2930	4643	1144	166250	0	174967
5981	2675	2879	1261	169954	0	176769
5982	165687	1053	1254	8527	0	176521
5983	6912	728	1171	165414	0	174225
5984	5154	627	1027	166663	0	173471
5985	3247	678	1138	164102	0	169165
5986	2616	157052	1479	8674	0	169821
5987	155228	4349	1250	5127	0	165954
5988	6311	156325	1574	2904	0	167114
5989	141744	4325	979	2287	0	149335
5990	5854	2622	136370	1960	0	146806
5991	131126	999	4173	1928	0	138226
5992	5523	946	132899	1992	0	141360
5993	3803	128604	4522	1835	0	138764
5994	123506	3651	3857	1672	0	132686
5995	120949	2296	1476	1623	0	126344
5996	6025	115835	1007	1491	0	124358
5997	3500	118262	1052	1420	0	124234
5998	117298	4513	987	1598	0	124396
5999	119225	2276	810	1516	0	123827
6000	6074	942	721	115913	0	123650
6001	3734	792	654	119777	0	124957
6002	2125	951	115396	5444	0	123916
6003	113066	751	3056	3142	0	120015
6004	4530	704	1993	112461	0	119688
6005	3195	113493	1049	3888	0	121625
6006	2195	2927	531	114271	0	119924
6007	1867	1911	393	115334	0	119505
6008	1540	1059	110324	5440	0	118363
6009	1821	862	2765	111646	0	117094
6010	108578	725	1797	4416	0	115516
6011	3663	105593	984	2965	0	113205
6012	2731	107214	745	1494	0	112184
6013	106588	4089	634	1315	0	112626
6014	108885	2215	669	1180	0	112949
6015	107796	937	598	1132	0	110463
6016	5488	102615	791	980	0	109874
6017	2015	88730	453	580	0	91778
6018	92400	2853	555	591	0	96399
6019	92804	1519	474	687	0	95484
6020	3656	88069	434	613	0	92772
6021	1106	76838	193	336	0	78473
6022	75526	1986	318	393	0	78223
6023	1728	977	96	74575	0	77376
6024	77462	315	137	1551	0	79465
6025	1865	326	86	76167	0	78444
6026	1031	78030	193	1595	0	80849
6027	494	79273	178	944	0	80889
6028	81107	2107	259	483	0	83956
6029	81870	1012	196	447	0	83525
6030	83383	381	148	406	0	84318
6031	2627	81252	214	309	0	84402
6032	1120	1645	75893	212	0	78870
6033	362	77599	1414	213	0	79588
6034	74747	1699	850	264	0	77560
6035	70743	750	218	336	0	72047
6036	2085	349	71684	130	0	74248
6037	889	70607	1346	166	0	73008
6038	502	1460	737	71026	0	73725
6039	370	812	166	68271	0	69619
6040	357	64476	193	1829	0	66855
6041	430	1477	68180	747	0	70834
6042	69403	781	1318	331	0	71833
6043	1635	393	633	71262	0	73923
6044	72070	286	217	1561	0	74134
6045	73215	251	142	895	0	74503
6046	2317	276	118	75848	0	78559
6047	1206	279	132	79334	0	80951
6048	607	299	125	81081	0	82112
6049	528	315	120	81797	0	82760
6050	79060	284	140	2757	0	82241
6051	80092	282	116	1270	0	81760
6052	2729	382	79418	499	0	83028
6053	1421	306	1623	79629	0	82979
6054	690	320	892	81716	0	83618
6055	571	329	269	82744	0	83913
6056	547	416	79548	2734	0	83245
6057	684	259	1679	79255	0	81877
6058	78598	289	931	2128	0	81946
6059	2055	296	324	79593	0	82268
6060	1220	391	78504	2117	0	82232
6061	668	304	1715	79021	0	81708
6062	564	450	78970	2127	0	82111
6063	79779	303	1825	1346	0	83253
6064	2201	285	945	80973	0	84404
6065	81861	276	338	2122	0	84597
6066	80828	297	267	1412	0	82804
6067	3003	311	200	79965	0	83479
6068	81969	296	255	2377	0	84897
6069	2478	300	237	78973	0	81988
6070	1418	84229	337	2114	0	88098
6071	87740	1900	226	1416	0	91282
6072	87739	1041	232	778	0	89790
6073	88782	387	217	754	0	90140
6074	3337	321	256	86993	0	90907
6075	1678	323	226	88144	0	90371
6076	964	326	205	89605	0	91100
6077	728	350	85076	3377	0	89531
6078	709	83526	2004	1697	0	87936
6079	811	1795	972	82081	0	85659
6080	678	1082	81245	2247	0	85252
6081	79075	338	1901	1532	0	82846
6082	2253	240	1034	81244	0	84771
6083	1423	312	80075	2309	0	84119
6084	82007	207	1863	1699	0	85776
6085	2299	231	1025	84512	0	88067
6086	1502	226	405	85844	0	87977
6087	859	188	334	87182	0	88563
6088	85653	181	274	3307	0	89415
6089	87020	209	310	1786	0	89325
6090	86362	172	350	953	0	87837
6091	3023	81555	421	807	0	85806
6092	1411	83758	401	799	0	86369
6093	84102	2265	280	797	0	87444
6094	2276	1042	82919	806	0	87043
6095	1548	362	1723	82206	0	85839
6096	1035	254	992	84466	0	86747
6097	82976	213	382	3014	0	86585
6098	81053	222	270	1684	0	83229
6099	2791	80445	419	919	0	84574
6100	1543	1638	305	81556	0	85042
6101	852	962	79877	2278	0	83969
6102	768	364	80373	1551	0	83056
6103	766	234	2446	81224	0	84670
6104	764	211	1067	84217	0	86259
6105	82042	211	451	3241	0	85945
6106	2365	206	376	84347	0	87294
6107	86528	161	419	2695	0	89803
6108	86372	171	419	1730	0	88692
6109	2892	298	85995	1043	0	90228
6110	85720	155	1719	1037	0	88631
6111	87338	177	1045	1017	0	89577
6112	87639	164	452	1074	0	89329
6113	2944	85389	487	954	0	89774
6114	1450	85861	469	843	0	88623
6115	1029	2464	310	85052	0	88855
6116	824	1001	84064	2249	0	88138
6117	655	81058	1600	1423	0	84736
6118	913	1517	909	76281	0	79620
6119	789	624	345	74654	0	76412
6120	661	75395	415	1832	0	78303
6121	76107	1132	261	1133	0	78633
6122	76604	625	293	764	0	78286
6123	2105	334	76692	663	0	79794
6124	73200	184	1186	740	0	75310
6125	1485	307	73533	572	0	75897
6126	66899	202	1101	634	0	68836
6127	1492	266	71021	564	0	73343
6128	904	69569	1076	462	0	72011
6129	933	727	808	67757	0	70225
6130	547	422	293	69074	0	70336
6131	69013	164	232	1411	0	70820
6132	68999	140	216	936	0	70291
6133	68194	147	177	662	0	69180
6134	1413	217	68941	460	0	71031
6135	957	144	830	68625	0	70556
6136	565	171	518	71059	0	72313
6137	70467	134	243	1447	0	72291
6138	1081	70316	301	789	0	72487
6139	73937	790	220	671	0	75618
6140	1185	532	197	75161	0	77075
6141	900	184	198	77085	0	78367
6142	569	198	197	77483	0	78447
6143	534	200	159	77924	0	78817
6144	550	230	143	77447	0	78370
6145	445	74170	257	1445	0	76317
6146	330	70757	202	614	0	71903
6147	280	69628	167	238	0	70313
6148	301	737	145	69930	0	71113
6149	296	365	68404	536	0	69601
6150	60332	109	498	479	0	61418
6151	573	70798	392	160	0	71923
6152	437	468	148	70894	0	71947
6153	248	274	115	71836	0	72473
6154	72165	112	99	893	0	73269
6155	71294	88	90	500	0	71972
6156	72025	75	126	308	0	72534
6157	935	98	91	74929	0	76053
6158	475	177	74916	664	0	76232
6159	278	192	76458	408	0	77336
6160	247	82	820	78253	0	79402
6161	264	179	78996	748	0	80187
6162	74925	97	624	542	0	76188
6163	753	89	321	77769	0	78932
6164	489	190	78008	735	0	79422
6165	303	82	579	76877	0	77841
6166	248	141	80318	788	0	81495
6167	218	204	83447	453	0	84322
6168	362	218	903	86748	0	88231
6169	168	182	91911	928	0	93189
6170	170	168	87620	487	0	88445
6171	127	76718	1409	240	0	78494
6172	415	1004	568	86114	0	88101
6173	90815	423	180	1172	0	92590
6174	974	131	85	90172	0	91362
6175	531	50	60	94003	0	94644
6176	207	156	91807	1389	0	93559
6177	79117	55	955	892	0	81019
6178	1011	50	456	94745	0	96262
6179	587	46	139	97288	0	98060
6180	94786	44	74	1613	0	96517
6181	997	46	83	97908	0	99034
6182	97382	55	85	1336	0	98858
6183	98098	57	103	764	0	99022
6184	97522	45	98	435	0	98100
6185	1424	94202	209	193	0	96028
6186	96854	877	94	330	0	98155
6187	1008	95835	176	230	0	97249
6188	606	1000	98	96411	0	98115
6189	97146	482	118	1130	0	98876
6190	954	96540	200	683	0	98377
6191	97751	955	111	405	0	99222
6192	1078	96548	195	296	0	98117
6193	95166	1048	118	326	0	96658
6194	1054	93883	224	225	0	95386
6195	569	96453	182	197	0	97401
6196	244	101223	184	232	0	101883
6197	242	1492	109	97285	0	99128
6198	150	101883	196	1046	0	103275
6199	288	1160	123	101566	0	103137
6200	290	592	105	103447	0	104434
6201	258	222	114	103929	0	104523
6202	257	168	96	104227	0	104748
6203	100638	118	100	1944	0	102800
6204	103335	113	109	1020	0	104577
6205	1743	263	101843	387	0	104236
6206	104679	108	1156	561	0	106504
6207	111765	141	634	458	0	112998
6208	114959	143	298	446	0	115846
6209	2320	260	109215	278	0	112073
6210	1078	302	108300	252	0	109932
6211	104413	149	2157	466	0	107185
6212	1873	290	113864	335	0	116362
6213	992	117539	1774	359	0	120664
6214	581	1694	840	119835	0	122950
6215	123320	863	273	2026	0	126482
6216	124649	280	235	1250	0	126414
6217	125220	226	235	655	0	126336
6218	2856	198	196	122652	0	125902
6219	1331	168	179	126171	0	127849
6220	586	412	126286	2691	0	129975
6221	545	218	1740	126344	0	128847
6222	516	215	889	130452	0	132072
6223	128227	159	321	2981	0	131688
6224	2016	129495	414	1286	0	133211
6225	132419	1861	230	786	0	135296
6226	2342	985	228	132245	0	135800
6227	130801	352	253	2278	0	133684
6228	129420	240	286	1382	0	131328
6229	124377	230	272	780	0	125659
6230	2857	125126	376	498	0	128857
6231	1347	128810	421	469	0	131047
6232	763	2599	309	129137	0	132808
6233	129907	1082	287	2336	0	133612
6234	2331	391	330	128017	0	131069
6235	1438	301	272	130376	0	132387
6236	736	513	128779	2943	0	132971
6237	705	247	1841	128935	0	131728
6238	758	245	962	130866	0	132831
6239	759	231	356	130768	0	132114
6240	688	354	127601	3158	0	131801
6241	721	372	123843	1624	0	126560
6242	625	125696	2713	863	0	129897
6243	126736	1855	1146	766	0	130503
6244	2338	988	376	127498	0	131200
6245	1456	602	126941	2212	0	131211
6246	991	268	1859	125659	0	128777
6247	1048	281	995	134967	0	137291
6248	133486	280	395	3086	0	137247
6249	134033	310	331	1659	0	136333
6250	3026	133342	556	719	0	137643
6251	133605	1903	357	785	0	136650
6252	133424	1036	390	707	0	135557
6253	3224	527	298	132028	0	136077
6254	1630	656	131823	2202	0	136311
6255	846	132488	1947	1471	0	136752
6256	132914	1885	1008	1057	0	136864
6257	136264	1022	402	972	0	138660
6258	3011	139150	449	888	0	143498
6259	1735	1956	265	143191	0	147147
6260	148324	1025	303	2902	0	152554
6261	149968	425	335	1812	0	152540
6262	3596	350	347	149968	0	154261
6263	152625	267	363	3018	0	156273
6264	159062	329	301	1896	0	161588
6265	160945	322	393	1051	0	162711
6266	4287	489	162611	809	0	168196
6267	1924	157933	2566	826	0	163249
6268	950	161329	1352	791	0	164422
6269	155139	3125	526	846	0	159636
6270	2761	155427	466	626	0	159280
6271	1798	2729	154672	605	0	159804
6272	1068	1353	2369	154208	0	158998
6273	155028	470	1223	2861	0	159582
6274	2984	407	379	155560	0	159330
6275	156251	366	290	3074	0	159981
6276	156694	345	340	1878	0	159257
6277	156260	311	327	1003	0	157901
6278	3853	150732	551	798	0	155934
6279	1740	161041	502	810	0	164093
6280	161107	3329	293	989	0	165718
6281	160274	1393	308	996	0	162971
6282	161798	474	324	905	0	163501
6283	4231	385	306	158225	0	163147
6284	157995	368	287	3057	0	161707
6285	3070	153194	561	1753	0	158578
6286	1846	160276	499	925	0	163546
6287	1266	3348	295	159084	0	163993
6288	1030	1631	156279	2861	0	161801
6289	1012	714	154345	1581	0	157652
6290	1148	534	3312	155743	0	160737
6291	1011	740	158214	2709	0	162674
6292	1058	570	2491	157893	0	162012
6293	159486	484	1325	2963	0	164258
6294	3249	436	466	159804	0	163955
6295	158728	386	430	3040	0	162584
6296	3079	154009	598	1727	0	159413
6297	2173	2740	155207	731	0	160851
6298	1362	1463	2349	150305	0	155479
6299	1342	610	1220	157987	0	161159
6300	1078	767	158325	3667	0	163837
6301	1294	531	2432	152739	0	156996
6302	1054	161082	1484	2756	0	166376
6303	1377	2599	437	165402	0	169815
6304	1382	1441	340	167653	0	170816
6305	1368	533	311	173751	0	175963
6306	1231	589	169891	4381	0	176092
6307	1005	545	157371	1868	0	160789
6308	142402	392	3778	1086	0	147658
6309	3132	547	157370	623	0	161672
6310	1661	157468	2891	674	0	162694
6311	159559	2460	1464	750	0	164233
6312	2890	160627	694	630	0	164841
6313	157829	2552	726	756	0	161863
6314	157942	1358	420	697	0	160417
6315	156770	529	395	701	0	158395
6316	157073	480	315	803	0	158671
6317	3898	151461	502	584	0	156445
6318	1804	155466	488	646	0	158404
6319	156121	3271	382	719	0	160493
6320	2988	1639	152494	516	0	157637
6321	1837	648	2348	149601	0	154434
6322	936	459	1374	155821	0	158590
6323	809	604	153952	3537	0	158902
6324	138494	424	2506	1859	0	143283
6325	153987	390	1325	960	0	156662
6326	153247	442	544	843	0	155076
6327	3794	149884	675	728	0	155081
6328	157592	2450	531	881	0	161454
6329	3198	1469	551	151182	0	156400
6330	1812	163337	712	2499	0	168360
6331	166985	2838	529	1739	0	172091
6332	168799	1703	476	852	0	171830
6333	177213	775	465	878	0	179331
6334	5180	679	394	173418	0	179671
6335	2835	578	349	174298	0	178060
6336	1325	168630	587	4550	0	175092
6337	1278	3135	171205	2180	0	177798
6338	1354	1817	3042	170137	0	176350
6339	1270	759	1830	171274	0	175133
6340	1190	599	719	179274	0	181782
6341	999	714	174221	5093	0	181027
6342	167853	540	3243	2702	0	174338
6343	3855	515	1909	178210	0	184489
6344	2449	736	179444	3688	0	186317
6345	1490	477	3479	179065	0	184511
6346	180919	428	2029	4195	0	187571
6347	3969	178605	1029	2554	0	186157
6348	2726	3607	600	182863	0	189796
6349	1343	2302	182419	4014	0	190078
6350	169565	760	3751	2664	0	176740
6351	181816	632	2152	1386	0	185986
6352	5778	805	181217	1135	0	188935
6353	3175	852	3748	165199	0	172974
6354	1355	178570	2474	3499	0	185898
6355	181262	3547	999	2363	0	188171
6356	4389	2230	177575	1182	0	185376
6357	171403	836	3925	1343	0	177507
6358	4531	765	171637	1042	0	177975
6359	2853	634	163054	907	0	167448
6360	154901	489	4853	998	0	161241
6361	3499	160945	2428	1227	0	168099
6362	2751	3156	159482	942	0	166331
6363	1198	157714	3444	938	0	163294
6364	1580	3133	153410	878	0	159001
6365	793	153862	3246	897	0	158798
6366	144472	2825	2275	1063	0	150635
6367	2933	1759	142639	764	0	148095
6368	1954	779	143152	681	0	146566
6369	1119	608	142401	697	0	144825
6370	137015	554	3947	775	0	142291
6371	142191	363	2035	743	0	145332
6372	3858	388	926	138756	0	143928
6373	2089	541	144668	2537	0	149835
6374	1119	513	144851	1682	0	148165
6375	142021	384	3806	872	0	147083
6376	3072	420	2022	146566	0	152080
6377	147092	318	1052	2784	0	151246
6378	148526	383	857	1765	0	151531
6379	4179	421	703	138933	0	144236
6380	2242	139793	956	2573	0	145564
6381	1440	2417	811	141940	0	146608
6382	1208	1505	725	143787	0	147225
6383	925	945	141293	3757	0	146920
6384	883	137659	2952	2077	0	143571
6385	823	142628	2054	1039	0	146544
6386	968	3587	1129	136360	0	142044
6387	799	1964	139128	2497	0	144388
6388	757	139104	3089	1814	0	144764
6389	907	2775	139994	875	0	144551
6390	134804	1586	3272	913	0	140575
6391	141844	714	2152	803	0	145513
6392	4000	747	139362	700	0	144809
6393	138179	457	3176	773	0	142585
6394	3442	545	2059	138269	0	144315
6395	2218	146661	1442	2577	0	152898
6396	1544	2541	1080	149709	0	154874
6397	146667	1510	938	3155	0	152270
6398	148434	657	1034	2032	0	152157
6399	148274	580	927	1172	0	150953
6400	145655	460	856	986	0	147957
6401	4252	141034	1086	831	0	147203
6402	2187	141385	964	775	0	145311
6403	139948	3255	980	893	0	145076
6404	3094	1794	140995	674	0	146557
6405	1962	2648	2653	136887	0	144150
6406	959	147853	1897	2485	0	153194
6407	1023	2680	950	143196	0	147849
6408	687	151193	980	2732	0	155592
6409	988	3044	756	151049	0	155837
6410	728	1841	150024	3007	0	155600
6411	144117	801	3127	1960	0	150005
6412	151171	626	1893	976	0	154666
6413	4252	718	149155	593	0	154718
6414	146950	565	3193	753	0	151461
6415	151805	505	1865	702	0	154877
6416	4442	693	148030	525	0	153690
6417	2480	458	3136	142795	0	148869
6418	147249	377	1938	2945	0	152509
6419	3442	625	146756	1639	0	152462
6420	2243	472	3056	140745	0	146516
6421	1207	610	151275	2992	0	156084
6422	1123	639	149094	1680	0	152536
6423	144537	530	4312	1006	0	150385
6424	154673	489	1972	821	0	157955
6425	155998	451	937	754	0	158140
6426	161642	514	732	704	0	163592
6427	5128	710	651	152222	0	158711
6428	2404	147719	767	2829	0	153719
6429	1257	153561	770	1794	0	157382
6430	1081	3695	488	144062	0	149326
6431	144574	1445	587	2841	0	149447
6432	3054	141219	670	1440	0	146383
6433	1400	142315	473	619	0	144807
6434	141063	3388	424	557	0	145432
6435	3149	1521	395	139812	0	144877
6436	142411	499	404	2800	0	146114
6437	3033	140485	485	1382	0	145385
6438	145175	2639	367	726	0	148907
6439	3309	1383	149303	510	0	154505
6440	164962	648	3011	634	0	169255
6441	172281	412	1420	682	0	174795
6442	175514	453	575	713	0	177255
6443	5613	748	145609	636	0	152606
6444	166755	526	2646	644	0	170571
6445	4108	166371	1526	594	0	172599
6446	2103	3396	167576	401	0	173476
6447	1515	1941	3504	160520	0	167480
6448	1055	608	1721	159392	0	162776
6449	726	163789	774	4428	0	169717
6450	948	3176	474	166220	0	170818
6451	894	1485	457	168799	0	171635
6452	778	615	162111	4691	0	168195
6453	148073	348	3481	2320	0	154222
6454	3814	430	165274	767	0	170285
6455	2145	272	3743	161861	0	168021
6456	1090	453	166919	3484	0	171946
6457	943	279	3889	166042	0	171153
6458	171005	276	1872	3955	0	177108
6459	177136	310	834	1937	0	180217
6460	5622	294	564	174331	0	180811
6461	2565	500	178189	3935	0	185189
6462	1468	336	3763	178330	0	183897
6463	1123	552	177423	4124	0	183222
6464	168346	450	4034	2315	0	175145
6465	179296	509	1896	1148	0	182849
6466	178197	525	773	941	0	180436
6467	175803	621	532	997	0	177953
6468	5607	167968	763	892	0	175230
6469	2879	3966	476	171716	0	179037
6470	165996	2080	577	4288	0	172941
6471	4212	165696	699	2336	0	172943
6472	2460	171448	838	1172	0	175918
6473	1603	5004	159505	963	0	167075
6474	161276	1955	4145	791	0	168167
6475	168742	719	2217	755	0	172433
6476	6353	571	161708	603	0	169235
6477	3423	368	4246	158111	0	166148
6478	2222	342	2200	166969	0	171733
6479	1610	508	164288	5463	0	171869
6480	1725	354	4345	161697	0	168121
6481	162256	387	2418	4676	0	169737
6482	4850	552	158837	2449	0	166688
6483	2724	542	164103	1322	0	168691
6484	158020	475	5736	1329	0	165560
6485	4671	674	164307	1135	0	170787
6486	160474	574	4643	1055	0	166746
6487	5114	160284	2461	1067	0	168926
6488	164733	3810	1034	1086	0	170663
6489	5421	1967	819	160748	0	168955
6490	3123	1015	768	165611	0	170517
6491	162501	937	688	5788	0	169914
6492	4944	853	754	163568	0	170119
6493	164115	758	643	4981	0	170497
6494	4956	164279	894	2586	0	172715
6495	3162	4191	716	156536	0	164605
6496	2036	2213	792	161990	0	167031
6497	157946	956	770	5659	0	165331
6498	161563	683	788	2755	0	165789
6499	161848	616	824	1487	0	164775
6500	6699	151526	892	1215	0	160332
6501	3310	156417	1097	966	0	161790
6502	154982	4799	852	975	0	161608
6503	5266	2144	150149	889	0	158448
6504	3129	148214	3934	910	0	156187
6505	137238	3321	3397	1005	0	144961
6506	133817	1422	1178	675	0	137092
6507	133826	560	614	644	0	135644
6508	4853	421	656	127013	0	132943
6509	131158	330	651	3058	0	135197
6510	131269	336	500	1760	0	133865
6511	4843	332	462	124958	0	130595
6512	128169	372	570	3272	0	132383
6513	3628	510	122399	1845	0	128382
6514	2217	453	2810	125628	0	131108
6515	1296	427	1571	129234	0	132528
6516	1251	326	810	132868	0	135255
6517	129222	343	566	4711	0	134842
6518	133729	373	549	2368	0	137019
6519	134880	410	578	1270	0	137138
6520	134642	258	494	1156	0	136550
6521	130115	206	594	920	0	131835
6522	4953	266	583	121791	0	127593
6523	2717	302	492	126227	0	129738
6524	122436	270	581	4106	0	127393
6525	3348	118969	695	2029	0	125041
6526	120718	2383	593	998	0	124692
6527	3448	1236	113610	760	0	119054
6528	124383	404	2487	707	0	127981
6529	132395	332	1333	749	0	134809
6530	4533	408	139729	679	0	145349
6531	145588	228	3271	654	0	149741
6532	4292	336	146703	627	0	151958
6533	2690	322	150953	436	0	154401
6534	1753	525	4857	143267	0	150402
6535	1464	455	2263	155087	0	159269
6536	1160	305	153523	4785	0	159773
6537	1162	410	154652	2431	0	158655
6538	641	146627	4604	1282	0	153154
6539	623	144189	2201	819	0	147832
6540	124247	3343	1708	510	0	129808
6541	2292	131064	537	430	0	134323
6542	127648	2374	559	393	0	130974
6543	2406	126122	417	307	0	129252
6544	125635	2273	280	282	0	128470
6545	2514	1500	119355	261	0	123630
6546	121096	516	1981	254	0	123847
6547	2625	330	1191	119579	0	123725
6548	1590	122036	528	1909	0	126063
6549	853	1943	296	122905	0	125997
6550	122446	1152	224	2311	0	126133
6551	124228	396	196	1388	0	126208
6552	3471	326	217	120528	0	124542
6553	1714	253	118939	2131	0	123037
6554	832	256	117801	1357	0	120246
6555	510	120369	3088	545	0	124512
6556	754	2463	1466	118873	0	123556
6557	492	1225	118999	2041	0	122757
6558	305	108598	2074	1228	0	112205
6559	796	1869	1369	110808	0	114842
6560	367	1080	468	113181	0	115096
6561	106768	405	328	2718	0	110219
6562	1862	272	226	106978	0	109338
6563	1176	285	105230	2131	0	108822
6564	596	153	1743	104775	0	107267
6565	99056	185	1121	2176	0	102538
6566	1870	227	102053	1302	0	105452
6567	99371	137	1765	670	0	101943
6568	2066	103370	1158	430	0	107024
6569	107018	1624	466	397	0	109505
6570	107684	1073	419	349	0	109525
6571	3044	395	283	102334	0	106056
6572	1647	269	255	105410	0	107581
6573	720	103058	327	2723	0	106828
6574	598	1657	242	106775	0	109272
6575	101843	1113	249	2228	0	105433
6576	1878	566	102869	1355	0	106668
6577	1378	401	1641	102053	0	105473
6578	620	102637	1210	1898	0	106365
6579	568	1700	515	104807	0	107590
6580	571	1195	358	106508	0	108632
6581	102233	507	290	2869	0	105899
6582	1856	102749	345	1637	0	106587
6583	1422	1724	281	103916	0	107343
6584	101913	1132	284	2119	0	105448
6585	1990	503	262	103293	0	106048
6586	1433	370	246	104731	0	106780
6587	102438	238	250	3154	0	106080
6588	104038	223	288	1766	0	106315
6589	2946	333	103519	790	0	107588
6590	101801	248	1726	733	0	104508
6591	105394	240	1213	555	0	107402
6592	105969	255	508	529	0	107261
6593	3080	98404	476	516	0	102476
6594	1689	99602	405	425	0	102121
6595	1019	2582	303	98977	0	102881
6596	99639	1311	409	1860	0	103219
6597	100756	578	245	1396	0	102975
6598	2909	362	222	97922	0	101415
6599	1653	388	98677	2021	0	102739
6600	98441	297	1644	1498	0	101880
6601	104557	285	1135	893	0	106870
6602	2892	248	480	100846	0	104466
6603	1767	237	370	103392	0	105766
6604	102155	268	249	2837	0	105509
6605	2103	285	226	101486	0	104100
6606	1477	100997	368	2153	0	104995
6607	957	1635	210	105104	0	107906
6608	102568	1084	186	2367	0	106205
6609	1997	564	102694	1522	0	106777
6610	98043	331	1587	999	0	100960
6611	2141	435	102940	703	0	106219
6612	1624	225	1823	102256	0	105928
6613	103508	251	1173	2079	0	107011
6614	2119	204	518	102797	0	105638
6615	1523	234	356	104254	0	106367
6616	99138	233	360	3058	0	102789
6617	2046	283	99477	1771	0	103577
6618	1525	340	102763	922	0	105550
6619	923	367	2497	102196	0	105983
6620	708	222	1332	106150	0	108412
6621	678	208	593	107355	0	108834
6622	545	344	105087	3037	0	109013
6623	99978	138	1684	2001	0	103801
6624	107532	165	1126	1043	0	109866
6625	107861	170	460	861	0	109352
6626	106283	139	327	713	0	107462
6627	3099	100946	436	599	0	105080
6628	1729	98171	322	573	0	100795
6629	750	91816	250	443	0	93259
6630	733	1862	257	71635	0	74487
6631	587	421	240	75249	0	76497
6632	314	152	72812	784	0	74062
6633	166	66468	440	397	0	67471
6634	610	354	230	63572	0	64766
6635	61053	150	156	478	0	61837
6636	281	61960	113	368	0	62722
6637	256	282	58	60732	0	61328
6638	127	62232	129	355	0	62843
6639	63159	289	62	382	0	63892
6640	433	181	125	62536	0	63275
6641	250	142	60352	399	0	61143
6642	164	144	59946	271	0	60525
6643	207	194	502	62042	0	62945
6644	163	48	220	62630	0	63061
6645	151	25	80	64534	0	64790
6646	63010	50	72	770	0	63902
6647	503	137	62334	300	0	63274
6648	252	61243	410	189	0	62094
6649	169	374	210	61236	0	61989
6650	145	235	61277	485	0	62142
6651	85	61467	403	380	0	62335
6652	171	427	252	62762	0	63612
6653	124	282	63098	432	0	63936
6654	133	103	353	61836	0	62425
6655	154	44	183	63383	0	63764
6656	63986	27	76	678	0	64767
6657	63808	32	47	405	0	64292
6658	653	32	47	63719	0	64451
6659	63900	40	61	591	0	64592
6660	542	123	64964	282	0	65911
6661	299	50	476	65595	0	66420
6662	159	133	67789	575	0	68656
6663	127	240	553	71477	0	72397
6664	82	70988	322	755	0	72147
6665	85	72777	191	449	0	73502
6666	65	75608	128	168	0	75969
6667	174	1013	67	76541	0	77795
6668	137	365	46	88476	0	89024
6669	105	173	87787	1332	0	89397
6670	121	168	89541	587	0	90417
6671	124	185	93300	160	0	93769
6672	94758	82	1640	201	0	96681
6673	1287	68	607	99748	0	101710
6674	101408	58	134	1446	0	103046
6675	1397	103111	171	722	0	105401
6676	772	1521	62	103920	0	106275
6677	106454	747	84	1648	0	108933
6678	1679	197	64	106790	0	108730
6679	106241	83	84	1930	0	108338
6680	1779	185	106251	926	0	109141
6681	874	108808	1544	332	0	111558
6682	343	1538	785	109803	0	112469
6683	110936	782	234	1828	0	113780
6684	112310	198	179	1066	0	113753
6685	2453	122	149	112383	0	115107
6686	1095	114	196	114208	0	115613
6687	110913	120	262	2667	0	113962
6688	1807	120	318	111029	0	113274
6689	1017	206	109741	1971	0	112935
6690	401	109478	1848	1130	0	112857
6691	435	1636	952	111284	0	114307
6692	111995	861	373	2090	0	115319
6693	113447	348	263	1286	0	115344
6694	2805	351	113889	661	0	117706
6695	1343	110271	1915	623	0	114152
6696	638	116744	1072	769	0	119223
6697	625	2841	387	116354	0	120207
6698	638	1109	308	119392	0	121447
6699	622	429	340	119195	0	120586
6700	581	337	325	118472	0	119715
6701	564	115199	432	3375	0	119570
6702	760	1995	320	116898	0	119973
6703	753	1078	278	119033	0	121142
6704	115897	391	233	3626	0	120147
6705	115641	311	267	1890	0	118109
6706	3253	114947	370	1036	0	119606
6707	117191	2081	297	1077	0	120646
6708	117292	1117	311	1008	0	119728
6709	117588	477	317	1027	0	119409
6710	3537	465	113316	889	0	118207
6711	1862	406	2097	113386	0	117751
6712	1033	410	1177	117254	0	119874
6713	879	520	113703	3437	0	118539
6714	840	446	2174	113742	0	117202
6715	862	483	1210	112009	0	114564
6716	112984	456	575	3790	0	117805
6717	2538	604	112290	2152	0	117584
6718	1627	463	2128	110283	0	114501
6719	108514	457	1207	3150	0	113328
6720	2426	108278	626	2228	0	113558
6721	109275	2204	340	1536	0	113355
6722	107765	1307	344	1333	0	110749
6723	3430	105409	469	1263	0	110571
6724	2046	2283	281	105594	0	110204
6725	106573	1287	285	2970	0	111115
6726	2881	106219	434	1864	0	111398
6727	2029	2301	374	107208	0	111912
6728	106221	1339	439	2931	0	110930
6729	105150	617	428	2038	0	108233
6730	3584	103649	500	1404	0	109137
6731	105586	2206	445	1301	0	109538
6732	3023	1288	485	104807	0	109603
6733	105117	590	451	3277	0	109435
6734	3044	538	102625	2133	0	108340
6735	2064	418	2303	102913	0	107698
6736	1265	444	1366	104460	0	107535
6737	101876	458	672	3944	0	106950
6738	2891	100118	715	2212	0	105936
6739	98895	2254	567	1403	0	103119
6740	3031	98839	608	1279	0	103757
6741	2045	2448	95452	1193	0	101138
6742	1414	1538	95379	1167	0	99498
6743	1454	1100	3067	93888	0	99509
6744	1248	763	95094	2931	0	100036
6745	1254	788	2149	95659	0	99850
6746	1285	593	1145	95223	0	98246
6747	1406	588	486	99023	0	101503
6748	97753	692	349	3956	0	102750
6749	98145	669	328	2212	0	101354
6750	100596	615	350	1415	0	102976
6751	4281	97437	440	1263	0	103421
6752	2420	104469	537	1220	0	108646
6753	1644	3609	108762	1184	0	115199
6754	1494	1659	2809	111073	0	117035
6755	1358	855	111011	3805	0	117029
6756	1375	698	3032	111060	0	116165
6757	1374	625	1670	113239	0	116908
6758	1306	607	754	114256	0	116923
6759	1200	710	107944	5146	0	115000
6760	1251	631	2997	108718	0	113597
6761	106501	529	1774	4110	0	112914
6762	3396	103644	1048	2599	0	110687
6763	2218	2665	657	100830	0	106370
6764	100038	1515	652	3575	0	105780
6765	99917	727	551	2383	0	103578
6766	4574	537	522	96077	0	101710
6767	2643	410	440	92706	0	96199
6768	82737	348	360	3907	0	87352
6769	3144	277	321	82900	0	86642
6770	76182	300	257	3042	0	79781
6771	2967	277	215	74153	0	77612
6772	1503	267	68728	2704	0	73202
6773	863	64255	1796	1547	0	68461
6774	688	67538	1023	841	0	70090
6775	1139	2248	1063	63447	0	67897
6776	847	976	735	64640	0	67198
6777	62815	401	269	2535	0	66020
6778	1793	294	240	63872	0	66199
6779	1049	236	238	64514	0	66037
6780	622	236	191	60336	0	61385
6781	457	57762	263	2688	0	61170
6782	470	1501	214	60213	0	62398
6783	535	803	198	60113	0	61649
6784	478	407	193	60173	0	61251
6785	55194	272	263	2834	0	58563
6786	1661	55866	317	1480	0	59324
6787	1014	1450	217	57490	0	60171
6788	626	764	212	58405	0	60007
6789	523	350	194	59036	0	60103
6790	55859	219	212	2837	0	59127
6791	1904	181	171	56670	0	58926
6792	1141	160	150	55677	0	57128
6793	533	241	50875	2533	0	54182
6794	345	49256	1274	1408	0	52283
6795	394	1440	651	50550	0	53035
6796	48850	666	305	1780	0	51601
6797	1392	49482	228	1082	0	52184
6798	48710	1264	133	677	0	50784
6799	48896	668	144	527	0	50235
6800	1881	335	130	47993	0	50339
6801	998	176	146	49621	0	50941
6802	496	223	48531	2139	0	51389
6803	421	197	1189	50216	0	52023
6804	291	216	50179	1809	0	52495
6805	342	164	1320	51208	0	53034
6806	47900	139	699	1912	0	50650
6807	1305	49219	352	1158	0	52034
6808	858	1259	215	52547	0	54879
6809	459	723	180	53639	0	55001
6810	400	337	221	53658	0	54616
6811	302	216	184	54274	0	54976
6812	51504	149	189	2555	0	54397
6813	1347	50934	282	1469	0	54032
6814	848	1215	164	52998	0	55225
6815	52883	671	144	2014	0	55712
6816	1490	367	51884	1312	0	55053
6817	51641	216	1262	920	0	54039
6818	53418	222	683	765	0	55088
6819	2119	327	52102	585	0	55133
6820	1085	254	1308	52737	0	55384
6821	53369	236	738	1867	0	56210
6822	1579	54520	444	1213	0	57756
6823	56559	1334	240	968	0	59101
6824	57015	680	198	871	0	58764
6825	57788	290	195	793	0	59066
6826	2309	238	158	56098	0	58803
6827	1279	183	148	58061	0	59671
6828	658	61872	262	2395	0	65187
6829	666	1527	149	63854	0	66196
6830	63388	855	135	2199	0	66577
6831	1781	496	62365	1297	0	65939
6832	61590	275	1409	980	0	64254
6833	65525	201	765	804	0	67295
6834	2472	231	280	63183	0	66166
6835	1291	165	199	65743	0	67398
6836	64950	160	167	2733	0	68010
6837	65678	147	176	1578	0	67579
6838	62355	185	186	1016	0	63742
6839	2455	259	63788	743	0	67245
6840	1129	63048	1418	699	0	66294
6841	63973	1409	710	654	0	66746
6842	1759	825	302	63190	0	66076
6843	1063	63676	227	1774	0	66740
6844	736	1512	134	63922	0	66304
6845	62969	773	164	1959	0	65865
6846	1745	443	128	63790	0	66106
6847	1252	319	61892	1894	0	65357
6848	482	61436	1156	1255	0	64329
6849	374	63258	726	771	0	65129
6850	476	1588	58904	566	0	61534
6851	50782	1184	1463	578	0	54007
6852	981	52182	603	437	0	54203
6853	697	634	251	44794	0	46376
6854	44783	274	78	633	0	45768
6855	587	44110	100	370	0	45167
6856	381	485	106	44590	0	45562
6857	44675	265	122	637	0	45699
6858	623	98	68	44667	0	45456
6859	44542	71	65	735	0	45413
6860	693	132	44820	380	0	46025
6861	399	45337	499	224	0	46459
6862	47754	496	230	363	0	48843
6863	47551	270	104	306	0	48231
6864	47593	114	88	292	0	48087
6865	901	173	45408	200	0	46682
6866	45423	106	450	250	0	46229
6867	47558	113	245	281	0	48197
6868	853	125	124	47079	0	48181
6869	47297	121	69	685	0	48172
6870	701	46494	124	399	0	47718
6871	465	498	112	47154	0	48229
6872	315	370	46806	591	0	48082
6873	284	176	525	46481	0	47466
6874	249	149	279	47449	0	48126
6875	46978	131	123	868	0	48100
6876	46705	152	92	496	0	47445
6877	900	190	45948	245	0	47283
6878	44793	113	503	281	0	45690
6879	803	174	46027	216	0	47220
6880	519	116	536	45881	0	47052
6881	385	187	46225	639	0	47436
6882	353	155	549	44963	0	46020
6883	313	45866	335	641	0	47155
6884	377	539	46510	361	0	47787
6885	383	351	47787	185	0	48706
6886	416	191	867	39554	0	41028
6887	48209	122	374	705	0	49410
6888	48365	139	149	480	0	49133
6889	48795	139	121	315	0	49370
6890	1061	112	126	47563	0	48862
6891	631	113	114	48716	0	49574
6892	422	115	91	48954	0	49582
6893	368	117	127	48871	0	49483
6894	310	205	47803	965	0	49283
6895	339	175	612	47271	0	48397
6896	272	47053	397	756	0	48478
6897	281	564	165	48230	0	49240
6898	48943	328	152	856	0	50279
6899	856	217	49344	488	0	50905
6900	45589	116	711	366	0	46782
6901	909	160	51534	240	0	52843
6902	569	124	51685	226	0	52604
6903	284	51421	1156	226	0	53087
6904	382	869	586	46033	0	47870
6905	306	495	243	48900	0	49944
6906	261	46062	289	1247	0	47859
6907	55689	917	173	595	0	57374
6908	1228	586	157	57735	0	59706
6909	881	186	147	62776	0	63990
6910	379	120	142	65836	0	66477
6911	71142	103	142	2391	0	73778
6912	75326	106	130	1202	0	76764
6913	2744	105	130	74248	0	77227
6914	1273	82	117	75326	0	76798
6915	73029	94	123	2846	0	76092
6916	1961	108	124	73921	0	76114
6917	1192	112	143	74889	0	76336
6918	560	99	157	76025	0	76841
6919	371	136	71834	2962	0	75303
6920	68168	62	1711	1485	0	71426
6921	72128	90	915	696	0	73829
6922	2789	140	68401	518	0	71848
6923	1398	476	1675	62908	0	66457
6924	513	67857	1071	1854	0	71295
6925	66482	1624	331	1194	0	69631
6926	1777	67416	366	690	0	70249
6927	1034	64841	238	547	0	66660
6928	743	2183	272	61750	0	64948
6929	61048	887	194	1866	0	63995
6930	63312	254	151	1178	0	64895
6931	2493	187	145	62051	0	64876
6932	1254	178	168	63055	0	64655
6933	630	221	119	63204	0	64174
6934	559	235	111	63075	0	63980
6935	522	210	123	61156	0	62011
6936	367	59115	188	2729	0	62399
6937	474	1498	120	60688	0	62780
6938	59432	793	108	2222	0	62555
6939	60914	247	128	1399	0	62688
6940	61045	155	156	864	0	62220
6941	2542	58342	217	808	0	61909
6942	1335	1502	153	58541	0	61531
6943	622	867	58376	2029	0	61894
6944	57151	347	1506	1405	0	60409
6945	1929	436	820	58047	0	61232
6946	58911	304	320	1992	0	61527
6947	57913	246	159	1293	0	59611
6948	58371	254	125	658	0	59408
6949	2800	256	160	55832	0	59048
6950	56647	227	153	1932	0	58959
6951	2143	242	144	56698	0	59227
6952	1393	179	178	57730	0	59480
6953	56340	173	172	2744	0	59429
6954	2006	219	103	57440	0	59768
6955	56767	194	101	2288	0	59350
6956	57554	220	95	1494	0	59363
6957	2825	186	81	56948	0	60040
6958	1552	192	86	58370	0	60200
6959	902	192	61	59559	0	60714
6960	803	203	54667	2929	0	58602
6961	722	211	55450	1672	0	58055
6962	749	147	2124	54304	0	57324
6963	737	198	947	55184	0	57066
6964	683	145	307	56391	0	57526
6965	725	155	219	56035	0	57134
6966	768	158	203	56730	0	57859
6967	53633	131	213	3098	0	57075
6968	1963	52948	296	1687	0	56894
6969	1424	1471	236	54376	0	57507
6970	54386	821	302	2210	0	57719
6971	2066	277	234	54938	0	57515
6972	1350	215	155	55520	0	57240
6973	53503	203	154	3031	0	56891
6974	54155	170	127	1842	0	56294
6975	2789	249	52468	1044	0	56550
6976	1632	161	1440	53312	0	56545
6977	911	213	53764	2313	0	57201
6978	789	181	1572	54488	0	57030
6979	780	105	867	54621	0	56373
6980	790	112	317	55726	0	56945
6981	682	142	52616	3195	0	56635
6982	563	51013	1670	1883	0	55129
6983	636	54010	1046	1153	0	56845
6984	625	2102	395	53111	0	56233
6985	52057	893	309	2352	0	55611
6986	1840	309	51750	1742	0	55641
6987	1227	250	53827	1142	0	56446
6988	717	225	2345	53245	0	56532
6989	622	232	1092	52523	0	54469
6990	503	54989	508	2839	0	58839
6991	555	1594	382	55245	0	57776
6992	562	988	285	57702	0	59537
6993	607	390	284	59018	0	60299
6994	55769	202	270	3104	0	59345
6995	56135	199	319	1663	0	58316
6996	2644	223	313	55855	0	59035
6997	1308	55205	394	2250	0	59157
6998	724	1422	199	55117	0	57462
6999	53012	820	208	2349	0	56389
7000	1661	54187	326	1636	0	57810
7001	1151	1387	197	49391	0	52126
7002	537	50405	277	1868	0	53087
7003	49239	1402	227	1295	0	52163
7004	47079	804	272	833	0	48988
7005	1984	48726	293	756	0	51759
7006	901	48527	259	678	0	50365
7007	537	1531	43820	570	0	46458
7008	312	41454	1029	501	0	43296
7009	561	1255	627	35470	0	37913
7010	237	466	35136	958	0	36797
7011	72	27023	409	321	0	27825
7012	85	330	235	24453	0	25103
7013	71	175	50	25123	0	25419
7014	56	45	35	25391	0	25527
7015	24523	38	35	525	0	25121
7016	309	61	23836	264	0	24470
7017	188	70	23686	102	0	24046
7018	80	46	424	23643	0	24193
7019	71	80	26504	364	0	27019
7020	82	44	304	26717	0	27147
7021	66	55	181	25756	0	26058
7022	74	49	53	27946	0	28122
7023	65	43	39	28203	0	28350
7024	27192	45	46	544	0	27827
7025	27205	50	42	271	0	27568
7026	461	40	37	27890	0	28428
7027	234	72	29603	380	0	30289
7028	89	46	307	29672	0	30114
7029	63	29822	208	368	0	30461
7030	73	326	61	30071	0	30531
7031	29967	178	59	441	0	30645
7032	30678	78	52	291	0	31099
7033	487	63	50	30928	0	31528
7034	231	54	57	31187	0	31529
7035	89	61	40	31680	0	31870
7036	30440	54	58	584	0	31136
7037	351	99	30772	291	0	31513
7038	252	70	30340	182	0	30844
7039	79	30044	407	123	0	30653
7040	30841	287	173	143	0	31444
7041	322	167	75	31191	0	31755
7042	190	92	32219	440	0	32941
7043	69	31438	278	249	0	32034
7044	65	32692	179	142	0	33078
7045	108	365	58	33130	0	33661
7046	92	175	48	34165	0	34480
7047	63	33676	53	466	0	34258
7048	91	266	56	34878	0	35291
7049	89	160	58	34953	0	35260
7050	34284	72	48	490	0	34894
7051	277	34345	75	299	0	34996
7052	180	270	40	34438	0	34928
7053	92	195	33896	341	0	34524
7054	107	104	253	33561	0	34025
7055	33911	62	145	374	0	34492
7056	262	33985	84	251	0	34582
7057	197	247	43	34671	0	35158
7058	95	194	34261	355	0	34905
7059	98	98	35834	251	0	36281
7060	95	83	433	37206	0	37817
7061	103	78	200	38784	0	39165
7062	39153	58	79	558	0	39848
7063	338	39655	95	263	0	40351
7064	40346	371	66	204	0	40987
7065	426	259	40391	142	0	41218
7066	37386	87	405	186	0	38064
7067	440	109	41262	136	0	41947
7068	38419	72	436	210	0	39137
7069	40995	77	241	184	0	41497
7070	657	133	44912	138	0	45840
7071	304	109	44470	161	0	45044
7072	103	43867	686	160	0	44816
7073	108	442	265	46879	0	47694
7074	48138	254	92	610	0	49094
7075	500	85	79	49316	0	49980
7076	323	63	80	50113	0	50579
7077	120	67	87	50557	0	50831
7078	103	123	49632	792	0	50650
7079	42104	63	498	547	0	43212
7080	49411	61	284	248	0	50004
7081	715	51627	154	176	0	52672
7082	360	471	87	50943	0	51861
7083	111	52533	127	540	0	53311
7084	121	539	84	53501	0	54245
7085	53074	273	77	672	0	54096
7086	562	52952	114	384	0	54012
7087	373	485	54	51950	0	52862
7088	51458	276	64	631	0	52429
7089	51491	92	85	383	0	52051
7090	845	60	63	50119	0	51087
7091	407	105	50442	574	0	51528
7092	179	235	481	48443	0	49338
7093	86	50779	318	506	0	51689
7094	50920	482	83	358	0	51843
7095	509	51071	109	133	0	51822
7096	364	474	68	50369	0	51275
7097	51378	244	70	631	0	52323
7098	570	84	55	53271	0	53980
7099	347	60	46	53712	0	54165
7100	160	121	53290	745	0	54316
7101	90	52876	540	376	0	53882
7102	51975	433	256	176	0	52840
7103	48341	282	91	243	0	48957
7104	532	52035	105	115	0	52787
7105	243	52997	80	163	0	53483
7106	196	596	48	52438	0	53278
7107	51774	233	60	506	0	52573
7108	416	51832	85	287	0	52620
7109	294	409	43	52681	0	53427
7110	131	295	52174	449	0	53049
7111	151	74	391	51775	0	52391
7112	52807	50	215	558	0	53630
7113	416	53339	118	361	0	54234
7114	286	425	52	55564	0	56327
7115	148	308	54604	460	0	55520
7116	139	150	54547	292	0	55128
7117	157	78	612	55001	0	55848
7118	175	59	267	57017	0	57518
7119	111	55709	103	698	0	56621
7120	175	510	59	55634	0	56378
7121	56119	274	80	594	0	57067
7122	557	130	58	56984	0	57729
7123	56858	93	89	669	0	57709
7124	570	56492	118	345	0	57525
7125	411	58442	118	176	0	59147
7126	228	718	123	59863	0	60932
7127	224	292	116	58680	0	59312
7128	179	230	58526	788	0	59723
7129	213	119	510	57283	0	58125
7130	57767	128	335	712	0	58942
7131	629	205	57961	406	0	59201
7132	443	115	509	58535	0	59602
7133	248	180	61951	711	0	63090
7134	235	117	628	62021	0	63001
7135	275	117	353	62360	0	63105
7136	225	110	162	63921	0	64418
7137	195	225	63141	969	0	64530
7138	253	151	640	61185	0	62229
7139	176	63385	402	772	0	64735
7140	186	641	133	64755	0	65715
7141	196	372	82	64533	0	65183
7142	63174	199	97	1080	0	64550
7143	710	210	62675	609	0	64204
7144	494	139	598	62652	0	63883
7145	265	197	62734	829	0	64025
7146	238	231	60463	553	0	61485
7147	294	137	887	62276	0	63594
7148	300	169	398	61798	0	62665
7149	200	163	160	65812	0	66335
7150	64480	157	116	1289	0	66042
7151	741	243	64109	624	0	65717
7152	63313	170	668	523	0	64674
7153	852	137	361	68493	0	69843
7154	512	137	182	70263	0	71094
7155	228	73971	186	1187	0	75572
7156	272	678	127	75901	0	76978
7157	250	361	145	75727	0	76483
7158	385	172	134	75619	0	76310
7159	68801	100	113	1184	0	70198
7160	652	204	68515	538	0	69909
7161	60287	99	556	478	0	61420
7162	618	69158	377	312	0	70465
7163	67959	538	130	334	0	68961
7164	563	67966	157	267	0	68953
7165	372	67986	156	329	0	68843
7166	392	836	148	68152	0	69528
7167	68528	299	162	736	0	69725
7168	579	118	82	69112	0	69891
7169	280	67855	151	730	0	69016
7170	159	68972	136	453	0	69720
7171	142	783	85	69018	0	70028
7172	161	352	76	68680	0	69269
7173	110	69444	153	983	0	70690
7174	196	588	84	71715	0	72583
7175	166	320	80	71508	0	72074
7176	182	119	95	72226	0	72622
7177	69995	84	81	1262	0	71422
7178	638	209	70781	494	0	72122
7179	67712	106	592	506	0	68916
7180	72898	74	297	427	0	73696
7181	72080	84	142	348	0	72654
7182	856	71559	163	231	0	72809
7183	477	497	71	71062	0	72107
7184	71143	254	105	759	0	72261
7185	615	138	73	72231	0	73057
7186	71997	81	91	815	0	72984
7187	571	75283	135	441	0	76430
7188	77786	520	59	491	0	78856
7189	78844	276	65	447	0	79632
7190	79638	137	82	387	0	80244
7191	864	101	69	78939	0	79973
7192	490	118	56	81362	0	82026
7193	80688	120	54	1051	0	81913
7194	528	80637	120	519	0	81804
7195	319	80824	122	285	0	81550
7196	83259	652	80	481	0	84472
7197	589	294	72	83181	0	84136
7198	418	136	87	83226	0	83867
7199	243	118	65	84623	0	85049
7200	169	82969	157	996	0	84291
7201	82301	588	72	679	0	83640
7202	715	318	66	84020	0	85119
7203	402	84751	129	724	0	86006
7204	311	631	76	88379	0	89397
7205	250	365	79	88490	0	89184
7206	232	186	67	88557	0	89042
7207	242	94	64	89314	0	89714
7208	87793	123	48	1279	0	89243
7209	87397	120	54	726	0	88297
7210	88292	90	72	563	0	89017
7211	1103	132	52	88569	0	89856
7212	636	234	86859	761	0	88490
7213	377	245	81216	535	0	82373
7214	288	254	83765	353	0	84660
7215	84167	196	919	499	0	85781
7216	784	141	372	87606	0	88903
7217	523	153	134	87659	0	88469
7218	299	121	72	88472	0	88964
7219	86159	124	67	1258	0	87608
7220	85508	147	74	752	0	86481
7221	993	89430	167	373	0	90963
7222	523	564	49	90067	0	91203
7223	284	491	88370	740	0	89885
7224	212	89880	592	537	0	91221
7225	294	588	271	90522	0	91675
7226	290	358	104	90524	0	91276
7227	253	184	59	89859	0	90355
7228	280	119	58	88209	0	88666
7229	248	232	86924	1005	0	88409
7230	269	241	83794	579	0	84883
7231	188	87280	773	398	0	88639
7232	282	507	283	87639	0	88711
7233	222	290	103	85505	0	86120
7234	82840	126	94	1061	0	84121
7235	609	229	84227	484	0	85549
7236	424	120	486	83671	0	84701
7237	287	92	262	86357	0	86998
7238	318	229	87883	872	0	89302
7239	150	87659	559	553	0	88921
7240	87583	475	300	504	0	88862
7241	641	428	86972	269	0	88310
7242	83596	128	456	433	0	84613
7243	657	301	90004	259	0	91221
7244	442	128	485	89958	0	91013
7245	273	276	90982	615	0	92146
7246	257	262	92336	447	0	93302
7247	296	92	662	91748	0	92798
7248	391	201	421	80773	0	81786
7249	221	78	135	96244	0	96678
7250	222	86	104	94951	0	95363
7251	239	92	139	94873	0	95343
7252	200	272	93293	881	0	94646
7253	215	259	88787	586	0	89847
7254	133	92967	755	361	0	94216
7255	91290	485	360	445	0	92580
7256	630	341	137	92224	0	93332
7257	92002	108	112	991	0	93213
7258	814	84	129	91888	0	92915
7259	93468	76	101	1195	0	94840
7260	745	72	126	94894	0	95837
7261	459	65	133	95188	0	95845
7262	187	96345	225	1036	0	97793
7263	243	635	123	99603	0	100604
7264	213	347	126	99663	0	100349
7265	282	120	115	99655	0	100172
7266	215	76	112	98578	0	98981
7267	83	96256	211	1129	0	97679
7268	95876	516	108	759	0	97259
7269	556	95639	216	313	0	96724
7270	345	536	74	93408	0	94363
7271	91522	273	74	915	0	92784
7272	598	274	89655	411	0	90938
7273	386	241	89289	246	0	90162
7274	358	167	739	85562	0	86826
7275	147	70	377	89873	0	90467
7276	164	56	141	90022	0	90383
7277	176	79	136	86745	0	87136
7278	147	52	99	88017	0	88315
7279	92	85522	176	899	0	86689
7280	154	468	93	87704	0	88419
7281	87364	256	105	947	0	88672
7282	607	113	92	89285	0	90097
7283	386	222	91930	773	0	93311
7284	192	70	721	91046	0	92029
7285	89919	71	445	1148	0	91583
7286	718	94413	240	675	0	96046
7287	545	761	84	104753	0	106143
7288	257	459	83	111438	0	112237
7289	228	285	109520	2181	0	112214
7290	265	282	144336	1009	0	145892
7291	161998	137	3486	617	0	166238
7292	3951	112	1351	165920	0	171334
7293	2041	110	528	170920	0	173599
7294	887	313	177473	5770	0	184443
7295	602	298	179592	2780	0	183272
7296	217	179362	6167	1484	0	187230
7297	526	4315	2668	177254	0	184763
7298	580	2130	178053	4310	0	185073
7299	162	179357	4657	2476	0	186652
7300	180072	4412	2303	1205	0	187992
7301	186773	2162	1081	844	0	190860
7302	6491	975	495	176188	0	184149
7303	2852	181879	649	4485	0	189865
7304	181941	4527	377	2464	0	189309
7305	5345	2532	497	156805	0	165179
7306	2720	1122	178022	3813	0	185677
7307	1188	180314	4595	2198	0	188295
7308	179356	4618	2233	1338	0	187545
7309	182861	2287	951	1091	0	187190
7310	6649	1090	524	181438	0	189701
7311	3163	494	463	186293	0	190413
7312	1407	629	178991	7023	0	188050
7313	1204	440	4652	182677	0	188973
7314	1003	453	2374	180091	0	183921
7315	871	376	1094	184596	0	186937
7316	926	435	770	184431	0	186562
7317	945	408	726	176705	0	178784
7318	563	176091	825	8088	0	185567
7319	176551	4585	624	4244	0	186004
7320	5007	2473	176033	2350	0	185863
7321	2524	173304	5007	1688	0	182523
7322	1678	4749	2495	176928	0	185850
7323	176757	2452	1334	5862	0	186405
7324	5178	1239	1038	177917	0	185372
7325	2891	850	904	180132	0	184777
7326	1691	660	722	182677	0	185750
7327	1259	637	768	183509	0	186173
7328	1088	756	174105	8786	0	184735
7329	882	174721	5240	4754	0	185597
7330	175404	4979	2628	2828	0	185839
7331	5589	2759	174885	2049	0	185282
7332	3195	1414	5509	175412	0	185530
7333	175751	1012	2925	6159	0	185847
7334	5436	175178	1900	3725	0	186239
7335	178047	5106	1146	2671	0	186970
7336	6402	2913	1008	169814	0	180137
7337	3673	1580	920	181214	0	187387
7338	2439	1047	766	180799	0	185051
7339	1830	838	751	181842	0	185261
7340	172704	1009	868	9415	0	183996
7341	5964	990	803	176426	0	184183
7342	3763	686	826	179700	0	184975
7343	169317	769	958	8951	0	179995
7344	5827	1012	167748	5211	0	179798
7345	3631	814	5014	170828	0	180287
7346	164970	664	2784	7100	0	175518
7347	167994	663	1565	4690	0	174912
7348	7804	671	1081	164469	0	174025
7349	4336	667	1047	164229	0	170279
7350	2135	157242	1378	8616	0	169371
7351	1779	4885	891	163557	0	171112
7352	1869	2585	809	165098	0	170361
7353	1466	1452	155988	9074	0	167980
7354	1227	1086	155492	5448	0	163253
7355	1072	153290	7215	3682	0	165259
7356	1593	4925	3547	152063	0	162128
7357	1547	2667	2009	158443	0	164666
7358	154264	1479	1485	8509	0	165737
7359	5662	1027	1334	155459	0	163482
7360	3379	1167	151179	7577	0	163302
7361	2336	925	5181	154852	0	163294
7362	1604	1114	148541	7793	0	159052
7363	1557	1177	150175	4885	0	157794
7364	1651	951	7427	145575	0	155604
7365	1694	1060	3747	152491	0	158992
7366	148798	1070	1905	8479	0	160252
7367	152837	852	1355	5171	0	160215
7368	8100	913	1229	150753	0	160995
7369	153560	932	969	7144	0	162605
7370	157085	719	901	4698	0	163403
7371	8338	820	806	154058	0	164022
7372	4679	869	798	158876	0	165222
7373	153638	781	850	9003	0	164272
7374	157249	496	825	5787	0	164357
7375	7937	486	927	154162	0	163512
7376	4205	152243	1313	7285	0	165046
7377	2942	4850	709	156805	0	165306
7378	2313	2381	774	160725	0	166193
7379	1622	1407	151774	9820	0	164623
7380	1855	739	4820	158476	0	165890
7381	148529	634	2771	8286	0	160220
7382	5168	150356	2254	5235	0	163013
7383	150559	4532	881	3792	0	159764
7384	151842	2422	846	3178	0	158288
7385	153262	1285	812	2911	0	158270
7386	8651	1955	975	142830	0	154411
7387	5009	1010	125919	5935	0	137873
7388	3068	860	120966	3406	0	128300
7389	1705	119322	5537	2626	0	129190
7390	770	83453	1864	1352	0	87439
7391	620	62313	676	646	0	64255
7392	580	60597	929	620	0	62726
7393	1283	1716	56842	562	0	60403
7394	45320	1189	2007	499	0	49015
7395	789	232	430	45955	0	47406
7396	479	88	113	45595	0	46275
7397	245	119	98	45210	0	45672
7398	174	44989	172	1015	0	46350
7399	43573	542	124	577	0	44816
7400	661	377	43741	279	0	45058
7401	301	40600	534	227	0	41662
7402	212	564	404	40857	0	42037
7403	40760	238	136	628	0	41762
7404	542	71	75	40872	0	41560
7405	351	105	39764	614	0	40834
7406	228	111	40142	385	0	40866
7407	233	57	629	40909	0	41828
7408	178	54	295	41557	0	42084
7409	40646	44	107	851	0	41648
7410	558	107	40532	390	0	41587
7411	39399	61	490	252	0	40202
7412	40318	73	266	258	0	40915
7413	762	65	83	40579	0	41489
7414	388	146	41001	571	0	42106
7415	221	110	466	40996	0	41793
7416	41229	66	298	701	0	42294
7417	532	40972	168	422	0	42094
7418	42085	482	104	303	0	42974
7419	615	299	102	42371	0	43387
7420	346	44281	146	725	0	45498
7421	228	625	84	44967	0	45904
7422	229	347	95	45703	0	46374
7423	183	45716	150	1043	0	47092
7424	236	696	101	46716	0	47749
7425	198	384	119	48013	0	48714
7426	211	118	107	49489	0	49925
7427	186	149	48634	1290	0	50259
7428	113	48706	912	603	0	50334
7429	49917	822	446	339	0	51524
7430	984	466	158	50351	0	51959
7431	519	54733	180	1015	0	56447
7432	58298	959	122	676	0	60055
7433	1221	511	86	59095	0	60913
7434	753	167	72	59910	0	60902
7435	363	114	78	59317	0	59872
7436	275	107	83	58494	0	58959
7437	56991	87	73	1881	0	59032
7438	1310	86	87	58088	0	59571
7439	766	118	76	58555	0	59515
7440	57387	106	94	1930	0	59517
7441	1302	108	88	58261	0	59759
7442	726	177	57151	1501	0	59555
7443	339	126	1110	57978	0	59553
7444	55886	130	608	1489	0	58113
7445	1280	142	182	56769	0	58373
7446	718	202	56508	1440	0	58868
7447	305	195	55810	844	0	57154
7448	56603	112	1684	524	0	58923
7449	59470	132	748	411	0	60761
7450	59960	138	244	402	0	60744
7451	59917	130	157	364	0	60568
7452	1944	191	58288	324	0	60747
7453	978	119	1136	57719	0	59952
7454	479	114	629	59969	0	61191
7455	58618	111	223	1965	0	60917
7456	1375	95	143	59699	0	61312
7457	747	182	58407	1542	0	60878
7458	381	85	1169	59402	0	61037
7459	251	150	59633	1575	0	61609
7460	202	59491	1317	994	0	62004
7461	60713	1122	748	579	0	63162
7462	1390	652	224	60768	0	63034
7463	797	234	59492	1460	0	61983
7464	409	122	1266	60147	0	61944
7465	347	119	682	62674	0	63822
7466	293	195	61868	2133	0	64489
7467	377	117	1336	62464	0	64294
7468	61693	107	819	1832	0	64451
7469	1478	181	57213	1082	0	59954
7470	57034	141	1200	698	0	59073
7471	1553	57086	812	550	0	60001
7472	937	1158	57650	499	0	60244
7473	477	782	58034	500	0	59793
7474	663	962	1889	47895	0	51409
7475	405	138	847	54365	0	55755
7476	317	190	53798	1987	0	56292
7477	346	117	1236	54437	0	56136
7478	54599	109	744	1775	0	57227
7479	55155	102	359	1200	0	56816
7480	1880	88	289	53451	0	55708
7481	1011	147	265	53173	0	54596
7482	518	54041	309	1962	0	56830
7483	54979	1116	233	1339	0	57667
7484	1511	632	260	55253	0	57656
7485	891	57118	345	1630	0	59984
7486	57927	1173	256	1230	0	60586
7487	58211	660	273	852	0	59996
7488	1923	59523	352	773	0	62571
7489	1133	1266	283	59688	0	62370
7490	749	679	286	60050	0	61764
7491	564	312	57676	2304	0	60856
7492	625	165	1396	57673	0	59859
7493	57151	166	864	2006	0	60187
7494	1641	162	447	57373	0	59623
7495	1066	173	55922	1971	0	59132
7496	55387	113	1488	1433	0	58421
7497	1747	113	917	56450	0	59227
7498	1103	164	55819	1971	0	59057
7499	718	96	1527	56542	0	58883
7500	614	160	56263	1982	0	59019
7501	688	149	1575	56384	0	58796
7502	691	120	914	57546	0	59271
7503	56345	115	539	2474	0	59473
7504	1565	56365	587	1457	0	59974
7505	58213	1244	508	967	0	60932
7506	57464	663	449	893	0	59469
7507	57441	293	410	827	0	58971
7508	2386	55873	482	735	0	59476
7509	1335	1341	55939	695	0	59310
7510	862	740	1596	55810	0	59008
7511	57392	299	979	1840	0	60510
7512	58281	230	564	1246	0	60321
7513	2344	262	464	55701	0	58771
7514	56753	191	471	1921	0	59336
7515	1821	248	55799	1304	0	59172
7516	55290	179	1595	978	0	58042
7517	1897	241	55891	820	0	58849
7518	1163	54639	1649	814	0	58265
7519	54710	1135	964	786	0	57595
7520	52870	655	587	805	0	54917
7521	1952	52885	614	690	0	56141
7522	52836	1173	572	800	0	55381
7523	51432	648	416	721	0	53217
7524	1863	377	50013	648	0	52901
7525	47844	203	1214	695	0	49956
7526	1450	252	47904	581	0	50187
7527	936	522	1092	42038	0	44588
7528	596	45317	771	1102	0	47786
7529	568	901	45060	746	0	47275
7530	40509	1379	1373	883	0	44144
7531	39169	363	684	634	0	40850
7532	1149	159	234	36525	0	38067
7533	600	194	36073	771	0	37638
7534	439	163	666	36220	0	37488
7535	36318	99	416	819	0	37652
7536	806	36677	271	523	0	38277
7537	36588	594	200	374	0	37756
7538	36845	304	193	299	0	37641
7539	1025	36276	239	272	0	37812
7540	637	571	150	36737	0	38095
7541	37483	313	179	727	0	38702
7542	871	179	180	37759	0	38989
7543	630	164	175	39418	0	40387
7544	435	240	39513	880	0	41068
7545	434	131	658	39099	0	40322
7546	447	128	335	39483	0	40393
7547	38581	141	191	980	0	39893
7548	38975	111	195	529	0	39810
7549	1153	100	195	38651	0	40099
7550	625	168	37978	811	0	39582
7551	447	177	37396	455	0	38475
7552	408	185	927	37480	0	39000
7553	362	161	39034	796	0	40353
7554	392	178	762	38145	0	39477
7555	362	118	405	38197	0	39082
7556	38681	97	267	1022	0	40067
7557	830	150	38293	488	0	39761
7558	37452	76	686	381	0	38595
7559	37765	75	408	362	0	38610
7560	971	152	36481	273	0	37877
7561	566	186	36782	239	0	37773
7562	401	837	759	34979	0	36976
7563	315	35115	424	548	0	36402
7564	333	36684	226	397	0	37640
7565	484	601	135	34179	0	35399
7566	258	237	138	33479	0	34112
7567	260	110	119	34784	0	35273
7568	266	50	129	35088	0	35533
7569	33932	64	124	737	0	34857
7570	595	69	121	34165	0	34950
7571	312	111	33538	591	0	34552
7572	254	69	462	32670	0	33455
7573	222	32300	260	518	0	33300
7574	285	404	145	32613	0	33447
7575	32413	150	124	609	0	33296
7576	572	71	141	32872	0	33656
7577	302	100	32739	556	0	33697
7578	177	32101	520	317	0	33115
7579	199	397	259	32511	0	33366
7580	32405	189	157	592	0	33343
7581	32648	95	145	367	0	33255
7582	805	68	106	32706	0	33685
7583	356	101	30628	510	0	31595
7584	247	119	28558	261	0	29185
7585	28686	64	574	216	0	29540
7586	543	77	30070	156	0	30846
7587	264	108	29746	141	0	30259
7588	157	50	420	27678	0	28305
7589	29520	31	199	456	0	30206
7590	29103	25	93	294	0	29515
7591	29119	24	82	206	0	29431
7592	498	69	30913	129	0	31609
7593	253	63	31702	120	0	32138
7594	120	34071	453	138	0	34782
7595	141	293	216	33962	0	34612
7596	113	127	154	34667	0	35061
7597	122	43	127	33833	0	34125
7598	108	23	121	34905	0	35157
7599	152	84	34810	573	0	35619
7600	130	35925	371	352	0	36778
7601	38712	303	213	226	0	39454
7602	43016	160	146	206	0	43528
7603	43648	37	129	204	0	44018
7604	900	43712	178	164	0	44954
7605	368	632	124	43171	0	44295
7606	44801	245	143	785	0	45974
7607	705	46586	151	460	0	47902
7608	46475	673	119	278	0	47545
7609	788	46611	169	183	0	47751
7610	47152	720	124	213	0	48209
7611	47179	319	116	215	0	47829
7612	1118	83	121	47755	0	49077
7613	536	64	101	49682	0	50383
7614	212	126	48915	1148	0	50401
7615	190	126	47452	498	0	48266
7616	48402	139	1123	238	0	49902
7617	49962	89	452	232	0	50735
7618	1218	102	153	49257	0	50730
7619	555	74	92	50046	0	50767
7620	272	128	48723	1297	0	50420
7621	234	111	822	47788	0	48955
7622	222	148	48116	1069	0	49555
7623	276	104	865	48257	0	49502
7624	267	125	433	49443	0	50268
7625	48816	144	161	1423	0	50544
7626	48559	142	108	692	0	49501
7627	1356	151	122	48599	0	50228
7628	750	82	120	49014	0	49966
7629	338	181	48236	1372	0	50127
7630	309	112	896	48705	0	50022
7631	271	208	49148	1113	0	50740
7632	47947	141	994	664	0	49746
7633	1166	87	497	49772	0	51522
7634	49387	101	210	1104	0	50802
7635	1076	48911	245	723	0	50955
7636	49764	842	202	523	0	51331
7637	1159	451	237	49533	0	51380
7638	701	169	260	49259	0	50389
7639	409	49173	269	1382	0	51233
7640	368	866	226	50060	0	51520
7641	339	492	48940	1191	0	50962
7642	514	141	935	48962	0	50552
7643	338	166	47803	1121	0	49428
7644	256	46213	990	749	0	48208
7645	319	721	612	46973	0	48625
7646	319	432	46684	1017	0	48452
7647	288	180	45860	667	0	46995
7648	340	107	1161	45806	0	47414
7649	45760	58	815	1099	0	47732
7650	906	100	45524	707	0	47237
7651	595	83	870	45305	0	46853
7652	46192	105	501	1076	0	47874
7653	910	44707	309	694	0	46620
7654	47669	748	193	617	0	49227
7655	1041	421	172	47648	0	49282
7656	683	187	132	48192	0	49194
7657	368	158	165	49203	0	49894
7658	48437	103	186	1570	0	50296
7659	1006	123	234	49313	0	50676
7660	641	97	215	50261	0	51214
7661	47829	131	249	1477	0	49686
7662	1047	216	47995	793	0	50051
7663	690	117	969	48494	0	50270
7664	371	202	48550	1138	0	50261
7665	46901	149	991	800	0	48841
7666	1183	172	521	48900	0	50776
7667	685	243	49674	1101	0	51703
7668	47054	151	940	844	0	48989
7669	49260	164	526	589	0	50539
7670	1405	264	51449	458	0	53576
7671	760	193	901	51389	0	53243
7672	449	142	557	52863	0	54011
7673	330	218	53401	1512	0	55461
7674	330	52893	1071	910	0	55204
7675	382	883	53977	615	0	55857
7676	50572	443	1041	632	0	52688
7677	1021	241	55869	594	0	57725
7678	52528	131	1077	647	0	54383
7679	1116	160	55891	542	0	57709
7680	53544	86	1094	640	0	55364
7681	1077	56362	749	523	0	58711
7682	751	764	390	55896	0	57801
7683	528	435	259	58074	0	59296
7684	401	231	57696	1499	0	59827
7685	485	105	938	55128	0	56656
7686	367	56700	679	1197	0	58943
7687	56025	767	347	912	0	58051
7688	986	56729	350	654	0	58719
7689	683	838	306	57274	0	59101
7690	57503	383	296	1406	0	59588
7691	1093	57745	388	879	0	60105
7692	56399	885	327	600	0	58211
7693	1220	527	56761	506	0	59014
7694	779	196	1123	55931	0	58029
7695	504	137	716	56573	0	57930
7696	475	113	394	58192	0	59174
7697	57485	121	368	1787	0	59761
7698	57982	178	325	942	0	59427
7699	57702	156	337	601	0	58796
7700	56136	133	307	554	0	57130
7701	1425	191	52391	399	0	54406
7702	45545	76	594	274	0	46489
7703	725	46904	430	217	0	48276
7704	423	47300	273	198	0	48194
7705	47898	667	825	368	0	49758
7706	48786	271	292	333	0	49682
7707	701	99	114	46784	0	47698
7708	47486	56	99	633	0	48274
7709	46844	59	107	376	0	47386
7710	51099	73	159	271	0	51602
7711	970	83	96	50615	0	51764
7712	398	49787	144	647	0	50976
7713	179	50827	115	339	0	51460
7714	228	791	112	50599	0	51730
7715	50015	308	90	721	0	51134
7716	606	50761	142	372	0	51881
7717	387	545	66	50872	0	51870
7718	194	336	50923	629	0	52082
7719	45569	105	600	458	0	46732
7720	649	50871	319	187	0	52026
7721	351	52074	163	171	0	52759
7722	50888	742	102	220	0	51952
7723	707	350	51336	123	0	52516
7724	398	103	553	50197	0	51251
7725	205	51863	323	586	0	52977
7726	223	577	119	52418	0	53337
7727	254	288	77	51780	0	52399
7728	205	47690	123	836	0	48854
7729	246	584	71	53361	0	54262
7730	265	310	57	53821	0	54453
7731	52788	134	91	919	0	53932
7732	678	52985	116	411	0	54190
7733	53595	639	73	310	0	54617
7734	792	333	61	52966	0	54152
7735	408	54445	103	717	0	55673
7736	271	729	54260	378	0	55638
7737	260	459	649	54432	0	55800
7738	250	186	305	57327	0	58068
7739	190	225	58145	1041	0	59601
7740	53863	130	792	516	0	55301
7741	931	129	347	64178	0	65585
7742	63704	141	143	1230	0	65218
7743	1184	250	62947	565	0	64946
7744	638	138	1049	63100	0	64925
7745	317	230	66421	1183	0	68151
7746	260	210	1153	66562	0	68185
7747	241	186	543	68529	0	69499
7748	67317	121	203	1798	0	69439
7749	1174	67781	145	840	0	69940
7750	68556	1195	84	409	0	70244
7751	1441	642	68003	234	0	70320
7752	718	256	1144	67733	0	69851
7753	339	240	70470	1264	0	72313
7754	60869	172	1369	810	0	63220
7755	68772	137	550	452	0	69911
7756	1726	230	68651	260	0	70867
7757	67056	143	1270	346	0	68815
7758	69831	138	588	366	0	70923
7759	1754	107	241	68783	0	70885
7760	801	221	67833	1325	0	70180
7761	421	210	69862	745	0	71238
7762	369	114	1660	69384	0	71527
7763	340	108	737	68702	0	69887
7764	300	67672	398	1713	0	70083
7765	302	70122	334	919	0	71677
7766	69499	1591	222	618	0	71930
7767	1475	706	255	67582	0	70018
7768	766	67639	349	1364	0	70118
7769	377	70247	316	857	0	71797
7770	65371	1689	249	540	0	67849
7771	1439	753	248	66746	0	69186
7772	815	67984	304	1445	0	70548
7773	540	1241	292	67812	0	69885
7774	447	639	256	68099	0	69441
7775	516	263	288	68174	0	69241
7776	65766	185	278	2091	0	68320
7777	1515	64871	326	936	0	67648
7778	954	1252	336	65166	0	67708
7779	630	617	299	65914	0	67460
7780	541	266	315	66540	0	67662
7781	422	298	62924	2054	0	65698
7782	59585	196	1412	1109	0	62302
7783	1523	210	781	63157	0	65671
7784	62253	212	393	1646	0	64504
7785	62503	235	322	1039	0	64099
7786	62730	275	293	693	0	63991
7787	2051	390	61528	479	0	64448
7788	977	60993	1372	476	0	63818
7789	582	1284	661	60295	0	62822
7790	391	866	60211	1461	0	62929
7791	400	521	59196	921	0	61038
7792	501	572	1593	55357	0	58023
7793	354	57181	797	1320	0	59652
7794	58003	1215	329	1034	0	60581
7795	59028	670	245	753	0	60696
7796	59368	360	204	743	0	60675
7797	58903	291	223	695	0	60112
7798	1862	355	57265	563	0	60045
7799	56552	293	1153	634	0	58632
7800	1397	58218	746	570	0	60931
7801	920	1150	334	59067	0	61471
7802	584	603	286	60539	0	62012
7803	59735	252	336	1979	0	62302
7804	1543	187	272	60085	0	62087
7805	995	272	57872	1528	0	60667
7806	54838	191	1204	995	0	57228
7807	57307	187	679	685	0	58858
7808	57148	188	397	623	0	58356
7809	1857	270	55246	476	0	57849
7810	50429	200	1077	491	0	52197
7811	1239	51774	703	445	0	54161
7812	52485	896	435	544	0	54360
7813	1227	605	331	51204	0	53367
7814	743	313	237	51643	0	52936
7815	493	51083	328	1405	0	53309
7816	501	977	245	51132	0	52855
7817	450	51546	320	1129	0	53445
7818	499	1059	239	50778	0	52575
7819	501	50777	304	1095	0	52677
7820	509	1043	225	51071	0	52848
7821	465	52161	277	1209	0	54112
7822	466	1132	178	54395	0	56171
7823	407	55937	280	1297	0	57921
7824	59344	1155	181	951	0	61631
7825	1549	606	177	60311	0	62643
7826	998	305	173	61203	0	62679
7827	593	233	190	63787	0	64803
7828	562	179	173	63968	0	64882
7829	477	293	62664	2339	0	65773
7830	545	199	1409	63333	0	65486
7831	614	195	750	64239	0	65798
7832	62116	161	292	2233	0	64802
7833	61586	204	186	1136	0	63112
7834	2173	62946	280	507	0	65906
7835	1227	1422	150	62359	0	65158
7836	634	698	166	66209	0	67707
7837	66762	341	165	2380	0	69648
7838	1865	346	62490	1143	0	65844
7839	61799	214	1369	594	0	63976
7840	1731	64196	797	421	0	67145
7841	58980	1207	132	284	0	60603
7842	58402	639	88	287	0	59416
7843	1747	57462	162	217	0	59588
7844	768	59875	140	194	0	60977
7845	610	1844	252	56019	0	58725
7846	189	697	55607	1218	0	57711
7847	53935	192	1137	771	0	56035
7848	1184	193	55800	263	0	57440
7849	54142	86	1168	265	0	55661
7850	1271	119	55087	221	0	56698
7851	637	54401	1204	171	0	56413
7852	352	1112	542	54757	0	56763
7853	53453	562	187	1265	0	55467
7854	54934	170	98	701	0	55903
7855	1779	109	86	55016	0	56990
7856	57512	127	77	1290	0	59006
7857	57400	92	84	752	0	58328
7858	1897	56286	146	341	0	58670
7859	57216	1236	86	260	0	58798
7860	1474	57689	156	225	0	59544
7861	911	1339	75	57103	0	59428
7862	57038	693	104	1442	0	59277
7863	58549	225	96	791	0	59661
7864	58579	145	70	342	0	59136
7865	2015	218	57464	172	0	59869
7866	952	201	58805	178	0	60136
7867	427	164	1908	60386	0	62885
7868	389	166	819	63912	0	65286
7869	278	67444	325	2145	0	70192
7870	67703	1650	172	1050	0	70575
7871	1899	954	167	67661	0	70681
7872	1169	296	133	69336	0	70934
7873	471	291	68161	2600	0	71523
7874	378	66203	1698	1257	0	69536
7875	379	69434	988	482	0	71283
7876	502	2487	241	68820	0	72050
7877	68387	1125	147	2004	0	71663
7878	1992	378	171	68857	0	71398
7879	1307	240	166	70803	0	72516
7880	69307	271	178	2841	0	72597
7881	70859	230	172	1390	0	72651
7882	2980	250	194	69838	0	73262
7883	1457	321	69092	2095	0	72965
7884	745	265	1732	70571	0	73313
7885	643	235	1003	71788	0	73669
7886	70571	176	338	3013	0	74098
7887	2192	199	257	71536	0	74184
7888	71523	211	270	2403	0	74407
7889	2388	276	70995	1476	0	75135
7890	1559	247	1874	72332	0	76012
7891	858	322	1043	74948	0	77171
7892	710	287	387	76231	0	77615
7893	645	338	294	75604	0	76881
7894	696	325	278	75089	0	76388
7895	596	385	71448	3456	0	75885
7896	70493	333	2033	1790	0	74649
7897	2465	321	1165	72143	0	76094
7898	1502	358	71069	2553	0	75482
7899	862	371	71938	1673	0	74844
7900	812	334	2851	70877	0	74874
7901	70563	342	1319	2651	0	74875
7902	71483	400	495	1726	0	74104
7903	72998	305	380	1026	0	74709
7904	3642	330	381	66401	0	70754
7905	1827	70045	527	2448	0	74847
7906	72231	2031	444	1733	0	76439
7907	73438	1247	421	982	0	76088
7908	74170	546	395	908	0	76019
7909	73985	413	332	1024	0	75754
7910	3795	346	386	71136	0	75663
7911	1965	421	70464	2696	0	75546
7912	1191	304	2065	71225	0	74785
7913	965	426	71165	2875	0	75431
7914	70202	246	2288	1939	0	74675
7915	72211	224	1309	1315	0	75059
7916	3435	327	69719	1143	0	74624
7917	69564	206	2182	1142	0	73094
7918	72507	226	1337	1182	0	75252
7919	3653	235	581	69065	0	73534
7920	1894	69407	677	2638	0	74616
7921	69781	1828	497	1796	0	73902
7922	2709	1385	467	64806	0	69367
7923	1671	64308	505	2407	0	68891
7924	1023	1763	319	62937	0	66042
7925	909	927	62846	2326	0	67008
7926	789	63538	1726	1575	0	67628
7927	61996	1654	1096	982	0	65728
7928	62408	843	611	903	0	64765
7929	61725	269	345	799	0	63138
7930	62086	164	391	803	0	63444
7931	2744	459	393	58246	0	61842
7932	1441	58898	504	1863	0	62706
7933	56423	1332	449	1349	0	59553
7934	1930	836	57488	757	0	61011
7935	1295	55486	1589	665	0	59035
7936	888	1157	53092	585	0	55722
7937	838	652	1249	47461	0	50200
7938	698	45171	889	1226	0	47984
7939	799	995	345	50761	0	52900
7940	771	703	52510	1322	0	55306
7941	778	268	1087	51022	0	53155
7942	732	232	744	53323	0	55031
7943	712	207	339	54542	0	55800
7944	51410	218	336	1953	0	53917
7945	1452	51617	380	1201	0	54650
7946	1166	1017	316	52119	0	54618
7947	50962	640	328	1458	0	53388
7948	1388	51391	448	1092	0	54319
7949	51719	1020	367	658	0	53764
7950	1600	745	51934	574	0	54853
7951	1256	344	1098	49169	0	51867
7952	847	51863	792	1193	0	54695
7953	51960	1051	362	897	0	54270
7954	1622	758	50805	522	0	53707
7955	1107	47736	1195	496	0	50534
7956	767	985	650	47469	0	49871
7957	637	652	302	48480	0	50071
7958	47240	324	337	1513	0	49414
7959	1347	299	274	47226	0	49146
7960	934	328	45637	1175	0	48074
7961	674	235	857	44679	0	46445
7962	573	321	46144	1100	0	48138
7963	610	374	911	42656	0	44551
7964	519	45502	658	1025	0	47704
7965	45056	893	307	746	0	47002
7966	43399	539	234	495	0	44667
7967	1257	40698	257	340	0	42552
7968	463	37142	175	212	0	37992
7969	565	541	211	35180	0	36497
7970	34968	233	128	508	0	35837
7971	578	130	99	34837	0	35644
7972	34516	102	95	515	0	35228
7973	466	33708	128	254	0	34556
7974	341	371	90	34741	0	35543
7975	235	256	35285	429	0	36205
7976	230	140	373	34770	0	35513
7977	205	130	168	35997	0	36500
7978	36319	119	147	665	0	37250
7979	394	37441	108	305	0	38248
7980	258	416	66	37748	0	38488
7981	37341	196	73	518	0	38128
7982	441	157	37829	274	0	38701
7983	36596	94	373	259	0	37322
7984	473	242	173	38336	0	39224
7985	252	40242	131	361	0	40986
7986	40017	368	96	280	0	40761
7987	465	248	40898	126	0	41737
7988	258	148	39769	99	0	40274
7989	140	40465	465	142	0	41212
7990	39575	246	343	120	0	40284
7991	244	128	45	39874	0	40291
7992	137	39	30	40295	0	40501
7993	40078	30	28	470	0	40606
7994	331	69	40323	229	0	40952
7995	194	25	306	40700	0	41225
7996	117	85	43331	364	0	43897
7997	93	41	358	42528	0	43020
7998	51	44170	237	401	0	44859
7999	81	365	72	45454	0	45972
8000	54	263	45026	450	0	45793
8001	42720	82	382	313	0	43497
8002	442	44	195	46074	0	46755
8003	267	113	46080	473	0	46933
8004	141	46	430	44825	0	45442
8005	93	41	236	45591	0	45961
8006	73	101	44795	638	0	45607
8007	76	95	45129	326	0	45626
8008	92	39	649	46005	0	46785
8009	89	107	46921	507	0	47624
8010	44970	45	547	346	0	45908
8011	496	46	275	47311	0	48128
8012	46939	41	153	567	0	47700
8013	551	87	46668	307	0	47613
8014	341	28	503	46972	0	47844
8015	180	103	51333	528	0	52144
8016	82	50410	608	355	0	51455
8017	112	523	51488	169	0	52292
8018	80	324	49189	133	0	49726
8019	47062	95	751	196	0	48104
8020	50538	57	369	195	0	51159
8021	779	123	51995	123	0	53020
8022	428	42	589	47426	0	48485
8023	201	51	316	52189	0	52757
8024	138	115	52712	808	0	53773
8025	67	50266	626	478	0	51437
8026	49223	495	337	289	0	50344
8027	577	388	51701	150	0	52816
8028	383	99	584	52015	0	53081
8029	176	65	361	53914	0	54516
8030	54785	34	151	998	0	55968
8031	55588	45	127	539	0	56299
8032	56191	38	121	305	0	56655
8033	56568	48	125	214	0	56955
8034	959	53	138	55769	0	56919
8035	482	131	58766	633	0	60012
8036	225	56	649	58256	0	59186
8037	206	48	403	59741	0	60398
8038	198	44	191	61414	0	61847
8039	132	119	59819	1021	0	61091
8040	54845	45	677	568	0	56135
8041	735	34	409	59456	0	60634
8042	477	96	60425	769	0	61767
8043	164	61271	799	524	0	62758
8044	193	655	452	62874	0	64174
8045	196	380	228	63789	0	64593
8046	62428	120	182	1190	0	63920
8047	711	64117	220	639	0	65687
8048	504	737	64373	282	0	65896
8049	274	381	755	63558	0	64968
8050	241	148	461	64409	0	65259
8051	63546	83	225	1195	0	65049
8052	63430	68	161	657	0	64316
8053	1134	69	170	64462	0	65835
8054	64510	48	164	945	0	65667
8055	819	63456	218	588	0	65081
8056	580	765	67382	338	0	69065
8057	322	373	788	67280	0	68763
8058	293	174	497	69815	0	70779
8059	255	103	224	70532	0	71114
8060	249	68	201	69409	0	69927
8061	166	68423	290	1238	0	70117
8062	67206	666	173	805	0	68850
8063	848	407	162	67338	0	68755
8064	515	70332	259	861	0	71967
8065	70782	688	150	721	0	72341
8066	70077	416	189	425	0	71107
8067	1098	72294	258	414	0	74064
8068	661	730	181	74200	0	75772
8069	393	547	167	74869	0	75976
8070	336	152	169	74455	0	75112
8071	294	101	152	75502	0	76049
8072	75049	93	197	1487	0	76826
8073	75795	106	156	848	0	76905
8074	1325	76434	251	527	0	78537
8075	714	971	75545	350	0	77580
8076	376	511	931	75616	0	77434
8077	76884	179	558	1189	0	78810
8078	989	74774	319	822	0	76904
8079	624	75269	263	414	0	76570
8080	76402	1296	110	438	0	78246
8081	77194	598	173	409	0	78374
8082	1645	219	149	76338	0	78351
8083	797	259	76898	1226	0	79180
8084	470	267	77632	766	0	79135
8085	81493	168	1500	603	0	83764
8086	85402	140	635	548	0	86725
8087	84778	146	236	468	0	85628
8088	84344	112	164	432	0	85052
8089	84131	140	155	450	0	84876
8090	1584	83608	238	390	0	85820
8091	860	1058	115	80477	0	82510
8092	333	87486	174	906	0	88899
8093	89115	970	203	799	0	91087
8094	88360	572	141	562	0	89635
8095	88004	182	108	440	0	88734
8096	87599	153	99	402	0	88253
8097	1339	86450	209	306	0	88304
8098	85846	785	100	382	0	87113
8099	985	85446	191	278	0	86900
8100	655	935	91	85683	0	87364
8101	84969	452	113	1094	0	86628
8102	1014	293	86407	537	0	88251
8103	675	154	754	84511	0	86094
8104	395	158	390	88041	0	88984
8105	333	316	87713	1195	0	89557
8106	260	87015	867	679	0	88821
8107	86956	795	424	456	0	88631
8108	85812	443	175	371	0	86801
8109	1188	85965	223	398	0	87774
8110	721	797	118	85970	0	87606
8111	580	635	87289	849	0	89353
8112	348	90353	801	527	0	92029
8113	89284	833	442	526	0	91085
8114	996	642	90168	205	0	92011
8115	80169	198	728	402	0	81497
8116	86542	170	381	377	0	87470
8117	1280	355	89430	271	0	91336
8118	648	89496	854	243	0	91241
8119	519	801	382	88963	0	90665
8120	426	587	91684	789	0	93486
8121	83650	217	729	658	0	85254
8122	89910	160	368	418	0	90856
8123	1152	89815	229	291	0	91487
8124	668	710	125	89710	0	91213
8125	397	438	121	91228	0	92184
8126	453	371	91093	1010	0	92927
8127	311	91276	773	524	0	92884
8128	94608	723	351	715	0	96397
8129	94885	414	130	442	0	95871
8130	95623	208	129	461	0	96421
8131	1175	368	94093	233	0	95869
8132	91270	175	634	389	0	92468
8133	94925	167	349	420	0	95861
8134	1139	177	159	95267	0	96742
8135	580	359	92092	682	0	93713
8136	444	173	630	91243	0	92490
8137	390	334	93103	685	0	94512
8138	396	236	600	90115	0	91347
8139	273	91730	420	647	0	93070
8140	231	96432	249	407	0	97319
8141	313	807	122	97253	0	98495
8142	369	370	153	94665	0	95557
8143	92925	151	127	1059	0	94262
8144	754	349	93882	362	0	95347
8145	88547	143	589	426	0	89705
8146	679	94903	427	208	0	96217
8147	94624	580	130	389	0	95723
8148	94139	313	149	345	0	94946
8149	931	152	158	93753	0	94994
8150	556	347	96276	610	0	97789
8151	442	157	578	95818	0	96995
8152	269	101010	421	630	0	102330
8153	317	715	159	101646	0	102837
8154	283	374	117	102520	0	103294
8155	100799	144	134	1249	0	102326
8156	843	135	122	98129	0	99229
8157	475	96478	218	813	0	97984
8158	311	701	107	98406	0	99525
8159	98642	377	100	1022	0	100141
8160	845	99953	245	524	0	101567
8161	567	875	125	102893	0	104460
8162	320	480	109	103705	0	104614
8163	340	163	115	109510	0	110128
8164	301	144	102	108292	0	108839
8165	107686	112	104	1855	0	109757
8166	1340	106	149	109756	0	111351
8167	776	147	117	110832	0	111872
8168	373	218	113	111168	0	111872
8169	191	112240	217	1919	0	114567
8170	110730	1324	180	1101	0	113335
8171	1521	847	111538	367	0	114273
8172	667	109191	1324	375	0	111557
8173	107068	1160	612	424	0	109264
8174	1400	755	110173	229	0	112557
8175	642	110039	1249	236	0	112166
8176	440	1520	709	106921	0	109590
8177	176	111018	321	1200	0	112715
8178	243	1350	110126	572	0	112291
8179	322	797	111336	278	0	112733
8180	116	111426	1662	301	0	113505
8181	110970	1047	700	416	0	113133
8182	110971	591	253	422	0	112237
8183	1578	379	107851	220	0	110028
8184	741	303	99330	205	0	100579
8185	324	265	102476	187	0	103252
8186	275	127	1625	100391	0	102418
8187	235	107	681	101840	0	102863
8188	216	96	246	105074	0	105632
8189	185	321	106645	1806	0	108957
8190	286	124	1169	102717	0	104296
8191	252	134	642	106336	0	107364
8192	237	305	103207	1895	0	105644
8193	96245	155	1378	1119	0	98897
8194	1444	147	758	106060	0	108409
8195	923	157	273	104486	0	105839
8196	280	106707	348	2032	0	109367
8197	106844	1329	356	1207	0	109736
8198	1470	1033	106903	427	0	109833
8199	105083	301	1383	517	0	107284
8200	1669	243	871	106699	0	109482
8201	1027	455	107929	1515	0	110926
8202	521	207	1525	106673	0	108926
8203	107230	195	1009	1949	0	110383
8204	1570	370	107107	1035	0	110082
8205	104586	175	1613	681	0	107055
8206	107228	192	994	540	0	108954
8207	108371	177	452	597	0	109597
8208	2341	106210	497	435	0	109483
8209	1300	1474	297	109330	0	112401
8210	113142	806	351	1902	0	116201
8211	113324	335	383	1226	0	115268
8212	117060	240	307	746	0	118353
8213	2905	398	111848	493	0	115644
8214	118711	195	1810	637	0	121353
8215	2568	183	1166	127183	0	131100
8216	1548	339	126406	2594	0	130887
8217	918	211	2449	130270	0	133848
8218	725	198	1407	132407	0	134737
8219	592	417	131827	4332	0	137168
8220	661	193	2961	132396	0	136211
8221	603	151	1695	138107	0	140556
8222	504	402	154437	4821	0	160164
8223	162028	200	3776	2592	0	168596
8224	178296	178	2307	1271	0	182052
8225	6524	181	1094	183382	0	191181
8226	3413	384	182068	4768	0	190633
8227	1783	237	4632	178552	0	185204
8228	1149	177711	2880	5309	0	187049
8229	1331	4221	1172	179031	0	185755
8230	1112	2375	821	182591	0	186899
8231	179246	853	797	7561	0	188457
8232	181062	477	710	4225	0	186474
8233	185079	511	632	2275	0	188497
8234	8183	402	612	179215	0	188412
8235	4381	383	552	183632	0	188948
8236	2339	601	177079	7687	0	187706
8237	2005	409	4686	172525	0	179625
8238	1594	176218	3100	6084	0	186996
8239	176881	4297	1318	4002	0	186498
8240	5164	174860	1315	2662	0	184001
8241	176869	4987	1061	2228	0	185145
8242	6008	2798	1049	165327	0	175182
8243	3435	172510	1216	5735	0	182896
8244	173235	4836	1019	4021	0	183111
8245	176748	2908	984	2441	0	183081
8246	8061	1411	865	171205	0	181542
8247	4338	172074	1249	6052	0	183713
8248	2633	5019	1060	174824	0	183536
8249	2115	3112	171220	6667	0	183114
8250	167242	1425	5044	4381	0	178092
8251	5848	169325	3293	2886	0	181352
8252	168568	4897	1480	2374	0	177319
8253	6569	2895	1077	167284	0	177825
8254	170857	1477	1083	6219	0	179636
8255	6874	1190	170991	4116	0	183171
8256	175127	936	5184	2987	0	184234
8257	177319	861	3157	2409	0	183746
8258	9308	901	173351	2435	0	185995
8259	5927	855	5473	171204	0	183459
8260	3810	730	3483	175243	0	183266
8261	168421	974	1863	9049	0	180307
8262	6657	167065	1814	5518	0	181054
8263	4728	5450	1384	163082	0	174644
8264	3185	3386	160869	6639	0	174079
8265	2734	1868	161075	4815	0	170492
8266	2630	157655	6918	3355	0	170558
8267	3144	5183	159102	2659	0	170088
8268	153112	3328	5939	2734	0	165113
8269	6293	1903	3561	150367	0	162124
8270	155720	1282	2114	6125	0	165241
8271	6368	1666	152696	4370	0	165100
8272	4661	1366	5355	152571	0	163953
8273	3273	1505	3313	156585	0	164676
8274	2742	1739	151541	7896	0	163918
8275	3169	1323	5121	153074	0	162687
8276	150892	1461	3306	6854	0	162513
8277	154347	1222	2059	4660	0	162288
8278	8777	1115	1535	150457	0	161884
8279	151783	1087	1528	6473	0	160871
8280	152169	1074	1339	4741	0	159323
8281	8764	146091	1589	3310	0	159754
8282	6150	4619	1371	147397	0	159537
8283	149841	2896	1360	6406	0	160503
8284	7251	1657	1416	150515	0	160839
8285	149779	1233	1397	6965	0	159374
8286	7359	1287	1422	147820	0	157888
8287	5198	1358	147668	7100	0	161324
8288	3527	146944	5497	4870	0	160838
8289	3721	5190	3579	120367	0	132857
8290	3149	145392	2449	5539	0	156529
8291	142074	5382	2016	4197	0	153669
8292	6164	140076	2226	3014	0	151480
8293	4405	140818	2148	2653	0	150024
8294	3484	6871	1778	138205	0	150338
8295	138208	3937	1728	6326	0	150199
8296	6335	2207	1449	139386	0	149377
8297	138936	1679	1503	6966	0	149084
8298	138314	1786	1483	4831	0	146414
8299	7906	136952	1785	3442	0	150085
8300	141409	5010	1756	2948	0	151123
8301	141940	3138	1625	2817	0	149520
8302	143109	1864	1612	2508	0	149093
8303	9531	1564	134453	2431	0	147979
8304	6239	1439	4851	133227	0	145756
8305	4653	1194	3118	138272	0	147237
8306	3729	1278	133478	7965	0	146450
8307	135093	1092	4924	5048	0	146157
8308	140373	899	3353	3620	0	148245
8309	139430	1010	2018	3065	0	145523
8310	134336	948	1506	2994	0	139784
8311	8806	127239	1669	2986	0	140700
8312	126994	4103	1082	2565	0	134744
8313	7920	2709	1040	123201	0	134870
8314	5202	1682	111425	5147	0	123456
8315	108367	1007	3343	3399	0	116116
8316	5735	109302	2488	2324	0	119849
8317	103470	3422	1100	1858	0	109850
8318	5152	101699	975	1882	0	109708
8319	3641	98591	925	1786	0	104943
8320	2624	97855	1082	1742	0	103303
8321	2510	96328	1543	1697	0	102078
8322	2316	3823	74766	1415	0	82320
8323	2272	5250	2745	59176	0	69443
8324	916	737	55164	1805	0	58622
8325	43893	417	1314	1062	0	46686
8326	1327	45070	780	705	0	47882
8327	924	46012	363	556	0	47855
8328	709	1631	239	44298	0	46877
8329	682	908	189	45358	0	47137
8330	579	589	44572	1644	0	47384
8331	545	508	44410	917	0	46380
8332	676	413	1452	43992	0	46533
8333	630	353	44844	1294	0	47121
8334	672	44419	1243	888	0	47222
8335	821	1127	662	42939	0	45549
8336	813	728	268	47001	0	48810
8337	773	400	45944	1672	0	48789
8338	827	240	1032	45690	0	47789
8339	46071	219	671	1402	0	48363
8340	1484	227	424	46086	0	48221
8341	1003	209	330	46319	0	47861
8342	628	303	44987	1911	0	47829
8343	41758	229	1153	1096	0	44236
8344	1548	45207	732	591	0	48078
8345	1240	1088	260	45042	0	47630
8346	931	685	44756	1175	0	47547
8347	850	422	1012	44533	0	46817
8348	44320	358	604	1306	0	46588
8349	1595	404	44442	842	0	47283
8350	1055	358	1059	44034	0	46506
8351	674	316	45281	1398	0	47669
8352	591	44986	1224	905	0	47706
8353	638	1205	44592	475	0	46910
8354	479	43542	1156	418	0	45595
8355	343	890	38455	209	0	39897
8356	348	772	818	33860	0	35798
8357	162	36903	462	585	0	38112
8358	36485	699	147	427	0	37758
8359	707	425	116	36704	0	37952
8360	37396	174	116	728	0	38414
8361	825	158	98	38331	0	39412
8362	510	145	106	38987	0	39748
8363	38385	131	115	1078	0	39709
8364	39280	116	123	527	0	40046
8365	1191	108	93	40233	0	41625
8366	591	138	41319	867	0	42915
8367	308	40444	771	477	0	42000
8368	274	748	41398	216	0	42636
8369	212	41895	816	194	0	43117
8370	41029	736	481	269	0	42515
8371	842	400	40749	183	0	42174
8372	464	184	40695	158	0	41501
8373	208	123	1001	39084	0	40416
8374	40221	100	428	825	0	41574
8375	814	147	41326	432	0	42719
8376	454	42968	796	178	0	44396
8377	44306	679	409	251	0	45645
8378	45157	368	160	250	0	45935
8379	45572	137	136	204	0	46049
8380	45648	134	146	206	0	46134
8381	45142	132	127	220	0	45621
8382	1117	157	44004	161	0	45439
8383	519	338	679	40984	0	42520
8384	195	42674	422	637	0	43928
8385	43318	652	151	420	0	44541
8386	685	43463	175	184	0	44507
8387	40676	531	109	170	0	41486
8388	40492	279	104	168	0	41043
8389	731	40184	138	130	0	41183
8390	40783	520	118	180	0	41601
8391	618	265	108	40561	0	41552
8392	392	105	106	41354	0	41957
8393	194	108	40483	749	0	41534
8394	152	41741	567	335	0	42795
8395	224	549	294	41543	0	42610
8396	192	268	144	42472	0	43076
8397	197	115	139	42736	0	43187
8398	146	159	41329	814	0	42448
8399	36073	91	583	485	0	37232
8400	661	89	303	41893	0	42946
8401	42079	80	165	653	0	42977
8402	709	88	118	42054	0	42969
8403	436	125	42425	632	0	43618
8404	213	146	42338	358	0	43055
8405	39378	111	864	231	0	40584
8406	43099	108	372	205	0	43784
8407	882	42173	183	175	0	43413
8408	453	589	42216	138	0	43396
8409	252	313	597	41035	0	42197
8410	315	200	380	35634	0	36529
8411	44260	118	124	939	0	45441
8412	44233	98	132	439	0	44902
8413	44184	97	101	274	0	44656
8414	920	147	43166	185	0	44418
8415	43600	96	598	303	0	44597
8416	724	89	329	44693	0	45835
8417	486	96	118	44977	0	45677
8418	291	77	128	44968	0	45464
8419	186	44245	175	841	0	45447
8420	43429	558	124	465	0	44576
8421	717	300	118	43204	0	44339
8422	411	196	42636	680	0	43923
8423	249	113	611	41779	0	42752
8424	219	42655	372	663	0	43909
8425	43075	559	183	453	0	44270
8426	700	308	167	42766	0	43941
8427	486	125	134	42557	0	43302
8428	281	141	42714	880	0	44016
8429	248	105	605	41818	0	42776
8430	215	42560	424	642	0	43841
8431	290	567	144	43333	0	44334
8432	257	364	42923	663	0	44207
8433	37629	110	565	495	0	38799
8434	41462	80	328	264	0	42134
8435	815	42582	199	198	0	43794
8436	41713	448	108	240	0	42509
8437	43255	255	132	226	0	43868
8438	808	42983	131	166	0	44088
8439	459	630	80	43119	0	44288
8440	43877	265	135	686	0	44963
8441	615	45602	157	371	0	46745
8442	416	598	45929	164	0	47107
8443	45071	373	627	283	0	46354
8444	47799	106	315	235	0	48455
8445	48031	79	135	257	0	48502
8446	47887	91	73	225	0	48276
8447	897	48916	177	159	0	50149
8448	49983	559	97	246	0	50885
8449	51302	303	79	285	0	51969
8450	52013	106	77	238	0	52434
8451	1061	77	86	51391	0	52615
8452	50979	81	68	812	0	51940
8453	716	52168	138	458	0	53480
8454	487	753	54080	169	0	55489
8455	266	398	784	55237	0	56685
8456	55516	139	391	970	0	57016
8457	950	160	56167	468	0	57745
8458	571	72	827	56085	0	57555
8459	241	128	56378	936	0	57683
8460	149	55891	925	624	0	57589
8461	261	877	403	54909	0	56450
8462	282	498	55047	861	0	56688
8463	153	54894	877	527	0	56451
8464	335	784	389	53754	0	55262
8465	54722	356	187	949	0	56214
8466	55130	84	73	536	0	55823
8467	55885	50	60	240	0	56235
8468	55604	57	66	192	0	55919
8469	55367	76	90	205	0	55738
8470	1191	131	54758	129	0	56209
8471	54790	82	714	191	0	55777
8472	56844	54	372	199	0	57469
8473	1154	80	97	56246	0	57577
8474	56749	66	64	828	0	57707
8475	54810	80	92	471	0	55453
8476	1111	53019	135	171	0	54436
8477	621	700	72	53623	0	55016
8478	313	392	81	54335	0	55121
8479	53720	114	91	1181	0	55106
8480	858	53290	153	587	0	54888
8481	503	55400	165	188	0	56256
8482	298	1103	87	56387	0	57875
8483	270	426	109	57203	0	58008
8484	291	133	98	57022	0	57544
8485	249	116	78	57785	0	58228
8486	55850	106	71	1417	0	57444
8487	55758	86	79	640	0	56563
8488	1356	180	56454	203	0	58193
8489	726	108	845	55216	0	56895
8490	361	93	434	57247	0	58135
8491	271	142	56025	1271	0	57709
8492	52414	104	867	642	0	54027
8493	973	55648	504	286	0	57411
8494	55469	847	139	223	0	56678
8495	1122	437	92	54920	0	56571
8496	652	199	55184	960	0	56995
8497	440	150	856	55758	0	57204
8498	319	195	58158	1002	0	59674
8499	274	58726	944	595	0	60539
8500	57436	894	489	342	0	59161
8501	58031	430	151	249	0	58861
8502	1209	58131	168	231	0	59739
8503	644	787	99	57019	0	58549
8504	56065	401	95	945	0	57506
8505	904	55723	192	514	0	57333
8506	604	802	92	56330	0	57828
8507	56616	408	96	1014	0	58134
8508	987	242	55694	531	0	57454
8509	54335	134	775	387	0	55631
8510	962	56814	508	255	0	58539
8511	56777	790	184	334	0	58085
8512	56543	416	114	325	0	57398
8513	1309	228	55755	235	0	57527
8514	759	136	779	53561	0	55235
8515	428	130	415	56401	0	57374
8516	300	206	55947	1254	0	57707
8517	345	124	809	54331	0	55609
8518	354	145	474	53749	0	54722
8519	56625	113	194	1332	0	58264
8520	57104	117	159	666	0	58046
8521	1330	113	165	56262	0	57870
8522	662	223	56186	954	0	58025
8523	413	131	809	56312	0	57665
8524	354	134	446	57203	0	58137
8525	325	212	57487	1260	0	59284
8526	364	122	798	58432	0	59716
8527	57763	130	447	1059	0	59399
8528	57930	128	189	690	0	58937
8529	1255	57671	225	329	0	59480
8530	59256	809	119	420	0	60604
8531	58831	414	134	382	0	59761
8532	1309	59559	193	270	0	61331
8533	61280	813	130	408	0	62631
8534	61335	426	145	331	0	62237
8535	63587	161	139	394	0	64281
8536	1450	226	61314	306	0	63296
8537	60217	109	810	360	0	61496
8538	1094	153	424	61914	0	63585
8539	62077	119	169	1077	0	63442
8540	1116	186	60624	551	0	62477
8541	589	58756	894	302	0	60541
8542	58881	795	483	342	0	60501
8543	940	60533	256	274	0	62003
8544	602	836	110	59578	0	61126
8545	369	427	135	61316	0	62247
8546	60961	142	132	1377	0	62612
8547	59784	106	142	687	0	60719
8548	1374	194	59243	327	0	61138
8549	607	171	54166	224	0	55168
8550	284	161	56202	188	0	56835
8551	282	278	1037	55240	0	56837
8552	259	164	56211	813	0	57447
8553	216	180	54227	426	0	55049
8554	669	974	871	50752	0	53266
8555	54913	66	407	870	0	56256
8556	55524	49	140	436	0	56149
8557	55907	55	114	278	0	56354
8558	55910	52	89	238	0	56289
8559	933	58	104	55663	0	56758
8560	477	65	89	56706	0	57337
8561	254	140	58538	812	0	59744
8562	252	75	641	57691	0	58659
8563	281	92	360	57359	0	58092
8564	60326	69	119	1125	0	61639
8565	60261	64	111	559	0	60995
8566	1118	64	115	59439	0	60736
8567	60111	59	111	841	0	61122
8568	60597	53	125	561	0	61336
8569	1203	70	130	60591	0	61994
8570	650	63	149	60224	0	61086
8571	288	144	59048	1182	0	60662
8572	281	179	57967	542	0	58969
8573	304	185	1078	59119	0	60686
8574	294	101	491	60682	0	61568
8575	258	151	60448	1126	0	61983
8576	57379	67	775	646	0	58867
8577	59029	40	425	397	0	59891
8578	1273	125	58702	265	0	60365
8579	600	58002	825	291	0	59718
8580	58520	585	487	344	0	59936
8581	821	384	60014	209	0	61428
8582	560	134	755	58500	0	59949
8583	333	47	484	61110	0	61974
8584	63644	63	235	1276	0	65218
8585	67993	32	179	881	0	69085
8586	1237	42	198	68095	0	69572
8587	754	48	176	72791	0	73769
8588	72405	55	143	1380	0	73983
8589	72838	38	168	785	0	73829
8590	72290	43	196	460	0	72989
8591	1452	138	73273	356	0	75219
8592	764	38	956	73427	0	75185
8593	433	46	574	76129	0	77182
8594	75175	39	250	1641	0	77105
8595	1041	75610	267	929	0	77847
8596	83028	829	196	499	0	84552
8597	1570	83660	317	328	0	85875
8598	1033	1266	189	84517	0	87005
8599	538	628	196	85808	0	87170
8600	428	280	84428	2241	0	87377
8601	456	104	1500	84711	0	86771
8602	435	186	85106	1848	0	87575
8603	435	100	1644	85638	0	87817
8604	444	116	924	85291	0	86775
8605	383	81593	466	2413	0	84855
8606	427	86150	398	1236	0	88211
8607	544	2088	269	83183	0	86084
8608	558	788	248	87332	0	88926
8609	579	205	259	88093	0	89136
8610	548	140	270	88942	0	89900
8611	557	121	250	89810	0	90738
8612	462	210	87048	2771	0	90491
8613	566	139	1677	86831	0	89213
8614	536	134	935	88967	0	90572
8615	507	238	85246	2718	0	88709
8616	434	84550	1741	1626	0	88351
8617	515	1532	939	85782	0	88768
8618	557	928	85038	2078	0	88601
8619	441	85332	1779	1383	0	88935
8620	581	1594	956	86377	0	89508
8621	88063	863	417	2260	0	91603
8622	2000	312	333	88480	0	91125
8623	1252	217	314	90242	0	92025
8624	623	225	321	91607	0	92776
8625	541	205	320	89339	0	90405
8626	413	85971	449	3007	0	89840
8627	497	1612	308	88883	0	91300
8628	90366	916	302	2726	0	94310
8629	1914	363	326	92352	0	94955
8630	1159	286	300	91550	0	93295
8631	548	237	297	93341	0	94423
8632	88507	238	311	3305	0	92361
8633	89182	208	388	1991	0	91769
8634	2669	223	335	89733	0	92960
8635	85815	210	239	2424	0	88688
8636	85858	234	278	1678	0	88048
8637	2243	85681	423	1031	0	89378
8638	85320	1476	275	1049	0	88120
8639	1635	85372	417	893	0	88317
8640	925	86040	388	902	0	88255
8641	529	2117	356	86924	0	89926
8642	519	1077	87913	2108	0	91617
8643	490	427	1477	85749	0	88143
8644	434	315	851	86665	0	88265
8645	289	85850	495	2533	0	89167
8646	85571	1476	262	1568	0	88877
8647	1615	871	241	86234	0	88961
8648	938	563	88261	2092	0	91854
8649	463	409	1391	87895	0	90158
8650	315	90142	890	2128	0	93475
8651	91128	1399	326	1660	0	94513
8652	1623	858	208	91791	0	94480
8653	967	602	91492	2153	0	95214
8654	652	312	1360	92860	0	95184
8655	420	90471	919	2216	0	94026
8656	460	1496	286	92511	0	94753
8657	95011	886	267	2488	0	98652
8658	97044	427	255	1881	0	99607
8659	97604	327	297	1250	0	99478
8660	2560	96751	427	1121	0	100859
8661	96209	1651	283	1032	0	99175
8662	2071	990	227	96340	0	99628
8663	95144	465	273	2405	0	98287
8664	1876	95449	345	1590	0	99260
8665	1199	1801	187	97209	0	100396
8666	518	1246	96817	2242	0	100823
8667	89020	525	1557	1796	0	92898
8668	1674	97135	1014	1071	0	100894
8669	1118	1733	376	97666	0	100893
8670	512	953	240	100513	0	102218
8671	473	406	210	99239	0	100328
8672	498	353	244	96107	0	97202
8673	345	96215	391	2879	0	99830
8674	97055	1638	229	1786	0	100708
8675	97428	972	229	1052	0	99681
8676	2520	626	97693	857	0	101696
8677	1325	381	1542	98164	0	101412
8678	673	433	98611	2204	0	101921
8679	95445	318	1666	1580	0	99009
8680	99491	333	865	980	0	101669
8681	97316	338	333	920	0	98907
8682	2734	376	220	92855	0	96185
8683	1267	92947	328	2039	0	96581
8684	92451	1627	210	1462	0	95750
8685	2098	999	168	89233	0	92498
8686	88936	469	329	2221	0	91955
8687	1913	456	83349	1221	0	86939
8688	1161	441	80945	663	0	83210
8689	83941	275	1816	744	0	86776
8690	1936	289	838	84748	0	87811
8691	83757	282	330	1881	0	86250
8692	1730	83267	319	1181	0	86497
8693	83891	1379	202	803	0	86275
8694	84475	807	185	735	0	86202
8695	2237	596	83022	551	0	86406
8696	827	316	73356	291	0	74790
8697	408	73747	1301	308	0	75764
8698	710	879	816	72838	0	75243
8699	73709	429	539	1116	0	75793
8700	959	172	140	73309	0	74580
8701	661	138	111	75757	0	76667
8702	421	270	73487	1179	0	75357
8703	70565	172	768	763	0	72268
8704	1044	139	424	75943	0	77550
8705	653	295	74523	920	0	76391
8706	430	261	72948	536	0	74175
8707	421	411	1045	74080	0	75957
8708	347	269	74638	874	0	76128
8709	385	249	73988	494	0	75116
8710	350	177	1027	65980	0	67534
8711	358	294	75735	785	0	77172
8712	322	165	743	72985	0	74215
8713	241	72865	462	878	0	74446
8714	76924	685	184	673	0	78466
8715	883	78850	236	382	0	80351
8716	582	908	161	78291	0	79942
8717	336	82107	253	925	0	83621
8718	395	1147	86409	560	0	88511
8719	411	534	1194	101731	0	103870
8720	365	343	116420	2225	0	119353
8721	112919	166	2521	1222	0	116828
8722	2651	121884	1416	486	0	126437
8723	123285	2610	478	458	0	126831
8724	3192	1306	321	120757	0	125576
8725	122596	457	353	2909	0	126315
8726	3326	372	121814	1441	0	126953
8727	1658	122533	2807	666	0	127664
8728	121579	2691	1371	546	0	126187
8729	3151	1437	518	114806	0	119912
8730	1618	121802	449	2563	0	126432
8731	864	2917	334	123899	0	128014
8732	125858	1457	285	3402	0	131002
8733	3020	133881	555	1712	0	139168
8734	135636	3351	272	903	0	140162
8735	3906	1864	132523	453	0	138746
8736	132237	599	3432	550	0	136818
8737	4167	396	1695	133313	0	139571
8738	133046	294	673	3618	0	137631
8739	3795	132141	569	1753	0	138258
8740	2002	3390	398	133342	0	139132
8741	1104	1704	298	136741	0	139847
8742	708	763	130164	5070	0	136705
8743	771	408	3416	130173	0	134768
8744	708	462	1697	134152	0	137019
8745	793	388	685	135207	0	137073
8746	738	365	471	136035	0	137609
8747	641	451	132060	5658	0	138810
8748	525	126983	3792	2685	0	133985
8749	713	3524	1827	128293	0	134357
8750	127287	1720	728	4041	0	133776
8751	128397	657	516	2308	0	131878
8752	5145	128126	646	1112	0	135029
8753	127856	3616	448	991	0	132911
8754	128795	1786	517	904	0	132002
8755	128610	762	490	845	0	130707
8756	5724	124229	559	895	0	131407
8757	122006	3565	424	739	0	126734
8758	4418	2085	395	117640	0	124538
8759	2236	831	117237	3790	0	124094
8760	1083	117720	3400	2232	0	124435
8761	1066	3562	1794	118207	0	124629
8762	831	1871	117283	3738	0	123723
8763	114638	707	3342	2239	0	120926
8764	3734	509	1727	118027	0	123997
8765	2153	494	678	119903	0	123228
8766	1173	480	426	119845	0	121924
8767	999	520	361	120749	0	122629
8768	898	621	113816	5462	0	120797
8769	104902	455	3330	2815	0	111502
8770	3625	112757	1856	1385	0	119623
8771	113979	3342	697	1081	0	119099
8772	3995	114217	683	920	0	119815
8773	115475	3715	462	922	0	120574
8774	4368	1850	393	113680	0	120291
8775	2377	942	113232	3849	0	120400
8776	1324	732	115241	2228	0	119525
8777	1116	641	4601	113506	0	119864
8778	1116	616	1973	116048	0	119753
8779	1075	535	824	118362	0	120796
8780	113315	488	617	5726	0	120146
8781	3840	621	113636	2813	0	120910
8782	2380	816	3437	106153	0	112786
8783	1244	113539	1905	3762	0	120450
8784	113564	3398	823	2387	0	120172
8785	4024	1996	113143	1270	0	120433
8786	2305	111187	3716	1328	0	118536
8787	1469	3533	113611	1115	0	119728
8788	1288	1931	3768	112731	0	119718
8789	1178	1070	113750	4059	0	120057
8790	1122	890	114646	2319	0	118977
8791	1265	728	4803	113140	0	119936
8792	1094	776	114237	4117	0	120224
8793	1115	725	115429	2524	0	119793
8794	1160	589	4974	111379	0	118102
8795	111939	581	2277	4452	0	119249
8796	3950	671	112345	2658	0	119624
8797	2491	586	3834	109774	0	116685
8798	1453	584	2167	114386	0	118590
8799	111377	614	1130	5614	0	118735
8800	4175	552	801	113443	0	118971
8801	111038	501	790	4776	0	117105
8802	4191	109279	929	2744	0	117143
8803	2443	3393	748	111776	0	118360
8804	111656	1729	730	4406	0	118521
8805	113699	801	842	2665	0	118007
8806	5498	600	690	111532	0	118320
8807	2611	736	110945	4315	0	118607
8808	105577	574	3739	2705	0	112595
8809	3847	110518	2308	1612	0	118285
8810	110405	3454	1114	1477	0	116450
8811	111144	1748	928	1456	0	115276
8812	112302	791	928	1381	0	115402
8813	5662	665	107788	1210	0	115325
8814	2529	106602	3868	1272	0	114271
8815	1660	3794	2070	104429	0	111953
8816	1420	2268	962	107318	0	111968
8817	1174	849	102657	5067	0	109747
8818	865	93956	3260	2654	0	100735
8819	649	77802	1392	1092	0	80935
8820	462	68404	526	570	0	69962
8821	63048	1957	2124	593	0	67722
8822	1802	657	404	61071	0	63934
8823	885	242	277	62173	0	63577
8824	471	273	61465	1894	0	64103
8825	57162	209	1290	885	0	59546
8826	1453	187	655	61186	0	63481
8827	973	443	333	61911	0	63660
8828	485	231	60712	1797	0	63225
8829	360	59555	1297	882	0	62094
8830	563	1567	577	58895	0	61602
8831	393	554	58628	1311	0	60886
8832	229	52944	934	678	0	54785
8833	46663	567	402	367	0	47999
8834	674	321	48860	224	0	50079
8835	386	151	567	46039	0	47143
8836	156	48398	344	531	0	49429
8837	48600	533	128	358	0	49619
8838	659	268	110	48695	0	49732
8839	49057	111	120	655	0	49943
8840	48913	96	87	381	0	49477
8841	746	49014	154	186	0	50100
8842	49229	514	124	239	0	50106
8843	50579	220	119	322	0	51240
8844	772	154	50781	155	0	51862
8845	49586	91	479	245	0	50401
8846	603	165	50728	165	0	51661
8847	49443	66	431	160	0	50100
8848	50520	62	199	199	0	50980
8849	633	136	51619	117	0	52505
8850	281	123	394	50856	0	51654
8851	159	136	52907	402	0	53604
8852	121	122	49918	226	0	50387
8853	146	136	54434	120	0	54836
8854	161	249	531	52672	0	53613
8855	108	56	207	59621	0	59992
8856	119	37	61	60131	0	60348
8857	118	43	62	61458	0	61681
8858	120	135	61681	705	0	62641
8859	151	33	536	57195	0	57915
8860	92	54084	314	686	0	55176
8861	127	600	62430	296	0	63453
8862	131	263	596	60629	0	61619
8863	125	164	63120	636	0	64045
8864	83	61548	655	375	0	62661
8865	63	62853	354	136	0	63406
8866	151	822	78	62277	0	63328
8867	128	355	62209	604	0	63296
8868	122	197	62587	345	0	63251
8869	164	66	842	62885	0	63957
8870	142	79	336	64504	0	65061
8871	106	61	121	65697	0	65985
8872	140	153	65170	965	0	66428
8873	73	64632	699	546	0	65950
8874	78	67478	410	196	0	68162
8875	114	1005	125	66603	0	67847
8876	133	443	65060	744	0	66380
8877	144	175	65456	460	0	66235
8878	72	68143	1057	203	0	69475
8879	68280	742	421	282	0	69725
8880	720	69510	229	215	0	70674
8881	422	859	72008	187	0	73476
8882	71691	401	942	192	0	73226
8883	982	148	468	75061	0	76659
8884	76857	97	153	1196	0	78303
8885	1075	79	160	77054	0	78368
8886	596	100	152	78153	0	79001
8887	77027	102	131	1647	0	78907
8888	1044	79944	180	799	0	81967
8889	640	1150	79568	282	0	81640
8890	157	81828	1136	234	0	83355
8891	80783	1120	583	338	0	82824
8892	1044	81434	265	213	0	82956
8893	81244	1130	127	349	0	82850
8894	81265	577	170	296	0	82308
8895	1584	82009	250	197	0	84040
8896	700	1164	120	81133	0	83117
8897	81169	609	151	1230	0	83159
8898	81832	209	157	760	0	82958
8899	1686	158	180	80493	0	82517
8900	723	239	79239	1178	0	81379
8901	276	225	80336	674	0	81511
8902	290	177	1641	80906	0	83014
8903	248	197	80028	1265	0	81738
8904	75029	178	1281	877	0	77365
8905	1145	78586	736	351	0	80818
8906	779	1102	207	80160	0	82248
8907	335	612	206	81003	0	82156
8908	301	211	199	81038	0	81749
8909	301	169	218	80495	0	81183
8910	300	206	186	81587	0	82279
8911	249	285	79630	1815	0	81979
8912	177	79804	1202	857	0	82040
8913	80404	1183	697	411	0	82695
8914	1270	688	254	79529	0	81741
8915	823	219	210	80511	0	81763
8916	372	236	205	80653	0	81466
8917	219	79630	271	1978	0	82098
8918	328	1183	182	81139	0	82832
8919	354	707	222	81827	0	83110
8920	79090	247	182	1984	0	81503
8921	1227	77410	271	949	0	79857
8922	716	78525	259	494	0	79994
8923	338	1767	181	78638	0	80924
8924	77490	743	193	1503	0	79929
8925	1297	350	77786	839	0	80272
8926	72672	265	1233	599	0	74769
8927	1337	316	80780	362	0	82795
8928	869	228	1241	79934	0	82272
8929	439	230	697	82440	0	83806
8930	323	248	241	82245	0	83057
8931	361	225	193	82071	0	82850
8932	333	200	190	81983	0	82706
8933	79897	173	206	2077	0	82353
8934	1300	303	79012	992	0	81607
8935	869	207	1221	79828	0	82125
8936	368	272	82111	1493	0	84244
8937	231	81519	1377	1095	0	84222
8938	81016	1219	767	642	0	83644
8939	1393	842	84416	530	0	87181
8940	898	309	1310	85069	0	87586
8941	438	216	752	88603	0	90009
8942	303	289	87762	2303	0	90657
8943	324	293	87757	1127	0	89501
8944	428	281	2012	82607	0	85328
8945	87380	202	930	1785	0	90297
8946	87774	219	306	1207	0	89506
8947	2074	87080	352	604	0	90110
8948	88561	1403	211	585	0	90760
8949	1712	798	221	84115	0	86846
8950	902	88129	333	1675	0	91039
8951	563	1389	202	89034	0	91188
8952	368	914	89940	1838	0	93060
8953	506	286	1417	85530	0	87739
8954	623	238	770	87866	0	89497
8955	82341	188	273	2184	0	84986
8956	1388	82576	320	1224	0	85508
8957	81648	1274	212	612	0	83746
8958	1396	81017	332	474	0	83219
8959	78020	1299	197	476	0	79992
8960	1372	78302	280	406	0	80360
8961	727	78486	319	440	0	79972
8962	78975	1643	232	546	0	81396
8963	1437	748	223	75256	0	77664
8964	710	78083	320	1281	0	80394
8965	79245	1116	258	1024	0	81643
8966	79195	619	243	563	0	80620
8967	80952	220	233	526	0	81931
8968	79563	161	211	529	0	80464
8969	1780	78779	328	481	0	81368
8970	895	1114	199	79217	0	81425
8971	444	654	171	80957	0	82226
8972	80400	237	191	1953	0	82781
8973	1306	200	173	79842	0	81521
8974	78425	180	177	1568	0	80350
8975	1276	280	76846	846	0	79248
8976	73917	184	1045	651	0	75797
8977	1281	314	77064	402	0	79061
8978	875	478	1118	75197	0	77668
8979	75609	178	629	1312	0	77728
8980	1147	74458	288	787	0	76680
8981	71204	885	135	467	0	72691
8982	1006	70728	239	466	0	72439
8983	665	1058	109	74624	0	76456
8984	318	624	72770	916	0	74628
8985	64963	367	887	738	0	66955
8986	876	72380	464	265	0	73985
8987	603	918	124	72072	0	73717
8988	346	423	110	70561	0	71440
8989	286	185	89	69900	0	70460
8990	264	275	68999	1105	0	70643
8991	198	68757	720	614	0	70289
8992	68580	690	336	389	0	69995
8993	68516	368	132	310	0	69326
8994	1013	68554	167	203	0	69937
8995	69987	702	87	426	0	71202
8996	916	464	77	69351	0	70808
8997	475	69479	181	736	0	70871
8998	69594	684	90	594	0	70962
8999	835	486	67927	309	0	69557
9000	446	68466	730	256	0	69898
9001	385	661	342	69180	0	70568
9002	298	402	119	70253	0	71072
9003	285	315	68783	952	0	70335
9004	300	182	629	66743	0	67854
9005	264	285	69070	804	0	70423
9006	285	168	676	68128	0	69257
9007	302	194	347	69728	0	70571
9008	281	184	142	70557	0	71164
9009	272	160	105	72226	0	72763
9010	276	245	70841	1152	0	72514
9011	248	267	76831	599	0	77945
9012	222	83211	1401	436	0	85270
9013	302	1287	598	87502	0	89689
9014	374	816	90784	1462	0	93436
9015	243	89922	1578	938	0	92681
9016	341	1631	716	93221	0	95909
9017	265	906	96726	1589	0	99486
9018	89615	321	1691	985	0	92612
9019	101190	182	804	441	0	102617
9020	2546	160	253	100111	0	103070
9021	1122	311	99811	1836	0	103080
9022	527	271	1707	99319	0	101824
9023	99150	141	862	2167	0	102320
9024	1759	100833	396	1039	0	104027
9025	103984	1737	179	626	0	106526
9026	105294	887	154	522	0	106857
9027	2636	298	151	100647	0	103732
9028	1229	198	175	102772	0	104374
9029	531	138	146	103383	0	104198
9030	377	162	191	102866	0	103596
9031	322	188	179	103083	0	103772
9032	100461	147	208	2983	0	103799
9033	101517	153	225	1393	0	103288
9034	102081	170	249	703	0	103203
9035	2725	371	96816	441	0	100353
9036	96629	238	1659	565	0	99091
9037	2141	336	950	97685	0	101112
9038	1098	368	96732	2132	0	100330
9039	455	94323	1932	1207	0	97917
9040	631	1960	1069	93198	0	96858
9041	458	898	469	92931	0	94756
9042	409	93351	446	2397	0	96603
9043	620	1564	283	96306	0	98773
9044	511	993	94683	2133	0	98320
9045	470	417	95788	1261	0	97936
9046	504	263	2630	96353	0	99750
9047	95581	214	1161	2313	0	99269
9048	95785	252	421	1385	0	97843
9049	2908	379	95356	697	0	99340
9050	1453	88992	1883	702	0	93030
9051	645	93287	1088	739	0	95759
9052	88532	2347	386	859	0	92124
9053	2032	1155	89620	858	0	93665
9054	1306	343	1733	88970	0	92352
9055	89071	209	995	2390	0	92665
9056	2110	87093	503	1479	0	91185
9057	1420	90275	341	811	0	92847
9058	89402	2374	300	674	0	92750
9059	2366	1066	315	90719	0	94466
9060	98214	315	350	2373	0	101252
9061	2727	246	346	108968	0	112287
9062	1812	283	382	111301	0	113778
9063	842	461	109360	4063	0	114726
9064	730	372	2485	111646	0	115233
9065	726	388	1514	113275	0	115903
9066	112190	352	693	4523	0	117758
9067	2881	372	487	115097	0	118837
9068	1803	505	113126	3518	0	118952
9069	111720	271	2805	2349	0	117145
9070	3022	261	1752	114429	0	119464
9071	114382	309	781	3473	0	118945
9072	3287	108161	685	2251	0	114384
9073	2034	114053	710	1221	0	118018
9074	113228	3840	611	906	0	118585
9075	114367	2009	577	846	0	117799
9076	4502	873	517	112038	0	117930
9077	2513	647	110695	3045	0	116900
9078	1373	465	2832	112981	0	117651
9079	110286	501	1825	3563	0	116175
9080	3207	110572	966	2224	0	116969
9081	2343	2863	478	110556	0	116240
9082	110682	1869	522	3430	0	116503
9083	3375	1018	106778	2426	0	113597
9084	107561	555	2779	1669	0	112564
9085	104537	474	1755	1545	0	108311
9086	4461	503	107383	1356	0	113703
9087	2532	495	109370	1341	0	113738
9088	1613	379	4221	104545	0	110758
9089	1407	394	2168	105961	0	109930
9090	1138	110713	1168	4694	0	117713
9091	1305	2881	603	113056	0	117845
9092	1144	1998	112786	4064	0	119992
9093	1301	858	3094	114457	0	119710
9094	1350	504	1947	120028	0	123829
9095	1287	580	115029	5359	0	122255
9096	1131	114433	3341	3173	0	122078
9097	1197	3133	2009	115660	0	121999
9098	1212	1943	953	118939	0	123047
9099	117036	879	689	5332	0	123936
9100	3863	626	621	117488	0	122598
9101	2615	735	114619	4306	0	122275
9102	113503	612	3301	2923	0	120339
9103	117391	577	2086	1759	0	121813
9104	118952	580	1021	1441	0	121994
9105	5664	745	112647	1242	0	120298
9106	3190	492	3430	111331	0	118443
9107	1850	438	2318	114512	0	119118
9108	1650	440	1265	115193	0	118548
9109	108704	501	904	5504	0	115613
9110	3622	107802	1064	3546	0	116034
9111	2282	2612	98170	1714	0	104778
9112	1066	95729	2734	1395	0	100924
9113	870	92300	1751	1244	0	96165
9114	786	91515	1080	1216	0	94597
9115	1635	3926	1277	87783	0	94621
9116	930	1825	86386	2862	0	92003
9117	76819	920	2406	2181	0	82326
9118	2242	82963	1659	1424	0	88288
9119	80046	1870	780	1332	0	84028
9120	2373	82924	704	1139	0	87140
9121	83662	2214	535	1121	0	87532
9122	2572	84961	627	962	0	89122
9123	1992	2427	85570	924	0	90913
9124	1329	1444	2173	85009	0	89955
9125	1064	650	1489	88812	0	92015
9126	87276	496	807	3849	0	92428
9127	2596	469	627	93553	0	97245
9128	1857	562	92248	3387	0	98054
9129	1281	510	2454	93987	0	98232
9130	991	657	93520	3338	0	98506
9131	778	92114	2941	2351	0	98184
9132	1015	2570	1774	84693	0	90052
9133	859	94051	1106	2603	0	98619
9134	93578	2787	729	1870	0	98964
9135	2932	1658	722	93256	0	98568
9136	1988	916	93000	2937	0	98841
9137	1096	773	92795	2042	0	96706
9138	90084	656	3631	1349	0	95720
9139	2873	763	1857	91018	0	96511
9140	1913	835	90485	2815	0	96048
9141	1124	877	88303	1932	0	92236
9142	741	88797	3767	1233	0	94538
9143	895	2742	1995	79294	0	84926
9144	558	87642	1099	2548	0	91847
9145	723	2646	736	86614	0	90719
9146	87445	1575	644	3065	0	92729
9147	2475	874	722	88774	0	92845
9148	1715	649	666	90543	0	93573
9149	89509	551	721	4006	0	94787
9150	2710	694	667	94148	0	98219
9151	1844	671	623	90961	0	94099
9152	1081	93743	742	3792	0	99358
9153	94408	2553	630	2328	0	99919
9154	96507	1656	673	1417	0	100253
9155	3865	830	698	95295	0	100688
9156	2150	586	725	96188	0	99649
9157	1317	564	686	95023	0	97590
9158	851	89070	795	4428	0	95144
9159	722	93025	859	2565	0	97171
9160	1179	3130	619	84759	0	89687
9161	71476	1052	418	2068	0	75014
9162	71474	472	424	1261	0	73631
9163	2126	70213	492	765	0	73596
9164	66849	1638	379	634	0	69500
9165	1613	66800	413	638	0	69464
9166	881	67043	399	642	0	68965
9167	1242	2216	540	64832	0	68830
9168	63807	897	457	1787	0	66948
9169	1494	61942	359	1121	0	64916
9170	870	64147	372	676	0	66065
9171	551	1912	293	64083	0	66839
9172	548	852	283	65634	0	67317
9173	396	494	64101	2268	0	67259
9174	61961	374	1428	1318	0	65081
9175	63220	415	779	808	0	65222
9176	2016	470	65198	698	0	68382
9177	998	469	65407	685	0	67559
9178	578	406	1916	65605	0	68505
9179	537	363	820	67516	0	69236
9180	475	66597	387	2428	0	69887
9181	543	1653	284	67931	0	70411
9182	474	1067	66660	2108	0	70309
9183	532	503	1466	66449	0	68950
9184	606	438	814	67330	0	69188
9185	65371	428	405	2543	0	68747
9186	1747	495	64701	1371	0	68314
9187	62633	455	1565	875	0	65528
9188	1810	537	63471	794	0	66612
9189	1019	459	1489	60393	0	63360
9190	533	464	60438	1783	0	63218
9191	449	503	60276	1162	0	62390
9192	632	695	1942	58352	0	61621
9193	56495	458	1265	2011	0	60229
9194	54568	367	510	1125	0	56570
9195	1778	55536	487	699	0	58500
9196	55857	1345	406	683	0	58291
9197	54928	835	375	660	0	56798
9198	1847	55103	445	626	0	58021
9199	986	1432	407	55790	0	58615
9200	585	787	391	57463	0	59226
9201	506	417	344	57962	0	59229
9202	494	353	338	58499	0	59684
9203	448	419	56499	2328	0	59694
9204	54169	293	1436	1296	0	57194
9205	1567	266	847	56899	0	59579
9206	1009	330	434	56063	0	57836
9207	514	56738	432	2244	0	59928
9208	571	1464	305	58212	0	60552
9209	487	864	57373	1922	0	60646
9210	53361	445	1385	1376	0	56567
9211	1598	408	58141	908	0	61055
9212	1029	334	1297	56548	0	59208
9213	56268	297	722	1826	0	59113
9214	1460	57244	387	1304	0	60395
9215	1077	1364	246	59382	0	62069
9216	599	921	59328	1825	0	62673
9217	540	484	1336	59690	0	62050
9218	58765	381	807	1872	0	61825
9219	1638	411	59303	1183	0	62535
9220	1047	398	57836	734	0	60015
9221	545	57237	1915	663	0	60360
9222	54772	1361	871	600	0	57604
9223	1369	54196	384	584	0	56533
9224	877	1352	52536	520	0	55285
9225	406	767	50178	459	0	51810
9226	346	49442	1579	460	0	51827
9227	43619	876	830	288	0	45613
9228	826	43804	394	310	0	45334
9229	601	884	207	42687	0	44379
9230	281	486	190	43970	0	44927
9231	217	194	43508	1341	0	45260
9232	250	154	927	43237	0	44568
9233	210	164	44770	1047	0	46191
9234	43049	151	934	706	0	44840
9235	44751	132	588	370	0	45841
9236	45092	140	257	353	0	45842
9237	1300	167	43817	322	0	45606
9238	43590	127	915	315	0	44947
9239	1020	192	558	41521	0	43291
9240	567	43701	315	947	0	45530
9241	43773	757	289	658	0	45477
9242	884	505	42844	329	0	44562
9243	42101	151	866	337	0	43455
9244	42582	125	584	300	0	43591
9245	1239	179	41873	290	0	43581
9246	596	41506	968	295	0	43365
9247	385	943	594	41484	0	43406
9248	250	480	41738	894	0	43362
9249	257	216	40334	540	0	41347
9250	268	629	1048	35494	0	37439
9251	172	139	36731	678	0	37720
9252	216	102	653	35509	0	36480
9253	217	87	408	34511	0	35223
9254	209	107	195	36135	0	36646
9255	183	132	35634	919	0	36868
9256	214	100	673	35547	0	36534
9257	186	142	36128	727	0	37183
9258	217	96	701	36317	0	37331
9259	37293	91	425	795	0	38604
9260	764	90	204	37354	0	38412
9261	394	38360	237	765	0	39756
9262	232	693	163	39474	0	40562
9263	39192	362	169	836	0	40559
9264	776	39351	228	493	0	40848
9265	489	689	167	39328	0	40673
9266	39269	368	168	821	0	40626
9267	785	179	39218	483	0	40665
9268	513	125	758	38503	0	39899
9269	233	135	39633	843	0	40844
9270	193	154	39259	499	0	40105
9271	242	131	1072	38434	0	39879
9272	38892	87	500	862	0	40341
9273	756	143	38315	475	0	39689
9274	37690	117	764	263	0	38834
9275	924	163	481	38879	0	40447
9276	443	146	38742	711	0	40042
9277	209	127	37758	437	0	38531
9278	196	147	38200	203	0	38746
9279	219	337	1026	35835	0	37417
9280	36880	69	715	734	0	38398
9281	602	37154	231	412	0	38399
9282	407	572	154	36676	0	37809
9283	182	328	162	37642	0	38314
9284	37503	118	139	943	0	38703
9285	37597	51	178	491	0	38317
9286	834	37384	210	270	0	38698
9287	38012	537	173	233	0	38955
9288	37708	320	155	201	0	38384
9289	880	105	184	37306	0	38475
9290	438	114	37356	622	0	38530
9291	36664	103	619	416	0	37802
9292	688	143	409	37796	0	39036
9293	437	88	158	37851	0	38534
9294	37437	86	137	881	0	38541
9295	649	82	141	35893	0	36765
9296	477	90	116	36150	0	36833
9297	35356	60	148	885	0	36449
9298	577	36150	182	462	0	37371
9299	36224	483	162	241	0	37110
9300	641	304	36038	168	0	37151
9301	35580	73	578	214	0	36445
9302	726	53	343	35857	0	36979
9303	384	36751	210	617	0	37962
9304	260	503	110	37503	0	38376
9305	198	280	134	37658	0	38270
9306	240	78	118	37781	0	38217
9307	36707	40	115	906	0	37768
9308	576	35753	152	413	0	36894
9309	298	35836	138	204	0	36476
9310	35330	651	94	196	0	36271
9311	576	310	36168	155	0	37209
9312	320	118	35164	148	0	35750
9313	34322	261	828	201	0	35612
9314	553	82	36217	156	0	37008
9315	292	44	457	34296	0	35089
9316	172	50	242	33021	0	33485
9317	139	38	101	35574	0	35852
9318	146	50	75	34854	0	35125
9319	98	34063	108	699	0	34968
9320	120	431	81	35504	0	36136
9321	141	280	34716	612	0	35749
9322	109	78	472	34519	0	35178
9323	131	72	33911	586	0	34700
9324	130	112	33439	318	0	33999
9325	140	55	683	33958	0	34836
9326	153	93	34649	565	0	35460
9327	158	83	524	34282	0	35047
9328	34444	80	291	632	0	35447
9329	575	95	34786	315	0	35771
9330	33165	65	499	218	0	33947
9331	566	66	283	34526	0	35441
9332	355	107	34246	579	0	35287
9333	148	33581	533	398	0	34660
9334	184	467	286	34275	0	35212
9335	185	305	35993	581	0	37064
9336	161	99	520	36258	0	37038
9337	37583	67	297	760	0	38707
9338	38006	82	128	447	0	38663
9339	38771	78	108	291	0	39248
9340	867	70	121	39189	0	40247
9341	405	79	124	40228	0	40836
9342	231	57	118	41033	0	41439
9343	40782	70	131	1006	0	41989
9344	638	41658	178	483	0	42957
9345	419	590	118	41989	0	43116
9346	204	314	110	43029	0	43657
9347	41886	104	112	1147	0	43249
9348	715	42827	159	557	0	44258
9349	465	670	106	44754	0	45995
9350	45138	346	104	944	0	46532
9351	44783	95	133	580	0	45591
9352	1227	96	137	44309	0	45769
9353	44406	72	106	1006	0	45590
9354	942	60	128	44384	0	45514
9355	523	121	44585	968	0	46197
9356	284	72	770	44783	0	45909
9357	239	65	433	45798	0	46535
9358	295	67	175	46375	0	46912
9359	43581	51	108	1270	0	45010
9360	735	44041	162	630	0	45568
9361	43003	692	94	343	0	44132
9362	753	42720	135	222	0	43830
9363	388	43895	124	213	0	44620
9364	43937	968	84	285	0	45274
9365	733	44949	134	210	0	46026
9366	483	753	86	44764	0	46086
9367	44781	379	87	863	0	46110
9368	45092	137	95	572	0	45896
9369	1132	87	86	44869	0	46174
9370	547	92	75	44041	0	44755
9371	186	44448	131	1156	0	45921
9372	45093	700	86	641	0	46520
9373	43747	404	79	386	0	44616
9374	1020	46052	137	307	0	47516
9375	493	46104	139	285	0	47021
9376	302	1061	65	46277	0	47705
9377	45889	446	104	1035	0	47474
9378	967	151	77	46160	0	47355
9379	580	119	73	47057	0	47829
9380	264	176	45572	1310	0	47322
9381	241	161	45527	638	0	46567
9382	263	135	1119	45920	0	47437
9383	236	169	46345	1027	0	47777
9384	200	46042	878	635	0	47755
9385	256	872	395	46318	0	47841
9386	270	425	127	47564	0	48386
9387	259	197	79	48097	0	48632
9388	243	189	46941	1440	0	48813
9389	242	194	45534	668	0	46638
9390	44340	135	1121	428	0	46024
9391	961	46891	502	314	0	48668
9392	47135	889	136	347	0	48507
9393	1058	495	93	46796	0	48442
9394	47586	201	83	1119	0	48989
9395	1094	161	81	46461	0	47797
9396	579	47855	123	973	0	49530
9397	48389	879	97	655	0	50020
9398	1053	490	46933	377	0	48853
9399	558	46758	811	303	0	48430
9400	46835	909	451	395	0	48590
9401	948	481	138	45916	0	47483
9402	515	45346	164	967	0	46992
9403	329	818	102	47212	0	48461
9404	46973	435	84	1131	0	48623
9405	996	238	103	47260	0	48597
9406	47109	205	107	1129	0	48550
9407	1044	219	46260	639	0	48162
9408	607	187	794	46342	0	47930
9409	46353	153	413	1099	0	48018
9410	989	219	45918	686	0	47812
9411	557	44444	860	395	0	46256
9412	399	860	454	43808	0	45521
9413	315	514	43857	988	0	45674
9414	273	270	43629	644	0	44816
9415	346	289	1109	43529	0	45273
9416	285	215	43898	1006	0	45404
9417	279	208	43599	648	0	44734
9418	287	221	1057	42851	0	44416
9419	43764	152	496	979	0	45391
9420	908	150	230	43682	0	44970
9421	573	172	159	44527	0	45431
9422	298	214	44326	1244	0	46082
9423	297	201	821	45387	0	46706
9424	46359	178	461	1166	0	48164
9425	936	209	46698	701	0	48544
9426	578	47508	869	393	0	49348
9427	343	856	451	48629	0	50279
9428	49364	475	213	1076	0	51128
9429	943	221	214	48866	0	50244
9430	546	49505	220	997	0	51268
9431	361	918	51812	595	0	53686
9432	339	498	889	52939	0	54665
9433	55882	236	518	1130	0	57766
9434	1095	244	55501	698	0	57538
9435	727	149	1025	55767	0	57668
9436	57228	143	573	1311	0	59255
9437	58276	114	229	864	0	59483
9438	1639	58366	296	369	0	60670
9439	58009	1119	201	350	0	59679
9440	1410	599	169	57572	0	59750
9441	775	247	58525	1239	0	60786
9442	278	56946	1175	796	0	59195
9443	204	59524	676	428	0	60832
9444	310	1605	371	57949	0	60235
9445	306	620	244	59161	0	60331
9446	172	256	57028	1543	0	58999
9447	141	56450	1105	772	0	58468
9448	140	56852	673	343	0	58008
9449	370	1448	287	54291	0	56396
9450	53827	516	193	989	0	55525
9451	834	53831	195	621	0	55481
9452	621	819	120	54820	0	56380
9453	56488	457	143	1165	0	58253
9454	941	149	154	57289	0	58533
9455	605	159	129	56575	0	57468
9456	306	139	143	57241	0	57829
9457	290	141	153	57227	0	57811
9458	55820	125	128	1499	0	57572
9459	1002	135	133	56483	0	57753
9460	575	231	54614	999	0	56419
9461	52233	152	912	771	0	54068
9462	1025	210	54149	326	0	55710
9463	619	225	55516	286	0	56646
9464	336	160	1189	55208	0	56893
9465	274	138	611	55854	0	56877
9466	271	146	211	57016	0	57644
9467	55869	128	160	1441	0	57598
9468	928	210	55512	688	0	57338
9469	54114	141	828	449	0	55532
9470	55862	165	497	401	0	56925
9471	1320	202	55285	290	0	57097
9472	53838	149	789	423	0	55199
9473	981	203	56421	288	0	57893
9474	552	57167	822	296	0	58837
9475	417	728	776	57055	0	58976
9476	241	440	233	58547	0	59461
9477	230	152	157	58240	0	58779
9478	191	119	138	58292	0	58740
9479	219	183	57676	1264	0	59342
9480	194	188	57423	671	0	58476
9481	237	140	1069	57075	0	58521
9482	206	187	58032	904	0	59329
9483	54632	109	817	700	0	56258
9484	58189	111	491	445	0	59236
9485	1189	112	200	57596	0	59097
9486	57344	112	171	971	0	58598
9487	818	59036	250	720	0	60824
9488	59080	647	155	457	0	60339
9489	857	546	59491	356	0	61250
9490	644	161	707	58444	0	59956
9491	247	60584	535	837	0	62203
9492	61500	649	243	721	0	63113
9493	879	445	200	62159	0	63683
9494	615	258	61620	904	0	63397
9495	365	138	777	61349	0	62629
9496	60804	131	566	1032	0	62533
9497	910	238	61543	706	0	63397
9498	668	156	805	61690	0	63319
9499	414	134	534	62619	0	63701
9500	355	256	62108	1369	0	64088
9501	320	60580	857	819	0	62576
9502	413	50408	757	602	0	52180
9503	368	1149	267	62337	0	64121
9504	352	578	235	63994	0	65159
9505	353	269	217	65027	0	65866
9506	62577	225	213	1550	0	64565
9507	63461	225	226	902	0	64814
9508	1332	231	211	63943	0	65717
9509	63814	222	211	1190	0	65437
9510	939	63655	269	826	0	65689
9511	695	934	201	65794	0	67624
9512	372	604	191	66749	0	67916
9513	363	259	208	67349	0	68179
9514	62227	200	194	1714	0	64335
9515	938	62699	264	950	0	64851
9516	732	823	202	64248	0	66005
9517	63182	526	188	1293	0	65189
9518	1043	176	163	64313	0	65695
9519	755	141	195	63844	0	64935
9520	365	60383	264	1617	0	62629
9521	326	63535	258	985	0	65104
9522	382	1130	212	63217	0	64941
9523	388	561	243	62988	0	64180
9524	59512	145	242	1641	0	61540
9525	1062	113	240	60675	0	62090
9526	655	203	58157	1191	0	60206
9527	383	110	866	57655	0	59014
9528	310	56112	652	1124	0	58198
9529	57262	737	318	970	0	59287
9530	1176	447	246	57547	0	59416
9531	696	146	202	55781	0	56825
9532	319	55588	241	1384	0	57532
9533	53058	645	121	694	0	54518
9534	739	56756	192	398	0	58085
9535	527	757	91	56431	0	57806
9536	246	418	54509	810	0	55983
9537	339	328	558	52050	0	53275
9538	52098	89	299	744	0	53230
9539	550	52740	114	489	0	53893
9540	398	593	46	52566	0	53603
9541	151	51287	110	662	0	52210
9542	158	570	68	52609	0	53405
9543	160	376	51162	733	0	52431
9544	155	314	497	50609	0	51575
9545	136	116	281	51687	0	52220
9546	125	112	73	52504	0	52814
9547	49781	93	69	1082	0	51025
9548	50938	75	70	578	0	51661
9549	808	51272	123	310	0	52513
9550	51288	567	54	369	0	52278
9551	621	50770	94	247	0	51732
9552	340	51838	93	268	0	52539
9553	49941	805	56	340	0	51142
9554	697	434	49555	260	0	50946
9555	398	165	510	49537	0	50610
9556	233	126	276	51446	0	52081
9557	174	147	76	53134	0	53531
9558	51139	136	71	1124	0	52470
9559	668	52073	137	608	0	53486
9560	475	742	74	51794	0	53085
9561	209	53142	128	859	0	54338
9562	55929	817	68	649	0	57463
9563	870	450	74	56648	0	58042
9564	551	231	56	68291	0	69129
9565	212	72056	119	1891	0	74278
9566	238	1404	76	75998	0	77716
9567	236	801	81	76817	0	77935
9568	73030	289	82	2599	0	76000
9569	1495	71632	146	1324	0	74597
9570	881	74433	161	566	0	76041
9571	347	2238	49	74471	0	77105
9572	309	1051	71996	1841	0	75197
9573	306	440	71887	1119	0	73752
9574	295	371	2135	71220	0	74021
9575	248	352	70878	1827	0	73305
9576	283	259	1597	71386	0	73525
9577	284	258	904	68724	0	70170
9578	273	205	291	73878	0	74647
9579	70738	199	233	2785	0	73955
9580	1680	182	184	71889	0	73935
9581	1019	228	159	70755	0	72161
9582	345	69710	252	2633	0	72940
9583	336	1640	132	73239	0	75347
9584	352	1036	70633	2146	0	74167
9585	342	365	1578	72599	0	74884
9586	359	303	863	74033	0	75558
9587	69570	335	249	2967	0	73121
9588	1723	332	179	71343	0	73577
9589	1057	302	183	70666	0	72208
9590	520	293	181	71661	0	72655
9591	65044	288	167	3116	0	68615
9592	1618	66986	226	1613	0	70443
9593	1048	1730	192	67880	0	70850
9594	455	1019	189	69417	0	71080
9595	298	518	66315	2944	0	70075
9596	326	323	1650	67649	0	69948
9597	63828	284	964	2460	0	67536
9598	1637	64630	433	1645	0	68345
9599	1035	1690	225	64554	0	67504
9600	463	1046	224	66091	0	67824
9601	399	470	63245	3054	0	67168
9602	59475	372	1632	1813	0	63292
9603	1626	62199	997	1153	0	65975
9604	61939	1682	341	1013	0	64975
9605	1793	1007	281	62567	0	65648
9606	1038	480	256	63792	0	65566
9607	510	352	284	64790	0	65936
9608	449	372	282	64972	0	66075
9609	62116	336	306	3098	0	65856
9610	1749	293	256	61401	0	63699
9611	993	58963	398	2498	0	62852
9612	551	1560	336	61248	0	63695
9613	484	877	303	62886	0	64550
9614	60266	387	329	3131	0	64113
9615	1698	59922	355	1900	0	63875
9616	1181	1617	223	61985	0	65006
9617	60828	977	212	2603	0	64620
9618	62048	446	236	1873	0	64603
9619	2420	367	215	62211	0	65213
9620	1209	423	60232	2554	0	64418
9621	60168	429	1512	1752	0	63861
9622	1895	322	845	62095	0	65157
9623	1137	381	61297	2470	0	65285
9624	672	289	1620	63181	0	65762
9625	562	313	959	62687	0	64521
9626	621	292	380	63391	0	64684
9627	524	63127	355	3207	0	67213
9628	539	1635	235	66036	0	68445
9629	532	950	205	66823	0	68510
9630	571	391	226	67027	0	68215
9631	588	397	234	66496	0	67715
9632	548	376	210	65431	0	66565
9633	597	385	217	65066	0	66265
9634	57442	338	252	3127	0	61159
9635	1587	363	56178	1923	0	60051
9636	998	56096	1464	1304	0	59862
9637	56668	1452	838	1162	0	60120
9638	1568	57133	414	1085	0	60200
9639	56636	1527	260	1051	0	59474
9640	2098	926	339	55931	0	59294
9641	56609	359	291	2136	0	59395
9642	1843	320	287	56462	0	58912
9643	1260	257	236	53913	0	55666
9644	573	54371	311	2679	0	57934
9645	54932	1359	212	1777	0	58280
9646	1637	873	55321	1266	0	59097
9647	1094	283	1288	56488	0	59153
9648	586	333	56789	2207	0	59915
9649	479	380	55450	1651	0	57960
9650	55478	342	1902	1137	0	58859
9651	1602	294	882	57349	0	60127
9652	1001	330	56268	2169	0	59768
9653	598	276	57426	1609	0	59909
9654	554	260	1918	56145	0	58877
9655	622	220	876	58385	0	60103
9656	57121	212	347	2676	0	60356
9657	1724	196	327	57436	0	59683
9658	1064	320	57922	2093	0	61399
9659	653	180	1356	58204	0	60393
9660	659	463	825	56926	0	58873
9661	413	57761	395	2290	0	60859
9662	55813	1115	305	1503	0	58736
9663	1195	54665	308	938	0	57106
9664	43080	556	130	575	0	44341
9665	459	37254	104	255	0	38072
9666	215	36188	102	219	0	36724
9667	183	407	187	36077	0	36854
9668	168	177	136	36043	0	36524
9669	210	144	67	35804	0	36225
9670	33832	46	77	495	0	34450
9671	267	108	34171	261	0	34807
9672	190	41	227	33760	0	34218
9673	32487	42	133	375	0	33037
9674	264	33209	87	244	0	33804
9675	162	33292	87	172	0	33713
9676	196	373	79	33626	0	34274
9677	106	144	61	34237	0	34548
9678	107	71	48	34262	0	34488
9679	70	35063	76	390	0	35599
9680	89	218	37	35610	0	35954
9681	91	174	35114	332	0	35711
9682	61	96	32048	222	0	32427
9683	32112	46	199	193	0	32550
9684	242	41	169	34594	0	35046
9685	34867	50	75	273	0	35265
9686	34277	26	51	248	0	34602
9687	207	34606	82	107	0	35002
9688	35047	119	46	174	0	35386
9689	35950	101	30	211	0	36292
9690	228	47	42	36002	0	36319
9691	161	40	47	36980	0	37228
9692	110	102	38108	283	0	38603
9693	80	39416	149	186	0	39831
9694	125	138	106	35990	0	36359
9695	71	103	52	40542	0	40768
9696	40626	45	56	355	0	41082
9697	179	50	47	40828	0	41104
9698	41582	47	40	296	0	41965
9699	229	43	29	42555	0	42856
9700	133	42875	70	298	0	43376
9701	44456	258	34	346	0	45094
9702	339	190	32	49766	0	50327
9703	231	76	40	53475	0	53822
9704	126	53	45	56589	0	56813
9705	94	114	55715	1139	0	57062
9706	126	40	762	56295	0	57223
9707	57520	31	416	1080	0	59047
9708	853	51	108	60777	0	61789
9709	484	33	64	67299	0	67880
9710	193	76	74	66879	0	67222
9711	109	64909	101	1774	0	66893
9712	103	68369	94	729	0	69295
9713	67168	1636	52	342	0	69198
9714	1181	68254	89	202	0	69726
9715	67876	1249	58	236	0	69419
9716	67605	610	41	206	0	68462
9717	67321	168	32	257	0	67778
9718	1835	158	66579	165	0	68737
9719	695	68210	1189	129	0	70223
9720	69556	1172	540	249	0	71517
9721	1278	575	106	70476	0	72435
9722	683	172	48	71711	0	72614
9723	243	105	38	71647	0	72033
9724	132	69098	111	2315	0	71656
9725	191	1151	43	70712	0	72097
9726	69891	554	36	1554	0	72035
9727	1236	174	67	68935	0	70412
9728	665	88	64	69883	0	70700
9729	239	147	68054	2012	0	70452
9730	223	164	69415	988	0	70790
9731	239	118	1690	70399	0	72446
9732	224	81	695	71154	0	72154
9733	148	71246	288	2052	0	73734
9734	263	1233	147	72177	0	73820
9735	331	643	125	73413	0	74512
9736	322	241	84	73837	0	74484
9737	70808	216	131	2251	0	73406
9738	1445	328	71769	1032	0	74574
9739	885	273	1168	73140	0	75466
9740	73737	273	623	1636	0	76269
9741	74296	294	178	1011	0	75779
9742	2101	261	124	73508	0	75994
9743	1117	249	144	74687	0	76197
9744	73113	248	124	2187	0	75672
9745	1560	72617	209	1068	0	75454
9746	940	74306	232	569	0	76047
9747	547	1922	150	73793	0	76412
9748	74454	825	151	1810	0	77240
9749	75261	327	114	1238	0	76940
9750	73961	240	112	854	0	75167
9751	2000	344	74648	666	0	77658
9752	70083	297	1327	758	0	72465
9753	1650	353	73594	667	0	76264
9754	70887	264	1335	810	0	73296
9755	1531	73055	805	759	0	76150
9756	911	1406	73345	829	0	76491
9757	525	734	1429	73170	0	75858
9758	406	409	73565	1963	0	76343
9759	527	286	1448	72447	0	74708
9760	71772	273	799	2140	0	74984
9761	1541	404	72202	1428	0	75575
9762	1021	287	1380	71346	0	74034
9763	599	76445	922	1917	0	79883
9764	587	1300	394	80357	0	82638
9765	654	730	311	80231	0	81926
9766	621	367	291	79472	0	80751
9767	78995	320	260	2665	0	82240
9768	79584	333	223	1547	0	81687
9769	2358	301	195	79726	0	82580
9770	1244	439	77983	2107	0	81773
9771	780	438	76883	1366	0	79467
9772	765	370	1892	79235	0	82262
9773	779	475	82023	1940	0	85217
9774	812	370	1443	82200	0	84825
9775	889	341	823	78748	0	80801
9776	827	307	396	82807	0	84337
9777	746	78414	444	2468	0	82072
9778	712	79617	533	1315	0	82177
9779	803	1892	395	83156	0	86246
9780	740	927	414	83504	0	85585
9781	749	432	422	83972	0	85575
9782	81262	332	356	2628	0	84578
9783	1892	483	83020	1343	0	86738
9784	1182	303	1583	83556	0	86624
9785	83084	286	965	2153	0	86488
9786	1659	83661	657	1463	0	87440
9787	1204	1386	488	86005	0	89083
9788	662	797	506	87205	0	89170
9789	606	359	435	86593	0	87993
9790	583	286	402	86699	0	87970
9791	525	408	83201	2805	0	86939
9792	76039	267	1491	1788	0	79585
9793	81330	247	947	1269	0	83793
9794	2181	320	80847	1068	0	84416
9795	77710	189	1580	1031	0	80510
9796	81170	197	1001	982	0	83350
9797	2243	320	81725	996	0	85284
9798	1092	84114	1653	964	0	87823
9799	731	1388	962	84078	0	87159
9800	574	727	87413	1806	0	90520
9801	539	85088	1453	1466	0	88546
9802	569	1062	80624	758	0	83013
9803	319	77248	1025	1580	0	80172
9804	423	798	733	75250	0	77204
9805	298	430	75232	896	0	76856
9806	395	258	749	72975	0	74377
9807	353	202	75979	874	0	77408
9808	204	73939	663	612	0	75418
9809	67884	171	353	244	0	68652
9810	154	67735	117	117	0	68123
9811	129	71430	140	217	0	71916
9812	461	303	155	71163	0	72082
9813	110	111	65	73028	0	73314
9814	68	38	34	72876	0	73016
9815	75	24	22	72739	0	72860
9816	58	26	27	73956	0	74067
9817	85	153	77611	219	0	78068
9818	108	51	137	76216	0	76512
9819	80	25	76	78768	0	78949
9820	78834	35	31	514	0	79414
9821	78676	31	29	373	0	79109
9822	79562	28	35	237	0	79862
9823	368	35	36	79922	0	80361
9824	87133	35	33	574	0	87775
9825	93575	44	41	528	0	94188
9826	94930	17	31	282	0	95260
9827	842	158	94223	64	0	95287
9828	91069	28	588	260	0	91945
9829	96361	36	277	277	0	96951
9830	96204	41	73	218	0	96536
9831	996	35	54	96089	0	97174
9832	398	211	97083	692	0	98384
9833	184	40	634	96090	0	96948
9834	99287	25	279	992	0	100583
9835	760	48	71	100368	0	101247
9836	337	105291	148	688	0	106464
9837	202	630	38	108480	0	109350
9838	108228	283	53	1055	0	109619
9839	109242	66	58	648	0	110014
9840	108276	54	48	382	0	108760
9841	1143	210	110559	137	0	112049
9842	517	50	744	108605	0	109916
9843	254	38	363	114225	0	114880
9844	187	224	115150	1150	0	116711
9845	123	112245	847	610	0	113825
9846	266	917	113299	189	0	114671
9847	260	393	795	113923	0	115371
9848	114255	102	433	1050	0	115840
9849	944	296	118545	478	0	120263
9850	614	55	791	118271	0	119731
9851	290	292	119394	894	0	120870
9852	115269	48	923	738	0	116978
9853	1009	54	436	121201	0	122700
9854	622	271	126614	1026	0	128533
9855	304	51	899	125737	0	126991
9856	334	286	128776	1084	0	130480
9857	263	129621	1000	758	0	131642
9858	379	846	458	130361	0	132044
9859	132319	413	204	1313	0	134249
9860	1185	112	152	133780	0	135229
9861	770	86	153	132376	0	133385
9862	131593	54	166	1672	0	133485
9863	1102	124494	294	744	0	126634
9864	665	127509	259	408	0	128841
9865	435	1217	139	128076	0	129867
9866	259	128662	326	1169	0	130416
9867	354	891	176	129796	0	131217
9868	372	509	144	130033	0	131058
9869	129531	159	135	1756	0	131581
9870	1061	129319	288	1038	0	131706
9871	848	1166	128985	430	0	131429
9872	384	132788	1041	422	0	134635
9873	131555	933	569	606	0	133663
9874	134363	496	249	583	0	135691
9875	1694	181	237	132631	0	134743
9876	134757	132	233	1503	0	136625
9877	1394	146	237	134345	0	136122
9878	133805	163	230	1586	0	135784
9879	135422	170	246	1099	0	136937
9880	1905	157	251	140403	0	142716
9881	142257	127	280	1754	0	144418
9882	1635	361	142271	854	0	145121
9883	139157	131	1233	776	0	141297
9884	1584	150	707	143424	0	145865
9885	145102	153	346	1656	0	147257
9886	1572	148107	444	892	0	151015
9887	1161	1097	257	149037	0	151552
9888	713	583	341	150612	0	152249
9889	148266	212	340	2281	0	151099
9890	1616	508	149699	1085	0	152908
9891	1032	148922	1347	633	0	151934
9892	746	1213	646	150483	0	153088
9893	519	151593	472	1523	0	154107
9894	688	1223	264	154009	0	156184
9895	720	678	278	152348	0	154024
9896	734	309	265	154900	0	156208
9897	152354	321	254	2414	0	155343
9898	1556	339	239	149759	0	151893
9899	150627	345	230	2058	0	153260
9900	148530	284	296	1491	0	150601
9901	2067	277	275	149179	0	151798
9902	148745	250	387	1911	0	151293
9903	146514	267	337	1501	0	148619
9904	2105	561	148113	712	0	151491
9905	1159	313	1350	145108	0	147930
9906	149258	304	763	1920	0	152245
9907	1470	148155	637	1139	0	151401
9908	151129	1245	337	1031	0	153742
9909	151027	673	298	1003	0	153001
9910	2230	528	147538	638	0	150934
9911	1197	243	1317	142008	0	144765
9912	157338	209	822	2412	0	160781
9913	1982	231	389	162877	0	165479
9914	1348	252	310	170943	0	172853
9915	853	265	347	173273	0	174738
9916	825	204	293	183072	0	184394
9917	181353	203	372	3541	0	185469
9918	2720	559	186803	1628	0	191710
9919	1719	394	2400	191580	0	196093
9920	912	579	203446	2975	0	207912
9921	771	513	204029	1892	0	207205
9922	197536	229	4973	1333	0	204071
9923	4005	478	215426	895	0	220804
9924	2111	207466	3892	689	0	214158
9925	207785	3225	2536	933	0	214479
9926	210427	1853	611	830	0	213721
9927	5335	542	362	204946	0	211185
9928	2578	517	209762	3359	0	216216
9929	956	470	207654	2090	0	211170
9930	209403	203	5065	1134	0	215805
9931	3915	309	2349	219049	0	225622
9932	221310	203	731	3962	0	226206
9933	3970	227179	742	2369	0	234260
9934	229092	3457	512	1168	0	234229
9935	228190	2060	433	978	0	231661
9936	5711	225036	651	661	0	232059
9937	3069	3619	343	225237	0	232268
9938	223994	2128	411	4227	0	230760
9939	4397	871	224616	2462	0	232346
9940	2667	226087	4167	1026	0	233947
9941	1534	3760	2427	224247	0	231968
9942	225526	2218	933	4222	0	232899
9943	4125	227937	920	2693	0	235675
9944	231041	3870	599	1436	0	236946
9945	4897	2802	228135	729	0	236563
9946	220630	816	4144	1137	0	226727
9947	5074	848	231259	632	0	237813
9948	223506	496	4599	979	0	229580
9949	224774	432	2782	1066	0	229054
9950	6696	685	224304	858	0	232543
9951	3446	225205	4415	1070	0	234136
9952	1916	3867	2815	220198	0	228796
9953	1563	2678	227086	4387	0	235714
9954	1388	222450	4588	2986	0	231412
9955	1676	4052	2894	218681	0	227303
9956	1704	2609	1357	225329	0	230999
9957	1549	1270	221383	6452	0	230654
9958	1836	784	4709	215146	0	222475
9959	1734	683	3359	222424	0	228200
9960	1565	1017	219667	6641	0	228890
9961	1819	866	4960	210510	0	218155
9962	1506	217977	3792	4814	0	228089
9963	220161	4257	1804	3588	0	229810
9964	5491	2880	1767	215331	0	225469
9965	3791	220973	2117	4734	0	231615
9966	2890	4578	1755	208257	0	217480
9967	2319	226098	2115	4556	0	235088
9968	2884	5085	223387	3277	0	234633
9969	2223	227879	5369	1920	0	237391
9970	225810	5001	3699	1864	0	236374
9971	227213	3139	2129	1835	0	234316
9972	232323	1695	1888	2160	0	238066
9973	8302	1553	235124	1692	0	246671
9974	5010	1724	232493	1650	0	240877
9975	2970	241411	8124	1612	0	254117
9976	3062	5861	4195	227447	0	240565
9977	2664	248743	2348	5488	0	259243
9978	3359	6688	1866	216064	0	227977
9979	2644	248348	2023	5358	0	258373
9980	247888	6565	1720	4041	0	260214
9981	264426	4145	1873	2389	0	272833
9982	10291	2352	1739	267805	0	282187
9983	6101	2026	266387	7304	0	281818
9984	256017	1872	7245	5107	0	270241
9985	8246	269444	5059	2702	0	285451
9986	6099	7155	2801	263910	0	279965
9987	4136	4832	2142	255302	0	266412
9988	3173	268351	2521	9483	0	283528
9989	269657	7445	2251	5432	0	284785
9990	8594	5427	267172	2510	0	283703
9991	6239	2875	7351	266452	0	282917
9992	268437	2151	5112	7820	0	283520
9993	267428	2230	2787	5467	0	277912
9994	11087	267840	2722	3036	0	284685
9995	6748	7537	2474	256747	0	273506
9996	3468	272362	2711	7467	0	286008
9997	275958	8175	2444	5708	0	292285
9998	8525	5634	275323	3326	0	292808
9999	5819	3683	275384	2619	0	287505
10000	3857	2657	10489	271637	0	288640
10001	3059	2529	5864	269157	0	280609
10002	2839	274809	3460	10707	0	291815
10003	2880	8000	2553	276022	0	289455
10004	2736	5560	273180	9109	0	290585
10005	266018	3041	8028	6255	0	283342
10006	8329	2690	4985	276761	0	292765
10007	5446	3125	274489	8742	0	291802
10008	3755	2538	7710	275861	0	289864
10009	2909	2601	5375	268931	0	279816
10010	2423	275555	3545	11163	0	292686
10011	3144	7829	2414	276767	0	290154
10012	2895	5258	2348	269972	0	280473
10013	3328	3041	2160	268723	0	277252
10014	248083	2107	1870	11925	0	263985
10015	7612	243959	2312	6515	0	260398
10016	5014	242706	2002	3507	0	253229
10017	232395	8410	1668	2995	0	245468
10018	220988	4419	1769	2593	0	229769
10019	8212	216948	1940	2163	0	229263
10020	3840	209895	1425	1804	0	216964
10021	195684	6470	1083	1736	0	204973
10022	4783	196290	1035	1701	0	203809
10023	2972	200563	1081	1637	0	206253
10024	196441	6486	1542	1782	0	206251
10025	4822	199077	1148	1632	0	206679
10026	198113	5299	1098	1796	0	206306
10027	197640	3165	1055	1738	0	203598
10028	197241	2008	1074	1611	0	201934
10029	7069	197537	1162	1765	0	207533
10030	3688	198829	1049	1781	0	205347
10031	2494	6741	701	190173	0	200109
10032	1793	196022	892	4793	0	203500
10033	2104	5618	766	198714	0	207202
10034	200274	3423	919	6086	0	210702
10035	5650	2144	867	197422	0	206083
10036	3532	195215	1136	6160	0	206043
10037	192553	5302	946	3967	0	202768
10038	5474	192391	1023	2488	0	201376
10039	3642	198716	880	2163	0	205401
10040	2649	8101	686	187176	0	198612
10041	1724	194643	1049	5203	0	202619
10042	191748	5906	1092	3569	0	202315
10043	5499	3882	187598	2089	0	199068
10044	3406	186393	4899	2162	0	196860
10045	2327	5290	2734	188699	0	199050
10046	2044	3917	187301	5735	0	198997
10047	2145	2231	4618	184406	0	193400
10048	2027	1807	2932	189528	0	196294
10049	2047	1878	1521	191193	0	196639
10050	2025	1889	1177	189359	0	194450
10051	2024	1841	183517	8293	0	195675
10052	1512	181309	5157	5115	0	193093
10053	180292	5380	2965	3487	0	192124
10054	5324	3953	177910	2792	0	189979
10055	176667	2349	4735	2848	0	186599
10056	5971	2216	180355	2501	0	191043
10057	4094	1965	5311	178803	0	190173
10058	2789	2157	179318	5675	0	189939
10059	2289	2249	182794	3909	0	191241
10060	2255	2097	6926	180062	0	191340
10061	2361	1990	3704	177603	0	185658
10062	2206	1980	1817	188046	0	194049
10063	2032	2087	1374	187466	0	192959
10064	181917	2032	1373	8740	0	194062
10065	5531	2190	182414	5143	0	195278
10066	183508	1949	4609	3802	0	193868
10067	185980	1996	2848	3191	0	194015
10068	186313	2004	1524	2891	0	192732
10069	185625	2084	1010	2723	0	191442
10070	186686	2058	906	2449	0	192099
10071	9477	1961	773	178086	0	190297
10072	5117	2043	168778	5491	0	181429
10073	2993	1873	162357	3476	0	170699
10074	2390	165256	5459	2358	0	175463
10075	157139	4658	3391	1872	0	167060
10076	4552	3472	1412	153346	0	162782
10077	3206	3361	1089	148916	0	156572
10078	1982	150267	1085	5511	0	158845
10079	1719	150323	985	3356	0	156383
10080	1719	149954	841	1916	0	154430
10081	129977	4871	668	1623	0	137139
10082	2726	2701	612	120822	0	126861
10083	1583	120622	502	2798	0	125505
10084	1077	2598	342	121894	0	125911
10085	883	1903	119580	2885	0	125251
10086	1138	1068	126128	1857	0	130191
10087	1315	812	3144	136651	0	141922
10088	142462	939	1502	3463	0	148366
10089	149968	886	551	2253	0	153658
10090	150796	894	522	1277	0	153489
10091	5341	1180	148198	1094	0	155813
10092	2846	1041	3230	146350	0	153467
10093	1507	991	2015	153422	0	157935
10094	1391	1210	147663	5029	0	155293
10095	136762	957	3504	3011	0	144234
10096	4035	1114	150308	1660	0	157117
10097	2208	899	147431	1217	0	151755
10098	1172	814	150290	1223	0	153499
10099	1119	675	4909	142814	0	149517
10100	1009	620	2415	147958	0	152002
10101	849	781	151043	5110	0	157783
10102	891	688	3648	152020	0	157247
10103	153338	469	2455	4473	0	160735
10104	3685	440	1272	158320	0	163717
10105	2285	645	158545	4517	0	165992
10106	1117	628	165302	2976	0	170023
10107	1126	547	5481	161570	0	168724
10108	170240	470	2944	4618	0	178272
10109	4407	178553	1753	2908	0	187621
10110	183384	4023	1321	1758	0	190486
10111	184719	2345	1406	1663	0	190133
10112	7089	849	186750	1618	0	196306
10113	3920	382	5025	185854	0	195181
10114	189102	429	3521	5846	0	198898
10115	185868	410	1811	4159	0	192248
10116	7073	187444	1843	2085	0	198445
10117	4078	3953	1732	188200	0	197963
10118	2107	2373	1583	195401	0	201464
10119	1783	859	190550	7578	0	200770
10120	1983	382	5170	189098	0	196633
10121	1862	618	191735	5953	0	200168
10122	2038	559	189760	3966	0	196323
10123	2046	384	6983	184062	0	193475
10124	183986	297	3819	5403	0	193505
10125	5197	179739	2225	3942	0	191103
10126	180999	3924	1702	2240	0	188865
10127	179959	2469	1644	2010	0	186082
10128	7016	177562	1741	1785	0	188104
10129	4141	3942	1336	165699	0	175118
10130	167739	2571	1239	4340	0	175889
10131	5195	168379	1378	2889	0	177841
10132	165678	3773	1098	1850	0	172399
10133	4818	161566	1321	1449	0	169154
10134	3284	3435	1157	155413	0	163289
10135	2238	2101	1035	160451	0	165825
10136	156663	958	947	5805	0	164373
10137	153827	868	1015	3485	0	159195
10138	5648	156051	1362	2247	0	165308
10139	3167	3301	153223	1998	0	161689
10140	1756	2077	152767	1992	0	158592
10141	1661	933	5605	145257	0	153456
10142	1389	154234	3485	4151	0	163259
10143	1688	3205	2113	157901	0	164907
10144	1765	2107	1772	157745	0	163389
10145	1906	965	1688	159893	0	164452
10146	1865	1098	155685	6045	0	164693
10147	1933	1133	153513	3582	0	160161
10148	1934	156809	5557	2233	0	166533
10149	2161	3573	3071	155284	0	164089
10150	2229	2529	1556	162983	0	169297
10151	2099	1644	159006	5935	0	168684
10152	138362	1353	4187	4014	0	147916
10153	4909	1089	2930	161251	0	170179
10154	3480	1366	160558	4788	0	170192
10155	148578	1120	4228	4208	0	158134
10156	4668	159396	3137	2734	0	169935
10157	4032	3908	163205	2273	0	173418
10158	2751	2782	4200	162473	0	172206
10159	161736	1514	3312	5047	0	171609
10160	4669	1367	165304	3767	0	175107
10161	3490	1148	4793	164388	0	173819
10162	2217	1098	3498	168377	0	175190
10163	1984	1192	2137	179463	0	184776
10164	176899	1160	1840	7662	0	187561
10165	4830	173304	1966	5033	0	185133
10166	3631	4274	1786	175402	0	185093
10167	2108	3109	177518	5974	0	188709
10168	2065	1682	5062	170477	0	179286
10169	1882	170788	3739	5712	0	182121
10170	1730	182118	2295	4380	0	190523
10171	179049	6039	1722	3325	0	190135
10172	181092	3243	1841	2946	0	189122
10173	7333	1884	178441	2459	0	190117
10174	174163	1579	4860	2576	0	183178
10175	5672	178604	3589	2410	0	190275
10176	181288	4755	1859	2616	0	190518
10177	6119	3351	1578	179468	0	190516
10178	4412	2255	183814	5495	0	195976
10179	3048	1647	4981	183425	0	193101
10180	2506	1715	185050	6085	0	195356
10181	179004	1292	5585	4594	0	190475
10182	5351	1430	3648	183550	0	193979
10183	3592	190166	2205	6247	0	202210
10184	2640	5175	1476	193716	0	203007
10185	2363	3590	190764	6663	0	203380
10186	1837	185084	5127	4944	0	196992
10187	170167	4342	2962	3137	0	180608
10188	3914	167219	1825	2084	0	175042
10189	2317	164646	1554	1760	0	170277
10190	1787	5361	1166	155769	0	164083
10191	1115	162739	1189	3838	0	168881
10192	1556	3953	922	164101	0	170532
10193	1531	2732	161844	4094	0	170201
10194	146534	1356	3403	2792	0	154085
10195	159060	1105	2206	1677	0	164048
10196	5179	1269	156793	1309	0	164550
10197	148605	1010	3225	1401	0	154241
10198	3770	153082	2382	1360	0	160594
10199	154902	3156	1163	1458	0	160679
10200	4001	2139	948	151707	0	158795
10201	2463	1240	151698	3632	0	159033
10202	1295	154513	3251	2484	0	161543
10203	1494	3139	2085	152126	0	158844
10204	1099	1846	892	153848	0	157685
10205	146093	920	702	4744	0	152459
10206	139259	699	724	2658	0	143340
10207	3850	138551	891	1316	0	144608
10208	1561	129098	560	790	0	132009
10209	577	124776	409	535	0	126297
10210	1106	2223	585	120344	0	124258
10211	119163	878	524	1898	0	122463
10212	116765	378	237	1074	0	118454
10213	2165	313	193	115928	0	118599
10214	1025	285	173	116352	0	117835
10215	114331	276	247	2302	0	117156
10216	1710	308	214	116331	0	118563
10217	892	504	115394	1712	0	118502
10218	112153	300	1400	1202	0	115055
10219	115771	325	662	743	0	117501
10220	2235	522	116471	438	0	119666
10221	117490	297	1393	662	0	119842
10222	1930	369	706	121145	0	124150
10223	1078	343	343	122216	0	123980
10224	536	345	311	123821	0	125013
10225	119525	327	299	2579	0	122730
10226	1658	123905	394	1213	0	127170
10227	1091	1616	300	123260	0	126267
10228	599	122242	429	1659	0	124929
10229	122106	1685	292	1190	0	125273
10230	1896	890	309	123276	0	126371
10231	1173	467	320	125644	0	127604
10232	689	124618	381	2466	0	128154
10233	722	1979	121789	1176	0	125666
10234	707	961	1628	123714	0	127010
10235	124420	484	868	2177	0	127949
10236	137918	412	464	1402	0	140196
10237	3513	570	142621	687	0	147391
10238	1734	381	2692	142387	0	147194
10239	708	148091	1480	2820	0	153099
10240	731	2947	464	151688	0	155830
10241	150471	1491	358	3570	0	155890
10242	151711	609	398	1937	0	154655
10243	4431	512	363	147823	0	153129
10244	1905	147138	522	3144	0	152709
10245	155744	2990	254	1964	0	160952
10246	3468	1645	283	159028	0	164424
10247	158555	722	289	3804	0	163370
10248	165177	551	299	2367	0	168394
10249	4877	487	280	165122	0	170766
10250	2260	431	313	166432	0	169436
10251	1203	376	308	168981	0	170868
10252	835	167236	464	5061	0	173596
10253	997	3287	283	170443	0	175010
10254	991	1669	340	171545	0	174545
10255	885	912	164686	5017	0	171500
10256	877	733	162329	2336	0	166275
10257	865	390	4412	161640	0	167307
10258	159679	399	1829	4061	0	165968
10259	3218	161015	874	2392	0	167499
10260	157471	3202	478	1439	0	162590
10261	3892	1862	157073	1082	0	163909
10262	2141	731	151313	1089	0	155274
10263	914	150473	4149	854	0	156390
10264	1449	2995	2034	148568	0	155046
10265	719	1599	148767	3035	0	154120
10266	757	734	152331	1697	0	155519
10267	794	603	3571	149026	0	153994
10268	149791	260	1504	3326	0	154881
10269	150311	257	530	2029	0	153127
10270	4014	299	321	147661	0	152295
10271	1855	721	156291	3119	0	161986
10272	1045	326	2629	158849	0	162849
10273	802	363	1415	153386	0	155966
10274	481	159141	794	3739	0	164155
10275	158776	2568	510	2148	0	164002
10276	158701	1350	420	1311	0	161782
10277	3812	160252	701	918	0	165683
10278	2033	2680	436	148368	0	153517
10279	824	155819	627	2695	0	159965
10280	155029	2760	573	1906	0	160268
10281	3063	1712	152262	935	0	157972
10282	1749	772	146417	828	0	149766
10283	825	679	146319	675	0	148498
10284	729	511	3731	142942	0	147913
10285	664	352	1707	145217	0	147940
10286	143159	337	708	3915	0	148119
10287	2720	337	511	143421	0	146989
10288	1813	351	484	146232	0	148880
10289	934	558	151043	3803	0	156338
10290	716	674	146910	1985	0	150285
10291	143451	321	3431	1410	0	148613
10292	2550	148938	1793	984	0	154265
10293	151875	2334	751	1151	0	156111
10294	3052	1325	561	151041	0	155979
10295	1933	543	543	150274	0	153293
10296	969	150048	777	3631	0	155425
10297	963	2451	536	151547	0	155497
10298	148942	1405	511	3377	0	154235
10299	2915	733	500	150186	0	154334
10300	1901	791	150497	3201	0	156390
10301	997	148151	2729	2087	0	153964
10302	145752	2458	1620	1412	0	151242
10303	148229	1404	797	1491	0	151921
10304	148521	706	616	1489	0	151332
10305	149789	575	568	1427	0	152359
10306	4198	484	564	147315	0	152561
10307	2291	533	538	149790	0	153152
10308	1398	710	147535	4174	0	153817
10309	1221	444	2542	148594	0	152801
10310	1119	867	148169	3575	0	153730
10311	1112	465	2712	148719	0	153008
10312	146717	539	1595	3805	0	152656
10313	2837	151167	1093	2382	0	157479
10314	2077	2473	744	152944	0	158238
10315	1262	1554	682	157475	0	160973
10316	153181	662	786	4585	0	159214
10317	150275	548	809	2802	0	154434
10318	3961	806	150463	1648	0	156878
10319	1921	151104	2911	1473	0	157409
10320	1211	2608	1760	148910	0	154489
10321	1114	1547	1041	151609	0	155311
10322	148320	660	1000	4369	0	154349
10323	147602	608	1347	2515	0	152072
10324	4169	852	148902	1282	0	155205
10325	2212	800	148255	1151	0	152418
10326	1366	558	3915	143733	0	149572
10327	1271	428	2029	148574	0	152302
10328	1057	758	146172	4215	0	152202
10329	139841	456	2984	2449	0	145730
10330	3300	393	1855	146782	0	152330
10331	144003	373	1070	3517	0	148963
10332	2897	142119	1088	2560	0	148664
10333	145661	2365	736	1826	0	150588
10334	3543	1674	156718	1307	0	163242
10335	2050	153437	2865	1356	0	159708
10336	800	143816	1403	773	0	146792
10337	135247	2067	1752	947	0	140013
10338	132216	846	390	860	0	134312
10339	2289	296	254	131137	0	133976
10340	1007	131508	444	1602	0	134561
10341	468	136138	449	1113	0	138168
10342	515	2150	220	138260	0	141145
10343	139078	957	262	1990	0	142287
10344	141878	334	276	1490	0	143978
10345	2374	454	133639	416	0	136883
10346	128179	192	1240	562	0	130173
10347	1487	143869	927	355	0	146638
10348	149277	1718	194	540	0	151729
10349	2480	179059	364	383	0	182286
10350	1204	192476	362	334	0	194376
10351	1193	5943	297	204167	0	211600
10352	218023	2402	371	5214	0	226010
10353	223613	797	156	2859	0	227425
10354	8043	659	217960	1032	0	227694
10355	4018	271	5237	218173	0	227699
10356	221678	216	2661	5877	0	230432
10357	6263	249	1016	224467	0	231995
10358	225712	229	504	6603	0	233048
10359	227508	273	394	3486	0	231661
10360	8559	496	224783	1514	0	235352
10361	4518	289	5293	220687	0	230787
10362	2213	305	2697	228185	0	233400
10363	1398	234	1056	231606	0	234294
10364	988	523	220812	9057	0	231380
10365	1031	305	5600	222002	0	228938
10366	967	429	2854	213199	0	217449
10367	571	215931	1437	8383	0	226322
10368	1125	5692	213457	4095	0	224369
10369	668	220219	5696	1965	0	228548
10370	217976	6434	2894	1338	0	228642
10371	6249	3309	1200	207460	0	218218
10372	3720	1579	707	199971	0	205977
10373	1797	206822	962	7961	0	217542
10374	205841	5851	692	4178	0	216562
10375	209801	3095	502	2343	0	215741
10376	8863	204729	895	1542	0	216029
10377	4424	210937	908	1639	0	217908
10378	209010	8061	559	1360	0	218990
10379	6937	4199	206536	1107	0	218779
10380	4201	2008	206208	1173	0	213590
10381	199665	1263	8227	1442	0	210597
10382	6227	206865	4177	1389	0	218658
10383	209281	5919	1806	1786	0	218792
10384	7314	3594	206465	1506	0	218879
10385	206516	1755	5826	1901	0	215998
10386	7393	216068	3638	1576	0	228675
10387	4784	6156	1619	217974	0	230533
10388	3250	3322	1227	222372	0	230171
10389	2748	1709	1131	212825	0	218413
10390	2667	1075	1115	217476	0	222333
10391	2364	1102	968	209097	0	213531
10392	2035	208875	1244	10525	0	222679
10393	209444	5965	961	6014	0	222384
10394	7167	3755	208104	3429	0	222455
10395	4816	1884	6038	210714	0	223452
10396	2809	1738	211883	7602	0	224032
10397	2387	1272	7229	211759	0	222647
10398	2220	1234	4067	216303	0	223824
10399	209653	1304	2348	10494	0	223799
10400	6977	1389	207857	5943	0	222166
10401	4205	206632	7012	3378	0	221227
10402	2977	6544	3961	207799	0	221281
10403	2675	4103	2063	215118	0	223959
10404	2273	2866	210806	9607	0	225552
10405	2554	1971	6506	210903	0	221934
10406	2493	1794	3671	217568	0	225526
10407	206501	1648	1877	10784	0	220810
10408	6711	210638	1590	6140	0	225079
10409	212624	6783	1173	3880	0	224460
10410	216180	4188	1066	2947	0	224381
10411	10610	2560	1137	210092	0	224399
10412	6048	2278	208074	7229	0	223629
10413	3625	2173	209245	4619	0	219662
10414	3087	1845	9133	204295	0	218360
10415	3165	1529	4925	198795	0	208414
10416	2407	205473	3278	9396	0	220554
10417	204992	6331	2207	5733	0	219263
10418	7267	203148	2431	3504	0	216350
10419	4874	209916	2027	3236	0	220053
10420	206310	9124	1533	3438	0	220405
10421	7953	4747	1479	203399	0	217578
10422	4906	211682	1922	8231	0	226741
10423	3277	7043	1406	215580	0	227306
10424	2217	4279	209104	9791	0	225391
10425	2196	2586	210795	6669	0	222246
10426	2437	1822	9093	211766	0	225118
10427	2131	1998	214174	8996	0	227299
10428	2508	1535	7976	212833	0	224852
10429	2346	1475	4759	215193	0	223773
10430	2320	1371	3067	220432	0	227190
10431	209056	1333	2341	12087	0	224817
10432	6638	203196	2553	7279	0	219666
10433	3999	211822	2262	4548	0	222631
10434	197729	8351	1679	3783	0	211542
10435	201736	4637	1445	3450	0	211268
10436	9443	2791	1459	197838	0	211531
10437	5046	2580	198581	7772	0	213979
10438	3362	1938	6288	200750	0	212338
10439	2555	2121	200332	8735	0	213743
10440	2065	198039	7392	5715	0	213211
10441	2674	6313	3879	198831	0	211697
10442	196347	3625	2348	7625	0	209945
10443	7468	2391	1810	197546	0	209215
10444	4388	2102	189927	7416	0	203833
10445	181782	1558	6627	4914	0	194881
10446	7494	1751	190210	3384	0	202839
10447	5007	1333	181340	2591	0	190271
10448	2218	170544	7338	2660	0	182760
10449	1070	138992	3012	1363	0	144437
10450	975	131509	2435	1200	0	136119
10451	108021	2683	3873	1808	0	116385
10452	100676	455	446	728	0	102305
10453	1042	192	156	102403	0	103793
10454	532	165	153	103803	0	104653
10455	305	177	117	105303	0	105902
10456	182	104747	253	1088	0	106270
10457	104538	679	158	778	0	106153
10458	687	104816	297	348	0	106148
10459	480	733	157	105430	0	106800
10460	102586	419	159	1106	0	104270
10461	821	187	164	102966	0	104138
10462	512	174	145	105255	0	106086
10463	104448	139	162	1440	0	106189
10464	102918	162	201	860	0	104141
10465	1143	368	103487	321	0	105319
10466	583	372	101661	274	0	102890
10467	348	386	105426	270	0	106430
10468	335	157	1169	104277	0	105938
10469	266	203	517	106451	0	107437
10470	157	106985	324	1246	0	108712
10471	110169	881	162	910	0	112122
10472	1038	504	150	111544	0	113236
10473	636	236	158	113586	0	114616
10474	293	112927	306	1542	0	115068
10475	243	119218	270	836	0	120567
10476	313	1397	151	122134	0	123995
10477	329	608	156	135152	0	136245
10478	134933	261	182	2564	0	137940
10479	134674	220	188	1317	0	136399
10480	2521	215	152	134979	0	137867
10481	1136	424	134845	1922	0	138327
10482	529	447	130275	1064	0	132315
10483	478	148	2295	132789	0	135710
10484	447	143	932	131419	0	132941
10485	267	130939	492	2582	0	134280
10486	124719	1599	242	1324	0	127884
10487	1853	831	221	124751	0	127656
10488	957	480	124382	1954	0	127773
10489	575	278	1640	125563	0	128056
10490	389	350	125493	2069	0	128301
10491	379	424	126215	1114	0	128132
10492	475	657	2393	126598	0	130123
10493	126628	234	1179	2212	0	130253
10494	1716	381	126179	1070	0	129346
10495	1016	173	1633	124035	0	126857
10496	459	462	135908	1909	0	138738
10497	461	183	1764	135246	0	137654
10498	467	144	898	137115	0	138624
10499	413	354	135626	2610	0	139003
10500	443	381	132547	1277	0	134648
10501	581	243	2442	123962	0	127228
10502	469	151	1070	136090	0	137780
10503	466	197	526	137149	0	138338
10504	441	179	381	135814	0	136815
10505	132950	171	364	3021	0	136506
10506	133922	209	335	1681	0	136147
10507	2337	133379	533	756	0	137005
10508	133987	1698	322	923	0	136930
10509	2026	822	377	134167	0	137392
10510	135726	250	439	2440	0	138855
10511	2062	365	136752	1288	0	140467
10512	138445	167	2131	954	0	141697
10513	2297	174	1155	142506	0	146132
10514	1337	184	534	149144	0	151199
10515	147352	168	474	3553	0	151547
10516	2518	187	465	160191	0	163361
10517	1290	489	164053	3205	0	169037
10518	160001	234	2952	2156	0	165343
10519	2875	166915	1746	1116	0	172652
10520	1741	2625	599	173742	0	178707
10521	743	1592	184813	3512	0	190660
10522	743	428	3412	182538	0	187121
10523	592	567	184637	4192	0	189988
10524	653	292	3712	184182	0	188839
10525	444	185254	2122	4192	0	192012
10526	877	3390	695	185589	0	190551
10527	606	193209	753	4268	0	198836
10528	1026	4077	560	183664	0	189327
10529	1019	1939	522	203183	0	206663
10530	901	562	550	205214	0	207227
10531	1066	299	611	205632	0	207608
10532	1022	296	629	206899	0	208846
10533	803	572	198833	6852	0	207060
10534	878	279	4203	200090	0	205450
10535	814	273	2451	202501	0	206039
10536	200310	304	1066	6923	0	208603
10537	4180	198959	971	3787	0	207897
10538	201525	4175	606	2002	0	208308
10539	5003	2232	621	201208	0	209064
10540	2798	996	199497	5382	0	208673
10541	947	199993	4799	3623	0	209362
10542	196856	4266	2715	2156	0	205993
10543	4303	198444	1498	1859	0	206104
10544	2322	204627	1166	1689	0	209804
10545	201318	6147	834	1826	0	210125
10546	4899	2768	781	212684	0	221132
10547	213024	877	786	6232	0	220919
10548	5576	610	762	209377	0	216325
10549	2906	841	209687	6444	0	219878
10550	1088	815	208154	4093	0	214150
10551	199906	548	7060	2526	0	210040
10552	212027	552	3258	2174	0	218011
10553	7433	516	1275	206247	0	215471
10554	3489	599	892	209579	0	214559
10555	199262	641	830	8471	0	209204
10556	5006	198789	988	4606	0	209389
10557	2914	205808	1030	2543	0	212295
10558	202672	6734	772	2171	0	212349
10559	204070	2992	844	1946	0	209852
10560	7469	203616	1102	1710	0	213897
10561	3901	5243	699	204299	0	214142
10562	1778	3121	202149	5883	0	212931
10563	1449	1469	201897	3631	0	208446
10564	194980	911	7124	2249	0	205264
10565	5795	1138	203252	1891	0	212076
10566	3742	901	5295	195923	0	205861
10567	1999	917	2777	193555	0	199248
10568	1360	197409	1632	7703	0	208104
10569	197903	5052	1108	4006	0	208069
10570	6174	2838	1003	196428	0	206443
10571	3579	1371	193145	6027	0	204122
10572	1777	193201	5293	4238	0	204509
10573	1868	5624	2816	191994	0	202302
10574	1556	2996	191120	5812	0	201484
10575	1710	1496	186452	3869	0	193527
10576	1242	182901	6851	2308	0	193302
10577	168709	4285	2918	1733	0	177645
10578	4361	172741	1320	1643	0	180065
10579	172201	4501	1015	1850	0	179567
10580	4727	2777	168648	1752	0	177904
10581	163996	1182	4264	1800	0	171242
10582	4523	169418	2820	1706	0	178467
10583	3129	4253	1227	169900	0	178509
10584	1670	2516	1128	175709	0	181023
10585	172586	1237	1141	6793	0	181757
10586	4593	1198	171805	3693	0	181289
10587	170237	1057	4390	2134	0	177818
10588	174319	1096	2547	2055	0	180017
10589	6387	1194	168101	1817	0	177499
10590	3165	1310	171691	1815	0	177981
10591	1998	1163	5963	167527	0	176651
10592	169939	1055	2841	5424	0	179259
10593	171245	1091	1417	3562	0	177315
10594	6270	172879	1517	2049	0	182715
10595	3545	4563	1026	175256	0	184390
10596	2273	2663	1082	169484	0	175502
10597	1912	1336	1108	172817	0	177173
10598	2080	1091	1082	175324	0	179577
10599	170080	1072	1254	7004	0	179410
10600	5582	1188	1118	172788	0	180676
10601	3430	1446	170169	5288	0	180333
10602	2072	1429	168279	3185	0	174965
10603	159822	1128	6317	2017	0	169284
10604	5326	165455	3217	1687	0	175685
10605	3502	172437	1800	1592	0	179331
10606	2381	6473	1376	171087	0	181317
10607	2246	3031	1260	175411	0	181948
10608	2070	1322	1311	175224	0	179927
10609	2160	1055	1261	178051	0	182527
10610	1812	1303	170954	7237	0	181306
10611	2271	920	4519	168190	0	175900
10612	2274	936	2776	167995	0	173981
10613	1648	1140	158739	6487	0	168014
10614	143937	790	4734	3594	0	153055
10615	4531	153945	3138	2108	0	163722
10616	143052	3437	1286	1701	0	149476
10617	4144	1997	139777	1427	0	147345
10618	2606	922	136977	1287	0	141792
10619	1272	135424	4728	1332	0	142756
10620	126934	4424	6634	1741	0	139733
10621	120722	1568	1332	1263	0	124885
10622	120840	644	669	1127	0	123280
10623	3692	117185	846	953	0	122676
10624	114598	2318	573	933	0	118422
10625	2844	1425	114509	861	0	119639
10626	1480	114159	2513	864	0	119016
10627	109405	2159	1459	924	0	113947
10628	2273	111563	786	748	0	115370
10629	108278	2029	525	733	0	111565
10630	105623	1042	521	731	0	107917
10631	2921	534	107620	565	0	111640
10632	1335	108399	2180	600	0	112514
10633	106660	1968	1162	665	0	110455
10634	2238	1137	107085	508	0	110968
10635	1216	107362	2080	684	0	111342
10636	792	1925	1023	105009	0	108749
10637	566	1041	104776	1783	0	108166
10638	545	568	102887	1031	0	105031
10639	630	457	2134	102371	0	105592
10640	101202	221	947	1858	0	104228
10641	1611	101187	531	1310	0	104639
10642	1054	1558	100319	430	0	103361
10643	820	950	98292	315	0	100377
10644	91531	378	1975	392	0	94276
10645	1478	99521	993	327	0	102319
10646	89638	869	427	327	0	91261
10647	906	90043	278	162	0	91389
10648	90979	899	456	336	0	92670
10649	87942	497	165	299	0	88903
10650	1357	86759	267	149	0	88532
10651	725	949	176	87762	0	89612
10652	92348	546	176	1225	0	94295
10653	1205	246	204	94094	0	95749
10654	791	207	202	98814	0	100014
10655	97529	164	222	1839	0	99754
10656	1258	97330	312	819	0	99719
10657	98868	1196	182	486	0	100732
10658	1446	802	98210	231	0	100689
10659	855	244	1247	98571	0	100917
10660	444	189	683	98249	0	99565
10661	97087	211	274	1902	0	99474
10662	97388	207	219	945	0	98759
10663	1894	234	186	96907	0	99221
10664	924	440	98521	1386	0	101271
10665	521	215	1254	98367	0	100357
10666	470	236	641	100680	0	102027
10667	450	206	262	101535	0	102453
10668	448	198	240	101679	0	102565
10669	99151	206	234	2189	0	101780
10670	1530	359	99422	967	0	102278
10671	892	99835	1437	476	0	102640
10672	568	1309	715	99208	0	101800
10673	516	742	262	104212	0	105732
10674	499	470	103193	2175	0	106337
10675	475	423	101546	1082	0	103526
10676	519	239	2086	103806	0	106650
10677	520	217	884	105402	0	107023
10678	544	382	102824	2453	0	106203
10679	565	271	1618	102653	0	105107
10680	103323	209	926	2137	0	106595
10681	1843	106161	499	1299	0	109802
10682	1212	1698	104555	662	0	108127
10683	534	105041	1733	573	0	107881
10684	616	1812	940	105140	0	108508
10685	588	1043	105312	1898	0	108841
10686	508	105106	1870	1370	0	108854
10687	533	1671	1028	105870	0	109102
10688	531	1116	107910	1925	0	111482
10689	584	391	1762	106771	0	109508
10690	584	285	1025	107809	0	109703
10691	107114	280	475	2938	0	110807
10692	2034	296	420	107574	0	110324
10693	107657	284	420	2369	0	110730
10694	102920	282	435	1579	0	105216
10695	103338	303	412	1010	0	105063
10696	2969	294	376	101440	0	105079
10697	1260	360	99174	2092	0	102886
10698	611	391	96861	1308	0	99171
10699	97871	205	2425	899	0	101400
10700	1906	375	101850	667	0	104798
10701	97151	186	1904	882	0	100123
10702	1794	100785	1296	699	0	104574
10703	102743	1545	579	783	0	105650
10704	2007	1028	103780	684	0	107499
10705	1221	485	107260	594	0	109560
10706	641	237	2523	108839	0	112240
10707	499	353	114239	2386	0	117477
10708	521	376	116779	1431	0	119107
10709	556	252	3174	119649	0	123631
10710	543	282	1448	127058	0	129331
10711	571	313	589	129699	0	131172
10712	383	129944	669	4240	0	135236
10713	672	2647	500	124089	0	127908
10714	404	133579	582	2958	0	137523
10715	132749	2813	481	1913	0	137956
10716	136230	1457	504	1048	0	139239
10717	4222	490	517	130535	0	135764
10718	1907	130853	648	3289	0	136697
10719	839	2877	132815	2026	0	138557
10720	132689	1457	3193	1121	0	138460
10721	3419	473	1848	133943	0	139683
10722	2115	307	771	135939	0	139132
10723	1047	338	591	138925	0	140901
10724	132890	372	618	5116	0	138996
10725	3293	128832	820	2445	0	135390
10726	1897	133682	832	1152	0	137563
10727	127954	4097	685	1001	0	133737
10728	3181	131194	824	955	0	136154
10729	132340	3283	702	1022	0	137347
10730	132218	1708	742	1083	0	135751
10731	4515	130399	901	1030	0	136845
10732	2279	3149	739	126992	0	133159
10733	853	130462	926	3628	0	135869
10734	883	3335	636	131141	0	135995
10735	903	1817	566	139189	0	142475
10736	138016	842	646	5627	0	145131
10737	142965	704	642	2955	0	147266
10738	5705	605	672	141574	0	148556
10739	2763	800	138042	4415	0	146020
10740	133333	631	3776	3009	0	140749
10741	3924	137577	2437	1782	0	145720
10742	2733	3653	1041	138930	0	146357
10743	1556	2258	740	142234	0	146788
10744	1275	1094	617	144294	0	147280
10745	135665	877	539	6642	0	143723
10746	136324	821	603	3614	0	141362
10747	5663	129908	806	1960	0	138337
10748	2977	134021	773	1462	0	139233
10749	1892	5187	586	133280	0	140945
10750	1560	2867	601	136413	0	141441
10751	1293	1388	133845	5827	0	142353
10752	1501	1167	3601	130673	0	136942
10753	1136	940	129034	4895	0	136005
10754	1173	818	123309	2918	0	128218
10755	1092	122506	4983	1849	0	130430
10756	1582	3663	2362	123380	0	130987
10757	124033	2220	897	4460	0	131610
10758	4390	1167	571	124137	0	130265
10759	2737	1106	121791	4531	0	130165
10760	119088	1015	3452	2899	0	126454
10761	122822	966	2059	1722	0	127569
10762	5802	1057	119738	1471	0	128068
10763	3350	881	3441	123535	0	131207
10764	121918	835	2041	4602	0	129396
10765	4411	123584	1118	3202	0	132315
10766	127036	3889	764	2191	0	133880
10767	130117	2409	717	1949	0	135192
10768	6236	1318	724	127320	0	135598
10769	3455	1025	669	132265	0	137414
10770	129303	940	758	6554	0	137555
10771	4976	867	722	131067	0	137632
10772	3054	1072	127900	5460	0	137486
10773	122083	893	3764	3407	0	130147
10774	124627	869	2203	2270	0	129969
10775	5619	121145	1175	1995	0	129934
10776	2951	125898	907	1896	0	131652
10777	1868	5405	721	119520	0	127514
10778	1343	125645	929	4477	0	132394
10779	1659	4414	755	126083	0	132911
10780	123653	2245	780	4931	0	131609
10781	121858	1153	815	3220	0	127046
10782	5534	120410	1032	1919	0	128895
10783	120222	3746	768	1750	0	126486
10784	4565	120941	1021	1580	0	128107
10785	121104	3914	855	1744	0	127617
10786	122132	2342	857	1777	0	127108
10787	5829	1316	117956	1689	0	126790
10788	116121	918	3558	1698	0	122295
10789	4779	114491	2341	1514	0	123125
10790	3058	119222	1223	1684	0	125187
10791	119466	4802	803	1537	0	126608
10792	4975	2499	643	119284	0	127401
10793	3291	1412	119219	4270	0	128192
10794	2423	1144	3485	120422	0	127474
10795	2115	997	2020	123732	0	128864
10796	1824	1124	119329	5824	0	128101
10797	112267	934	3568	3410	0	120179
10798	4697	117557	2162	2163	0	126579
10799	116923	3478	919	1829	0	123149
10800	5069	2167	743	112868	0	120847
10801	113459	1129	641	4171	0	119400
10802	4735	111523	764	2746	0	119768
10803	3363	3677	577	111581	0	119198
10804	110166	2061	614	4315	0	117156
10805	4412	1185	104106	2706	0	112409
10806	2568	975	96981	1652	0	102176
10807	90297	955	3992	1339	0	96583
10808	3734	91086	1930	1042	0	97792
10809	1942	83577	831	861	0	87211
10810	2466	3547	950	76580	0	83543
10811	1176	78712	539	2391	0	82818
10812	1298	2626	595	77710	0	82229
10813	1256	1339	528	81180	0	84303
10814	1138	731	633	79946	0	82448
10815	1147	77445	775	3191	0	82558
10816	1200	2124	541	76688	0	80553
10817	1204	1420	74338	2408	0	79370
10818	1115	73027	1827	2065	0	78034
10819	1174	2052	969	66860	0	71055
10820	985	70986	647	1861	0	74479
10821	70560	1906	601	1371	0	74438
10822	70777	1153	460	1049	0	73439
10823	71229	636	583	899	0	73347
10824	2970	71712	618	755	0	76055
10825	1863	1850	462	71294	0	75469
10826	1378	1357	70547	1820	0	75102
10827	1193	981	69580	1269	0	73023
10828	67036	1097	2301	1045	0	71479
10829	68819	700	1262	1000	0	71781
10830	2548	636	531	71666	0	75381
10831	1769	634	382	73558	0	76343
10832	1192	701	72972	2947	0	77812
10833	937	68883	1865	3941	0	75626
10834	1009	71336	1257	1086	0	74688
10835	921	1943	65714	725	0	69303
10836	826	1503	1591	61233	0	65153
10837	665	557	722	54693	0	56637
10838	639	472	278	62918	0	64307
10839	701	489	287	63014	0	64491
10840	62083	516	275	1755	0	64629
10841	1576	523	59875	897	0	62871
10842	59331	460	1104	556	0	61451
10843	1571	498	656	59793	0	62518
10844	60081	465	304	1418	0	62268
10845	1573	416	285	60341	0	62615
10846	996	498	60065	1407	0	62966
10847	692	474	1161	60517	0	62844
10848	592	451	61481	1465	0	63989
10849	546	421	1080	59464	0	61511
10850	525	417	61602	1372	0	63916
10851	426	61773	1045	966	0	64210
10852	435	1064	727	62106	0	64332
10853	484	683	283	61422	0	62872
10854	369	62957	355	1472	0	65153
10855	64074	1048	317	939	0	66378
10856	1244	694	267	63930	0	66135
10857	843	345	296	63964	0	65448
10858	64257	351	290	1771	0	66669
10859	65075	319	258	1051	0	66703
10860	66848	289	272	711	0	68120
10861	66985	290	269	695	0	68239
10862	1691	351	63602	563	0	66207
10863	62221	227	931	606	0	63985
10864	64674	204	660	538	0	66076
10865	1510	267	307	61281	0	63365
10866	836	242	214	60390	0	61682
10867	57967	156	199	1404	0	59726
10868	868	57410	279	798	0	59355
10869	555	696	131	55934	0	57316
10870	263	481	57773	866	0	59383
10871	156	57761	703	606	0	59226
10872	58025	686	514	427	0	59652
10873	58485	356	266	350	0	59457
10874	58517	138	108	305	0	59068
10875	59464	108	127	290	0	59989
10876	1045	121	108	57597	0	58871
10877	504	173	57264	772	0	58713
10878	261	168	60680	518	0	61627
10879	262	128	1142	63988	0	65520
10880	66964	65	541	1090	0	68660
10881	1133	69	146	67525	0	68873
10882	714	142	67321	1138	0	69315
10883	67046	88	1002	840	0	68976
10884	67765	72	609	376	0	68822
10885	1687	71	189	68640	0	70587
10886	832	151	70786	1109	0	72878
10887	379	142	72150	686	0	73357
10888	68616	70	1512	450	0	70648
10889	1126	71066	696	396	0	73284
10890	802	1015	72577	261	0	74655
10891	363	529	1043	72105	0	74040
10892	72572	114	684	1284	0	74654
10893	1135	70306	304	767	0	72512
10894	737	71755	248	307	0	73047
10895	71362	1454	169	403	0	73388
10896	1230	612	181	71123	0	73146
10897	76669	172	157	1380	0	78378
10898	1452	170	158	78044	0	79824
10899	881	149	196	78959	0	80185
10900	376	208	78159	1957	0	80700
10901	389	224	74429	946	0	75988
10902	423	248	78787	377	0	79835
10903	445	134	1958	77365	0	79902
10904	79230	82	912	1549	0	81773
10905	1594	224	79244	890	0	81952
10906	1085	114	1378	78918	0	81495
10907	522	234	80323	1560	0	82639
10908	370	81019	1572	1081	0	84042
10909	512	1286	936	82068	0	84802
10910	463	721	352	82934	0	84470
10911	415	185	350	83740	0	84690
10912	81991	164	368	2340	0	84863
10913	1617	160	346	82151	0	84274
10914	1074	181	305	82967	0	84527
10915	81935	168	304	2398	0	84805
10916	1648	294	81161	1131	0	84234
10917	80419	170	1469	572	0	82630
10918	81426	193	878	510	0	83007
10919	2261	285	80228	448	0	83222
10920	76599	191	1439	568	0	78797
10921	1776	165	902	81901	0	84744
10922	1147	203	83597	1564	0	86511
10923	82104	118	1482	1220	0	84924
10924	83884	115	972	664	0	85635
10925	2288	114	420	83088	0	85910
10926	1234	99	388	83807	0	85528
10927	634	95	390	84288	0	85407
10928	81592	96	401	2475	0	84564
10929	1623	82177	492	1238	0	85530
10930	79293	1075	344	744	0	81456
10931	1329	76238	485	492	0	78544
10932	840	76104	490	489	0	77923
10933	490	1607	382	77060	0	79539
10934	488	672	338	78124	0	79622
10935	493	198	304	77508	0	78503
10936	477	144	313	78109	0	79043
10937	448	257	75544	2039	0	78288
10938	72543	185	1272	1180	0	75180
10939	1474	217	818	76754	0	79263
10940	982	330	76719	1535	0	79566
10941	589	202	1287	76964	0	79042
10942	586	169	799	78307	0	79861
10943	554	310	80925	2056	0	83845
10944	559	210	1284	80905	0	82958
10945	566	165	866	81845	0	83442
10946	80873	127	401	2342	0	83743
10947	1496	246	82485	1188	0	85415
10948	78535	119	1324	824	0	80802
10949	1479	83526	1004	650	0	86659
10950	83247	1123	435	720	0	85525
10951	81281	690	383	744	0	83098
10952	2092	202	407	80706	0	83407
10953	1055	288	80258	1638	0	83239
10954	541	86299	1447	1159	0	89446
10955	633	1451	845	81426	0	84355
10956	386	90395	456	1596	0	92833
10957	89832	1535	378	1275	0	93020
10958	1762	947	88628	686	0	92023
10959	1087	407	87867	627	0	89988
10960	557	238	2159	87041	0	89995
10961	515	327	91227	1935	0	94004
10962	565	235	1652	91882	0	94334
10963	553	250	932	91982	0	93717
10964	93041	166	376	2899	0	96482
10965	1768	93397	495	1495	0	97155
10966	1154	1564	390	95173	0	98281
10967	597	794	426	97495	0	99312
10968	539	242	425	95681	0	96887
10969	497	93987	531	2695	0	97710
10970	444	95637	554	1402	0	98037
10971	93492	2147	461	891	0	96991
10972	94170	864	386	850	0	96270
10973	93809	270	358	775	0	95212
10974	2530	412	91992	611	0	95545
10975	1297	517	1587	90837	0	94238
10976	586	402	91646	1988	0	94622
10977	497	90756	1723	1370	0	94346
10978	86794	1521	982	751	0	90048
10979	1597	805	84958	540	0	87900
10980	1042	334	1312	82100	0	84788
10981	489	284	84314	1459	0	86546
10982	80883	168	1419	1087	0	83557
10983	85395	165	760	704	0	87024
10984	86053	172	360	602	0	87187
10985	84287	173	341	596	0	85397
10986	1870	316	86236	526	0	88948
10987	83521	222	1188	561	0	85492
10988	85799	196	686	533	0	87214
10989	1761	85273	404	410	0	87848
10990	84685	1105	281	540	0	86611
10991	86195	624	242	551	0	87612
10992	1879	246	322	82636	0	85083
10993	893	87964	308	1238	0	90403
10994	92146	1189	234	999	0	94568
10995	99155	695	268	579	0	100697
10996	2484	430	108843	524	0	112281
10997	1063	271	108164	321	0	109819
10998	469	268	110881	303	0	111921
10999	441	329	3165	108145	0	112080
11000	108683	172	1420	2240	0	112515
11001	2107	109210	616	1404	0	113337
11002	108226	1964	338	659	0	111187
11003	2300	109271	386	396	0	112353
11004	107576	2170	265	442	0	110453
11005	2314	106880	328	331	0	109853
11006	1369	109092	334	313	0	111108
11007	104691	2894	222	418	0	108225
11008	2109	108120	351	254	0	110834
11009	1395	2181	215	107384	0	111175
11010	710	1286	108858	1964	0	112818
11011	523	611	109782	1090	0	112006
11012	580	334	2872	108245	0	112031
11013	553	256	1334	112158	0	114301
11014	449	419	111013	3016	0	114897
11015	543	257	2116	109473	0	112389
11016	569	217	1215	112039	0	114040
11017	110523	250	554	3205	0	114532
11018	2201	110815	525	1720	0	115261
11019	1497	2127	464	103941	0	108029
11020	652	111761	573	2003	0	114989
11021	109363	2297	457	1446	0	113563
11022	2315	110706	551	611	0	114183
11023	111184	2387	347	592	0	114510
11024	111803	1354	339	528	0	114024
11025	3516	670	263	109563	0	114012
11026	1901	529	347	111040	0	113817
11027	1017	554	379	112199	0	114149
11028	836	561	413	112630	0	114440
11029	675	643	107673	3439	0	112430
11030	98605	507	2157	1905	0	103174
11031	2413	106961	1350	869	0	111593
11032	1690	2256	639	109231	0	113816
11033	962	1334	570	109116	0	111982
11034	664	109542	718	3274	0	114198
11035	109090	2345	608	1823	0	113866
11036	2474	111176	694	950	0	115294
11037	1736	2616	470	111210	0	116032
11038	1068	1518	434	114354	0	117374
11039	982	802	376	115234	0	117394
11040	962	708	356	115327	0	117353
11041	111561	665	410	3888	0	116524
11042	2879	789	111899	1845	0	117412
11043	1856	651	2426	109044	0	113977
11044	1060	645	1602	110742	0	114049
11045	1000	605	933	111680	0	114218
11046	1023	568	720	111272	0	113583
11047	105598	495	573	4272	0	110938
11048	2906	723	106211	2249	0	112089
11049	1942	885	2291	100379	0	105497
11050	1030	99842	1423	2780	0	105075
11051	823	105438	732	1873	0	108866
11052	103187	3336	449	1267	0	108239
11053	2771	2076	102860	824	0	108531
11054	93865	1065	1939	852	0	97721
11055	2743	949	97008	808	0	101508
11056	1561	626	1952	92349	0	96488
11057	93996	539	1230	2561	0	98326
11058	1921	95314	906	1920	0	100061
11059	1452	1920	773	89511	0	93656
11060	753	91497	807	2253	0	95310
11061	93523	2023	607	1919	0	98072
11062	93845	1204	553	1471	0	97073
11063	3007	659	451	93694	0	97811
11064	1712	673	91338	2690	0	96413
11065	1035	778	91209	1906	0	94928
11066	899	815	2523	89365	0	93602
11067	710	90466	1396	2343	0	94915
11068	816	2347	536	95361	0	99060
11069	933	1582	266	91975	0	94756
11070	954	966	271	93006	0	95197
11071	878	834	92054	3557	0	97323
11072	918	572	1878	92059	0	95427
11073	727	517	1209	92779	0	95232
11074	461	90577	833	4046	0	95917
11075	599	2168	526	88835	0	92128
11076	570	1154	535	96322	0	98581
11077	608	529	619	97823	0	99579
11078	712	380	546	97830	0	99468
11079	650	479	458	96719	0	98306
11080	656	551	367	96819	0	98393
11081	626	631	323	95502	0	97082
11082	640	756	339	94004	0	95739
11083	763	868	86976	4882	0	93489
11084	855	732	1711	90057	0	93355
11085	88169	504	1092	3105	0	92870
11086	2361	440	540	86575	0	89916
11087	1575	507	85965	3051	0	91098
11088	83083	419	1987	2297	0	87786
11089	88432	425	1234	1600	0	91691
11090	88625	450	696	1399	0	91170
11091	89027	390	465	1518	0	91400
11092	3431	362	397	88137	0	92327
11093	1723	412	85233	2926	0	90294
11094	832	80814	1861	2073	0	85580
11095	499	74117	1110	1207	0	76933
11096	1195	1526	2179	61452	0	66352
11097	209	415	508	65341	0	66473
11098	188	137	86	65216	0	65627
11099	163	90	65	67880	0	68198
11100	133	101	82	75679	0	75995
11101	78847	85	65	2018	0	81015
11102	1393	79219	169	980	0	81761
11103	776	81746	144	491	0	83157
11104	344	2442	127	82880	0	85793
11105	213	903	110	85324	0	86550
11106	220	218	95	85649	0	86182
11107	256	121	74	85709	0	86160
11108	214	206	80294	2852	0	83566
11109	123	79061	1679	1414	0	82277
11110	254	1578	770	78647	0	81249
11111	76643	809	196	1946	0	79594
11112	1640	262	105	78015	0	80022
11113	917	239	77149	1993	0	80298
11114	312	237	74712	1185	0	76446
11115	224	248	78198	589	0	79259
11116	263	222	2363	75892	0	78740
11117	78902	126	1117	2034	0	82179
11118	1662	130	282	80276	0	82350
11119	942	156	180	83776	0	85054
11120	81781	124	200	2838	0	84943
11121	1818	117	199	84192	0	86326
11122	1074	119	190	85477	0	86860
11123	464	252	88145	2766	0	91627
11124	248	88806	1841	1487	0	92382
11125	333	1770	941	92173	0	95217
11126	91072	899	319	2368	0	94658
11127	1960	267	208	93043	0	95478
11128	1131	344	92772	2403	0	96650
11129	505	263	1791	92761	0	95320
11130	259	93515	1158	2369	0	97301
11131	402	1857	313	96242	0	98814
11132	298	1184	93957	2484	0	97923
11133	255	100877	2012	1648	0	104792
11134	368	2400	1062	102582	0	106412
11135	362	1276	428	111799	0	113865
11136	300	416	309	113804	0	114829
11137	356	267	291	114569	0	115483
11138	270	327	109736	4457	0	114790
11139	227	109747	2596	2290	0	114860
11140	110385	2474	1455	1212	0	115526
11141	112478	1405	540	995	0	115418
11142	3818	446	336	111222	0	115822
11143	1778	379	109693	3070	0	114920
11144	106236	272	2605	2171	0	111284
11145	2725	223	1608	111469	0	116025
11146	1628	394	113882	3174	0	119078
11147	779	209	2646	115168	0	118802
11148	621	228	1552	115933	0	118334
11149	539	226	573	118169	0	119507
11150	523	508	119009	4637	0	124677
11151	696	323	2684	112498	0	116201
11152	450	119609	1735	3335	0	125129
11153	120734	2534	658	2272	0	126198
11154	122032	1547	460	1428	0	125467
11155	122886	566	495	1278	0	125225
11156	4112	120440	573	1087	0	126212
11157	121220	2612	397	1313	0	125542
11158	3100	1530	424	118821	0	123875
11159	119120	552	536	3537	0	123745
11160	119403	459	513	2456	0	122831
11161	4087	587	116090	1455	0	122219
11162	1996	115485	2816	1193	0	121490
11163	115534	2601	1634	1243	0	121012
11164	3020	1563	697	116145	0	121425
11165	1866	756	115338	3324	0	121284
11166	898	115494	2825	2275	0	121492
11167	114104	2652	1662	1453	0	119871
11168	2975	1575	733	115487	0	120770
11169	1966	684	488	117623	0	120761
11170	1055	457	523	117666	0	119701
11171	781	115125	633	4751	0	121290
11172	839	2635	518	116486	0	120478
11173	711	115113	725	3617	0	120166
11174	847	2769	594	116939	0	121149
11175	787	1805	115140	3613	0	121345
11176	938	735	2725	116403	0	120801
11177	948	498	1723	118077	0	121246
11178	890	471	787	120386	0	122534
11179	796	666	115817	5083	0	122362
11180	933	460	2779	116379	0	120551
11181	937	453	1763	119629	0	122782
11182	861	545	832	121193	0	123431
11183	954	559	624	121084	0	123221
11184	944	542	567	122157	0	124210
11185	902	658	117416	5059	0	124035
11186	1032	549	2683	118105	0	122369
11187	1110	490	1723	118183	0	121506
11188	112815	508	803	4954	0	119080
11189	3009	110918	782	2990	0	117699
11190	2117	114905	724	1808	0	119554
11191	1317	3695	604	114183	0	119799
11192	1063	1881	650	112804	0	116398
11193	820	108980	786	4586	0	115172
11194	1086	2627	489	109706	0	113908
11195	812	109165	748	3763	0	114488
11196	1157	2710	555	108433	0	112855
11197	1054	1626	520	106268	0	109468
11198	770	884	101145	4121	0	106920
11199	658	98396	2375	2622	0	104051
11200	583	94439	1330	1445	0	97797
11201	83303	2304	762	1217	0	87586
11202	1509	85800	509	987	0	88805
11203	1185	1707	358	84771	0	88021
11204	681	1198	82224	2132	0	86235
11205	596	585	1418	82398	0	84997
11206	80624	464	966	2305	0	84359
11207	1577	582	82251	1732	0	86142
11208	1077	84125	1537	1163	0	87902
11209	848	1587	1027	74876	0	78338
11210	554	1036	461	87346	0	89397
11211	87317	491	444	2993	0	91245
11212	1536	440	407	88973	0	91356
11213	1136	424	309	89382	0	91251
11214	606	404	329	89754	0	91093
11215	486	455	308	89493	0	90742
11216	86017	358	323	3190	0	89888
11217	86185	409	308	2141	0	89043
11218	2186	361	295	86640	0	89482
11219	83702	350	306	2294	0	86652
11220	1582	376	302	83197	0	85457
11221	1006	448	80199	2256	0	83909
11222	563	476	77078	1728	0	79845
11223	577	810	1806	70600	0	73793
11224	341	72374	1014	1838	0	75567
11225	379	1214	331	72335	0	74259
11226	70862	758	249	1941	0	73810
11227	1165	411	247	72229	0	74052
11228	70095	289	244	1998	0	72626
11229	1340	366	205	70780	0	72691
11230	834	416	69959	1740	0	72949
11231	334	68457	1088	1292	0	71171
11232	258	70800	749	933	0	72740
11233	343	1544	252	62232	0	64371
11234	191	533	62904	1096	0	64724
11235	92	55151	345	421	0	56009
11236	272	374	289	54570	0	55505
11237	53872	147	85	551	0	54655
11238	285	206	55134	295	0	55920
11239	196	82	248	55456	0	55982
11240	127	80	136	58329	0	58672
11241	114	152	57953	547	0	58766
11242	107	167	54923	339	0	55536
11243	96	170	59043	208	0	59517
11244	105	140	532	58447	0	59224
11245	81	142	60956	432	0	61611
11246	55702	56	406	370	0	56534
11247	515	53	217	62330	0	63115
11248	368	178	73037	607	0	74190
11249	108	74565	599	573	0	75845
11250	139	601	72890	209	0	73839
11251	170	332	645	72522	0	73669
11252	75024	105	347	1022	0	76498
11253	690	64	119	76895	0	77768
11254	398	97	68	77689	0	78252
11255	82309	67	71	1244	0	83691
11256	852	56	67	84166	0	85141
11257	467	239	84822	1027	0	86555
11258	82688	71	930	710	0	84399
11259	929	85976	579	274	0	87758
11260	87125	887	145	271	0	88428
11261	1046	449	82	87238	0	88815
11262	559	229	86715	1011	0	88514
11263	258	211	88537	574	0	89580
11264	209	159	1385	87863	0	89616
11265	174	120	582	88029	0	88905
11266	160	199	88741	1364	0	90464
11267	138	214	85394	615	0	86361
11268	87468	72	1439	368	0	89347
11269	1067	79	617	89084	0	90847
11270	90150	53	216	1204	0	91623
11271	1153	103	138	89291	0	90685
11272	618	206	92286	1185	0	94295
11273	299	259	97892	685	0	99135
11274	281	70	1585	100145	0	102081
11275	215	52	685	103511	0	104463
11276	216	236	105561	1776	0	107789
11277	102862	69	1441	958	0	105330
11278	1587	75	698	109417	0	111777
11279	112768	57	260	1783	0	114868
11280	1755	125809	380	979	0	128923
11281	962	2060	207	128184	0	131413
11282	128845	927	183	2542	0	132497
11283	2376	394	130520	1261	0	134551
11284	1266	103	2344	131392	0	135105
11285	444	88	1212	132566	0	134310
11286	387	103	375	135891	0	136756
11287	343	305	132663	3573	0	136884
11288	418	144	2388	130304	0	133254
11289	260	132655	1401	2597	0	136913
11290	384	2170	444	135456	0	138454
11291	367	1228	133439	2676	0	137710
11292	345	376	134455	1454	0	136630
11293	459	144	3486	134653	0	138742
11294	451	140	1413	136756	0	138760
11295	417	117	514	138777	0	139825
11296	462	92	426	139561	0	140541
11297	136441	108	397	4097	0	141043
11298	136203	155	348	1855	0	138561
11299	3671	283	134529	806	0	139289
11300	1447	135963	2759	664	0	140833
11301	691	2378	1317	138453	0	142839
11302	145338	1119	495	3319	0	150271
11303	138764	345	522	2009	0	141640
11304	148020	184	456	1060	0	149720
11305	148638	162	476	1029	0	150305
11306	3873	418	145514	795	0	150600
11307	140568	189	2681	1083	0	144521
11308	2817	141988	1655	840	0	147300
11309	1630	2444	613	144228	0	148915
11310	698	1350	144728	3062	0	149838
11311	737	350	2786	142945	0	146818
11312	581	406	144296	3318	0	148601
11313	725	213	2927	143860	0	147725
11314	706	241	1552	147191	0	149690
11315	145554	185	690	4481	0	150910
11316	3058	206	562	147030	0	150856
11317	1648	458	146665	3508	0	152279
11318	884	265	2905	149775	0	153829
11319	148805	234	1663	3728	0	154430
11320	3176	252	771	150868	0	155067
11321	1807	488	149214	3578	0	155087
11322	723	147348	3145	2221	0	153437
11323	153078	2539	1644	1681	0	158942
11324	3311	1314	817	146402	0	151844
11325	1767	156193	903	3090	0	161953
11326	155666	2626	707	2111	0	161110
11327	3195	1523	155550	1313	0	161581
11328	1795	154012	3212	1315	0	160334
11329	1113	2683	1732	157064	0	162592
11330	858	1601	156382	3416	0	162257
11331	997	473	3062	152978	0	157510
11332	153411	312	1754	3876	0	159353
11333	3190	570	152944	2325	0	159029
11334	2073	344	3028	152092	0	157537
11335	1075	574	154173	3768	0	159590
11336	1126	360	3118	152418	0	157022
11337	1098	381	1708	156618	0	159805
11338	151820	323	894	4830	0	157867
11339	3092	152608	1002	2507	0	159209
11340	2029	2614	729	153308	0	158680
11341	151242	1253	775	3809	0	157079
11342	152000	479	760	2450	0	155689
11343	4165	471	720	149026	0	154382
11344	1827	147392	910	3467	0	153596
11345	851	152065	952	2192	0	156060
11346	1102	3500	851	147882	0	153335
11347	1056	1411	715	148499	0	151681
11348	135064	447	601	4261	0	140373
11349	2937	418	663	134721	0	138739
11350	1471	488	129783	3189	0	134931
11351	119704	310	2434	2242	0	124690
11352	2543	125729	1524	1317	0	131113
11353	126067	2124	623	1250	0	130064
11354	2901	1233	126971	1160	0	132265
11355	1447	129183	2432	958	0	134020
11356	130166	2283	1481	1061	0	134991
11357	130811	1071	784	1080	0	133746
11358	3384	646	129114	732	0	133876
11359	127104	444	2356	920	0	130824
11360	130852	306	1181	973	0	133312
11361	3238	129834	781	789	0	134642
11362	1695	2210	465	133337	0	137707
11363	969	1261	131116	2730	0	136076
11364	913	427	2498	135482	0	139320
11365	712	560	138417	3088	0	142777
11366	783	404	2651	136222	0	140060
11367	137777	330	1429	3248	0	142784
11368	2928	248	604	142369	0	146149
11369	1570	543	153903	3209	0	159225
11370	152021	263	3139	1927	0	157350
11371	3660	227	1574	157812	0	163273
11372	1798	491	153780	3535	0	159604
11373	142442	268	3223	2090	0	148023
11374	3646	359	1634	146277	0	151916
11375	1800	480	143666	3333	0	149279
11376	794	484	141207	1751	0	144236
11377	998	1394	3670	136584	0	142646
11378	691	507	141033	2986	0	145217
11379	543	135394	2867	1585	0	140389
11380	665	1995	1097	121768	0	125525
11381	122339	795	445	2119	0	125698
11382	1939	366	123344	1026	0	126675
11383	1024	292	121481	411	0	123208
11384	112588	108	2592	572	0	115860
11385	1895	245	122527	312	0	124979
11386	114531	89	2021	481	0	117122
11387	1953	224	121287	306	0	123770
11388	1086	145	1930	118367	0	121528
11389	452	262	122096	1813	0	124623
11390	468	123	1926	120280	0	122797
11391	350	278	124096	1944	0	126668
11392	385	267	121628	1002	0	123282
11393	110679	144	2550	618	0	113991
11394	1719	121320	1308	446	0	124793
11395	122800	1554	615	487	0	125456
11396	1883	123933	602	344	0	126762
11397	1272	1728	432	123913	0	127345
11398	617	917	464	127102	0	129100
11399	125539	252	472	2692	0	128955
11400	2002	187	425	125532	0	128146
11401	1137	325	124790	2062	0	128314
11402	116150	146	1928	1327	0	119551
11403	120062	146	1226	654	0	122088
11404	2701	148	569	119693	0	123111
11405	1298	304	120817	1963	0	124382
11406	699	207	1992	118849	0	121747
11407	458	120740	1332	2018	0	124548
11408	583	1669	569	121355	0	124176
11409	693	880	506	123624	0	125703
11410	510	487	120519	2763	0	124279
11411	105556	202	2073	1666	0	109497
11412	1873	118981	1377	826	0	123057
11413	118281	1675	659	888	0	121503
11414	1978	120165	797	640	0	123580
11415	1352	1857	583	116513	0	120305
11416	577	120470	690	2029	0	123766
11417	633	1984	116812	1338	0	120767
11418	738	1439	2057	111710	0	115944
11419	745	393	1331	115888	0	118357
11420	693	237	712	119334	0	120976
11421	115990	249	713	3085	0	120037
11422	2232	245	664	116606	0	119747
11423	112640	266	755	2498	0	116159
11424	113358	262	716	1657	0	115993
11425	110892	276	807	1096	0	113071
11426	3043	450	109926	855	0	114274
11427	1759	238	2298	110358	0	114653
11428	1003	307	1589	117019	0	119918
11429	887	287	1027	120268	0	122469
11430	123072	260	919	3734	0	127985
11431	2901	284	885	124289	0	128359
11432	1802	290	1044	127468	0	130604
11433	130444	315	987	4028	0	135774
11434	3235	328	972	134096	0	138631
11435	1955	499	135634	3425	0	141513
11436	1069	600	137169	2106	0	140944
11437	1085	405	4393	137356	0	143239
11438	136432	305	2151	3767	0	142655
11439	132612	290	1338	2180	0	136420
11440	4691	225	1021	134107	0	140044
11441	2195	454	133935	3529	0	140113
11442	1152	132287	3640	2188	0	139267
11443	1241	2822	2001	135335	0	141399
11444	1079	1437	1000	138146	0	141662
11445	1167	534	946	138698	0	141345
11446	136243	440	920	5016	0	142619
11447	3457	519	137186	2595	0	143757
11448	137626	413	3383	1477	0	142899
11449	3927	414	1865	134173	0	140379
11450	2167	138371	1142	3627	0	145307
11451	139772	2918	766	2414	0	145870
11452	138891	1577	667	1531	0	142666
11453	4863	800	144384	1268	0	151315
11454	2219	137869	3346	1477	0	144911
11455	1092	136468	1922	1281	0	140763
11456	134296	3803	860	1395	0	140354
11457	3557	1560	691	134945	0	140753
11458	2279	617	633	135877	0	139406
11459	1209	512	697	135600	0	138018
11460	980	128540	774	4883	0	135177
11461	847	134615	707	2501	0	138670
11462	130972	3763	506	1488	0	136729
11463	3555	1557	472	129959	0	135543
11464	1684	726	139520	3383	0	145313
11465	1142	533	3417	144805	0	149897
11466	849	586	158297	4441	0	164173
11467	915	550	158816	2366	0	162647
11468	995	616	158349	1178	0	161138
11469	467	139516	5669	748	0	146400
11470	1070	3673	3404	130081	0	138228
11471	484	138913	1186	3426	0	144009
11472	750	4076	702	129224	0	134752
11473	585	1887	513	141559	0	144544
11474	139439	816	377	5470	0	146102
11475	3832	437	351	141198	0	145818
11476	139867	377	321	4639	0	145204
11477	140844	336	333	2616	0	144129
11478	5438	337	335	133454	0	139564
11479	2499	134764	574	4002	0	141839
11480	1398	3483	359	132249	0	137489
11481	826	135682	444	4104	0	141056
11482	836	3899	324	135673	0	140732
11483	676	2068	134225	4530	0	141499
11484	741	886	3540	135050	0	140217
11485	711	529	1898	138809	0	141947
11486	131246	459	912	5894	0	138511
11487	3574	133206	779	3075	0	140634
11488	2293	3556	612	134223	0	140684
11489	1281	1941	536	132092	0	135850
11490	725	130868	852	5642	0	138087
11491	955	3792	519	132084	0	137350
11492	126136	2103	485	4986	0	133710
11493	130828	1055	503	2911	0	135297
11494	5261	128427	656	1738	0	136082
11495	2661	3750	438	128914	0	135763
11496	125064	1993	518	4523	0	132098
11497	3977	128055	647	2777	0	135456
11498	2587	3853	552	119590	0	126582
11499	1307	127407	712	4078	0	133504
11500	125631	4102	722	2757	0	133212
11501	4117	2375	124383	1606	0	132481
11502	2316	1274	124769	1442	0	129801
11503	1434	929	5274	123606	0	131243
11504	1043	821	125877	4487	0	132228
11505	1054	710	4480	123246	0	129490
11506	122425	788	2528	4846	0	130587
11507	4030	839	125525	3048	0	133442
11508	2552	835	3900	125335	0	132622
11509	1532	832	2161	129791	0	134316
11510	126590	815	1020	6414	0	134839
11511	3984	129231	881	3524	0	137620
11512	131048	3829	559	2308	0	137744
11513	130448	2283	552	1796	0	135079
11514	5696	126552	785	1833	0	134866
11515	3235	3867	598	128912	0	136612
11516	1700	2658	126341	4457	0	135156
11517	1434	1419	3652	125035	0	131540
11518	1037	127093	2208	4760	0	135098
11519	129416	4104	1108	3033	0	137661
11520	4019	2420	898	130790	0	138127
11521	2261	1547	132264	4977	0	141049
11522	1485	1109	3862	134087	0	140543
11523	1226	946	2245	138190	0	142607
11524	1222	1028	1175	139997	0	143422
11525	1210	880	827	140361	0	143278
11526	1210	871	868	137431	0	140380
11527	972	1011	130248	7108	0	139339
11528	1536	922	124642	3944	0	131044
11529	885	118240	4922	2458	0	126505
11530	815	120908	2408	1746	0	125877
11531	117676	4165	1187	1680	0	124708
11532	3622	2260	116750	1316	0	123948
11533	108659	1217	3542	1334	0	114752
11534	3501	881	108058	1145	0	113585
11535	1944	787	104470	1078	0	108279
11536	1154	732	3949	101318	0	107153
11537	104835	697	2197	3236	0	110965
11538	2890	628	1094	106321	0	110933
11539	1759	702	690	107945	0	111096
11540	1016	688	114285	4599	0	120588
11541	909	550	2620	116269	0	120348
11542	1003	406	1512	116962	0	119883
11543	1046	431	799	118019	0	120295
11544	1113	409	524	117659	0	119705
11545	1058	444	440	118325	0	120267
11546	112764	437	362	5071	0	118634
11547	2856	504	355	113426	0	117141
11548	1613	703	108971	3829	0	115116
11549	1063	671	2303	110459	0	114496
11550	776	655	109550	3521	0	114502
11551	778	734	2795	109691	0	113998
11552	594	583	111901	3698	0	116776
11553	586	568	2986	104620	0	108760
11554	573	356	1609	109562	0	112100
11555	520	565	107179	4008	0	112272
11556	95884	436	2569	2458	0	101347
11557	2476	548	107780	1499	0	112303
11558	1668	454	2814	107320	0	112256
11559	108419	284	1666	3155	0	113524
11560	2706	376	902	109453	0	113437
11561	1893	405	524	110781	0	113603
11562	1106	414	109295	3951	0	114766
11563	597	105584	2289	2559	0	111029
11564	343	93003	1036	1225	0	95607
11565	305	89508	656	838	0	91307
11566	1721	630	980	73044	0	76375
11567	74319	174	118	648	0	75259
11568	354	74	67	74874	0	75369
11569	202	80	55	75554	0	75891
11570	111	32	59	76268	0	76470
11571	84	27	65	75312	0	75488
11572	48	74101	116	702	0	74967
11573	130	331	56	75681	0	76198
11574	89	147	58	75496	0	75790
11575	42	74937	136	571	0	75686
11576	75814	307	51	408	0	76580
11577	357	161	60	75982	0	76560
11578	75468	61	61	577	0	76167
11579	74850	51	71	388	0	75360
11580	463	76312	142	194	0	77111
11581	265	336	91	81002	0	81694
11582	143	273	80090	456	0	80962
11583	141	193	78056	279	0	78669
11584	111	174	464	79258	0	80007
11585	81175	39	220	611	0	82045
11586	82887	44	116	470	0	83517
11587	527	73	80	83609	0	84289
11588	84096	38	103	646	0	84883
11589	417	83442	124	333	0	84316
11590	83556	356	77	321	0	84310
11591	428	88609	150	187	0	89374
11592	273	396	65	90948	0	91682
11593	175	216	68	91146	0	91605
11594	95	91654	139	575	0	92463
11595	91034	386	110	494	0	92024
11596	466	348	90175	263	0	91252
11597	286	104	374	89553	0	90317
11598	175	212	91512	501	0	92400
11599	158	87	413	90776	0	91434
11600	92442	67	231	692	0	93432
11601	458	72	136	92503	0	93169
11602	91945	65	90	737	0	92837
11603	91832	60	78	519	0	92489
11604	643	57	69	91855	0	92624
11605	353	194	90685	557	0	91789
11606	204	94299	441	385	0	95329
11607	184	391	217	92753	0	93545
11608	91050	213	122	734	0	92119
11609	520	281	92265	372	0	93438
11610	347	118	420	91872	0	92757
11611	252	117	220	91707	0	92296
11612	209	89	131	93000	0	93429
11613	92770	109	151	942	0	93972
11614	499	114	133	91896	0	92642
11615	312	76	137	93468	0	93993
11616	214	210	91609	757	0	92790
11617	262	97	454	91665	0	92478
11618	237	100	254	93712	0	94303
11619	229	88	135	95005	0	95457
11620	160	94132	174	890	0	95356
11621	230	395	96	91170	0	91891
11622	248	226	69	91425	0	91968
11623	87234	113	104	867	0	88318
11624	532	273	88791	409	0	90005
11625	366	214	84833	296	0	85709
11626	171	88001	612	361	0	89145
11627	242	459	302	90803	0	91806
11628	90551	236	187	790	0	91764
11629	524	114	112	89575	0	90325
11630	332	103	102	91197	0	91734
11631	206	92	96	91765	0	92159
11632	199	78	91	91027	0	91395
11633	186	77	80	91319	0	91662
11634	188	194	90209	826	0	91417
11635	189	63	431	90333	0	91016
11636	90101	75	237	888	0	91301
11637	456	88678	156	511	0	89801
11638	331	419	106	89603	0	90459
11639	199	245	88	89841	0	90373
11640	201	249	84057	855	0	85362
11641	217	105	458	81986	0	82766
11642	200	86	286	88540	0	89112
11643	88412	70	147	1194	0	89823
11644	650	91429	194	681	0	92954
11645	472	697	86	92916	0	94171
11646	268	384	106	94366	0	95124
11647	243	144	110	94574	0	95071
11648	214	225	95156	1379	0	96974
11649	195	192	91496	781	0	92664
11650	144	93597	1244	483	0	95468
11651	126	96319	565	443	0	97453
11652	175	1152	199	95142	0	96668
11653	115	85902	296	1170	0	87483
11654	208	1233	131	103011	0	104583
11655	179	622	92	116754	0	117647
11656	228	196	109	123291	0	123824
11657	196	161	114	135906	0	136377
11658	170	290	133764	3732	0	137956
11659	270	109	2138	135427	0	137944
11660	217	115	1414	137432	0	139178
11661	223	100	514	140778	0	141615
11662	133736	89	305	4664	0	138794
11663	2249	138109	384	2690	0	143432
11664	1758	2463	209	125954	0	130384
11665	528	139114	319	2677	0	142638
11666	132925	2819	181	2062	0	137987
11667	113818	1990	236	1358	0	117402
11668	3143	137148	258	895	0	141444
11669	1554	142761	244	695	0	145254
11670	893	4341	137092	588	0	142914
11671	460	143974	2547	593	0	147574
11672	518	3345	1616	139095	0	144574
11673	141594	2113	600	3032	0	147339
11674	2578	144618	423	2052	0	149671
11675	1817	3168	315	146920	0	152220
11676	773	2079	285	149419	0	152556
11677	497	881	326	153139	0	154843
11678	147176	587	243	5393	0	153399
11679	2903	684	147517	3020	0	154124
11680	141272	481	2704	1734	0	146191
11681	3206	144109	1873	1197	0	150385
11682	2222	3033	603	145689	0	151547
11683	989	2125	143726	3424	0	150264
11684	134115	917	2908	2566	0	140506
11685	3072	143927	1970	1175	0	150144
11686	2210	3171	718	140208	0	146307
11687	891	144539	585	3127	0	149142
11688	707	3523	463	145955	0	150648
11689	699	2242	402	149077	0	152420
11690	526	1261	144741	4991	0	151519
11691	517	938	139092	2977	0	143524
11692	616	761	4381	140092	0	145850
11693	472	783	143025	3910	0	148190
11694	577	593	3380	142248	0	146798
11695	638	502	2234	139980	0	143354
11696	627	546	1011	146556	0	148740
11697	142062	398	785	5903	0	149148
11698	3204	450	718	144704	0	149076
11699	2168	633	142086	4516	0	149403
11700	140089	513	3148	3326	0	147076
11701	3379	518	2134	144920	0	150951
11702	2463	540	992	147442	0	151437
11703	143210	587	694	5814	0	150305
11704	3347	147244	843	3436	0	154870
11705	2526	3184	663	150767	0	157140
11706	1361	2183	595	150205	0	154344
11707	145976	1023	605	6105	0	153709
11708	3394	1026	146933	3665	0	155018
11709	2563	797	3127	145676	0	152163
11710	1328	781	2277	147847	0	152233
11711	1032	827	1040	144578	0	147477
11712	760	144244	1002	6069	0	152075
11713	947	3150	832	146468	0	151397
11714	142754	2211	793	5015	0	150773
11715	3186	143654	921	3760	0	151521
11716	142428	3373	741	2505	0	149047
11717	3561	144823	890	2154	0	151428
11718	145353	3692	662	2181	0	151888
11719	4016	2613	142255	1907	0	150791
11720	2739	1473	141103	1856	0	147171
11721	139441	1038	4662	1912	0	147053
11722	3787	1138	146891	1789	0	153605
11723	2891	806	3722	145012	0	152431
11724	1782	803	2614	138201	0	143400
11725	1414	689	1384	150380	0	153867
11726	146648	706	1130	6295	0	154779
11727	3594	888	144791	3919	0	153192
11728	144625	664	3460	2646	0	151395
11729	3993	737	2407	157526	0	164663
11730	158664	657	1194	5230	0	165745
11731	4748	804	901	160081	0	166534
11732	164626	782	843	5518	0	171769
11733	5151	868	747	176805	0	183571
11734	3175	1008	179145	5846	0	189174
11735	179783	814	4254	4102	0	188953
11736	188212	746	2767	2530	0	194255
11737	7392	814	1309	187917	0	197432
11738	4025	866	1092	181603	0	187586
11739	1936	188403	1313	7113	0	198765
11740	181604	4290	1109	4404	0	191407
11741	5064	186884	1252	2577	0	195777
11742	179685	4576	1111	2347	0	187719
11743	5313	2787	182088	2022	0	192210
11744	3415	1366	181627	1938	0	188346
11745	1945	955	178683	1821	0	183404
11746	170627	737	6770	1859	0	179993
11747	5001	179686	3642	1652	0	189981
11748	3509	4075	1563	175701	0	184848
11749	173837	2410	1254	4965	0	182466
11750	4734	178826	1434	3706	0	188700
11751	3459	5719	1081	167033	0	177292
11752	1721	174331	1203	4714	0	181969
11753	1521	169385	1082	3332	0	175320
11754	1404	170063	884	1989	0	174340
11755	149862	4865	1426	1719	0	157872
11756	3497	150523	755	1360	0	156135
11757	1783	135064	627	975	0	138449
11758	988	136792	769	865	0	139414
11759	134917	3364	944	938	0	140163
11760	135712	1372	602	913	0	138599
11761	3872	745	131157	834	0	136608
11762	127954	422	2398	897	0	131671
11763	132271	421	1244	826	0	134762
11764	3631	462	563	130092	0	134748
11765	132824	423	474	2746	0	136467
11766	3027	567	129473	1477	0	134544
11767	1657	136456	2436	763	0	141312
11768	137151	2513	1250	827	0	141741
11769	3079	1412	550	139022	0	144063
11770	139993	583	396	2881	0	143853
11771	3178	708	131316	1548	0	136750
11772	135271	511	2291	745	0	138818
11773	3232	621	1237	138950	0	144040
11774	1728	662	138559	2719	0	143668
11775	749	133429	2707	1461	0	138346
11776	635	140878	1406	649	0	143568
11777	1088	3724	652	135519	0	140983
11778	812	1584	330	129794	0	132520
11779	524	138226	371	3127	0	142248
11780	138843	2563	267	1390	0	143063
11781	138926	1337	277	617	0	141157
11782	136818	499	252	516	0	138085
11783	3875	138436	335	575	0	143221
11784	1962	2582	220	127096	0	131860
11785	772	138746	400	2229	0	142147
11786	139072	2685	259	1297	0	143313
11787	137929	1316	262	740	0	140247
11788	3750	135575	436	466	0	140227
11789	138199	2568	262	532	0	141561
11790	3168	1323	280	137276	0	142047
11791	1812	522	340	138976	0	141650
11792	139360	449	404	3868	0	144081
11793	136984	510	376	1650	0	139520
11794	138545	472	361	782	0	140160
11795	4200	525	345	136328	0	141398
11796	2012	509	317	139389	0	142227
11797	948	740	136632	3815	0	142135
11798	986	652	2637	135681	0	139956
11799	991	698	1300	137016	0	140005
11800	1058	759	133875	3734	0	139426
11801	936	813	129636	1634	0	133019
11802	906	734	136355	735	0	138730
11803	1020	617	3894	133315	0	138846
11804	1062	879	131703	2903	0	136547
11805	1014	823	2780	130075	0	134692
11806	1070	808	1354	133833	0	137065
11807	1054	1004	131250	3898	0	137206
11808	997	1067	130789	1697	0	134550
11809	1129	833	3610	128109	0	133681
11810	968	1063	136912	3072	0	142015
11811	1070	1034	135846	1668	0	139618
11812	980	135444	3766	837	0	141027
11813	139353	3052	1539	878	0	144822
11814	141095	1803	622	763	0	144283
11815	141071	939	531	892	0	143433
11816	4378	137315	635	864	0	143192
11817	2313	141972	582	830	0	145697
11818	1460	3915	522	141330	0	147227
11819	1419	1692	612	142144	0	145867
11820	1204	941	138833	4226	0	145204
11821	1314	752	2925	138874	0	143865
11822	139324	643	1536	3614	0	145117
11823	3627	630	761	127815	0	132833
11824	2023	137588	890	3013	0	143514
11825	141349	2957	694	1809	0	146809
11826	143194	1546	675	1062	0	146477
11827	145142	655	639	1175	0	147611
11828	4817	646	139873	1014	0	146350
11829	2161	1033	2498	135572	0	141264
11830	140492	428	1705	3473	0	146098
11831	3626	556	144844	1918	0	150944
11832	1877	138259	3229	1040	0	144405
11833	802	131813	1547	708	0	134870
11834	121025	3234	1098	688	0	126045
11835	2484	121527	520	591	0	125122
11836	1473	2383	489	118004	0	122349
11837	708	1236	118483	2496	0	122923
11838	767	541	2277	117996	0	121581
11839	117613	351	1141	2690	0	121795
11840	2341	116667	546	1456	0	121010
11841	116318	2160	364	730	0	119572
11842	2513	1147	114887	660	0	119207
11843	1381	736	2269	109110	0	113496
11844	520	118125	1272	2184	0	122101
11845	683	2134	437	119918	0	123172
11846	121120	1016	430	2562	0	125128
11847	122510	344	387	1359	0	124600
11848	122858	336	370	715	0	124279
11849	123492	307	399	627	0	124825
11850	3376	283	386	118329	0	122374
11851	1469	524	120270	2537	0	124800
11852	871	425	2253	115280	0	118829
11853	577	119497	1297	2379	0	123750
11854	120822	2142	601	1346	0	124911
11855	2421	1164	119816	692	0	124093
11856	115771	363	2320	699	0	119153
11857	2499	337	1159	119089	0	123084
11858	1324	466	121515	2490	0	125795
11859	724	294	2282	121070	0	124370
11860	122599	291	1170	2783	0	126843
11861	123702	263	558	1465	0	125988
11862	123546	353	537	828	0	125264
11863	3262	541	121758	610	0	126171
11864	1605	541	2172	120341	0	124659
11865	815	525	125280	2353	0	128973
11866	706	123870	2366	1272	0	128214
11867	117922	2037	1174	821	0	121954
11868	2112	116500	642	590	0	119844
11869	112876	1693	530	548	0	115647
11870	2173	810	330	108680	0	111993
11871	996	111504	415	1572	0	114487
11872	112241	1667	319	1000	0	115227
11873	1970	867	112726	439	0	116002
11874	1010	393	1616	110356	0	113375
11875	111198	312	752	1939	0	114201
11876	1957	458	111258	922	0	114595
11877	1176	273	1635	107491	0	110575
11878	741	108018	903	1645	0	111307
11879	786	1699	361	112255	0	115101
11880	712	849	313	113666	0	115540
11881	108847	403	274	2446	0	111970
11882	1822	111357	402	1161	0	114742
11883	1096	1661	301	108465	0	111523
11884	586	111943	428	1700	0	114657
11885	712	1833	325	110561	0	113431
11886	604	113620	475	1706	0	116405
11887	112745	1752	341	1119	0	115957
11888	2090	1009	114885	550	0	118534
11889	1196	470	1749	114006	0	117421
11890	746	327	856	115970	0	117899
11891	755	350	409	116695	0	118209
11892	848	309	327	115235	0	116719
11893	809	486	112770	2504	0	116569
11894	725	113978	1801	1250	0	117754
11895	114208	1634	881	801	0	117524
11896	114767	797	425	807	0	116796
11897	2278	114281	424	720	0	117703
11898	115444	1685	355	677	0	118161
11899	115154	866	317	756	0	117093
11900	2366	117427	447	534	0	120774
11901	1341	1774	300	113467	0	116882
11902	728	119133	478	1497	0	121836
11903	117856	1792	345	1111	0	121104
11904	2011	1002	117181	612	0	120806
11905	108234	411	1727	855	0	111227
11906	2065	504	119357	658	0	122584
11907	1287	332	1772	118132	0	121523
11908	118995	329	860	2083	0	122267
11909	2144	488	117512	1068	0	121212
11910	109109	333	1728	834	0	112004
11911	113840	306	866	842	0	115854
11912	2553	366	458	111250	0	114627
11913	1141	113181	490	1647	0	116459
11914	114894	1718	283	1113	0	118008
11915	2071	998	258	113391	0	116718
11916	1141	111889	461	1847	0	115338
11917	112289	1733	289	1220	0	115531
11918	2006	899	304	112516	0	115725
11919	1049	117882	536	1814	0	121281
11920	702	1675	375	121316	0	124068
11921	122748	804	362	2197	0	126111
11922	122225	387	336	1302	0	124250
11923	123766	368	377	950	0	125461
11924	2576	370	369	120446	0	123761
11925	1254	470	313	121691	0	123728
11926	680	602	122436	2326	0	126044
11927	898	683	1626	122682	0	125889
11928	735	544	127131	2054	0	130464
11929	492	417	116393	910	0	118212
11930	335	273	114097	386	0	115091
11931	204	118762	1535	416	0	120917
11932	500	1144	1093	111148	0	113885
11933	202	127099	438	904	0	128643
11934	129031	1375	256	773	0	131435
11935	129654	688	240	490	0	131072
11936	2075	260	205	133962	0	136502
11937	965	376	137388	1670	0	140399
11938	484	199	1766	136787	0	139236
11939	388	411	141588	2082	0	144469
11940	458	274	1872	136942	0	139546
11941	300	140015	1040	1929	0	143284
11942	312	145142	384	1065	0	146903
11943	141823	2531	204	610	0	145168
11944	2038	1216	141301	342	0	144897
11945	1212	374	1862	138656	0	142104
11946	557	218	975	141724	0	143474
11947	141964	229	342	2978	0	145513
11948	1944	142936	392	1502	0	146774
11949	143147	1939	257	720	0	146063
11950	2079	145800	420	426	0	148725
11951	143543	1992	317	582	0	146434
11952	145497	1050	323	709	0	147579
11953	2983	419	299	146398	0	150099
11954	1389	481	146261	2151	0	150282
11955	139540	355	2072	1424	0	143391
11956	2215	148119	1250	539	0	152123
11957	150294	2127	416	599	0	153436
11958	2482	1169	285	145182	0	149118
11959	1475	439	297	144881	0	147092
11960	604	144902	458	3032	0	148996
11961	673	2037	301	142930	0	145941
11962	528	147010	494	2230	0	150262
11963	709	2225	260	145736	0	148930
11964	702	1174	304	144342	0	146522
11965	137819	444	293	3316	0	141872
11966	2361	570	139419	1476	0	143826
11967	1313	138655	2099	711	0	142778
11968	803	2088	1111	139797	0	143799
11969	142293	1144	476	2540	0	146453
11970	144410	468	378	1660	0	146916
11971	143791	402	404	1001	0	145598
11972	3433	614	141371	564	0	145982
11973	141480	430	2364	706	0	144980
11974	2817	461	1274	143277	0	147829
11975	142033	469	485	2797	0	145784
11976	2683	140172	519	1606	0	144980
11977	1795	2396	342	141676	0	146209
11978	140128	1309	369	2822	0	144628
11979	2765	143782	572	1576	0	148695
11980	1787	2609	372	145364	0	150132
11981	1007	1556	142227	2930	0	147720
11982	141709	683	2418	1873	0	146683
11983	151989	529	1255	1169	0	154942
11984	4344	680	149846	764	0	155634
11985	1990	145629	2754	830	0	151203
11986	974	152983	1575	776	0	156308
11987	1161	3770	711	151919	0	157561
11988	924	1760	514	148764	0	151962
11989	1014	741	443	153472	0	155670
11990	876	780	153804	4484	0	159944
11991	150549	642	2998	2335	0	156524
11992	163505	671	1519	1298	0	166993
11993	168039	605	635	1212	0	170491
11994	169487	664	529	1122	0	171802
11995	171726	674	534	1191	0	174125
11996	173436	612	612	1169	0	175829
11997	5713	607	660	177276	0	184256
11998	2788	903	174618	4079	0	182388
11999	1560	844	178781	2328	0	183513
12000	1521	704	5026	176875	0	184126
12001	1526	717	2002	176538	0	180783
12002	1525	699	787	174660	0	177671
12003	1340	177814	760	5606	0	185520
12004	178931	4002	559	2776	0	186268
12005	4610	185039	790	1512	0	191951
12006	2868	4317	654	182581	0	190420
12007	179724	2147	614	4874	0	187359
12008	4613	181605	722	2816	0	189756
12009	2939	4360	590	183968	0	191857
12010	1762	2308	523	189026	0	193619
12011	1525	1155	494	190488	0	193662
12012	1237	188706	764	6774	0	197481
12013	1625	4561	513	194483	0	201182
12014	1449	2541	192040	5754	0	201784
12015	1584	1181	4573	196218	0	203556
12016	1638	851	2117	201142	0	205748
12017	1721	891	791	214441	0	217844
12018	1803	918	594	218824	0	222139
12019	1610	1035	206751	8849	0	218245
12020	1489	206271	5400	4737	0	217897
12021	1736	5467	2769	207774	0	217746
12022	1651	2851	1275	216211	0	221988
12023	1700	1443	969	207674	0	211786
12024	1414	199897	1286	9363	0	211960
12025	1390	213732	1124	5258	0	221504
12026	207321	7568	830	3335	0	219054
12027	6277	3540	669	203248	0	213734
12028	3421	1941	199777	6993	0	212132
12029	1737	200158	5218	4764	0	211877
12030	195163	5647	2925	2988	0	206723
12031	5947	3228	192182	2445	0	203802
12032	3299	1870	189991	2434	0	197594
12033	1831	1360	189933	2195	0	195319
12034	1566	2641	7620	182958	0	194785
12035	1418	1271	186436	6364	0	195489
12036	1021	177283	6138	4384	0	188826
12037	1122	4676	3310	173494	0	182602
12038	1017	2803	176401	5977	0	186198
12039	1062	1823	5388	173953	0	182226
12040	170039	1275	3107	7038	0	181459
12041	4703	1362	171248	4714	0	182027
12042	165257	1178	5187	3628	0	175250
12043	5268	174672	3136	2970	0	186046
12044	176405	5172	1884	2729	0	186190
12045	6266	2942	1690	175179	0	186077
12046	177158	1731	1580	6537	0	187006
12047	178382	1382	1856	4259	0	185879
12048	173459	1688	1702	3066	0	179915
12049	7676	175628	1730	2420	0	187454
12050	177569	4867	1948	2480	0	186864
12051	178037	2662	2140	2515	0	185354
12052	7623	1888	173233	2349	0	185093
12053	4246	172404	5507	2510	0	184667
12054	3023	5194	3656	172278	0	184151
12055	2441	3309	2423	176547	0	184720
12056	2275	2078	2009	178711	0	185073
12057	1926	1767	172951	8423	0	185067
12058	2041	1509	5568	174179	0	183297
12059	2242	1558	174537	7432	0	185769
12060	169886	1400	6209	5026	0	182521
12061	177279	1344	3790	3756	0	186169
12062	7671	1844	174773	3105	0	187393
12063	174601	1551	5624	3081	0	184857
12064	180020	1322	3698	3063	0	188103
12065	182196	1350	2463	2840	0	188849
12066	9350	1351	2227	175242	0	188170
12067	5760	1547	176400	6187	0	189894
12068	3896	176852	5570	4370	0	190688
12069	3927	5077	3398	176836	0	189238
12070	3575	3241	179664	6122	0	192602
12071	2970	2221	173162	4257	0	182610
12072	166162	2016	6853	3542	0	178573
12073	5445	178137	4217	3451	0	191250
12074	180843	4764	2708	3632	0	191947
12075	180899	2918	2405	3482	0	189704
12076	7059	179668	2972	3133	0	192832
12077	180732	4706	2606	2931	0	190975
12078	6800	3156	182280	2744	0	194980
12079	5080	1890	179696	2481	0	189147
12080	4284	1674	179860	2265	0	188083
12081	3566	176237	7130	2171	0	189104
12082	175137	4174	4452	2067	0	185830
12083	174806	2484	3111	2222	0	182623
12084	7313	166674	2900	2322	0	179209
12085	4626	173366	2611	2422	0	183025
12086	3641	5374	2530	170762	0	182307
12087	3091	3642	2168	173629	0	182530
12088	172012	2352	2049	6366	0	182779
12089	5402	173035	2442	3831	0	184710
12090	170704	4399	2324	2826	0	180253
12091	166512	2761	2150	2338	0	173761
12092	6689	2331	162599	1949	0	173568
12093	4873	159476	4256	1660	0	170265
12094	4740	4288	2904	156445	0	168377
12095	155972	2724	2189	3402	0	164287
12096	6058	1807	2005	151593	0	161463
12097	147533	1346	2266	3550	0	154695
12098	4892	1618	143266	2167	0	151943
12099	3570	138223	4134	1866	0	147793
12100	2997	143954	2675	1639	0	151265
12101	3149	4742	2304	130059	0	140254
12102	2837	145049	1863	2668	0	152417
12103	144252	3947	1724	2202	0	152125
12104	3822	3093	140679	1709	0	149303
12105	132515	2176	2960	1954	0	139605
12106	4010	1932	141733	1818	0	149493
12107	3523	1608	3023	139931	0	148085
12108	3308	1667	2053	141759	0	148787
12109	3397	1396	1698	143464	0	149955
12110	140773	1200	1532	3972	0	147477
12111	4078	1169	139883	2454	0	147584
12112	2954	1177	2487	135280	0	141898
12113	2388	1098	1796	133425	0	138707
12114	2302	129420	1447	3545	0	136714
12115	2003	128240	1113	2730	0	134086
12116	2134	131264	1265	1827	0	136490
12117	1492	2431	718	118860	0	123501
12118	992	1055	532	113633	0	116212
12119	486	110222	362	983	0	112053
12120	496	111657	335	648	0	113136
12121	110077	759	515	748	0	112099
12122	847	627	266	109658	0	111398
12123	479	109184	234	535	0	110432
12124	110449	482	277	470	0	111678
12125	711	304	225	111628	0	112868
12126	119686	136	227	813	0	120862
12127	1009	194	222	121509	0	122934
12128	610	306	124446	997	0	126359
12129	280	125374	855	711	0	127220
12130	120997	769	445	625	0	122836
12131	957	549	126779	249	0	128534
12132	447	126823	795	250	0	128315
12133	303	643	323	127884	0	129153
12134	163	262	119	129231	0	129775
12135	181	135	67	127248	0	127631
12136	194	80	69	126708	0	127051
12137	167	223	126552	960	0	127902
12138	93	124797	665	551	0	126106
12139	164	674	274	124803	0	125915
12140	121165	290	122	878	0	122455
12141	578	124399	162	570	0	125709
12142	370	647	73	131986	0	133076
12143	411	470	128837	1028	0	130746
12144	120	129667	1027	638	0	131452
12145	569	1106	493	117632	0	119800
12146	130	133048	274	608	0	134060
12147	133278	1212	76	590	0	135156
12148	133401	558	69	451	0	134479
12149	1734	417	129168	153	0	131472
12150	126125	128	1098	438	0	127789
12151	131163	132	536	410	0	132241
12152	1819	282	126869	160	0	129130
12153	780	128965	1189	177	0	131111
12154	457	1201	556	128322	0	130536
12155	286	565	211	132457	0	133519
12156	132367	212	127	1914	0	134620
12157	1319	116	101	131976	0	133512
12158	697	274	132152	1328	0	134451
12159	125106	125	1245	915	0	127391
12160	1451	275	130018	362	0	132106
12161	690	130049	1366	378	0	132483
12162	126351	1212	634	400	0	128597
12163	1378	783	128675	217	0	131053
12164	833	410	123595	251	0	125089
12165	331	127841	1722	267	0	130161
12166	317	1295	709	129418	0	131739
12167	321	827	125770	1334	0	128252
12168	414	321	1410	110183	0	112328
12169	315	132	654	124022	0	125123
12170	262	287	120383	1911	0	122843
12171	200	119744	1444	954	0	122342
12172	258	1291	692	121337	0	123578
12173	119658	637	328	1612	0	122235
12174	118711	308	249	946	0	120214
12175	1948	231	201	119302	0	121682
12176	900	355	117841	1491	0	120587
12177	453	413	122359	785	0	124010
12178	439	224	1888	120746	0	123297
12179	357	356	119662	1565	0	121940
12180	114058	240	1574	977	0	116849
12181	1689	182	805	119851	0	122527
12182	983	233	416	120672	0	122304
12183	424	121633	464	2062	0	124583
12184	419	1631	276	124236	0	126562
12185	370	975	120410	1788	0	123543
12186	111767	397	1599	1245	0	115008
12187	120545	221	797	795	0	122358
12188	2268	349	121653	502	0	124772
12189	1135	257	1650	132132	0	135174
12190	643	228	881	137172	0	138924
12191	477	325	136563	3363	0	140728
12192	560	248	2405	137797	0	141010
12193	630	257	1260	136610	0	138757
12194	397	142055	749	3445	0	146646
12195	547	2528	451	144961	0	148487
12196	500	1233	422	147571	0	149726
12197	148221	501	447	4153	0	153322
12198	153169	325	492	2046	0	156032
12199	156333	269	376	1150	0	158128
12200	155036	280	450	971	0	156737
12201	153901	290	446	941	0	155578
12202	4400	450	146866	778	0	152494
12203	2054	326	2889	145484	0	150753
12204	1129	253	1457	150631	0	153470
12205	800	415	148507	4244	0	153966
12206	140116	343	2990	2122	0	145571
12207	146788	312	1593	1094	0	149787
12208	4382	479	137129	686	0	142676
12209	143693	263	2663	893	0	147512
12210	148452	249	1501	871	0	151073
12211	4512	412	144267	726	0	149917
12212	2392	356	3129	137861	0	143738
12213	1109	148401	1891	3091	0	154492
12214	990	2971	843	158678	0	163482
12215	1068	1424	539	160511	0	163542
12216	1053	522	546	160754	0	162875
12217	812	395	156070	4984	0	162261
12218	149335	307	3291	2516	0	155449
12219	158086	279	1747	1250	0	161362
12220	4846	211	837	155677	0	161571
12221	2297	373	152893	3792	0	159355
12222	1226	371	3348	152074	0	157019
12223	823	328	157141	4024	0	162316
12224	992	316	158234	2134	0	161676
12225	726	160353	4816	1219	0	167114
12226	1217	2786	1955	152674	0	158632
12227	153397	1268	856	3493	0	159014
12228	149222	408	545	2024	0	152199
12229	154468	192	594	1134	0	156388
12230	5030	233	569	149084	0	154916
12231	2237	160128	691	3546	0	166602
12232	1261	3580	441	164824	0	170106
12233	839	1834	169506	4473	0	176652
12234	176917	568	3984	2671	0	184140
12235	193072	273	1947	1634	0	196926
12236	6801	232	966	191874	0	199873
12237	3357	282	678	196010	0	200327
12238	1876	258	593	199004	0	201731
12239	1228	376	191025	7485	0	200114
12240	166249	249	5023	3896	0	175417
12241	5221	185920	2680	1891	0	195712
12242	2259	183789	1371	1355	0	188774
12243	1337	5345	184669	1115	0	192466
12244	1170	2224	4483	181200	0	189077
12245	904	984	185609	5034	0	192531
12246	174521	470	4788	2637	0	182416
12247	5237	469	2024	180146	0	187876
12248	2831	510	179108	4732	0	187181
12249	1526	185697	4459	3006	0	194688
12250	184167	4084	2136	1779	0	192166
12251	5136	1965	191281	1253	0	199635
12252	2544	186969	4897	1318	0	195728
12253	1502	194406	2514	1247	0	199669
12254	193842	5637	1287	1521	0	202287
12255	5221	2285	988	194352	0	202846
12256	2762	1057	198788	5273	0	207880
12257	1586	198679	5131	3083	0	208479
12258	199399	4567	2433	1880	0	208279
12259	201626	2136	1226	1436	0	206424
12260	6711	198177	1245	1307	0	207440
12261	3115	5072	201823	1251	0	211261
12262	1822	2379	5018	202458	0	211677
12263	203327	1059	2633	5580	0	212599
12264	206546	717	1437	3127	0	211827
12265	7251	880	203628	1660	0	213419
12266	3812	750	5004	199124	0	208690
12267	2222	739	2638	208303	0	213902
12268	1740	960	207808	7000	0	217508
12269	1596	1106	206600	3325	0	212627
12270	207153	869	7069	2180	0	217271
12271	215302	890	3312	1718	0	221222
12272	217092	929	1649	1748	0	221418
12273	217507	842	1617	1793	0	221759
12274	7863	1074	209025	1709	0	219671
12275	209594	795	5396	1939	0	217724
12276	7025	763	2857	206997	0	217642
12277	3936	1088	211379	5667	0	222070
12278	2507	1151	211594	3512	0	218764
12279	1774	211085	7236	2535	0	222630
12280	2022	5022	3436	206723	0	217203
12281	1966	2834	210856	5326	0	220982
12282	202647	1494	5732	3268	0	213141
12283	6198	1427	3426	179864	0	190915
12284	3334	210213	2489	4387	0	220423
12285	212394	4736	1876	3385	0	222391
12286	215272	2259	1953	2444	0	221928
12287	7582	1493	212251	1810	0	223136
12288	4006	209405	5848	1733	0	220992
12289	2675	4208	2761	198944	0	208588
12290	198927	2333	1774	4745	0	207779
12291	5677	1578	1559	197305	0	206119
12292	3396	1401	192920	4698	0	202415
12293	174869	1132	4540	2815	0	183356
12294	4862	188485	2877	1772	0	197996
12295	3024	182906	1824	1533	0	189287
12296	2001	195390	1934	1504	0	200829
12297	191515	5145	2698	1792	0	201150
12298	190937	2430	1652	1613	0	196632
12299	192544	1365	1535	1274	0	196718
12300	6349	1044	1352	187776	0	196521
12301	3557	1277	188875	4032	0	197741
12302	2423	981	4158	190519	0	198081
12303	191825	862	2494	4713	0	199894
12304	5193	773	1591	192742	0	200299
12305	196593	744	1454	4811	0	203602
12306	196959	774	1534	2730	0	201997
12307	193579	872	1592	1884	0	197927
12308	5732	193160	1676	1668	0	202236
12309	194049	3622	1542	1494	0	200707
12310	5295	2228	190786	1080	0	199389
12311	3552	1277	192418	1041	0	198288
12312	2534	189971	5089	1127	0	198721
12313	2777	3435	2655	181972	0	190839
12314	180917	1667	1550	3718	0	187852
12315	4760	1208	179173	1900	0	187041
12316	175708	731	3928	1367	0	181734
12317	4668	748	2322	173678	0	181416
12318	2557	178751	1863	3601	0	186772
12319	1833	3364	1568	182334	0	189099
12320	1794	2071	181464	3890	0	189219
12321	169348	1081	3810	2588	0	176827
12322	4648	1129	184701	1491	0	191969
12323	2961	938	178891	1032	0	183822
12324	171559	693	4473	1256	0	177981
12325	4282	173592	2587	1002	0	181463
12326	179091	3274	1302	1259	0	184926
12327	180207	1677	1288	1262	0	184434
12328	5764	1077	174449	920	0	182210
12329	168064	732	3597	1195	0	173588
12330	4265	1010	169628	1221	0	176124
12331	2453	694	157802	1046	0	161995
12332	1995	606	159645	1077	0	163323
12333	1273	150894	3742	956	0	156865
12334	136934	2304	4479	965	0	144682
12335	133983	807	993	782	0	136565
12336	133236	292	340	642	0	134510
12337	132574	211	482	612	0	133879
12338	2346	477	130476	240	0	133539
12339	1318	259	1474	129040	0	132091
12340	816	267	834	132984	0	134901
12341	131575	218	462	2166	0	134421
12342	1687	130585	593	907	0	133772
12343	1096	1282	359	129160	0	131897
12344	127744	709	363	1652	0	130468
12345	1647	577	129858	816	0	132898
12346	1191	369	1385	129598	0	132543
12347	681	495	133601	1589	0	136366
12348	556	132041	1717	1056	0	135370
12349	734	1582	940	124337	0	127593
12350	123750	732	442	1620	0	126544
12351	1662	287	344	126387	0	128680
12352	1070	499	125848	1472	0	128889
12353	450	126278	1494	984	0	129206
12354	123239	1242	821	700	0	126002
12355	1579	949	123931	320	0	126779
12356	117867	242	1290	447	0	119846
12357	1467	123346	915	443	0	126171
12358	126367	1286	681	450	0	128784
12359	127477	741	295	506	0	129019
12360	2226	233	249	129829	0	132537
12361	1183	354	129589	1534	0	132660
12362	472	131202	1635	1030	0	134339
12363	611	1410	945	138216	0	141182
12364	553	876	298	142617	0	144344
12365	613	265	256	152792	0	153926
12366	654	225	255	157557	0	158691
12367	383	171400	437	3701	0	175921
12368	173642	2734	273	1863	0	178512
12369	3091	175138	507	686	0	179422
12370	2001	3260	273	178488	0	184022
12371	181697	1675	270	3643	0	187285
12372	3751	470	279	183165	0	187665
12373	2181	530	181030	3866	0	187607
12374	747	181540	3495	2173	0	187955
12375	894	3344	1821	181012	0	187071
12376	807	1912	544	186342	0	189605
12377	176968	610	376	5347	0	183301
12378	3735	665	175556	2368	0	182324
12379	173441	436	3434	1221	0	178532
12380	176692	417	1925	998	0	180032
12381	177666	453	610	1035	0	179764
12382	5791	719	173641	807	0	180958
12383	2894	583	3591	171904	0	178972
12384	1289	558	2028	176118	0	179993
12385	915	676	177480	5699	0	184770
12386	851	707	179417	2840	0	183815
12387	180858	463	5644	1536	0	188501
12388	4487	579	2526	184423	0	192015
12389	188528	522	912	4741	0	194703
12390	192723	519	719	3116	0	197077
12391	6687	633	569	190462	0	198351
12392	3490	784	199050	4942	0	208266
12393	193048	605	4568	3390	0	201611
12394	5459	536	2637	202148	0	210780
12395	3413	838	201723	5352	0	211326
12396	1612	199444	4846	3505	0	209407
12397	199007	4606	2821	1951	0	208385
12398	5122	203984	1383	1535	0	212024
12399	4059	5161	943	177750	0	187913
12400	1816	206296	1120	4680	0	213912
12401	200825	4910	1010	3345	0	210090
12402	203715	2749	1065	2056	0	209585
12403	7558	201467	1273	1858	0	212156
12404	202777	4695	1179	1852	0	210503
12405	200727	2774	1075	1963	0	206539
12406	7671	196627	1405	1970	0	207673
12407	200017	4641	1133	1912	0	207703
12408	6625	2645	1268	196081	0	206619
12409	4729	1046	1204	200191	0	207170
12410	198051	820	1204	7456	0	207531
12411	6784	744	1135	183698	0	192361
12412	4270	193076	1461	5341	0	204148
12413	194453	4658	1159	3765	0	204035
12414	193789	2888	1259	2323	0	200259
12415	7625	193533	1636	2035	0	204829
12416	197044	4847	1304	1959	0	205154
12417	198666	2981	1361	1790	0	204798
12418	8781	1335	1134	192999	0	204249
12419	5267	1368	191883	5702	0	204220
12420	3038	191617	5166	4205	0	204026
12421	195255	5134	2913	2331	0	205633
12422	197074	3292	1278	2092	0	203736
12423	8891	1794	190056	1906	0	202647
12424	191840	1406	4925	2029	0	200200
12425	7022	1585	187989	1837	0	198433
12426	187820	1614	5059	1738	0	196231
12427	7183	1742	3019	186631	0	198575
12428	4951	1959	186414	5432	0	198756
12429	3211	1974	189683	3614	0	198482
12430	3231	2096	6633	184910	0	196870
12431	3220	1659	3144	187594	0	195617
12432	3169	1838	181263	7377	0	193647
12433	3540	1550	4740	181743	0	191573
12434	3398	1890	184637	5782	0	195707
12435	3663	1672	5141	183445	0	193921
12436	3823	1739	3111	179081	0	187754
12437	3509	177966	1797	7219	0	190491
12438	3425	180622	1564	4219	0	189830
12439	3341	189246	1623	2870	0	197080
12440	3610	7161	1337	184199	0	196307
12441	3487	3538	1405	188800	0	197230
12442	3105	1915	184024	8008	0	197052
12443	175861	1546	5247	4642	0	187296
12444	187393	1491	3423	2700	0	195007
12445	8883	181819	2190	2212	0	195104
12446	184238	4925	1666	2075	0	192904
12447	7564	3316	1658	179546	0	192084
12448	183973	1621	1754	5782	0	193130
12449	185615	1326	1794	4152	0	192887
12450	8987	1458	1743	179778	0	191966
12451	174144	1511	1885	5696	0	183236
12452	6574	169949	2057	3948	0	182528
12453	4612	174823	2085	2401	0	183921
12454	3625	6623	1892	164192	0	176332
12455	2963	175421	2211	5104	0	185699
12456	3392	4957	1646	170833	0	180828
12457	3449	2995	1511	174209	0	182164
12458	168568	1492	1574	7126	0	178760
12459	5764	166055	2055	4438	0	178312
12460	163173	4323	1608	2723	0	171827
12461	158114	2801	1536	2597	0	165048
12462	6731	157751	1787	2517	0	168786
12463	153577	4134	1287	2471	0	161469
12464	5760	2668	147536	2142	0	158106
12465	3119	137803	3757	1952	0	146631
12466	128653	3248	2165	1952	0	136018
12467	3666	1913	121190	1372	0	128141
12468	2141	111755	2539	1154	0	117589
12469	1405	116958	1907	1117	0	121387
12470	110111	2871	1848	997	0	115827
12471	109260	1488	607	894	0	112249
12472	109581	782	443	877	0	111683
12473	3340	107805	682	782	0	112609
12474	2115	2021	488	108587	0	113211
12475	108898	1334	520	2316	0	113068
12476	109485	680	525	1668	0	112358
12477	3270	615	567	107419	0	111871
12478	1940	725	109037	2236	0	113938
12479	1155	791	108765	1509	0	112220
12480	1189	587	2648	108797	0	113221
12481	1115	502	1410	111626	0	114653
12482	1042	609	110980	3010	0	115641
12483	1149	428	1959	104953	0	108489
12484	891	108481	1462	2229	0	113063
12485	104687	1589	643	1438	0	108357
12486	2286	1253	567	102305	0	106411
12487	98008	421	475	1798	0	100702
12488	1703	98184	553	1253	0	101693
12489	1089	99249	563	749	0	101650
12490	96461	1612	444	772	0	99289
12491	1386	902	94769	570	0	97627
12492	80497	670	1140	445	0	82752
12493	924	83842	747	388	0	85901
12494	617	588	234	80652	0	82091
12495	79862	364	143	767	0	81136
12496	764	215	138	79006	0	80123
12497	80102	154	135	845	0	81236
12498	78106	152	145	579	0	78982
12499	840	81033	203	328	0	82404
12500	79300	448	94	326	0	80168
12501	520	78534	177	203	0	79434
12502	79281	466	80	263	0	80090
12503	697	317	84	78995	0	80093
12504	80722	180	67	632	0	81601
12505	610	142	55	82545	0	83352
12506	85710	128	86	795	0	86719
12507	88006	155	75	551	0	88787
12508	89145	120	63	346	0	89674
12509	89658	115	53	302	0	90128
12510	90404	121	86	222	0	90833
12511	851	100	76	90477	0	91504
12512	87862	108	90	606	0	88666
12513	578	86311	136	375	0	87400
12514	371	534	86588	192	0	87685
12515	277	251	383	85248	0	86159
12516	220	249	89274	485	0	90228
12517	247	115	433	90866	0	91661
12518	231	219	93092	641	0	94183
12519	89422	100	525	461	0	90508
12520	713	88	274	93087	0	94162
12521	375	219	91890	536	0	93020
12522	275	191	93029	337	0	93832
12523	236	292	700	94137	0	95365
12524	103343	75	437	877	0	104732
12525	741	108034	243	553	0	109571
12526	109901	721	75	421	0	111118
12527	109362	414	66	322	0	110164
12528	1148	109669	152	208	0	111177
12529	114478	739	63	530	0	115810
12530	1006	431	57	115003	0	116497
12531	582	188	61	115715	0	116546
12532	375	146	70	116995	0	117586
12533	115986	95	75	1386	0	117542
12534	835	118079	162	655	0	119731
12535	589	912	73	119401	0	120975
12536	345	516	70	120905	0	121836
12537	119745	169	75	1611	0	121600
12538	1098	115	72	120110	0	121395
12539	631	255	120679	1173	0	122738
12540	294	123647	1110	704	0	125755
12541	124753	1199	565	401	0	126918
12542	1447	727	189	120946	0	123309
12543	759	126509	181	1255	0	128704
12544	126181	1225	149	789	0	128344
12545	1511	844	125555	332	0	128242
12546	802	125765	1300	246	0	128113
12547	127334	1273	669	354	0	129630
12548	1392	744	253	126061	0	128450
12549	891	275	122	126869	0	128157
12550	427	305	125536	1917	0	128185
12551	390	218	1221	123433	0	125262
12552	334	286	134882	1545	0	137047
12553	280	292	128172	913	0	129657
12554	286	308	133771	407	0	134772
12555	129791	138	2121	468	0	132518
12556	132255	141	927	490	0	133813
12557	137728	125	367	446	0	138666
12558	2209	126	208	134122	0	136665
12559	1049	135129	282	1289	0	137749
12560	477	138538	250	833	0	140098
12561	139761	1761	190	692	0	142404
12562	139145	910	147	644	0	140846
12563	1784	141454	295	325	0	143858
12564	140530	1239	249	463	0	142481
12565	1517	911	138681	258	0	141367
12566	986	489	138011	277	0	139763
12567	567	193	1827	127571	0	130158
12568	417	172	863	138411	0	139863
12569	357	307	138339	1860	0	140863
12570	378	148	1338	134937	0	136801
12571	137100	135	884	1781	0	139900
12572	1377	323	137315	869	0	139884
12573	132343	180	1347	553	0	134423
12574	1639	161	817	137850	0	140467
12575	1047	347	142175	1389	0	144958
12576	490	144384	1491	908	0	147273
12577	145845	1239	816	702	0	148602
12578	1574	930	141824	364	0	144692
12579	138305	329	1431	444	0	140509
12580	1694	211	841	141600	0	144346
12581	142183	224	384	1646	0	144437
12582	1753	429	148141	876	0	151199
12583	1199	254	1431	148977	0	151861
12584	155998	168	843	1919	0	158928
12585	159332	221	439	1315	0	161307
12586	164467	195	327	758	0	165747
12587	165772	190	332	598	0	166892
12588	2778	203	318	160098	0	163397
12589	1514	209	289	160914	0	162926
12590	734	445	160562	2559	0	164300
12591	729	232	1698	159595	0	162254
12592	746	266	989	157724	0	159725
12593	522	164971	550	2617	0	168660
12594	165849	1771	338	1511	0	169469
12595	167506	1013	352	867	0	169738
12596	2874	172082	449	630	0	176035
12597	1603	2119	374	170968	0	175064
12598	885	1157	319	174270	0	176631
12599	167033	375	298	3553	0	171259
12600	2582	469	174517	1731	0	179299
12601	1631	259	2315	176599	0	180804
12602	829	428	179463	2678	0	183398
12603	171266	217	2558	1827	0	175868
12604	179390	261	1343	936	0	181930
12605	180743	240	523	779	0	182285
12606	3953	246	366	174108	0	178673
12607	2020	261	345	174084	0	176710
12608	172526	220	377	3748	0	176871
12609	2829	493	171226	1694	0	176242
12610	1750	222	2355	171080	0	175407
12611	171876	217	1310	2906	0	176309
12612	2811	259	564	172667	0	176301
12613	1759	441	180911	2769	0	185880
12614	973	462	175298	1620	0	178353
12615	169555	354	3245	1156	0	174310
12616	2601	179030	1689	749	0	184069
12617	180039	2061	631	1006	0	183737
12618	181894	1097	449	952	0	184392
12619	3618	380	439	181038	0	185475
12620	1826	278	439	180482	0	183025
12621	871	179943	599	3372	0	184785
12622	178489	2026	390	1897	0	182802
12623	2568	181676	537	915	0	185696
12624	1375	178174	488	650	0	180687
12625	977	2587	340	172874	0	176778
12626	172353	1072	312	2515	0	176252
12627	175230	403	291	1644	0	177568
12628	3209	277	317	173121	0	176924
12629	1715	230	264	168773	0	170982
12630	1066	213	262	169422	0	170963
12631	165021	205	370	3411	0	169007
12632	2437	472	166019	1657	0	170585
12633	1466	165482	2170	993	0	170111
12634	163227	1626	984	1063	0	166900
12635	2370	1070	443	162785	0	166668
12636	1470	575	162153	2136	0	166334
12637	1065	473	159824	1399	0	162761
12638	724	161223	2605	908	0	165460
12639	707	163827	1149	807	0	166490
12640	999	2116	862	157641	0	161618
12641	733	147151	487	1674	0	150045
12642	823	1500	345	157413	0	160081
12643	712	806	307	161166	0	162991
12644	160772	382	329	2588	0	164071
12645	1936	337	324	161210	0	163807
12646	1307	367	284	162794	0	164752
12647	842	665	160465	2365	0	164337
12648	862	370	1470	163624	0	166326
12649	163430	372	810	2429	0	167041
12650	164426	334	420	1592	0	166772
12651	2539	170399	498	943	0	174379
12652	163560	1784	336	1049	0	166729
12653	2504	1128	161594	925	0	166151
12654	1339	161224	1924	945	0	165432
12655	1018	1885	992	164134	0	168029
12656	921	974	521	167232	0	169648
12657	897	537	430	167363	0	169227
12658	165808	422	460	3360	0	170050
12659	153109	431	669	1885	0	156094
12660	2857	610	162413	1011	0	166891
12661	1508	611	159230	978	0	162327
12662	1165	645	160734	1012	0	163556
12663	888	160743	2834	980	0	165445
12664	887	164331	1282	965	0	167465
12665	163864	2642	536	1277	0	168319
12666	162607	1177	472	1278	0	165534
12667	3130	521	471	164803	0	168925
12668	1630	425	513	161666	0	164234
12669	921	163949	654	3239	0	168763
12670	940	2145	488	167670	0	171243
12671	945	1426	165407	2791	0	170569
12672	826	167230	2345	1956	0	172357
12673	936	2211	1180	169193	0	173520
12674	982	1620	175605	2599	0	180806
12675	1232	779	2167	159476	0	163654
12676	816	171140	1287	2633	0	175876
12677	177364	2443	515	1943	0	182265
12678	177621	1294	455	1427	0	180797
12679	184412	691	449	1383	0	186935
12680	4006	669	442	184978	0	190095
12681	2099	626	395	187522	0	190642
12682	184594	622	452	4445	0	190113
12683	3302	182653	765	2047	0	188767
12684	184871	2831	591	1450	0	189743
12685	3599	1660	186506	949	0	192714
12686	188078	563	3054	1161	0	192856
12687	193646	527	1587	1201	0	196961
12688	5156	558	585	188878	0	195177
12689	196117	504	486	3885	0	200992
12690	196895	511	572	2343	0	200321
12691	5144	548	533	197884	0	204109
12692	2198	684	195482	3632	0	201996
12693	181719	477	3363	2416	0	187975
12694	3714	699	199740	934	0	205087
12695	1865	204346	3639	811	0	210661
12696	1229	3217	1953	206353	0	212752
12697	826	1525	568	212009	0	214928
12698	222384	474	499	5137	0	228494
12699	4141	747	222675	2095	0	229658
12700	2279	728	3762	205790	0	212559
12701	749	219245	2063	3849	0	225906
12702	672	215462	767	2203	0	219104
12703	876	5403	498	220701	0	227478
12704	814	2244	217466	4375	0	224899
12705	963	752	3978	220264	0	225957
12706	1019	577	1923	217315	0	220834
12707	846	814	211666	5811	0	219137
12708	753	219488	3910	2631	0	226782
12709	210620	4133	1858	1313	0	217924
12710	4109	220582	831	1207	0	226729
12711	2573	4234	593	214702	0	222102
12712	208523	2096	653	4579	0	215851
12713	4108	206403	829	2562	0	213902
12714	2365	4198	208521	1052	0	216136
12715	200870	2075	4064	1201	0	208210
12716	4339	212968	2353	1089	0	220749
12717	216519	4092	744	1229	0	222584
12718	4981	2288	209377	1034	0	217680
12719	207563	776	4140	1186	0	213665
12720	4957	663	2148	209368	0	217136
12721	2733	919	208940	4664	0	217256
12722	1490	757	4095	200424	0	206766
12723	1143	202495	2368	4580	0	210586
12724	1498	4137	863	208700	0	215198
12725	1451	2176	753	208710	0	213090
12726	1313	1131	203199	6233	0	211876
12727	1522	756	4258	206637	0	213173
12728	1483	1183	175009	5209	0	182884
12729	1425	206500	3638	3359	0	214922
12730	1625	4500	1952	205926	0	214003
12731	1715	2565	209009	5104	0	218393
12732	1473	206804	4719	3114	0	216110
12733	1514	215521	2539	1954	0	221528
12734	1771	6377	211901	1510	0	221559
12735	1908	2791	212539	1474	0	218712
12736	2039	1126	6314	208763	0	218242
12737	210166	943	2678	5472	0	219259
12738	5639	209362	1342	3556	0	219899
12739	3889	5087	1008	204427	0	214411
12740	206362	2552	1006	5431	0	215351
12741	5994	207981	1340	3371	0	218686
12742	208267	4888	1027	2153	0	216335
12743	6209	213633	1333	1910	0	223085
12744	215194	4999	1186	2041	0	223420
12745	216569	2723	1203	2141	0	222636
12746	219361	1340	1186	2196	0	224083
12747	8385	225157	1427	2279	0	237248
12748	4904	5464	1319	226448	0	238135
12749	3131	3140	222480	6559	0	235310
12750	2705	221947	6041	4446	0	235139
12751	3174	5873	3224	216661	0	228932
12752	3320	3103	1767	220036	0	228226
12753	2825	1745	212879	7875	0	225324
12754	2626	209206	6001	4289	0	222122
12755	207573	5244	3521	2486	0	218824
12756	6634	207739	1819	2429	0	218621
12757	4376	5372	1434	207187	0	218369
12758	2373	3261	207253	6562	0	219449
12759	197403	1585	5882	4195	0	209065
12760	6342	1454	3352	209606	0	220754
12761	3273	1861	207325	6635	0	219094
12762	194676	1587	6156	4247	0	206666
12763	5615	202568	3676	2733	0	214592
12764	204617	5958	1932	2697	0	215204
12765	205731	3788	1358	2983	0	213860
12766	7637	1757	1401	204185	0	214980
12767	3664	1995	203818	6595	0	216072
12768	2057	203035	6038	4075	0	215205
12769	1475	6251	203779	2548	0	214053
12770	1532	4227	5577	197671	0	209007
12771	1722	2603	3270	205898	0	213493
12772	198009	1945	1755	8222	0	209931
12773	5481	1779	198103	4739	0	210102
12774	3075	190891	6027	2389	0	202382
12775	2111	5604	2957	189570	0	200242
12776	2022	3388	1544	192108	0	199062
12777	185625	1996	1378	6902	0	195901
12778	5457	187690	1355	3600	0	198102
12779	3433	5108	908	179692	0	189141
12780	173894	2997	1076	5215	0	183182
12781	4484	173672	1196	3006	0	182358
12782	170393	4308	737	1295	0	176733
12783	169786	2510	1020	1204	0	174520
12784	5927	166810	1361	1236	0	175334
12785	155237	3663	607	872	0	160379
12786	4002	155688	878	846	0	161414
12787	155064	3563	745	918	0	160290
12788	154661	1828	753	1076	0	158318
12789	4978	151658	810	1021	0	158467
12790	146702	3234	491	925	0	151352
12791	150835	1681	600	948	0	154064
12792	150782	785	587	965	0	153119
12793	4959	816	145610	921	0	152306
12794	2099	627	134771	709	0	138206
12795	2382	677	135008	582	0	138649
12796	133707	910	4899	805	0	140321
12797	3215	647	133006	693	0	137561
12798	1640	514	120791	464	0	123409
12799	1164	750	3292	112262	0	117468
12800	114386	405	1454	2455	0	118700
12801	2540	490	115481	1365	0	119876
12802	1572	521	122186	713	0	124992
12803	938	467	3283	119984	0	124672
12804	825	393	1463	124196	0	126877
12805	797	434	508	126320	0	128059
12806	687	554	123323	3576	0	128140
12807	804	414	2376	123851	0	127445
12808	122702	468	1325	2819	0	127314
12809	2673	123825	671	1601	0	128770
12810	1813	2475	398	124887	0	129573
12811	1100	1421	334	127718	0	130573
12812	904	801	129097	3437	0	134239
12813	767	127578	2683	1664	0	132692
12814	127032	2639	1361	829	0	131861
12815	2793	129497	808	655	0	133753
12816	1870	2807	515	129306	0	134498
12817	1039	1605	129180	2740	0	134564
12818	989	658	2806	136620	0	141073
12819	907	418	1698	139872	0	142895
12820	138931	411	985	4378	0	144705
12821	3490	416	694	135152	0	139752
12822	1998	136583	869	3351	0	142801
12823	961	143174	932	1846	0	146913
12824	781	4194	143865	899	0	149739
12825	142000	1687	3378	854	0	147919
12826	3559	622	1889	145519	0	151589
12827	2178	361	946	147158	0	150643
12828	1186	400	763	148618	0	150967
12829	145138	373	642	5124	0	151277
12830	3411	147380	811	2615	0	154217
12831	147665	3104	715	1276	0	152760
12832	3671	1729	142067	937	0	148404
12833	1962	783	140636	905	0	144286
12834	143842	449	4430	1073	0	149794
12835	3680	513	2319	145057	0	151569
12836	2077	499	959	149522	0	153057
12837	1140	461	790	151395	0	153786
12838	851	592	148298	5032	0	154773
12839	146810	490	3375	2565	0	153240
12840	151183	507	1884	1496	0	155070
12841	147857	503	948	1405	0	150713
12842	5075	694	745	144249	0	150763
12843	2424	628	140617	3728	0	147397
12844	1222	717	136945	2345	0	141229
12845	1109	740	143088	1480	0	146417
12846	817	137462	4411	1249	0	143939
12847	1382	2508	2547	126968	0	133405
12848	126765	1275	919	2934	0	131893
12849	2538	664	126566	1894	0	131662
12850	127194	363	2439	1393	0	131389
12851	2922	440	1461	129273	0	134096
12852	1761	531	714	128232	0	131238
12853	985	125541	716	3684	0	130926
12854	897	128057	866	1972	0	131792
12855	836	133367	954	1080	0	136237
12856	1151	3229	885	131865	0	137130
12857	131266	1340	913	3008	0	136527
12858	132630	539	718	2116	0	136003
12859	3592	534	130383	1357	0	135866
12860	127846	388	2598	1391	0	132223
12861	2875	523	130376	1231	0	135005
12862	2045	378	2763	128598	0	133784
12863	1288	477	130490	2792	0	135047
12864	126058	457	2772	1978	0	131265
12865	2973	465	1742	129642	0	134822
12866	1798	548	135467	2724	0	140537
12867	1028	493	128974	1888	0	132383
12868	126950	456	3538	1439	0	132383
12869	132133	423	1839	1375	0	135770
12870	3437	133442	1078	1250	0	139207
12871	1951	2212	850	135776	0	140789
12872	1223	1433	135092	2815	0	140563
12873	1084	815	133657	1917	0	137473
12874	1256	720	3287	134050	0	139313
12875	134569	571	1877	3001	0	140018
12876	2465	134125	1025	1994	0	139609
12877	1783	2289	687	135628	0	140387
12878	135036	1375	636	2981	0	140028
12879	2745	749	685	134171	0	138350
12880	1821	135255	925	2860	0	140861
12881	1376	2044	889	137105	0	141414
12882	135904	1215	848	2765	0	140732
12883	3009	516	869	136782	0	141176
12884	136393	411	880	3045	0	140729
12885	2661	138219	1147	2099	0	144126
12886	139057	2055	1036	1424	0	143572
12887	2795	1302	136437	1251	0	141785
12888	131810	610	2666	1142	0	136228
12889	137104	601	1695	1127	0	140527
12890	3440	137052	1257	1016	0	142765
12891	2035	2191	971	133324	0	138521
12892	1214	1269	133571	2267	0	138321
12893	1133	723	128656	1688	0	132200
12894	122405	1123	2965	1350	0	127843
12895	121972	524	1429	1071	0	124996
12896	2394	123039	887	1015	0	127335
12897	1415	124782	804	847	0	127848
12898	122548	2103	730	868	0	126249
12899	2016	121710	766	816	0	125308
12900	1463	124881	703	834	0	127881
12901	1075	1922	496	123139	0	126632
12902	863	918	504	118695	0	120980
12903	826	550	117957	2569	0	121902
12904	948	351	1597	117611	0	120507
12905	116632	385	1050	2153	0	120220
12906	2097	512	116696	1283	0	120588
12907	1593	543	117455	797	0	120388
12908	1135	381	2172	114434	0	118122
12909	1102	364	1230	119668	0	122364
12910	995	401	747	119355	0	121498
12911	931	522	117109	2176	0	120738
12912	773	456	1576	111081	0	113886
12913	886	367	980	114782	0	117015
12914	112434	336	562	1944	0	115276
12915	1429	111015	697	1088	0	114229
12916	110098	1035	520	637	0	112290
12917	1546	764	110745	520	0	113575
12918	94670	180	758	447	0	96055
12919	860	104270	558	321	0	106009
12920	99155	426	184	275	0	100040
12921	496	99579	168	193	0	100436
12922	95527	433	288	278	0	96526
12923	388	93692	108	157	0	94345
12924	367	92647	193	175	0	93382
12925	626	639	388	92075	0	93728
12926	92806	201	235	436	0	93678
12927	92678	74	37	340	0	93129
12928	92847	73	63	220	0	93203
12929	526	160	91326	89	0	92101
12930	292	192	89502	87	0	90073
12931	171	59	448	90844	0	91522
12932	91	92828	277	447	0	93643
12933	97	95313	133	257	0	95800
12934	172	522	62	91055	0	91811
12935	91556	218	46	471	0	92291
12936	91289	70	78	385	0	91822
12937	91917	58	50	214	0	92239
12938	658	196	90361	68	0	91283
12939	354	89	392	91629	0	92464
12940	152	187	93425	477	0	94241
12941	93160	68	458	408	0	94094
12942	95452	68	250	291	0	96061
12943	745	195	94161	103	0	95204
12944	395	64	436	96059	0	96954
12945	95106	77	254	750	0	96187
12946	585	78	69	99265	0	99997
12947	420	59	88	100592	0	101159
12948	209	70	61	108875	0	109215
12949	114257	70	69	1424	0	115820
12950	1186	69	71	121423	0	122749
12951	121511	65	76	1522	0	123174
12952	1307	128337	178	717	0	130539
12953	747	1372	76	138937	0	141132
12954	339	588	59	139730	0	140716
12955	246	168	93	134446	0	134953
12956	135939	87	85	2407	0	138518
12957	1742	81	67	136006	0	137896
12958	1044	83	77	124844	0	126048
12959	137852	74	94	2207	0	140227
12960	139753	73	91	884	0	140801
12961	139244	110	110	381	0	139845
12962	2555	204	135592	215	0	138566
12963	1075	235	126206	218	0	127734
12964	134286	99	2147	296	0	136828
12965	1858	80	727	135523	0	138188
12966	1036	83	214	123948	0	125281
12967	133409	63	157	2526	0	136155
12968	131480	89	149	1032	0	132750
12969	125517	120	136	471	0	126244
12970	2345	126778	194	321	0	129638
12971	129022	1565	138	352	0	131077
12972	123035	714	129	397	0	124275
12973	2329	125334	226	317	0	128206
12974	944	121415	205	353	0	122917
12975	753	1967	165	115861	0	118746
12976	131549	649	118	1674	0	133990
12977	132175	168	117	941	0	133401
12978	130183	122	145	514	0	130964
12979	2736	111	120	127236	0	130203
12980	128608	87	157	1959	0	130811
12981	2078	229	126851	952	0	130110
12982	124054	137	1693	565	0	126449
12983	2062	229	128270	384	0	130945
12984	1023	246	122183	490	0	123942
12985	599	150	2123	121061	0	123933
12986	121581	131	903	2083	0	124698
12987	1948	129	230	121404	0	123711
12988	1084	244	123419	2024	0	126771
12989	696	278	120476	1158	0	122608
12990	770	254	2106	115929	0	119059
12991	116012	252	832	2071	0	119167
12992	1881	119554	403	1275	0	123113
12993	1395	1494	263	122940	0	126092
12994	983	693	259	124759	0	126694
12995	879	292	125848	2713	0	129732
12996	897	308	121439	1359	0	124003
12997	936	172	2286	125307	0	128701
12998	125565	130	953	2536	0	129184
12999	2502	406	123039	1494	0	127441
13000	1793	252	1605	125573	0	129223
13001	1277	297	846	127453	0	129873
13002	1104	255	432	125856	0	127647
13003	124435	239	318	3486	0	128478
13004	2615	561	101427	2185	0	106788
13005	1751	124036	1295	1700	0	128782
13006	1552	1758	596	125669	0	129575
13007	1570	953	123843	3043	0	129409
13008	1724	121747	1967	2269	0	127707
13009	1882	125576	1106	1707	0	130271
13010	125191	2431	651	1800	0	130073
13011	3217	125418	616	1931	0	131182
13012	127449	1977	555	2145	0	132126
13013	3440	1183	124495	2254	0	131372
13014	2589	541	2030	127031	0	132191
13015	126383	392	1136	4145	0	132056
13016	3652	127174	737	3315	0	134878
13017	2968	2155	126195	2589	0	133907
13018	3038	1187	2099	111745	0	118069
13019	2655	127821	1361	3203	0	135040
13020	2804	2312	790	132904	0	138810
13021	132885	1344	922	3791	0	138942
13022	4198	135542	1041	2748	0	143529
13023	138736	2360	810	2121	0	144027
13024	140498	1248	810	2127	0	144683
13025	5659	643	138193	1782	0	146277
13026	3810	143113	3078	1652	0	151653
13027	3282	3022	1611	149681	0	157596
13028	3216	1553	154297	3630	0	162696
13029	3241	901	163934	2105	0	170181
13030	3020	1058	4882	163715	0	172675
13031	168832	702	2376	4092	0	176002
13032	169767	782	1181	2576	0	174306
13033	6921	841	814	166809	0	175385
13034	3961	1049	167761	4509	0	177280
13035	2625	168148	3978	2725	0	177476
13036	172202	3804	2042	1663	0	179711
13037	172883	2116	973	1338	0	177310
13038	6740	172369	993	1282	0	181384
13039	175122	3867	945	1395	0	181329
13040	5539	2172	170182	1106	0	178999
13041	169709	792	4214	1308	0	176023
13042	162416	631	2598	1448	0	167093
13043	5684	754	168980	1206	0	176624
13044	3137	467	4425	165466	0	173495
13045	1964	475	167430	4394	0	174263
13046	1513	160195	4702	2738	0	169148
13047	1346	162966	2914	1787	0	169013
13048	1594	5522	1394	148043	0	156553
13049	1033	1553	149604	3472	0	155662
13050	599	140060	3183	1793	0	145635
13051	397	139257	1712	772	0	142138
13052	126163	3364	1252	774	0	131553
13053	126361	1104	340	504	0	128309
13054	3211	366	326	126043	0	129946
13055	1398	248	273	123823	0	125742
13056	477	126569	419	2960	0	130425
13057	124756	2216	267	1337	0	128576
13058	127125	1030	275	636	0	129066
13059	3086	126122	370	500	0	130078
13060	1444	2194	231	127630	0	131499
13061	674	1203	126957	2360	0	131194
13062	602	410	2259	127813	0	131084
13063	128831	292	1081	2718	0	132922
13064	2604	314	418	129900	0	133236
13065	1439	316	351	132880	0	134986
13066	132687	273	326	3606	0	136892
13067	2697	309	363	129377	0	132746
13068	1334	131526	456	2551	0	135867
13069	814	2349	350	134449	0	137962
13070	768	1140	329	136149	0	138386
13071	661	490	393	131820	0	133364
13072	465	133504	560	3378	0	137907
13073	685	2497	361	132951	0	136494
13074	634	1415	130877	2750	0	135676
13075	759	569	2447	130088	0	133863
13076	656	663	129702	2872	0	133893
13077	589	128478	2706	1628	0	133401
13078	797	2585	1317	131260	0	135959
13079	856	1305	543	133081	0	135785
13080	787	596	500	133912	0	135795
13081	795	519	478	133452	0	135244
13082	772	671	129521	3935	0	134899
13083	632	128828	2712	1903	0	134075
13084	856	2592	1342	131550	0	136340
13085	816	1590	132856	2922	0	138184
13086	956	607	2779	133840	0	138182
13087	134034	540	1584	3359	0	139517
13088	3167	699	130352	1807	0	136025
13089	130347	535	2627	1142	0	134651
13090	3496	616	1432	133327	0	138871
13091	2019	793	133426	3334	0	139572
13092	1042	132020	3077	2106	0	138245
13093	1156	2898	1540	131840	0	137434
13094	1115	1798	135933	3249	0	142095
13095	910	135406	3200	1939	0	141455
13096	1084	3060	1603	135790	0	141537
13097	136622	1659	879	3566	0	142726
13098	139336	821	790	2207	0	143154
13099	141134	768	665	1393	0	143960
13100	4571	824	137589	1188	0	144172
13101	2152	139619	3272	1094	0	146137
13102	1256	3180	1668	139548	0	145652
13103	1030	1855	829	145899	0	149613
13104	147448	929	748	4804	0	153929
13105	3454	150709	876	2374	0	157413
13106	153023	3633	643	1553	0	158852
13107	152206	1967	665	1456	0	156294
13108	153819	1066	639	1499	0	157023
13109	5319	957	150586	1296	0	158158
13110	151812	736	3565	1331	0	157444
13111	4401	760	1830	153443	0	160434
13112	2412	729	763	155434	0	159338
13113	152069	643	734	5595	0	159041
13114	3893	772	576	150273	0	155514
13115	2103	149967	781	4436	0	157287
13116	1316	3447	528	149125	0	154416
13117	145000	1917	487	4598	0	152002
13118	3817	1054	143105	2715	0	150691
13119	2031	141813	3514	1671	0	149029
13120	1249	3159	1598	138238	0	144244
13121	137463	1664	676	3938	0	143741
13122	3402	892	135062	2355	0	141711
13123	2287	1990	3104	131882	0	139263
13124	1425	652	132492	3659	0	138228
13125	1271	611	127514	2301	0	131697
13126	1145	582	124259	1120	0	127106
13127	1016	485	121036	947	0	123484
13128	885	503	116515	814	0	118717
13129	100077	986	4100	778	0	105941
13130	1759	102949	1324	599	0	106631
13131	101073	1358	531	598	0	103560
13132	100333	761	379	583	0	102056
13133	2167	99576	387	439	0	102569
13134	1065	101780	409	417	0	103671
13135	101611	1899	347	550	0	104407
13136	101443	861	231	572	0	103107
13137	2259	368	228	96992	0	99847
13138	1149	100004	341	1470	0	102964
13139	101775	1334	218	1117	0	104444
13140	1517	101413	401	541	0	103872
13141	1141	1497	228	101705	0	104571
13142	102612	815	247	1698	0	105372
13143	102629	344	262	1180	0	104415
13144	2277	307	307	102216	0	105107
13145	1214	298	305	103041	0	104858
13146	625	416	101581	2156	0	104778
13147	638	237	1488	99352	0	101715
13148	515	399	102042	1686	0	104642
13149	620	226	1595	97625	0	100066
13150	600	279	971	100281	0	102131
13151	99702	227	484	2393	0	102806
13152	98992	245	412	1253	0	100902
13153	2246	364	98846	520	0	101976
13154	96554	242	1577	543	0	98916
13155	1895	276	1007	98755	0	101933
13156	1168	419	100217	1618	0	103422
13157	856	225	1593	99795	0	102469
13158	759	258	981	108269	0	110267
13159	610	471	107675	2383	0	111139
13160	742	293	1674	109613	0	112322
13161	663	446	115351	1965	0	118425
13162	726	320	1951	119555	0	122552
13163	125812	260	1096	2403	0	129571
13164	2342	128753	586	1579	0	133260
13165	129636	2147	356	885	0	133024
13166	2523	132416	509	640	0	136088
13167	130288	2358	328	727	0	133701
13168	2590	130939	459	532	0	134520
13169	128608	2416	292	706	0	132022
13170	2580	131830	418	589	0	135417
13171	1769	2461	314	131684	0	136228
13172	931	1530	131835	2411	0	136707
13173	856	737	130634	1498	0	133725
13174	886	462	3281	130400	0	135029
13175	130969	343	1526	2742	0	135580
13176	2525	133387	850	1763	0	138525
13177	1696	2336	499	134067	0	138598
13178	817	1487	134138	2704	0	139146
13179	673	703	135850	1744	0	138970
13180	811	591	3489	126293	0	131184
13181	543	136090	1945	2490	0	141068
13182	135020	2330	798	1755	0	139903
13183	2667	1580	139019	879	0	144145
13184	1733	693	135847	725	0	138998
13185	705	138946	3623	667	0	143941
13186	138382	2442	1928	872	0	143624
13187	139896	1432	839	738	0	142905
13188	3633	605	574	137900	0	142712
13189	140811	478	555	2615	0	144459
13190	138745	409	603	1641	0	141398
13191	3460	138801	724	773	0	143758
13192	138254	2304	645	762	0	141965
13193	2913	1564	141719	544	0	146740
13194	1923	623	2375	137473	0	142394
13195	1144	530	1467	138468	0	141609
13196	136782	479	717	3459	0	141437
13197	2488	136902	745	1931	0	142066
13198	135614	2254	528	927	0	139323
13199	2576	140485	646	667	0	144374
13200	1615	139917	560	702	0	142794
13201	1172	3136	137299	530	0	142137
13202	927	1828	134181	608	0	137544
13203	124251	988	2921	667	0	128827
13204	130408	555	1418	559	0	132940
13205	2712	626	128295	451	0	132084
13206	1339	124108	1692	456	0	127595
13207	708	128232	1187	420	0	130547
13208	126844	2292	736	472	0	130344
13209	126636	1162	484	499	0	128781
13210	2577	678	426	126460	0	130141
13211	128950	452	433	1839	0	131674
13212	2124	419	452	127802	0	130797
13213	1334	570	127460	1797	0	131161
13214	859	606	119052	1133	0	121650
13215	122245	428	2295	759	0	125727
13216	1978	517	1180	122853	0	126528
13217	1316	136147	713	1486	0	139662
13218	139080	1650	595	1260	0	142585
13219	138853	1080	555	868	0	141356
13220	2698	754	139547	467	0	143466
13221	138262	494	1757	594	0	141107
13222	143760	493	1200	597	0	146050
13223	2946	513	659	140958	0	145076
13224	1648	139101	718	1713	0	143180
13225	1043	143828	598	1257	0	146726
13226	1181	2665	416	147050	0	151312
13227	1091	1493	434	144664	0	147682
13228	1095	742	437	147653	0	149927
13229	987	792	144733	2930	0	149442
13230	1011	820	141154	1531	0	144516
13231	974	614	2855	141073	0	145516
13232	957	755	144431	2138	0	148281
13233	968	728	143200	1416	0	146312
13234	979	617	2909	138794	0	143299
13235	1099	735	149573	2229	0	153636
13236	748	148208	2762	1577	0	153295
13237	153786	2313	1655	1135	0	158889
13238	2717	1516	947	149307	0	154487
13239	1765	150827	942	2368	0	155902
13240	1280	2539	155382	1496	0	160697
13241	1091	1485	2620	153997	0	159193
13242	921	964	161619	2540	0	166044
13243	1090	578	2839	159766	0	164273
13244	1101	572	1685	165253	0	168611
13245	973	820	168438	3795	0	174026
13246	1017	620	2791	163001	0	167429
13247	833	167037	1962	2903	0	172735
13248	1054	2614	935	172821	0	177424
13249	1003	1812	172185	3113	0	178113
13250	1102	802	2741	170364	0	175009
13251	166812	520	1790	3361	0	172483
13252	2755	170841	1154	2392	0	177142
13253	2029	2610	764	171764	0	177167
13254	1181	1803	174881	2963	0	180828
13255	854	170613	2979	2182	0	176628
13256	831	174956	1872	1152	0	178811
13257	1153	3751	170489	927	0	176320
13258	979	1817	2587	161286	0	166669
13259	1069	1030	1664	163192	0	166955
13260	811	678	161909	3610	0	167008
13261	509	153782	2398	1925	0	158614
13262	491	154490	1573	895	0	157449
13263	143705	2325	698	722	0	147450
13264	1612	144354	556	515	0	147037
13265	143841	1694	380	710	0	146625
13266	1803	968	323	139774	0	142868
13267	147396	390	395	2217	0	150398
13268	1866	500	148329	1156	0	151851
13269	146199	321	1728	760	0	149008
13270	2069	312	1091	147532	0	151004
13271	1111	152726	680	1827	0	156344
13272	153975	1740	359	1431	0	157505
13273	2011	1573	382	152427	0	156393
13274	1123	154860	515	1873	0	158371
13275	408	164381	472	1275	0	166536
13276	162070	2389	489	1035	0	165983
13277	164876	1164	306	712	0	167058
13278	166352	469	305	688	0	167814
13279	2690	404	303	160384	0	163781
13280	1190	156919	515	1906	0	160530
13281	429	162172	457	1263	0	164321
13282	514	2398	317	161655	0	164884
13283	159136	1122	317	2194	0	162769
13284	152822	527	368	1596	0	155313
13285	158145	386	318	918	0	159767
13286	2760	576	153898	511	0	157745
13287	1443	637	154437	488	0	157005
13288	162031	386	2469	791	0	165677
13289	2130	387	1191	162971	0	166679
13290	1408	387	518	165810	0	168123
13291	760	379	434	164980	0	166553
13292	630	417	418	166268	0	167733
13293	542	733	161055	3107	0	165437
13294	702	461	1879	159690	0	162732
13295	540	712	159689	2488	0	163429
13296	147049	431	2117	1957	0	151554
13297	1968	159657	1426	1011	0	164062
13298	1497	1939	670	163405	0	167511
13299	831	1271	568	160887	0	163557
13300	158538	658	521	3322	0	163039
13301	157926	613	502	1973	0	161014
13302	158117	589	493	1204	0	160403
13303	157895	603	529	1120	0	160147
13304	3182	813	157364	889	0	162248
13305	1810	803	154904	841	0	158358
13306	1068	578	2713	155588	0	159947
13307	157684	510	1445	2647	0	162286
13308	156224	552	783	1957	0	159516
13309	2974	830	156060	1152	0	161016
13310	1722	573	2012	152946	0	157253
13311	154544	499	1401	2743	0	159187
13312	2284	543	716	155207	0	158750
13313	1625	880	155677	2570	0	160752
13314	1170	608	1984	154610	0	158372
13315	155065	606	1376	2894	0	159941
13316	2148	166973	890	2024	0	172035
13317	164305	1955	600	1512	0	168372
13318	166125	1318	545	1457	0	169445
13319	167435	701	576	1285	0	169997
13320	3374	600	501	165808	0	170283
13321	162389	541	474	2574	0	165978
13322	2293	170047	689	1549	0	174578
13323	1663	175949	640	1000	0	179252
13324	1202	3417	483	173452	0	178554
13325	173085	1509	421	2721	0	177736
13326	2699	180547	568	1594	0	185408
13327	208830	2663	371	1175	0	213039
13328	217430	1601	341	1065	0	220437
13329	5642	225429	596	801	0	232468
13330	3187	3990	423	227315	0	234915
13331	1714	2215	406	233049	0	237384
13332	1431	1205	232161	5972	0	240769
13333	1752	646	3925	228887	0	235210
13334	1419	843	232561	4857	0	239680
13335	1060	225436	4325	2891	0	233712
13336	1384	3846	2116	228594	0	235940
13337	220935	2085	861	4880	0	228761
13338	223668	801	702	3007	0	228178
13339	6138	694	635	222323	0	229790
13340	2719	822	216415	4453	0	224409
13341	199561	609	3702	2994	0	206866
13342	4095	208230	2279	1517	0	216121
13343	2508	208147	955	1166	0	212776
13344	1464	213827	740	966	0	216997
13345	1731	5738	725	203541	0	211735
13346	1153	2607	208628	3807	0	216195
13347	1243	1131	3423	205765	0	211562
13348	1023	1079	209128	4029	0	215259
13349	865	1070	206490	2245	0	210670
13350	934	1109	212116	1159	0	215318
13351	1041	766	5299	198431	0	205537
13352	895	712	2476	213837	0	217920
13353	920	700	1135	216255	0	219010
13354	962	620	973	212877	0	215432
13355	210173	479	920	6161	0	217733
13356	3540	208632	1231	3132	0	216535
13357	209517	3366	771	1969	0	215623
13358	3837	212654	911	1474	0	218876
13359	2409	3790	618	212439	0	219256
13360	1350	2058	548	220793	0	224749
13361	217130	917	523	6044	0	224614
13362	220733	762	468	3270	0	225233
13363	223436	720	423	1849	0	226428
13364	222745	814	391	1533	0	225483
13365	221022	764	378	1636	0	223800
13366	5831	217435	622	1192	0	225080
13367	209564	3538	357	1426	0	214885
13368	4345	208571	756	978	0	214650
13369	205498	3616	527	1182	0	210823
13370	4473	2184	203443	830	0	210930
13371	2924	1092	3203	197061	0	204280
13372	1518	206112	1986	3217	0	212833
13373	1399	3496	736	205665	0	211296
13374	1457	2388	201126	3760	0	208731
13375	1386	1062	3310	194611	0	200369
13376	190794	814	1899	4463	0	197970
13377	3466	191496	1256	2979	0	199197
13378	1972	196318	910	1935	0	201135
13379	1476	4947	195788	1446	0	203657
13380	1244	2581	3482	189498	0	196805
13381	945	199738	2261	3913	0	206857
13382	1221	3633	1035	203822	0	209711
13383	1071	2481	203589	4283	0	211424
13384	906	200398	3719	3330	0	208353
13385	1152	3937	201524	1562	0	208175
13386	1359	2568	200310	1416	0	205653
13387	1472	1338	4652	196485	0	203947
13388	200335	1099	2289	4272	0	207995
13389	3985	1085	1337	202906	0	209313
13390	2348	1359	203229	4317	0	211253
13391	1534	1083	4055	206344	0	213016
13392	1101	1401	213980	4589	0	221071
13393	1048	1362	211018	2845	0	216273
13394	209160	980	5680	2230	0	218050
13395	224183	813	2912	2102	0	230010
13396	226022	719	1844	2080	0	230665
13397	5918	974	222564	1858	0	231314
13398	2991	942	224421	1624	0	229978
13399	1822	715	6191	217292	0	226020
13400	1701	744	3141	223707	0	229293
13401	222038	775	1612	6369	0	230794
13402	4773	711	1206	224314	0	231004
13403	2810	1121	224024	5160	0	233115
13404	1669	958	220365	3375	0	226367
13405	1320	223075	6103	2143	0	232641
13406	1840	4064	2776	225823	0	234503
13407	1772	2752	229971	4696	0	239191
13408	1654	1143	4609	225868	0	233274
13409	227241	918	2862	5631	0	236652
13410	4705	1159	232606	3214	0	241684
13411	3140	842	4564	231348	0	239894
13412	2052	774	2719	236874	0	242419
13413	1730	1182	231633	6470	0	241015
13414	1978	707	4646	228340	0	235671
13415	1557	1195	231923	5204	0	239879
13416	211399	763	4963	3510	0	220635
13417	4927	835	2933	211307	0	220002
13418	2864	213427	1909	4822	0	223022
13419	213178	3972	1337	3290	0	221777
13420	211915	2193	1375	2157	0	217640
13421	6081	211810	1695	1817	0	221403
13422	4806	12840	1602	184493	0	203741
13423	1530	197406	1199	3594	0	203729
13424	1266	199118	1075	2500	0	203959
13425	3119	5202	188955	1411	0	198687
13426	1339	186827	3644	1432	0	193242
13427	1263	2873	156290	822	0	161248
13428	128949	1319	2070	673	0	133011
13429	134269	310	903	560	0	136042
13430	1767	139094	504	524	0	141889
13431	889	140090	411	380	0	141770
13432	346	146593	428	405	0	147772
13433	151572	2041	417	561	0	154591
13434	1908	891	328	157039	0	160166
13435	1088	523	170422	1974	0	174007
13436	390	172670	2201	1302	0	176563
13437	486	2051	1211	177643	0	181391
13438	599	1251	454	166314	0	168618
13439	281	197540	515	3117	0	201453
13440	211117	2973	405	1655	0	216150
13441	3763	1684	214856	637	0	220940
13442	2309	598	3761	237257	0	243925
13443	487	274257	2145	4797	0	281686
13444	273403	5704	558	2561	0	282226
13445	6027	2792	272180	874	0	281873
13446	2661	266923	5895	773	0	276252
13447	1241	5825	2563	269311	0	278940
13448	753	2855	268259	5832	0	277699
13449	258510	857	6148	2846	0	268361
13450	6305	577	2707	264196	0	273785
13451	3032	749	265120	6118	0	275019
13452	993	263602	6353	3364	0	274312
13453	256852	6002	2812	1359	0	267025
13454	5676	265544	1341	962	0	273523
13455	266470	6343	730	955	0	274498
13456	267195	3004	626	933	0	271758
13457	8595	1150	661	258319	0	268725
13458	3397	251365	965	6073	0	261800
13459	1563	5871	256270	3013	0	266717
13460	1323	2809	6142	256363	0	266637
13461	1506	1447	3200	239852	0	246005
13462	1333	829	1210	261824	0	265196
13463	1376	829	863	262469	0	265537
13464	1366	793	784	262216	0	265159
13465	255733	901	914	9587	0	267135
13466	254197	904	945	4269	0	260315
13467	246023	847	1023	2302	0	250195
13468	8436	242730	1388	1874	0	254428
13469	3847	6061	252820	1517	0	264245
13470	1741	3251	256384	1347	0	262723
13471	1500	1655	259962	1327	0	264444
13472	1558	1292	9429	245111	0	257390
13473	1450	1148	4184	254536	0	261318
13474	1625	1147	1614	257362	0	261748
13475	1396	1263	250925	9897	0	263481
13476	1288	242997	7277	5546	0	257108
13477	1496	6750	250408	2327	0	260981
13478	1608	3622	253359	1786	0	260375
13479	1788	1745	9455	245269	0	258257
13480	1541	1938	252942	7552	0	263973
13481	1900	1493	7758	246857	0	258008
13482	245968	1490	4112	8208	0	259778
13483	247453	1462	2120	4585	0	255620
13484	9840	1691	243515	2607	0	257653
13485	5011	1575	7396	240383	0	254365
13486	2759	1897	246129	7965	0	258750
13487	2089	244375	8179	4963	0	259606
13488	242090	7509	4391	2750	0	256740
13489	8029	4358	244248	2450	0	259085
13490	4494	236821	8039	2480	0	251834
13491	2534	235718	4765	2498	0	245515
13492	2275	236898	3198	2652	0	245023
13493	2322	9820	225226	2538	0	239906
13494	2964	5638	7599	207934	0	224135
13495	2249	221069	4613	7453	0	235384
13496	2718	7774	2701	221177	0	234370
13497	2927	4486	2450	224684	0	234547
13498	215234	2409	2361	10469	0	230473
13499	7408	216334	2826	6017	0	232585
13500	213702	7279	2457	3811	0	227249
13501	7698	210972	2799	3731	0	225200
13502	4589	217094	3089	3231	0	228003
13503	3439	9546	212442	3342	0	228769
13504	3068	5190	7710	210234	0	226202
13505	2652	3061	212969	8425	0	227107
13506	2623	206284	8242	6819	0	223968
13507	3034	7276	209222	3934	0	223466
13508	3390	4127	210150	3701	0	221368
13509	2779	208495	10202	3453	0	224929
13510	200885	7381	5239	3712	0	217217
13511	7027	206962	3977	4072	0	222038
13512	207436	7884	3666	3861	0	222847
13513	7877	4548	207466	3943	0	223834
13514	4640	2472	208943	4340	0	220395
13515	2644	205432	10616	4324	0	223016
13516	202935	7126	5253	4132	0	219446
13517	7727	206285	4065	3678	0	221755
13518	5426	7659	3489	204190	0	220764
13519	207561	4535	3417	7909	0	223422
13520	7969	3080	207288	4895	0	223232
13521	4843	2579	8922	207376	0	223720
13522	205354	2453	5506	8646	0	221959
13523	7484	205505	4403	5820	0	223212
13524	4869	7358	3271	206810	0	222308
13525	2959	4288	205833	9075	0	222155
13526	201524	2500	8371	5935	0	218330
13527	7357	2313	5602	206832	0	222104
13528	3735	2640	205518	8824	0	220717
13529	2564	2268	8782	196443	0	210057
13530	2043	200696	5737	9006	0	217482
13531	2562	7234	202237	5676	0	217709
13532	3246	3924	7674	192232	0	207076
13533	184060	2244	4522	7517	0	198343
13534	8119	1919	3018	178940	0	191996
13535	162691	1700	2676	6539	0	173606
13536	6444	160783	3196	3736	0	174159
13537	157210	5943	2820	2268	0	168241
13538	6207	3740	154376	2121	0	166444
13539	3472	1994	136222	1740	0	143428
13540	1653	1612	120966	1387	0	125618
13541	1756	113447	7474	1432	0	124109
13542	2561	1378	6243	54614	0	64796
13543	327	588	732	54183	0	55830
13544	286	272	278	53251	0	54087
13545	227	236	220	54809	0	55492
13546	241	250	53439	1324	0	55254
13547	47873	205	909	761	0	49748
13548	845	53625	647	374	0	55491
13549	52034	776	258	268	0	53336
13550	888	517	222	51981	0	53608
13551	509	52571	252	788	0	54120
13552	322	818	182	53109	0	54431
13553	52291	542	207	854	0	53894
13554	740	54465	279	575	0	56059
13555	54352	771	216	307	0	55646
13556	54307	487	226	240	0	55260
13557	1109	296	163	54682	0	56250
13558	565	243	54742	769	0	56319
13559	52763	183	771	581	0	54298
13560	771	204	484	56623	0	58082
13561	57205	181	257	946	0	58589
13562	58380	152	188	616	0	59336
13563	58382	162	186	349	0	59079
13564	1250	233	57965	245	0	59693
13565	633	181	722	55971	0	57507
13566	56727	132	447	845	0	58151
13567	820	202	58741	521	0	60284
13568	488	58262	733	244	0	59727
13569	378	691	495	53085	0	54649
13570	212	474	57794	614	0	59094
13571	203	201	57680	405	0	58489
13572	267	241	820	56450	0	57778
13573	242	110	471	59399	0	60222
13574	197	76	170	59939	0	60382
13575	218	89	104	59235	0	59646
13576	174	173	58580	891	0	59818
13577	159	58815	600	505	0	60079
13578	236	516	363	59469	0	60584
13579	59983	325	158	686	0	61152
13580	58904	117	118	553	0	59692
13581	59493	88	108	277	0	59966
13582	949	126	107	58699	0	59881
13583	491	186	112	57693	0	58482
13584	201	54736	155	812	0	55904
13585	140	56230	157	433	0	56960
13586	317	835	166	54295	0	55613
13587	53650	307	196	677	0	54830
13588	53177	74	104	424	0	53779
13589	52509	66	88	233	0	52896
13590	52668	70	75	216	0	53029
13591	52573	44	68	220	0	52905
13592	531	52519	130	152	0	53332
13593	321	349	66	53280	0	54016
13594	54700	205	81	570	0	55556
13595	55086	57	70	380	0	55593
13596	599	52	79	54412	0	55142
13597	351	65	52	55069	0	55537
13598	165	124	55659	590	0	56538
13599	171	66	359	53713	0	54309
13600	186	74	213	55772	0	56245
13601	172	141	58323	575	0	59211
13602	188	122	338	57390	0	58038
13603	154	58755	286	498	0	59693
13604	239	416	57842	290	0	58787
13605	145	59157	378	183	0	59863
13606	213	343	218	58053	0	58827
13607	172	228	79	58911	0	59390
13608	111	58577	124	519	0	59331
13609	111	59306	123	302	0	59842
13610	59741	434	80	302	0	60557
13611	58743	207	69	263	0	59282
13612	552	160	57743	142	0	58597
13613	56873	64	318	346	0	57601
13614	60487	54	215	346	0	61102
13615	60741	43	77	274	0	61135
13616	59809	77	479	295	0	60660
13617	566	119	58173	227	0	59085
13618	315	162	54370	128	0	54975
13619	58658	74	371	248	0	59351
13620	381	61786	283	189	0	62639
13621	254	306	61557	132	0	62249
13622	61136	130	273	225	0	61764
13623	62415	56	162	241	0	62874
13624	477	189	61523	109	0	62298
13625	60266	57	334	191	0	60848
13626	433	71	203	66107	0	66814
13627	254	170	67811	408	0	68643
13628	60216	70	380	453	0	61119
13629	337	66884	303	222	0	67746
13630	68590	297	127	361	0	69375
13631	75946	191	96	610	0	76843
13632	544	108	116	76212	0	76980
13633	313	73	115	76712	0	77213
13634	191	74	68	78167	0	78500
13635	78248	53	92	818	0	79211
13636	82642	75	75	575	0	83367
13637	757	62	69	83427	0	84315
13638	474	81	62	82757	0	83374
13639	241	202	80556	871	0	81870
13640	75409	96	485	609	0	76599
13641	637	92	279	83031	0	84039
13642	436	77	85	82783	0	83381
13643	215	81903	128	993	0	83239
13644	276	573	55	83097	0	84001
13645	236	351	53	83194	0	83834
13646	80666	136	53	1110	0	81965
13647	727	82703	135	536	0	84101
13648	594	606	53	84320	0	85573
13649	364	362	52	84607	0	85385
13650	324	120	51	85766	0	86261
13651	281	223	84203	1086	0	85793
13652	285	115	604	83270	0	84274
13653	81769	88	378	1042	0	83277
13654	795	217	82896	592	0	84500
13655	541	84	645	83926	0	85196
13656	293	54	384	86100	0	86831
13657	84996	60	153	1387	0	86596
13658	83136	75	152	812	0	84175
13659	1114	233	83758	321	0	85426
13660	76913	91	638	473	0	78115
13661	794	212	82848	265	0	84119
13662	80055	103	682	381	0	81221
13663	859	88652	470	281	0	90262
13664	90436	786	143	460	0	91825
13665	925	91453	172	287	0	92837
13666	93563	919	117	450	0	95049
13667	964	95075	183	265	0	96487
13668	642	1025	119	97253	0	99039
13669	299	512	98	98060	0	98969
13670	256	154	118	97698	0	98226
13671	151	95345	190	1659	0	97345
13672	263	934	96	95554	0	96847
13673	162	96699	214	1186	0	98261
13674	224	1016	105	97696	0	99041
13675	98067	563	100	1349	0	100079
13676	96631	204	113	881	0	97829
13677	1567	96792	227	418	0	99004
13678	849	1022	118	97492	0	99481
13679	96325	627	135	1260	0	98347
13680	1157	97350	220	820	0	99547
13681	731	98633	216	355	0	99935
13682	98737	1619	110	422	0	100888
13683	99215	773	99	399	0	100486
13684	1725	98764	178	274	0	100941
13685	98704	1196	87	422	0	100409
13686	1415	769	94	98115	0	100393
13687	877	436	100579	1302	0	103194
13688	99543	226	1142	1113	0	102024
13689	102013	231	646	606	0	103496
13690	1983	410	102561	353	0	105307
13691	103185	211	1214	675	0	105285
13692	106578	211	717	571	0	108077
13693	109983	231	197	594	0	111005
13694	2086	108347	247	397	0	111077
13695	110720	1347	108	560	0	112735
13696	111348	865	142	505	0	112860
13697	2320	381	123	110543	0	113367
13698	1299	285	118	112937	0	114639
13699	654	272	111	114907	0	115944
13700	114526	310	117	2506	0	117459
13701	1809	288	116	112664	0	114877
13702	113854	287	112	1992	0	116245
13703	115189	299	141	1442	0	117071
13704	2518	305	144	114444	0	117411
13705	1421	304	158	119187	0	121070
13706	813	285	146	120063	0	121307
13707	118529	307	123	2828	0	121787
13708	1906	118623	314	1375	0	122218
13709	1409	1647	157	120843	0	124056
13710	862	1040	137	123418	0	125457
13711	121580	423	162	2889	0	125054
13712	122225	369	293	1660	0	124547
13713	2952	507	119825	729	0	124013
13714	1636	489	118882	668	0	121675
13715	126398	339	2589	771	0	130097
13716	2640	380	1115	130187	0	134322
13717	1758	345	312	147650	0	150065
13718	966	572	145964	4373	0	151875
13719	988	500	2939	140131	0	144558
13720	744	143411	1542	3348	0	149045
13721	735	149098	507	1861	0	152201
13722	144373	4158	282	1074	0	149887
13723	3660	1813	142553	851	0	148877
13724	1991	147157	2843	773	0	152764
13725	1235	3232	1299	148655	0	154421
13726	996	1715	147390	3456	0	153557
13727	1089	629	3064	144143	0	148925
13728	1036	450	1426	147539	0	150451
13729	958	597	147460	4676	0	153691
13730	809	147919	3264	2223	0	154215
13731	1042	3198	1504	140780	0	146524
13732	142383	1516	600	3605	0	148104
13733	143640	587	421	2074	0	146722
13734	144049	407	387	1203	0	146046
13735	4812	139741	654	968	0	146175
13736	137225	2952	448	971	0	141596
13737	3784	1534	402	136513	0	142233
13738	1973	729	134721	3486	0	140909
13739	131925	451	2956	2087	0	137419
13740	3376	136349	1665	1152	0	142542
13741	1905	2944	600	136032	0	141481
13742	1128	1466	510	135949	0	139053
13743	838	134548	667	4464	0	140517
13744	1090	3153	485	138881	0	143609
13745	1090	1519	509	140930	0	144048
13746	1100	791	497	143298	0	145686
13747	138438	716	648	5030	0	144832
13748	138420	613	628	2776	0	142437
13749	4448	947	137670	1586	0	144651
13750	2208	849	3181	136960	0	143198
13751	1478	667	1590	141540	0	145275
13752	1171	817	970	143365	0	146323
13753	139050	876	765	5180	0	145871
13754	3678	903	135821	2671	0	143073
13755	133808	672	3349	1710	0	139539
13756	139778	730	1550	1661	0	143719
13757	4841	619	837	138220	0	144517
13758	138976	527	895	4046	0	144444
13759	4140	928	134980	2416	0	142464
13760	133101	614	3043	1945	0	138703
13761	4039	147860	1825	1865	0	155589
13762	2447	3414	146032	1307	0	153200
13763	1556	1893	147924	1467	0	152840
13764	1748	1458	4391	144650	0	152247
13765	1631	888	147791	3951	0	154261
13766	140800	836	3624	2668	0	147928
13767	3664	141696	1990	1706	0	149056
13768	142206	3113	822	1830	0	147971
13769	4038	1748	700	142800	0	149286
13770	2263	937	141403	4331	0	148934
13771	1338	855	141812	2747	0	146752
13772	1288	1122	4245	141308	0	147963
13773	142764	598	1862	4574	0	149798
13774	3563	140586	1005	2963	0	148117
13775	2009	146799	966	2171	0	151945
13776	145010	3912	883	2077	0	151882
13777	3891	146624	940	1826	0	153281
13778	147236	3344	897	1691	0	153168
13779	4533	1745	750	145809	0	152837
13780	146137	690	907	4090	0	151824
13781	4163	573	995	146404	0	152135
13782	147201	585	845	4293	0	152924
13783	4030	572	992	145746	0	151340
13784	2462	144783	1241	3893	0	152379
13785	145202	2995	962	2455	0	151614
13786	3743	145484	1115	1936	0	152278
13787	2500	3386	139617	1237	0	146740
13788	1790	1798	3373	131386	0	138347
13789	1410	143138	2045	3183	0	149776
13790	140466	3166	955	1976	0	146563
13791	138566	1609	1083	1350	0	142608
13792	4593	137050	1266	1168	0	144077
13793	2146	3417	135163	1298	0	142024
13794	1641	1616	3411	129386	0	136054
13795	1334	132011	2183	3453	0	138981
13796	1340	3170	1271	135441	0	141222
13797	1754	1603	1016	137163	0	141536
13798	133056	1131	753	4625	0	139565
13799	3732	132330	989	2257	0	139308
13800	2286	3042	800	133359	0	139487
13801	133634	1798	747	3825	0	140004
13802	134330	907	821	2310	0	138368
13803	132941	1003	827	1746	0	136517
13804	5105	1051	807	129575	0	136538
13805	126636	799	704	3620	0	131759
13806	3840	125266	1057	1908	0	132071
13807	124985	2952	757	1519	0	130213
13808	3512	126120	893	1442	0	131967
13809	126331	2911	707	1453	0	131402
13810	125394	1559	536	1584	0	129073
13811	4817	1302	699	122176	0	128994
13812	2274	970	125282	3222	0	131748
13813	1816	1012	123039	1826	0	127693
13814	1573	123597	3131	1185	0	129486
13815	118707	2647	1534	1359	0	124247
13816	3030	1562	116529	750	0	121871
13817	90279	510	1011	536	0	92336
13818	1303	95966	598	327	0	98194
13819	1002	101156	325	400	0	102883
13820	640	1561	249	104390	0	106840
13821	585	108865	310	1222	0	110982
13822	585	1808	109859	948	0	113200
13823	831	1005	1513	105942	0	109291
13824	575	112486	914	1744	0	115719
13825	594	1975	322	114441	0	117332
13826	113360	1040	286	2244	0	116930
13827	2030	648	215	114818	0	117711
13828	1245	683	114934	2179	0	119041
13829	654	114959	1956	1293	0	118862
13830	602	2225	1051	114556	0	118434
13831	683	1185	502	116036	0	118406
13832	608	692	370	118114	0	119784
13833	114191	556	303	3332	0	118382
13834	114096	386	351	1757	0	116590
13835	3091	621	115088	773	0	119573
13836	1666	676	113420	583	0	116345
13837	725	115266	2802	756	0	119549
13838	117502	2076	1253	869	0	121700
13839	2448	1257	544	117533	0	121782
13840	1453	694	364	119076	0	121587
13841	987	481	264	120185	0	121917
13842	955	431	181	120857	0	122424
13843	804	628	115080	3470	0	119982
13844	109554	435	1995	1919	0	113903
13845	2618	430	1065	131522	0	135635
13846	1800	601	130413	2969	0	135783
13847	130465	549	2870	2017	0	135901
13848	145940	351	1601	1167	0	149059
13849	5095	662	161683	691	0	168131
13850	2977	685	168758	546	0	172966
13851	1591	510	5797	165202	0	173100
13852	168876	442	2617	4785	0	176720
13853	172688	407	1179	2557	0	176831
13854	6523	472	760	165181	0	172936
13855	3159	447	739	172130	0	176475
13856	1508	574	169412	6208	0	177702
13857	1066	928	4572	166978	0	173544
13858	1122	628	168579	5381	0	175710
13859	158598	495	4773	2813	0	166679
13860	4607	167629	2602	1561	0	176399
13861	159070	3840	877	1070	0	164857
13862	4531	158165	896	776	0	164368
13863	156959	4408	847	809	0	163023
13864	4985	2101	478	152124	0	159688
13865	2785	815	430	155539	0	159569
13866	154958	522	319	6031	0	161830
13867	157800	394	354	2908	0	161456
13868	159809	342	413	1558	0	162122
13869	161345	352	411	1053	0	163161
13870	7126	384	155306	858	0	163674
13871	155699	240	4287	1048	0	161274
13872	161188	216	2155	1011	0	164570
13873	161550	225	994	882	0	163651
13874	7544	241	741	154959	0	163485
13875	150663	203	643	4731	0	156240
13876	5327	149712	902	2585	0	158526
13877	3327	3919	674	152180	0	160100
13878	2042	1942	658	156249	0	160891
13879	1566	953	151123	6544	0	160186
13880	1523	547	4357	146628	0	153055
13881	1239	150966	2584	5351	0	160140
13882	149549	4259	1177	3214	0	158199
13883	4886	151726	1134	1860	0	159606
13884	153326	4759	741	1649	0	160475
13885	5919	2467	759	151406	0	160551
13886	150305	1003	795	5271	0	157374
13887	5583	147805	919	3084	0	157391
13888	151677	4372	705	1823	0	158577
13889	152973	2349	700	1545	0	157567
13890	7674	1135	671	148281	0	157761
13891	4308	714	696	153121	0	158839
13892	2660	728	148480	6869	0	158737
13893	2501	693	4329	150410	0	157933
13894	2263	644	2329	153545	0	158781
13895	2094	715	149716	7072	0	159597
13896	2137	474	4655	151931	0	159197
13897	1894	620	150161	6222	0	158897
13898	147180	509	5168	3674	0	156531
13899	5979	484	2793	149077	0	158333
13900	3747	682	146227	5598	0	156254
13901	145337	592	4856	3232	0	154017
13902	6216	537	2517	147886	0	157156
13903	3736	857	149322	5567	0	159482
13904	149488	527	4781	3449	0	158245
13905	6154	662	2515	151461	0	160792
13906	4066	524	1308	156046	0	161944
13907	155393	580	1022	7394	0	164389
13908	6437	589	795	155450	0	163271
13909	3997	665	828	158076	0	163566
13910	2940	590	834	150938	0	155302
13911	2314	150735	1024	7448	0	161521
13912	148540	4343	832	4295	0	158010
13913	151368	2327	818	2618	0	157131
13914	7930	1156	777	147138	0	157001
13915	149191	816	788	5883	0	156678
13916	150216	684	781	3881	0	155562
13917	151705	729	904	2504	0	155842
13918	133930	810	1026	2401	0	138167
13919	147143	587	1159	2208	0	151097
13920	7863	668	132179	1909	0	142619
13921	4039	660	127176	2018	0	133893
13922	126066	486	5350	1779	0	133681
13923	5183	126166	2888	1917	0	136154
13924	3393	3517	1491	124427	0	132828
13925	2202	1888	123906	4605	0	132601
13926	2069	997	124279	2934	0	130279
13927	2268	1476	5245	121454	0	130443
13928	121627	905	3416	4858	0	130806
13929	4904	622	1168	123839	0	130533
13930	2872	793	122618	4951	0	131234
13931	126545	375	3608	3455	0	133983
13932	4738	438	2178	129498	0	136852
13933	3234	291	1192	132575	0	137292
13934	2382	312	809	134463	0	137966
13935	2171	262	682	132859	0	135974
13936	1906	566	126847	6501	0	135820
13937	2220	266	3601	128655	0	134742
13938	127669	329	2109	5106	0	135213
13939	4598	567	124762	3298	0	133225
13940	124382	356	3556	2221	0	130515
13941	129682	363	1842	1931	0	133818
13942	129391	372	1160	1767	0	132690
13943	127178	349	991	1770	0	130288
13944	6152	122725	964	1754	0	131595
13945	2552	107500	649	1025	0	111726
13946	1677	110963	758	1158	0	114556
13947	102706	3973	2532	1636	0	110847
13948	2982	1322	95185	1126	0	100615
13949	73031	737	1788	539	0	76095
13950	1705	241	663	70979	0	73588
13951	71091	138	237	1105	0	72571
13952	1057	109	197	70823	0	72186
13953	70648	89	206	1176	0	72119
13954	1063	84	225	70717	0	72089
13955	867	77	168	72085	0	73197
13956	57187	98	215	1678	0	59178
13957	1101	77672	256	808	0	79837
13958	775	717	77596	438	0	79526
13959	481	76618	785	446	0	78330
13960	477	637	73777	296	0	75187
13961	393	597	676	70077	0	71743
13962	72911	106	529	670	0	74216
13963	630	109	173	72385	0	73297
13964	71195	70	150	707	0	72122
13965	606	76386	200	613	0	77805
13966	711	497	77397	260	0	78865
13967	279	77712	518	248	0	78757
13968	247	78113	363	228	0	78951
13969	75271	507	259	266	0	76303
13970	72948	217	139	271	0	73575
13971	574	74588	199	197	0	75558
13972	380	331	94	75346	0	76151
13973	264	201	87	75501	0	76053
13974	74995	92	115	774	0	75976
13975	535	199	75449	378	0	76561
13976	402	217	73900	210	0	74729
13977	263	94	583	74660	0	75600
13978	237	228	76875	542	0	77882
13979	70130	85	508	496	0	71219
13980	75572	69	313	366	0	76320
13981	707	75874	219	238	0	77038
13982	488	475	77306	205	0	78474
13983	321	286	492	76766	0	77865
13984	279	244	80795	605	0	81923
13985	279	117	516	80178	0	81090
13986	80373	124	314	746	0	81557
13987	602	84013	238	569	0	85422
13988	518	687	87290	255	0	88750
13989	235	88767	645	251	0	89898
13990	205	92044	407	261	0	92917
13991	92123	747	162	401	0	93433
13992	88515	355	148	377	0	89395
13993	954	301	91456	268	0	92979
13994	485	94359	673	317	0	95834
13995	391	617	346	94912	0	96266
13996	303	354	186	95089	0	95932
13997	320	160	148	94901	0	95529
13998	304	299	95637	986	0	97226
13999	342	168	597	94031	0	95138
14000	307	156	389	97996	0	98848
14001	98941	143	176	1182	0	100442
14002	98395	137	184	731	0	99447
14003	98189	142	218	588	0	99137
14004	96458	152	153	481	0	97244
14005	96365	137	163	456	0	97121
14006	1000	95689	279	277	0	97245
14007	93730	545	132	311	0	94718
14008	813	512	92577	176	0	94078
14009	539	292	510	92306	0	93647
14010	94154	151	368	754	0	95427
14011	651	94190	252	409	0	95502
14012	95772	572	120	387	0	96851
14013	97159	346	122	455	0	98082
14014	839	164	135	97277	0	98415
14015	491	156	154	99003	0	99804
14016	283	103166	267	915	0	104631
14017	347	627	162	105405	0	106541
14018	293	601	108380	811	0	110085
14019	384	172	721	108707	0	109984
14020	267	308	109422	884	0	110881
14021	98776	143	923	765	0	100607
14022	1015	118	448	111006	0	112587
14023	628	317	111953	957	0	113855
14024	271	109441	956	667	0	111335
14025	188	111855	579	323	0	112945
14026	110781	1129	283	378	0	112571
14027	956	569	188	110878	0	112591
14028	585	340	116261	865	0	118051
14029	226	113892	871	768	0	115757
14030	280	993	114501	239	0	116013
14031	108577	444	893	379	0	110293
14032	111596	165	424	337	0	112522
14033	111943	118	176	330	0	112567
14034	1280	107	130	111534	0	113051
14035	605	314	111509	933	0	113361
14036	230	111044	936	654	0	112864
14037	284	779	457	113207	0	114727
14038	226	601	110483	874	0	112184
14039	258	363	107624	568	0	108813
14040	249	128	1168	110861	0	112406
14041	113059	119	523	1103	0	114804
14042	884	104	264	113014	0	114266
14043	579	141	179	114725	0	115624
14044	278	306	114531	1244	0	116359
14045	305	143	874	113160	0	114482
14046	287	113	497	114352	0	115249
14047	242	316	114828	1299	0	116685
14048	261	282	112719	648	0	113910
14049	298	125	1198	113392	0	115013
14050	297	350	116368	957	0	117972
14051	270	170	955	115677	0	117072
14052	115850	96	574	1249	0	117769
14053	870	119209	393	840	0	121312
14054	604	879	226	121283	0	122992
14055	377	662	119169	943	0	121151
14056	99703	235	920	1109	0	101967
14057	911	111068	631	390	0	113000
14058	112137	854	281	544	0	113816
14059	1079	502	227	111801	0	113609
14060	615	227	259	112097	0	113198
14061	113547	141	295	1763	0	115746
14062	993	319	114392	766	0	116470
14063	111492	123	992	594	0	113201
14064	1140	113	592	116684	0	118529
14065	113526	101	297	1398	0	115322
14066	113392	126	294	899	0	114711
14067	1560	190	242	112153	0	114145
14068	748	117076	357	1171	0	119352
14069	120429	1075	293	946	0	122743
14070	121700	564	269	710	0	123243
14071	1900	475	120956	346	0	123677
14072	119014	219	1261	471	0	120965
14073	1556	198	733	120370	0	122857
14074	886	122984	462	1341	0	125673
14075	656	1290	290	118147	0	120383
14076	357	123241	387	1299	0	125284
14077	121921	1317	249	963	0	124450
14078	125083	669	272	643	0	126667
14079	2126	311	208	132901	0	135546
14080	1034	356	132219	1758	0	135367
14081	595	390	130956	1015	0	132956
14082	505	208	2338	135733	0	138784
14083	136178	152	1108	2075	0	139513
14084	144957	168	432	1376	0	146933
14085	2853	146588	447	640	0	150528
14086	1561	2039	322	147583	0	151505
14087	653	1241	149363	2364	0	153621
14088	550	541	153183	1459	0	155733
14089	728	672	3757	160217	0	165374
14090	169724	234	1858	3568	0	175384
14091	3641	194	567	172604	0	177006
14092	1855	380	170410	3887	0	176532
14093	168665	184	3582	2151	0	174582
14094	3770	162	1794	169453	0	175179
14095	2049	173	710	173156	0	176088
14096	987	219	423	168676	0	170305
14097	531	168224	619	5230	0	174604
14098	667	3346	169404	2211	0	175628
14099	631	1747	173416	992	0	176786
14100	753	517	4942	171780	0	177992
14101	638	505	173605	3939	0	178687
14102	169330	288	4068	2370	0	176056
14103	4016	328	1971	170624	0	176939
14104	2251	281	875	172672	0	176079
14105	1069	304	655	170847	0	172875
14106	634	171368	854	5483	0	178339
14107	174118	3495	588	2765	0	180966
14108	4095	1767	520	173315	0	179697
14109	172221	594	594	4378	0	177787
14110	4100	172184	785	2526	0	179595
14111	173112	3652	593	1533	0	178890
14112	170220	1802	615	1246	0	173883
14113	172286	632	582	1333	0	174833
14114	5770	166757	839	1199	0	174565
14115	2640	168915	702	1020	0	173277
14116	161323	4813	505	1226	0	167867
14117	3925	163991	781	1178	0	169875
14118	2306	3931	158780	1113	0	166130
14119	1127	155527	3621	1011	0	161286
14120	837	160641	2111	1017	0	164606
14121	158692	4619	1022	1032	0	165365
14122	3862	2239	157050	863	0	164014
14123	2224	1094	156096	843	0	160257
14124	1435	633	4874	152974	0	159916
14125	156302	587	2197	4040	0	163126
14126	4014	722	156357	2340	0	163433
14127	2462	605	3691	155795	0	162553
14128	1280	838	151328	3940	0	157386
14129	1080	821	149513	2347	0	153761
14130	144179	612	4903	1542	0	151236
14131	4120	862	150622	995	0	156599
14132	2636	791	3969	145864	0	153260
14133	1557	729	2192	144841	0	149319
14134	1182	145479	1407	4872	0	152940
14135	1267	151205	1206	2451	0	156129
14136	1402	4868	1002	146876	0	154148
14137	1197	2470	147941	4125	0	155733
14138	1434	1129	3747	147895	0	154205
14139	1273	956	2253	151085	0	155567
14140	1035	1088	150331	5518	0	157972
14141	1320	786	4046	151621	0	157773
14142	152623	774	2432	4877	0	160706
14143	4167	908	152836	2775	0	160686
14144	152083	759	4262	1886	0	158990
14145	4568	758	2697	151108	0	159131
14146	2941	642	1560	154980	0	160123
14147	1684	155094	1471	5972	0	164221
14148	1648	3968	1376	157366	0	164358
14149	1582	2116	1314	162046	0	167058
14150	158876	1086	1410	6514	0	167886
14151	4632	906	1322	160792	0	167652
14152	2889	902	1307	163014	0	168112
14153	155774	978	1420	6787	0	164959
14154	4652	965	1464	157627	0	164708
14155	3009	935	1476	149062	0	154482
14156	1579	154272	1793	6353	0	163997
14157	154940	4013	1500	3911	0	164364
14158	4891	2165	1222	156484	0	164762
14159	3048	1181	1120	160224	0	165573
14160	1940	1138	154832	6872	0	164782
14161	1683	924	4263	154473	0	161343
14162	1674	855	2627	157500	0	162656
14163	151529	926	1320	7000	0	160775
14164	153430	947	1123	3985	0	159485
14165	6234	1013	1163	150650	0	159060
14166	3153	1102	146463	5100	0	155818
14167	1737	140327	4272	3237	0	149573
14168	1492	144897	2681	2167	0	151237
14169	2387	5462	1682	141386	0	150917
14170	142272	2340	1118	4997	0	150727
14171	4396	1246	861	143895	0	150398
14172	144095	1064	663	5238	0	151060
14173	4642	1037	760	145831	0	152270
14174	2813	870	775	146774	0	151232
14175	141659	899	787	6229	0	149574
14176	140361	1003	850	3448	0	145662
14177	5723	140597	1009	2127	0	149456
14178	2894	144463	984	1846	0	150187
14179	1722	4521	797	130257	0	137297
14180	1441	2106	719	133916	0	138182
14181	1317	1034	129194	5083	0	136628
14182	117529	714	3469	2868	0	124580
14183	3504	124683	1972	1808	0	131967
14184	1464	116647	937	1330	0	120378
14185	112275	3081	943	1264	0	117563
14186	3020	1422	111759	1022	0	117223
14187	1631	732	107397	959	0	110719
14188	1001	880	98624	843	0	101348
14189	541	89605	2155	640	0	92941
14190	556	1084	1324	80710	0	83674
14191	337	528	263	80844	0	81972
14192	367	244	217	81469	0	82297
14193	78568	181	191	1829	0	80769
14194	77821	175	185	1030	0	79211
14195	1432	77809	290	635	0	80166
14196	779	1034	143	78698	0	80654
14197	570	713	78558	1262	0	81103
14198	364	78990	1054	829	0	81237
14199	76973	1049	582	738	0	79342
14200	1164	729	76812	458	0	79163
14201	70051	286	976	607	0	71920
14202	1157	381	76273	476	0	78287
14203	706	480	1042	72183	0	74411
14204	393	76145	585	1113	0	78236
14205	76633	970	265	859	0	78727
14206	1005	78484	302	534	0	80325
14207	77213	1034	197	582	0	79026
14208	1188	556	189	76539	0	78472
14209	707	501	79044	1259	0	81511
14210	530	261	972	82438	0	84201
14211	467	279	491	89154	0	90391
14212	390	422	88216	2071	0	91099
14213	82585	243	1461	1195	0	85484
14214	1566	89860	785	659	0	92870
14215	89536	1501	275	660	0	91972
14216	1668	92490	348	538	0	95044
14217	915	1705	269	98341	0	101230
14218	510	914	97557	2087	0	101068
14219	118034	413	1850	1286	0	121583
14220	2721	124409	932	672	0	128734
14221	1552	2703	305	122676	0	127236
14222	781	1276	264	128692	0	131013
14223	135840	558	237	3964	0	140599
14224	141702	373	241	1843	0	144159
14225	4445	145050	380	852	0	150727
14226	151584	3460	273	708	0	156025
14227	152714	1610	273	699	0	155296
14228	154950	733	265	725	0	156673
14229	5877	626	150906	563	0	157972
14230	2527	148035	3713	717	0	154992
14231	995	156782	1975	653	0	160405
14232	1113	5346	638	144612	0	151709
14233	971	2404	394	153684	0	157453
14234	152809	901	355	5360	0	159425
14235	4129	152371	498	2401	0	159399
14236	154500	4097	312	1084	0	159993
14237	4634	2184	337	151265	0	158420
14238	2534	853	363	154973	0	158723
14239	151417	619	353	5809	0	158198
14240	151507	593	382	2655	0	155137
14241	5946	796	146828	1131	0	154701
14242	3092	771	3698	145005	0	152566
14243	1294	658	144361	4090	0	150403
14244	1027	693	143263	2264	0	147247
14245	1082	695	145456	945	0	148178
14246	138864	630	5711	861	0	146066
14247	4329	596	2398	137850	0	145173
14248	2646	522	855	135819	0	139842
14249	1375	546	603	143147	0	145671
14250	978	668	139071	5701	0	146418
14251	1322	495	3709	139008	0	144534
14252	1327	617	1937	142066	0	145947
14253	139803	559	756	5645	0	146763
14254	142592	620	529	2735	0	146476
14255	145498	539	464	1422	0	147923
14256	145637	583	562	1180	0	147962
14257	6763	724	515	139285	0	147287
14258	141618	735	612	4527	0	147492
14259	5427	804	455	140560	0	147246
14260	3383	917	132892	4786	0	141978
14261	135135	788	3505	2883	0	142311
14262	5213	136016	2116	1505	0	144850
14263	3565	4058	940	134513	0	143076
14264	2348	2562	706	133352	0	138968
14265	1761	136687	919	5727	0	145094
14266	135832	4175	757	3217	0	143981
14267	5047	134404	812	2253	0	142516
14268	3336	4288	133786	1535	0	142945
14269	2071	2362	135282	1604	0	141319
14270	131785	1120	5626	1684	0	140215
14271	136657	993	2674	1732	0	142056
14272	6504	969	132381	1553	0	141407
14273	132926	849	4248	1699	0	139722
14274	5658	914	132981	1724	0	141277
14275	132910	753	4647	1806	0	140116
14276	5701	971	132769	1950	0	141391
14277	3748	831	134838	1955	0	141372
14278	2698	903	6021	123568	0	133190
14279	2561	805	3139	130956	0	137461
14280	132095	719	1697	6610	0	141121
14281	132639	722	1298	3782	0	138441
14282	135404	685	1383	2294	0	139766
14283	135553	851	1149	2197	0	139750
14284	7463	129079	1599	2168	0	140309
14285	4744	3882	1223	124073	0	133922
14286	3003	130295	1548	5098	0	139944
14287	3170	4174	1367	132395	0	141106
14288	2933	2491	1313	133484	0	140221
14289	3176	1427	1258	133981	0	139842
14290	2873	1302	127206	7220	0	138601
14291	122130	980	4415	4469	0	131994
14292	5840	120747	2804	3000	0	132391
14293	4081	128184	1669	2664	0	136598
14294	3267	5600	128100	2350	0	139317
14295	3006	2654	4595	127455	0	137710
14296	2810	1331	3150	131142	0	138433
14297	129084	995	1948	6968	0	138995
14298	6071	1037	1782	128701	0	137591
14299	4418	1011	1817	131268	0	138514
14300	3149	901	1760	132973	0	138783
14301	2861	910	2001	134403	0	140175
14302	129145	720	1968	7253	0	139086
14303	131754	711	2215	3978	0	138658
14304	133706	667	2008	2704	0	139085
14305	7724	684	1916	130873	0	141197
14306	131780	626	1893	5942	0	140241
14307	6386	544	1735	133172	0	141837
14308	4645	719	1889	136256	0	143509
14309	3445	655	128840	7053	0	139993
14310	2937	647	124037	4038	0	131659
14311	2822	707	121427	2350	0	127306
14312	118004	686	6168	2131	0	126989
14313	5532	932	3356	107295	0	117115
14314	3893	115163	1886	4682	0	125624
14315	118224	3325	1564	3350	0	126463
14316	5433	1987	113626	2349	0	123395
14317	105587	833	3646	2061	0	112127
14318	4761	100804	2679	1833	0	110077
14319	78432	1865	820	1016	0	82133
14320	3252	1233	560	77408	0	82453
14321	76636	448	612	2479	0	80175
14322	2660	72987	667	1842	0	78156
14323	1684	71704	590	1069	0	75047
14324	63069	1905	596	718	0	66288
14325	1625	63864	489	695	0	66673
14326	785	56360	285	412	0	57842
14327	683	57845	476	385	0	59389
14328	55475	1432	1071	473	0	58451
14329	54064	528	217	332	0	55141
14330	54150	242	120	274	0	54786
14331	1282	197	131	52951	0	54561
14332	679	174	133	53767	0	54753
14333	373	230	52677	1152	0	54432
14334	400	148	758	52472	0	53778
14335	417	202	54167	902	0	55688
14336	391	146	793	53920	0	55250
14337	332	128	434	55323	0	56217
14338	54491	142	230	1233	0	56096
14339	54018	143	178	686	0	55025
14340	1168	54132	239	396	0	55935
14341	652	772	173	54498	0	56095
14342	356	542	56792	886	0	58576
14343	377	243	752	56658	0	58030
14344	404	183	423	57659	0	58669
14345	426	200	165	58431	0	59222
14346	339	242	57315	1218	0	59114
14347	293	206	52888	634	0	54021
14348	54615	117	1013	438	0	56183
14349	908	187	459	57400	0	58954
14350	545	168	56510	952	0	58175
14351	52512	144	776	657	0	54089
14352	792	57140	498	416	0	58846
14353	57918	687	224	409	0	59238
14354	891	486	59116	323	0	60816
14355	57434	184	695	371	0	58684
14356	872	181	421	59571	0	61045
14357	584	264	61788	735	0	63371
14358	290	61275	718	544	0	62827
14359	62129	652	500	395	0	63676
14360	822	440	233	62161	0	63656
14361	518	158	170	62364	0	63210
14362	238	63603	252	1027	0	65120
14363	279	623	209	64340	0	65451
14364	404	444	63531	806	0	65185
14365	206	63255	723	599	0	64783
14366	63878	585	401	415	0	65279
14367	746	429	195	63566	0	64936
14368	544	199	139	63353	0	64235
14369	329	215	62661	971	0	64176
14370	349	267	623	62383	0	63622
14371	442	269	65717	772	0	67200
14372	238	65313	708	566	0	66825
14373	64769	546	474	440	0	66229
14374	64785	355	213	391	0	65744
14375	64872	149	194	359	0	65574
14376	893	68194	248	266	0	69601
14377	531	537	169	68378	0	69615
14378	324	371	147	68581	0	69423
14379	268	195	146	64837	0	65446
14380	67834	132	153	1016	0	69135
14381	67428	157	128	596	0	68309
14382	905	145	133	67582	0	68765
14383	566	264	72367	712	0	73909
14384	346	148	540	71940	0	72974
14385	337	120	367	73081	0	73905
14386	287	133	168	73097	0	73685
14387	312	112	161	73336	0	73921
14388	73015	125	145	1162	0	74447
14389	675	143	143	74877	0	75838
14390	517	91	124	74609	0	75341
14391	229	74451	195	1072	0	75947
14392	239	597	108	76928	0	77872
14393	203	78042	179	905	0	79329
14394	225	746	120	78281	0	79372
14395	77408	443	103	1062	0	79016
14396	739	78039	194	710	0	79682
14397	76582	740	100	522	0	77944
14398	918	581	77925	331	0	79755
14399	632	162	733	76856	0	78383
14400	340	253	79105	998	0	80696
14401	277	131	815	78984	0	80207
14402	269	193	487	78307	0	79256
14403	184	78088	297	1239	0	79808
14404	201	79172	179	733	0	80285
14405	168	79374	181	338	0	80061
14406	77590	828	109	433	0	78960
14407	563	75794	130	285	0	76772
14408	277	75549	111	261	0	76198
14409	554	785	120	76358	0	77817
14410	76494	269	54	748	0	77565
14411	479	80520	131	425	0	81555
14412	81831	479	59	432	0	82801
14413	81438	291	91	361	0	82181
14414	736	289	84906	218	0	86149
14415	421	126	508	82397	0	83452
14416	231	114	268	87058	0	87671
14417	172	111	98	87592	0	87973
14418	205	114	99	86608	0	87026
14419	163	237	83072	793	0	84265
14420	193	255	72668	359	0	73475
14421	74825	131	601	373	0	75930
14422	448	81762	318	188	0	82716
14423	280	82237	142	180	0	82839
14424	82332	615	69	330	0	83346
14425	453	80432	141	239	0	81265
14426	354	484	65	80555	0	81458
14427	80359	315	67	708	0	81449
14428	536	257	79399	393	0	80585
14429	368	137	454	80127	0	81086
14430	169	271	80997	581	0	82018
14431	76949	132	482	555	0	78118
14432	599	320	89162	207	0	90288
14433	89653	139	488	504	0	90784
14434	94857	118	349	583	0	95907
14435	95056	122	100	434	0	95712
14436	95316	121	97	384	0	95918
14437	95529	124	89	357	0	96099
14438	867	116	102	95407	0	96492
14439	98468	121	100	949	0	99638
14440	649	119	110	98906	0	99784
14441	488	129	95	98758	0	99470
14442	273	142	98	98627	0	99140
14443	244	297	98457	917	0	99915
14444	297	142	530	96068	0	97037
14445	263	157	348	100147	0	100915
14446	233	313	97655	930	0	99131
14447	87668	162	556	718	0	89104
14448	690	128	345	100082	0	101245
14449	507	332	100189	661	0	101689
14450	276	283	97364	473	0	98396
14451	303	152	809	97809	0	99073
14452	292	278	99601	741	0	100912
14453	294	159	603	99565	0	100621
14454	303	135	393	98945	0	99776
14455	177	98574	257	944	0	99952
14456	209	100222	220	541	0	101192
14457	99723	760	140	527	0	101150
14458	705	396	141	100699	0	101941
14459	580	154	122	99331	0	100187
14460	326	118	109	102082	0	102635
14461	268	349	102147	1054	0	103818
14462	288	106	615	100358	0	101367
14463	100425	122	445	1046	0	102038
14464	801	314	103274	610	0	104999
14465	622	119	652	105906	0	107299
14466	347	110	447	107615	0	108519
14467	307	120	207	108101	0	108735
14468	178	113612	324	1181	0	115295
14469	114013	859	203	884	0	115959
14470	117743	436	197	583	0	118959
14471	1593	121320	302	344	0	123559
14472	841	1058	151	127335	0	129385
14473	363	740	127870	1433	0	130406
14474	345	372	125369	842	0	126928
14475	128179	138	2105	567	0	130989
14476	1764	147	914	132244	0	135069
14477	137225	114	333	1972	0	139644
14478	1964	139997	350	1161	0	143472
14479	1102	142908	325	519	0	144854
14480	141373	2769	161	591	0	144894
14481	1946	147169	344	354	0	149813
14482	1283	2083	191	148353	0	151910
14483	570	1126	198	140638	0	142532
14484	302	152468	386	2851	0	156007
14485	153659	2126	249	1664	0	157698
14486	2404	1455	155036	504	0	159399
14487	147868	375	2178	768	0	151189
14488	2594	484	157951	347	0	161376
14489	144115	212	2468	753	0	147548
14490	2658	504	159171	405	0	162738
14491	1404	156096	2664	435	0	160599
14492	968	2364	1437	156001	0	160770
14493	155066	1164	486	2446	0	159162
14494	2387	510	153766	1313	0	157976
14495	1447	405	154270	453	0	156575
14496	686	215	3200	150010	0	154111
14497	473	406	154829	2267	0	157975
14498	560	197	2388	151714	0	154859
14499	555	188	1307	151575	0	153625
14500	413	479	152487	3337	0	156716
14501	524	228	2249	151409	0	154410
14502	153797	165	1424	2835	0	158221
14503	2217	153278	737	1555	0	157787
14504	155105	2120	401	942	0	158568
14505	2616	1280	354	152847	0	157097
14506	154188	399	348	2639	0	157574
14507	156792	276	356	1788	0	159212
14508	3605	311	383	151701	0	156000
14509	1690	156852	538	2248	0	161328
14510	158417	2143	482	1729	0	162771
14511	2583	1499	153200	704	0	157986
14512	1573	718	151543	611	0	154445
14513	149890	346	3314	715	0	154265
14514	2596	261	1567	149538	0	153962
14515	1615	591	150419	2436	0	155061
14516	896	320	2437	150473	0	154126
14517	150794	291	1484	2896	0	155465
14518	152868	320	649	1865	0	155702
14519	152251	311	534	965	0	154061
14520	3562	155287	655	673	0	160177
14521	1985	2269	412	156253	0	160919
14522	1056	1444	401	157509	0	160410
14523	156162	573	385	3782	0	160902
14524	2601	156572	606	1816	0	161595
14525	156831	2356	445	1070	0	160702
14526	3076	1440	401	155466	0	160383
14527	155236	582	446	2781	0	159045
14528	2948	732	151276	1576	0	156532
14529	1734	152032	2541	852	0	157159
14530	1310	2452	1500	143416	0	148678
14531	783	155548	903	2134	0	159368
14532	975	2547	529	147644	0	151695
14533	145797	1362	548	2825	0	150532
14534	2716	842	141058	1534	0	146150
14535	137286	447	2406	1023	0	141162
14536	2771	143792	1727	736	0	149026
14537	1906	2328	813	145739	0	150786
14538	1100	1405	551	148307	0	151363
14539	143438	569	584	3802	0	148393
14540	2752	760	143532	1877	0	148921
14541	1974	418	2469	144647	0	149508
14542	1166	472	1525	145223	0	148386
14543	1075	397	777	144863	0	147112
14544	1031	416	628	146072	0	148147
14545	142011	443	608	4028	0	147090
14546	142187	423	586	2301	0	145497
14547	3862	600	141434	1073	0	146969
14548	2057	734	136369	919	0	140079
14549	141032	424	3330	1177	0	145963
14550	146828	433	1623	1166	0	150050
14551	3905	445	758	144995	0	150103
14552	2224	352	659	146291	0	149526
14553	143464	369	674	3975	0	148482
14554	2800	143353	942	2046	0	149141
14555	2088	2183	648	144369	0	149288
14556	1214	1258	635	146789	0	149896
14557	1051	790	142674	3869	0	148384
14558	1139	362	2447	143210	0	147158
14559	1057	664	144513	3117	0	149351
14560	1061	409	2633	143993	0	148096
14561	140299	387	1528	3249	0	145463
14562	2966	358	701	142683	0	146708
14563	1989	516	140590	3065	0	146160
14564	1071	133209	2619	2281	0	139180
14565	1238	2212	1450	139220	0	144120
14566	1125	1497	139260	2816	0	144698
14567	931	139863	2518	2103	0	145415
14568	1151	2330	1336	136447	0	141264
14569	921	1547	134641	2577	0	139686
14570	105458	501	2174	2173	0	110306
14571	2159	127807	1477	1664	0	133107
14572	1367	123260	655	752	0	126034
14573	677	126540	560	762	0	128539
14574	1175	3438	477	119669	0	124759
14575	705	1287	125588	1975	0	129555
14576	487	124800	1982	1356	0	128625
14577	1077	2530	1218	121934	0	126759
14578	130970	958	428	2117	0	134473
14579	2282	379	232	172622	0	175515
14580	1790	459	194558	3838	0	200645
14581	591	194518	4067	2146	0	201322
14582	188243	3967	1905	1139	0	195254
14583	3904	193541	866	879	0	199190
14584	2449	4417	183092	667	0	190625
14585	647	185951	4080	626	0	191304
14586	1046	4920	2320	179091	0	187377
14587	660	2436	179431	3749	0	186276
14588	431	178230	4161	2092	0	184914
14589	779	4203	1936	174012	0	180930
14590	570	2323	898	173455	0	177246
14591	206	175704	935	5296	0	182141
14592	479	4244	608	177785	0	183116
14593	332	2458	176054	4524	0	183368
14594	324	1397	179001	2378	0	183100
14595	498	926	5392	177164	0	183980
14596	176947	737	2322	4849	0	184855
14597	178687	706	972	2790	0	183155
14598	5386	767	759	173048	0	179960
14599	2168	176066	1080	4440	0	183754
14600	1087	4107	960	177523	0	183677
14601	175181	2062	959	5019	0	183221
14602	4546	1051	676	175513	0	181786
14603	2762	901	547	177601	0	181811
14604	173108	938	628	6360	0	181034
14605	4197	172133	997	3187	0	180514
14606	2660	4427	689	170465	0	178241
14607	171114	2365	545	5094	0	179118
14608	4588	1273	167719	2955	0	176535
14609	167704	900	4025	1961	0	174590
14610	4973	879	1987	169624	0	177463
14611	171178	912	861	5203	0	178154
14612	172347	931	668	3266	0	177212
14613	163833	802	821	2115	0	167571
14614	6201	166065	1074	1637	0	174977
14615	3259	4216	166251	1368	0	175094
14616	1844	169090	4524	1303	0	176761
14617	166142	4583	2235	1510	0	174470
14618	5207	168235	1165	1233	0	175840
14619	3558	4849	722	167765	0	176894
14620	163738	2695	763	4881	0	172077
14621	4770	164208	1057	2899	0	172934
14622	2922	5184	164620	1619	0	174345
14623	2064	2943	4175	164250	0	173432
14624	1566	1791	165752	5140	0	174249
14625	1286	165182	4904	3889	0	175261
14626	1551	5022	2391	163155	0	172119
14627	1649	2927	1272	166541	0	172389
14628	1556	1664	1184	168290	0	172694
14629	1639	1230	1299	162392	0	166560
14630	1196	163161	1383	6999	0	172739
14631	161438	4740	1079	3787	0	171044
14632	4977	3006	161297	2516	0	171796
14633	3168	1603	4621	162313	0	171705
14634	161062	1481	2586	5848	0	170977
14635	5421	1739	161582	3551	0	172293
14636	3046	159704	5014	2267	0	170031
14637	2148	5480	2871	156623	0	167122
14638	1920	3445	159654	5183	0	170202
14639	1468	160527	5396	3569	0	170960
14640	154261	5236	2953	2559	0	165009
14641	4909	160459	1907	2020	0	169295
14642	3108	5749	1418	156518	0	166793
14643	1900	3444	1298	162685	0	169327
14644	156990	2129	1387	7443	0	167949
14645	4797	157385	1885	4330	0	168397
14646	3199	5466	1681	158824	0	169170
14647	155726	3392	1572	6068	0	166758
14648	155418	2103	1273	4315	0	163109
14649	6856	153762	1322	3030	0	164970
14650	155204	5380	1000	2663	0	164247
14651	157024	3457	904	2418	0	163803
14652	7493	2431	954	153147	0	164025
14653	4083	2040	151291	6136	0	163550
14654	3081	1678	4623	150279	0	159661
14655	2820	1500	2604	153859	0	160783
14656	2288	1755	148829	7782	0	160654
14657	2191	146799	5177	4542	0	158709
14658	2503	5257	2712	146966	0	157438
14659	2045	2999	1727	151958	0	158729
14660	2066	1712	1697	154003	0	159478
14661	2021	1510	1538	148203	0	153272
14662	2070	147863	1649	7703	0	159285
14663	149457	4915	1106	4675	0	160153
14664	151513	2765	874	3512	0	158664
14665	149640	1729	681	3126	0	155176
14666	7339	142396	1089	2975	0	153799
14667	4106	5303	787	142056	0	152252
14668	2570	3370	141657	6014	0	153611
14669	2722	2505	4338	137011	0	146576
14670	2740	143105	2654	5526	0	154025
14671	140461	4973	1049	3344	0	149827
14672	141835	2994	827	2673	0	148329
14673	140602	1842	1124	2430	0	145998
14674	6723	137888	1604	2271	0	148486
14675	3334	132115	1669	1999	0	139117
14676	2195	135272	1472	2272	0	141211
14677	2589	5799	130202	1845	0	140435
14678	2844	4673	116674	2209	0	126400
14679	3666	11662	3753	63334	0	82415
14680	53645	266	1714	1275	0	56900
14681	53484	244	226	764	0	54718
14682	1330	246	160	54451	0	56187
14683	627	236	179	54090	0	55132
14684	367	243	169	55460	0	56239
14685	355	253	156	55705	0	56469
14686	55195	247	121	1517	0	57080
14687	56094	249	111	825	0	57279
14688	1405	57235	182	440	0	59262
14689	58385	1103	122	506	0	60116
14690	58920	597	148	431	0	60096
14691	59568	305	150	387	0	60410
14692	1672	388	49835	349	0	52244
14693	56277	220	707	375	0	57579
14694	1185	58172	436	333	0	60126
14695	745	1050	154	59774	0	61723
14696	419	564	155	59553	0	60691
14697	318	58601	221	1568	0	60708
14698	371	1154	173	61184	0	62882
14699	60310	574	229	1466	0	62579
14700	1300	253	187	61475	0	63215
14701	761	269	60231	1400	0	62661
14702	57189	274	1027	892	0	59382
14703	1225	61462	562	496	0	63745
14704	787	1215	172	62199	0	64373
14705	489	573	129	63197	0	64388
14706	466	292	106	63768	0	64632
14707	485	290	61720	1829	0	64324
14708	461	60819	1084	911	0	63275
14709	552	1130	442	61365	0	63489
14710	502	686	60074	1219	0	62481
14711	518	292	979	59372	0	61161
14712	430	320	59382	1283	0	61415
14713	488	333	1081	56983	0	58885
14714	370	58367	606	1224	0	60567
14715	404	1074	215	57727	0	59420
14716	57463	584	163	1369	0	59579
14717	57562	258	163	826	0	58809
14718	1612	286	56874	459	0	59231
14719	642	265	53819	353	0	55079
14720	346	287	60089	352	0	61074
14721	353	175	1395	60098	0	62021
14722	320	151	626	63514	0	64611
14723	288	197	237	63476	0	64198
14724	216	64401	256	1845	0	66718
14725	346	1193	168	64223	0	65930
14726	351	644	168	66693	0	67856
14727	348	268	198	68373	0	69187
14728	67172	205	192	2061	0	69630
14729	67762	229	255	1070	0	69316
14730	1802	271	68002	541	0	70616
14731	858	271	67185	465	0	68779
14732	66717	207	1770	555	0	69249
14733	70378	173	797	544	0	71892
14734	1973	219	72159	430	0	74781
14735	938	240	70776	380	0	72334
14736	69823	205	1866	472	0	72366
14737	71942	159	815	487	0	73403
14738	1962	232	72072	458	0	74724
14739	966	178	1384	70937	0	73465
14740	470	168	809	71650	0	73097
14741	322	74757	490	1946	0	77515
14742	397	1390	306	76410	0	78503
14743	396	789	79863	1824	0	82872
14744	435	290	1619	80222	0	82566
14745	455	192	886	81583	0	83116
14746	342	272	79650	2426	0	82690
14747	76498	153	1672	1372	0	79695
14748	81076	168	930	731	0	82905
14749	2431	139	422	79596	0	82588
14750	1203	163	340	81294	0	83000
14751	80267	160	362	2534	0	83323
14752	80339	155	409	1301	0	82204
14753	77635	169	396	755	0	78955
14754	81258	157	335	649	0	82399
14755	2420	78544	486	557	0	82007
14756	77285	1466	359	592	0	79702
14757	1789	77959	390	561	0	80699
14758	1152	1553	327	77771	0	80803
14759	637	767	317	77562	0	79283
14760	410	76181	475	2399	0	79465
14761	538	1462	366	77885	0	80251
14762	590	787	302	76254	0	77933
14763	455	75763	484	2478	0	79180
14764	580	1502	381	76937	0	79400
14765	618	821	347	77746	0	79532
14766	601	308	386	78115	0	79410
14767	494	324	75120	2670	0	78608
14768	510	72904	1677	1477	0	76568
14769	731	1869	920	66555	0	70075
14770	490	72570	591	1613	0	75264
14771	71109	1405	460	1145	0	74119
14772	1730	921	70957	704	0	74312
14773	1112	408	69262	670	0	71452
14774	64782	311	1899	630	0	67622
14775	1754	497	999	66459	0	69709
14776	986	238	64769	1547	0	67540
14777	612	315	63850	944	0	65721
14778	730	809	1747	61694	0	64980
14779	61325	252	864	1561	0	64002
14780	61756	270	369	1013	0	63408
14781	1881	237	300	60584	0	63002
14782	927	287	59114	1577	0	61905
14783	526	61328	1268	1151	0	64273
14784	585	1169	727	61081	0	63562
14785	482	720	61186	1518	0	63906
14786	403	60687	1251	1087	0	63428
14787	573	1147	708	59642	0	62070
14788	59702	627	362	1640	0	62331
14789	1261	330	320	57458	0	59369
14790	787	58809	397	1457	0	61450
14791	58860	1054	353	1107	0	61374
14792	1244	775	61188	672	0	63879
14793	807	60144	1202	628	0	62781
14794	547	1133	60131	577	0	62388
14795	57348	643	1270	613	0	59874
14796	1331	322	809	56725	0	59187
14797	906	226	484	59738	0	61354
14798	59389	177	429	1691	0	61686
14799	1304	200	437	59673	0	61614
14800	831	316	58415	1375	0	60937
14801	54007	214	1170	1016	0	56407
14802	1279	57974	829	738	0	60820
14803	963	944	399	57332	0	59638
14804	56966	578	375	1363	0	59282
14805	1223	56305	404	995	0	58927
14806	912	1064	327	57963	0	60266
14807	58159	677	326	1374	0	60536
14808	1220	362	302	58022	0	59906
14809	732	57764	405	1430	0	60331
14810	483	1180	59093	968	0	61724
14811	544	654	1008	60797	0	63003
14812	589	354	648	59962	0	61553
14813	61433	278	321	1843	0	63875
14814	1289	274	265	61891	0	63719
14815	61972	308	283	1441	0	64004
14816	62225	294	284	1050	0	63853
14817	1731	303	271	60157	0	62462
14818	850	61726	361	1316	0	64253
14819	634	1111	209	60822	0	62776
14820	56084	624	218	1362	0	58288
14821	1170	56758	266	937	0	59131
14822	616	58217	218	430	0	59481
14823	58917	1204	168	549	0	60838
14824	58917	561	216	448	0	60142
14825	1334	59391	276	364	0	61365
14826	59785	999	254	440	0	61478
14827	59299	526	223	391	0	60439
14828	1470	274	147	59163	0	61054
14829	643	313	61725	1129	0	63810
14830	406	262	1096	61544	0	63308
14831	355	256	63632	1214	0	65457
14832	344	268	1063	63346	0	65021
14833	276	234	63742	1176	0	65428
14834	59884	118	1024	731	0	61757
14835	1099	123	630	61287	0	63139
14836	63505	104	211	1173	0	64993
14837	1244	269	183	61136	0	62832
14838	755	63352	160	1069	0	65336
14839	64750	970	118	866	0	66704
14840	1198	652	61940	255	0	64045
14841	59094	251	773	243	0	60361
14842	894	61258	546	150	0	62848
14843	58262	689	115	196	0	59262
14844	58291	424	66	167	0	58948
14845	1132	58737	115	117	0	60101
14846	591	774	48	60651	0	62064
14847	60266	456	66	931	0	61719
14848	883	60548	108	537	0	62076
14849	580	867	49	61297	0	62793
14850	61469	478	64	1019	0	63030
14851	994	131	58	61839	0	63022
14852	620	107	63	62173	0	62963
14853	264	93	64	62786	0	63207
14854	227	158	60659	1435	0	62479
14855	262	100	835	60990	0	62187
14856	61359	97	488	1116	0	63060
14857	993	149	62062	632	0	63836
14858	684	85	886	62347	0	64002
14859	302	92	506	63795	0	64695
14860	202	168	62284	1424	0	64078
14861	58675	104	900	780	0	60459
14862	64133	108	545	357	0	65143
14863	1500	149	63832	244	0	65725
14864	770	109	949	62753	0	64581
14865	364	94	533	65580	0	66571
14866	265	148	68839	1526	0	70778
14867	327	111	965	69125	0	70528
14868	294	99	573	70228	0	71194
14869	283	218	71118	1654	0	73273
14870	67798	113	1092	895	0	69898
14871	1204	107	632	72554	0	74497
14872	72614	89	216	1367	0	74286
14873	72813	99	207	881	0	74000
14874	1846	187	72808	471	0	75312
14875	894	110	1082	72075	0	74161
14876	73175	61	658	1406	0	75300
14877	1224	75312	363	966	0	77865
14878	894	1159	188	78806	0	81047
14879	418	598	212	80416	0	81644
14880	397	164	193	82251	0	83005
14881	321	220	80316	2094	0	82951
14882	70933	94	1371	1203	0	73601
14883	1474	102	730	78532	0	80838
14884	961	97	291	79176	0	80525
14885	457	156	78208	2085	0	80906
14886	439	111	1272	78112	0	79934
14887	394	122	769	79967	0	81252
14888	77449	103	344	2200	0	80096
14889	1415	76936	321	1173	0	79845
14890	887	1228	76731	595	0	79441
14891	76061	638	1320	561	0	78580
14892	1560	205	773	75622	0	78160
14893	943	183	76514	1566	0	79206
14894	482	186	77061	1019	0	78748
14895	517	168	1798	77659	0	80142
14896	400	193	79911	1596	0	82100
14897	429	171	79843	1093	0	81536
14898	359	75549	1928	742	0	78578
14899	437	1206	910	83017	0	85570
14900	424	733	83814	1622	0	86593
14901	446	222	1376	81758	0	83802
14902	86928	145	845	1890	0	89808
14903	1465	116	435	87895	0	89911
14904	994	109	366	89731	0	91200
14905	86236	130	355	2324	0	89045
14906	88404	135	346	1393	0	90278
14907	2101	132	362	92341	0	94936
14908	1025	247	93727	1799	0	96798
14909	468	92312	1588	1241	0	95609
14910	453	1322	920	93074	0	95769
14911	91641	695	466	1877	0	94679
14912	92490	221	378	1288	0	94377
14913	2118	90898	490	728	0	94234
14914	1006	94098	505	661	0	96270
14915	93925	1811	381	704	0	96821
14916	93655	799	407	717	0	95578
14917	2165	367	96091	684	0	99307
14918	1172	231	1514	91951	0	94868
14919	479	97322	1059	1645	0	100505
14920	99951	1305	553	1226	0	103035
14921	1683	881	383	98343	0	101290
14922	991	96827	473	1743	0	100034
14923	580	1434	97416	1133	0	100563
14924	632	1339	1435	91116	0	94522
14925	382	100587	965	1572	0	103506
14926	100535	1245	445	1156	0	103381
14927	100859	739	362	794	0	102754
14928	1870	100636	382	626	0	103514
14929	97457	1157	269	625	0	99508
14930	96693	599	289	581	0	98162
14931	1680	95426	336	549	0	97991
14932	798	97273	387	491	0	98949
14933	644	1579	372	95140	0	97735
14934	94150	651	224	1451	0	96476
14935	1316	424	98065	795	0	100600
14936	90637	232	1098	590	0	92557
14937	1205	98859	649	492	0	101205
14938	99601	1066	289	570	0	101526
14939	100281	577	276	467	0	101601
14940	100579	276	231	563	0	101649
14941	1748	286	270	97180	0	99484
14942	824	98335	356	1184	0	100699
14943	98616	1067	241	875	0	100799
14944	1260	755	99607	471	0	102093
14945	767	99510	1127	425	0	101829
14946	526	985	542	102717	0	104770
14947	428	668	100094	1029	0	102219
14948	425	425	101349	615	0	102814
14949	471	252	1286	98756	0	100765
14950	474	283	585	105437	0	106779
14951	462	232	283	106791	0	107768
14952	482	250	233	104825	0	105790
14953	375	101423	295	1479	0	103572
14954	359	105679	309	758	0	107105
14955	106185	1340	197	527	0	108249
14956	1241	667	197	106237	0	108342
14957	830	327	199	106302	0	107658
14958	525	306	197	108022	0	109050
14959	105780	287	208	1656	0	107931
14960	107571	269	198	889	0	108927
14961	1657	286	163	107373	0	109479
14962	108281	255	183	1279	0	109998
14963	108109	242	184	807	0	109342
14964	109491	262	189	590	0	110532
14965	1704	314	167	106888	0	109073
14966	851	358	101148	968	0	103325
14967	577	343	96231	625	0	97776
14968	458	339	101433	357	0	102587
14969	466	327	105396	279	0	106468
14970	470	332	1197	104277	0	106276
14971	105623	217	657	997	0	107494
14972	104848	192	262	710	0	106012
14973	1279	276	105365	326	0	107246
14974	723	330	105308	347	0	106708
14975	353	113170	1128	342	0	114993
14976	443	817	531	114333	0	116124
14977	113826	469	391	1035	0	115721
14978	869	328	113414	518	0	115129
14979	108319	166	689	450	0	109624
14980	804	117740	487	289	0	119320
14981	550	688	163	120783	0	122184
14982	343	445	153	124462	0	125403
14983	344	188	137	124514	0	125183
14984	125112	143	132	1615	0	127002
14985	1102	148	136	126268	0	127654
14986	771	144	123	127116	0	128154
14987	126707	136	131	1568	0	128542
14988	1118	151	137	126493	0	127899
14989	737	269	127476	1132	0	129614
14990	124004	156	929	866	0	125955
14991	1126	161	578	129198	0	131063
14992	833	130	236	127328	0	128527
14993	378	127722	275	1387	0	129762
14994	129546	866	134	945	0	131491
14995	130165	574	178	653	0	131570
14996	1649	240	187	128171	0	130247
14997	861	311	127415	1097	0	129684
14998	117783	145	1062	931	0	119921
14999	1237	291	127983	447	0	129958
15000	823	124	1152	125427	0	127526
15001	495	127	662	129531	0	130815
15002	127483	131	273	1854	0	129741
15003	1455	96	232	132317	0	134100
15004	817	235	132232	1416	0	134700
15005	126605	100	1289	1062	0	129056
15006	1470	235	138060	516	0	140281
15007	906	274	135108	384	0	136672
15008	136127	67	2022	547	0	138763
15009	1821	521	867	141188	0	144397
15010	839	149752	486	1287	0	152364
15011	151001	1307	360	1006	0	153674
15012	151017	648	278	599	0	152542
15013	2200	391	149678	350	0	152619
15014	148219	141	1491	546	0	150397
15015	1827	133	803	151055	0	153818
15016	1025	298	156086	1570	0	158979
15017	451	153228	1536	1088	0	156303
15018	152583	1317	838	700	0	155438
15019	1482	155915	461	499	0	158357
15020	1014	1392	301	155230	0	157937
15021	553	665	199	156712	0	158129
15022	506	263	212	157438	0	158419
15023	432	167	206	154053	0	154858
15024	324	154486	314	2217	0	157341
15025	479	1426	148714	1160	0	151779
15026	311	150925	1462	689	0	153387
15027	150972	1409	753	611	0	153745
15028	1602	753	342	151042	0	153739
15029	151908	294	287	1684	0	154173
15030	1780	282	275	152419	0	154756
15031	156318	144	297	2024	0	158783
15032	1708	158871	421	1034	0	162034
15033	163488	1352	310	909	0	166059
15034	164676	694	275	728	0	166373
15035	161285	313	291	635	0	162524
15036	163258	217	269	667	0	164411
15037	2364	161450	328	479	0	164621
15038	1272	1542	162081	396	0	165291
15039	808	790	1447	162680	0	165725
15040	163622	288	806	1797	0	166513
15041	167392	225	419	1076	0	169112
15042	2370	214	308	171079	0	173971
15043	1286	425	174272	1924	0	177907
15044	773	237	1730	168966	0	171706
15045	563	172970	1047	2054	0	176634
15046	173851	1762	403	1355	0	177371
15047	2196	995	321	173237	0	176749
15048	1202	170630	421	2065	0	174318
15049	662	179669	424	1242	0	181997
15050	493	182835	387	798	0	184513
15051	640	2886	300	183804	0	187630
15052	184678	1238	230	2505	0	188651
15053	2334	186769	386	1347	0	190836
15054	1485	2242	256	189195	0	193178
15055	188599	1144	243	2628	0	192614
15056	2579	533	260	189638	0	193010
15057	189272	369	230	2786	0	192657
15058	189967	336	245	1613	0	192161
15059	3287	196074	461	859	0	200681
15060	2084	2285	268	185526	0	190163
15061	932	198715	408	1906	0	201961
15062	197348	2382	298	1321	0	201349
15063	198401	1190	312	900	0	200803
15064	202011	547	328	897	0	203783
15065	3749	435	327	200426	0	204937
15066	1838	645	198792	2469	0	203744
15067	192499	455	2222	1653	0	196829
15068	200451	481	1101	1014	0	203047
15069	3665	525	462	194195	0	198847
15070	1860	200820	483	2492	0	205655
15071	1260	2375	302	202421	0	206358
15072	976	1426	314	205746	0	208462
15073	203883	804	356	3487	0	208530
15074	201701	647	292	1962	0	204602
15075	3595	786	193017	1067	0	198465
15076	2001	611	2186	192330	0	197128
15077	195590	585	1056	2856	0	200087
15078	3068	613	443	197083	0	201207
15079	1847	821	197595	3100	0	203363
15080	1128	187178	2390	1996	0	192692
15081	979	196603	1243	1068	0	199893
15082	211525	3055	484	1094	0	216158
15083	3447	1529	294	219869	0	225139
15084	2107	760	247	238688	0	241802
15085	233599	637	331	5311	0	239878
15086	4501	829	234689	2493	0	242512
15087	2699	573	3509	235144	0	241925
15088	1766	691	238106	4225	0	244788
15089	1112	238770	4109	2492	0	246483
15090	246865	3811	1895	1710	0	254281
15091	252017	1963	847	1273	0	256100
15092	254920	1024	527	1179	0	257650
15093	6419	959	246060	1053	0	254491
15094	248099	707	3656	1058	0	253520
15095	255338	605	1929	1067	0	258939
15096	6448	584	843	251879	0	259754
15097	217565	746	1620	4664	0	224595
15098	4147	897	246729	2350	0	254123
15099	239001	610	3611	1621	0	244843
15100	5273	719	247819	1116	0	254927
15101	2998	251625	4006	1163	0	259792
15102	2082	5164	2267	231761	0	241274
15103	1630	250750	1230	3528	0	257138
15104	1978	4033	245939	1975	0	253925
15105	1382	250816	3702	1401	0	257301
15106	237602	3763	1806	1218	0	244389
15107	3622	236841	1190	1063	0	242716
15108	2381	234488	918	915	0	238702
15109	1957	4634	227012	819	0	234422
15110	1507	2236	3430	223443	0	230616
15111	226413	1223	1859	3697	0	233192
15112	3820	1142	227352	2114	0	234428
15113	2383	227027	3601	1348	0	234359
15114	1848	3423	1864	223349	0	230484
15115	1625	2115	228679	3663	0	236082
15116	1658	1286	222198	2166	0	227308
15117	1487	964	4976	223292	0	230719
15118	1420	888	226243	3967	0	232518
15119	1613	896	4238	204687	0	211434
15120	1402	216795	2567	3626	0	224390
15121	1848	3447	1504	213103	0	219902
15122	1567	219948	1378	3543	0	226436
15123	1954	3798	963	220523	0	227238
15124	217295	2060	1321	4149	0	224825
15125	4396	1286	1129	216738	0	223549
15126	2834	215501	1219	4113	0	223667
15127	2025	3541	1082	222025	0	228673
15128	1837	2199	218488	4214	0	226738
15129	1823	1393	3857	219455	0	226528
15130	219287	1105	2350	4402	0	227144
15131	4297	1294	212768	2544	0	220903
15132	3019	1320	3984	210461	0	218784
15133	207748	1011	2365	4245	0	215369
15134	4235	206178	1890	2960	0	215263
15135	3367	3916	1591	203147	0	212021
15136	208465	2477	1565	4285	0	216792
15137	4786	1559	1568	207872	0	215785
15138	3009	1625	202364	4459	0	211457
15139	194899	1695	4215	2939	0	203748
15140	4382	201876	3218	1892	0	211368
15141	2653	201738	2156	1919	0	208466
15142	202999	4784	1888	1729	0	211400
15143	199342	2774	1591	1544	0	205251
15144	5299	2218	1437	194740	0	203694
15145	198846	1618	1684	3930	0	206078
15146	4380	1945	194114	2674	0	203113
15147	192330	1412	4084	2207	0	200033
15148	4143	193049	2843	2125	0	202160
15149	193239	3444	2143	2077	0	200903
15150	4335	2539	191654	1927	0	200455
15151	3304	2166	3964	193161	0	202595
15152	2474	1531	2953	195434	0	202392
15153	2249	1751	2353	177150	0	183503
15154	1903	190657	2408	4751	0	199719
15155	193374	3340	1770	3323	0	201807
15156	4922	2310	2199	170996	0	180427
15157	3217	178187	2121	3736	0	187261
15158	199059	3482	1797	3300	0	207638
15159	190881	2483	2289	2610	0	198263
15160	195635	2026	1763	2804	0	202228
15161	195311	1889	1672	2824	0	201696
15162	189933	1664	1960	2737	0	196294
15163	5436	2033	2023	190425	0	199917
15164	3996	1920	2024	188691	0	196631
15165	185889	1946	1950	5728	0	195513
15166	4157	2242	1989	187825	0	196213
15167	3511	2468	2037	185812	0	193828
15168	2571	2408	172395	5868	0	183242
15169	179454	2397	4260	3931	0	190042
15170	183707	2182	3410	3501	0	192800
15171	185361	2774	2499	2881	0	193515
15172	5642	2603	2413	165328	0	175986
15173	3384	176279	2428	5210	0	187301
15174	192840	3797	2549	3851	0	203037
15175	185907	3088	2308	4141	0	195444
15176	6081	2382	2176	196302	0	206941
15177	194473	2162	2501	5742	0	204878
15178	6174	3399	155923	4826	0	170322
15179	4110	194597	4072	3810	0	206589
15180	4146	199916	2957	4415	0	211434
15181	4583	5730	194094	3878	0	208285
15182	2291	175084	4443	3777	0	185595
15183	2809	167286	2958	3952	0	177005
15184	150332	3223	2666	3144	0	159365
15185	2954	149634	1670	3216	0	157474
15186	2930	3123	1489	149758	0	157300
15187	151570	1992	1186	4560	0	159308
15188	3779	1659	146706	3279	0	155423
15189	142282	1742	1711	3510	0	149245
15190	3401	2091	141198	2913	0	149603
15191	2721	1100	139331	3052	0	146204
15192	135323	1085	2658	2857	0	141923
15193	3071	1046	142558	2843	0	149518
15194	2825	140165	2150	1756	0	146896
15195	2341	1820	1933	140022	0	146116
15196	140223	1563	1069	2791	0	145646
15197	3198	136096	775	2302	0	142371
15198	2694	2104	856	137412	0	143066
15199	2345	1594	135349	2771	0	142059
15200	2899	1010	1392	136362	0	141663
15201	132677	884	1559	2906	0	138026
15202	3422	931	130156	1938	0	136447
15203	3448	1132	1532	128550	0	134662
15204	130527	1677	1211	2317	0	135732
15205	134389	1054	857	2001	0	138301
15206	4561	935	739	132131	0	138366
15207	3330	899	448	133283	0	137960
15208	2430	876	134094	3058	0	140458
15209	2452	660	130577	1696	0	135385
15210	131168	495	2427	1379	0	135469
15211	138298	764	1109	1218	0	141389
15212	3353	137141	819	1014	0	142327
15213	137321	1358	737	744	0	140160
15214	139642	998	767	1301	0	142708
15215	3037	835	149348	1434	0	154654
15216	1683	152987	1795	1439	0	157904
15217	154418	1693	1171	1132	0	158414
15218	154565	1004	353	717	0	156639
15219	157432	410	268	694	0	158804
15220	2838	443	230	153597	0	157108
15221	1835	239	162	154611	0	156847
15222	983	153825	322	2434	0	157564
15223	902	1597	159	156310	0	158968
15224	155236	914	181	2200	0	158531
15225	2320	364	172	156483	0	159339
15226	1549	489	154168	2077	0	158283
15227	993	392	150706	1368	0	153459
15228	927	147	2311	152337	0	155722
15229	720	375	155009	2180	0	158284
15230	709	435	153383	1491	0	156018
15231	875	190	2551	146791	0	150407
15232	770	221	1245	156531	0	158767
15233	664	338	156957	2723	0	160682
15234	949	421	156102	1416	0	158888
15235	743	157780	2579	805	0	161907
15236	158177	1744	1277	868	0	162066
15237	2050	162663	762	488	0	165963
15238	162042	1820	417	637	0	164916
15239	164224	1047	319	557	0	166147
15240	2640	164000	399	385	0	167424
15241	164975	1846	284	527	0	167632
15242	2417	1072	243	162267	0	165999
15243	1386	704	166792	1925	0	170807
15244	865	371	1856	163936	0	167028
15245	584	341	1077	169436	0	171438
15246	162035	195	497	3098	0	165825
15247	162667	184	381	1671	0	164903
15248	163778	223	353	929	0	165283
15249	164052	185	315	766	0	165318
15250	156188	184	304	673	0	157349
15251	3134	151111	533	442	0	155220
15252	1812	1723	298	154533	0	158366
15253	855	1196	158035	2023	0	162109
15254	802	450	2011	157564	0	160827
15255	762	280	1250	160949	0	163241
15256	680	216	601	170002	0	171499
15257	182189	256	444	3768	0	186657
15258	3287	230	363	183101	0	186981
15259	186471	272	380	3749	0	190872
15260	3844	491	189115	2056	0	195506
15261	2372	254	3236	216202	0	222064
15262	1171	517	224085	4670	0	230443
15263	221283	258	4662	2692	0	228895
15264	4879	321	2359	223975	0	231534
15265	2707	556	228649	4818	0	236730
15266	1385	282	4646	230327	0	236640
15267	230292	226	2598	5762	0	238878
15268	4924	512	234387	2869	0	242692
15269	234962	241	4621	1759	0	241583
15270	243563	207	2580	1407	0	247757
15271	243250	190	1190	1234	0	245864
15272	236960	205	1012	1314	0	239491
15273	7120	231151	1148	1235	0	240654
15274	3155	223686	944	985	0	228770
15275	1808	221138	959	959	0	224864
15276	1740	7352	1209	205987	0	216288
15277	1081	214138	915	3914	0	220048
15278	209955	4029	705	2323	0	217012
15279	4186	206384	934	1092	0	212596
15280	2469	210612	810	1098	0	214989
15281	1670	5253	737	208895	0	216555
15282	1481	2493	689	213497	0	218160
15283	209405	1042	705	6030	0	217182
15284	4706	786	762	211810	0	218064
15285	2830	945	206956	4795	0	215526
15286	1773	936	199192	2843	0	204744
15287	1644	872	208502	1518	0	212536
15288	2044	594	5685	202258	0	210581
15289	2037	586	2447	218165	0	223235
15290	1772	841	212641	6066	0	221320
15291	1723	955	208287	3012	0	213977
15292	1550	1111	214606	1561	0	218828
15293	210491	931	6367	1451	0	219240
15294	5021	984	2925	214552	0	223482
15295	2997	970	1358	217721	0	223046
15296	215739	1009	1110	6809	0	224667
15297	5166	991	967	214499	0	221623
15298	2950	213174	1207	5548	0	222879
15299	1619	222923	1082	3407	0	229031
15300	1593	5970	847	220857	0	229267
15301	221750	2660	881	5715	0	231006
15302	223627	1148	1005	3661	0	229441
15303	227445	799	1140	2397	0	231781
15304	7226	657	1236	222997	0	232116
15305	3608	847	219582	5480	0	229517
15306	2224	563	5008	220279	0	228074
15307	1687	780	221294	5744	0	229505
15308	208551	554	5498	3755	0	218358
15309	5613	657	3330	214841	0	224441
15310	208234	522	1979	5787	0	216522
15311	5406	752	212501	3512	0	222171
15312	193812	511	5228	2452	0	202003
15313	6071	779	217940	1948	0	226738
15314	3767	206768	5104	1935	0	217574
15315	2262	205836	2939	1824	0	212861
15316	200233	5793	1633	1884	0	209543
15317	5474	2799	1159	199347	0	208779
15318	3546	1684	200595	4961	0	210786
15319	1955	197922	4425	3226	0	207528
15320	1753	205002	2679	1900	0	211334
15321	2118	5983	1325	202406	0	211832
15322	203485	2686	1214	5142	0	212527
15323	204017	1247	1159	3507	0	209930
15324	6353	202752	1511	2179	0	212795
15325	205011	4327	1202	2069	0	212609
15326	5530	2479	1362	202963	0	212334
15327	3569	1281	201702	5236	0	211788
15328	2051	203042	5026	3413	0	213532
15329	2296	4313	3054	204348	0	214011
15330	2140	2429	1687	207818	0	214074
15331	205177	1193	1409	6773	0	214552
15332	5277	1301	203556	3432	0	213566
15333	200852	1086	4792	2054	0	208784
15334	205680	1125	2891	1886	0	211582
15335	7065	1110	1568	201767	0	211510
15336	3848	1230	1305	206731	0	213114
15337	200324	1299	1289	6629	0	209541
15338	5548	1301	1153	202267	0	210269
15339	3378	1504	198617	5444	0	208943
15340	1939	1338	196909	3440	0	203626
15341	1760	194292	5915	2105	0	204072
15342	1901	207592	2931	1988	0	214412
15343	2200	5940	1417	187448	0	197005
15344	1754	195620	1368	4615	0	203357
15345	197631	4812	1116	3324	0	206883
15346	4653	201483	1318	2160	0	209614
15347	3288	4827	1048	200394	0	209557
15348	1972	2717	1066	205412	0	211167
15349	1559	1694	200944	6770	0	210967
15350	1925	1158	4651	199615	0	207349
15351	1879	925	2875	204192	0	209871
15352	1634	206017	1897	6932	0	216480
15353	2093	4271	1238	202482	0	210084
15354	2045	2301	1229	208611	0	214186
15355	2340	1273	201952	7258	0	212823
15356	1449	196346	4819	4091	0	206705
15357	1546	10192	2186	166740	0	180664
15358	960	179417	1342	3999	0	185718
15359	1329	3436	171222	2463	0	178450
15360	852	168265	3444	1465	0	174026
15361	137280	2973	3046	1273	0	144572
15362	133616	1192	682	705	0	136195
15363	133409	580	334	663	0	134986
15364	2515	132760	443	513	0	136231
15365	131068	1772	285	590	0	133715
15366	2120	1128	241	129193	0	132682
15367	125906	542	249	2063	0	128760
15368	1858	122407	345	1288	0	125898
15369	121828	1763	293	852	0	124736
15370	124454	1055	276	874	0	126659
15371	2564	127288	377	634	0	130863
15372	1400	2073	127673	606	0	131752
15373	793	1280	1917	136886	0	140876
15374	603	731	145401	2550	0	149285
15375	627	514	2697	146997	0	150835
15376	557	469	1411	154398	0	156835
15377	486	560	155138	4271	0	160455
15378	606	465	2900	155752	0	159723
15379	156059	404	1597	3698	0	161758
15380	3085	557	158376	1954	0	163972
15381	1576	158700	3092	1071	0	164439
15382	898	2963	1532	155500	0	160893
15383	795	1593	577	162019	0	164984
15384	591	851	159404	4381	0	165227
15385	775	588	2850	150773	0	154986
15386	475	158034	1642	3245	0	163396
15387	152594	2910	617	2035	0	158156
15388	2549	154999	628	936	0	159112
15389	146627	2846	349	745	0	150567
15390	2587	149107	497	634	0	152825
15391	1285	155032	483	620	0	157420
15392	770	3802	148587	578	0	153737
15393	666	1752	2962	149635	0	155015
15394	596	703	1402	150032	0	152733
15395	604	454	582	155523	0	157163
15396	412	164282	706	4397	0	169797
15397	620	3374	496	166475	0	170965
15398	167075	1647	471	4303	0	173496
15399	3774	668	585	167419	0	172446
15400	166740	508	517	4563	0	172328
15401	4034	682	166344	2397	0	173457
15402	164984	558	3800	1404	0	170746
15403	4193	624	1889	166340	0	173046
15404	2088	622	841	174331	0	177882
15405	174022	631	670	5799	0	181122
15406	4018	820	175536	2717	0	183091
15407	1937	174205	3972	1497	0	181611
15408	1106	4008	1892	173443	0	180449
15409	176986	2090	894	4293	0	184263
15410	179465	1095	601	2409	0	183570
15411	5631	966	560	177258	0	184415
15412	2387	1033	177392	4510	0	185322
15413	168050	862	4048	2649	0	175609
15414	4171	1011	173679	1515	0	180376
15415	2545	933	4075	171304	0	178857
15416	1099	989	173669	4847	0	180604
15417	1229	952	4099	172011	0	178291
15418	1011	820	168548	5067	0	175446
15419	987	168115	4227	3134	0	176463
15420	1851	3931	1969	143805	0	151556
15421	1039	170917	1184	3794	0	176934
15422	172131	4038	766	2434	0	179369
15423	173988	2017	858	1715	0	178578
15424	5753	1199	169648	1337	0	177937
15425	3031	793	3973	168848	0	176645
15426	171241	713	2114	4806	0	178874
15427	4655	732	1086	171328	0	177801
15428	2905	618	904	171200	0	175627
15429	1685	918	166521	5956	0	175080
15430	157565	686	4206	3518	0	165975
15431	4685	820	167796	2064	0	175365
15432	3080	632	4536	164115	0	172363
15433	1871	707	167687	4924	0	175189
15434	165267	627	4709	3348	0	173951
15435	168357	513	2798	2310	0	173978
15436	167559	763	1837	1836	0	171995
15437	6200	723	1530	163940	0	172393
15438	2909	973	162185	4917	0	170984
15439	1695	955	163942	3176	0	169768
15440	1800	1398	5707	142154	0	151059
15441	1520	161128	3242	4213	0	170103
15442	156599	3859	1687	3160	0	165305
15443	4942	2201	1414	157360	0	165917
15444	3045	1304	157457	4939	0	166745
15445	2585	937	4221	159667	0	167410
15446	2081	969	163104	5257	0	171411
15447	2218	836	4790	163903	0	171747
15448	2008	751	166574	5600	0	174933
15449	2067	728	165562	3641	0	171998
15450	1793	159939	6121	3104	0	170957
15451	1863	3568	161483	2363	0	169277
15452	2092	2133	161518	2283	0	168026
15453	2545	1251	6035	125769	0	135600
15454	2414	841	3113	138976	0	145344
15455	2091	154817	2139	5245	0	164292
15456	155006	3317	2009	3167	0	163499
15457	4865	155083	2153	2143	0	164244
15458	3560	3696	1893	152100	0	161249
15459	154666	1852	2044	4816	0	163378
15460	4842	952	1825	154451	0	162070
15461	154511	770	2272	5076	0	162629
15462	4967	701	2022	156058	0	163748
15463	2925	1028	156333	5382	0	165668
15464	2187	957	4782	156973	0	164899
15465	2146	863	3092	159809	0	165910
15466	159048	860	2429	6262	0	168599
15467	160286	723	2425	3907	0	167341
15468	156702	709	2496	2727	0	162634
15469	5626	152087	2858	2450	0	163021
15470	2709	151871	2392	2505	0	159477
15471	149944	3862	2571	2273	0	158650
15472	4097	2119	151996	2201	0	160413
15473	2481	1200	144534	2021	0	150236
15474	2310	3633	5019	129594	0	140556
15475	1541	830	134258	3472	0	140101
15476	1460	597	128619	2339	0	133015
15477	119931	739	4304	2022	0	126996
15478	122507	606	2371	1686	0	127170
15479	3897	124673	1466	1620	0	131656
15480	2189	126150	1506	1717	0	131562
15481	2132	3169	1426	98249	0	104976
15482	1353	124017	1641	2768	0	129779
15483	125977	2275	1523	2259	0	132034
15484	3276	1364	1379	113878	0	119897
15485	1969	124217	1444	3155	0	130785
15486	127081	2378	1383	2195	0	133037
15487	3187	1424	127683	1589	0	133883
15488	2149	877	125719	1455	0	130200
15489	122279	574	3858	1655	0	128366
15490	3074	659	120284	1589	0	125606
15491	117924	395	2979	1455	0	122753
15492	2991	774	1992	121141	0	126898
15493	1885	727	121303	2667	0	126582
15494	1239	117974	2976	1842	0	124031
15495	1127	120742	2287	1224	0	125380
15496	105824	1828	1411	1060	0	110123
15497	1699	107798	1364	929	0	111790
15498	101538	1208	1095	817	0	104658
15499	101079	699	1039	742	0	103559
15500	1866	101002	948	548	0	104364
15501	1058	1309	680	100277	0	103324
15502	616	825	102998	1345	0	105784
15503	435	107378	1690	820	0	110323
15504	457	2875	1070	104244	0	108646
15505	491	836	627	110563	0	112517
15506	107477	251	320	2229	0	110277
15507	1606	197	238	107627	0	109668
15508	829	317	106421	1833	0	109400
15509	333	106646	1643	993	0	109615
15510	380	1638	879	107388	0	110285
15511	109982	777	437	1808	0	113004
15512	113070	309	294	1111	0	114784
15513	2515	245	357	113190	0	116307
15514	115712	203	338	2008	0	118261
15515	2183	346	116736	1094	0	120359
15516	1343	210	2035	116035	0	119623
15517	574	371	119394	2074	0	122413
15518	479	236	2158	126567	0	129440
15519	488	248	1207	126654	0	128597
15520	472	286	448	128159	0	129365
15521	501	214	299	126434	0	127448
15522	482	253	240	126859	0	127834
15523	123485	213	209	4228	0	128135
15524	125097	198	199	2040	0	127534
15525	3595	124643	382	965	0	129585
15526	126973	2425	274	890	0	130562
15527	2946	1289	262	126936	0	131433
15528	1719	453	285	129280	0	131737
15529	1011	261	242	129824	0	131338
15530	726	399	128583	4210	0	133918
15531	869	337	2620	119440	0	123266
15532	575	127058	1499	3052	0	132184
15533	126753	2544	566	1873	0	131736
15534	127228	1376	394	1091	0	130089
15535	3977	621	124705	869	0	130172
15536	1892	125037	2674	989	0	130592
15537	946	2635	1423	124905	0	129909
15538	744	1512	127681	3220	0	133157
15539	818	546	2702	117641	0	121707
15540	580	125143	1722	3210	0	130655
15541	120967	2621	715	2068	0	126371
15542	2840	124362	579	1537	0	129318
15543	1789	2960	124294	1066	0	130109
15544	1215	1677	125146	980	0	129018
15545	776	121734	3686	956	0	127152
15546	643	122369	1636	1019	0	125667
15547	118492	3576	858	1178	0	124104
15548	119159	1587	479	1075	0	122300
15549	3868	620	482	118464	0	123434
15550	1861	646	118280	3185	0	123972
15551	1045	585	2583	118048	0	122261
15552	1002	530	1406	119002	0	121940
15553	117576	460	621	4327	0	122984
15554	116058	515	549	2376	0	119498
15555	4139	490	553	123764	0	128946
15556	2060	685	124215	3538	0	130498
15557	927	125903	3104	2336	0	132270
15558	125301	3117	1710	1398	0	131526
15559	3274	130745	802	1170	0	135991
15560	2258	3392	572	132165	0	138387
15561	1187	1892	600	138219	0	141898
15562	1011	940	707	138818	0	141476
15563	925	696	715	136349	0	138685
15564	130905	806	659	5635	0	138005
15565	3760	691	550	130760	0	135761
15566	2267	127870	675	4216	0	135028
15567	1374	3261	476	129606	0	134717
15568	124736	1912	598	4417	0	131663
15569	3491	125978	809	2857	0	133135
15570	2442	3324	636	126486	0	132888
15571	1169	2081	124062	4285	0	131597
15572	120673	926	3303	2832	0	127734
15573	4079	719	1830	124582	0	131210
15574	2512	771	122677	4128	0	130088
15575	1357	750	122060	2766	0	126933
15576	1426	973	4784	121217	0	128400
15577	120719	690	2687	4261	0	128357
15578	122230	720	944	2929	0	126823
15579	4854	125165	833	1902	0	132754
15580	126454	3118	613	1930	0	132115
15581	127347	1863	688	1961	0	131859
15582	127843	806	692	2004	0	131345
15583	126521	740	692	1890	0	129843
15584	5392	791	624	123395	0	130202
15585	2868	829	500	125346	0	129543
15586	1624	819	118958	5604	0	127005
15587	1237	113764	3111	3447	0	121559
15588	1133	118824	1900	2134	0	123991
15589	1241	4370	116368	1864	0	123843
15590	113941	1994	3070	1819	0	120824
15591	3802	960	1876	116428	0	123066
15592	117678	773	872	4086	0	123409
15593	117188	771	780	2831	0	121570
15594	4953	977	113774	1642	0	121346
15595	2811	800	3055	113253	0	119919
15596	114389	656	1907	3977	0	120929
15597	3938	687	918	114743	0	120286
15598	2629	945	113070	4054	0	120698
15599	1718	3230	3137	104995	0	113080
15600	1460	114197	2080	3461	0	121198
15601	1348	118121	1132	2252	0	122853
15602	1763	3984	112642	1364	0	119753
15603	1258	109048	2890	1202	0	114398
15604	102338	3142	2112	1535	0	109127
15605	101446	1378	765	1067	0	104656
15606	3593	588	567	99445	0	104193
15607	2070	537	555	100632	0	103794
15608	1332	484	512	102366	0	104694
15609	98859	517	434	3537	0	103347
15610	2747	98833	553	1947	0	104080
15611	96586	2009	395	1054	0	100044
15612	94448	1166	427	857	0	96898
15613	3227	93861	561	824	0	98473
15614	89497	1764	394	799	0	92454
15615	2172	90553	453	801	0	93979
15616	91043	1828	383	964	0	94218
15617	2241	1123	88769	964	0	93097
15618	78216	625	1751	760	0	81352
15619	1585	82051	902	723	0	85261
15620	1401	1258	612	82837	0	86108
15621	740	720	235	87106	0	88801
15622	693	347	231	88836	0	90107
15623	88609	250	216	2743	0	91818
15624	1880	377	301	89757	0	92315
15625	1168	461	87266	2052	0	90947
15626	83953	382	1536	1402	0	87273
15627	1810	548	86931	672	0	89961
15628	1285	569	1595	85901	0	89350
15629	788	505	87931	1846	0	91070
15630	650	498	1594	83605	0	86347
15631	476	86332	1080	1756	0	89644
15632	616	1403	497	84295	0	86811
15633	583	86460	527	1685	0	89255
15634	789	1475	305	87223	0	89792
15635	87399	934	266	1902	0	90501
15636	1940	439	265	89932	0	92576
15637	90107	328	257	1894	0	92586
15638	2059	488	85635	1106	0	89288
15639	86686	394	1329	711	0	89120
15640	88955	327	815	690	0	90787
15641	89194	354	402	574	0	90524
15642	2719	295	282	88297	0	91593
15643	87139	380	354	1788	0	89661
15644	1917	494	83688	1108	0	87207
15645	83277	389	1553	767	0	85986
15646	2025	415	83733	675	0	86848
15647	84003	342	1520	634	0	86499
15648	2121	295	930	85962	0	89308
15649	1467	453	87260	1663	0	90843
15650	1004	247	1514	87327	0	90092
15651	953	216	1037	89563	0	91769
15652	790	324	87526	2440	0	91080
15653	79118	238	1546	1559	0	82461
15654	1640	87883	1090	1055	0	91668
15655	83723	1035	396	711	0	85865
15656	1276	83155	398	544	0	85373
15657	81169	987	373	557	0	83086
15658	1208	668	79916	467	0	82259
15659	71606	487	1431	635	0	74159
15660	873	74906	612	295	0	76686
15661	747	566	214	74135	0	75662
15662	348	354	156	77223	0	78081
15663	390	149	104	78233	0	78876
15664	323	210	78219	1130	0	79882
15665	383	92	725	77397	0	78597
15666	289	235	83337	918	0	84779
15667	85502	74	886	699	0	87161
15668	91115	99	564	442	0	92220
15669	1713	88	220	92257	0	94278
15670	788	175	93103	1230	0	95296
15671	87097	72	1216	960	0	89345
15672	1414	225	110011	368	0	112018
15673	942	85	1593	108186	0	110806
15674	461	93	838	112231	0	113623
15675	400	94	294	115081	0	115869
15676	360	121	258	116601	0	117340
15677	111806	106	192	2715	0	114819
15678	1719	113643	342	1273	0	116977
15679	1191	1660	109339	427	0	112617
15680	387	110836	1735	371	0	113329
15681	110714	1683	881	451	0	113729
15682	1894	891	279	110921	0	113985
15683	112008	217	235	2079	0	114539
15684	2008	205	227	112273	0	114713
15685	1111	133	248	112700	0	114192
15686	479	177	261	113438	0	114355
15687	431	262	110216	2788	0	113697
15688	329	108432	1826	1479	0	112066
15689	553	1685	111087	605	0	113930
15690	513	787	1872	111184	0	114356
15691	113026	227	995	2222	0	116470
15692	112693	201	450	1396	0	114740
15693	113869	160	389	866	0	115284
15694	2559	113106	439	622	0	116726
15695	116213	1637	334	844	0	119028
15696	2108	872	308	116005	0	119293
15697	1272	298	307	117113	0	118990
15698	663	284	330	117077	0	118354
15699	531	117868	477	2871	0	121747
15700	766	1812	292	108195	0	111065
15701	551	114421	478	1939	0	117389
15702	113400	1841	320	1451	0	117012
15703	114337	949	297	895	0	116478
15704	2839	341	272	114257	0	117709
15705	1361	447	112647	2260	0	116715
15706	109628	308	1770	1626	0	113332
15707	2170	327	993	115019	0	118509
15708	1232	414	113772	2325	0	117743
15709	106782	296	1866	1585	0	110529
15710	2145	289	1015	114859	0	118308
15711	114374	289	460	2390	0	117513
15712	2111	113471	497	1441	0	117520
15713	1502	1781	328	111225	0	114836
15714	718	115087	435	2181	0	118421
15715	942	2103	306	114692	0	118043
15716	623	116005	474	2261	0	119363
15717	775	2085	280	117146	0	120286
15718	589	1101	114776	2159	0	118625
15719	93018	434	1677	1736	0	96865
15720	1801	112590	956	866	0	116213
15721	1246	1664	108988	644	0	112542
15722	105845	813	1465	837	0	108960
15723	1912	328	764	110748	0	113752
15724	1151	455	109763	1822	0	113191
15725	628	110165	1574	1337	0	113704
15726	647	1450	798	112134	0	115029
15727	668	935	113116	1845	0	116564
15728	658	428	1509	112699	0	115294
15729	602	296	766	115526	0	117190
15730	583	541	116091	2485	0	119700
15731	678	370	1597	116619	0	119264
15732	577	582	118921	2116	0	122196
15733	622	433	1638	119144	0	121837
15734	638	598	123759	2147	0	127142
15735	758	373	1655	123665	0	126451
15736	708	366	953	124502	0	126529
15737	783	421	519	121592	0	123315
15738	582	122115	645	2653	0	125995
15739	122379	1601	475	1709	0	126164
15740	122946	871	566	1099	0	125482
15741	2467	455	451	124128	0	127501
15742	123509	396	567	2478	0	126950
15743	1981	575	122996	1542	0	127094
15744	1086	124569	1818	1123	0	128596
15745	125061	1612	954	1257	0	128884
15746	1781	127432	695	975	0	130883
15747	1160	1747	490	127568	0	130965
15748	722	1091	471	129281	0	131565
15749	124335	498	472	2842	0	128147
15750	1988	448	449	124911	0	127796
15751	1284	553	123455	2273	0	127565
15752	599	122858	1792	1590	0	126839
15753	124294	1597	971	1195	0	128057
15754	1910	932	467	121852	0	125161
15755	1042	124029	599	2207	0	127877
15756	759	1794	495	119617	0	122665
15757	526	125244	636	1971	0	128377
15758	124420	1849	464	1478	0	128211
15759	124219	932	513	1122	0	126786
15760	2554	642	121968	973	0	126137
15761	1373	656	120640	806	0	123475
15762	849	370	2057	117958	0	121234
15763	621	121370	1156	1923	0	125070
15764	753	1609	492	122874	0	125728
15765	121512	837	467	2378	0	125194
15766	1584	576	116668	1211	0	120039
15767	934	512	1230	110180	0	112856
15768	471	394	109678	1555	0	112098
15769	528	385	104781	913	0	106607
15770	339	109808	1598	622	0	112367
15771	1819	2605	1033	104408	0	109865
15772	93321	420	405	1063	0	95209
15773	743	344	93474	429	0	94990
15774	341	92163	616	305	0	93425
15775	91138	453	277	352	0	92220
15776	537	286	119	91567	0	92509
15777	93312	148	119	842	0	94421
15778	93511	121	92	672	0	94396
15779	94367	115	110	475	0	95067
15780	704	272	97782	175	0	98933
15781	91951	98	490	371	0	92910
15782	98303	83	276	405	0	99067
15783	725	101537	246	193	0	102701
15784	429	505	115	102859	0	103908
15785	266	304	114	102262	0	102946
15786	206	124	95	104046	0	104471
15787	103533	112	110	1014	0	104769
15788	100666	108	116	638	0	101528
15789	840	306	101511	333	0	102990
15790	509	100	535	100076	0	101220
15791	201	100749	454	636	0	102040
15792	101728	534	170	553	0	102985
15793	679	544	101085	238	0	102546
15794	490	175	588	97510	0	98763
15795	289	120	332	99931	0	100672
15796	171	100220	256	899	0	101546
15797	257	594	132	101115	0	102098
15798	252	347	113	98466	0	99178
15799	234	157	133	100923	0	101447
15800	99727	99	138	1272	0	101236
15801	744	112	156	99288	0	100300
15802	477	140	112	99770	0	100499
15803	100562	115	100	1367	0	102144
15804	883	156	89	99744	0	100872
15805	528	119100	223	942	0	120793
15806	123824	1409	98	798	0	126129
15807	128183	853	134	610	0	129780
15808	132707	272	114	443	0	133536
15809	143283	160	132	418	0	143993
15810	3518	151473	251	314	0	155556
15811	168966	2597	109	517	0	172189
15812	171360	1349	122	473	0	173304
15813	5057	478	130	169090	0	174755
15814	2199	453	166839	3412	0	172903
15815	1038	260	3222	167117	0	171637
15816	737	181	1512	168790	0	171220
15817	631	145	468	167674	0	168918
15818	603	181	307	168339	0	169430
15819	598	165	175	169614	0	170552
15820	162086	144	195	5789	0	168214
15821	3804	146	137	164473	0	168560
15822	1895	355	163589	4286	0	170125
15823	952	256	3332	159600	0	164140
15824	475	162351	1752	4077	0	168655
15825	618	3622	493	164002	0	168735
15826	540	1726	162878	4134	0	169278
15827	144104	545	3520	2465	0	150634
15828	156380	327	1710	1178	0	159595
15829	5300	434	162939	684	0	169357
15830	2322	162768	3514	644	0	169248
15831	166149	3493	1659	850	0	172151
15832	167518	1746	568	757	0	170589
15833	169189	689	321	723	0	170922
15834	165226	371	322	714	0	166633
15835	6596	440	270	158241	0	165547
15836	3234	751	159708	3981	0	167674
15837	2173	457	3552	160212	0	166394
15838	1699	410	1741	165453	0	169303
15839	1415	509	162117	5945	0	169986
15840	1269	650	161326	3176	0	166421
15841	157156	381	5329	2107	0	164973
15842	4629	161852	2543	1916	0	170940
15843	3018	3671	988	163066	0	170743
15844	1521	1910	159944	5563	0	168938
15845	150791	672	4333	4026	0	159822
15846	4630	581	159702	2752	0	167665
15847	153816	432	4456	2779	0	161483
15848	4778	158601	2601	2576	0	168556
15849	3186	3901	1164	160439	0	168690
15850	1995	2351	158841	5474	0	168661
15851	151264	912	4344	3664	0	160184
15852	5145	157935	2839	2067	0	167986
15853	3245	169272	1624	1806	0	175947
15854	2430	5751	1296	165838	0	175315
15855	2031	3052	1174	174491	0	180748
15856	176136	1545	1123	7186	0	185990
15857	6194	174725	1351	3963	0	186233
15858	4552	4732	1199	177762	0	188245
15859	177978	2539	1151	6048	0	187716
15860	183154	1251	1087	4046	0	189538
15861	186570	998	1126	2792	0	191486
15862	8987	969	185038	2323	0	197317
15863	5096	830	188932	2425	0	197283
15864	193777	679	7441	2560	0	204457
15865	7066	196046	4197	2501	0	209810
15866	4249	201732	2387	2664	0	211032
15867	2947	7825	1768	187422	0	199962
15868	1886	199641	2039	6808	0	210374
15869	200262	6200	1945	4587	0	212994
15870	7260	3298	2009	198828	0	211395
15871	4508	1898	198521	6734	0	211661
15872	197916	1346	6595	4181	0	210038
15873	204177	1487	3782	2547	0	211993
15874	9922	1490	2063	199142	0	212617
15875	5717	1314	1832	203473	0	212336
15876	3843	1248	2020	205281	0	212392
15877	3427	1387	1687	204400	0	210901
15878	2988	1945	191655	9852	0	206440
15879	2661	190759	6260	5511	0	205191
15880	2852	6439	3553	168792	0	181636
15881	2611	191354	2412	6906	0	203283
15882	3311	6993	1759	167700	0	179763
15883	2558	187170	1906	6910	0	198544
15884	184897	7029	1604	4674	0	198204
15885	187495	3977	1545	3403	0	196420
15886	9770	185144	1917	3031	0	199862
15887	188447	6407	1755	2746	0	199355
15888	8858	3983	1828	185204	0	199873
15889	185725	2416	1785	7192	0	197118
15890	8461	183416	2059	4551	0	198487
15891	187216	6831	1839	2516	0	198402
15892	190243	4042	1892	2242	0	198419
15893	10216	2675	2001	183073	0	197965
15894	5830	2406	182786	6917	0	197939
15895	3649	182214	6652	4521	0	197036
15896	3508	6964	3570	183402	0	197444
15897	184064	4486	1990	7409	0	197949
15898	7774	3090	182034	4930	0	197828
15899	5457	2141	5865	179386	0	192849
15900	3842	2000	3454	183833	0	193129
15901	183592	1523	2021	9885	0	197021
15902	186337	1702	1703	6021	0	195763
15903	184193	1627	1759	3962	0	191541
15904	10029	177242	1982	3439	0	192692
15905	160775	5097	1301	2995	0	170168
15906	6323	2934	151556	3107	0	163920
15907	3634	1818	147331	2887	0	155670
15908	2451	1587	147233	2386	0	153657
15909	2993	7219	6943	124670	0	141825
15910	1752	1278	123952	3962	0	130944
15911	107446	947	2799	2046	0	113238
15912	3460	839	1424	109500	0	115223
15913	2313	924	112026	3148	0	118411
15914	114213	854	2556	2141	0	119764
15915	3677	857	1445	114911	0	120890
15916	2669	858	787	117762	0	122076
15917	117210	802	699	4101	0	122812
15918	3619	804	766	120895	0	126084
15919	2314	933	121549	3419	0	128215
15920	1641	723	2938	123155	0	128457
15921	1483	817	125376	3491	0	131167
15922	1590	692	3061	123731	0	129074
15923	121179	550	1790	3780	0	127299
15924	3440	118675	1143	2424	0	125682
15925	2425	123466	947	1582	0	128420
15926	1824	3613	781	120605	0	126823
15927	1633	1846	734	119969	0	124182
15928	1408	117918	918	4134	0	124378
15929	1339	117588	996	2407	0	122330
15930	1459	3403	953	114583	0	120398
15931	1288	1638	1027	115503	0	119456
15932	110767	771	1031	4400	0	116969
15933	3072	110457	1134	2582	0	117245
15934	2078	110001	989	1549	0	114617
15935	1360	114556	985	1307	0	118208
15936	109149	3569	1012	1348	0	115078
15937	3065	1844	109222	1293	0	115424
15938	106472	786	2908	1416	0	111582
15939	3254	588	1705	107672	0	113219
15940	1930	103639	1105	3319	0	109993
15941	1241	110820	931	2289	0	115281
15942	108234	3275	742	1692	0	113943
15943	3140	1679	819	101425	0	107063
15944	1868	114840	1025	3090	0	120823
15945	117003	2773	836	2266	0	122878
15946	118192	1738	718	1664	0	122312
15947	3987	1252	115839	1279	0	122357
15948	115154	920	2586	1360	0	120020
15949	117388	851	1600	1271	0	121110
15950	4157	812	791	111743	0	117503
15951	2019	110730	817	3242	0	116808
15952	1157	113307	677	2125	0	117266
15953	1135	3703	419	107672	0	112929
15954	102222	1602	588	2986	0	107398
15955	2627	1020	99099	1691	0	104437
15956	1598	779	96217	885	0	99479
15957	1599	786	93642	761	0	96788
15958	1432	657	96843	631	0	99563
15959	669	95004	2751	819	0	99243
15960	772	94193	1567	722	0	97254
15961	1627	2488	89322	578	0	94015
15962	915	1245	87809	724	0	90693
15963	346	78391	1896	567	0	81200
15964	399	951	869	73446	0	75665
15965	218	610	78289	858	0	79975
15966	232	197	871	75313	0	76613
15967	202	134	533	81208	0	82077
15968	232	141	196	83001	0	83570
15969	256	83	129	86084	0	86552
15970	212	206	84577	1813	0	86808
15971	241	131	1210	81933	0	83515
15972	83166	133	711	1544	0	85554
15973	1265	195	82241	822	0	84523
15974	82337	133	1315	505	0	84290
15975	1497	147	758	84732	0	87134
15976	835	237	85702	1410	0	88184
15977	84421	142	1413	989	0	86965
15978	1537	130	816	86100	0	88583
15979	87869	177	322	1660	0	90028
15980	1574	214	307	85231	0	87326
15981	805	85314	377	1680	0	88176
15982	485	1370	89422	1034	0	92311
15983	325	813	1416	89493	0	92047
15984	91347	379	825	1761	0	94312
15985	92242	311	436	1156	0	94145
15986	92760	306	293	742	0	94101
15987	92511	336	311	628	0	93786
15988	90270	339	315	663	0	91587
15989	2000	90714	382	613	0	93709
15990	91831	1544	294	619	0	94288
15991	1653	1051	89976	541	0	93221
15992	89906	494	1419	587	0	92406
15993	1766	455	1005	78422	0	81648
15994	1065	547	90291	1208	0	93111
15995	588	493	89574	926	0	91581
15996	555	421	2091	89495	0	92562
15997	91329	362	986	1718	0	94395
15998	1663	90018	570	1118	0	93369
15999	90077	1525	379	678	0	92659
16000	1799	91013	412	541	0	93765
16001	1316	1651	365	92324	0	95656
16002	806	1013	328	94423	0	96570
16003	93547	521	378	2340	0	96786
16004	1994	384	354	94408	0	97140
16005	1355	450	93890	1855	0	97550
16006	92781	343	1590	1217	0	95931
16007	2046	293	964	95225	0	98528
16008	1420	308	474	95946	0	98148
16009	839	425	95046	2304	0	98614
16010	87671	364	1634	1296	0	90965
16011	94359	317	1035	744	0	96455
16012	2490	94211	596	657	0	97954
16013	1254	1463	90813	421	0	93951
16014	817	918	89038	392	0	91165
16015	845	811	2038	86858	0	90552
16016	667	466	1046	86177	0	88356
16017	486	88278	591	2029	0	91384
16018	555	1330	85443	956	0	88284
16019	549	717	1456	82421	0	85143
16020	458	348	84912	1492	0	87210
16021	494	220	1447	80163	0	82324
16022	372	83207	959	1407	0	85945
16023	511	1239	488	85617	0	87855
16024	482	674	415	86175	0	87746
16025	520	298	367	85944	0	87129
16026	84229	246	375	2228	0	87078
16027	1547	300	84418	1148	0	87413
16028	875	88578	1571	741	0	91765
16029	571	1502	856	92512	0	95441
16030	94149	790	418	2022	0	97379
16031	1890	304	375	95873	0	98442
16032	95811	215	386	2233	0	98645
16033	2058	325	95724	1351	0	99458
16034	94669	199	1811	769	0	97448
16035	2269	201	1067	98552	0	102089
16036	1414	316	98709	2121	0	102560
16037	660	98465	1994	1327	0	102446
16038	752	1690	1101	97573	0	101116
16039	671	942	491	99742	0	101846
16040	96818	331	445	2854	0	100448
16041	1986	96195	517	1486	0	100184
16042	1215	94848	531	698	0	97292
16043	625	97794	469	647	0	99535
16044	88777	2349	315	697	0	92138
16045	1712	89736	488	575	0	92511
16046	1284	1712	400	88282	0	91678
16047	734	943	289	89570	0	91536
16048	87807	367	294	2608	0	91076
16049	1749	87302	398	1301	0	90750
16050	1156	1602	275	88455	0	91488
16051	89458	924	276	2063	0	92721
16052	89427	356	271	1322	0	91376
16053	89486	277	290	730	0	90783
16054	2508	88019	372	567	0	91466
16055	86075	1450	240	620	0	88385
16056	1869	864	255	83955	0	86943
16057	1040	83133	337	1617	0	86127
16058	495	85512	323	1037	0	87367
16059	632	2043	224	84528	0	87427
16060	83846	859	240	1790	0	86735
16061	85397	320	234	1168	0	87119
16062	2177	294	179	81680	0	84330
16063	988	81675	327	1602	0	84592
16064	82075	1359	248	1041	0	84723
16065	1538	908	79029	473	0	81948
16066	933	425	76342	406	0	78106
16067	73318	291	1628	461	0	75698
16068	1380	353	75173	390	0	77296
16069	751	188	993	70466	0	72398
16070	71479	154	567	1215	0	73415
16071	1162	154	193	73258	0	74767
16072	714	269	72373	1243	0	74599
16073	360	73114	1001	839	0	75314
16074	358	1056	529	73829	0	75772
16075	306	656	73225	1085	0	75272
16076	68558	266	1014	780	0	70618
16077	1138	196	509	72689	0	74532
16078	661	317	72456	1092	0	74526
16079	361	252	940	71145	0	72698
16080	238	70706	568	1136	0	72648
16081	383	1016	194	74022	0	75615
16082	379	586	139	72512	0	73616
16083	354	285	154	70998	0	71791
16084	247	70386	219	1569	0	72421
16085	71867	970	153	941	0	73931
16086	1163	581	169	72780	0	74693
16087	776	269	175	73387	0	74607
16088	433	229	182	74414	0	75258
16089	380	311	72904	1674	0	75269
16090	391	196	1031	73890	0	75508
16091	73860	204	558	1448	0	76070
16092	1123	74645	288	884	0	76940
16093	760	1128	157	76038	0	78083
16094	397	705	134	76587	0	77823
16095	75280	305	147	1828	0	77560
16096	1164	75584	211	935	0	77894
16097	76718	1122	149	596	0	78585
16098	78651	678	141	449	0	79919
16099	1828	308	129	77801	0	80066
16100	78241	256	139	1454	0	80090
16101	1404	75013	235	873	0	77525
16102	76558	1219	141	520	0	78438
16103	1535	706	137	78074	0	80452
16104	88099	333	148	1667	0	90247
16105	90408	255	124	1081	0	91868
16106	2414	378	85529	466	0	88787
16107	90045	222	1304	603	0	92174
16108	92717	199	682	558	0	94156
16109	91989	244	298	577	0	93108
16110	2702	365	99157	397	0	102621
16111	1240	100016	2024	412	0	103692
16112	642	2049	991	100238	0	103920
16113	100654	1049	359	2268	0	104330
16114	2163	99284	291	1291	0	103029
16115	99968	2049	171	628	0	102816
16116	2559	1048	150	100966	0	104723
16117	1383	516	100753	2259	0	104911
16118	102354	222	2030	1384	0	105990
16119	2531	209	1058	105809	0	109607
16120	1496	311	106019	2324	0	110150
16121	105550	200	2189	1495	0	109434
16122	2724	345	110118	593	0	113780
16123	1637	222	2431	111124	0	115414
16124	854	194	1287	117439	0	119774
16125	116539	195	488	3937	0	121159
16126	116730	182	263	1960	0	119135
16127	3975	115443	410	807	0	120635
16128	114366	2264	300	702	0	117632
16129	2934	1232	108398	366	0	112930
16130	1583	506	108454	379	0	110922
16131	105598	327	3102	507	0	109534
16132	2503	108325	1566	410	0	112804
16133	107115	2110	569	448	0	110242
16134	2594	107319	454	351	0	110718
16135	107038	2260	317	396	0	110011
16136	2794	1134	329	102971	0	107228
16137	1693	547	105324	2176	0	109740
16138	1040	281	2144	105606	0	109071
16139	824	197	1251	109343	0	111615
16140	107652	237	553	3339	0	111781
16141	2561	373	106715	1624	0	111273
16142	104555	224	2242	905	0	107926
16143	2680	106558	1392	574	0	111204
16144	108216	2170	561	580	0	111527
16145	2996	1200	363	106537	0	111096
16146	1701	721	105695	2425	0	110542
16147	1204	364	2302	106567	0	110437
16148	107346	323	1330	2831	0	111830
16149	2825	387	687	108275	0	112174
16150	1985	325	516	106259	0	109085
16151	1074	104173	656	3424	0	109327
16152	1042	2096	564	107209	0	110911
16153	970	1294	105550	2836	0	110650
16154	1079	518	2380	106127	0	110104
16155	1075	343	1387	107916	0	110721
16156	105695	424	676	3717	0	110512
16157	2947	369	547	106138	0	110001
16158	1917	490	104170	2970	0	109547
16159	1149	104477	2600	2074	0	110300
16160	1234	2297	1434	104583	0	109548
16161	1259	1350	739	106584	0	109932
16162	106243	683	586	3635	0	111147
16163	2998	103969	710	1886	0	109563
16164	2092	2383	597	105669	0	110741
16165	104150	1366	619	2948	0	109083
16166	106996	653	601	1857	0	110107
16167	3936	502	588	105960	0	110986
16168	2209	517	106224	3038	0	111988
16169	105910	502	2494	2080	0	110986
16170	3253	492	1505	110598	0	115848
16171	111450	387	811	3467	0	116115
16172	111578	460	664	2168	0	114870
16173	4050	108076	763	1325	0	114214
16174	108188	2384	603	1266	0	112441
16175	3266	109118	820	1055	0	114259
16176	2204	2556	721	109174	0	114655
16177	1605	1478	637	106286	0	110006
16178	1161	108611	735	3764	0	114271
16179	110468	2438	598	2318	0	115822
16180	109787	1509	648	1504	0	113448
16181	3881	946	106497	1285	0	112609
16182	2266	671	106131	1280	0	110348
16183	1396	573	3331	107040	0	112340
16184	108187	415	1676	3343	0	113621
16185	3098	506	856	108154	0	112614
16186	2224	433	695	109958	0	113310
16187	1351	559	109505	4160	0	115575
16188	1268	629	108556	2341	0	112794
16189	1158	633	110441	1578	0	113810
16190	105553	524	3657	1424	0	111158
16191	109015	511	1810	1237	0	112573
16192	3723	104912	1016	1230	0	110881
16193	2176	107866	824	1209	0	112075
16194	1505	3355	603	106934	0	112397
16195	1246	1726	106766	2922	0	112660
16196	103776	785	2328	2261	0	109150
16197	2964	811	110942	1369	0	116086
16198	2152	600	2539	109085	0	114376
16199	1307	467	1476	113171	0	116421
16200	1221	415	836	114335	0	116807
16201	1371	433	617	116337	0	118758
16202	112954	453	637	4221	0	118265
16203	3349	533	525	112149	0	116556
16204	1673	494	103124	2850	0	108141
16205	93366	287	2154	2109	0	97916
16206	2465	444	100205	1155	0	104269
16207	1659	427	98585	914	0	101585
16208	902	98843	2912	926	0	103583
16209	1608	1434	1608	90162	0	94812
16210	89514	801	842	1725	0	92882
16211	1678	309	373	89841	0	92201
16212	1081	351	89967	1691	0	93090
16213	661	213	1292	90400	0	92566
16214	89203	171	921	1818	0	92113
16215	1407	89931	470	1281	0	93089
16216	88080	1156	357	776	0	90369
16217	1457	87690	411	592	0	90150
16218	86124	1181	297	745	0	88347
16219	1304	85604	310	488	0	87706
16220	789	86297	322	409	0	87817
16221	721	1498	83245	292	0	85756
16222	394	82388	1117	325	0	84224
16223	76341	729	719	300	0	78089
16224	701	417	170	75743	0	77031
16225	76157	139	118	891	0	77305
16226	780	77322	199	550	0	78851
16227	76688	739	151	341	0	77919
16228	957	543	77183	215	0	78898
16229	587	183	810	76146	0	77726
16230	245	79817	581	865	0	81508
16231	271	963	194	82682	0	84110
16232	250	524	144	83260	0	84178
16233	92025	177	159	1615	0	93976
16234	1354	93435	219	824	0	95832
16235	94402	1376	208	443	0	96429
16236	1690	942	94757	294	0	97683
16237	1045	356	92033	212	0	93646
16238	354	93089	2314	338	0	96095
16239	330	1406	1076	93235	0	96047
16240	363	997	94460	1505	0	97325
16241	398	320	1568	88585	0	90871
16242	338	209	947	96793	0	98287
16243	272	309	94023	2404	0	97008
16244	283	318	92879	1159	0	94639
16245	294	322	96420	461	0	97497
16246	402	314	96820	367	0	97903
16247	291	99832	2562	542	0	103227
16248	429	1687	1248	99013	0	102377
16249	376	1142	432	102669	0	104619
16250	336	520	100349	2562	0	103767
16251	356	276	1713	99649	0	101994
16252	321	406	104217	2002	0	106946
16253	351	250	1896	103431	0	105928
16254	351	229	1198	102232	0	104010
16255	270	104017	599	2659	0	107545
16256	432	1760	354	105442	0	107988
16257	458	1169	347	105337	0	107311
16258	440	456	328	106123	0	107347
16259	391	527	102961	2927	0	106806
16260	329	102910	1861	1661	0	106761
16261	103143	1771	1171	775	0	106860
16262	103899	1180	509	624	0	106212
16263	2714	431	383	102165	0	105693
16264	1422	351	392	100185	0	102350
16265	508	103488	446	2664	0	107106
16266	102831	1823	353	1543	0	106550
16267	1774	105146	539	769	0	108228
16268	103118	1815	465	654	0	106052
16269	1923	1274	101024	500	0	104721
16270	94584	488	1877	731	0	97680
16271	1845	100112	1330	573	0	103860
16272	1257	1731	556	101961	0	105505
16273	592	1108	460	101182	0	103342
16274	313	102476	582	2700	0	106071
16275	102527	1820	454	1604	0	106405
16276	1922	1198	460	104436	0	108016
16277	1318	527	463	106991	0	109299
16278	106594	421	451	3232	0	110698
16279	108687	412	406	1865	0	111370
16280	3030	468	107991	864	0	112353
16281	108733	337	2120	879	0	112069
16282	2362	356	1411	110255	0	114384
16283	1480	550	109791	2388	0	114209
16284	798	342	2150	109325	0	112615
16285	535	533	109021	2543	0	112632
16286	508	518	109402	1686	0	112114
16287	510	445	3076	108086	0	112117
16288	462	547	110385	2498	0	113892
16289	370	111267	2487	2065	0	116189
16290	554	2122	1466	111307	0	115449
16291	598	1344	736	115771	0	118449
16292	564	706	114349	3512	0	119131
16293	518	114586	2446	2018	0	119568
16294	114950	2164	1519	1134	0	119767
16295	2405	1430	675	117365	0	121875
16296	117674	638	549	2820	0	121681
16297	2467	114582	762	1911	0	119722
16298	1828	2499	115252	995	0	120574
16299	861	1563	2437	113782	0	118643
16300	112486	599	1700	2850	0	117635
16301	2443	617	113107	1924	0	118091
16302	107150	410	2559	1227	0	111346
16303	2534	110576	1889	873	0	115872
16304	1489	111627	915	841	0	114872
16305	110847	2882	963	904	0	115596
16306	2300	1438	806	110384	0	114928
16307	1564	614	684	109706	0	112568
16308	574	110679	759	3444	0	115456
16309	629	2012	663	113268	0	116572
16310	570	1330	672	114202	0	116774
16311	111340	516	531	3812	0	116199
16312	2222	406	633	111489	0	114750
16313	1461	548	110255	2795	0	115059
16314	710	385	2330	110648	0	114073
16315	606	416	1611	113990	0	116623
16316	517	617	112497	3689	0	117320
16317	594	445	2167	113314	0	116520
16318	111012	371	1454	3249	0	116086
16319	109110	408	724	2204	0	112446
16320	109928	433	577	1319	0	112257
16321	3482	391	532	108497	0	112902
16322	1807	553	108157	2736	0	113253
16323	834	108596	2182	2074	0	113686
16324	973	2069	1298	108806	0	113146
16325	798	1487	109711	2421	0	114417
16326	830	699	1974	108104	0	111607
16327	758	490	1297	110196	0	112741
16328	106283	399	652	3318	0	110652
16329	2018	109566	636	2012	0	114232
16330	1534	2079	105763	916	0	110292
16331	96140	1141	1877	1005	0	100163
16332	2000	102960	1360	901	0	107221
16333	887	95195	459	625	0	97166
16334	96889	1717	868	701	0	100175
16335	1576	821	357	97356	0	100110
16336	1030	511	103522	1620	0	106683
16337	574	353	1474	101877	0	104278
16338	352	103635	1027	1778	0	106792
16339	104961	1432	378	1297	0	108068
16340	1674	893	292	106061	0	108920
16341	108532	329	291	2058	0	111210
16342	1808	274	294	106801	0	109177
16343	1025	111751	363	1760	0	114899
16344	113862	1608	277	1303	0	117050
16345	113201	901	280	765	0	115147
16346	2557	113541	369	618	0	117085
16347	111170	1634	228	665	0	113697
16348	1911	972	256	107832	0	110971
16349	1050	108741	354	1773	0	111918
16350	109556	1640	239	1223	0	112658
16351	1802	110670	360	504	0	113336
16352	109713	1754	177	667	0	112311
16353	2039	936	213	109304	0	112492
16354	110884	380	199	2015	0	113478
16355	111497	357	206	1326	0	113386
16356	112300	338	225	705	0	113568
16357	2666	327	168	111300	0	114461
16358	1346	332	168	113738	0	115584
16359	111026	273	150	2706	0	114155
16360	1997	458	114671	1242	0	118368
16361	1291	334	1660	114048	0	117333
16362	624	117609	1006	1988	0	121227
16363	706	1847	275	120240	0	123068
16364	663	1016	198	121578	0	123455
16365	573	705	118490	2895	0	122663
16366	683	399	1715	126247	0	129044
16367	534	132882	1107	2617	0	137140
16368	751	2537	301	137181	0	140770
16369	644	1665	143498	2977	0	148784
16370	824	626	2674	142779	0	146903
16371	810	491	1502	146417	0	149220
16372	141362	374	468	4659	0	146863
16373	143159	342	274	2379	0	146154
16374	4581	479	239	138491	0	143790
16375	2154	137875	425	3125	0	143579
16376	976	139920	313	1956	0	143165
16377	1212	3943	136775	963	0	142893
16378	947	2654	2666	135791	0	142058
16379	136031	643	1658	3347	0	141679
16380	2984	563	461	137607	0	141615
16381	1768	591	137026	3282	0	142667
16382	923	365	2627	137309	0	141224
16383	869	331	1487	139150	0	141837
16384	800	336	541	142350	0	144027
16385	726	460	137874	4541	0	143601
16386	525	137539	2705	2414	0	143183
16387	136362	2681	1495	1334	0	141872
16388	135492	1569	571	1028	0	138660
16389	4110	745	381	132311	0	137547
16390	2076	667	131268	3060	0	137071
16391	929	131438	2678	2125	0	137170
16392	934	3169	1444	122123	0	127670
16393	598	129766	746	2717	0	133827
16394	580	133326	539	1775	0	136220
16395	129522	3613	598	1180	0	134913
16396	2870	1808	129921	926	0	135525
16397	1827	901	129496	815	0	133039
16398	1195	597	3517	127645	0	132954
16399	877	466	1628	132679	0	135650
16400	776	705	132244	3871	0	137596
16401	881	449	2519	128948	0	132797
16402	714	591	131651	3342	0	136298
16403	122686	435	2750	2222	0	128093
16404	2810	478	1544	130741	0	135573
16405	1825	714	132333	3047	0	137919
16406	1127	560	2539	124315	0	128541
16407	736	136218	1720	2978	0	141652
16408	135520	2522	719	2296	0	141057
16409	2633	136716	751	1367	0	141467
16410	137572	2690	535	1475	0	142272
16411	3099	1870	135389	1129	0	141487
16412	135137	778	2551	1302	0	139768
16413	3159	681	1590	137783	0	143213
16414	2008	818	138031	3186	0	144043
16415	1190	643	2647	137065	0	141545
16416	932	834	135128	3565	0	140459
16417	125504	645	2823	2649	0	131621
16418	2761	135270	1897	1651	0	141579
16419	2114	2668	998	125799	0	131579
16420	935	137653	1014	2889	0	142491
16421	136558	2862	770	2379	0	142569
16422	136218	1716	752	1789	0	140475
16423	3854	136115	957	1567	0	142493
16424	2239	2781	734	136042	0	141796
16425	1444	1711	697	136785	0	140637
16426	1132	861	736	137926	0	140655
16427	133635	697	849	5063	0	140244
16428	2672	133560	1031	3026	0	140289
16429	1909	2658	899	131427	0	136893
16430	1114	1701	921	133291	0	137027
16431	129601	875	913	4830	0	136219
16432	2914	955	128064	2890	0	134823
16433	1980	815	126084	2027	0	130906
16434	119090	508	3655	1861	0	125114
16435	2769	740	124019	1527	0	129055
16436	1779	926	115461	1296	0	119462
16437	1168	797	3420	111806	0	117191
16438	115342	539	2214	2954	0	121049
16439	2687	581	1148	114420	0	118836
16440	1769	777	113041	3015	0	118602
16441	104471	603	2454	2254	0	109782
16442	2749	771	109844	1387	0	114751
16443	1549	105927	2554	1115	0	111145
16444	1227	2248	1846	106551	0	111872
16445	107671	1329	1015	2597	0	112612
16446	2078	734	901	108038	0	111751
16447	1485	472	878	109459	0	112294
16448	110880	392	617	3684	0	115573
16449	2276	391	630	112975	0	116272
16450	1506	365	707	115385	0	117963
16451	858	707	113247	3379	0	118191
16452	782	465	1976	112875	0	116098
16453	113705	417	1401	2976	0	118499
16454	113226	522	823	2098	0	116669
16455	113779	526	770	1292	0	116367
16456	3276	559	543	109829	0	114207
16457	1847	109983	775	2120	0	114725
16458	110401	1729	653	1706	0	114489
16459	1965	111492	847	1083	0	115387
16460	107704	1767	559	855	0	110885
16461	2149	1063	580	107155	0	110947
16462	104533	477	575	2016	0	107601
16463	104508	290	541	1520	0	106859
16464	104518	221	634	1020	0	106393
16465	2570	102826	712	785	0	106893
16466	894	94283	448	550	0	96175
16467	87864	810	246	477	0	89397
16468	786	88144	288	383	0	89601
16469	244	80832	146	154	0	81376
16470	281	81015	266	124	0	81686
16471	81003	603	359	346	0	82311
16472	491	289	47	80308	0	81135
16473	312	96	28	81776	0	82212
16474	81998	52	32	837	0	82919
16475	544	217	83930	338	0	85029
16476	392	52	463	98788	0	99695
16477	237	63	284	101357	0	101941
16478	233	67	105	110769	0	111174
16479	230	85	67	113929	0	114311
16480	93	112356	185	2680	0	115314
16481	89	135086	202	1187	0	136564
16482	137172	3249	63	602	0	141086
16483	2799	1533	71	138205	0	142608
16484	1628	421	76	141376	0	143501
16485	542	281	138163	4268	0	143254
16486	398	122	2730	139722	0	142972
16487	273	280	140928	3430	0	144911
16488	350	119	3166	141976	0	145611
16489	264	310	146972	3573	0	151119
16490	207	144717	3606	2007	0	150537
16491	392	3124	1750	145731	0	150997
16492	147092	1657	532	3608	0	152889
16493	147065	476	253	2063	0	149857
16494	5007	199	184	145920	0	151310
16495	2204	327	145525	3641	0	151697
16496	755	351	144919	2067	0	148092
16497	137179	179	4903	1066	0	143327
16498	3267	143271	2327	641	0	149506
16499	147023	3316	651	724	0	151714
16500	145819	1786	302	856	0	148763
16501	5190	766	143585	584	0	150125
16502	2551	390	3430	141975	0	148346
16503	1119	328	1896	147259	0	150602
16504	768	309	701	153558	0	155336
16505	726	252	404	150617	0	151999
16506	702	259	428	149136	0	150525
16507	492	419	139324	6307	0	146542
16508	506	425	140159	3081	0	144171
16509	688	284	5413	139996	0	146381
16510	761	318	2480	143396	0	146955
16511	726	344	893	145874	0	147837
16512	140631	416	553	6415	0	148015
16513	4197	417	515	141667	0	146796
16514	141561	322	528	5010	0	147421
16515	4755	339	535	144118	0	149747
16516	147037	295	566	5331	0	153229
16517	150544	306	637	3281	0	154768
16518	149046	283	713	1764	0	151806
16519	149536	268	675	1467	0	151946
16520	149380	383	669	1390	0	151822
16521	6825	373	636	144673	0	152507
16522	145653	387	600	4876	0	151516
16523	4751	143872	826	3050	0	152499
16524	146673	3790	671	1835	0	152969
16525	5090	2094	625	146883	0	154692
16526	2833	947	145386	5061	0	154227
16527	1530	436	4292	148132	0	154390
16528	1239	649	147535	5573	0	154996
16529	1355	406	4713	146983	0	153457
16530	1425	347	2712	151125	0	155609
16531	1183	510	147189	7071	0	155953
16532	1162	557	148169	3841	0	153729
16533	1370	293	6233	147869	0	155765
16534	147052	308	3045	5539	0	155944
16535	4943	518	147320	3718	0	156499
16536	3040	148574	4631	2404	0	158649
16537	1708	4075	155090	1851	0	162724
16538	152296	2154	4954	1810	0	161214
16539	5382	722	2738	154180	0	163022
16540	157767	404	1257	5347	0	164775
16541	159540	312	896	3788	0	164536
16542	7283	326	870	157336	0	165815
16543	3697	579	155138	5534	0	164948
16544	2237	336	4558	155329	0	162460
16545	1816	396	2762	156751	0	161725
16546	150371	367	1222	7676	0	159636
16547	5021	154131	1251	4370	0	164773
16548	3617	3994	1024	155638	0	164273
16549	1945	2389	152312	5701	0	162347
16550	144923	718	4732	3913	0	154286
16551	5160	150909	3118	2417	0	161604
16552	3704	4025	1336	153461	0	162526
16553	2209	2280	1118	155329	0	160936
16554	1941	770	1233	158262	0	162206
16555	151257	517	1089	7989	0	160852
16556	155464	416	1046	4386	0	161312
16557	7675	398	1084	154122	0	163279
16558	4009	619	152524	5901	0	163053
16559	2008	152681	5073	4113	0	163875
16560	154460	4104	2907	2567	0	164038
16561	159198	2267	1385	2299	0	165149
16562	7691	716	1122	155330	0	164859
16563	4283	449	1020	160526	0	166278
16564	2145	647	157603	7824	0	168219
16565	1658	158031	5315	4337	0	169341
16566	162079	4353	3121	2503	0	172056
16567	159732	2477	1419	2208	0	165836
16568	7233	158572	1469	2008	0	169282
16569	160360	4436	939	1922	0	167657
16570	6244	2479	898	157528	0	167149
16571	3692	1176	155656	5820	0	166344
16572	2538	525	4680	157656	0	165399
16573	1730	753	155747	6234	0	164464
16574	149435	496	5066	4085	0	159082
16575	5250	151244	3287	2450	0	162231
16576	3104	4354	1006	136850	0	145314
16577	1778	2113	135979	4538	0	144408
16578	1404	864	130165	2766	0	135199
16579	121303	858	4736	1719	0	128616
16580	3515	123150	2577	1447	0	130689
16581	104511	2064	2036	929	0	109540
16582	102578	978	701	891	0	105148
16583	102998	345	452	869	0	104664
16584	3228	493	434	100182	0	104337
16585	1596	428	99873	2291	0	104188
16586	827	100054	1988	1343	0	104212
16587	1002	2163	1195	100434	0	104794
16588	786	1078	100958	2060	0	104882
16589	633	520	94704	1110	0	96967
16590	634	418	2103	94120	0	97275
16591	535	367	94365	1761	0	97028
16592	87907	238	1621	1252	0	91018
16593	1728	251	979	93727	0	96685
16594	1154	263	444	96584	0	98445
16595	95379	247	434	2393	0	98453
16596	1621	94093	562	1145	0	97421
16597	99059	1414	436	879	0	101788
16598	1828	837	432	98268	0	101365
16599	1258	367	370	100350	0	102345
16600	826	278	382	101095	0	102581
16601	783	262	379	98722	0	100146
16602	95815	295	381	2429	0	98920
16603	1778	412	95723	1296	0	99209
16604	1071	93608	1505	619	0	96803
16605	688	1262	816	94478	0	97244
16606	92681	774	397	1730	0	95582
16607	94324	337	421	1145	0	96227
16608	1930	93881	531	611	0	96953
16609	92248	1218	370	697	0	94533
16610	1433	92263	462	540	0	94698
16611	886	95849	465	550	0	97750
16612	647	1817	321	95971	0	98756
16613	560	901	96068	1578	0	99107
16614	651	585	1261	94542	0	97039
16615	93380	316	834	1719	0	96249
16616	1396	91036	477	1029	0	93938
16617	1040	1222	254	91429	0	93945
16618	591	909	97595	1589	0	100684
16619	96737	323	1316	1265	0	99641
16620	102475	251	767	861	0	104354
16621	102896	263	373	758	0	104290
16622	1982	378	98322	456	0	101138
16623	94653	287	1167	595	0	96702
16624	1395	98268	814	454	0	100931
16625	945	1167	332	94577	0	97021
16626	525	98743	394	1100	0	100762
16627	99516	1152	249	935	0	101852
16628	95930	712	261	656	0	97559
16629	1698	459	100807	403	0	103367
16630	817	101790	1153	458	0	104218
16631	516	1230	761	102295	0	104802
16632	505	662	353	103368	0	104888
16633	482	315	331	102750	0	103878
16634	539	261	281	105428	0	106509
16635	518	303	277	106933	0	108031
16636	497	435	100815	2114	0	103861
16637	415	99022	1421	1218	0	102076
16638	97999	1358	808	669	0	100834
16639	1779	868	99923	427	0	102997
16640	1027	102281	1522	447	0	105277
16641	103189	1392	835	558	0	105974
16642	1743	952	106548	414	0	109657
16643	102590	376	1618	577	0	105161
16644	104380	296	856	623	0	106155
16645	105661	284	359	538	0	106842
16646	2268	106314	370	577	0	109529
16647	1256	1723	102954	437	0	106370
16648	519	107300	1719	360	0	109898
16649	889	1942	902	88177	0	91910
16650	441	107854	417	1350	0	110062
16651	107087	1633	314	875	0	109909
16652	112223	861	223	678	0	113985
16653	109986	315	207	646	0	111154
16654	2763	358	112148	453	0	115722
16655	1231	117074	1942	471	0	120718
16656	653	2110	947	126198	0	129908
16657	134630	1095	382	2532	0	138639
16658	2753	133920	443	1473	0	138589
16659	1660	2674	266	133044	0	137644
16660	774	1517	134337	2725	0	139353
16661	130089	534	2817	1662	0	135102
16662	3142	474	140200	587	0	144403
16663	1789	487	142350	360	0	144986
16664	130237	286	3986	511	0	135020
16665	3172	426	137941	318	0	141857
16666	130922	251	2934	358	0	134465
16667	3005	133290	1659	348	0	138302
16668	139287	2607	701	566	0	143161
16669	3222	1460	388	140292	0	145362
16670	1857	532	357	142027	0	144773
16671	876	292	400	144782	0	146350
16672	142236	295	340	4317	0	147188
16673	142642	252	359	2006	0	145259
16674	142733	306	341	775	0	144155
16675	4436	139164	473	469	0	144542
16676	2219	2679	357	141114	0	146369
16677	1070	1622	139371	2937	0	145000
16678	875	622	2739	134539	0	138775
16679	719	135181	1711	3146	0	140757
16680	876	2826	636	135957	0	140295
16681	918	1603	451	137651	0	140623
16682	136053	740	460	4330	0	141583
16683	3411	468	451	137299	0	141629
16684	2025	621	135343	3469	0	141458
16685	1191	539	133200	2008	0	136938
16686	1106	460	4289	134310	0	140165
16687	133482	464	2162	3348	0	139456
16688	3552	471	995	133006	0	138024
16689	2368	510	735	136538	0	140151
16690	1305	590	134360	4537	0	140792
16691	1011	133018	3292	2507	0	139828
16692	1147	2817	2003	134929	0	140896
16693	132877	1641	1049	3407	0	138974
16694	3408	133333	950	2200	0	139891
16695	2590	2900	670	135195	0	141355
16696	1499	1891	135027	3425	0	141842
16697	1350	820	3177	132589	0	137936
16698	129944	626	1947	3993	0	136510
16699	3452	127707	1113	2470	0	134742
16700	2500	3099	130530	1504	0	137633
16701	1633	1909	3050	128702	0	135294
16702	1277	1123	132485	3805	0	138690
16703	127743	706	3453	2759	0	134661
16704	131611	670	2131	1703	0	136115
16705	4921	813	131236	1371	0	138341
16706	2991	658	3384	129692	0	136725
16707	1680	859	133931	3719	0	140189
16708	1294	132553	3933	2838	0	140618
16709	1562	3101	2465	133970	0	141098
16710	1410	2092	135271	3877	0	142650
16711	1527	1159	3663	126065	0	132414
16712	1247	131741	2538	3913	0	139439
16713	1512	3095	1470	133423	0	139500
16714	1366	1971	132614	4198	0	140149
16715	126491	996	3468	3063	0	134018
16716	3673	132237	2530	1932	0	140372
16717	134952	3100	1276	1948	0	141276
16718	4106	2099	128624	1624	0	136453
16719	125557	1001	3500	1761	0	131819
16720	4174	979	127447	1674	0	134274
16721	126116	869	3853	1725	0	132563
16722	132049	775	2408	1881	0	137113
16723	5207	867	1416	129697	0	137187
16724	3147	849	1177	134303	0	139476
16725	132255	914	1142	5439	0	139750
16726	3980	132804	1418	3412	0	141614
16727	135275	3301	1328	2105	0	142009
16728	4362	1958	1353	131269	0	138942
16729	2765	131478	1591	4292	0	140126
16730	2113	3226	1254	135528	0	142121
16731	1840	1905	1342	137897	0	142984
16732	1682	979	1255	135325	0	139241
16733	1343	133976	1452	5900	0	142671
16734	132538	3097	1097	3307	0	140039
16735	4024	1887	1019	133623	0	140553
16736	2445	1207	132093	4344	0	140089
16737	1464	956	129705	3184	0	135309
16738	1290	889	132682	2121	0	136982
16739	128918	780	4712	2082	0	136492
16740	131380	823	2603	1920	0	136726
16741	4775	978	128401	1747	0	135901
16742	2650	795	3324	120195	0	126964
16743	1579	774	2219	125187	0	129759
16744	1199	831	127931	4841	0	134802
16745	1239	901	127809	2828	0	132777
16746	1400	576	4251	129086	0	135313
16747	128529	574	2493	3692	0	135288
16748	125610	574	1437	2596	0	130217
16749	125481	558	1202	1851	0	129092
16750	4482	122715	1343	1618	0	130158
16751	2467	125166	1312	1479	0	130424
16752	1578	3300	960	121294	0	127132
16753	120742	1599	979	3103	0	126423
16754	2799	903	117930	2164	0	123796
16755	105671	616	2186	1643	0	110116
16756	2146	101852	1330	913	0	106241
16757	897	95271	476	552	0	97196
16758	94139	1655	447	579	0	96820
16759	1271	94088	522	514	0	96395
16760	876	92830	436	440	0	94582
16761	90563	2023	1530	954	0	95070
16762	969	92062	282	361	0	93674
16763	559	849	207	89312	0	90927
16764	322	435	155	90412	0	91324
16765	89389	199	225	1348	0	91161
16766	88974	122	195	744	0	90035
16767	1155	90501	292	352	0	92300
16768	553	90651	259	289	0	91752
16769	354	1130	88257	223	0	89964
16770	89579	687	884	399	0	91549
16771	96554	183	486	374	0	97597
16772	99552	147	209	399	0	100307
16773	1627	142	182	99749	0	101700
16774	783	145	183	103388	0	104499
16775	104386	138	175	1758	0	106457
16776	1417	114	160	105322	0	107013
16777	786	250	105748	1373	0	108157
16778	469	165	1184	104886	0	106704
16779	261	109007	713	1386	0	111367
16780	389	1321	215	111788	0	113713
16781	344	661	153	114122	0	115280
16782	349	264	141	115101	0	115855
16783	111630	184	154	2284	0	114252
16784	1406	112241	214	1036	0	114897
16785	910	1336	148	114662	0	117056
16786	336	877	113954	1571	0	116738
16787	335	443	109758	894	0	111430
16788	449	241	1902	111846	0	114438
16789	426	228	775	113141	0	114570
16790	111134	219	248	2227	0	113828
16791	1597	232	167	108551	0	110547
16792	843	108205	265	1681	0	110994
16793	513	1445	110514	985	0	113457
16794	454	826	1373	111603	0	114256
16795	442	493	113188	1749	0	115872
16796	427	219	1498	112703	0	114847
16797	112736	215	781	1767	0	115499
16798	113918	228	308	1172	0	115626
16799	2124	113382	390	622	0	116518
16800	1168	1420	226	111843	0	114657
16801	117706	779	224	1819	0	120528
16802	119103	260	284	1196	0	120843
16803	120935	213	303	710	0	122161
16804	121055	209	263	629	0	122156
16805	119619	184	296	620	0	120719
16806	2260	116910	414	443	0	120027
16807	117135	1304	239	584	0	119262
16808	1822	865	115040	403	0	118130
16809	1122	281	1329	114987	0	117719
16810	117156	204	707	1714	0	119781
16811	116937	231	305	1135	0	118608
16812	116475	543	232	705	0	117955
16813	2257	344	114424	555	0	117580
16814	1224	216	1311	114390	0	117141
16815	118074	208	749	1795	0	120826
16816	1585	117162	396	1072	0	120215
16817	121441	1425	233	878	0	123977
16818	119035	822	243	737	0	120837
16819	119987	353	223	754	0	121317
16820	2342	301	230	120274	0	123147
16821	121733	297	231	1987	0	124248
16822	1842	413	120287	1135	0	123677
16823	1159	412	118927	673	0	121171
16824	117643	225	1857	760	0	120485
16825	1620	357	121495	538	0	124010
16826	111856	221	1295	657	0	114029
16827	1635	374	118826	459	0	121294
16828	992	309	1226	116451	0	118978
16829	115312	139	712	1578	0	117741
16830	1390	111679	446	988	0	114503
16831	115257	1096	229	626	0	117208
16832	1399	112936	359	516	0	115210
16833	908	118851	353	502	0	120614
16834	714	1510	265	120519	0	123008
16835	570	665	272	121484	0	122991
16836	592	240	240	121612	0	122684
16837	536	359	118296	1865	0	121056
16838	113061	223	1235	1247	0	115766
16839	123252	174	705	779	0	124910
16840	123901	193	266	724	0	125084
16841	124398	184	216	665	0	125463
16842	123898	212	534	654	0	125298
16843	2406	373	116060	449	0	119288
16844	1330	306	119037	381	0	121054
16845	817	189	1877	121946	0	124829
16846	792	349	120947	1579	0	123667
16847	119556	208	1502	1183	0	122449
16848	2050	128659	955	532	0	132196
16849	1443	1613	342	134191	0	137589
16850	135654	841	282	2141	0	138918
16851	2452	286	296	135659	0	138693
16852	1535	366	137286	2017	0	141204
16853	859	356	137606	1191	0	140012
16854	834	200	2826	141160	0	145020
16855	739	363	142004	2180	0	145286
16856	136305	178	2192	1418	0	140093
16857	2518	221	1154	141660	0	145553
16858	1628	435	141666	2177	0	145906
16859	830	140867	2127	1539	0	145363
16860	911	1909	1167	144149	0	148136
16861	835	1281	144735	2249	0	149100
16862	922	322	2168	139559	0	142971
16863	909	179	1265	142925	0	145278
16864	814	375	143506	3154	0	147849
16865	903	211	2248	142824	0	146186
16866	956	192	1350	141291	0	143789
16867	885	208	521	143685	0	145299
16868	138089	215	448	3399	0	142151
16869	2475	137575	586	1605	0	142241
16870	1524	138796	543	653	0	141516
16871	768	2846	132564	534	0	136712
16872	123454	1036	1927	739	0	127156
16873	2106	451	129829	428	0	132814
16874	1210	378	126948	386	0	128922
16875	544	407	2323	123490	0	126764
16876	125225	107	1047	1945	0	128324
16877	1689	126246	522	1168	0	129625
16878	126404	1460	380	617	0	128861
16879	122680	823	290	602	0	124395
16880	2154	124511	395	364	0	127424
16881	124024	1403	327	530	0	126284
16882	122497	779	304	547	0	124127
16883	2023	125862	427	331	0	128643
16884	1104	1507	322	126267	0	129200
16885	646	793	237	129408	0	131084
16886	133836	230	273	2418	0	136757
16887	1740	137353	416	1191	0	140700
16888	141430	1734	216	715	0	144095
16889	142448	983	224	592	0	144247
16890	149862	287	219	675	0	151043
16891	3213	232	234	148078	0	151757
16892	1539	232	208	151323	0	153302
16893	150278	194	247	3370	0	154089
16894	154008	200	241	1701	0	156150
16895	155267	201	309	785	0	156562
16896	3617	206	235	158602	0	162660
16897	1684	413	159462	2626	0	164185
16898	920	186	2465	162600	0	166171
16899	772	214	1356	174149	0	176491
16900	603	440	170246	4194	0	175483
16901	602	409	181402	1961	0	184374
16902	720	238	4634	182465	0	188057
16903	597	442	184943	3669	0	189651
16904	183611	187	3708	2475	0	189981
16905	3767	288	2100	187469	0	193624
16906	2419	274	712	191450	0	194855
16907	192393	198	461	5801	0	198853
16908	4006	188	437	193810	0	198441
16909	2596	268	386	195425	0	198675
16910	1164	228	410	198225	0	200027
16911	1063	214	369	198840	0	200486
16912	910	438	191610	5991	0	198949
16913	955	263	3517	194605	0	199340
16914	824	473	190773	4628	0	196698
16915	707	193449	3934	3607	0	201697
16916	955	3663	2107	193626	0	200351
16917	889	2254	190347	4442	0	197932
16918	176976	548	3877	3332	0	184733
16919	3991	188758	2627	1469	0	196845
16920	189879	3579	924	1407	0	195789
16921	4483	2071	694	179770	0	187018
16922	2553	182840	971	4166	0	190530
16923	182812	3586	692	3045	0	190135
16924	4074	185100	884	1549	0	191607
16925	186691	3939	672	1394	0	192696
16926	4821	2327	611	183924	0	191683
16927	187312	756	637	4699	0	193404
16928	4469	188227	915	3258	0	196869
16929	190296	3879	638	1742	0	196555
16930	5013	2418	187027	1369	0	195827
16931	3211	709	4011	188867	0	196798
16932	186896	442	2514	5154	0	195006
16933	188890	489	972	3618	0	193969
16934	6607	473	782	185601	0	193463
16935	3420	690	184477	5195	0	193782
16936	1598	174877	4289	4212	0	184976
16937	1225	186901	2804	1919	0	192849
16938	187594	5557	1337	2048	0	196536
16939	4842	2596	913	186325	0	194676
16940	3382	857	984	189481	0	194704
16941	185986	683	950	7042	0	194661
16942	184919	628	1008	4023	0	190578
16943	6536	886	184556	2118	0	194096
16944	3853	695	4034	182670	0	191252
16945	1872	769	180587	5159	0	188387
16946	1532	177544	4307	3836	0	187219
16947	168442	3593	2561	2495	0	177091
16948	3977	171861	1372	2111	0	179321
16949	2698	171993	1218	2001	0	177910
16950	2243	5040	959	170211	0	178453
16951	166405	2362	953	4891	0	174611
16952	3967	166177	1212	3489	0	174845
16953	164428	3588	1059	2338	0	171413
16954	4219	163039	1292	1774	0	170324
16955	3231	3881	1001	163545	0	171658
16956	161940	2403	962	4727	0	170032
16957	4381	1418	163207	3361	0	172367
16958	3406	1213	3532	163088	0	171239
16959	2134	1268	161945	4628	0	169975
16960	1879	152879	3822	3570	0	162150
16961	1617	162072	2579	2453	0	168721
16962	157524	4856	1327	2458	0	166165
16963	4056	160219	1231	2292	0	167798
16964	159523	3942	1131	2163	0	166759
16965	161005	2558	1059	2246	0	166868
16966	5657	1646	157004	1903	0	166210
16967	155431	1317	3736	1989	0	162473
16968	4832	1463	160502	1951	0	168748
16969	3451	159031	4060	1761	0	168303
16970	160417	3861	2571	1910	0	168759
16971	4537	160754	1576	1872	0	168739
16972	3680	4062	1060	160797	0	169599
16973	161839	2786	983	4495	0	170103
16974	5194	1583	826	162133	0	169736
16975	3533	1702	161448	4843	0	171526
16976	2339	1493	3582	161588	0	169002
16977	2247	1513	2394	163511	0	169665
16978	160274	1568	1134	6113	0	169089
16979	4818	1701	159502	3561	0	169582
16980	160709	1378	3806	2159	0	168052
16981	166217	1401	2439	1987	0	172044
16982	6749	1382	1321	162054	0	171506
16983	4354	1309	954	163315	0	169932
16984	159348	1260	1148	6028	0	167784
16985	5019	158991	1337	3434	0	168781
16986	3847	3876	895	154124	0	162742
16987	2184	2664	148450	3920	0	157218
16988	1925	1531	142609	2755	0	148820
16989	1671	147361	4661	1602	0	155295
16990	2055	3568	2258	139386	0	147267
16991	1804	2494	978	142044	0	147320
16992	138933	1307	767	4824	0	145831
16993	4240	1157	712	137318	0	143427
16994	131246	890	728	3715	0	136579
16995	3787	128197	886	2643	0	135513
16996	2288	125330	787	1393	0	129798
16997	1467	129323	781	1103	0	132674
16998	123862	3598	1241	1340	0	130041
16999	113712	1747	928	1052	0	117439
17000	3414	111458	703	996	0	116571
17001	97749	1437	375	576	0	100137
17002	1617	96355	322	501	0	98795
17003	1140	1617	225	91428	0	94410
17004	512	93461	331	1354	0	95658
17005	93165	1518	517	1047	0	96247
17006	93193	889	235	626	0	94943
17007	2108	414	208	88977	0	91707
17008	89046	355	211	1625	0	91237
17009	1623	353	205	88012	0	90193
17010	981	89217	302	1520	0	92020
17011	704	1825	246	88514	0	91289
17012	524	89506	337	1483	0	91850
17013	88528	1306	286	976	0	91096
17014	1470	878	85372	569	0	88289
17015	79196	350	949	521	0	81016
17016	1256	258	528	83242	0	85284
17017	832	416	82291	1116	0	84655
17018	79148	305	964	930	0	81347
17019	1242	423	86887	372	0	88924
17020	889	274	1052	85923	0	88138
17021	526	311	589	89205	0	90631
17022	476	285	211	89589	0	90561
17023	496	271	180	91600	0	92547
17024	401	91924	285	1947	0	94557
17025	540	1402	177	97819	0	99938
17026	96715	749	175	1819	0	99458
17027	1616	402	95305	986	0	98309
17028	888	101486	1385	502	0	104261
17029	105150	1628	691	552	0	108021
17030	113983	1049	230	494	0	115756
17031	2975	355	161	126110	0	129601
17032	1453	489	126003	2491	0	130436
17033	726	362	2218	124287	0	127593
17034	624	305	1331	128205	0	130465
17035	635	328	128132	3834	0	132929
17036	450	132767	2583	1815	0	137615
17037	135970	2669	1462	779	0	140880
17038	136190	1664	383	765	0	139002
17039	139163	453	354	753	0	140723
17040	4797	323	311	135460	0	140891
17041	2453	342	257	141801	0	144853
17042	143453	250	289	4861	0	148853
17043	3707	369	280	134539	0	138895
17044	2295	140902	400	3398	0	146995
17045	148336	2998	267	2265	0	153866
17046	151193	1899	230	1140	0	154462
17047	159761	546	236	973	0	161516
17048	160807	372	265	938	0	162382
17049	6266	494	152007	674	0	159441
17050	3203	450	152365	707	0	156725
17051	1490	458	5117	150682	0	157747
17052	1390	323	2349	156306	0	160368
17053	1100	423	153115	5596	0	160234
17054	1135	512	154021	2769	0	158437
17055	1203	349	5453	152773	0	159778
17056	153995	313	2669	4177	0	161154
17057	4195	308	1083	152605	0	158191
17058	2898	413	152477	4407	0	160195
17059	1297	155100	3867	2969	0	163233
17060	157687	3364	2501	1526	0	165078
17061	161905	2109	1043	1419	0	166476
17062	163894	664	898	1364	0	166820
17063	164892	484	838	1197	0	167411
17064	6544	662	156603	1119	0	164928
17065	3689	507	3771	157282	0	165249
17066	160238	560	2425	4273	0	167496
17067	5123	444	1096	160585	0	167248
17068	3762	411	898	152435	0	157506
17069	2023	154327	991	5864	0	163205
17070	2087	3559	717	157441	0	163804
17071	154630	2151	980	4795	0	162556
17072	4508	154955	1178	3314	0	163955
17073	155045	3658	848	1887	0	161438
17074	4885	155551	934	1725	0	163095
17075	3698	4007	805	142896	0	151406
17076	2081	149251	1118	4152	0	156602
17077	1740	156052	1189	3132	0	162113
17078	152908	5295	1036	2025	0	161264
17079	5004	2933	151403	1833	0	161173
17080	3532	1327	148107	1756	0	154722
17081	2134	1209	147489	1736	0	152568
17082	137226	1080	5584	1862	0	145752
17083	4606	144314	3158	1818	0	153896
17084	3685	148631	1586	1709	0	155611
17085	142079	5255	1134	1801	0	150269
17086	4978	142322	1401	1555	0	150256
17087	3755	148112	1421	1681	0	154969
17088	2718	5408	1141	148074	0	157341
17089	2547	3112	147141	4641	0	157441
17090	2420	1776	148755	3502	0	156453
17091	2518	1504	5490	149092	0	158604
17092	147884	1373	3082	4853	0	157192
17093	5205	149865	1832	3502	0	160404
17094	4310	4263	1402	152287	0	162262
17095	3047	2984	151356	4799	0	162186
17096	2889	1735	150061	3590	0	158275
17097	2837	1472	5715	149886	0	159910
17098	150436	1285	3360	5251	0	160332
17099	152215	1439	1951	3766	0	159371
17100	7000	1542	149053	2261	0	159856
17101	147954	1250	4628	2381	0	156213
17102	5824	1432	151346	2093	0	160695
17103	4766	1132	4926	138357	0	149181
17104	3053	149414	3714	4376	0	160557
17105	154110	3983	2168	3339	0	163600
17106	5713	2897	1962	154234	0	164806
17107	4529	1517	1994	153741	0	161781
17108	3196	1225	2064	159553	0	166038
17109	2870	1231	1999	160091	0	166191
17110	2699	1406	151621	6957	0	162683
17111	2799	150669	4869	4215	0	162552
17112	2983	3875	3457	152902	0	163217
17113	152803	2830	2088	5405	0	163126
17114	5389	1644	1808	154684	0	163525
17115	4196	1359	1858	156302	0	163715
17116	2661	1626	151302	6918	0	162507
17117	2673	1715	146535	4373	0	155296
17118	2640	146986	6180	2866	0	158672
17119	2448	150232	3634	2771	0	159085
17120	2547	5384	1926	147348	0	157205
17121	146672	3152	1785	5178	0	156787
17122	4731	1999	145193	3941	0	155864
17123	3661	144925	4206	2437	0	155229
17124	2828	4012	2815	135915	0	145570
17125	1843	141534	1669	4229	0	149275
17126	2129	3984	1327	133494	0	140934
17127	1741	139385	1566	4108	0	146800
17128	2107	3492	1177	131640	0	138416
17129	126131	2461	1130	3746	0	133468
17130	2948	118316	1121	2525	0	124910
17131	1740	2658	610	104471	0	109479
17132	99683	1575	736	2424	0	104418
17133	2022	101863	784	1923	0	106592
17134	1255	95837	611	1126	0	98829
17135	1002	97801	657	952	0	100412
17136	1374	2156	1032	91263	0	95825
17137	552	1020	488	90228	0	92288
17138	362	89967	411	1856	0	92596
17139	555	1480	439	90445	0	92919
17140	759	1034	89747	1498	0	93038
17141	392	89742	1085	887	0	92106
17142	473	3972	516	82085	0	87046
17143	323	86577	403	983	0	88286
17144	497	1064	79973	655	0	82189
17145	233	81755	939	381	0	83308
17146	73038	1062	559	417	0	75076
17147	511	296	136	73397	0	74340
17148	72698	116	106	640	0	73560
17149	475	193	72158	321	0	73147
17150	287	92	443	72557	0	73379
17151	137	230	73306	531	0	74204
17152	150	111	446	72788	0	73495
17153	75245	101	238	701	0	76285
17154	492	116	95	74884	0	75587
17155	75062	123	78	677	0	75940
17156	432	76123	101	388	0	77044
17157	75285	459	88	322	0	76154
17158	529	332	78729	218	0	79808
17159	255	79750	494	182	0	80681
17160	133	433	242	80250	0	81058
17161	241	245	62	79681	0	80229
17162	127	218	77839	641	0	78825
17163	87	78252	455	500	0	79294
17164	121	459	200	78387	0	79167
17165	75	79558	135	435	0	80203
17166	108	470	64	77525	0	78167
17167	63	78569	119	447	0	79198
17168	76540	457	67	280	0	77344
17169	448	288	49	77987	0	78772
17170	292	223	77844	425	0	78784
17171	84	78821	394	356	0	79655
17172	68	81062	230	183	0	81543
17173	301	606	79415	145	0	80467
17174	71	80683	408	195	0	81357
17175	150	373	197	79573	0	80293
17176	114	300	81099	338	0	81851
17177	130	81	314	78795	0	79320
17178	124	62	171	81678	0	82035
17179	87	191	80796	485	0	81559
17180	73215	66	371	416	0	74068
17181	389	50	177	81811	0	82427
17182	284	173	85777	389	0	86623
17183	74	86988	374	307	0	87743
17184	87370	334	217	308	0	88229
17185	339	87688	140	138	0	88305
17186	254	386	51	88143	0	88834
17187	86715	207	45	568	0	87535
17188	409	83	53	86405	0	86950
17189	258	239	88452	417	0	89366
17190	154	62	374	86854	0	87444
17191	101	202	87960	417	0	88680
17192	83113	79	436	490	0	84118
17193	437	211	87447	125	0	88220
17194	86164	96	383	336	0	86979
17195	87154	96	244	379	0	87873
17196	643	192	86944	159	0	87938
17197	312	217	83611	171	0	84311
17198	105	87584	642	138	0	88469
17199	89753	407	308	321	0	90789
17200	508	284	109	90592	0	91493
17201	353	114	102	90445	0	91014
17202	97010	109	73	1259	0	98451
17203	98551	78	104	621	0	99354
17204	98688	108	107	398	0	99301
17205	98158	95	96	364	0	98713
17206	699	89	119	96451	0	97358
17207	97485	85	75	750	0	98395
17208	570	88	110	98278	0	99046
17209	352	95	109	98154	0	98710
17210	234	84	107	99070	0	99495
17211	176	244	97330	784	0	98534
17212	160	95796	545	454	0	96955
17213	132	97362	381	220	0	98095
17214	208	641	106	97975	0	98930
17215	97825	304	114	684	0	98927
17216	543	120	107	97719	0	98489
17217	97244	90	105	744	0	98183
17218	558	243	98633	414	0	99848
17219	94818	79	496	396	0	95789
17220	568	116	327	99947	0	100958
17221	101702	94	141	846	0	102783
17222	100496	108	105	607	0	101316
17223	100596	111	101	463	0	101271
17224	886	98	126	100496	0	101606
17225	466	320	98578	623	0	99987
17226	266	141	580	98356	0	99343
17227	99783	94	369	831	0	101077
17228	745	321	110199	475	0	111740
17229	569	143	665	116250	0	117627
17230	119770	81	395	1254	0	121500
17231	982	352	121554	548	0	123436
17232	125772	111	896	572	0	127351
17233	132047	140	492	517	0	133196
17234	1734	112	185	133075	0	135106
17235	870	115	140	135146	0	136271
17236	134103	82	119	2107	0	136411
17237	1379	125	131	139263	0	140898
17238	136861	82	155	1984	0	139082
17239	1466	138485	243	1019	0	141213
17240	733	139825	234	362	0	141154
17241	427	2034	92	138910	0	141463
17242	337	966	141525	1563	0	144391
17243	178	141739	1594	856	0	144367
17244	138678	1554	718	633	0	141583
17245	1382	139484	362	427	0	141655
17246	780	1756	138558	200	0	141294
17247	433	738	1459	135797	0	138427
17248	344	474	140804	1618	0	143240
17249	221	144778	1684	989	0	147672
17250	328	1404	713	142950	0	145395
17251	197	144024	425	1437	0	146083
17252	373	1711	143150	693	0	145927
17253	333	727	1488	140710	0	143258
17254	279	502	144627	1616	0	147024
17255	312	182	1590	142383	0	144467
17256	142601	125	772	1968	0	145466
17257	1617	420	140760	886	0	143683
17258	131035	151	1564	614	0	133364
17259	1752	343	135169	304	0	137568
17260	1025	141	1606	133372	0	136144
17261	511	401	142810	1679	0	145401
17262	479	194	1616	142147	0	144436
17263	460	151	813	144406	0	145830
17264	429	146	331	143671	0	144577
17265	407	155	250	145373	0	146185
17266	333	475	149614	2455	0	152877
17267	142912	201	1570	1535	0	146218
17268	1716	641	787	161366	0	164510
17269	163183	195	399	2213	0	165990
17270	167952	195	297	1300	0	169744
17271	170662	201	266	900	0	172029
17272	3068	244	262	171914	0	175488
17273	1494	224	299	171650	0	173667
17274	589	191196	459	2791	0	195035
17275	207117	2649	313	1708	0	211787
17276	215563	1514	284	1030	0	218391
17277	217640	577	328	967	0	219512
17278	5746	698	216640	518	0	223602
17279	2906	281	3513	216436	0	223136
17280	1349	617	217835	3696	0	223497
17281	213260	236	3929	2336	0	219761
17282	218345	226	2148	1409	0	222128
17283	5515	246	906	214361	0	221028
17284	2920	322	635	206178	0	210055
17285	1294	217282	648	4816	0	224040
17286	218892	3371	465	2690	0	225418
17287	219654	1851	430	1506	0	223441
17288	5435	217216	799	880	0	224330
17289	219274	3540	417	1101	0	224332
17290	4699	1898	438	217910	0	224945
17291	2809	740	412	220962	0	224923
17292	219194	474	381	5807	0	225856
17293	4230	689	217393	2780	0	225092
17294	215896	357	3444	1707	0	221404
17295	220076	328	1896	1445	0	223745
17296	5585	216293	1047	994	0	223919
17297	221356	3480	567	964	0	226367
17298	4909	2308	215984	704	0	223905
17299	3186	893	3531	216494	0	224104
17300	217905	548	2042	4168	0	224663
17301	4666	432	977	218575	0	224650
17302	2882	610	207490	4432	0	215414
17303	1787	398	3852	200643	0	206680
17304	1347	216519	2386	4444	0	224696
17305	1468	3617	1008	223676	0	229769
17306	1500	1952	674	228837	0	232963
17307	1481	924	555	227882	0	230842
17308	1415	661	494	229452	0	232022
17309	1184	887	222418	6716	0	231205
17310	1365	579	3701	225455	0	231100
17311	223065	478	2102	5552	0	231197
17312	4419	221838	1249	3217	0	230723
17313	3070	3814	669	226856	0	234409
17314	1924	2427	227030	4736	0	236117
17315	1859	970	3907	229060	0	235796
17316	230297	657	2267	5465	0	238686
17317	231468	521	1139	3497	0	236625
17318	230841	449	935	1995	0	234220
17319	7389	498	744	228315	0	236946
17320	4240	725	227322	4658	0	236945
17321	2425	224747	4277	3149	0	234598
17322	228449	3797	2447	2166	0	236859
17323	5180	2213	1251	227146	0	235790
17324	3654	974	1043	229694	0	235365
17325	2440	1073	225410	6421	0	235344
17326	2073	220743	4157	3833	0	230806
17327	1792	229207	2646	2363	0	236008
17328	2303	6227	1321	214630	0	224481
17329	1717	2822	209786	4720	0	219045
17330	196265	1305	3877	3509	0	204956
17331	4840	1338	199644	1917	0	207739
17332	188025	744	3551	2164	0	194484
17333	4637	202120	2324	1878	0	210959
17334	3292	3487	199773	1600	0	208152
17335	191949	2025	3574	1851	0	199399
17336	4477	198852	2426	1407	0	207162
17337	203765	3222	1172	1777	0	209936
17338	4658	2338	202024	1283	0	210303
17339	3124	202573	3343	1434	0	210474
17340	205808	3118	2088	1718	0	212732
17341	4448	2229	201028	1508	0	209213
17342	200110	988	3251	1543	0	205892
17343	4587	821	2175	201079	0	208662
17344	203493	702	1353	3925	0	209473
17345	4467	696	1053	203083	0	209299
17346	203147	743	890	4478	0	209258
17347	4279	1041	203959	3100	0	212379
17348	2876	661	3336	206108	0	212981
17349	1899	708	2122	206084	0	210813
17350	1503	1055	205053	5623	0	213234
17351	1523	744	3478	206750	0	212495
17352	1396	182178	2895	4943	0	191412
17353	1521	3209	1353	227724	0	233807
17354	1621	2033	1065	241362	0	246081
17355	1720	1102	865	261035	0	264722
17356	1519	1157	253365	7807	0	263848
17357	237815	745	4847	4879	0	248286
17358	5631	756	2989	265693	0	275069
17359	3753	984	269704	6211	0	280652
17360	260332	608	5604	4323	0	270867
17361	271019	730	3295	2445	0	277489
17362	278824	787	1473	2180	0	283264
17363	9416	749	1206	274124	0	285495
17364	5073	816	1118	300756	0	307763
17365	2945	769	1124	287877	0	292715
17366	1893	291146	1563	10060	0	304662
17367	288875	6101	1187	5591	0	301754
17368	285403	3356	1129	3098	0	292986
17369	9884	1249	1087	281287	0	293507
17370	5112	1111	274208	7070	0	287501
17371	3121	1034	275901	4489	0	284545
17372	1711	264161	9290	2428	0	277590
17373	1403	275625	4351	2156	0	283535
17374	247936	8710	3301	2777	0	262724
17375	4942	244907	1065	1117	0	252031
17376	243838	4714	671	1172	0	250395
17377	243857	2321	453	1139	0	247770
17378	244027	682	514	1052	0	246275
17379	7607	480	482	243062	0	251631
17380	3718	496	476	260625	0	265315
17381	264992	397	503	8042	0	273934
17382	6397	443	452	270794	0	278086
17383	3424	729	267869	6610	0	278632
17384	269315	517	5633	3635	0	279100
17385	6668	588	2783	269991	0	280030
17386	3913	538	818	276012	0	281281
17387	1995	514	486	280524	0	283519
17388	1416	834	269488	9283	0	281021
17389	250547	515	6038	4707	0	261807
17390	6734	787	270912	1793	0	280226
17391	4150	602	6440	267609	0	278801
17392	1831	944	273748	6755	0	283278
17393	1787	718	6785	267271	0	276561
17394	1780	700	3370	274851	0	280701
17395	1603	1028	279321	9381	0	291333
17396	2344	729	6548	252556	0	262177
17397	1592	280282	3645	6550	0	292069
17398	280175	6255	1223	4154	0	291807
17399	285414	3123	925	2332	0	291794
17400	10228	1006	856	282493	0	294583
17401	4840	973	284930	7756	0	298499
17402	2191	276216	7052	4715	0	290174
17403	1814	289826	3927	2631	0	298198
17404	274824	8695	1705	2472	0	287696
17405	7511	3824	271035	2179	0	284549
17406	269908	1224	6792	2337	0	280261
17407	8245	783	3816	270768	0	283612
17408	4900	748	1709	276489	0	283846
17409	265621	754	1358	10758	0	278491
17410	7140	267082	1713	5748	0	281683
17411	4605	6500	270803	2952	0	284860
17412	2848	3257	7063	265259	0	278427
17413	2188	1398	275195	8368	0	287149
17414	1822	270878	8057	5281	0	286038
17415	2333	6238	4232	272974	0	285777
17416	272381	3325	2148	8700	0	286554
17417	275674	1364	1868	5600	0	284506
17418	10456	1324	271324	3194	0	286298
17419	5199	271852	7477	2818	0	287346
17420	269104	6624	4255	2943	0	282926
17421	7805	274178	2398	2683	0	287064
17422	5321	7296	1617	269061	0	283295
17423	271705	3830	1769	8232	0	285536
17424	8344	1819	1719	274889	0	286771
17425	5151	1754	269901	8742	0	285548
17426	3455	1389	7197	272984	0	285025
17427	2778	1701	272770	8918	0	286167
17428	3028	1451	7828	271244	0	283551
17429	271763	1341	4595	9220	0	286919
17430	8056	273467	2903	5787	0	290213
17431	277520	7123	2025	3779	0	290447
17432	9094	4236	2080	274023	0	289433
17433	5679	2260	1978	277635	0	287552
17434	3239	2127	260256	11509	0	277131
17435	3067	1896	275156	5908	0	286027
17436	2934	272928	10712	4148	0	290722
17437	3006	7602	272388	3118	0	286114
17438	245584	4169	8535	3555	0	261843
17439	8299	266477	5300	3217	0	283293
17440	5236	274448	3073	3295	0	286052
17441	3109	279529	2637	3280	0	288555
17442	3464	11001	2066	270733	0	287264
17443	3165	5326	274960	9094	0	292545
17444	2637	277978	8609	6335	0	295559
17445	3586	7995	4820	250918	0	267319
17446	2577	282004	3108	8274	0	295963
17447	275371	8016	2441	5703	0	291531
17448	280780	4468	2356	3911	0	291515
17449	11421	2316	2419	274858	0	291014
17450	6297	1922	2355	276666	0	287240
17451	259607	1692	2225	11698	0	275222
17452	7867	253550	2616	6550	0	270583
17453	4782	256350	2508	3760	0	267400
17454	3560	9657	1827	235447	0	250491
17455	2047	3856	222065	7197	0	235165
17456	1739	221189	6596	4477	0	234001
17457	212112	5731	3930	2634	0	224407
17458	5617	210014	2538	2246	0	220415
17459	3149	211389	2000	2261	0	218799
17460	201648	7192	1955	2014	0	212809
17461	5232	208605	1661	2107	0	217605
17462	3612	5914	201576	1757	0	212859
17463	1690	204862	5201	1771	0	213524
17464	179108	4454	2906	1420	0	187888
17465	3803	180386	1387	1158	0	186734
17466	179320	4269	1214	1214	0	186017
17467	4402	2505	857	178236	0	186000
17468	2496	1518	797	183853	0	188664
17469	1581	1461	181914	5234	0	190190
17470	1246	183484	3605	2679	0	191014
17471	1421	4024	1930	185713	0	193088
17472	184811	2255	1103	4255	0	192424
17473	185179	1228	879	2812	0	190098
17474	5000	186644	1146	1572	0	194362
17475	2664	4095	760	184830	0	192349
17476	185641	2387	735	4182	0	192945
17477	187191	1519	920	2603	0	192233
17478	5511	1446	178882	1391	0	187230
17479	2633	1315	166993	952	0	171893
17480	1317	1141	164077	837	0	167372
17481	699	159513	3543	721	0	164476
17482	154185	2566	2389	743	0	159883
17483	2511	154208	744	542	0	158005
17484	153122	2630	761	721	0	157234
17485	2485	158024	658	494	0	161661
17486	1618	2710	437	159822	0	164587
17487	160887	1462	420	2602	0	165371
17488	2648	1011	162161	1281	0	167101
17489	158666	692	2268	806	0	162432
17490	164674	636	1190	785	0	167285
17491	3345	162923	625	565	0	167458
17492	1422	166373	446	516	0	168757
17493	170739	3109	696	735	0	175279
17494	2682	1640	174496	473	0	179291
17495	164413	1111	2577	688	0	168789
17496	169088	620	1079	650	0	171437
17497	3357	507	405	165693	0	169962
17498	170015	526	289	2435	0	173265
17499	2769	543	286	172447	0	176045
17500	1633	462	315	176127	0	178537
17501	1040	483	350	170373	0	172246
17502	767	170512	518	2923	0	174720
17503	172328	2193	403	1536	0	176460
17504	174212	1255	408	844	0	176719
17505	3340	694	391	172793	0	177218
17506	1826	607	421	170120	0	172974
17507	950	171291	591	2875	0	175707
17508	171359	2351	504	1532	0	175746
17509	2737	1584	169541	632	0	174494
17510	1701	827	2155	171221	0	175904
17511	1095	874	169131	2370	0	173470
17512	1130	642	2251	168616	0	172639
17513	1013	891	168762	2456	0	173122
17514	1196	632	2241	163999	0	168068
17515	164604	645	1214	2747	0	169210
17516	2798	803	165211	1429	0	170241
17517	158656	518	2316	980	0	162470
17518	2887	167988	1492	739	0	173106
17519	1913	2307	722	169734	0	174676
17520	1411	1391	556	172073	0	175431
17521	174177	798	506	3488	0	178969
17522	3086	635	472	181000	0	185193
17523	2000	897	185661	2695	0	191253
17524	179681	607	2045	2185	0	184518
17525	191191	529	1086	1477	0	194283
17526	191577	552	536	1284	0	193949
17527	191163	509	433	1260	0	193365
17528	3892	187012	692	1023	0	192619
17529	2044	2017	446	186694	0	191201
17530	185247	1127	421	2680	0	189475
17531	2923	633	451	183475	0	187482
17532	180621	601	573	2608	0	184403
17533	2913	675	177021	1473	0	182082
17534	1855	688	175661	930	0	179134
17535	1350	2041	2577	163556	0	169524
17536	1069	171621	1414	2174	0	176278
17537	875	178186	867	1756	0	181684
17538	173878	2451	833	1641	0	178803
17539	2353	1151	172543	1057	0	177104
17540	154313	460	1857	1275	0	157905
17541	2201	169433	1363	869	0	173866
17542	170530	1539	557	1081	0	173707
17543	2445	951	453	167444	0	171293
17544	1654	755	168653	2242	0	173304
17545	1373	470	1644	167762	0	171249
17546	1217	429	935	166480	0	169061
17547	927	165565	744	2639	0	169875
17548	976	173439	639	1635	0	176689
17549	1267	2245	518	169443	0	173473
17550	1241	174227	625	2096	0	178189
17551	1344	1836	170235	1280	0	174695
17552	1124	1168	165973	1040	0	169305
17553	154228	581	2295	1263	0	158367
17554	171040	493	1105	1133	0	173771
17555	2897	167876	802	904	0	172479
17556	1769	1690	586	167375	0	171420
17557	1263	969	599	169920	0	172751
17558	1028	795	169109	2698	0	173630
17559	1089	487	1877	159106	0	162559
17560	929	166945	1221	2314	0	171409
17561	970	1959	161909	1416	0	166254
17562	1172	1167	160812	887	0	164038
17563	1143	154656	2551	1173	0	159523
17564	1289	1954	160422	831	0	164496
17565	1216	1141	1780	157561	0	161698
17566	1168	848	1073	147061	0	150150
17567	1033	813	161816	2709	0	166371
17568	1220	760	1764	157384	0	161128
17569	754	155847	1376	2332	0	160309
17570	850	162597	892	1619	0	165958
17571	916	2190	600	158025	0	161731
17572	1048	1157	160025	1970	0	164200
17573	770	161453	1863	1341	0	165427
17574	1193	1993	1051	160238	0	164475
17575	694	1065	158020	1727	0	161506
17576	144471	464	1325	1182	0	147442
17577	158019	375	753	824	0	159971
17578	158587	329	417	793	0	160126
17579	1939	387	415	155583	0	158324
17580	1007	295	513	157163	0	158978
17581	603	535	160889	2073	0	164100
17582	595	333	1453	158352	0	160733
17583	663	441	788	163671	0	165563
17584	534	619	161227	1895	0	164275
17585	131490	306	1371	1330	0	134497
17586	1296	151308	927	543	0	154074
17587	151110	1173	387	619	0	153289
17588	1252	149694	395	572	0	151913
17589	851	1309	281	149490	0	151931
17590	554	812	149509	1351	0	152226
17591	533	761	1266	144465	0	147025
17592	304	559	146392	1550	0	148805
17593	117613	272	1198	1232	0	120315
17594	1002	420	138738	375	0	140535
17595	627	265	1147	132814	0	134853
17596	398	440	138654	1153	0	140645
17597	349	141764	1269	721	0	144103
17598	552	1095	750	147110	0	149507
17599	547	578	327	147962	0	149414
17600	526	209	226	154653	0	155614
17601	399	343	153353	2414	0	156509
17602	357	436	157214	1289	0	159296
17603	356	165	2363	155777	0	158661
17604	369	175	1108	187760	0	189412
17605	421	177	472	199233	0	200303
17606	202157	198	429	5041	0	207825
17607	3587	254	408	210107	0	214356
17608	2075	549	216407	3947	0	222978
17609	220386	323	3787	2609	0	227105
17610	4326	318	2201	230407	0	237252
17611	237699	256	868	4892	0	243715
17612	242025	212	616	3223	0	246076
17613	6767	156	689	241452	0	249064
17614	242131	156	725	5249	0	248261
17615	244074	212	668	3317	0	248271
17616	7011	445	243086	1371	0	251913
17617	3266	245937	4710	1024	0	254937
17618	1532	4330	2651	238144	0	246657
17619	1030	2503	970	249755	0	254258
17620	247189	720	630	7396	0	255935
17621	245229	383	710	4045	0	250367
17622	244111	326	690	2108	0	247235
17623	7591	494	227747	1481	0	237313
17624	3626	229468	5013	1493	0	239600
17625	230081	4280	2957	1538	0	238856
17626	5031	232862	1517	1358	0	240768
17627	234906	4800	778	1576	0	242060
17628	5825	2648	653	233029	0	242155
17629	234415	874	689	5616	0	241594
17630	236316	523	714	3746	0	241299
17631	238975	397	664	2169	0	242205
17632	8350	667	235710	1572	0	246299
17633	238429	404	4553	1794	0	245180
17634	6288	239833	3075	1614	0	250810
17635	248233	4574	1049	1717	0	255573
17636	251627	2662	787	1747	0	256823
17637	256539	956	814	1868	0	260177
17638	9485	641	889	241130	0	252145
17639	4887	248492	1043	5466	0	259888
17640	250111	4954	778	3844	0	259687
17641	6953	3215	249564	2089	0	261821
17642	4847	251523	5171	1770	0	263311
17643	3777	5180	2979	223768	0	235704
17644	2705	249929	1495	4592	0	258721
17645	249723	5618	1073	3299	0	259713
17646	258223	3527	976	1872	0	264598
17647	9556	1537	855	253762	0	265710
17648	5427	1393	247744	6415	0	260979
17649	3232	249363	5515	4597	0	262707
17650	4154	5686	3823	203113	0	216776
17651	3406	3396	1695	248634	0	257131
17652	3252	1428	1411	261229	0	267320
17653	260698	1158	1306	9557	0	272719
17654	264701	1107	1227	5186	0	272221
17655	267444	1217	1030	2913	0	272604
17656	269511	1186	904	2566	0	274167
17657	11701	1129	961	261186	0	274977
17658	6915	1494	264043	7094	0	279546
17659	4857	993	5875	268359	0	280084
17660	4464	1088	3613	270764	0	279929
17661	4725	1066	1639	272757	0	280187
17662	4954	1185	1310	273982	0	281431
17663	266661	1183	1548	11213	0	280605
17664	9665	1224	1745	268260	0	280894
17665	269593	1072	1474	8717	0	280856
17666	271361	1370	1551	6125	0	280407
17667	12889	1550	260474	3717	0	278630
17668	8364	1449	259086	3509	0	272408
17669	6032	1445	266585	3697	0	277759
17670	6210	1463	8985	257686	0	274344
17671	5588	1783	266422	7470	0	281263
17672	5371	1606	7276	260756	0	275009
17673	4766	1995	4358	265550	0	276669
17674	265552	1654	2095	11063	0	280364
17675	10068	1723	1570	259687	0	273048
17676	8004	267893	2007	8270	0	286174
17677	275033	6157	1815	6027	0	289032
17678	10073	276585	2239	3877	0	292774
17679	7718	7571	277861	3255	0	296405
17680	5284	283208	7027	3057	0	298576
17681	278330	7453	4238	3192	0	293213
17682	10460	4919	1970	276044	0	293393
17683	8168	2807	273258	7705	0	291938
17684	274146	2060	6393	5651	0	288250
17685	11214	1859	4111	275367	0	292551
17686	8703	2178	275487	7528	0	293896
17687	6597	1633	6787	277773	0	292790
17688	5602	1695	4672	281005	0	292974
17689	5625	1954	2341	279589	0	289509
17690	5285	278110	2363	10298	0	296056
17691	282832	6577	1819	6113	0	297341
17692	10604	4443	1696	273631	0	290374
17693	7656	278548	1957	7913	0	296074
17694	5496	7266	1312	281211	0	295285
17695	5358	5396	276581	7972	0	295307
17696	4778	278709	7049	5605	0	296141
17697	276538	6970	4637	3910	0	292055
17698	276699	4948	2305	3327	0	287279
17699	10964	2722	1796	267577	0	283059
17700	6787	2401	1635	270895	0	281718
17701	266596	1766	1693	9929	0	279984
17702	259922	1682	1618	6250	0	269472
17703	9852	259955	2280	3973	0	276060
17704	230574	4553	1446	2544	0	239117
17705	6306	2792	220667	1936	0	231701
17706	3923	1464	217006	1862	0	224255
17707	1899	210484	5409	1922	0	219714
17708	1499	211384	2982	1544	0	217409
17709	196470	4141	3961	1569	0	206141
17710	3146	197934	1186	1205	0	203471
17711	195597	2844	857	1294	0	200592
17712	193243	1612	525	1198	0	196578
17713	191206	672	560	1291	0	193729
17714	4284	561	571	188075	0	193491
17715	189708	452	647	3378	0	194185
17716	3376	749	183463	1940	0	189528
17717	2202	725	184259	1110	0	188296
17718	1099	184777	3758	1373	0	191007
17719	1081	2654	187444	1116	0	192295
17720	1110	1551	2749	179414	0	184824
17721	981	956	188110	3106	0	193153
17722	1043	948	185718	1928	0	189637
17723	1173	659	3546	184249	0	189627
17724	186914	633	1774	3221	0	192542
17725	187971	589	913	2290	0	191763
17726	4010	876	190850	984	0	196720
17727	185014	620	2734	1454	0	189822
17728	3334	879	193642	872	0	198727
17729	190152	616	2910	1235	0	194913
17730	201050	599	1719	1402	0	204770
17731	4376	573	889	198151	0	203989
17732	2468	595	697	192020	0	195780
17733	1234	189106	969	3922	0	195231
17734	1153	195393	763	2030	0	199339
17735	1365	3560	641	189616	0	195182
17736	1401	1648	678	191318	0	195045
17737	183932	714	621	3698	0	188965
17738	2790	184052	871	1762	0	189475
17739	183340	2412	625	1280	0	187657
17740	2765	184978	904	969	0	189616
17741	1982	2919	181483	693	0	187077
17742	1430	1666	2513	181285	0	186894
17743	182885	649	1553	2943	0	188030
17744	193361	599	689	1993	0	196642
17745	4222	197695	891	1069	0	203877
17746	2088	200765	778	866	0	204497
17747	1067	205508	815	741	0	208131
17748	1356	4848	697	210321	0	217222
17749	1157	2277	211391	3647	0	218472
17750	867	210743	3754	2036	0	217400
17751	1254	3594	2034	208947	0	215829
17752	959	1735	701	213715	0	217110
17753	838	905	209889	4719	0	216351
17754	867	792	208310	2140	0	212109
17755	196562	467	4795	1362	0	203186
17756	3963	743	216268	746	0	221720
17757	212430	506	3552	1062	0	217550
17758	210116	482	1937	933	0	213468
17759	210957	503	785	981	0	213226
17760	209722	518	679	959	0	211878
17761	5311	771	201162	739	0	207983
17762	2413	203815	3437	868	0	210533
17763	1376	3428	1848	202692	0	209344
17764	1099	2181	204462	3494	0	211236
17765	1179	829	3382	198681	0	204071
17766	1130	183238	2429	3568	0	190365
17767	1302	3454	743	209601	0	215100
17768	1239	1992	661	211158	0	215050
17769	1274	963	569	209664	0	212470
17770	206072	742	628	5461	0	212903
17771	4113	766	768	206535	0	212182
17772	2628	778	764	207125	0	211295
17773	1209	767	799	204961	0	207736
17774	784	196225	1126	5193	0	203328
17775	195385	3358	821	2776	0	202340
17776	3595	187901	1069	1234	0	193799
17777	2048	193759	913	1002	0	197722
17778	1391	4476	883	195518	0	202268
17779	1308	2072	773	197223	0	201376
17780	195180	716	743	5434	0	202073
17781	4359	605	759	199451	0	205174
17782	201776	532	696	4374	0	207378
17783	245201	585	798	2788	0	249372
17784	7825	659	694	243502	0	252680
17785	4138	701	698	239509	0	245046
17786	1475	246080	977	8248	0	256780
17787	253207	5648	719	4318	0	263892
17788	6059	261398	942	2243	0	270642
17789	262008	6580	886	1731	0	271205
17790	6971	4005	256761	1525	0	269262
17791	256446	1390	5938	1726	0	265500
17792	271197	984	3396	1783	0	277360
17793	10105	947	1082	262768	0	274902
17794	4860	1116	263949	7300	0	277225
17795	1985	264257	6731	4774	0	277747
17796	2115	6895	3715	270400	0	283125
17797	1895	4254	268649	7590	0	282388
17798	2026	1718	6693	267518	0	277955
17799	261471	1051	3919	8085	0	274526
17800	7642	1048	261989	4755	0	275434
17801	4536	258046	6932	2327	0	271841
17802	2191	269054	4212	1780	0	277237
17803	2827	10000	1414	223497	0	237738
17804	1666	267032	1325	5763	0	275786
17805	266455	7328	961	3888	0	278632
17806	269888	4352	815	2209	0	277264
17807	271000	1647	918	2153	0	275718
17808	10665	1768	257016	1753	0	271202
17809	261593	1313	6547	2021	0	271474
17810	8361	1421	3776	259586	0	273144
17811	5427	1270	1347	264879	0	272923
17812	2786	1246	1089	267918	0	273039
17813	2430	1189	1732	268757	0	274108
17814	2137	1424	258943	11174	0	273678
17815	1906	1471	259293	5940	0	268610
17816	2017	1309	259747	3019	0	266092
17817	241680	1229	10195	2776	0	255880
17818	7700	251130	4931	2820	0	266581
17819	5174	6832	2030	248856	0	262892
17820	247397	4369	1461	8328	0	261555
17821	7594	250054	1700	5500	0	264848
17822	4962	258227	1771	2846	0	267806
17823	253145	10293	1332	2397	0	267167
17824	255893	5130	1287	2285	0	264595
17825	10945	256020	1837	2408	0	271210
17826	6625	7460	1242	235022	0	250349
17827	3210	253319	1571	7317	0	265417
17828	251662	7540	1205	5010	0	265417
17829	253002	4759	1236	2778	0	261775
17830	250675	2334	1110	2600	0	256719
17831	11350	242228	1573	2719	0	257870
17832	6123	7334	1231	245301	0	259989
17833	3333	4919	242576	8344	0	259172
17834	3392	2109	6863	241303	0	253667
17835	3440	1841	4228	247849	0	257358
17836	2717	2312	239217	11006	0	255252
17837	232463	1813	7172	6127	0	247575
17838	8560	1769	4485	240686	0	255500
17839	5990	1857	1947	235832	0	245626
17840	3283	236839	1776	10565	0	252463
17841	236133	7142	1457	5858	0	250590
17842	8968	4771	1492	228084	0	243315
17843	5564	230334	2025	7893	0	245816
17844	219052	6821	1382	5317	0	232572
17845	7172	220018	1605	3018	0	231813
17846	211723	6689	1413	2539	0	222364
17847	7645	4323	207565	2361	0	221894
17848	4658	2138	195649	2044	0	204489
17849	2631	1599	197803	1921	0	203954
17850	2240	198109	8717	1841	0	210907
17851	3339	6151	5280	173940	0	188710
17852	2376	194818	2076	5048	0	204318
17853	195630	6254	1567	3686	0	207137
17854	6325	4239	195655	2092	0	208311
17855	192760	2071	5654	1982	0	202467
17856	197767	1810	3632	1845	0	205054
17857	9062	1693	1749	192146	0	204650
17858	196227	1523	1494	5897	0	205141
17859	7616	1470	1511	195764	0	206361
17860	4494	1913	193444	6339	0	206190
17861	187925	1794	5476	4363	0	199558
17862	6364	191869	3844	2253	0	204330
17863	4848	5756	1581	193097	0	205282
17864	194116	3685	1226	6021	0	205048
17865	7179	1832	1242	194765	0	205018
17866	4757	1788	189040	6440	0	202025
17867	2815	1519	5501	186841	0	196676
17868	2177	189443	3900	6429	0	201949
17869	191705	5559	1611	4355	0	203230
17870	6427	3638	1342	190833	0	202240
17871	193370	1704	1332	6537	0	202943
17872	7153	1437	1199	193144	0	202933
17873	4624	1291	1219	186428	0	193562
17874	2542	189119	1666	8127	0	201454
17875	187971	5490	1160	4578	0	199199
17876	6221	196041	1529	2768	0	206559
17877	4494	5666	1044	173055	0	184259
17878	2021	182830	1153	5422	0	191426
17879	179923	5475	805	3779	0	189982
17880	178266	3405	866	2238	0	184775
17881	177106	1677	1005	1979	0	181767
17882	7668	169008	1382	1680	0	179738
17883	1894	128190	503	751	0	131338
17884	125656	3405	465	816	0	130342
17885	2817	128801	516	753	0	132887
17886	2181	3751	624	120786	0	127342
17887	971	1431	117930	2274	0	122606
17888	108255	573	1831	1378	0	112037
17889	113125	448	890	705	0	115168
17890	111089	444	295	613	0	112441
17891	2534	110727	418	542	0	114221
17892	106273	1496	176	571	0	108516
17893	1901	945	108812	384	0	112042
17894	927	106508	1276	371	0	109082
17895	735	2114	652	99422	0	102923
17896	290	102174	259	856	0	103579
17897	97658	875	153	620	0	99306
17898	886	100231	202	281	0	101600
17899	589	869	95	99619	0	101172
17900	293	100874	218	823	0	102208
17901	372	965	113	102680	0	104130
17902	325	497	131	101102	0	102055
17903	299	447	100721	1220	0	102687
17904	354	239	822	97808	0	99223
17905	97309	220	443	1195	0	99167
17906	97134	194	231	701	0	98260
17907	1324	240	141	97465	0	99170
17908	724	412	96135	991	0	98262
17909	519	232	817	95306	0	96874
17910	94987	225	459	1151	0	96822
17911	97521	189	251	891	0	98852
17912	98132	174	182	538	0	99026
17913	1425	101084	243	314	0	103066
17914	102425	867	135	530	0	103957
17915	1182	675	100162	318	0	102337
17916	107502	307	966	728	0	109503
17917	1275	251	530	113086	0	115142
17918	777	261	262	113831	0	115131
17919	524	282	143	115090	0	116039
17920	112210	266	143	1832	0	114451
17921	110430	243	155	1049	0	111877
17922	1704	185	158	111069	0	113116
17923	915	443	112174	1264	0	114796
17924	659	207	984	111875	0	113725
17925	526	242	484	109894	0	111146
17926	501	393	108247	1673	0	110814
17927	412	107869	1065	998	0	110344
17928	513	1083	555	109635	0	111786
17929	111231	609	270	1452	0	113562
17930	1303	377	164	111991	0	113835
17931	857	316	134	113084	0	114391
17932	112514	263	105	1992	0	114874
17933	1303	111396	244	953	0	113896
17934	833	113972	250	504	0	115559
17935	112347	1554	123	586	0	114610
17936	1391	1024	112116	347	0	114878
17937	103819	375	1062	652	0	105908
17938	1489	474	119713	400	0	122076
17939	880	121121	1225	388	0	123614
17940	122795	1122	624	596	0	125137
17941	123272	678	231	595	0	124776
17942	124253	347	184	592	0	125376
17943	124262	254	166	703	0	125385
17944	1905	459	122044	319	0	124727
17945	1045	230	1001	118547	0	120823
17946	120299	209	598	1407	0	122513
17947	1352	440	125662	766	0	128220
17948	912	394	124318	398	0	126022
17949	433	123953	1371	385	0	126142
17950	124467	780	662	513	0	126422
17951	1143	467	228	123102	0	124940
17952	124115	175	196	1174	0	125660
17953	1002	126555	263	683	0	128503
17954	780	932	128	136361	0	138201
17955	446	526	137	137437	0	138546
17956	399	240	124	141139	0	141902
17957	373	385	141770	2101	0	144629
17958	260	143773	1457	1222	0	146712
17959	152838	1420	788	712	0	155758
17960	2011	1006	281	152847	0	156145
17961	152702	299	175	2178	0	155354
17962	151208	168	180	1308	0	152864
17963	2940	148	136	151776	0	155000
17964	1416	429	153305	1993	0	157143
17965	726	172	1790	151553	0	154241
17966	366	153446	1263	2116	0	157191
17967	515	1763	338	156712	0	159328
17968	437	1232	155324	2106	0	159099
17969	151756	307	1791	1415	0	155269
17970	2152	194	1045	157724	0	161115
17971	155374	151	427	2316	0	158268
17972	2196	442	153332	1194	0	157164
17973	145084	165	1794	868	0	147911
17974	2241	429	153507	397	0	156574
17975	142370	175	1889	650	0	145084
17976	1996	146602	1156	421	0	150175
17977	1185	152242	500	494	0	154421
17978	715	2512	269	151823	0	155319
17979	575	1193	224	145911	0	147903
17980	539	396	199	153723	0	154857
17981	151957	229	232	3163	0	155581
17982	2079	208	196	154596	0	157079
17983	1290	482	153602	2236	0	157610
17984	143481	224	1745	1801	0	147251
17985	1858	153770	1197	736	0	157561
17986	155831	1723	424	852	0	158830
17987	152763	1027	324	809	0	154923
17988	3066	658	153745	521	0	157990
17989	1749	289	1893	152142	0	156073
17990	922	251	1158	163212	0	165543
17991	687	467	164646	3162	0	168962
17992	499	164225	2284	1719	0	168727
17993	161985	2036	1227	1121	0	166369
17994	162887	1180	501	949	0	165517
17995	3506	465	364	164783	0	169118
17996	1836	305	376	166573	0	169090
17997	1005	307	344	173423	0	175079
17998	168172	301	342	4259	0	173074
17999	2586	173864	613	2045	0	179108
18000	176452	2420	403	1163	0	180438
18001	175899	1412	355	947	0	178613
18002	4076	863	185540	713	0	191192
18003	2332	392	2832	178988	0	184544
18004	1012	189353	1863	3080	0	195308
18005	1030	2945	576	193255	0	197806
18006	1069	1815	454	200821	0	204159
18007	889	858	203345	4924	0	210016
18008	206216	431	3398	2836	0	212881
18009	228383	389	1962	1525	0	232259
18010	234229	424	850	1248	0	236751
18011	6890	493	546	230852	0	238781
18012	3491	573	510	221400	0	225974
18013	1346	225575	793	6235	0	233949
18014	1056	234117	864	3083	0	239120
18015	228143	6166	586	1632	0	236527
18016	4916	222454	837	1137	0	229344
18017	3020	4850	221193	1015	0	230078
18018	1653	2441	4435	223108	0	231637
18019	226074	859	2611	5201	0	234745
18020	5258	884	224377	2900	0	233419
18021	3227	944	223400	1431	0	229002
18022	225787	595	6558	1407	0	234347
18023	228519	642	2975	1337	0	233473
18024	7393	632	1090	224339	0	233454
18025	3743	771	223916	5298	0	233728
18026	2042	657	4684	225525	0	232908
18027	1598	964	217544	5634	0	225740
18028	1621	850	226620	3251	0	232342
18029	1378	228940	6723	1730	0	238771
18030	230517	4558	3157	1568	0	239800
18031	230935	2543	1207	1705	0	236390
18032	7163	227800	1228	1406	0	237597
18033	3969	4895	970	226802	0	236636
18034	2205	2736	919	231010	0	236870
18035	1938	1236	876	235294	0	239344
18036	228734	878	878	7927	0	238417
18037	5352	227855	1160	3923	0	238290
18038	223569	4739	916	2076	0	231300
18039	223111	2806	962	1665	0	228544
18040	7538	1506	215812	1425	0	226281
18041	3889	216969	4959	1398	0	227215
18042	2458	4967	2876	218262	0	228563
18043	1833	3027	220634	5116	0	230610
18044	214690	1217	5013	3525	0	224445
18045	224267	852	2943	2004	0	230066
18046	224974	781	1463	1872	0	229090
18047	221144	752	1246	1719	0	224861
18048	8291	802	1087	213061	0	223241
18049	4093	1135	210991	5259	0	221478
18050	2757	774	4886	211136	0	219553
18051	210842	840	2940	5790	0	220412
18052	210280	659	1394	3726	0	216059
18053	7236	204670	1396	1990	0	215292
18054	199646	4142	986	1697	0	206471
18055	5600	2650	196809	1318	0	206377
18056	3452	1293	195768	1179	0	201692
18057	187317	1007	6068	1411	0	195803
18058	5171	190330	3105	1232	0	199838
18059	3365	3579	1033	175419	0	183396
18060	1657	183120	1005	3667	0	189449
18061	1879	3758	701	185013	0	191351
18062	1673	2110	779	186867	0	191429
18063	1705	1062	734	194079	0	197580
18064	189007	823	749	5991	0	196570
18065	192651	846	793	2940	0	197230
18066	191342	785	767	1503	0	194397
18067	6342	993	186813	1224	0	195372
18068	186809	718	4123	1322	0	192972
18069	5393	618	2506	194161	0	202678
18070	3613	656	1161	204650	0	210080
18071	2142	828	203372	6394	0	212736
18072	2107	731	4674	224304	0	231816
18073	232084	644	2645	6294	0	241667
18074	6489	861	231424	3436	0	242210
18075	4085	589	5634	232074	0	242382
18076	233522	526	3160	6316	0	243524
18077	233692	578	1487	3630	0	239387
18078	8609	949	231740	1770	0	243068
18079	4499	1013	234930	1308	0	241750
18080	2668	775	7722	234086	0	245251
18081	239881	674	3652	6295	0	250502
18082	242515	778	1532	3790	0	248615
18083	8999	919	1102	224556	0	235576
18084	4338	239187	1343	5846	0	250714
18085	238896	5381	1059	3603	0	248939
18086	6420	243798	1564	2121	0	253903
18087	4487	5820	1031	243019	0	254357
18088	2556	3090	240448	6271	0	252365
18089	2120	1228	236137	3643	0	243128
18090	2022	928	240836	1674	0	245460
18091	2082	659	8428	228203	0	239372
18092	2068	608	3733	235075	0	241484
18093	231813	495	1685	8359	0	242352
18094	6246	230821	1614	4240	0	242921
18095	231876	5071	1059	2167	0	240173
18096	7215	2902	1223	211664	0	223004
18097	3866	223768	1446	5257	0	234337
18098	2061	232240	1421	3236	0	238958
18099	2389	7378	965	224366	0	235098
18100	224000	3005	1053	6034	0	234092
18101	6002	225825	1384	3571	0	236782
18102	212029	4657	844	1763	0	219293
18103	5672	217525	1195	1547	0	225939
18104	213378	4952	1250	1360	0	220940
18105	6073	2844	209245	1217	0	219379
18106	3708	1311	204585	1128	0	210732
18107	1737	201524	6288	1006	0	210555
18108	183999	4953	4587	1241	0	194780
18109	3784	177412	1258	975	0	183429
18110	2176	169095	935	775	0	172981
18111	1998	4817	878	169706	0	177399
18112	169676	1943	789	3466	0	175874
18113	3464	171993	870	2101	0	178428
18114	168059	3013	634	998	0	172704
18115	3435	168286	648	894	0	173263
18116	164998	3247	490	841	0	169576
18117	3423	165137	592	717	0	169869
18118	1936	168388	591	780	0	171695
18119	1282	4424	475	159233	0	165414
18120	744	167146	626	2867	0	171383
18121	163988	3199	437	1948	0	169572
18122	3329	2020	162971	829	0	169149
18123	2153	924	2840	163227	0	169144
18124	1077	960	167270	3261	0	172568
18125	992	594	3290	164805	0	169681
18126	1092	615	1867	169036	0	172610
18127	1000	748	159747	4518	0	166013
18128	139896	573	3202	2846	0	146517
18129	3503	155508	2040	1294	0	162345
18130	157629	3008	1002	1256	0	162895
18131	3849	159105	938	1079	0	164971
18132	2747	3448	738	158379	0	165312
18133	158553	1873	1591	3531	0	165548
18134	160927	984	991	2229	0	165131
18135	162976	902	882	1402	0	166162
18136	5424	835	725	158241	0	165225
18137	3279	925	746	156060	0	161010
18138	1775	163264	890	4410	0	170339
18139	165707	3538	721	2646	0	172612
18140	168385	2174	811	1395	0	172765
18141	169262	1277	951	1269	0	172759
18142	167831	1182	932	1285	0	171230
18143	5353	161240	1316	1086	0	168995
18144	2975	3463	1182	163296	0	170916
18145	1660	2395	162661	3594	0	170310
18146	156812	1266	3598	2533	0	164209
18147	169037	1158	1929	1811	0	173935
18148	5530	1331	165501	1224	0	173586
18149	3142	1503	167134	1111	0	172890
18150	2128	1435	4501	164257	0	172321
18151	1782	1455	2166	172886	0	178289
18152	1635	1529	1034	176047	0	180245
18153	171095	1549	885	5500	0	179029
18154	4228	1361	830	173539	0	179958
18155	2746	1420	168520	4348	0	177034
18156	1771	1324	3727	171662	0	178484
18157	1603	1388	174991	4418	0	182400
18158	1690	1204	3969	172031	0	178894
18159	1815	1197	2196	185223	0	190431
18160	1584	1456	183878	5637	0	192555
18161	166261	1308	4081	3229	0	174879
18162	4507	185078	2570	1497	0	193652
18163	185582	4528	934	1197	0	192241
18164	5183	2991	624	188436	0	197234
18165	187986	1819	526	4555	0	194886
18166	5036	194624	806	2910	0	203376
18167	3190	203882	790	1666	0	209528
18168	2307	8651	681	203154	0	214793
18169	1772	3521	209525	4593	0	219411
18170	1613	1735	199711	2545	0	205604
18171	1391	202483	6292	1441	0	211607
18172	174557	3615	2797	917	0	181886
18173	3499	2027	946	173822	0	180294
18174	172071	719	591	3486	0	176867
18175	3565	169971	671	2137	0	176344
18176	2123	175322	614	976	0	179035
18177	1452	5096	391	172831	0	179770
18178	173736	2367	363	3685	0	180151
18179	175316	916	349	2261	0	178842
18180	5156	802	172676	959	0	179593
18181	2484	737	166227	661	0	170109
18182	163303	515	4406	777	0	169001
18183	3301	167944	2346	731	0	174322
18184	167281	3006	941	650	0	171878
18185	3842	1922	580	164847	0	171191
18186	2265	964	160979	3146	0	167354
18187	149521	523	3066	2177	0	155287
18188	3155	157526	2077	933	0	163691
18189	1916	161414	944	672	0	164946
18190	1515	4341	797	157664	0	164317
18191	159811	2105	733	3428	0	166077
18192	3385	920	612	161424	0	166341
18193	166397	723	579	3734	0	171433
18194	3719	952	161598	1980	0	168249
18195	161963	730	2657	1282	0	166632
18196	168282	558	1547	1063	0	171450
18197	5055	778	160449	729	0	167011
18198	153847	561	2897	864	0	158169
18199	3840	157148	2048	742	0	163778
18200	2645	2882	968	153991	0	160486
18201	1535	159083	796	2699	0	164113
18202	159846	3230	729	1795	0	165600
18203	3645	1898	712	154958	0	161213
18204	2300	155385	834	3049	0	161568
18205	1546	3132	605	154827	0	160110
18206	1078	156299	613	3455	0	161445
18207	1237	3506	418	157833	0	162994
18208	156482	2118	468	3716	0	162784
18209	3584	1096	455	157405	0	162540
18210	2380	1083	154654	3683	0	161800
18211	150044	880	2879	2527	0	156330
18212	3667	796	1756	156321	0	162540
18213	2402	829	152641	3579	0	159451
18214	1710	754	145986	2426	0	150876
18215	1427	691	155998	1377	0	159493
18216	1451	591	4915	150129	0	157086
18217	1481	551	2595	158262	0	162889
18218	1414	636	1400	158720	0	162170
18219	1299	609	1120	159780	0	162808
18220	157098	725	975	5307	0	164105
18221	160016	697	824	3110	0	164647
18222	161378	771	735	1854	0	164738
18223	163769	806	620	1610	0	166805
18224	5738	788	570	158891	0	165987
18225	3175	1012	163352	3884	0	171423
18226	161449	732	3020	2855	0	168056
18227	170673	799	1947	1749	0	175168
18228	5627	781	1005	167499	0	174912
18229	3497	725	780	171988	0	176990
18230	172964	675	804	5412	0	179855
18231	4450	651	858	164888	0	170847
18232	2927	165676	1049	4223	0	173875
18233	169562	3194	903	2900	0	176559
18234	167407	1995	829	2031	0	172262
18235	5486	1196	171504	1546	0	179732
18236	3336	781	3514	170800	0	178431
18237	1947	811	2318	177353	0	182429
18238	175623	710	1247	5596	0	183176
18239	176842	674	923	3267	0	181706
18240	6106	587	672	175944	0	183309
18241	3493	760	175361	4414	0	184028
18242	2235	663	175282	2955	0	181135
18243	2076	467	4790	176800	0	184133
18244	2248	595	2482	180516	0	185841
18245	175517	484	1193	5594	0	182788
18246	4352	172534	1244	3321	0	181451
18247	2883	171161	1118	1861	0	177023
18248	1902	177585	1118	1464	0	182069
18249	1967	4741	975	172751	0	180434
18250	172275	2204	867	4074	0	179420
18251	171459	1099	542	2714	0	175814
18252	5117	172129	682	1796	0	179724
18253	173569	3326	458	1502	0	178855
18254	4464	1946	420	171812	0	178642
18255	2778	1265	173273	3773	0	181089
18256	2150	790	2984	169940	0	175864
18257	1943	731	1715	172374	0	176763
18258	1959	577	856	172150	0	175542
18259	162469	413	662	5159	0	168703
18260	3454	815	725	156070	0	161064
18261	2248	156257	863	3826	0	163194
18262	152216	2346	1119	2623	0	158304
18263	2947	151491	822	1614	0	156874
18264	1662	146922	737	1239	0	150560
18265	1146	150651	747	1133	0	153677
18266	1043	2562	135940	940	0	140485
18267	646	133745	1905	867	0	137163
18268	989	1567	122135	631	0	125322
18269	111721	671	1202	642	0	114236
18270	116706	189	487	662	0	118044
18271	1503	354	118371	377	0	120605
18272	112824	209	1006	699	0	114738
18273	122030	214	478	525	0	123247
18274	1495	362	122052	398	0	124307
18275	653	127069	987	433	0	129142
18276	553	1164	490	127368	0	129575
18277	129997	469	211	1407	0	132084
18278	1262	254	171	127503	0	129190
18279	133360	255	180	1600	0	135395
18280	131655	264	198	921	0	133038
18281	1533	438	132688	426	0	135085
18282	129172	258	950	682	0	131062
18283	1142	136081	569	444	0	138236
18284	137692	1050	173	647	0	139562
18285	1340	570	168	138093	0	140171
18286	777	514	138373	1233	0	140897
18287	573	251	987	137096	0	138907
18288	136735	267	507	1447	0	138956
18289	1177	137527	369	999	0	140072
18290	777	1332	137039	529	0	139677
18291	573	608	1023	131098	0	133302
18292	605	530	138303	1271	0	140709
18293	410	137406	1141	792	0	139749
18294	135429	1129	572	697	0	137827
18295	1354	574	267	135833	0	138028
18296	789	520	136950	1257	0	139516
18297	624	552	131428	739	0	133343
18298	135896	397	1382	637	0	138312
18299	1472	388	616	140555	0	143031
18300	961	393	307	141717	0	143378
18301	598	504	142582	1659	0	145343
18302	667	516	141075	780	0	143038
18303	606	146822	1672	547	0	149647
18304	737	1217	697	147940	0	150591
18305	738	644	388	145049	0	146819
18306	611	148264	484	1619	0	150978
18307	691	1449	145786	790	0	148716
18308	137121	674	1353	723	0	139871
18309	1645	370	659	150197	0	152871
18310	979	600	152806	1530	0	155915
18311	729	396	1356	144371	0	146852
18312	613	151970	802	1477	0	154862
18313	692	1562	150834	844	0	153932
18314	139995	796	1511	822	0	143124
18315	1779	577	155222	521	0	158099
18316	1027	593	152604	486	0	154710
18317	688	558	149144	468	0	150858
18318	654	571	160740	487	0	162452
18319	740	340	2164	158133	0	161377
18320	642	527	170304	1841	0	173314
18321	670	472	1813	162042	0	164997
18322	392	169157	1151	1854	0	172554
18323	178262	1622	478	1206	0	181568
18324	2312	914	438	179209	0	182873
18325	1310	549	175393	2299	0	179551
18326	520	174704	2256	1453	0	178933
18327	610	1980	1214	175126	0	178930
18328	173731	1074	481	2424	0	177710
18329	1995	175803	601	1219	0	179618
18330	1302	2146	406	176866	0	180720
18331	179377	1039	420	2369	0	183205
18332	2162	587	179390	1146	0	183285
18333	175530	256	2164	897	0	178847
18334	2264	448	184146	386	0	187244
18335	172576	277	2147	562	0	175562
18336	175153	184	1256	623	0	177216
18337	2907	462	173404	372	0	177145
18338	1122	170980	1897	378	0	174377
18339	641	1907	1067	166804	0	170419
18340	403	1105	174484	1810	0	177802
18341	524	378	1811	165284	0	167997
18342	526	230	1001	171340	0	173097
18343	342	356	171950	2641	0	175289
18344	387	423	170427	1246	0	172483
18345	453	226	2682	170329	0	173690
18346	174009	178	1209	2219	0	177615
18347	1875	171549	580	1322	0	175326
18348	1113	174329	493	524	0	176459
18349	174926	2570	357	722	0	178575
18350	178862	1131	404	908	0	181305
18351	2964	368	373	180037	0	183742
18352	1408	249	345	181320	0	183322
18353	616	235	343	183464	0	184658
18354	177878	218	379	3221	0	181696
18355	1940	172426	540	1448	0	176354
18356	1210	177067	551	565	0	179393
18357	655	2661	430	177001	0	180747
18358	541	1127	377	180200	0	182245
18359	588	388	380	181621	0	182977
18360	178476	304	417	3294	0	182491
18361	1954	181651	564	1780	0	185949
18362	184682	2018	448	923	0	188071
18363	2531	1365	183920	600	0	188416
18364	1395	184140	2534	618	0	188687
18365	694	2276	1472	182269	0	186711
18366	181799	1314	583	2746	0	186442
18367	2663	661	182896	1541	0	187761
18368	1669	581	183647	717	0	186614
18369	856	390	3571	181750	0	186567
18370	760	418	1609	187861	0	190648
18371	668	393	635	187384	0	189080
18372	779	400	515	182400	0	184094
18373	807	410	463	181137	0	182817
18374	582	177334	639	4021	0	182576
18375	719	2345	491	178122	0	181677
18376	174130	1374	531	3253	0	179288
18377	2430	176913	657	2122	0	182122
18378	176613	2471	513	1256	0	180853
18379	2952	1722	172186	900	0	177760
18380	1851	829	174709	860	0	178249
18381	1054	680	3745	185502	0	190981
18382	860	737	228877	3479	0	233953
18383	1018	492	4541	224975	0	231026
18384	1033	523	2670	226608	0	230834
18385	229963	500	1184	7200	0	238847
18386	225529	522	768	3855	0	230674
18387	6918	232371	1003	1744	0	242036
18388	3434	243014	918	1190	0	248556
18389	1645	7298	620	237870	0	247433
18390	239487	3534	708	5935	0	249664
18391	5338	1511	242515	3511	0	252875
18392	3372	759	5167	242506	0	251804
18393	1698	620	3059	245292	0	250669
18394	1117	784	240687	8382	0	250970
18395	835	239680	5700	4710	0	250925
18396	1209	5246	3148	239119	0	248722
18397	1215	3317	242025	6183	0	252740
18398	1200	1354	5385	240184	0	248123
18399	227475	764	3347	6777	0	238363
18400	5001	230634	1842	4282	0	241759
18401	3130	236939	1341	2235	0	243645
18402	1752	7780	1019	232425	0	242976
18403	226385	3609	1110	6388	0	237492
18404	5163	230299	1574	4499	0	241535
18405	233334	5428	1258	3239	0	243259
18406	6431	3544	231020	2730	0	243725
18407	4360	1889	236971	2626	0	245846
18408	2853	1534	8476	222461	0	235324
18409	2594	1547	4054	241467	0	249662
18410	236466	1526	1824	9620	0	249436
18411	7718	1829	1186	236923	0	247656
18412	4902	2402	234319	7572	0	249195
18413	2816	2296	5954	232121	0	243187
18414	2489	1774	3901	241071	0	249235
18415	2014	1486	229055	10444	0	242999
18416	214621	1365	6857	6457	0	229300
18417	6305	1470	4447	230814	0	243036
18418	220710	1271	2581	8578	0	233140
18419	5907	212483	2598	5707	0	226695
18420	210018	5857	2103	4031	0	222009
18421	6017	208575	1947	3569	0	220108
18422	3650	212301	2253	3409	0	221613
18423	3218	7924	2066	198091	0	211299
18424	200789	4391	1633	6605	0	213418
18425	203000	2997	1308	4357	0	211662
18426	7898	2790	1262	199511	0	211461
18427	201285	2042	1355	6889	0	211571
18428	201471	1828	1516	4809	0	209624
18429	9093	2038	1544	198683	0	211358
18430	191530	1834	1825	6668	0	201857
18431	6635	193546	2477	4846	0	207504
18432	194401	5355	2303	3758	0	205817
18433	6603	3461	189196	3873	0	203133
18434	195381	1528	5599	4327	0	206835
18435	7170	1101	3811	198189	0	210271
18436	4851	825	2736	203069	0	211481
18437	3015	923	2571	204365	0	210874
18438	2759	1430	2257	204676	0	211122
18439	2402	1427	2093	200346	0	206268
18440	2574	184415	2384	10098	0	199471
18441	2907	196636	2186	6311	0	208040
18442	196493	7058	1562	4301	0	209414
18443	7094	4925	193438	3226	0	208683
18444	191460	3405	5010	3272	0	203147
18445	7558	3190	194264	3175	0	208187
18446	5651	2879	5635	191284	0	205449
18447	4334	2874	2990	199701	0	209899
18448	193256	2277	1663	9503	0	206699
18449	8561	2109	192863	5551	0	209084
18450	6927	1795	5128	193507	0	207357
18451	5006	1841	198800	7740	0	213387
18452	4565	202632	6020	5617	0	218834
18453	4734	5906	3405	206521	0	220566
18454	207769	3550	1933	8297	0	221549
18455	205175	2229	1732	5849	0	214985
18456	208202	2130	1709	4248	0	216289
18457	10142	203554	2340	4052	0	220088
18458	6141	211154	2528	4141	0	223964
18459	183853	7828	2164	4987	0	198832
18460	6581	206432	2009	5552	0	220574
18461	4383	206858	1633	5730	0	218604
18462	3328	8115	200697	5233	0	217373
18463	2575	199558	5541	4804	0	212478
18464	2554	204431	3730	4004	0	214719
18465	3026	8677	2102	201905	0	215710
18466	3074	5456	202121	6957	0	217608
18467	3497	3119	198477	4759	0	209852
18468	190575	1796	8208	3826	0	204405
18469	7969	1855	200802	3227	0	213853
18470	202743	1540	7112	3556	0	214951
18471	7855	1601	4555	196333	0	210344
18472	5748	202875	2789	7761	0	219173
18473	210629	5568	2403	5646	0	224246
18474	218308	3882	2467	4366	0	229023
18475	9637	2059	2457	216376	0	230529
18476	6624	1864	2365	219031	0	229884
18477	4683	1796	1962	220903	0	229344
18478	213273	1664	1468	10340	0	226745
18479	204957	1700	1267	6155	0	214079
18480	213419	1990	1055	3905	0	220369
18481	9441	191826	1160	2882	0	205309
18482	152536	2942	582	1246	0	157306
18483	3664	150805	573	1071	0	156113
18484	2198	152213	641	1113	0	156165
18485	1908	5203	1221	140532	0	148864
18486	1031	145930	783	2525	0	150269
18487	139941	2482	462	1567	0	144452
18488	2629	1364	284	138756	0	143033
18489	136741	631	321	2435	0	140128
18490	2377	132481	468	1325	0	136651
18491	1406	137313	431	637	0	139787
18492	139940	2798	394	787	0	143919
18493	2551	143882	460	616	0	147509
18494	1700	2450	487	144723	0	149360
18495	1123	1279	337	147351	0	150090
18496	146322	538	361	3528	0	150749
18497	2842	443	292	147607	0	151184
18498	1664	654	148324	2772	0	153414
18499	962	544	2350	150025	0	153881
18500	151131	523	1311	3060	0	156025
18501	2801	153355	668	1710	0	158534
18502	160330	2695	418	1049	0	164492
18503	157455	1559	399	888	0	160301
18504	161861	744	350	905	0	163860
18505	4370	736	155699	640	0	161445
18506	1999	788	150667	561	0	154015
18507	147051	535	3540	722	0	151848
18508	2781	153089	1696	567	0	158133
18509	1723	2804	563	154851	0	159941
18510	933	1619	364	153294	0	156210
18511	644	147507	517	3654	0	152322
18512	665	153994	503	1738	0	156900
18513	777	3715	383	153625	0	158500
18514	807	1708	328	155947	0	158790
18515	760	945	151289	3910	0	156904
18516	747	777	144868	1898	0	148290
18517	147090	534	3752	1039	0	152415
18518	157525	593	1619	881	0	160618
18519	4308	604	589	155761	0	161262
18520	2167	742	155304	3191	0	161404
18521	1288	618	2780	155187	0	159873
18522	153574	602	1518	3596	0	159290
18523	3411	791	153157	1886	0	159245
18524	2266	615	2806	154036	0	159723
18525	1225	797	155925	3079	0	161026
18526	945	152276	3152	2117	0	158490
18527	1050	2999	154531	917	0	159497
18528	1086	2008	3001	151791	0	157886
18529	154919	779	1618	3178	0	160494
18530	3307	659	735	157876	0	162577
18531	158412	601	538	3491	0	163042
18532	160139	592	497	2099	0	163327
18533	156862	641	483	1275	0	159261
18534	4565	747	149898	891	0	156101
18535	151265	548	2697	1030	0	155540
18536	3659	532	1539	152454	0	158184
18537	2263	522	717	154299	0	157801
18538	1258	706	151040	4172	0	157176
18539	1219	867	2651	152846	0	157583
18540	153836	501	1557	3579	0	159473
18541	3032	156444	857	2118	0	162451
18542	161410	2564	523	1398	0	165895
18543	163261	1457	483	1178	0	166379
18544	164817	685	518	1125	0	167145
18545	4658	568	526	161041	0	166793
18546	2325	714	161643	3329	0	168011
18547	1338	481	2832	163987	0	168638
18548	1232	478	1658	166922	0	170290
18549	165625	465	815	4549	0	171454
18550	161072	442	619	2357	0	164490
18551	4460	630	156475	1093	0	162658
18552	2332	596	2788	155099	0	160815
18553	1181	573	158173	3369	0	163296
18554	157190	344	3385	2154	0	163073
18555	3642	172892	1990	1325	0	179849
18556	173022	3087	942	1014	0	178065
18557	3793	176378	867	838	0	181876
18558	175430	3487	649	967	0	180533
18559	3960	176001	754	771	0	181486
18560	2588	3541	573	174299	0	181001
18561	1343	1742	505	180828	0	184418
18562	180195	603	510	5363	0	186671
18563	181523	391	477	2735	0	185126
18564	182505	375	486	1349	0	184715
18565	178645	358	449	1071	0	180523
18566	180522	366	456	981	0	182325
18567	5930	346	465	172591	0	179332
18568	2773	173345	686	3727	0	180531
18569	1727	3189	450	170012	0	175378
18570	1147	171784	716	3821	0	177468
18571	1252	3492	457	165622	0	170823
18572	1075	169054	658	3729	0	174516
18573	1269	3446	415	168898	0	174028
18574	1144	1844	161794	3942	0	168724
18575	151784	667	3304	2404	0	158159
18576	3851	160954	1900	1218	0	167923
18577	162520	3270	702	1097	0	167589
18578	4249	1893	159858	861	0	166861
18579	157243	762	3357	1027	0	162389
18580	4422	713	167839	837	0	173811
18581	2727	688	3876	165233	0	172524
18582	1344	176306	2082	4022	0	183754
18583	1267	4066	179350	2231	0	186914
18584	1371	2116	4183	179821	0	187491
18585	174770	870	2266	4797	0	182703
18586	4919	580	887	184759	0	191145
18587	3061	534	552	187116	0	191263
18588	1932	499	520	189980	0	192931
18589	1358	748	182040	6726	0	190872
18590	1512	554	4099	179019	0	185184
18591	1205	178869	2333	4982	0	187389
18592	1323	3940	792	178312	0	184367
18593	1459	2115	463	179580	0	183617
18594	176395	871	491	6123	0	183880
18595	5017	722	376	181867	0	187982
18596	2760	716	183154	4969	0	191599
18597	1571	653	183284	2797	0	188305
18598	1262	629	184111	1580	0	187582
18599	989	181412	6245	1291	0	189937
18600	178563	4213	3545	1267	0	187588
18601	4395	179627	1320	1065	0	186407
18602	178059	4368	1019	1093	0	184539
18603	5019	2332	674	175592	0	183617
18604	2856	1258	180843	4467	0	189424
18605	1647	882	177287	2685	0	182501
18606	1074	185073	6065	1525	0	193737
18607	1346	4528	2791	183778	0	192443
18608	1209	2523	1185	187467	0	192384
18609	1189	1220	864	191351	0	194624
18610	977	1045	185984	7233	0	195239
18611	172636	754	4657	3943	0	181990
18612	5040	893	187789	2059	0	195781
18613	3252	730	4984	182390	0	191356
18614	1848	689	2645	190959	0	196141
18615	1262	843	185441	7270	0	194816
18616	173825	641	4968	4103	0	183537
18617	4829	185534	3111	2356	0	195830
18618	186005	4553	1525	1867	0	193950
18619	5538	2636	1104	178782	0	188060
18620	2885	184432	1348	5146	0	193811
18621	1873	4690	1089	187762	0	195414
18622	186175	2715	1026	6032	0	195948
18623	5287	1349	1096	187347	0	195079
18624	3185	1122	183527	5988	0	193822
18625	179505	983	4866	3817	0	189171
18626	185742	937	2908	2486	0	192073
18627	6985	1065	181642	1876	0	191568
18628	3768	943	4932	181703	0	191346
18629	186232	901	3035	5936	0	196104
18630	5566	893	1686	184188	0	192333
18631	3565	899	1358	183935	0	189757
18632	2180	827	1441	185522	0	189970
18633	1856	867	1307	186384	0	190414
18634	1442	1064	179340	8239	0	190085
18635	1617	873	5177	181400	0	189067
18636	1384	1033	180388	6597	0	189402
18637	175317	897	5613	4260	0	186087
18638	181861	852	3182	2812	0	188707
18639	181978	846	1855	2498	0	187177
18640	181274	807	1502	2403	0	185986
18641	7955	796	1507	172820	0	183078
18642	170864	749	1509	6016	0	179138
18643	5836	851	167753	4124	0	178564
18644	3553	834	167683	2508	0	174578
18645	160379	663	6465	2385	0	169892
18646	5099	160394	3810	2280	0	171583
18647	3128	163329	2046	2099	0	170602
18648	2379	5681	1586	160444	0	170090
18649	1690	2789	160332	5356	0	170167
18650	149205	1169	4772	3977	0	159123
18651	5016	924	160665	2485	0	169090
18652	3018	151483	4645	2456	0	161602
18653	2227	3541	151466	2068	0	159302
18654	1472	143739	4386	1954	0	151551
18655	130999	3650	3216	1858	0	139723
18656	3643	130523	1742	1800	0	137708
18657	2374	127643	1223	1672	0	132912
18658	1941	3857	1182	127230	0	134210
18659	1455	2069	126349	3743	0	133616
18660	1537	904	3291	122296	0	128028
18661	1572	672	2154	125844	0	130242
18662	1350	845	122177	4855	0	129227
18663	1611	591	3386	115674	0	121262
18664	1415	118107	2410	3634	0	125566
18665	1473	2866	1388	122959	0	128686
18666	122728	1622	1237	4017	0	129604
18667	3707	933	1119	124162	0	129921
18668	2490	826	122806	3983	0	130105
18669	1796	783	3281	124123	0	129983
18670	1412	844	123126	4039	0	129421
18671	119469	809	3668	2633	0	126579
18672	3761	786	2201	122169	0	128917
18673	122536	731	1533	3834	0	128634
18674	3812	842	122503	2515	0	129672
18675	112558	696	3417	1856	0	118527
18676	3612	124880	2492	1464	0	132448
18677	2510	3013	126245	1394	0	133162
18678	1712	2320	3479	123371	0	130882
18679	1443	1133	128249	3449	0	134274
18680	1075	119725	3289	2540	0	126629
18681	1083	125186	2286	1521	0	130076
18682	110722	3070	1078	1258	0	116128
18683	2433	118058	904	1102	0	122497
18684	118207	2614	883	1129	0	122833
18685	3174	1560	860	118631	0	124225
18686	1976	885	117375	2889	0	123125
18687	1034	120127	2840	1984	0	125985
18688	1142	2845	1870	120417	0	126274
18689	1012	1714	806	127340	0	130872
18690	1045	823	679	130105	0	132652
18691	930	765	722	125363	0	127780
18692	840	119921	870	4399	0	126030
18693	710	126364	896	2414	0	130384
18694	118087	3336	761	1221	0	123405
18695	2457	118762	782	945	0	122946
18696	1568	2439	507	113701	0	118215
18697	826	1511	112893	2641	0	117871
18698	580	112472	2385	1810	0	117247
18699	744	2290	1441	110530	0	115005
18700	783	1796	600	107758	0	110937
18701	458	110781	652	3129	0	115020
18702	107236	2214	553	1722	0	111725
18703	2154	1531	107521	793	0	111999
18704	96471	691	1850	691	0	99703
18705	1976	102986	1270	570	0	106802
18706	95253	1856	438	559	0	98106
18707	1802	98762	342	441	0	101347
18708	1313	2120	320	102283	0	106036
18709	597	1412	315	104674	0	106998
18710	101668	664	288	3194	0	105814
18711	2089	501	271	103940	0	106801
18712	1308	612	102151	2380	0	106451
18713	525	98859	1876	1600	0	102860
18714	404	101739	1244	751	0	104138
18715	460	2921	579	100257	0	104217
18716	471	1662	101295	2083	0	105511
18717	429	731	1744	100192	0	103096
18718	416	505	1142	103134	0	105197
18719	330	657	100593	3077	0	104657
18720	380	601	97775	1826	0	100582
18721	287	100032	2713	913	0	103945
18722	100453	2014	1291	814	0	104572
18723	1893	1470	469	96716	0	100548
18724	1228	96670	505	1876	0	100279
18725	99957	2074	347	1544	0	103922
18726	1938	1458	311	100370	0	104077
18727	1318	699	307	100420	0	102744
18728	481	98901	448	3125	0	102955
18729	535	2110	300	98355	0	101300
18730	97831	1512	321	2552	0	102216
18731	2095	763	344	99596	0	102798
18732	1452	657	337	100647	0	103093
18733	679	807	97493	3146	0	102125
18734	617	737	92893	1858	0	96105
18735	96060	621	2759	1202	0	100642
18736	2032	664	1370	98188	0	102254
18737	1498	640	537	99119	0	101794
18738	745	618	433	101053	0	102849
18739	598	753	97377	3479	0	102207
18740	95297	612	1977	2119	0	100005
18741	2156	597	1464	97831	0	102048
18742	1596	694	691	99233	0	102214
18743	96200	678	564	3502	0	100944
18744	2006	96170	658	2242	0	101076
18745	1490	2270	96171	1323	0	101254
18746	848	1524	1970	91905	0	96247
18747	630	95778	1533	2660	0	100601
18748	723	2096	732	98176	0	101727
18749	96551	1566	577	2859	0	101553
18750	2148	845	522	97399	0	100914
18751	95801	763	516	2897	0	99977
18752	95440	709	506	2269	0	98924
18753	3120	662	524	92123	0	96429
18754	1729	90746	739	2717	0	95931
18755	770	94759	674	2238	0	98441
18756	706	3027	93524	1450	0	98707
18757	904	1682	2114	88897	0	93597
18758	788	862	1423	95440	0	98513
18759	850	678	634	97680	0	99842
18760	94477	611	550	4011	0	99649
18761	2360	593	499	96423	0	99875
18762	1746	697	95034	3105	0	100582
18763	94271	563	2042	2483	0	99359
18764	2383	532	1466	99634	0	104015
18765	1759	612	725	102118	0	105214
18766	883	710	99196	3929	0	104718
18767	94422	559	2140	2587	0	99708
18768	2328	574	1454	100729	0	105085
18769	1705	710	102601	3127	0	108143
18770	1047	490	2204	102470	0	106211
18771	1108	530	1695	91003	0	94336
18772	917	103282	924	3439	0	108562
18773	102893	1990	608	2517	0	108008
18774	101581	1370	612	1773	0	105336
18775	3165	101094	765	1499	0	106523
18776	97571	1912	559	1440	0	101482
18777	95270	1246	575	1428	0	98519
18778	3212	568	510	94496	0	98786
18779	1700	557	90419	2717	0	95393
18780	932	468	86547	1918	0	89865
18781	722	454	87137	1194	0	89507
18782	670	486	89782	1152	0	92090
18783	725	779	2516	82162	0	86182
18784	579	320	1171	87101	0	89171
18785	621	324	530	86487	0	87962
18786	763	242	369	88105	0	89479
18787	84901	204	375	2828	0	88308
18788	1678	85143	522	1635	0	88978
18789	83805	1188	425	1009	0	86427
18790	1638	884	83138	702	0	86362
18791	1066	413	86499	649	0	88627
18792	706	382	1954	87952	0	90994
18793	88955	175	1504	1993	0	92627
18794	79483	175	525	1405	0	81588
18795	2035	87257	445	791	0	90528
18796	1031	89247	376	634	0	91288
18797	612	1829	261	89210	0	91912
18798	89241	871	274	1641	0	92027
18799	1372	89966	373	1115	0	92826
18800	90892	1213	247	771	0	93123
18801	90290	829	242	680	0	92041
18802	90988	322	251	679	0	92240
18803	2128	342	91265	450	0	94185
18804	1098	92250	1294	474	0	95116
18805	91376	1070	748	582	0	93776
18806	90172	677	362	543	0	91754
18807	1730	87158	242	378	0	89508
18808	674	84138	179	233	0	85224
18809	83824	1224	177	292	0	85517
18810	1051	585	101	83946	0	85683
18811	711	317	83878	906	0	85812
18812	80015	217	845	646	0	81723
18813	1030	216	494	84630	0	86370
18814	644	87184	274	898	0	89000
18815	378	939	117	89206	0	90640
18816	306	681	88892	1039	0	90918
18817	354	319	932	87996	0	89601
18818	92175	177	520	1342	0	94214
18819	1146	190	215	92996	0	94547
18820	787	170	124	94073	0	95154
18821	369	344	98268	1578	0	100559
18822	402	173	997	94520	0	96092
18823	288	98603	688	1161	0	100740
18824	99250	993	258	853	0	101354
18825	95942	586	153	518	0	97199
18826	1626	390	99119	274	0	101409
18827	869	184	1008	95803	0	97864
18828	312	96745	659	1150	0	98866
18829	288	100038	339	662	0	101327
18830	98640	1426	160	456	0	100682
18831	1303	713	156	100331	0	102503
18832	788	373	100063	1204	0	102428
18833	441	351	98750	756	0	100298
18834	375	204	1627	100148	0	102354
18835	99645	175	769	1365	0	101954
18836	99494	199	313	921	0	100927
18837	1839	209	232	102916	0	105196
18838	995	360	104729	1278	0	107362
18839	359	104846	1246	908	0	107359
18840	104801	1123	690	636	0	107250
18841	1224	106578	417	452	0	108671
18842	106951	1231	201	578	0	108961
18843	1459	704	231	106849	0	109243
18844	921	500	106456	1344	0	109221
18845	553	267	1176	104837	0	106833
18846	105295	240	767	1579	0	107881
18847	1410	354	106080	882	0	108726
18848	845	106395	1295	589	0	109124
18849	591	1166	727	107625	0	110109
18850	107939	688	329	1515	0	110471
18851	1413	474	108049	905	0	110841
18852	996	291	1295	109109	0	111691
18853	580	249	758	112288	0	113875
18854	435	443	112228	1931	0	115037
18855	589	265	1305	110087	0	112246
18856	522	405	111961	1535	0	114423
18857	106054	264	1418	1167	0	108903
18858	1553	255	848	115877	0	118533
18859	1074	449	121459	1528	0	124510
18860	522	123072	1614	1190	0	126398
18861	126043	1584	871	770	0	129268
18862	135143	880	417	778	0	137218
18863	2907	457	325	142572	0	146261
18864	1306	147543	567	2330	0	151746
18865	148596	2555	365	1468	0	152984
18866	2905	1274	316	148965	0	153460
18867	1580	680	148809	2693	0	153762
18868	143303	358	2538	1746	0	147945
18869	2731	145614	1412	732	0	150489
18870	1692	2456	549	146748	0	151445
18871	147353	1231	384	2891	0	151859
18872	2838	699	144772	1466	0	149775
18873	1595	563	147496	679	0	150333
18874	935	369	3573	141343	0	146220
18875	627	511	150627	2844	0	154609
18876	795	301	3000	143674	0	147770
18877	469	147898	1724	2892	0	152983
18878	611	2615	769	153926	0	157921
18879	150815	1235	555	3336	0	155941
18880	2850	680	151663	1760	0	156953
18881	1463	151305	2933	1087	0	156788
18882	986	2619	1392	149487	0	154484
18883	672	1506	153256	2959	0	158393
18884	675	881	2679	143298	0	147533
18885	469	147610	1643	2834	0	152556
18886	418	153050	835	1518	0	155821
18887	146354	3293	516	1017	0	151180
18888	2254	150709	649	662	0	154274
18889	1205	2627	144625	571	0	149028
18890	131611	1334	2640	753	0	136338
18891	2486	789	144306	379	0	147960
18892	1365	450	2445	133340	0	137600
18893	731	504	144338	2301	0	147874
18894	498	143394	2570	1269	0	147731
18895	624	2148	1239	144378	0	148389
18896	564	1034	564	144683	0	146845
18897	549	478	465	143186	0	144678
18898	410	585	142407	3396	0	146798
18899	572	377	2302	139589	0	142840
18900	536	396	1146	144127	0	146205
18901	139868	345	636	3603	0	144452
18902	139348	315	533	1920	0	142116
18903	3165	486	139577	945	0	144173
18904	1440	136700	2536	784	0	141460
18905	829	2346	139441	602	0	143218
18906	687	1147	2553	139279	0	143666
18907	587	793	142525	2508	0	146413
18908	652	448	2668	140310	0	144078
18909	583	394	1423	144811	0	147211
18910	471	560	142889	3530	0	147450
18911	128432	390	2628	2068	0	133518
18912	2335	143919	1617	1048	0	148919
18913	1423	2383	692	143676	0	148174
18914	676	1453	146111	2635	0	150875
18915	603	730	142378	1524	0	145235
18916	136023	489	3294	1002	0	140808
18917	2289	143438	1730	854	0	148311
18918	1349	2335	775	142611	0	147070
18919	144606	1123	627	2776	0	149132
18920	2596	505	612	145551	0	149264
18921	1549	495	524	145277	0	147845
18922	731	703	143954	3598	0	148986
18923	135145	443	2522	2150	0	140260
18924	145298	376	1488	1236	0	148398
18925	3654	389	824	145031	0	149898
18926	145161	370	684	2925	0	149140
18927	2999	371	632	144331	0	148333
18928	1565	140077	802	3242	0	145686
18929	860	147045	780	1841	0	150526
18930	1018	3640	638	148256	0	153552
18931	144938	1506	580	3229	0	150253
18932	2631	616	499	146962	0	150708
18933	149547	504	471	3382	0	153904
18934	150526	479	583	2007	0	153595
18935	3939	416	497	150030	0	154882
18936	2020	376	571	154200	0	157167
18937	1022	559	148227	4069	0	153877
18938	899	564	151088	1991	0	154542
18939	881	409	3944	151729	0	156963
18940	697	578	159972	3395	0	164642
18941	154327	368	3535	2240	0	160470
18942	3202	328	1937	166486	0	171953
18943	1738	583	173499	3710	0	179530
18944	169874	306	3777	2441	0	176398
18945	183993	318	2052	1451	0	187814
18946	5338	186638	1124	1061	0	194161
18947	2854	3686	685	189117	0	196342
18948	1363	2289	194463	4029	0	202144
18949	191925	774	4054	2774	0	199527
18950	200662	519	2262	1532	0	204975
18951	5834	796	199775	1065	0	207470
18952	200051	351	4143	1189	0	205734
18953	4933	427	2325	198233	0	205918
18954	2957	394	1013	202178	0	206542
18955	199848	361	803	6230	0	207242
18956	201157	274	761	3265	0	205457
18957	6399	913	839	197652	0	205803
18958	3359	551	197205	4476	0	205591
18959	1491	190176	4025	3109	0	198801
18960	1408	3511	191803	1413	0	198135
18961	1479	1997	191018	1257	0	195751
18962	1046	182522	5548	1075	0	190191
18963	1424	2850	2827	164982	0	172083
18964	984	1570	1020	168720	0	172294
18965	863	864	166603	4148	0	172478
18966	1093	367	2937	164954	0	169351
18967	166337	333	1916	3718	0	172304
18968	3304	574	169096	2170	0	175144
18969	168662	323	3088	1461	0	173534
18970	173405	275	2075	1178	0	176933
18971	175702	296	1050	1169	0	178217
18972	5348	586	170145	873	0	176952
18973	2927	589	170864	898	0	175278
18974	1891	399	4328	168128	0	174746
18975	1631	482	2367	159260	0	163740
18976	1181	170065	1317	4120	0	176683
18977	169757	2580	986	2455	0	175778
18978	168812	1557	945	1497	0	172811
18979	4634	168571	1032	1200	0	175437
18980	168790	2642	889	1353	0	173674
18981	3634	167038	1044	1194	0	172910
18982	168473	3019	867	1241	0	173600
18983	3820	1716	891	162116	0	168543
18984	2388	1081	164267	3293	0	171029
18985	1507	781	163282	2147	0	167717
18986	1408	642	4399	160654	0	167103
18987	1364	448	2622	164309	0	168743
18988	1220	734	162219	4488	0	168661
18989	1318	568	3418	159335	0	164639
18990	1413	475	2365	163272	0	167525
18991	160423	436	1419	4918	0	167196
18992	162483	473	1149	2852	0	166957
18993	159984	449	1059	1804	0	163296
18994	5265	621	154590	1223	0	161699
18995	2953	154582	3580	1289	0	162404
18996	2170	2737	2239	154967	0	162113
18997	1834	1877	159242	3163	0	166116
18998	1529	159828	3610	2230	0	167197
18999	161669	2877	2286	1538	0	168370
19000	3980	1789	1287	161391	0	168447
19001	2894	921	1097	164227	0	169139
19002	162867	684	1063	4764	0	169378
19003	3969	744	1031	162786	0	168530
19004	2950	674	1027	164122	0	168773
19005	162184	679	1002	5213	0	169078
19006	3826	903	159206	2884	0	166819
19007	2696	158032	3529	1703	0	165960
19008	158142	2855	2182	1665	0	164844
19009	3818	1960	159906	1598	0	167282
19010	156626	889	3380	1716	0	162611
19011	3893	163513	2648	1439	0	171493
19012	162225	2797	1457	1704	0	168183
19013	162402	1649	1266	1734	0	167051
19014	159836	880	1204	1564	0	163484
19015	5427	689	1129	155485	0	162730
19016	3254	963	1085	154599	0	159901
19017	1949	153320	1320	4582	0	161171
19018	1709	155172	1391	2772	0	161044
19019	1645	157655	1233	1785	0	162318
19020	155161	3738	1030	1645	0	161574
19021	3565	2225	152579	1331	0	159700
19022	2861	964	2785	151739	0	158349
19023	1813	758	1868	151853	0	156292
19024	1398	152817	1338	4284	0	159837
19025	1724	2890	896	153840	0	159350
19026	1622	1824	964	151643	0	156053
19027	1310	153739	1138	4373	0	160560
19028	150727	2820	948	2687	0	157182
19029	3237	153751	1096	1716	0	159800
19030	2343	3074	149484	1410	0	156311
19031	146890	1752	2703	1603	0	152948
19032	3373	152174	1968	1436	0	158951
19033	144485	2605	983	1309	0	149382
19034	3697	1680	775	148211	0	154363
19035	2832	848	780	148863	0	153323
19036	1788	1000	146284	3628	0	152700
19037	1728	1084	145824	1901	0	150537
19038	1603	1241	3096	143228	0	149168
19039	142800	665	1597	2844	0	147906
19040	138803	625	916	1703	0	142047
19041	3590	144809	774	1102	0	150275
19042	1790	141341	663	892	0	144686
19043	1090	139283	467	625	0	141465
19044	2762	4008	1740	132473	0	140983
19045	132734	1070	1776	2461	0	138041
19046	135826	407	193	1335	0	137761
19047	134841	307	174	750	0	136072
19048	3215	435	130329	441	0	134420
19049	1362	152315	2190	455	0	156322
19050	780	2485	1073	164348	0	168686
19051	164648	1248	333	3062	0	169291
19052	3288	457	280	166565	0	170590
19053	1718	337	212	171930	0	174197
19054	170565	287	248	4632	0	175732
19055	178388	302	218	2014	0	180922
19056	4928	442	178334	679	0	184383
19057	2333	262	3326	178372	0	184293
19058	794	372	176531	3659	0	181356
19059	720	259	3532	176248	0	180759
19060	586	449	174991	3872	0	179898
19061	665	396	3502	173742	0	178305
19062	167539	218	1701	3957	0	173415
19063	3278	169651	723	2082	0	175734
19064	1812	177283	551	799	0	180445
19065	1185	5098	326	152204	0	158813
19066	451	178580	490	2857	0	182378
19067	177469	3682	330	1735	0	183216
19068	173392	1841	302	871	0	176406
19069	5211	727	169821	587	0	176346
19070	2176	170253	3539	644	0	176612
19071	962	3330	1659	171268	0	177219
19072	676	1890	171163	3587	0	177316
19073	168157	541	3506	2012	0	174216
19074	3922	538	1771	170511	0	176742
19075	2128	572	171320	3696	0	177716
19076	1065	379	3504	172414	0	177362
19077	171994	322	1926	4082	0	178324
19078	3911	499	170888	2126	0	177424
19079	170370	340	3638	976	0	175324
19080	174749	364	1935	792	0	177840
19081	5480	405	622	171227	0	177734
19082	2454	583	171999	3860	0	178896
19083	1104	560	169747	2269	0	173680
19084	168041	370	5114	1170	0	174695
19085	174029	392	2185	984	0	177590
19086	5765	599	170998	807	0	178169
19087	2920	439	3793	169152	0	176304
19088	1383	440	2195	163336	0	167354
19089	966	171220	1048	5241	0	178475
19090	1348	3698	680	171870	0	177596
19091	171845	1888	769	4572	0	179074
19092	4590	615	656	173567	0	179428
19093	2533	646	170391	4681	0	178251
19094	165058	515	4136	2711	0	172420
19095	4582	545	2221	167890	0	175238
19096	2778	799	168376	4401	0	176354
19097	1235	165412	4208	2879	0	173734
19098	160366	3839	2377	1796	0	168378
19099	4330	166734	1287	1660	0	174011
19100	166038	4036	946	1543	0	172563
19101	5053	2309	163534	1500	0	172396
19102	3042	158675	4286	1422	0	167425
19103	1727	167192	2631	1448	0	172998
19104	1818	5469	1334	161720	0	170341
19105	1821	2379	1180	166583	0	171963
19106	1501	1078	163288	6311	0	172178
19107	1704	697	4491	164665	0	171557
19108	162025	691	2835	5213	0	170764
19109	4771	950	159810	3193	0	168724
19110	3233	832	4496	159650	0	168211
19111	1699	1128	158167	5050	0	166044
19112	151140	984	4747	3412	0	160283
19113	4663	157156	3023	2067	0	166909
19114	159452	4111	1562	2200	0	167325
19115	162686	2427	1349	1906	0	168368
19116	164787	1081	1308	1804	0	168980
19117	7126	1163	156161	1577	0	166027
19118	3649	157153	4932	1545	0	167279
19119	2439	4363	2905	157041	0	166748
19120	2065	2587	1693	165376	0	171721
19121	168820	1237	1508	6893	0	178458
19122	5968	869	1519	170797	0	179153
19123	172570	833	1692	6123	0	181218
19124	173404	941	1741	3754	0	179840
19125	175450	874	1461	2359	0	180144
19126	175843	853	1652	1892	0	180240
19127	8306	922	1430	168542	0	179200
19128	170548	900	1499	5760	0	178707
19129	6359	1117	165105	3626	0	176207
19130	166592	832	5225	2225	0	174874
19131	170846	792	3307	1669	0	176614
19132	8010	1113	162586	2690	0	174399
19133	166864	849	5326	1642	0	174681
19134	171456	834	3266	1649	0	177205
19135	8014	816	1705	165975	0	176510
19136	4578	750	1623	169102	0	176053
19137	163315	1875	1488	7367	0	174045
19138	6364	742	1322	164285	0	172713
19139	4344	685	1477	160829	0	167335
19140	2417	154092	1728	7092	0	165329
19141	2352	3436	1235	150526	0	157549
19142	146793	1843	1196	5096	0	154928
19143	5477	788	1018	145708	0	152991
19144	3398	508	1151	141153	0	146210
19145	2069	134930	1356	5684	0	144039
19146	2356	3158	947	131615	0	138076
19147	2549	1817	1007	130245	0	135618
19148	124540	830	890	4922	0	131182
19149	3786	1432	552	98316	0	104086
19150	1824	467	88486	2719	0	93496
19151	858	83066	2109	1659	0	87692
19152	735	83911	1245	754	0	86645
19153	80779	2516	701	741	0	84737
19154	2273	81892	553	627	0	85345
19155	74702	1578	897	652	0	77829
19156	1906	74888	324	469	0	77587
19157	76438	1651	200	569	0	78858
19158	2087	837	114	76950	0	79988
19159	1260	397	136	77966	0	79759
19160	635	77298	271	2577	0	80781
19161	834	1713	130	79313	0	81990
19162	591	1006	79338	2087	0	83022
19163	75755	344	1621	1384	0	79104
19164	1926	86424	960	690	0	90000
19165	85539	1812	274	600	0	88225
19166	85973	1023	168	596	0	87760
19167	87236	373	167	541	0	88317
19168	3273	240	153	84154	0	87820
19169	1643	259	154	83455	0	85511
19170	705	83635	260	2966	0	87566
19171	83117	1952	120	1552	0	86741
19172	2127	84428	259	761	0	87575
19173	85047	2040	173	627	0	87887
19174	2427	1252	85160	544	0	89383
19175	88752	429	1930	571	0	91682
19176	2783	345	1004	89358	0	93490
19177	1641	391	88569	2454	0	93055
19178	874	359	89474	1493	0	92200
19179	788	260	3144	89230	0	93422
19180	666	329	90415	2540	0	93950
19181	689	295	2451	89392	0	92827
19182	86020	264	1269	2755	0	90308
19183	2648	291	458	87331	0	90728
19184	1675	354	85345	2696	0	90070
19185	816	83154	2267	1626	0	87863
19186	634	86543	1332	755	0	89264
19187	921	3210	503	83803	0	88437
19188	84715	1389	425	2638	0	89167
19189	2558	491	217	85746	0	89012
19190	1633	355	238	87084	0	89310
19191	909	329	263	88441	0	89942
19192	724	388	220	88892	0	90224
19193	683	440	85837	3658	0	90618
19194	683	398	84387	1836	0	87304
19195	83946	299	3115	967	0	88327
19196	87400	324	1443	814	0	89981
19197	3589	320	570	85629	0	90108
19198	1969	311	349	87498	0	90127
19199	927	417	84737	3602	0	89683
19200	637	85384	2353	1971	0	90345
19201	85283	2234	1283	1097	0	89897
19202	87110	1299	521	882	0	89812
19203	3594	615	359	85549	0	90117
19204	1882	545	85821	2719	0	90967
19205	1092	481	2223	81690	0	85486
19206	738	85105	1466	2692	0	90001
19207	789	2394	85947	1611	0	90741
19208	84103	1351	2317	1072	0	88843
19209	2742	637	1354	87158	0	91891
19210	88676	412	641	2854	0	92583
19211	2743	555	85629	1844	0	90771
19212	85787	399	2363	1173	0	89722
19213	2936	422	1456	86331	0	91145
19214	85852	414	667	2782	0	89715
19215	2996	401	504	82909	0	86810
19216	1686	80379	673	2779	0	85517
19217	912	83828	647	1768	0	87155
19218	1120	3394	484	80844	0	85842
19219	751	1419	79633	2392	0	84195
19220	638	78323	2057	1623	0	82641
19221	1152	1778	1204	73342	0	77476
19222	71849	961	649	2101	0	75560
19223	72125	416	435	1427	0	74403
19224	2611	294	382	71576	0	74863
19225	1466	336	448	71088	0	73338
19226	705	68258	510	2574	0	72047
19227	617	72123	492	1500	0	74732
19228	70967	2196	391	1019	0	74573
19229	1914	1122	424	70501	0	73961
19230	1270	456	412	71611	0	73749
19231	696	454	69666	2915	0	73731
19232	650	308	1752	69505	0	72215
19233	695	308	1161	69508	0	71672
19234	727	324	561	70610	0	72222
19235	677	400	69094	2886	0	73057
19236	676	308	1721	70162	0	72867
19237	69125	279	1155	2452	0	73011
19238	1797	421	68276	1627	0	72121
19239	70901	364	1778	1285	0	74328
19240	2065	326	1182	72492	0	76065
19241	1407	281	571	75570	0	77829
19242	934	271	465	77894	0	79564
19243	644	341	74924	3111	0	79020
19244	70955	221	1894	1921	0	74991
19245	1960	77606	1332	1093	0	81991
19246	77982	1723	591	989	0	81285
19247	2093	78933	579	870	0	82475
19248	1440	1892	410	79052	0	82794
19249	79483	1096	363	2414	0	83356
19250	2111	528	78060	1592	0	82291
19251	75546	339	1803	1063	0	78751
19252	2200	444	80111	805	0	83560
19253	1556	451	1939	78288	0	82234
19254	779	368	78895	2163	0	82205
19255	618	77311	1997	1599	0	81525
19256	885	1689	1223	75067	0	78864
19257	73715	997	653	2127	0	77492
19258	1751	388	348	71703	0	74190
19259	1054	71259	439	1783	0	74535
19260	716	1449	315	72529	0	75009
19261	71051	839	310	1893	0	74093
19262	68831	325	300	1298	0	70754
19263	2228	67508	381	796	0	70913
19264	867	61697	285	395	0	63244
19265	483	1482	239	60777	0	62981
19266	395	753	269	61607	0	63024
19267	60542	277	182	1714	0	62715
19268	59390	214	189	980	0	60773
19269	1514	60308	325	506	0	62653
19270	891	1130	166	58827	0	61014
19271	551	683	171	60001	0	61406
19272	433	359	59030	1570	0	61392
19273	339	57830	1008	970	0	60147
19274	310	56725	551	457	0	58043
19275	312	1036	154	54270	0	55772
19276	257	505	54499	775	0	56036
19277	216	277	54415	539	0	55447
19278	237	158	1091	54715	0	56201
19279	260	189	537	55878	0	56864
19280	251	252	55494	1180	0	57177
19281	258	125	814	56055	0	57252
19282	231	229	57296	954	0	58710
19283	58392	131	891	761	0	60175
19284	1076	173	536	59685	0	61470
19285	633	208	60676	1179	0	62696
19286	355	223	60320	749	0	61647
19287	332	137	1550	62864	0	64883
19288	267	236	67165	1325	0	68993
19289	350	249	67616	890	0	69105
19290	186	65103	1904	512	0	67705
19291	67507	1210	856	442	0	70015
19292	1400	834	69488	295	0	72017
19293	903	283	1333	67265	0	69784
19294	346	224	829	70350	0	71749
19295	260	166	311	72085	0	72822
19296	226	277	69966	2236	0	72705
19297	281	170	1366	69030	0	70847
19298	69194	159	876	1707	0	71936
19299	1422	161	319	69289	0	71191
19300	829	277	68627	1717	0	71450
19301	372	186	1441	68479	0	70478
19302	68676	141	963	1771	0	71551
19303	70449	133	401	1162	0	72145
19304	69995	139	311	601	0	71046
19305	2184	124	317	69282	0	71907
19306	69842	96	360	1631	0	71929
19307	69804	109	353	1149	0	71415
19308	69841	108	321	618	0	70888
19309	2162	66825	388	495	0	69870
19310	68039	1280	361	544	0	70224
19311	1653	750	376	67693	0	70472
19312	1034	335	67075	1592	0	70036
19313	448	67085	1569	1124	0	70226
19314	67583	1332	969	643	0	70527
19315	1504	847	492	67769	0	70612
19316	1089	292	389	65650	0	67420
19317	439	66171	475	2088	0	69173
19318	337	69714	479	1180	0	71710
19319	65474	1969	368	669	0	68480
19320	1462	66636	427	561	0	69086
19321	64453	1419	313	554	0	66739
19322	1479	64696	378	539	0	67092
19323	63468	1422	296	531	0	65717
19324	1531	63879	338	531	0	66279
19325	1002	66091	379	499	0	67971
19326	65330	1860	292	596	0	68078
19327	1607	981	64048	465	0	67101
19328	1049	65704	1377	492	0	68622
19329	689	1288	881	65991	0	68849
19330	501	850	419	69648	0	71418
19331	609	340	339	70088	0	71376
19332	625	227	299	71553	0	72704
19333	591	328	70404	2462	0	73785
19334	68590	276	1543	1401	0	71810
19335	1879	251	968	72945	0	76043
19336	74439	240	465	1951	0	77095
19337	76797	248	414	1289	0	78748
19338	77842	299	389	760	0	79290
19339	74898	280	411	639	0	76228
19340	2792	357	72674	624	0	76447
19341	1456	346	1729	71160	0	74691
19342	738	348	71323	1977	0	74386
19343	537	70146	2017	1348	0	74048
19344	868	1830	1305	62236	0	66239
19345	633	981	504	67592	0	69710
19346	464	332	412	69005	0	70213
19347	480	247	394	68616	0	69737
19348	458	315	66242	2764	0	69779
19349	569	282	1756	66582	0	69189
19350	579	248	1120	68178	0	70125
19351	67529	271	475	2762	0	71037
19352	69810	239	413	1559	0	72021
19353	2940	272	440	69589	0	73241
19354	1578	229	443	70726	0	72976
19355	839	267	422	71899	0	73427
19356	70067	247	395	3254	0	73963
19357	71929	260	378	1752	0	74319
19358	71023	266	423	923	0	72635
19359	71392	326	357	860	0	72935
19360	3023	69825	388	838	0	74074
19361	71316	1669	321	864	0	74170
19362	71859	1009	337	870	0	74075
19363	3110	383	253	69957	0	73703
19364	1841	245	264	70537	0	72887
19365	68302	255	294	3095	0	71946
19366	2240	66652	363	1759	0	71014
19367	1605	69133	342	886	0	71966
19368	70992	2451	236	854	0	74533
19369	2516	1193	221	71517	0	75447
19370	1780	490	218	72878	0	75366
19371	1161	355	169	74408	0	76093
19372	1014	380	179	74337	0	75910
19373	1000	378	210	72887	0	74475
19374	862	70462	336	3075	0	74735
19375	910	1712	173	69831	0	72626
19376	68931	1045	195	2269	0	72440
19377	2121	477	194	68379	0	71171
19378	1464	372	198	68783	0	70817
19379	66823	348	214	2818	0	70203
19380	1972	67356	293	1615	0	71236
19381	1399	2015	198	65641	0	69253
19382	750	67189	276	1943	0	70158
19383	807	1766	157	64894	0	67624
19384	660	924	62969	1755	0	66308
19385	57065	432	1178	1270	0	59945
19386	1467	61171	761	751	0	64150
19387	58557	1013	263	634	0	60467
19388	1406	666	56065	619	0	58756
19389	927	499	983	51930	0	54339
19390	523	53025	611	1242	0	55401
19391	430	55427	297	996	0	57150
19392	53690	1281	221	707	0	55899
19393	1289	618	115	53825	0	55847
19394	834	278	56067	1354	0	58533
19395	572	170	897	57241	0	58880
19396	456	234	57290	1462	0	59442
19397	53719	170	1010	1092	0	55991
19398	1302	239	58011	680	0	60232
19399	940	206	993	56484	0	58623
19400	553	59182	627	1373	0	61735
19401	585	1020	188	57780	0	59573
19402	480	59674	219	1395	0	61768
19403	60545	1041	151	1086	0	62823
19404	1425	681	109	62540	0	64755
19405	967	375	62986	1531	0	65859
19406	661	317	61280	1070	0	63328
19407	61119	199	1393	876	0	63587
19408	65919	269	613	773	0	67574
19409	66148	243	207	733	0	67331
19410	65291	228	159	722	0	66400
19411	1821	64403	228	706	0	67158
19412	65673	1116	133	763	0	67685
19413	65718	685	128	743	0	67274
19414	1883	430	63550	644	0	66507
19415	1113	289	953	62907	0	65262
19416	64182	287	570	1578	0	66617
19417	1446	370	62845	1127	0	65788
19418	1037	289	1000	62485	0	64811
19419	627	377	65671	1563	0	68238
19420	671	306	1052	63117	0	65146
19421	549	66360	643	1481	0	69033
19422	67523	1111	262	1042	0	69938
19423	1359	825	65964	711	0	68859
19424	65309	391	988	712	0	67400
19425	1519	351	603	66585	0	69058
19426	66870	289	272	1532	0	68963
19427	1449	284	215	66728	0	68676
19428	69459	318	248	1714	0	71739
19429	1400	411	67566	1032	0	70409
19430	69243	346	988	844	0	71421
19431	1410	258	570	70548	0	72786
19432	969	302	275	70804	0	72350
19433	69089	238	228	1668	0	71223
19434	1292	230	214	69475	0	71211
19435	716	326	67761	1162	0	69965
19436	513	358	770	66966	0	68607
19437	63583	140	504	1090	0	65317
19438	822	63487	290	646	0	65245
19439	532	63954	250	358	0	65094
19440	62843	705	135	357	0	64040
19441	652	66159	202	252	0	67265
19442	551	525	147	65328	0	66551
19443	65836	273	178	756	0	67043
19444	65794	170	97	446	0	66507
19445	65547	164	92	306	0	66109
19446	787	267	65544	203	0	66801
19447	423	235	455	64455	0	65568
19448	185	66252	361	573	0	67371
19449	258	471	198	66900	0	67827
19450	229	351	68295	538	0	69413
19451	235	64802	560	377	0	65974
19452	306	628	252	65831	0	67017
19453	63874	179	116	507	0	64676
19454	373	64677	113	300	0	65463
19455	316	435	65629	121	0	66501
19456	210	217	408	64264	0	65099
19457	179	185	65692	437	0	66493
19458	179	80	437	63574	0	64270
19459	66583	49	241	665	0	67538
19460	515	60	103	66657	0	67335
19461	66853	47	103	633	0	67636
19462	67225	75	100	440	0	67840
19463	666	68661	160	143	0	69630
19464	69812	406	82	300	0	70600
19465	547	69409	144	132	0	70232
19466	384	550	70272	152	0	71358
19467	326	244	505	68728	0	69803
19468	278	100	276	75154	0	75808
19469	230	181	73106	837	0	74354
19470	164	72890	629	420	0	74103
19471	73952	542	327	279	0	75100
19472	75483	301	117	338	0	76239
19473	908	106	107	76394	0	77515
19474	492	80	117	76889	0	77578
19475	229	74	113	78303	0	78719
19476	76705	78	117	1053	0	77953
19477	699	188	75816	428	0	77131
19478	480	222	76131	191	0	77024
19479	257	84	881	77004	0	78226
19480	213	202	76899	708	0	78022
19481	234	210	76388	455	0	77287
19482	273	87	895	73291	0	74546
19483	284	181	78619	750	0	79834
19484	189	78095	732	694	0	79710
19485	220	644	387	79548	0	80799
19486	200	472	80735	791	0	82198
19487	223	115	692	79370	0	80400
19488	164	77679	483	836	0	79162
19489	254	628	143	79729	0	80754
19490	241	515	80836	819	0	82411
19491	296	144	659	78992	0	80091
19492	79397	75	403	999	0	80874
19493	750	233	80448	485	0	81916
19494	73295	92	674	384	0	74445
19495	745	79557	421	305	0	81028
19496	80275	667	131	303	0	81376
19497	784	430	93	80721	0	82028
19498	435	80300	203	816	0	81754
19499	83029	717	115	640	0	84501
19500	923	428	109	83647	0	85107
19501	547	235	84318	1006	0	86106
19502	167	85366	963	618	0	87114
19503	290	887	547	85608	0	87332
19504	84140	460	131	1083	0	85814
19505	81861	97	125	679	0	82762
19506	1326	99	120	81787	0	83332
19507	586	194	81054	962	0	82796
19508	74567	83	917	787	0	76354
19509	951	201	81191	252	0	82595
19510	614	115	941	80350	0	82020
19511	81740	97	534	1195	0	83566
19512	898	81847	258	670	0	83673
19513	82705	851	186	435	0	84177
19514	1041	614	81154	246	0	83055
19515	81131	133	965	367	0	82596
19516	1092	107	572	83057	0	84828
19517	689	143	207	84494	0	85533
19518	294	253	83831	1416	0	85794
19519	301	143	934	80625	0	82003
19520	81832	131	575	1253	0	83791
19521	1086	137	208	81998	0	83429
19522	632	84203	280	1130	0	86245
19523	375	944	224	83300	0	84843
19524	239	84853	299	1184	0	86575
19525	330	1105	82669	665	0	84769
19526	77469	525	1005	490	0	79489
19527	1153	165	575	85046	0	86939
19528	704	300	81485	1194	0	83683
19529	307	81499	1112	734	0	83652
19530	348	1020	607	80058	0	82033
19531	364	612	264	81226	0	82466
19532	80339	211	237	1766	0	82553
19533	1230	206	213	82370	0	84019
19534	83061	164	238	1412	0	84875
19535	82132	197	234	926	0	83489
19536	1700	82060	325	449	0	84534
19537	84209	1181	211	512	0	86113
19538	1561	625	206	90447	0	92839
19539	908	337	90882	1648	0	93775
19540	89366	194	1552	1091	0	92203
19541	1761	161	794	88661	0	91377
19542	1039	342	88460	1662	0	91503
19543	83664	192	1698	1187	0	86741
19544	1749	210	863	88245	0	91067
19545	990	91395	447	1693	0	94525
19546	612	1517	270	87866	0	90265
19547	324	91159	417	1716	0	93616
19548	89964	1565	309	1156	0	92994
19549	1745	954	92485	600	0	95784
19550	986	91885	1651	599	0	95121
19551	586	1532	828	92776	0	95722
19552	487	960	93784	1720	0	96951
19553	483	454	91616	1086	0	93639
19554	396	94823	2205	629	0	98053
19555	785	1686	965	93635	0	97071
19556	495	831	384	97003	0	98713
19557	545	347	297	119229	0	120418
19558	120588	271	323	3908	0	125090
19559	3258	409	125895	1616	0	131178
19560	1461	126428	3425	877	0	132191
19561	782	3279	1455	124246	0	129762
19562	677	1466	559	130429	0	133131
19563	597	641	127228	4776	0	133242
19564	701	484	3411	127661	0	132257
19565	591	461	127659	3924	0	132635
19566	572	404	124072	1889	0	126937
19567	579	444	126262	915	0	128200
19568	628	304	4648	119053	0	124633
19569	599	372	1766	124609	0	127346
19570	616	347	704	128445	0	130112
19571	124754	302	510	5056	0	130622
19572	3433	123830	731	2143	0	130137
19573	126875	3340	440	1138	0	131793
19574	126118	1450	452	1016	0	129036
19575	129748	541	448	885	0	131622
19576	4871	129710	592	767	0	135940
19577	131903	3451	502	845	0	136701
19578	134861	1616	404	946	0	137827
19579	5163	653	491	131439	0	137746
19580	2303	528	475	134568	0	137874
19581	1173	425	578	137664	0	139840
19582	771	652	131977	5515	0	138915
19583	126025	450	3749	2618	0	132842
19584	4002	403	1852	131605	0	137862
19585	129959	374	1002	4414	0	135749
19586	3851	129195	1012	2461	0	136519
19587	1985	3469	857	130887	0	137198
19588	1040	1552	794	134886	0	138272
19589	131558	623	819	5535	0	138535
19590	4085	580	649	133197	0	138511
19591	128648	490	606	4790	0	134534
19592	131437	574	472	2614	0	135097
19593	5170	126685	652	1428	0	133935
19594	2159	131464	633	1106	0	135362
19595	1489	5213	542	125039	0	132283
19596	976	130811	669	3813	0	136269
19597	1277	3981	524	130916	0	136698
19598	916	1820	128794	4318	0	135848
19599	922	890	124942	2245	0	128999
19600	119233	649	4613	1446	0	125941
19601	125528	485	1936	1440	0	129389
19602	4781	122999	1008	1301	0	130089
19603	123250	3383	778	1474	0	128885
19604	3899	128266	847	1371	0	134383
19605	2168	3680	772	129622	0	136242
19606	1186	1646	798	132489	0	136119
19607	1209	759	806	132968	0	135742
19608	985	587	875	134594	0	137041
19609	129510	459	870	5913	0	136752
19610	3717	129846	987	3038	0	137588
19611	131184	3391	843	1948	0	137366
19612	132882	1649	723	1741	0	136995
19613	5473	996	128510	1423	0	136402
19614	126437	783	3418	1481	0	132119
19615	4500	127835	1742	1360	0	135437
19616	2744	3795	733	128467	0	135739
19617	1808	1942	652	125387	0	129789
19618	1306	127324	850	5022	0	134502
19619	129477	3750	772	2731	0	136730
19620	4444	1940	126379	1686	0	134449
19621	124498	873	3752	2008	0	131131
19622	4829	841	126105	1959	0	133734
19623	3041	733	4194	125279	0	133247
19624	2084	930	2293	129255	0	134562
19625	1847	928	1382	131575	0	135732
19626	129138	1078	1096	6806	0	138118
19627	4382	1073	131403	3916	0	140774
19628	130895	943	4050	3054	0	138942
19629	135411	763	2349	2816	0	141339
19630	135499	719	1612	2549	0	140379
19631	135372	648	1662	2178	0	139860
19632	6228	697	1524	131526	0	139975
19633	3152	831	129519	4866	0	138368
19634	2415	868	3603	129254	0	136140
19635	2113	899	129498	5117	0	137627
19636	2139	1124	127109	2932	0	133304
19637	2098	127253	4208	1995	0	135554
19638	2444	3710	1557	116824	0	124535
19639	2387	1885	618	122817	0	127707
19640	2315	1249	626	110168	0	114358
19641	2428	964	611	122985	0	126988
19642	121247	916	627	4812	0	127602
19643	122823	663	526	2667	0	126679
19644	5518	646	508	119841	0	126513
19645	2760	796	116062	4906	0	124524
19646	1824	628	3033	118768	0	124253
19647	1684	588	1550	121669	0	125491
19648	1701	687	117614	5494	0	125496
19649	1920	536	3047	116274	0	121777
19650	116511	703	1322	4616	0	123152
19651	117607	805	619	2885	0	121916
19652	117894	886	415	2115	0	121310
19653	5318	758	379	113890	0	120345
19654	112722	543	458	4172	0	117895
19655	111596	488	646	2490	0	115220
19656	4865	608	107616	1698	0	114787
19657	1321	316	81646	681	0	83964
19658	832	303	82532	560	0	84227
19659	74305	156	988	415	0	75864
19660	807	77440	566	370	0	79183
19661	77890	572	370	374	0	79206
19662	788	84149	216	266	0	85419
19663	605	658	145	83791	0	85199
19664	380	346	132	84625	0	85483
19665	337	136	162	85130	0	85765
19666	289	225	83768	1125	0	85407
19667	75876	104	734	726	0	77440
19668	986	100	401	83153	0	84640
19669	477	204	82259	769	0	83709
19670	326	196	77902	442	0	78866
19671	76478	92	879	393	0	77842
19672	690	82302	471	329	0	83792
19673	81431	533	167	414	0	82545
19674	80148	271	163	340	0	80922
19675	855	79908	219	222	0	81204
19676	77464	529	193	343	0	78529
19677	762	389	79723	216	0	81090
19678	458	211	76444	151	0	77264
19679	305	173	80531	199	0	81208
19680	293	308	789	79194	0	80584
19681	209	196	81360	563	0	82328
19682	76342	56	576	431	0	77405
19683	79818	52	289	341	0	80500
19684	790	191	80920	144	0	82045
19685	432	71	458	79571	0	80532
19686	80222	40	297	658	0	81217
19687	542	83795	231	333	0	84901
19688	294	85215	172	190	0	85871
19689	85260	557	120	365	0	86302
19690	497	373	85599	107	0	86576
19691	310	416	369	82187	0	83282
19692	207	64	261	83932	0	84464
19693	123	49	112	84978	0	85262
19694	100	85588	159	542	0	86389
19695	189	441	71	83192	0	83893
19696	89438	188	65	753	0	90444
19697	596	83	77	91008	0	91764
19698	293	91498	164	675	0	92630
19699	93133	576	70	556	0	94335
19700	684	288	64	93721	0	94757
19701	392	127	81	97912	0	98512
19702	100338	68	45	1144	0	101595
19703	100673	61	56	573	0	101363
19704	1163	67	58	98814	0	100102
19705	100722	68	72	1081	0	101943
19706	100812	64	59	661	0	101596
19707	1314	102036	176	237	0	103763
19708	102568	932	61	361	0	103922
19709	1035	101739	161	172	0	103107
19710	618	981	56	101986	0	103641
19711	284	678	104108	1034	0	106104
19712	284	158	937	103442	0	104821
19713	267	84	440	105420	0	106211
19714	214	95	112	109311	0	109732
19715	107825	84	61	1739	0	109709
19716	1110	107753	168	801	0	109832
19717	110954	1050	65	481	0	112550
19718	1289	115212	186	338	0	117025
19719	118185	1229	85	487	0	119986
19720	118901	577	123	436	0	120037
19721	119550	220	88	405	0	120263
19722	119388	115	90	409	0	120002
19723	2009	337	118425	203	0	120974
19724	983	145	1278	117472	0	119878
19725	463	140	634	122948	0	124185
19726	303	330	119773	2090	0	122496
19727	113098	137	1475	1066	0	115776
19728	1719	106	695	117555	0	120075
19729	944	276	116123	1646	0	118989
19730	507	285	114743	852	0	116387
19731	467	137	2167	117770	0	120541
19732	466	336	121793	1746	0	124341
19733	472	146	1655	119272	0	121545
19734	499	132	795	120954	0	122380
19735	428	331	117914	2337	0	121010
19736	109484	172	1612	1210	0	112478
19737	1837	171	801	118300	0	121109
19738	1086	333	119271	1869	0	122559
19739	603	164	1591	119682	0	122040
19740	119854	125	893	2063	0	122935
19741	1860	292	119623	1093	0	122868
19742	115225	152	1627	755	0	117759
19743	123219	164	867	555	0	124805
19744	2554	170	354	122401	0	125479
19745	1288	168	284	122329	0	124069
19746	669	391	121907	2428	0	125395
19747	625	179	1637	122196	0	124637
19748	692	183	962	115663	0	117500
19749	601	147	423	124259	0	125430
19750	591	305	120375	2645	0	123916
19751	115208	140	1743	1550	0	118641
19752	121361	128	945	956	0	123390
19753	124039	154	440	829	0	125462
19754	127233	181	394	815	0	128623
19755	2851	210	355	126654	0	130070
19756	126383	200	332	2248	0	129163
19757	126764	174	400	1482	0	128820
19758	110058	354	610	1133	0	112155
19759	127695	129	385	858	0	129067
19760	2668	127243	590	661	0	131162
19761	128931	1523	360	850	0	131664
19762	126014	751	370	885	0	128020
19763	2787	125330	577	742	0	129436
19764	126823	1775	383	733	0	129714
19765	2555	869	403	126789	0	130616
19766	1535	276	397	127835	0	130043
19767	125607	155	376	3122	0	129260
19768	2205	123496	531	1593	0	127825
19769	1346	124761	582	784	0	127473
19770	959	2522	392	126992	0	130865
19771	740	1120	128378	2293	0	132531
19772	824	253	2026	125533	0	128636
19773	832	163	1069	130537	0	132601
19774	128509	167	494	3129	0	132299
19775	129529	155	427	1525	0	131636
19776	3222	173	335	129379	0	133109
19777	1573	362	128095	2361	0	132391
19778	961	192	2086	130237	0	133476
19779	132509	126	1197	2742	0	136574
19780	2774	276	138111	1424	0	142585
19781	1574	139071	2649	843	0	144137
19782	143100	2315	1244	913	0	147572
19783	3052	1111	502	143338	0	148003
19784	1921	277	390	144678	0	147266
19785	1038	246	379	149062	0	150725
19786	824	336	144293	4045	0	149498
19787	125117	219	2617	2185	0	130138
19788	3105	378	139251	893	0	143627
19789	1780	137289	2831	748	0	142648
19790	1068	2246	1360	141061	0	145735
19791	1069	1159	489	143439	0	146156
19792	1002	351	396	152368	0	154117
19793	819	376	148791	4699	0	154685
19794	791	363	144679	2057	0	147890
19795	773	390	149109	1049	0	151321
19796	709	148563	4406	860	0	154538
19797	952	3125	1841	146886	0	152804
19798	151744	1288	652	3381	0	157065
19799	158120	379	510	1855	0	160864
19800	5043	426	166525	939	0	172933
19801	2315	168164	3747	1083	0	175309
19802	1251	3559	168368	721	0	173899
19803	736	174373	4096	816	0	180021
19804	169402	4211	2592	1080	0	177285
19805	168994	1893	875	1051	0	172813
19806	5216	168178	797	823	0	175014
19807	171113	3665	580	880	0	176238
19808	4537	1862	567	169105	0	176071
19809	2508	746	508	172632	0	176394
19810	171360	500	449	5368	0	177677
19811	167444	502	444	2590	0	170980
19812	167567	423	411	1401	0	169802
19813	5621	164003	698	1086	0	171408
19814	2483	170104	677	984	0	174248
19815	168958	4841	513	1003	0	175315
19816	4306	2229	167985	719	0	175239
19817	2520	1507	3550	163796	0	171373
19818	160244	695	1895	3759	0	166593
19819	4027	156724	977	1995	0	163723
19820	2214	163976	720	989	0	167899
19821	163591	4763	604	896	0	169854
19822	4154	2256	159999	662	0	167071
19823	155560	1045	3630	787	0	161022
19824	4321	862	157213	596	0	162992
19825	2361	905	158045	467	0	161778
19826	1658	768	4685	155445	0	162556
19827	1170	827	164099	3321	0	169417
19828	160464	708	3883	2008	0	167063
19829	167952	560	1971	1235	0	171718
19830	169564	496	1069	1005	0	172134
19831	169080	514	759	946	0	171299
19832	5831	551	739	162433	0	169554
19833	163469	639	709	3589	0	168406
19834	4520	161852	842	1952	0	169166
19835	2932	3457	650	152744	0	159783
19836	1678	164803	800	3111	0	170392
19837	170117	3664	634	2101	0	176516
19838	170998	1890	676	1329	0	174893
19839	5513	1143	651	168746	0	176053
19840	171929	835	701	3837	0	177302
19841	173618	862	768	2211	0	177459
19842	5779	809	724	171098	0	178410
19843	3323	809	725	172502	0	177359
19844	2256	693	778	175416	0	179143
19845	1885	824	169238	5242	0	177189
19846	1723	833	162089	2597	0	167242
19847	1692	905	169272	1362	0	173231
19848	1742	807	5202	166633	0	174384
19849	1701	929	172115	3909	0	178654
19850	1816	754	4197	169254	0	176021
19851	1848	782	181317	4358	0	188305
19852	1793	844	175498	2401	0	180536
19853	166035	750	5247	1748	0	173780
19854	4297	175005	2766	1276	0	183344
19855	177880	3525	1441	1372	0	184218
19856	4877	1998	1175	175535	0	183585
19857	3185	1102	1074	177889	0	183250
19858	2197	1064	176820	5063	0	185144
19859	1744	176662	3953	2930	0	185289
19860	2019	3722	2101	178178	0	186020
19861	1818	2133	181379	3905	0	189235
19862	1660	179488	3706	2283	0	187137
19863	1912	3319	2161	179771	0	187163
19864	179607	1823	1406	3953	0	186789
19865	180156	1089	1100	2407	0	184752
19866	5291	867	1115	180044	0	187317
19867	180759	899	1055	3962	0	186675
19868	4395	180404	1426	2396	0	188621
19869	3028	3434	1111	182903	0	190476
19870	2203	2128	186707	3774	0	194812
19871	2222	1096	3814	185878	0	193010
19872	1874	1126	187490	4404	0	194894
19873	180106	818	4083	2724	0	187731
19874	4851	837	2171	184866	0	192725
19875	2885	188363	1470	4076	0	196794
19876	2395	4148	928	193649	0	201120
19877	1936	2084	190746	4471	0	199237
19878	1880	1228	186442	2705	0	192255
19879	1719	1043	183287	1582	0	187631
19880	169922	1110	5162	1375	0	177569
19881	3473	178689	2534	1226	0	185922
19882	2104	3036	1384	175924	0	182448
19883	177568	1505	1232	3557	0	183862
19884	3343	176887	1441	2158	0	183829
19885	182703	2921	1063	1863	0	188550
19886	184118	1660	1005	1364	0	188147
19887	187694	1001	866	1386	0	190947
19888	190173	731	993	1234	0	193131
19889	4990	799	184883	1006	0	191678
19890	177107	464	3217	1302	0	182090
19891	3800	693	182176	1020	0	187689
19892	168289	362	2862	1012	0	172525
19893	3343	537	1778	176358	0	182016
19894	2141	601	174808	2382	0	179932
19895	1407	172210	2550	1657	0	177824
19896	1789	6016	1621	161720	0	171146
19897	1131	168303	977	2002	0	172413
19898	956	170056	801	1520	0	173333
19899	153562	1948	795	1034	0	157339
19900	1647	833	152330	549	0	155359
19901	669	146525	1117	343	0	148654
19902	143409	817	908	500	0	145634
19903	946	145866	397	231	0	147440
19904	146583	774	276	437	0	148070
19905	1043	588	176	145754	0	147561
19906	146559	167	191	1019	0	147936
19907	1008	200	228	144261	0	145697
19908	145065	169	187	1159	0	146580
19909	998	171	194	144359	0	145722
19910	612	147637	313	890	0	149452
19911	436	797	188	150013	0	151434
19912	149051	447	232	1150	0	150880
19913	894	148468	315	568	0	150245
19914	638	829	185	147863	0	149515
19915	148918	463	216	1168	0	150765
19916	1004	243	211	149726	0	151184
19917	661	228	172	150031	0	151092
19918	435	417	151216	1273	0	153341
19919	412	407	147562	653	0	149034
19920	473	240	1126	146779	0	148618
19921	382	513	154636	1057	0	156588
19922	469	208	877	153634	0	155188
19923	518	298	507	144761	0	146084
19924	445	246	208	156651	0	157550
19925	386	451	154899	1316	0	157052
19926	484	231	826	147984	0	149525
19927	380	188	440	150017	0	151025
19928	339	150740	367	1297	0	152743
19929	419	901	183	152663	0	154166
19930	152209	489	228	1330	0	154256
19931	1073	229	250	154974	0	156526
19932	715	420	172731	1287	0	175153
19933	157906	215	1849	1165	0	161135
19934	1940	180158	1360	764	0	184222
19935	1493	1934	629	182020	0	186076
19936	858	1500	179185	2237	0	183780
19937	163175	637	2142	1923	0	167877
19938	2086	176724	1553	977	0	181340
19939	177835	2059	760	776	0	181430
19940	2640	1379	402	175935	0	180356
19941	173539	705	375	2456	0	177075
19942	2890	568	172985	1600	0	178043
19943	1663	170538	2117	1009	0	175327
19944	957	184454	1433	671	0	187515
19945	186189	2997	797	910	0	190893
19946	186106	1727	378	792	0	189003
19947	3417	1052	185043	403	0	189915
19948	178758	405	2060	660	0	181883
19949	184543	325	1353	712	0	186933
19950	183923	277	725	721	0	185646
19951	3787	174539	539	458	0	179323
19952	2093	177620	454	525	0	180692
19953	177642	2931	283	650	0	181506
19954	177271	1737	301	715	0	180024
19955	3325	179177	435	472	0	183409
19956	2095	2236	219	179964	0	184514
19957	1122	1703	179909	2204	0	184938
19958	174922	776	2164	1912	0	179774
19959	168624	598	1715	1584	0	172521
19960	185630	399	835	966	0	187830
19961	3568	181238	634	669	0	186109
19962	2128	2417	181392	503	0	186440
19963	183525	1386	2232	693	0	187836
19964	2747	862	1462	186732	0	191803
19965	2007	542	782	188620	0	191951
19966	1413	416	384	192258	0	194471
19967	958	667	189100	3914	0	194639
19968	968	333	2134	185553	0	188988
19969	792	619	188599	3041	0	193051
19970	471	180655	2475	2120	0	185721
19971	176654	1902	1390	1202	0	181148
19972	1992	179371	911	559	0	182833
19973	1468	180579	591	494	0	183132
19974	178547	2827	687	690	0	182751
19975	2070	185036	470	451	0	188027
19976	1817	2543	234	179744	0	184338
19977	1015	182314	380	1814	0	185523
19978	180461	2507	190	1497	0	184655
19979	2249	183234	400	833	0	186716
19980	1907	2649	254	185168	0	189978
19981	1209	1886	183349	2319	0	188763
19982	854	1021	2080	185039	0	188994
19983	623	186177	1610	3202	0	191612
19984	784	2411	868	190568	0	194631
19985	754	1708	469	189445	0	192376
19986	846	878	414	188623	0	190761
19987	821	452	389	192851	0	194513
19988	810	537	372	194333	0	196052
19989	798	469	538	195714	0	197519
19990	801	676	191227	4984	0	197688
19991	180970	477	3008	3193	0	187648
19992	3320	456	1913	203968	0	209657
19993	2287	821	204118	3906	0	211132
19994	1443	778	204367	2684	0	209272
19995	1033	659	5193	205546	0	212431
19996	208699	571	2981	4164	0	216415
19997	3880	982	205749	2639	0	213250
19998	202075	670	3864	1979	0	208588
19999	4791	1042	211615	1011	0	218459
20000	3356	815	4389	208704	0	217264
20001	2218	855	2593	216855	0	222521
20002	1518	1173	214500	5549	0	222740
20003	200024	781	4026	3587	0	208418
20004	4532	829	2621	211259	0	219241
20005	3109	962	211610	4305	0	219986
20006	2117	1007	213020	3032	0	219176
20007	1935	768	5699	193773	0	202175
20008	1375	212420	3659	3510	0	220964
20009	215478	3670	1716	2984	0	223848
20010	216105	2534	1207	2019	0	221865
20011	6263	1689	215037	1218	0	224207
20012	4022	1035	4084	210156	0	219297
20013	215209	851	2640	4774	0	223474
20014	4825	998	214705	3330	0	223858
20015	206570	507	4369	2395	0	213841
20016	5250	209730	3293	1653	0	219926
20017	3479	3596	1876	215361	0	224312
20018	2464	2363	1298	217556	0	223681
20019	220112	1211	1354	6763	0	229440
20020	4902	839	1283	222352	0	229376
20021	3426	807	1164	219424	0	224821
20022	2232	721	1053	222667	0	226673
20023	214610	605	1111	8358	0	224684
20024	4871	960	214410	4676	0	224917
20025	213018	654	4553	3160	0	221385
20026	216355	602	3117	2616	0	222690
20027	220852	653	2075	2260	0	225840
20028	7900	892	1391	215178	0	225361
20029	4507	1095	219880	5328	0	230810
20030	2470	212750	5243	3798	0	224261
20031	1896	216612	3317	2778	0	224603
20032	1330	208460	1403	1763	0	212956
20033	1781	5383	210078	1698	0	218940
20034	1587	2946	4570	233384	0	242487
20035	240478	953	2595	6657	0	250683
20036	255965	718	1247	4245	0	262175
20037	8938	595	935	264242	0	274710
20038	4586	796	263491	7303	0	276176
20039	2254	778	265006	4616	0	272654
20040	1789	416	8973	265959	0	277137
20041	1668	642	270158	7676	0	280144
20042	1750	388	7448	273079	0	282665
20043	1688	442	4310	263064	0	269504
20044	1255	267185	2647	9974	0	281061
20045	1824	6147	1657	270368	0	279996
20046	1861	3197	1536	280186	0	286780
20047	272852	1338	1610	11409	0	287209
20048	7804	767	1604	276379	0	286554
20049	5028	668	1455	278740	0	285891
20050	269778	612	1557	11741	0	283688
20051	7555	268473	2295	6473	0	284796
20052	274760	6403	1883	3820	0	286866
20053	8815	3853	269706	2806	0	285180
20054	269226	1701	7450	3039	0	281416
20055	271028	1036	4842	3014	0	279920
20056	12633	1190	263621	2573	0	280017
20057	6288	1251	264661	2532	0	274732
20058	4041	1104	10773	253370	0	269288
20059	253796	763	5982	8686	0	269227
20060	8450	1027	251260	5655	0	266392
20061	5770	711	8819	250680	0	265980
20062	3318	1079	250518	9118	0	264033
20063	3242	907	9256	245432	0	258837
20064	3002	844	5590	249498	0	258934
20065	246650	870	3405	12607	0	263532
20066	248678	1075	2514	7833	0	260100
20067	253956	1122	2286	5455	0	262819
20068	12519	1255	246970	4705	0	265449
20069	6989	1283	249716	4432	0	262420
20070	4675	1184	11159	244850	0	261868
20071	3943	1351	6487	247982	0	259763
20072	4148	1356	4021	254167	0	263692
20073	243207	1381	3221	13353	0	261162
20074	9186	243248	3312	8302	0	264048
20075	240177	6986	3056	5488	0	255707
20076	233969	4026	2769	5080	0	245844
20077	12040	230789	3129	4630	0	250588
20078	7520	236781	3427	4373	0	252101
20079	230883	9142	3312	5097	0	248434
20080	9652	4520	3021	222824	0	240017
20081	7601	225398	3034	10865	0	246898
20082	6971	6896	2633	229707	0	246207
20083	5827	4502	223358	11317	0	245004
20084	5323	2224	9162	226200	0	242909
20085	221796	1480	7371	12353	0	243000
20086	9689	1719	219220	8736	0	239364
20087	6795	1515	218705	7273	0	234288
20088	5524	5120	12605	189384	0	212633
20089	4562	197922	8015	10790	0	221289
20090	4315	203530	4739	9115	0	221699
20091	4065	211673	4258	7780	0	227776
20092	200870	8930	3680	7609	0	221089
20093	202001	4391	3024	7376	0	216792
20094	195129	2329	2899	7198	0	207555
20095	11601	191846	3360	7370	0	214177
20096	197533	5902	3132	6805	0	213372
20097	197329	4192	2835	5949	0	210305
20098	12748	3421	190441	5173	0	211783
20099	9072	184013	8525	4519	0	206129
20100	7585	6589	6657	184600	0	205431
20101	186208	4338	4804	9031	0	204381
20102	10668	2591	183220	7251	0	203730
20103	7686	1693	9194	175923	0	194496
20104	5761	179421	7310	10485	0	202977
20105	5896	5983	5173	181618	0	198670
20106	6074	3810	4617	184892	0	199393
20107	185286	2375	4882	12392	0	204935
20108	186328	2456	4612	9054	0	202450
20109	12049	2501	4513	183776	0	202839
20110	7947	2695	179112	10607	0	200361
20111	6691	2598	179861	8373	0	197523
20112	181058	2495	9655	6411	0	199619
20113	12311	2475	182253	5231	0	202270
20114	9920	2273	8851	156464	0	177508
20115	7160	172465	7442	7913	0	194980
20116	174070	6066	5683	6786	0	192605
20117	9483	172893	5299	6124	0	193799
20118	177277	6672	4342	6771	0	195062
20119	10148	4406	3734	174650	0	192938
20120	8221	3591	3335	176081	0	191228
20121	175395	3684	3088	10866	0	193033
20122	179149	3652	2835	6898	0	192534
20123	13820	3794	2945	173206	0	193765
20124	9629	4179	2923	175480	0	192211
20125	6861	4157	169565	10116	0	190699
20126	5799	3854	168496	7240	0	185389
20127	166585	3388	8909	6313	0	185195
20128	9012	3654	159341	5819	0	177826
20129	161539	2728	7002	5925	0	177194
20130	165252	2183	5706	5655	0	178796
20131	11153	2427	156628	5033	0	175241
20132	7589	146845	7014	4063	0	165511
20133	5605	149758	6082	2846	0	164291
20134	3479	4142	120716	1768	0	130105
20135	5519	8676	6216	103023	0	123434
20136	98699	2019	4554	4169	0	109441
20137	96269	814	754	1889	0	99726
20138	108265	679	707	1361	0	111012
20139	125414	557	615	1372	0	127958
20140	125717	577	656	1213	0	128163
20141	5202	124651	1102	970	0	131925
20142	120126	3014	509	763	0	124412
20143	3712	119191	735	532	0	124170
20144	116239	3019	401	471	0	120130
20145	3534	1442	112154	260	0	117390
20146	1848	419	2587	108117	0	112971
20147	1012	277	1239	103087	0	105615
20148	463	108341	528	3378	0	112710
20149	109270	2615	212	1506	0	113603
20150	111257	1363	170	576	0	113366
20151	4137	515	199	107658	0	112509
20152	1931	255	227	110373	0	112786
20153	108726	174	209	3958	0	113067
20154	3054	215	184	109464	0	112917
20155	1698	243	174	111019	0	113134
20156	108934	226	169	4008	0	113337
20157	3253	185	152	109271	0	112861
20158	109732	190	195	3311	0	113428
20159	110831	154	166	1810	0	112961
20160	4247	240	107889	738	0	113114
20161	109908	206	2563	711	0	113388
20162	110183	189	1282	607	0	112261
20163	111066	231	461	507	0	112265
20164	4585	295	104862	494	0	110236
20165	2386	267	2655	102577	0	107885
20166	1430	199	1323	106784	0	109736
20167	871	329	104443	3879	0	109522
20168	101768	209	2775	1789	0	106541
20169	3443	204	1349	101871	0	106867
20170	1978	327	100529	2933	0	105767
20171	1137	325	103390	1521	0	106373
20172	1008	184	3862	102429	0	107483
20173	855	333	104066	3175	0	108429
20174	994	219	3130	103336	0	107679
20175	1081	173	1577	105447	0	108278
20176	900	337	103371	4346	0	108954
20177	980	271	3027	96631	0	100909
20178	829	99130	1739	3127	0	104825
20179	774	106208	887	1808	0	109677
20180	104553	3785	630	932	0	109900
20181	104877	1617	490	937	0	107921
20182	4358	103472	587	1013	0	109430
20183	104704	2868	496	885	0	108953
20184	105960	1489	416	837	0	108702
20185	4937	712	347	102718	0	108714
20186	2653	591	412	105669	0	109325
20187	102132	489	342	4513	0	107476
20188	3715	99801	544	2244	0	106304
20189	2293	103193	612	1204	0	107302
20190	1772	4227	495	101035	0	107529
20191	1461	1882	102159	3396	0	108898
20192	99446	726	3027	2269	0	105468
20193	103543	451	1632	1436	0	107062
20194	100961	476	712	1177	0	103326
20195	5194	100623	727	953	0	107497
20196	3094	3085	532	98098	0	104809
20197	2052	1654	514	103230	0	107450
20198	100428	761	610	4724	0	106523
20199	4075	99540	781	2634	0	107030
20200	3026	3066	524	99052	0	105668
20201	2216	1674	553	101787	0	106230
20202	2058	913	519	102664	0	106154
20203	98796	642	546	5234	0	105218
20204	4234	97846	787	2887	0	105754
20205	3074	3611	615	90952	0	98252
20206	2065	97412	815	3545	0	103837
20207	96062	3359	679	2474	0	102574
20208	4130	1791	94879	1797	0	102597
20209	93255	812	3224	1878	0	99169
20210	4114	748	92114	1896	0	98872
20211	2934	1245	3290	87087	0	94556
20212	87884	609	1638	3704	0	93835
20213	3921	657	86924	2383	0	93885
20214	87920	482	2889	1767	0	93058
20215	90592	363	1706	1684	0	94345
20216	91867	333	927	1602	0	94729
20217	5220	409	846	86915	0	93390
20218	2958	371	775	88331	0	92435
20219	2106	338	687	90090	0	93221
20220	85855	295	718	4958	0	91826
20221	3768	86065	948	2711	0	93492
20222	87267	2317	735	1618	0	91937
20223	88636	1259	826	1369	0	92090
20224	4587	765	85082	1282	0	91716
20225	85869	478	2688	1294	0	90329
20226	89094	428	1725	1331	0	92578
20227	4678	418	1060	86623	0	92779
20228	2748	513	879	87906	0	92046
20229	1845	474	814	88357	0	91490
20230	84126	441	931	4324	0	89822
20231	84165	389	829	2577	0	87960
20232	80302	403	792	1573	0	83070
20233	3669	75260	979	1241	0	81149
20234	1628	69763	828	952	0	73171
20235	844	71238	814	1147	0	74043
20236	69153	2602	1134	1267	0	74156
20237	2407	1142	67456	1198	0	72203
20238	1291	680	54464	882	0	57317
20239	35851	134	969	339	0	37293
20240	603	115	38496	234	0	39448
20241	211	67	261	32149	0	32688
20242	131	32854	158	269	0	33412
20243	34369	261	105	241	0	34976
20244	34424	125	75	156	0	34780
20245	34539	53	35	154	0	34781
20246	458	70	39	37070	0	37637
20247	214	125	38122	295	0	38756
20248	168	126	36442	145	0	36881
20249	37361	84	316	161	0	37922
20250	38818	43	126	155	0	39142
20251	38653	41	68	140	0	38902
20252	420	34	55	38826	0	39335
20253	258	43	51	39264	0	39616
20254	148	121	38695	341	0	39305
20255	37782	65	247	258	0	38352
20256	343	47	115	40167	0	40672
20257	222	52	53	40017	0	40344
20258	168	44	55	39670	0	39937
20259	129	39721	92	378	0	40320
20260	144	231	58	39526	0	39959
20261	143	118	55	39592	0	39908
20262	38896	58	62	473	0	39489
20263	342	121	38387	166	0	39016
20264	37179	43	246	196	0	37664
20265	39298	46	123	153	0	39620
20266	433	39	53	38853	0	39378
20267	228	58	59	38972	0	39317
20268	38424	47	66	464	0	39001
20269	331	106	38213	215	0	38865
20270	204	37755	281	132	0	38372
20271	161	169	125	37078	0	37533
20272	36918	84	53	281	0	37336
20273	292	39	47	36237	0	36615
20274	171	86	35775	290	0	36322
20275	146	81	34842	176	0	35245
20276	34702	36	262	162	0	35162
20277	305	59	104	36853	0	37321
20278	210	88	36249	227	0	36774
20279	34771	22	187	263	0	35243
20280	37655	29	91	245	0	38020
20281	271	29	51	37790	0	38141
20282	179	27	54	37797	0	38057
20283	78	37830	98	250	0	38256
20284	39326	136	36	286	0	39784
20285	232	75	35	39558	0	39900
20286	193	25	32	39815	0	40065
20287	93	102	40897	238	0	41330
20288	37324	22	143	246	0	37735
20289	39737	28	80	166	0	40011
20290	210	39603	77	145	0	40035
20291	118	184	38539	76	0	38917
20292	114	118	38511	63	0	38806
20293	111	143	138	37881	0	38273
20294	39606	55	183	255	0	40099
20295	121	32	43	39407	0	39603
20296	41080	22	25	284	0	41411
20297	41336	18	23	197	0	41574
20298	41823	20	47	175	0	42065
20299	150	16	33	42358	0	42557
20300	111	35	33	42961	0	43140
20301	43190	12	25	248	0	43475
20302	120	98	44484	51	0	44753
20303	40724	30	49	153	0	40956
20304	42317	16	47	142	0	42522
20305	94	94	43607	27	0	43822
20306	78	100	42818	54	0	43050
20307	43	43444	97	51	0	43635
20308	92	73	98	44258	0	44521
20309	40709	67	71	223	0	41070
20310	52	19	13	44495	0	44579
20311	70	108	44718	80	0	44976
20312	33	44024	54	88	0	44199
20313	18	44072	54	60	0	44204
20314	57	67	21	45236	0	45381
20315	41	38	5	44454	0	44538
20316	18	44452	45	126	0	44641
20317	51	144	43964	70	0	44229
20318	40501	46	81	172	0	40800
20319	45601	19	42	138	0	45800
20320	105	46255	59	52	0	46471
20321	44695	113	10	136	0	44954
20322	135	104	13	43929	0	44181
20323	43921	27	22	216	0	44186
20324	154	15	21	44367	0	44557
20325	65	47575	53	193	0	47886
20326	61	267	48235	103	0	48666
20327	67	115	232	53093	0	53507
20328	95	37	121	52971	0	53224
20329	69	23	22	56775	0	56889
20330	58361	14	28	709	0	59112
20331	554	20	27	59183	0	59784
20332	331	112	62561	577	0	63581
20333	118	116	64634	318	0	65186
20334	65347	19	1032	256	0	66654
20335	837	84	67913	98	0	68932
20336	67701	29	843	161	0	68734
20337	904	26	399	72470	0	73799
20338	487	35	116	74462	0	75100
20339	175	35	61	77696	0	77967
20340	176	37	60	77399	0	77672
20341	75792	29	67	1719	0	77607
20342	1103	121	76475	697	0	78396
20343	704	43	1067	73549	0	75363
20344	135	77837	631	1102	0	79705
20345	77862	1091	150	659	0	79762
20346	1188	533	85	75176	0	76982
20347	74605	113	77	1343	0	76138
20348	1327	145	73984	656	0	76112
20349	746	83	1191	69834	0	71854
20350	184	73680	704	1204	0	75772
20351	74281	1111	170	817	0	76379
20352	1282	648	73778	391	0	76099
20353	790	133	1185	72540	0	74648
20354	373	66	620	74875	0	75934
20355	73640	64	276	2030	0	76010
20356	1384	124	73331	942	0	75781
20357	840	166	74015	400	0	75421
20358	444	65	1921	73756	0	76186
20359	363	127	74367	1384	0	76241
20360	350	140	75279	873	0	76642
20361	438	101	1978	73666	0	76183
20362	404	93	862	75426	0	76785
20363	383	94	365	78985	0	79827
20364	77663	61	343	2296	0	80363
20365	1497	78487	395	1213	0	81592
20366	78919	1315	348	708	0	81290
20367	1768	736	353	77735	0	80592
20368	947	79558	413	1833	0	82751
20369	550	1423	243	81775	0	83991
20370	82735	754	287	2098	0	85874
20371	1715	86467	408	1345	0	89935
20372	1214	1616	333	88761	0	91924
20373	624	956	89462	2079	0	93121
20374	88537	321	1959	1426	0	92243
20375	2061	329	1068	90062	0	93520
20376	1419	256	510	91254	0	93439
20377	757	245	89355	2997	0	93354
20378	569	294	88878	1848	0	91589
20379	86384	217	2741	1047	0	90389
20380	2099	87119	1497	835	0	91550
20381	1445	1763	697	87302	0	91207
20382	88115	986	624	2343	0	92068
20383	2172	437	88097	1512	0	92218
20384	1204	86886	2273	1005	0	91368
20385	743	1813	1338	87210	0	91104
20386	88142	948	729	2542	0	92361
20387	86232	367	607	1836	0	89042
20388	87917	311	575	1150	0	89953
20389	2969	85409	702	1109	0	90189
20390	1574	1942	86249	893	0	90658
20391	929	1138	2110	86903	0	91080
20392	973	522	1329	79878	0	82702
20393	796	386	631	88805	0	90618
20394	807	383	553	88877	0	90620
20395	86731	329	590	3520	0	91170
20396	85804	434	597	1975	0	88810
20397	3057	506	84036	1218	0	88817
20398	1656	426	83311	1176	0	86569
20399	81217	334	3006	1146	0	85703
20400	83356	382	1550	1173	0	86461
20401	3182	325	835	78219	0	82561
20402	1657	81127	845	2479	0	86108
20403	80715	1929	722	1810	0	85176
20404	2348	79636	797	1234	0	84015
20405	1620	80365	741	1175	0	83901
20406	1162	2766	595	82353	0	86876
20407	997	1231	587	84541	0	87356
20408	927	596	688	85042	0	87253
20409	966	559	691	85107	0	87323
20410	914	610	81488	3526	0	86538
20411	79750	515	2092	1989	0	84346
20412	83503	498	1336	1193	0	86530
20413	3396	458	689	80722	0	85265
20414	1886	487	718	81618	0	84709
20415	80645	513	643	3329	0	85130
20416	2428	575	76983	2022	0	82008
20417	79667	382	2047	1330	0	83426
20418	80814	428	1330	1254	0	83826
20419	3220	501	78536	1141	0	83398
20420	80904	414	2049	1213	0	84580
20421	2771	416	1382	81505	0	86074
20422	1828	339	892	83065	0	86124
20423	1227	332	759	83897	0	86215
20424	1313	369	645	83280	0	85607
20425	77320	327	565	3242	0	81454
20426	2682	331	591	75954	0	79558
20427	1499	300	433	69460	0	71692
20428	782	64893	554	2670	0	68899
20429	643	66667	589	1469	0	69368
20430	831	1796	351	64744	0	67722
20431	63964	829	286	1864	0	66943
20432	1875	351	272	59940	0	62438
20433	901	306	55108	1485	0	57800
20434	535	263	52456	894	0	54148
20435	51243	193	1529	580	0	53545
20436	1253	52754	815	499	0	55321
20437	49040	883	709	436	0	51068
20438	1293	547	48648	399	0	50887
20439	1216	1314	935	44694	0	48159
20440	44853	189	508	987	0	46537
20441	868	44497	336	640	0	46341
20442	43891	664	290	450	0	45295
20443	964	466	47272	377	0	49079
20444	654	238	642	46411	0	47945
20445	340	131	437	48299	0	49207
20446	49240	97	314	1247	0	50898
20447	49430	119	254	650	0	50453
20448	51003	144	143	494	0	51784
20449	51173	155	112	415	0	51855
20450	51433	138	119	414	0	52104
20451	1151	50748	235	303	0	52437
20452	648	630	163	51574	0	53015
20453	52712	376	141	932	0	54161
20454	880	180	118	52672	0	53850
20455	656	115	95	52966	0	53832
20456	491	112	109	52949	0	53661
20457	342	51445	162	1027	0	52976
20458	51812	622	125	662	0	53221
20459	732	376	156	51609	0	52873
20460	50167	140	143	951	0	51401
20461	49120	88	89	712	0	50009
20462	996	48488	187	421	0	50092
20463	48552	510	89	419	0	49570
20464	850	392	47266	245	0	48753
20465	46427	164	607	227	0	47425
20466	793	376	531	46546	0	48246
20467	531	159	48565	534	0	49789
20468	334	48619	513	496	0	49962
20469	424	487	48232	238	0	49381
20470	126	45462	376	149	0	46113
20471	43169	313	411	280	0	44173
20472	43424	97	112	249	0	43882
20473	42973	27	29	161	0	43190
20474	180	43023	77	100	0	43380
20475	42520	97	41	194	0	42852
20476	154	153	42573	52	0	42932
20477	105	158	42840	50	0	43153
20478	87	94	92	42467	0	42740
20479	74	23	33	45665	0	45795
20480	38	45954	64	198	0	46254
20481	46517	151	16	183	0	46867
20482	210	64	23	46968	0	47265
20483	76	47114	68	227	0	47485
20484	62	177	13	48337	0	48589
20485	48183	75	21	316	0	48595
20486	46994	33	30	249	0	47306
20487	264	124	45794	75	0	46257
20488	166	34	182	46162	0	46544
20489	92	150	46521	243	0	47006
20490	85	42	193	46641	0	46961
20491	100	141	46883	264	0	47388
20492	98	36	213	46446	0	46793
20493	71	138	47235	286	0	47730
20494	116	36	223	46830	0	47205
20495	133	121	48058	284	0	48596
20496	100	30	256	47250	0	47636
20497	74	29	117	48775	0	48995
20498	54	49859	130	356	0	50399
20499	75	252	43	51475	0	51845
20500	81	270	50628	320	0	51299
20501	97	53	280	50236	0	50666
20502	84	33	110	50919	0	51146
20503	51069	34	62	553	0	51718
20504	291	43	50	51835	0	52219
20505	184	39	49	51528	0	51800
20506	92	150	49967	426	0	50635
20507	47956	31	281	342	0	48610
20508	288	33	139	51524	0	51984
20509	181	28	64	51902	0	52175
20510	80	40	55	52507	0	52682
20511	52417	26	57	592	0	53092
20512	319	31	66	53127	0	53543
20513	178	27	53	53279	0	53537
20514	52713	23	76	581	0	53393
20515	297	52701	92	262	0	53352
20516	185	280	51	52538	0	53054
20517	111	154	45	53075	0	53385
20518	103	160	51773	501	0	52537
20519	40423	60	353	515	0	41351
20520	350	53	162	50804	0	51369
20521	186	138	49201	430	0	49955
20522	49375	31	305	413	0	50124
20523	365	40	154	52317	0	52876
20524	193	36	91	54807	0	55127
20525	114	38	53	55354	0	55559
20526	125	29	67	56714	0	56935
20527	97	132	61059	783	0	62071
20528	151	33	680	61664	0	62528
20529	171	41	278	77226	0	77716
20530	148	150	86407	1703	0	88408
20531	88181	30	1788	901	0	90900
20532	93593	46	851	538	0	95028
20533	94511	49	361	360	0	95281
20534	3200	42	179	92067	0	95488
20535	93569	50	130	2173	0	95922
20536	95208	55	112	1220	0	96595
20537	3103	37	109	94258	0	97507
20538	95761	39	133	2385	0	98318
20539	96221	47	86	1267	0	97621
20540	96803	35	90	705	0	97633
20541	97560	43	101	494	0	98198
20542	3422	49	91	93255	0	96817
20543	1554	89551	201	2055	0	93361
20544	765	91003	228	1122	0	93118
20545	418	93085	184	623	0	94310
20546	89830	2994	96	488	0	93408
20547	92704	1293	90	415	0	94502
20548	3120	634	89001	360	0	93115
20549	90744	263	2049	434	0	93490
20550	2761	173	1019	92531	0	96484
20551	1548	133	436	93463	0	95580
20552	975	169	235	94941	0	96320
20553	91352	92	174	3643	0	95261
20554	2523	109	131	91764	0	94527
20555	1399	89390	287	2783	0	93859
20556	1008	2005	126	92017	0	95156
20557	694	1124	92673	2761	0	97252
20558	714	426	2067	93762	0	96969
20559	93702	222	1061	2903	0	97888
20560	2744	281	93427	1436	0	97888
20561	1654	136	2185	93274	0	97249
20562	1025	170	1083	94001	0	96279
20563	806	196	467	94598	0	96067
20564	547	94855	381	3492	0	99275
20565	668	2197	192	96500	0	99557
20566	95591	1103	160	2961	0	99815
20567	94755	523	236	1643	0	97157
20568	3616	368	91940	946	0	96870
20569	1987	317	92772	707	0	95783
20570	1274	174	3092	91698	0	96238
20571	947	190	1434	95247	0	97818
20572	714	336	94397	3680	0	99127
20573	907	293	2396	87822	0	91418
20574	595	92926	1374	2851	0	97746
20575	96424	2328	575	1635	0	100962
20576	96469	1156	420	1110	0	99155
20577	95801	561	359	914	0	97635
20578	4219	392	94002	797	0	99410
20579	2358	275	2418	94542	0	99593
20580	1223	291	94717	2832	0	99063
20581	90893	204	2620	1847	0	95564
20582	2755	93108	1453	1213	0	98529
20583	1847	2252	674	93171	0	97944
20584	93738	1187	387	3020	0	98332
20585	2947	613	353	93956	0	97869
20586	1888	405	355	96396	0	99044
20587	1186	445	93075	3870	0	98576
20588	87746	267	2506	2209	0	92728
20589	3053	92486	1581	1199	0	98319
20590	2033	2160	716	93893	0	98802
20591	93978	1126	538	2956	0	98598
20592	3211	567	400	94619	0	98797
20593	93873	409	347	3432	0	98061
20594	3271	93144	507	1987	0	98909
20595	95573	2258	309	1476	0	99616
20596	3602	1414	95365	919	0	101300
20597	96129	593	2462	986	0	100170
20598	97094	382	1419	956	0	99851
20599	98354	308	821	1055	0	100538
20600	4511	398	586	94600	0	100095
20601	2628	533	444	92140	0	95745
20602	1670	596	394	95142	0	97802
20603	1240	92393	472	4105	0	98210
20604	94171	2385	392	2308	0	99256
20605	3340	1274	390	93927	0	98931
20606	2293	666	475	95195	0	98629
20607	1685	385	498	95969	0	98537
20608	92618	383	432	4496	0	97929
20609	3215	319	453	93989	0	97976
20610	2026	471	90487	3649	0	96633
20611	1195	91193	2464	2433	0	97285
20612	1105	2492	1241	93370	0	98208
20613	1024	1540	641	95301	0	98506
20614	991	827	547	97096	0	99461
20615	1036	580	92409	4433	0	98458
20616	1066	497	92692	2472	0	96727
20617	1158	308	3581	93628	0	98675
20618	1061	473	96781	3331	0	101646
20619	1048	306	2960	98111	0	102425
20620	97970	278	1541	4026	0	103815
20621	101053	372	864	2669	0	104958
20622	101046	397	513	1807	0	103763
20623	4432	632	96112	1245	0	102421
20624	93763	426	2416	1196	0	97801
20625	3734	519	1616	95376	0	101245
20626	2088	360	94296	2953	0	99697
20627	1395	371	90971	1823	0	94560
20628	954	88179	3301	1601	0	94035
20629	562	76434	1347	763	0	79106
20630	64566	1288	2116	562	0	68532
20631	1174	466	237	62838	0	64715
20632	545	304	63517	1027	0	65393
20633	357	121	755	64610	0	65843
20634	64790	138	445	1165	0	66538
20635	959	231	69386	657	0	71233
20636	68951	86	992	581	0	70610
20637	73532	95	529	488	0	74644
20638	72448	84	219	465	0	73216
20639	1510	71124	278	370	0	73282
20640	73615	962	181	459	0	75217
20641	1345	470	161	73868	0	75844
20642	796	196	179	73889	0	75060
20643	496	126	146	74752	0	75520
20644	433	77	157	74223	0	74890
20645	71405	73	158	1802	0	73438
20646	1117	70370	231	858	0	72576
20647	590	68600	186	411	0	69787
20648	308	71011	251	284	0	71854
20649	70585	1309	225	407	0	72526
20650	70681	550	140	373	0	71744
20651	70573	207	127	392	0	71299
20652	70304	124	129	330	0	70887
20653	1546	124	152	69589	0	71411
20654	760	106	139	70457	0	71462
20655	69674	95	132	1558	0	71459
20656	1049	69427	242	727	0	71445
20657	67929	908	129	487	0	69453
20658	68704	442	132	377	0	69655
20659	1539	189	135	67369	0	69232
20660	718	68062	203	1077	0	70060
20661	470	987	151	69844	0	71452
20662	68499	469	129	1330	0	70427
20663	1231	307	69335	692	0	71565
20664	795	140	965	66744	0	68644
20665	383	68809	605	1026	0	70823
20666	68798	957	232	768	0	70755
20667	67627	519	145	528	0	68819
20668	1573	290	68802	318	0	70983
20669	767	67160	1020	296	0	69243
20670	460	1053	68586	229	0	70328
20671	467	579	1001	66163	0	68210
20672	325	310	66100	1021	0	67756
20673	351	257	65293	575	0	66476
20674	261	64568	1279	347	0	66455
20675	64610	855	565	331	0	66361
20676	64783	476	217	399	0	65875
20677	1274	65760	229	330	0	67593
20678	665	65547	238	305	0	66755
20679	434	1308	61268	246	0	63256
20680	440	659	61171	227	0	62497
20681	360	366	63478	229	0	64433
20682	394	195	1308	62519	0	64416
20683	367	289	63943	969	0	65568
20684	355	181	986	61766	0	63288
20685	379	168	546	62266	0	63359
20686	360	256	62730	1371	0	64717
20687	310	62440	989	721	0	64460
20688	420	912	511	62461	0	64304
20689	61878	521	221	1118	0	63738
20690	1121	265	160	62810	0	64356
20691	741	309	62641	1101	0	64792
20692	416	62379	971	709	0	64475
20693	375	66034	616	341	0	67366
20694	433	1426	313	64195	0	66367
20695	64629	632	199	1158	0	66618
20696	64302	321	192	771	0	65586
20697	1710	241	218	63003	0	65172
20698	910	67544	254	1185	0	69893
20699	587	1229	177	68538	0	70531
20700	576	736	167	70649	0	72128
20701	499	372	185	71379	0	72435
20702	72908	254	162	2168	0	75492
20703	1559	73152	310	1095	0	76116
20704	74265	1391	240	648	0	76544
20705	75318	892	236	507	0	76953
20706	75657	403	204	503	0	76767
20707	77518	337	204	521	0	78580
20708	2566	322	200	75226	0	78314
20709	1329	360	75222	1710	0	78621
20710	634	75579	1563	1127	0	78903
20711	76839	1496	905	676	0	79916
20712	78417	936	356	568	0	80277
20713	79799	384	234	533	0	80950
20714	2659	417	76603	351	0	80030
20715	76163	280	1535	393	0	78371
20716	78455	284	901	362	0	80002
20717	2694	296	353	76825	0	80168
20718	1380	355	73739	1626	0	77100
20719	667	72411	1572	1083	0	75733
20720	732	1581	927	72687	0	75927
20721	72129	847	482	1751	0	75209
20722	1762	380	241	72125	0	74508
20723	1151	291	277	74549	0	76268
20724	75694	249	226	2473	0	78642
20725	1932	348	74519	1183	0	77982
20726	75187	232	1607	713	0	77739
20727	74747	245	993	539	0	76524
20728	75186	237	429	490	0	76342
20729	75277	246	323	500	0	76346
20730	2774	334	72073	379	0	75560
20731	1502	265	1634	70793	0	74194
20732	749	312	72131	1649	0	74841
20733	695	350	1655	70848	0	73548
20734	530	266	71366	1770	0	73932
20735	63506	187	1607	1090	0	66390
20736	1707	62686	1050	468	0	65911
20737	1120	65139	400	336	0	66995
20738	768	2071	320	70263	0	73422
20739	710	1017	286	70220	0	72233
20740	482	75149	287	2506	0	78424
20741	76066	1863	209	1192	0	79330
20742	79694	1021	216	600	0	81531
20743	82766	320	242	421	0	83749
20744	85775	234	226	415	0	86650
20745	3676	194	207	83088	0	87165
20746	1862	180	208	86223	0	88473
20747	85764	169	208	3432	0	89573
20748	2839	153	212	85452	0	88656
20749	1703	268	82716	2611	0	87298
20750	875	292	83942	1438	0	86547
20751	853	163	3248	84057	0	88321
20752	721	241	84706	2529	0	88197
20753	82953	135	2551	1515	0	87154
20754	2764	133	1393	83628	0	87918
20755	84969	140	588	2612	0	88309
20756	2861	291	84924	1594	0	89670
20757	1807	177	2438	85080	0	89502
20758	890	274	86929	2727	0	90820
20759	635	85991	2801	1647	0	91074
20760	85345	2444	1492	862	0	90143
20761	86563	1237	567	753	0	89120
20762	3787	84466	443	733	0	89429
20763	85019	2421	334	662	0	88436
20764	3331	1260	310	83022	0	87923
20765	2045	446	325	85219	0	88035
20766	83211	292	367	3708	0	87578
20767	3039	80752	487	1819	0	86097
20768	1914	83355	449	957	0	86675
20769	1251	3316	381	81799	0	86747
20770	81879	1448	366	2768	0	86461
20771	83929	557	444	1656	0	86586
20772	84225	402	451	866	0	85944
20773	4343	450	80729	710	0	86232
20774	2275	371	80836	775	0	84257
20775	1298	80271	3647	723	0	85939
20776	81270	2481	1636	735	0	86122
20777	3472	1279	696	79042	0	84489
20778	80865	530	635	2889	0	84919
20779	81812	412	547	1751	0	84522
20780	4564	328	528	79162	0	84582
20781	2366	453	78910	3033	0	84762
20782	78966	346	2681	1888	0	83881
20783	3528	322	1493	79361	0	84704
20784	2137	416	79683	3163	0	85399
20785	78780	340	2743	1943	0	83806
20786	81921	317	1561	1182	0	84981
20787	4444	301	825	79644	0	85214
20788	2346	441	79589	3165	0	85541
20789	1629	372	2761	75800	0	80562
20790	1296	79663	1719	3027	0	85705
20791	1588	2580	80090	1767	0	86025
20792	1338	81738	2915	1078	0	87069
20793	80305	2570	1594	902	0	85371
20794	81647	1331	851	862	0	84691
20795	81449	582	707	921	0	83659
20796	81086	444	692	929	0	83151
20797	4644	497	575	76452	0	82168
20798	74039	414	512	2694	0	77659
20799	3472	343	485	72569	0	76869
20800	70703	320	521	2783	0	74327
20801	3006	69559	570	1745	0	74880
20802	1900	2010	448	64550	0	68908
20803	1077	66817	549	2286	0	70729
20804	67141	2119	402	1444	0	71106
20805	67487	1090	431	844	0	69852
20806	3216	65314	554	790	0	69874
20807	1856	1952	482	64757	0	69047
20808	1139	1044	63799	2196	0	68178
20809	1228	641	1964	63209	0	67042
20810	1054	471	63650	2268	0	67443
20811	1166	508	2085	56230	0	59989
20812	854	60727	1207	1884	0	64672
20813	61264	1806	537	1204	0	64811
20814	62406	916	435	772	0	64529
20815	3108	414	398	60855	0	64775
20816	63815	320	369	2250	0	66754
20817	2657	341	428	63605	0	67031
20818	1633	387	371	64820	0	67211
20819	1106	334	385	65967	0	67792
20820	64516	292	357	2950	0	68115
20821	65414	291	329	1525	0	67559
20822	65758	289	349	876	0	67272
20823	2958	61938	464	691	0	66051
20824	61041	1627	370	583	0	63621
20825	2214	59722	441	545	0	62922
20826	60811	1809	314	573	0	63507
20827	2412	872	292	59111	0	62687
20828	1536	482	272	60931	0	63221
20829	59653	360	294	2397	0	62704
20830	60177	342	282	1198	0	61999
20831	2660	58714	378	708	0	62460
20832	58921	1601	240	634	0	61396
20833	2377	746	178	56926	0	60227
20834	1430	418	191	57868	0	59907
20835	56319	265	193	2433	0	59210
20836	2171	338	55386	1158	0	59053
20837	1162	52906	1436	736	0	56240
20838	881	1136	498	46036	0	48551
20839	510	513	43317	1057	0	45397
20840	527	847	912	40583	0	42869
20841	40532	140	476	1096	0	42244
20842	962	38076	204	533	0	39775
20843	480	35691	124	316	0	36611
20844	295	34366	125	195	0	34981
20845	684	908	398	32606	0	34596
20846	32518	229	536	623	0	33906
20847	610	84	44	32455	0	33193
20848	32590	82	48	627	0	33347
20849	32948	61	43	292	0	33344
20850	746	76	45	32663	0	33530
20851	33235	63	47	601	0	33946
20852	663	65	38	33397	0	34163
20853	299	115	33286	581	0	34281
20854	32644	63	486	340	0	33533
20855	614	99	36019	161	0	36893
20856	33041	43	491	190	0	33765
20857	623	88	34279	115	0	35105
20858	272	49	346	31944	0	32611
20859	163	87	161	33130	0	33541
20860	33683	56	43	596	0	34378
20861	448	64	41	34602	0	35155
20862	34629	53	34	496	0	35212
20863	459	34433	62	267	0	35221
20864	35888	384	39	215	0	36526
20865	525	205	28	36897	0	37655
20866	286	70	44	37473	0	37873
20867	160	55	46	37858	0	38119
20868	183	41	42	37898	0	38164
20869	118	77	36518	585	0	37298
20870	102	97	35975	268	0	36442
20871	148	40	468	36605	0	37261
20872	101	74	37402	428	0	38005
20873	99	36870	423	252	0	37644
20874	146	379	186	37097	0	37808
20875	108	228	38343	441	0	39120
20876	104	99	37657	256	0	38116
20877	129	80	540	37850	0	38599
20878	126	42	241	38398	0	38807
20879	72	39196	108	614	0	39990
20880	129	420	61	39896	0	40506
20881	107	272	40315	499	0	41193
20882	38351	57	493	335	0	39236
20883	557	50	281	40928	0	41816
20884	40841	50	89	653	0	41633
20885	40831	38	68	419	0	41356
20886	41450	58	92	271	0	41871
20887	791	73	41805	166	0	42835
20888	339	89	41248	134	0	41810
20889	36526	48	742	260	0	37576
20890	584	105	42116	141	0	42946
20891	390	51	548	39571	0	40560
20892	169	37	312	40887	0	41405
20893	166	92	41230	766	0	42254
20894	110	41033	606	398	0	42147
20895	40845	498	342	253	0	41938
20896	552	41211	169	182	0	42114
20897	315	42530	168	179	0	43192
20898	42358	721	150	261	0	43490
20899	590	324	43963	168	0	45045
20900	343	154	44324	170	0	44991
20901	170	77	869	42868	0	43984
20902	43789	67	396	725	0	44977
20903	617	44156	209	466	0	45448
20904	44645	606	135	238	0	45624
20905	701	358	45361	208	0	46628
20906	383	49038	732	178	0	50331
20907	250	691	390	50064	0	51395
20908	203	426	51681	805	0	53115
20909	281	101	774	51554	0	52710
20910	241	133	474	48002	0	48850
20911	259	76	195	52993	0	53523
20912	221	86	223	52950	0	53480
20913	51898	76	177	1228	0	53379
20914	51680	96	183	620	0	52579
20915	1157	145	52357	224	0	53883
20916	49434	105	807	295	0	50641
20917	855	50258	540	241	0	51894
20918	50756	699	216	305	0	51976
20919	863	436	51082	237	0	52618
20920	574	170	802	49895	0	51441
20921	244	172	51399	852	0	52667
20922	226	133	51768	505	0	52632
20923	266	125	1183	50461	0	52035
20924	218	116	526	51694	0	52554
20925	214	163	50978	1235	0	52590
20926	198	49727	924	588	0	51437
20927	209	51111	564	306	0	52190
20928	240	1179	251	50715	0	52385
20929	49687	460	221	982	0	51350
20930	765	52555	289	664	0	54273
20931	527	841	52864	299	0	54531
20932	234	470	52174	286	0	53164
20933	244	218	53575	309	0	54346
20934	248	148	1262	51539	0	53197
20935	52744	129	570	1037	0	54480
20936	906	52407	351	678	0	54342
20937	665	886	52054	334	0	53939
20938	247	52518	994	298	0	54057
20939	292	835	576	52351	0	54054
20940	289	528	52745	918	0	54480
20941	233	53102	985	645	0	54965
20942	312	807	588	52252	0	53959
20943	272	482	290	54435	0	55479
20944	259	266	55421	1238	0	57184
20945	293	165	999	52661	0	54118
20946	244	54664	673	1012	0	56593
20947	272	870	54461	608	0	56211
20948	52604	514	958	315	0	54391
20949	993	260	572	54230	0	56055
20950	620	210	342	53223	0	54395
20951	235	53882	374	1152	0	55643
20952	53139	798	312	644	0	54893
20953	865	541	52556	291	0	54253
20954	50612	197	928	342	0	52079
20955	832	235	516	50300	0	51883
20956	421	51184	341	827	0	52773
20957	244	736	274	51348	0	52602
20958	236	440	200	52843	0	53719
20959	52020	229	230	1180	0	53659
20960	52506	183	274	629	0	53592
20961	1135	172	182	52465	0	53954
20962	496	225	52097	913	0	53731
20963	47588	174	879	642	0	49283
20964	747	52478	578	291	0	54094
20965	597	808	255	52271	0	53931
20966	277	413	253	53709	0	54652
20967	277	172	225	54100	0	54774
20968	172	254	52950	1331	0	54707
20969	233	212	903	51495	0	52843
20970	159	52693	624	956	0	54432
20971	266	807	258	51262	0	52593
20972	159	52479	281	941	0	53860
20973	249	888	223	52337	0	53697
20974	173	554	51641	1041	0	53409
20975	45728	189	829	637	0	47383
20976	870	168	479	51082	0	52599
20977	442	222	50737	913	0	52314
20978	164	50664	803	653	0	52284
20979	50076	756	539	415	0	51786
20980	754	456	49778	340	0	51328
20981	47602	200	879	383	0	49064
20982	783	135	374	49424	0	50716
20983	440	142	190	48751	0	49523
20984	188	49684	245	849	0	50966
20985	49527	658	207	475	0	50867
20986	48606	331	171	322	0	49430
20987	856	50175	249	229	0	51509
20988	455	653	146	50764	0	52018
20989	206	371	158	51166	0	51901
20990	178	152	155	50469	0	50954
20991	140	210	49274	1029	0	50653
20992	46644	148	679	601	0	48072
20993	697	147	377	49139	0	50360
20994	405	187	168	49690	0	50450
20995	193	232	48267	1024	0	49716
20996	152	200	47829	560	0	48741
20997	210	193	923	48754	0	50080
20998	200	199	49842	815	0	51056
20999	46627	115	723	540	0	48005
21000	658	114	430	48352	0	49554
21001	428	107	204	49230	0	49969
21002	209	168	50181	1004	0	51562
21003	239	201	657	50974	0	52071
21004	165	184	51947	801	0	53097
21005	198	50109	708	609	0	51624
21006	46208	581	606	297	0	47692
21007	45848	285	187	272	0	46592
21008	689	45046	165	213	0	46113
21009	389	489	82	45383	0	46343
21010	168	362	45848	572	0	46950
21011	143	114	483	45651	0	46391
21012	45425	81	317	662	0	46485
21013	511	46005	169	424	0	47109
21014	46360	470	105	274	0	47209
21015	565	280	91	46120	0	47056
21016	46071	108	92	643	0	46914
21017	530	45678	130	428	0	46766
21018	46083	476	96	277	0	46932
21019	578	308	44352	181	0	45419
21020	320	44968	515	172	0	45975
21021	221	428	312	44614	0	45575
21022	46694	226	143	617	0	47680
21023	47275	100	92	407	0	47874
21024	799	76	77	47165	0	48117
21025	48368	61	97	685	0	49211
21026	48043	70	85	452	0	48650
21027	49514	71	89	338	0	50012
21028	835	81	84	49593	0	50593
21029	393	133	50108	564	0	51198
21030	221	146	46978	351	0	47696
21031	164	122	48151	211	0	48648
21032	48123	68	744	217	0	49152
21033	613	78	333	49011	0	50035
21034	324	50301	200	615	0	51440
21035	257	503	112	49316	0	50188
21036	131	51242	189	573	0	52135
21037	51756	559	83	444	0	52842
21038	654	292	102	52485	0	53533
21039	396	139	82	54548	0	55165
21040	54757	92	120	1057	0	56026
21041	767	83	96	55536	0	56482
21042	488	90	99	56579	0	57256
21043	56880	72	111	1177	0	58240
21044	890	161	57772	540	0	59363
21045	524	85	793	57912	0	59314
21046	249	158	58315	954	0	59676
21047	57034	84	864	595	0	58577
21048	993	65	439	59145	0	60642
21049	59399	76	199	1033	0	60707
21050	1038	88	130	60268	0	61524
21051	570	141	61057	1031	0	62799
21052	358	93	893	61560	0	62904
21053	62184	77	485	1113	0	63859
21054	965	63584	263	710	0	65522
21055	559	936	63129	276	0	64900
21056	59314	419	875	311	0	60919
21057	995	64266	524	248	0	66033
21058	535	65661	210	232	0	66638
21059	281	71317	187	201	0	71986
21060	338	1427	111	73568	0	75444
21061	75529	556	196	1326	0	77607
21062	76979	187	127	774	0	78067
21063	1853	223	75414	278	0	77768
21064	73786	117	1264	287	0	75454
21065	1430	73503	651	222	0	75806
21066	757	1168	197	73367	0	75489
21067	77766	523	129	1467	0	79885
21068	79016	176	117	754	0	80063
21069	79856	112	128	408	0	80504
21070	78954	134	158	328	0	79574
21071	79858	102	162	316	0	80438
21072	2073	134	122	78466	0	80795
21073	882	206	78251	1402	0	80741
21074	537	150	1232	78936	0	80855
21075	471	149	587	79618	0	80825
21076	79139	128	220	1907	0	81394
21077	1558	77333	236	842	0	79969
21078	79018	1245	142	466	0	80871
21079	80161	611	178	467	0	81417
21080	82480	220	212	535	0	83447
21081	84164	176	175	484	0	84999
21082	2287	255	81343	341	0	84226
21083	81964	146	1270	400	0	83780
21084	83943	168	620	418	0	85149
21085	73959	201	336	511	0	75007
21086	84002	141	195	379	0	84717
21087	2360	147	157	80408	0	83072
21088	1125	249	78585	1497	0	81456
21089	77780	134	1359	865	0	80138
21090	1734	79400	705	459	0	82298
21091	1194	1239	262	77076	0	79771
21092	683	80434	242	1411	0	82770
21093	700	1336	185	81520	0	83741
21094	82299	642	211	1681	0	84833
21095	82894	257	250	901	0	84302
21096	83356	196	238	547	0	84337
21097	2304	311	77628	353	0	80596
21098	77835	225	1274	429	0	79763
21099	1865	326	77161	344	0	79696
21100	1199	280	76800	364	0	78643
21101	836	266	79389	321	0	80812
21102	949	475	1827	71890	0	75141
21103	770	145	786	76894	0	78595
21104	723	179	333	77157	0	78392
21105	715	167	286	77236	0	78404
21106	719	194	251	75837	0	77001
21107	681	191	290	75549	0	76711
21108	619	76194	350	1898	0	79061
21109	74759	1289	217	1038	0	77303
21110	1578	76419	311	576	0	78884
21111	1150	1380	224	76309	0	79063
21112	774	699	192	77929	0	79594
21113	76279	308	277	2043	0	78907
21114	1718	75986	349	969	0	79022
21115	77018	1319	233	554	0	79124
21116	1921	673	275	76268	0	79137
21117	1257	334	280	76913	0	78784
21118	869	252	292	77412	0	78825
21119	762	318	75713	2075	0	78868
21120	859	267	1312	75830	0	78268
21121	758	331	75049	1672	0	77810
21122	701	290	74229	952	0	76172
21123	790	265	78687	629	0	80371
21124	778	253	1827	77815	0	80673
21125	778	191	799	80655	0	82423
21126	780	242	395	82173	0	83590
21127	81082	270	302	2371	0	84025
21128	1868	293	311	83224	0	85696
21129	84274	228	353	2002	0	86857
21130	2042	83412	393	1169	0	87016
21131	87059	1456	283	799	0	89597
21132	90069	724	275	866	0	91934
21133	2620	92511	369	684	0	96184
21134	93982	1556	232	789	0	96559
21135	93975	799	301	764	0	95839
21136	95161	288	340	688	0	96477
21137	95195	218	491	652	0	96556
21138	2929	345	92311	526	0	96111
21139	1439	90614	1628	484	0	94165
21140	976	1666	804	89972	0	93418
21141	89466	681	493	1887	0	92527
21142	1968	374	89035	1057	0	92434
21143	1139	87328	1575	650	0	90692
21144	835	1321	757	81492	0	84405
21145	686	86600	465	1460	0	89211
21146	747	1555	249	86616	0	89167
21147	814	764	254	87618	0	89450
21148	827	445	86710	1998	0	89980
21149	788	368	85350	946	0	87452
21150	78197	293	1950	697	0	81137
21151	1775	408	86097	432	0	88712
21152	1173	461	85361	409	0	87404
21153	879	328	1795	82710	0	85712
21154	748	348	889	80965	0	82950
21155	600	83549	543	1878	0	86570
21156	603	89723	499	1080	0	91905
21157	626	1946	88230	520	0	91322
21158	860	1285	1689	87940	0	91774
21159	509	403	86268	1575	0	88755
21160	381	257	79705	859	0	81202
21161	294	79242	1861	395	0	81792
21162	535	1255	956	77263	0	80009
21163	78233	704	351	1253	0	80541
21164	1353	294	216	78698	0	80561
21165	79242	177	230	1497	0	81146
21166	78835	174	236	880	0	80125
21167	78349	173	206	600	0	79328
21168	1878	274	76614	295	0	79061
21169	76480	175	1214	358	0	78227
21170	1484	124	749	78009	0	80366
21171	78762	126	360	1423	0	80671
21172	78574	151	283	920	0	79928
21173	1755	77269	335	431	0	79790
21174	78267	1131	217	409	0	80024
21175	1422	763	77971	251	0	80407
21176	75979	293	1217	347	0	77836
21177	77298	203	728	363	0	78592
21178	1711	77838	429	280	0	80258
21179	78025	1146	233	337	0	79741
21180	1434	697	253	74264	0	76648
21181	877	295	289	73419	0	74880
21182	430	73691	343	1627	0	76091
21183	530	1100	265	75023	0	76918
21184	473	638	289	75596	0	76996
21185	446	423	74133	1717	0	76719
21186	441	313	72770	943	0	74467
21187	70125	217	1671	540	0	72553
21188	74372	185	824	438	0	75819
21189	1930	189	351	75034	0	77504
21190	1082	286	74785	1320	0	77473
21191	548	74670	1338	827	0	77383
21192	558	1193	797	74659	0	77207
21193	494	764	75392	1296	0	77946
21194	70702	331	1350	995	0	73378
21195	1568	235	798	76047	0	78648
21196	970	77997	528	1391	0	80886
21197	737	1300	295	79058	0	81390
21198	612	756	333	80251	0	81952
21199	609	360	370	81042	0	82381
21200	78630	248	326	2268	0	81472
21201	1788	226	324	78444	0	80782
21202	79363	290	337	1819	0	81809
21203	79895	299	285	1142	0	81621
21204	2361	329	78572	656	0	81918
21205	1249	79050	1543	567	0	82409
21206	970	1548	919	67538	0	70975
21207	591	82531	591	1296	0	85009
21208	83612	1708	381	984	0	86685
21209	1976	931	361	83551	0	86819
21210	1248	432	83619	1849	0	87148
21211	779	336	83211	1137	0	85463
21212	638	392	83997	599	0	85626
21213	81421	285	2472	622	0	84800
21214	1922	83962	1244	557	0	87685
21215	83859	1680	519	599	0	86657
21216	2036	84934	485	578	0	88033
21217	1401	1834	435	83097	0	86767
21218	866	1011	429	81951	0	84257
21219	670	84215	484	2483	0	87852
21220	722	1817	84385	1378	0	88302
21221	605	85836	1867	783	0	89091
21222	82022	1738	992	731	0	85483
21223	1991	963	423	78813	0	82190
21224	1206	492	77272	1812	0	80782
21225	688	401	77452	1095	0	79636
21226	780	477	2286	75861	0	79404
21227	626	387	75688	1672	0	78373
21228	541	346	72604	1046	0	74537
21229	67150	281	2041	585	0	70057
21230	1495	70007	1144	537	0	73183
21231	67885	1316	422	476	0	70099
21232	1627	840	67121	431	0	70019
21233	957	62665	1527	426	0	65575
21234	545	64562	958	397	0	66462
21235	765	2136	680	62924	0	66505
21236	465	881	359	64296	0	66001
21237	447	361	304	66160	0	67272
21238	398	366	64318	2253	0	67335
21239	481	273	1416	64872	0	67042
21240	467	276	821	66523	0	68087
21241	65514	256	383	2317	0	68470
21242	1557	64857	386	1263	0	68063
21243	1046	1476	295	66271	0	69088
21244	66355	884	287	1743	0	69269
21245	65695	396	301	1111	0	67503
21246	2274	323	303	64801	0	67701
21247	1117	358	65101	1666	0	68242
21248	556	323	1529	65401	0	67809
21249	414	317	65439	1838	0	68008
21250	67966	222	1674	1174	0	71036
21251	75338	225	1046	633	0	77242
21252	2793	376	511	77727	0	81407
21253	1255	311	78425	2120	0	82111
21254	543	79866	2168	1404	0	83981
21255	558	2171	81673	576	0	84978
21256	653	1693	2156	68473	0	72975
21257	332	76080	1150	1747	0	79309
21258	73151	1815	324	907	0	76197
21259	1952	875	255	69734	0	72816
21260	892	72393	333	1786	0	75404
21261	73432	1827	272	956	0	76487
21262	1969	875	251	71979	0	75074
21263	909	73041	348	1917	0	76215
21264	522	1938	236	74021	0	76717
21265	303	1005	72722	2052	0	76082
21266	69823	352	1886	1101	0	73162
21267	72728	266	903	530	0	74427
21268	2571	297	71081	407	0	74356
21269	984	70828	1947	365	0	74124
21270	71624	1783	972	452	0	74831
21271	1991	869	389	71121	0	74370
21272	1147	358	284	71844	0	73633
21273	574	262	292	73338	0	74466
21274	480	286	318	73413	0	74497
21275	454	279	291	72823	0	73847
21276	70431	294	285	2906	0	73916
21277	71974	269	325	1349	0	73917
21278	2747	249	310	70369	0	73675
21279	1222	279	285	72057	0	73843
21280	575	308	69780	2841	0	73504
21281	421	288	70092	1351	0	72152
21282	68118	283	2564	661	0	71626
21283	2224	350	1032	69071	0	72677
21284	1123	332	68340	2246	0	72041
21285	609	296	1953	68883	0	71741
21286	68836	263	1065	2337	0	72501
21287	71167	230	487	1323	0	73207
21288	2906	291	354	69277	0	72828
21289	1352	248	345	70264	0	72209
21290	69528	237	394	2920	0	73079
21291	2187	294	320	68885	0	71686
21292	1240	69670	393	2225	0	73528
21293	773	1800	303	69712	0	72588
21294	663	973	296	70684	0	72616
21295	465	385	68404	2783	0	72037
21296	553	296	66900	1307	0	69056
21297	449	67857	2420	859	0	71585
21298	66920	1747	1084	682	0	70433
21299	66896	855	388	684	0	68823
21300	67820	323	368	702	0	69213
21301	2632	64795	484	709	0	68620
21302	1159	66660	526	616	0	68961
21303	64455	2314	354	688	0	67811
21304	1891	66877	465	739	0	69972
21305	1089	1876	65343	677	0	68985
21306	581	66124	1837	756	0	69298
21307	610	1834	63912	639	0	66995
21308	61260	919	1648	641	0	64468
21309	64312	395	834	693	0	66234
21310	2273	63381	449	632	0	66735
21311	65266	1624	328	699	0	67917
21312	69584	864	330	657	0	71435
21313	70442	399	346	725	0	71912
21314	2892	358	333	68372	0	71955
21315	69538	281	375	2147	0	72341
21316	2308	416	67395	1250	0	71369
21317	68213	332	1740	761	0	71046
21318	2397	312	965	68971	0	72645
21319	1439	384	68480	2064	0	72367
21320	872	357	69367	1357	0	71953
21321	835	331	2363	69003	0	72532
21322	712	291	1134	71080	0	73217
21323	70510	337	519	2820	0	74186
21324	2193	271	380	71120	0	73964
21325	1276	327	69890	2428	0	73921
21326	865	295	1816	68074	0	71050
21327	672	71286	1115	2202	0	75275
21328	72343	1656	509	1419	0	75927
21329	2249	858	466	72217	0	75790
21330	1340	510	71220	2085	0	75155
21331	786	70848	1873	1288	0	74795
21332	68875	1552	951	847	0	72225
21333	2062	832	526	70176	0	73596
21334	1349	450	70641	1880	0	74320
21335	802	69978	1676	1251	0	73707
21336	70031	1602	1003	867	0	73503
21337	70002	760	486	681	0	71929
21338	70732	362	422	659	0	72175
21339	2577	298	295	68505	0	71675
21340	1445	232	313	69759	0	71749
21341	68337	198	305	2375	0	71215
21342	1784	67398	416	1315	0	70913
21343	68405	1335	300	871	0	70911
21344	1889	750	309	67854	0	70802
21345	69650	355	346	1827	0	72178
21346	1952	337	341	69336	0	71966
21347	1245	268	359	69763	0	71635
21348	942	299	317	70660	0	72218
21349	1168	336	321	70782	0	72607
21350	617	322	63358	2054	0	66351
21351	467	256	56423	914	0	58060
21352	47928	112	1032	606	0	49678
21353	885	170	53644	354	0	55053
21354	460	128	48940	229	0	49757
21355	46081	100	981	295	0	47457
21356	49312	77	553	234	0	50176
21357	935	105	317	52203	0	53560
21358	53068	72	220	672	0	54032
21359	714	53683	171	440	0	55008
21360	54965	460	122	364	0	55911
21361	54534	313	134	317	0	55298
21362	57411	190	130	377	0	58108
21363	951	171	107	56789	0	58018
21364	606	55789	148	559	0	57102
21365	399	57574	145	401	0	58519
21366	57846	682	140	327	0	58995
21367	58055	366	120	317	0	58858
21368	819	236	92	57318	0	58465
21369	536	160	114	57287	0	58097
21370	365	57031	144	758	0	58298
21371	56718	443	108	516	0	57785
21372	622	398	56622	304	0	57946
21373	504	154	409	55394	0	56461
21374	375	105	301	56945	0	57726
21375	270	139	57193	761	0	58363
21376	260	96	456	55821	0	56633
21377	245	44145	446	725	0	45561
21378	269	404	190	57746	0	58609
21379	268	268	156	57232	0	57924
21380	222	53178	165	751	0	54316
21381	248	57749	141	526	0	58664
21382	265	573	106	57654	0	58598
21383	57336	349	116	692	0	58493
21384	530	199	119	57989	0	58837
21385	425	140	130	58417	0	59112
21386	316	59045	197	772	0	60330
21387	298	425	142	61115	0	61980
21388	279	269	136	60990	0	61674
21389	274	159	115	61372	0	61920
21390	59738	174	106	937	0	60955
21391	547	96	119	60159	0	60921
21392	469	114	91	59431	0	60105
21393	346	117	98	59544	0	60105
21394	308	191	56640	835	0	57974
21395	50202	100	416	697	0	51415
21396	604	56061	339	395	0	57399
21397	56984	365	156	332	0	57837
21398	678	311	122	56815	0	57926
21399	477	258	55502	480	0	56717
21400	49884	177	397	495	0	50953
21401	645	203	64017	284	0	65149
21402	468	143	449	63826	0	64886
21403	66823	95	339	619	0	67876
21404	65471	91	189	451	0	66202
21405	67276	78	137	461	0	67952
21406	786	105	68	67307	0	68266
21407	564	92	74	68289	0	69019
21408	366	158	80	68360	0	68964
21409	236	64683	112	796	0	65827
21410	166	65132	103	522	0	65923
21411	157	64324	95	372	0	64948
21412	93	62495	78	90	0	62756
21413	140	193	59	63793	0	64185
21414	68	87	39	64644	0	64838
21415	63266	33	36	299	0	63634
21416	62838	28	45	229	0	63140
21417	63924	38	49	208	0	64219
21418	228	42	26	63250	0	63546
21419	144	38	30	64149	0	64361
21420	61957	40	28	380	0	62405
21421	60031	83	80	238	0	60432
21422	243	134	61227	137	0	61741
21423	183	121	58654	110	0	59068
21424	117	135	60294	105	0	60651
21425	166	140	63235	94	0	63635
21426	107	35	191	62644	0	62977
21427	62758	32	85	304	0	63179
21428	153	62325	85	277	0	62840
21429	133	187	15	63986	0	64321
21430	118	189	64019	223	0	64549
21431	70	66418	154	274	0	66916
21432	105	134	76	67654	0	67969
21433	118	212	66660	251	0	67241
21434	98	67	135	64957	0	65257
21435	109	53	95	66749	0	67006
21436	67131	45	55	364	0	67595
21437	218	36	24	68254	0	68532
21438	157	140	68709	226	0	69232
21439	122	28	145	68131	0	68426
21440	85	72823	155	243	0	73306
21441	151	129	62	77018	0	77360
21442	119	95	56	78249	0	78519
21443	109	47	60	77952	0	78168
21444	78527	46	50	473	0	79096
21445	77667	31	59	372	0	78129
21446	78365	53	45	366	0	78829
21447	78392	41	49	284	0	78766
21448	301	162	77202	116	0	77781
21449	74608	35	148	201	0	74992
21450	78220	47	101	255	0	78623
21451	261	151	76560	139	0	77111
21452	220	170	80495	101	0	80986
21453	138	50	172	81081	0	81441
21454	62	82693	174	185	0	83114
21455	84603	142	90	299	0	85134
21456	85756	103	49	343	0	86251
21457	84175	32	55	323	0	84585
21458	242	34	57	83482	0	83815
21459	132	86036	137	213	0	86518
21460	89716	140	35	511	0	90402
21461	90829	91	61	401	0	91382
21462	291	66	48	88823	0	89228
21463	187	224	87812	245	0	88468
21464	86772	31	169	351	0	87323
21465	255	39	96	91586	0	91976
21466	93108	31	49	461	0	93649
21467	253	47	48	94666	0	95014
21468	178	205	94135	223	0	94741
21469	98848	41	175	615	0	99679
21470	228	46	109	103179	0	103562
21471	266	38	60	104001	0	104365
21472	127	43	51	104641	0	104862
21473	122	41	43	104648	0	104854
21474	105604	50	44	599	0	106297
21475	218	60	37	105011	0	105326
21476	151	104281	148	275	0	104855
21477	150	234	40	106476	0	106900
21478	89	106561	126	298	0	107074
21479	146	264	49	108452	0	108911
21480	146	141	42	109251	0	109580
21481	81	108390	139	418	0	109028
21482	140	233	36	110413	0	110822
21483	130	141	47	110314	0	110632
21484	109159	37	49	623	0	109868
21485	371	231	111274	283	0	112159
21486	277	43	339	111367	0	112026
21487	112158	30	199	674	0	113061
21488	111386	55	77	498	0	112016
21489	112262	59	52	408	0	112781
21490	682	216	111981	119	0	112998
21491	386	284	111363	117	0	112150
21492	190	113	662	114369	0	115334
21493	117038	32	294	760	0	118124
21494	581	226	116077	331	0	117215
21495	111190	47	504	378	0	112119
21496	540	117122	344	154	0	118160
21497	407	445	85	122055	0	122992
21498	214	277	66	124264	0	124821
21499	124788	90	58	1030	0	125966
21500	536	65	52	126018	0	126671
21501	119112	48	58	919	0	120137
21502	120174	63	72	707	0	121016
21503	818	41	62	119143	0	120064
21504	423	47	48	119779	0	120297
21505	118494	50	65	1061	0	119670
21506	641	266	123809	367	0	125083
21507	121344	50	514	693	0	122601
21508	679	309	129993	131	0	131112
21509	130004	55	541	615	0	131215
21510	139826	50	295	734	0	140905
21511	138246	65	136	473	0	138920
21512	136358	65	85	469	0	136977
21513	822	135234	233	231	0	136520
21514	138775	496	81	541	0	139893
21515	138594	274	70	445	0	139383
21516	840	144172	264	227	0	145503
21517	145839	521	92	590	0	147042
21518	761	643	142840	159	0	144403
21519	141696	105	564	483	0	142848
21520	851	396	145551	198	0	146996
21521	577	64	671	145556	0	146868
21522	327	67	376	148059	0	148829
21523	300	361	147414	1040	0	149115
21524	344	81	667	146651	0	147743
21525	724	527	890	116448	0	118589
21526	155106	68	173	1575	0	156922
21527	1029	80	150	156842	0	158101
21528	685	83	123	157472	0	158363
21529	388	68	96	158068	0	158620
21530	271	155198	287	1433	0	157189
21531	331	871	132	155987	0	157321
21532	154783	482	108	1456	0	156829
21533	1198	466	157959	778	0	160401
21534	853	137	1046	160604	0	162640
21535	440	353	160876	1342	0	163011
21536	154326	101	1246	991	0	156664
21537	1443	92	679	167639	0	169853
21538	995	448	199911	1707	0	203061
21539	615	142	2661	200505	0	203923
21540	552	132	1892	198027	0	200603
21541	342	197273	1015	4523	0	203153
21542	504	2608	418	204024	0	207554
21543	544	1836	277	213944	0	216601
21544	470	1156	210670	5443	0	217739
21545	580	359	3136	211141	0	215216
21546	601	198	2115	214667	0	217581
21547	208931	165	849	6064	0	216009
21548	208547	192	522	3510	0	212771
21549	5139	209483	564	1599	0	216785
21550	213451	3110	322	1391	0	218274
21551	212560	2105	412	1262	0	216339
21552	5603	209388	655	954	0	216600
21553	3314	3407	349	209050	0	216120
21554	212324	2227	305	4138	0	218994
21555	213844	888	382	3156	0	218270
21556	210425	504	340	1853	0	213122
21557	6213	208013	694	1175	0	216095
21558	3684	3609	214325	1026	0	222644
21559	219588	2289	3539	1301	0	226717
21560	222886	1096	2366	1309	0	227657
21561	6702	221939	1225	1156	0	231022
21562	225272	4226	563	1416	0	231477
21563	227632	2817	557	1302	0	232308
21564	7566	1143	493	223233	0	232435
21565	4174	1173	224347	4898	0	234592
21566	2348	546	4274	228026	0	235194
21567	1823	508	2775	229247	0	234353
21568	1598	524	1095	232947	0	236164
21569	1379	929	220794	8039	0	231141
21570	1726	521	4440	215487	0	222174
21571	1542	560	2910	224759	0	229771
21572	1435	497	1189	227740	0	230861
21573	1539	449	766	230185	0	232939
21574	1445	510	542	230794	0	233291
21575	1174	227938	848	9414	0	239374
21576	1429	4568	619	233282	0	239898
21577	1345	2941	720	242084	0	247090
21578	1226	1481	235057	8793	0	246557
21579	1661	739	4919	258606	0	265925
21580	1501	723	3292	262794	0	268310
21581	1745	714	1405	272689	0	276553
21582	2116	658	1097	276703	0	280574
21583	266697	754	828	12453	0	280732
21584	8002	931	764	273429	0	283126
21585	5854	1224	594	274412	0	282084
21586	3287	1456	261585	11922	0	278250
21587	2491	253069	6338	7739	0	269637
21588	1673	267183	4877	4891	0	278624
21589	260673	8954	2565	4170	0	276362
21590	6367	265670	1909	4258	0	278204
21591	4996	7119	1073	262866	0	276054
21592	262151	4519	1097	9730	0	277497
21593	7250	2370	264679	7376	0	281675
21594	5300	1435	6767	265264	0	278766
21595	2512	266803	4713	10217	0	284245
21596	2161	6720	1919	264363	0	275163
21597	1361	270202	1577	10904	0	284044
21598	1832	7991	967	273134	0	283924
21599	267523	5418	912	11193	0	285046
21600	7744	2891	271440	8326	0	290401
21601	5673	1667	7342	262393	0	277075
21602	2688	271624	5706	10264	0	290282
21603	272043	7368	2534	8466	0	290411
21604	8076	5266	270560	6240	0	290142
21605	6079	2322	7406	271099	0	286906
21606	3322	1977	264913	11142	0	281354
21607	3180	1481	8346	266292	0	279299
21608	2405	1747	260773	11900	0	276825
21609	2137	1563	9030	254875	0	267605
21610	1990	1773	6179	258574	0	268516
21611	249840	1956	2968	14336	0	269100
21612	256054	2260	1934	8899	0	269147
21613	12602	2155	1503	245990	0	262250
21614	7221	250210	1862	10396	0	269689
21615	3986	8245	1382	256688	0	270301
21616	3418	5450	1698	256278	0	266844
21617	243652	2591	2046	15372	0	263661
21618	7907	245205	2355	10672	0	266139
21619	247111	8630	1579	6859	0	264179
21620	246660	6248	1469	6064	0	260441
21621	12097	236971	1754	5851	0	256673
21622	7218	249673	1797	6091	0	264779
21623	243684	11157	1862	6532	0	263235
21624	9465	6758	239124	6672	0	262019
21625	238962	3310	8164	6553	0	256989
21626	240533	2877	5582	6151	0	255143
21627	13454	234623	3715	5687	0	257479
21628	8835	8340	2722	208118	0	228015
21629	4151	236562	3272	11111	0	255096
21630	234002	9459	3215	8826	0	255502
21631	239174	6783	3063	6385	0	255405
21632	13169	4237	2631	230859	0	250896
21633	8526	3649	2180	236516	0	250871
21634	221093	3101	1790	15515	0	241499
21635	9802	222080	2160	10844	0	244886
21636	8038	220312	2071	7174	0	237595
21637	4821	218549	2442	6167	0	231979
21638	2668	181376	1890	5356	0	191290
21639	2535	187147	1788	5536	0	197006
21640	3230	10746	1881	181041	0	196898
21641	3197	6389	174054	8945	0	192585
21642	3453	176426	5809	6507	0	192195
21643	168165	7023	3728	4127	0	183043
21644	8127	5101	2442	166284	0	181954
21645	167571	3588	1952	7671	0	180782
21646	7553	165844	2291	5892	0	181580
21647	167276	6641	2453	4007	0	180377
21648	8103	166925	3077	3635	0	181740
21649	6579	6838	2676	166226	0	182319
21650	166957	4584	2359	8013	0	181913
21651	170560	3174	2398	6556	0	182688
21652	9745	2829	2035	168692	0	183301
21653	6652	2921	1734	168449	0	179756
21654	4598	164669	1633	10764	0	181664
21655	4987	6389	1188	168006	0	180570
21656	4943	4700	976	170029	0	180648
21657	4797	3793	1040	166626	0	176256
21658	3529	154662	1406	10808	0	170405
21659	142772	5855	893	6538	0	156058
21660	6033	146639	1282	4330	0	158284
21661	144575	6383	920	3291	0	155169
21662	6978	144054	1393	2766	0	155191
21663	5742	6502	138708	2686	0	153638
21664	4313	4748	4669	138530	0	152260
21665	3565	3447	136684	5556	0	149252
21666	3326	3012	136357	4026	0	146721
21667	3658	2681	6634	133985	0	146958
21668	3698	2444	135913	5534	0	147589
21669	4084	2108	5248	132671	0	144111
21670	4259	2117	3371	133740	0	143487
21671	3649	2371	1794	137493	0	145307
21672	132150	2450	1231	8764	0	144595
21673	6583	2318	973	133121	0	142995
21674	5697	1999	756	131069	0	139521
21675	121322	1599	596	8209	0	131726
21676	6086	117779	710	5833	0	130408
21677	4594	111332	585	3813	0	120324
21678	3531	114722	575	2786	0	121614
21679	2249	7419	512	87194	0	97374
21680	1710	2606	87042	3352	0	94710
21681	74656	1607	2425	2160	0	80848
21682	2731	78833	1514	1164	0	84242
21683	77581	2503	657	932	0	81673
21684	77612	1751	361	780	0	80504
21685	77996	1279	383	698	0	80356
21686	3598	1226	76101	759	0	81684
21687	2329	1078	1770	76402	0	81579
21688	1633	856	1218	78497	0	82204
21689	1560	752	581	79755	0	82648
21690	1409	680	458	76828	0	79375
21691	1155	73777	554	3403	0	78889
21692	71510	1806	395	1982	0	75693
21693	1874	1268	67268	1063	0	71473
21694	63643	614	1224	879	0	66360
21695	1986	693	774	62119	0	65572
21696	1240	60734	361	1754	0	64089
21697	805	62923	258	1379	0	65365
21698	984	3696	350	56378	0	61408
21699	504	58276	309	1367	0	60456
21700	52554	966	174	878	0	54572
21701	877	685	51205	457	0	53224
21702	567	318	588	48665	0	50138
21703	347	205	415	51156	0	52123
21704	269	212	166	51898	0	52545
21705	301	208	144	51862	0	52515
21706	51232	191	147	1245	0	52815
21707	742	53659	180	768	0	55349
21708	59434	774	140	504	0	60852
21709	1203	585	109	60044	0	61941
21710	837	278	121	60460	0	61696
21711	355	63418	225	1753	0	65751
21712	64738	1123	192	1099	0	67152
21713	65376	781	146	567	0	66870
21714	1922	64659	203	379	0	67163
21715	970	1208	93	59318	0	61589
21716	394	62397	183	1171	0	64145
21717	61130	1278	279	923	0	63610
21718	1314	877	61546	383	0	64120
21719	856	390	59709	309	0	61264
21720	57165	190	1662	388	0	59405
21721	1122	59635	906	353	0	62016
21722	825	1098	269	59793	0	61985
21723	344	758	153	60638	0	61893
21724	243	420	59930	1832	0	62425
21725	332	212	1065	59912	0	61521
21726	295	194	700	60848	0	62037
21727	196	59112	291	1896	0	61495
21728	243	1151	162	59788	0	61344
21729	247	785	143	59802	0	60977
21730	57851	301	120	1988	0	60260
21731	1137	56254	223	1091	0	58705
21732	801	57088	203	593	0	58685
21733	425	1662	145	57056	0	59288
21734	353	912	116	58265	0	59646
21735	310	346	98	58352	0	59106
21736	224	56822	183	2042	0	59271
21737	331	1141	107	58466	0	60045
21738	299	792	107	58280	0	59478
21739	337	344	79	59170	0	59930
21740	310	246	90	58219	0	58865
21741	209	55260	187	2111	0	57767
21742	237	59138	182	1153	0	60710
21743	57692	1690	72	570	0	60024
21744	58239	926	108	441	0	59714
21745	1929	388	99	57863	0	60279
21746	1018	342	57256	1427	0	60043
21747	468	295	1150	58329	0	60242
21748	377	261	711	58513	0	59862
21749	56552	267	251	2056	0	59126
21750	1301	58414	227	1116	0	61058
21751	934	1257	142	58232	0	60565
21752	448	870	127	59237	0	60682
21753	319	471	57241	2127	0	60158
21754	305	366	57284	1177	0	59132
21755	273	265	1807	56817	0	59162
21756	331	291	934	55295	0	56851
21757	273	55263	423	1937	0	57896
21758	212	57271	286	1132	0	58901
21759	56078	1735	168	732	0	58713
21760	1369	914	180	57264	0	59727
21761	833	465	56442	1497	0	59237
21762	341	56507	1140	1230	0	59218
21763	319	1259	707	57516	0	59801
21764	57090	889	234	1632	0	59845
21765	1218	442	127	58823	0	60610
21766	57540	299	167	1725	0	59731
21767	1313	58126	208	1235	0	60882
21768	57380	1328	149	765	0	59622
21769	1449	934	118	58804	0	61305
21770	921	528	61392	1631	0	64472
21771	491	429	1318	60374	0	62612
21772	421	62584	933	1791	0	65729
21773	415	1587	295	62102	0	64399
21774	290	65591	288	1908	0	68077
21775	328	1737	209	68134	0	70408
21776	327	1094	65980	2216	0	69617
21777	334	520	64869	1589	0	67312
21778	332	527	66245	954	0	68058
21779	64062	450	2403	865	0	67780
21780	1663	65040	1218	757	0	68678
21781	1168	67557	503	687	0	69915
21782	66054	2370	336	809	0	69569
21783	66615	1226	347	792	0	68980
21784	2504	586	288	65605	0	68983
21785	1280	533	65404	2140	0	69357
21786	642	497	63405	1458	0	66002
21787	531	430	2382	62889	0	66232
21788	62690	365	1221	2185	0	66461
21789	1611	62526	586	1602	0	66325
21790	1122	1744	397	63176	0	66439
21791	62765	1114	377	2350	0	66606
21792	63404	497	344	1697	0	65942
21793	2431	482	62530	1089	0	66532
21794	59595	467	1637	945	0	62644
21795	1967	578	63662	792	0	66999
21796	1324	564	65475	748	0	68111
21797	735	416	2443	62915	0	66509
21798	584	429	1306	64811	0	67130
21799	569	474	584	66544	0	68171
21800	470	617	63810	2938	0	67835
21801	63077	479	1654	1902	0	67112
21802	1987	476	1107	66655	0	70225
21803	64535	422	527	2376	0	67860
21804	63800	499	450	1691	0	66440
21805	2585	64541	558	1046	0	68730
21806	1333	65960	626	902	0	68821
21807	595	64880	639	726	0	66840
21808	562	2149	443	57851	0	61005
21809	475	1007	57710	1457	0	60649
21810	546	1732	1369	53243	0	56890
21811	432	54498	937	1309	0	57176
21812	414	54570	423	941	0	56348
21813	584	1582	318	53633	0	56117
21814	52686	761	321	1314	0	55082
21815	1198	51814	422	919	0	54353
21816	798	52618	412	510	0	54338
21817	53501	1522	317	614	0	55954
21818	1345	787	305	53879	0	56316
21819	996	343	295	54454	0	56088
21820	600	226	245	56012	0	57083
21821	53654	212	307	1896	0	56069
21822	54517	205	330	1020	0	56072
21823	1867	204	359	54228	0	56658
21824	1066	246	53138	1343	0	55793
21825	52484	202	1259	1012	0	54957
21826	1340	205	878	54708	0	57131
21827	912	275	53844	1449	0	56480
21828	470	287	53713	1043	0	55513
21829	444	214	1725	55205	0	57588
21830	404	331	58327	1551	0	60613
21831	490	252	1332	62250	0	64324
21832	531	333	862	60547	0	62273
21833	539	318	376	65623	0	66856
21834	64140	394	311	2486	0	67331
21835	1637	418	317	65030	0	67402
21836	1180	459	309	65461	0	67409
21837	537	497	336	65938	0	67308
21838	512	476	322	66036	0	67346
21839	407	530	62141	2466	0	65544
21840	361	62381	1453	1524	0	65719
21841	419	1452	812	61007	0	63690
21842	415	988	376	58960	0	60739
21843	379	57814	378	1979	0	60550
21844	414	61421	384	1136	0	63355
21845	60579	1830	325	721	0	63455
21846	1466	60052	374	618	0	62510
21847	1047	1417	250	59300	0	62014
21848	591	907	59705	1605	0	62808
21849	56597	373	1242	1190	0	59402
21850	1519	331	58065	797	0	60712
21851	57313	210	1393	746	0	59662
21852	58471	131	904	723	0	60229
21853	2071	209	58367	745	0	61392
21854	1223	157	1489	54836	0	57705
21855	620	56873	1002	1820	0	60315
21856	568	1217	555	60550	0	62890
21857	61529	694	496	2008	0	64727
21858	62268	258	475	1454	0	64455
21859	2026	61214	539	1136	0	64915
21860	62075	1266	422	1033	0	64796
21861	1702	788	399	60838	0	63727
21862	60854	326	378	2130	0	63688
21863	62321	274	360	1636	0	64591
21864	2228	314	280	61728	0	64550
21865	61625	290	243	2182	0	64340
21866	58949	344	251	1628	0	61172
21867	1943	432	59753	1003	0	63131
21868	57781	436	1284	952	0	60453
21869	1630	454	58368	763	0	61215
21870	846	392	54621	598	0	56457
21871	432	56916	1642	612	0	59602
21872	516	1238	938	53965	0	56657
21873	392	697	55379	1159	0	57627
21874	393	351	54125	717	0	55586
21875	53886	241	1321	485	0	55933
21876	1103	196	649	54755	0	56703
21877	679	259	320	57157	0	58415
21878	378	246	245	58249	0	59118
21879	385	258	175	58406	0	59224
21880	448	209	185	59079	0	59921
21881	464	295	57290	1632	0	59681
21882	514	301	56904	881	0	58600
21883	486	235	1323	57754	0	59798
21884	57495	203	619	1295	0	59612
21885	1134	57075	369	972	0	59550
21886	918	879	253	57477	0	59527
21887	57457	511	244	1232	0	59444
21888	1237	57333	247	966	0	59783
21889	969	905	241	57931	0	60046
21890	656	547	246	58978	0	60427
21891	533	214	309	59227	0	60283
21892	57812	138	323	1814	0	60087
21893	1193	210	57349	1021	0	59773
21894	56992	158	1120	692	0	58962
21895	1272	180	719	58180	0	60351
21896	832	161	428	55191	0	56612
21897	429	56476	446	1721	0	59072
21898	374	948	56257	1057	0	58636
21899	54214	558	1062	813	0	56647
21900	56918	237	706	810	0	58671
21901	1476	259	55750	752	0	58237
21902	52677	183	984	799	0	54643
21903	1130	55664	729	720	0	58243
21904	750	56778	470	621	0	58619
21905	423	57188	443	580	0	58634
21906	54874	1372	480	560	0	57286
21907	1150	744	55138	562	0	57594
21908	793	664	891	52193	0	54541
21909	386	52150	637	1112	0	54285
21910	364	53006	318	767	0	54455
21911	405	53416	329	440	0	54590
21912	696	1483	291	42288	0	44758
21913	50989	559	202	1157	0	52907
21914	939	51770	218	847	0	53774
21915	661	883	195	52217	0	53956
21916	490	563	195	53025	0	54273
21917	51310	250	254	1372	0	53186
21918	1134	172	225	51532	0	53063
21919	785	194	171	52425	0	53575
21920	419	273	51151	1440	0	53283
21921	491	213	818	51133	0	52655
21922	518	198	531	52709	0	53956
21923	51886	151	295	1390	0	53722
21924	51926	168	258	776	0	53128
21925	1459	171	283	51639	0	53552
21926	49491	221	217	1084	0	51013
21927	49941	281	211	700	0	51133
21928	1265	50344	317	408	0	52334
21929	779	889	49149	314	0	51131
21930	459	47255	903	293	0	48910
21931	524	1040	556	42791	0	44911
21932	42218	354	235	615	0	43422
21933	496	42051	139	425	0	43111
21934	380	511	125	41897	0	42913
21935	41625	310	129	645	0	42709
21936	41521	171	116	457	0	42265
21937	732	122	91	41586	0	42531
21938	380	195	42032	657	0	43264
21939	219	105	448	42602	0	43374
21940	193	117	257	43569	0	44136
21941	177	182	43094	827	0	44280
21942	203	95	461	42841	0	43600
21943	204	108	309	43675	0	44296
21944	44954	80	128	1016	0	46178
21945	612	99	89	45567	0	46367
21946	411	124	102	46042	0	46679
21947	45164	111	106	938	0	46319
21948	44572	110	132	552	0	45366
21949	44798	164	102	330	0	45394
21950	822	192	44053	279	0	45346
21951	448	195	479	42624	0	43746
21952	200	44356	314	553	0	45423
21953	272	527	85	45242	0	46126
21954	295	422	46195	574	0	47486
21955	371	270	423	42971	0	44035
21956	194	170	44562	584	0	45510
21957	40703	126	370	393	0	41592
21958	42583	86	221	276	0	43166
21959	584	75	89	43286	0	44034
21960	339	69	82	43517	0	44007
21961	182	69	66	43001	0	43318
21962	120	44672	141	594	0	45527
21963	44350	311	74	454	0	45189
21964	44688	222	68	355	0	45333
21965	565	79	66	44354	0	45064
21966	344	71	59	44176	0	44650
21967	190	56	77	44542	0	44865
21968	188	57	63	44594	0	44902
21969	199	140	43600	650	0	44589
21970	248	69	325	43560	0	44202
21971	41668	58	208	541	0	42475
21972	41401	54	90	414	0	41959
21973	570	59	76	40532	0	41237
21974	301	142	39034	444	0	39921
21975	36890	66	341	397	0	37694
21976	449	92	227	39052	0	39820
21977	263	37425	139	462	0	38289
21978	110	39008	101	305	0	39524
21979	39908	460	112	325	0	40805
21980	465	229	53	40739	0	41486
21981	301	65	44	41892	0	42302
21982	159	46	46	44024	0	44275
21983	142	39	43	44407	0	44631
21984	136	68	51	45618	0	45873
21985	150	120	44720	873	0	45863
21986	122	106	44122	473	0	44823
21987	127	98	45010	214	0	45449
21988	141	35	812	44604	0	45592
21989	141	105	46579	685	0	47510
21990	134	46	612	46450	0	47242
21991	153	31	373	47125	0	47682
21992	152	36	141	49004	0	49333
21993	48902	32	134	1175	0	50243
21994	682	29	112	49255	0	50078
21995	472	61	121	50106	0	50760
21996	49267	33	120	1123	0	50543
21997	654	48800	164	597	0	50215
21998	399	50244	138	329	0	51110
21999	50088	938	78	354	0	51458
22000	684	51801	117	241	0	52843
22001	51907	680	74	364	0	53025
22002	52273	379	78	352	0	53082
22003	52321	101	66	327	0	52815
22004	51435	82	65	296	0	51878
22005	51724	86	76	272	0	52158
22006	1120	51028	125	205	0	52478
22007	51303	685	81	247	0	52316
22008	51904	429	115	264	0	52712
22009	1120	53504	134	228	0	54986
22010	62020	716	65	373	0	63174
22011	63431	459	72	312	0	64274
22012	68153	138	84	284	0	68659
22013	70655	113	58	310	0	71136
22014	2527	169	72838	292	0	75826
22015	1307	123	1661	75226	0	78317
22016	620	132	868	78518	0	80138
22017	417	194	77321	2721	0	80653
22018	401	224	76650	1201	0	78476
22019	74959	142	2718	503	0	78322
22020	2162	182	1143	77387	0	80874
22021	1288	195	78422	1925	0	81830
22022	617	211	77807	1094	0	79729
22023	76458	214	2772	494	0	79938
22024	79527	101	1197	383	0	81208
22025	80052	105	394	363	0	80914
22026	3227	216	78601	240	0	82284
22027	1634	126	1943	78263	0	81966
22028	764	212	80476	1975	0	83427
22029	78041	127	2163	1238	0	81569
22030	2397	184	82308	444	0	85333
22031	1469	159	2252	79416	0	83296
22032	855	152	1209	77408	0	79624
22033	519	81857	594	2735	0	85705
22034	83081	1921	425	1340	0	86767
22035	2414	1075	82739	551	0	86779
22036	81931	309	2268	511	0	85019
22037	2617	253	85585	406	0	88861
22038	1675	145	2465	82539	0	86824
22039	957	143	1415	85193	0	87708
22040	901	139	665	86254	0	87959
22041	83951	136	495	3384	0	87966
22042	2797	149	462	83459	0	86867
22043	1748	132	514	83946	0	86340
22044	888	81012	619	3299	0	85818
22045	908	1927	558	82956	0	86349
22046	80231	994	592	2724	0	84541
22047	2731	403	81148	1525	0	85807
22048	1868	180	2437	80698	0	85183
22049	1007	231	82063	2652	0	85953
22050	812	78998	2806	1774	0	84390
22051	848	1988	82138	972	0	85946
22052	79971	1100	2886	912	0	84869
22053	83115	349	1738	849	0	86051
22054	3657	234	1058	80101	0	85050
22055	81720	196	925	2757	0	85598
22056	82248	178	939	1769	0	85134
22057	3762	185	958	81442	0	86347
22058	2285	166	906	83149	0	86506
22059	1309	280	82158	3557	0	87304
22060	1119	81435	2732	1975	0	87261
22061	81784	2056	1697	1166	0	86703
22062	2886	80695	1063	1005	0	85649
22063	2136	2284	847	80385	0	85652
22064	1429	1157	801	82178	0	85565
22065	1208	467	852	83109	0	85636
22066	1092	356	873	83229	0	85550
22067	890	447	79762	4028	0	85127
22068	75864	352	2730	2210	0	81156
22069	81762	331	1724	1333	0	85150
22070	3839	328	1026	79862	0	85055
22071	80757	310	790	3013	0	84870
22072	3242	327	751	81129	0	85449
22073	2054	459	79612	3215	0	85340
22074	1450	290	2515	78286	0	82541
22075	1172	78503	1733	3117	0	84525
22076	1178	1943	932	76625	0	80678
22077	932	79353	898	3135	0	84318
22078	1165	2260	726	73909	0	78060
22079	886	77851	815	2965	0	82517
22080	74857	2221	752	2147	0	79977
22081	2721	1317	74965	1459	0	80462
22082	1599	70932	2514	1375	0	76420
22083	1036	73966	1585	1359	0	77946
22084	1270	2795	1380	71718	0	77163
22085	1122	1199	802	72475	0	75598
22086	1162	524	856	72905	0	75447
22087	1141	420	752	73625	0	75938
22088	1001	70405	924	3525	0	75855
22089	1146	1903	697	70682	0	74428
22090	1233	1028	684	70844	0	73789
22091	68196	556	624	3381	0	72757
22092	2684	428	535	69311	0	72958
22093	1617	462	67131	2982	0	72192
22094	997	493	65764	2038	0	69292
22095	61261	440	2517	1615	0	65833
22096	2195	65274	1433	1379	0	70281
22097	1356	67323	721	1259	0	70659
22098	1048	2522	751	65324	0	69645
22099	775	1334	477	66996	0	69582
22100	689	772	63686	3264	0	68411
22101	59100	533	1890	2101	0	63624
22102	63459	472	1161	1410	0	66502
22103	2776	487	65077	1334	0	69674
22104	1501	462	63736	1235	0	66934
22105	63026	370	2473	1351	0	67220
22106	67310	366	1196	1265	0	70137
22107	67559	416	615	1233	0	69823
22108	66524	377	459	1169	0	68529
22109	2789	62145	538	1168	0	66640
22110	54604	1314	300	824	0	57042
22111	1670	713	51695	781	0	54859
22112	655	331	46924	622	0	48532
22113	392	309	48230	540	0	49471
22114	742	2166	1476	39100	0	43484
22115	39714	98	492	517	0	40821
22116	39857	82	91	340	0	40370
22117	526	87	80	39578	0	40271
22118	286	82	77	37978	0	38423
22119	179	94	77	39332	0	39682
22120	140	41066	133	557	0	41896
22121	41792	324	69	454	0	42639
22122	41967	175	84	308	0	42534
22123	42203	89	93	251	0	42636
22124	42223	69	82	254	0	42628
22125	42239	67	91	235	0	42632
22126	578	67	83	40826	0	41554
22127	259	40245	105	469	0	41078
22128	221	294	69	37984	0	38568
22129	140	152	59	39013	0	39364
22130	37557	62	66	433	0	38118
22131	283	116	36780	192	0	37371
22132	172	78	34578	98	0	34926
22133	104	97	34687	90	0	34978
22134	36481	22	271	164	0	36938
22135	38609	29	221	130	0	38989
22136	325	32	74	39215	0	39646
22137	141	26	61	38200	0	38428
22138	91	35	42	39166	0	39334
22139	90	69	39136	341	0	39636
22140	99	22	226	37974	0	38321
22141	89	95	40868	301	0	41353
22142	96	31	241	40498	0	40866
22143	75	35	117	40889	0	41116
22144	70	34	44	42124	0	42272
22145	41969	23	37	409	0	42438
22146	42176	26	45	301	0	42548
22147	350	96	42515	108	0	43069
22148	41297	28	213	172	0	41710
22149	42487	17	96	151	0	42751
22150	357	25	63	42523	0	42968
22151	42973	24	53	358	0	43408
22152	285	26	66	43645	0	44022
22153	187	27	56	44061	0	44331
22154	103	83	43042	395	0	43623
22155	39384	25	228	290	0	39927
22156	280	69	135	43341	0	43825
22157	208	77	43425	291	0	44001
22158	116	99	45399	197	0	45811
22159	144	15	358	43698	0	44215
22160	108	15	181	44819	0	45123
22161	45492	13	76	533	0	46114
22162	286	13	55	46216	0	46570
22163	212	13	69	46418	0	46712
22164	118	13	54	47264	0	47449
22165	104	14	64	51060	0	51242
22166	52437	18	59	776	0	53290
22167	52489	13	76	462	0	53040
22168	53759	22	56	281	0	54118
22169	54668	19	64	264	0	55015
22170	850	20	58	56145	0	57073
22171	56905	11	65	704	0	57685
22172	714	12	48	56861	0	57635
22173	57257	14	71	760	0	58102
22174	746	11	61	57249	0	58067
22175	495	27	58	56274	0	56854
22176	164	56903	97	950	0	58114
22177	205	591	55	56750	0	57601
22178	55755	298	57	858	0	56968
22179	54495	72	86	576	0	55229
22180	994	114	55899	249	0	57256
22181	455	55954	670	216	0	57295
22182	56218	567	348	285	0	57418
22183	676	57359	201	201	0	58437
22184	57131	620	106	259	0	58116
22185	755	59931	138	257	0	61081
22186	524	727	59830	230	0	61311
22187	226	60654	649	285	0	61814
22188	216	61607	419	240	0	62482
22189	236	974	115	62772	0	64097
22190	63809	418	78	955	0	65260
22191	874	141	74	64292	0	65381
22192	562	103	60	64677	0	65402
22193	63394	85	72	1240	0	64791
22194	64785	93	68	835	0	65781
22195	1192	99	65	65096	0	66452
22196	684	75	70	65494	0	66323
22197	397	70	81	65831	0	66379
22198	63754	87	95	1284	0	65220
22199	897	161	64025	636	0	65719
22200	626	112	668	64250	0	65656
22201	348	200	66351	899	0	67798
22202	250	65046	812	673	0	66781
22203	385	779	63641	322	0	65127
22204	325	408	737	62734	0	64204
22205	269	290	63378	867	0	64804
22206	60021	153	769	699	0	61642
22207	882	140	428	62770	0	64220
22208	565	64219	237	975	0	65996
22209	422	758	122	64250	0	65552
22210	313	64416	166	923	0	65818
22211	325	64619	166	642	0	65752
22212	344	65317	191	362	0	66214
22213	421	1125	105	60272	0	61923
22214	300	62704	149	923	0	64076
22215	62181	771	110	699	0	63761
22216	969	528	60142	628	0	62267
22217	648	326	58592	426	0	59992
22218	412	269	61486	370	0	62537
22219	352	155	1042	62272	0	63821
22220	394	177	488	60513	0	61572
22221	411	173	207	60230	0	61021
22222	484	136	176	60304	0	61100
22223	536	183	183	58382	0	59284
22224	486	60480	246	1318	0	62530
22225	490	867	58961	716	0	61034
22226	523	571	58325	500	0	59919
22227	415	61126	1086	518	0	63145
22228	484	791	515	62193	0	63983
22229	481	503	231	62903	0	64118
22230	421	324	197	63240	0	64182
22231	61960	277	205	1483	0	63925
22232	956	416	60966	866	0	63204
22233	59307	278	753	626	0	60964
22234	60282	290	477	599	0	61648
22235	1277	58640	329	504	0	60750
22236	737	59761	258	416	0	61172
22237	60104	1090	212	482	0	61888
22238	1034	637	273	60074	0	62018
22239	743	349	184	62456	0	63732
22240	499	400	64381	1398	0	66678
22241	410	426	63998	756	0	65590
22242	407	330	1247	65792	0	67776
22243	66590	354	690	1221	0	68855
22244	1020	429	69360	825	0	71634
22245	70775	323	1042	677	0	72817
22246	1189	353	680	73334	0	75556
22247	829	295	320	76480	0	77924
22248	538	238	283	78896	0	79955
22249	403	370	77822	2012	0	80607
22250	355	76008	1254	1129	0	78746
22251	350	80444	810	682	0	82286
22252	79914	1639	289	721	0	82563
22253	81682	731	217	642	0	83272
22254	1932	295	252	82133	0	84612
22255	82871	212	270	1761	0	85114
22256	1597	287	81162	994	0	84040
22257	865	360	80545	560	0	82330
22258	471	236	1880	80072	0	82659
22259	82923	196	906	1748	0	85773
22260	1469	189	420	84477	0	86555
22261	938	175	393	86664	0	88170
22262	84680	177	368	2358	0	87583
22263	85917	195	395	1193	0	87700
22264	2082	88553	400	712	0	91747
22265	86723	1283	235	539	0	88780
22266	1594	805	227	84035	0	86661
22267	746	85822	299	1571	0	88438
22268	85523	1376	237	924	0	88060
22269	1442	87009	302	422	0	89175
22270	880	1439	179	85754	0	88252
22271	85708	648	151	1570	0	88077
22272	1505	281	84979	755	0	87520
22273	796	277	84759	300	0	86132
22274	445	264	1815	83301	0	85825
22275	334	119	734	86255	0	87442
22276	359	176	238	82663	0	83436
22277	247	89703	262	1846	0	92058
22278	91624	1490	188	924	0	94226
22279	92128	761	159	536	0	93584
22280	92169	236	131	527	0	93063
22281	2337	96365	244	385	0	99331
22282	1122	1687	179	103333	0	106321
22283	534	835	188	104825	0	106382
22284	531	256	162	105897	0	106846
22285	98383	199	207	3089	0	101878
22286	1896	99723	251	1320	0	103190
22287	1237	1863	131	100439	0	103670
22288	566	972	136	102059	0	103733
22289	483	440	98349	2907	0	102179
22290	443	97961	1853	1376	0	101633
22291	645	1927	952	97877	0	101401
22292	528	1020	266	99629	0	101443
22293	541	371	200	99919	0	101031
22294	95805	264	200	3149	0	99418
22295	2015	95744	351	1611	0	99721
22296	96894	1934	218	836	0	99882
22297	2314	1063	226	95818	0	99421
22298	96720	383	236	2375	0	99714
22299	2294	450	94397	1386	0	98527
22300	94367	338	1879	866	0	97450
22301	95468	300	1005	797	0	97570
22302	3015	429	94584	694	0	98722
22303	1588	389	1849	94755	0	98581
22304	886	314	1007	95868	0	98075
22305	98574	331	353	3397	0	102655
22306	2377	364	284	100718	0	103743
22307	1581	353	293	101262	0	103489
22308	899	373	245	101979	0	103496
22309	733	467	98189	3391	0	102780
22310	90139	355	1986	1937	0	94417
22311	2338	99860	1192	986	0	104376
22312	1552	2124	376	97290	0	101342
22313	816	99118	378	2535	0	102847
22314	683	103907	461	1738	0	106789
22315	748	3113	316	103544	0	107721
22316	753	1527	103286	2928	0	108494
22317	768	681	104200	1848	0	107497
22318	895	537	3055	105040	0	109527
22319	755	578	105308	2956	0	109597
22320	102427	465	2426	1978	0	107296
22321	2751	464	1345	107183	0	111743
22322	1775	461	497	108604	0	111337
22323	841	108297	541	3896	0	113575
22324	852	2357	425	109505	0	113139
22325	853	1327	414	108191	0	110785
22326	707	106267	602	3978	0	111554
22327	927	2352	459	108902	0	112640
22328	890	1367	413	107136	0	109806
22329	723	106406	544	3965	0	111638
22330	106416	2335	407	2251	0	111409
22331	2767	1487	106291	1275	0	111820
22332	1728	753	105905	1162	0	109548
22333	1065	659	3110	105139	0	109973
22334	847	618	1413	108108	0	110986
22335	729	619	106150	4034	0	111532
22336	737	677	104781	2196	0	108391
22337	95116	624	3202	1510	0	100452
22338	2431	105136	1583	1336	0	110486
22339	104049	2338	581	1269	0	108237
22340	2649	1384	101684	1278	0	106995
22341	1470	100745	2563	1203	0	105981
22342	995	2554	1456	102728	0	107733
22343	716	1453	105770	2950	0	110889
22344	612	650	104021	1929	0	107212
22345	790	911	3244	104558	0	109503
22346	737	637	105591	3128	0	110093
22347	620	103340	2628	2098	0	108686
22348	786	2570	1550	101722	0	106628
22349	878	1512	103409	2901	0	108700
22350	536	104099	2597	2058	0	109290
22351	102833	2394	1542	1172	0	107941
22352	2610	1479	102096	983	0	107168
22353	1492	102839	2544	1039	0	107914
22354	854	2362	1565	101283	0	106064
22355	667	1420	649	105791	0	108527
22356	103769	546	601	3936	0	108852
22357	2653	429	601	104199	0	107882
22358	1530	389	511	102931	0	105361
22359	99178	351	574	3895	0	103998
22360	2479	421	482	99334	0	102716
22361	1464	452	95568	2877	0	100361
22362	808	563	2255	95736	0	99362
22363	500	481	95473	2805	0	99259
22364	533	389	90592	1718	0	93232
22365	485	417	93237	949	0	95088
22366	725	434	3019	87136	0	91314
22367	483	269	1556	91947	0	94255
22368	90820	252	664	3055	0	94791
22369	1990	312	534	87864	0	90700
22370	1226	92168	593	2378	0	96365
22371	603	1803	524	95402	0	98332
22372	452	1149	549	92648	0	94798
22373	286	94233	619	3033	0	98171
22374	93346	1818	566	1729	0	97459
22375	91702	1113	569	1010	0	94394
22376	2481	91456	672	885	0	95494
22377	980	89327	519	688	0	91514
22378	665	3589	629	86341	0	91224
22379	87569	1098	622	2026	0	91315
22380	1714	589	87658	1266	0	91227
22381	1033	461	79947	640	0	82081
22382	72385	242	1853	497	0	74977
22383	1234	76891	1057	438	0	79620
22384	857	1357	428	77499	0	80141
22385	404	810	358	76730	0	78302
22386	339	298	335	78230	0	79202
22387	304	236	328	78389	0	79257
22388	201	77037	365	2141	0	79744
22389	324	1190	282	78708	0	80504
22390	78037	784	267	1786	0	80874
22391	1359	335	293	79464	0	81451
22392	909	244	276	80233	0	81662
22393	79820	218	287	2317	0	82642
22394	80706	216	281	1244	0	82447
22395	82317	218	256	759	0	83550
22396	82896	186	266	644	0	83992
22397	2233	197	279	81434	0	84143
22398	82115	224	253	1688	0	84280
22399	1609	199	295	81927	0	84030
22400	81671	191	284	1766	0	83912
22401	81780	207	320	1201	0	83508
22402	2125	182	292	81605	0	84204
22403	1051	321	83171	1577	0	86120
22404	82041	196	1402	1189	0	84828
22405	83292	222	885	671	0	85070
22406	82668	243	373	675	0	83959
22407	82652	230	301	624	0	83807
22408	2293	279	310	82171	0	85053
22409	1164	316	82350	1574	0	85404
22410	553	366	80147	1021	0	82087
22411	78196	304	1904	722	0	81126
22412	82578	180	983	598	0	84339
22413	1863	81184	521	528	0	84096
22414	904	81027	354	457	0	82742
22415	81658	1511	322	535	0	84026
22416	1363	774	267	79711	0	82115
22417	1053	288	196	81595	0	83132
22418	80475	189	224	1912	0	82800
22419	1220	81549	328	1025	0	84122
22420	83521	1087	198	783	0	85589
22421	1382	760	82346	532	0	85020
22422	81279	234	1074	648	0	83235
22423	1453	204	605	82430	0	84692
22424	942	242	83836	1471	0	86491
22425	515	84693	1161	1014	0	87383
22426	551	1056	662	86959	0	89228
22427	528	708	90790	1404	0	93430
22428	549	207	1220	89978	0	91954
22429	92453	115	794	1790	0	95152
22430	1470	257	92574	997	0	95298
22431	88572	143	1290	632	0	90637
22432	1533	93499	912	478	0	96422
22433	1046	1163	350	94751	0	97310
22434	727	862	99514	1376	0	102479
22435	588	287	1244	98715	0	100834
22436	531	356	101339	1587	0	103813
22437	447	99936	1407	1079	0	102869
22438	98595	1092	809	642	0	101138
22439	1309	102977	417	389	0	105092
22440	991	1209	201	101397	0	103798
22441	643	750	217	102438	0	104048
22442	439	433	98214	1780	0	100866
22443	76329	266	1070	1177	0	78842
22444	1146	92308	740	467	0	94661
22445	602	87895	245	314	0	89056
22446	363	89135	246	297	0	90041
22447	563	1400	364	85717	0	88044
22448	243	86782	271	805	0	88101
22449	404	938	176	84481	0	85999
22450	251	85339	201	766	0	86557
22451	291	796	100	83082	0	84269
22452	228	85598	222	746	0	86794
22453	85298	713	160	550	0	86721
22454	722	536	85425	293	0	86976
22455	80680	225	715	335	0	81955
22456	84838	147	398	367	0	85750
22457	86622	182	188	376	0	87368
22458	934	86726	271	221	0	88152
22459	88079	598	159	364	0	89200
22460	87775	402	146	326	0	88649
22461	89946	188	176	366	0	90676
22462	1140	281	88811	158	0	90390
22463	685	161	669	89907	0	91422
22464	387	261	92575	782	0	94005
22465	349	168	808	90781	0	92106
22466	90832	175	497	1057	0	92561
22467	872	91143	309	679	0	93003
22468	668	1010	102981	356	0	105015
22469	440	595	1242	102173	0	104450
22470	304	284	632	108160	0	109380
22471	278	339	115540	1999	0	118156
22472	110357	232	1860	1066	0	113515
22473	117235	193	880	547	0	118855
22474	119841	212	306	410	0	120769
22475	2857	215	203	116790	0	120065
22476	1110	114229	327	1901	0	117567
22477	507	120790	284	1022	0	122603
22478	492	2547	181	119278	0	122498
22479	509	1119	208	117102	0	118938
22480	269	118195	255	2545	0	121264
22481	117666	1850	173	1141	0	120830
22482	1893	118183	306	461	0	120843
22483	1092	1947	158	116234	0	119431
22484	479	1085	115334	1944	0	118842
22485	394	402	1856	114571	0	117223
22486	115345	252	903	2244	0	118744
22487	1993	410	115596	1018	0	119017
22488	115619	225	1916	614	0	118374
22489	120325	270	947	550	0	122092
22490	122409	229	351	548	0	123537
22491	122567	219	308	557	0	123651
22492	126471	208	470	509	0	127658
22493	3268	353	121501	322	0	125444
22494	1570	364	120838	341	0	123113
22495	130612	284	2895	454	0	134245
22496	136666	252	1204	422	0	138544
22497	3843	291	398	136726	0	141258
22498	1639	139101	397	2668	0	143805
22499	778	2708	246	141980	0	145712
22500	143895	1438	253	3118	0	148704
22501	3126	554	244	137658	0	141582
22502	1733	145739	372	2806	0	150650
22503	145007	2752	272	1653	0	149684
22504	144438	1470	257	865	0	147030
22505	144745	578	275	733	0	146331
22506	4194	142536	427	648	0	147805
22507	2115	2778	326	142742	0	147961
22508	1158	1479	260	141526	0	144423
22509	843	138070	459	3990	0	143362
22510	1050	2761	236	141197	0	145244
22511	139284	1467	228	3349	0	144328
22512	140112	591	301	1860	0	142864
22513	4446	138013	432	783	0	143674
22514	2394	2844	365	138886	0	144489
22515	1340	1517	421	140913	0	144191
22516	1097	645	499	142750	0	144991
22517	137034	438	475	4765	0	142712
22518	3534	615	135149	2184	0	141482
22519	131356	482	2853	1331	0	136022
22520	3922	760	134696	1019	0	140397
22521	2571	714	2996	127112	0	133393
22522	1504	129892	1680	3250	0	136326
22523	1289	136507	727	2100	0	140623
22524	132461	4228	418	1371	0	138478
22525	131562	2036	444	1256	0	135298
22526	4614	128047	486	1189	0	134336
22527	2330	127998	480	1110	0	131918
22528	128163	4226	453	1090	0	133932
22529	129793	2080	412	1231	0	133516
22530	4796	130459	506	1089	0	136850
22531	134133	3286	421	1164	0	139004
22532	4139	2109	131024	997	0	138269
22533	132252	1044	2844	1179	0	137319
22534	131689	859	1599	1137	0	135284
22535	5277	736	675	127965	0	134653
22536	2927	127287	621	3541	0	134376
22537	2125	3127	472	129663	0	135387
22538	130300	1794	495	3814	0	136403
22539	4497	843	452	126739	0	132531
22540	2999	745	536	129621	0	133901
22541	1885	859	128801	4866	0	136411
22542	1843	664	3107	130422	0	136036
22543	1727	737	1779	134303	0	138546
22544	132054	754	762	5105	0	138675
22545	4092	978	131024	2579	0	138673
22546	132745	929	3086	1565	0	138325
22547	4436	942	1654	133013	0	140045
22548	2907	923	642	135180	0	139652
22549	1968	970	462	133474	0	136874
22550	1657	128215	643	4945	0	135460
22551	1863	132935	651	2492	0	137941
22552	2023	4636	486	129848	0	136993
22553	129853	2141	428	3709	0	136131
22554	131864	1079	501	2236	0	135680
22555	5908	916	448	129086	0	136358
22556	129986	844	438	4019	0	135287
22557	4747	867	464	128776	0	134854
22558	3109	893	369	130875	0	135246
22559	124773	794	423	5446	0	131436
22560	4271	129287	632	2957	0	137147
22561	129138	3414	393	1771	0	134716
22562	129552	1908	391	1819	0	133670
22563	126158	825	473	1744	0	129200
22564	5139	123517	669	1592	0	130917
22565	2892	3475	478	123926	0	130771
22566	1982	1811	546	126889	0	131228
22567	1530	941	121479	5269	0	129219
22568	1563	1250	2581	110568	0	115962
22569	1383	634	107271	3504	0	112792
22570	1190	100721	2533	2192	0	106636
22571	926	90664	1235	1161	0	93986
22572	989	94219	573	1008	0	96789
22573	1356	3006	757	94646	0	99765
22574	1063	1357	332	96039	0	98791
22575	797	688	301	97400	0	99186
22576	776	593	267	99015	0	100651
22577	796	619	97310	3551	0	102276
22578	769	690	113218	2099	0	116776
22579	938	535	3162	116666	0	121301
22580	981	586	119742	3194	0	124503
22581	117976	419	2666	2214	0	123275
22582	122007	482	1332	1378	0	125199
22583	4018	598	121420	1294	0	127330
22584	2245	368	2551	122287	0	127451
22585	1392	463	1401	125497	0	128753
22586	1259	442	629	127310	0	129640
22587	1301	418	531	126072	0	128322
22588	1261	410	548	128622	0	130841
22589	101917	692	657	4942	0	108208
22590	120426	472	478	2689	0	124065
22591	3737	120460	559	1831	0	126587
22592	1924	2525	114704	1253	0	120406
22593	928	113734	2481	1245	0	118388
22594	716	114907	1375	1149	0	118147
22595	105981	2754	563	1038	0	110336
22596	2141	104865	495	948	0	108449
22597	1123	101265	471	704	0	103563
22598	99868	2455	577	706	0	103606
22599	2128	1195	98461	629	0	102413
22600	96427	517	1774	760	0	99478
22601	2165	352	1002	99468	0	102987
22602	1232	316	412	96436	0	98396
22603	705	291	346	98230	0	99572
22604	553	318	94640	3123	0	98634
22605	492	95183	1894	1689	0	99258
22606	95654	1644	1018	1176	0	99492
22607	1932	920	633	96358	0	99843
22608	1105	97760	525	2487	0	101877
22609	667	1894	622	101726	0	104909
22610	803	1185	100514	2410	0	104912
22611	924	632	1954	101605	0	105115
22612	736	574	1200	104653	0	107163
22613	679	497	514	105796	0	107486
22614	103434	471	407	3681	0	107993
22615	2247	437	446	105112	0	108242
22616	1351	405	103147	3236	0	108139
22617	740	102572	2099	2250	0	107661
22618	923	1998	1137	104219	0	108277
22619	1006	1233	732	104606	0	107577
22620	694	797	103357	3400	0	108248
22621	725	610	100264	1899	0	103498
22622	98662	806	3332	1421	0	104221
22623	98922	801	1598	1387	0	102708
22624	3308	99325	1181	1082	0	104896
22625	100947	2256	697	1094	0	104994
22626	2814	1479	99924	1144	0	105361
22627	1757	710	98577	1401	0	102445
22628	97947	686	3179	1998	0	103810
22629	97400	465	1398	2039	0	101302
22630	2873	478	94012	2071	0	99434
22631	92232	389	2093	1975	0	96689
22632	2517	531	93763	1613	0	98424
22633	92917	623	2314	1040	0	96894
22634	94153	1049	1341	959	0	97502
22635	3069	1216	896	86435	0	91616
22636	1548	96475	1027	2248	0	101298
22637	75159	3021	1055	1683	0	80918
22638	2013	1879	97369	1057	0	102318
22639	1648	98315	2356	1011	0	103330
22640	98961	2646	1332	1287	0	104226
22641	93439	1542	811	1492	0	97284
22642	3252	93758	1025	1455	0	99490
22643	2172	1971	1087	94823	0	100053
22644	1435	1219	93152	3078	0	98884
22645	1011	766	2435	94414	0	98626
22646	1062	937	92848	3285	0	98132
22647	945	813	2625	92935	0	97318
22648	983	864	1885	93411	0	97143
22649	1130	1145	91719	3291	0	97285
22650	1238	92071	2609	2214	0	98132
22651	1363	2257	1479	90234	0	95333
22652	1430	1662	67615	3097	0	73804
22653	90318	893	1831	2217	0	95259
22654	2623	604	1464	93753	0	98444
22655	1747	562	1094	95338	0	98741
22656	93058	629	1008	3793	0	98488
22657	2909	582	855	92675	0	97021
22658	2325	666	932	89554	0	93477
22659	1302	91846	1371	3091	0	97610
22660	1447	2099	1176	90296	0	95018
22661	1143	1590	89071	2840	0	94644
22662	1386	699	2319	85106	0	89510
22663	1257	87075	1844	2795	0	92971
22664	1085	89343	1689	1968	0	94085
22665	1388	2611	1260	89158	0	94417
22666	89567	1498	1036	2556	0	94657
22667	2812	1096	1148	89467	0	94523
22668	89664	1242	1134	2550	0	94590
22669	3152	734	1246	89353	0	94485
22670	89168	687	1543	2756	0	94154
22671	90805	797	1326	2227	0	95155
22672	3992	875	1103	88285	0	94255
22673	2730	2798	1524	84378	0	91430
22674	1757	83228	1613	3492	0	90090
22675	1749	86036	1351	2254	0	91390
22676	1765	2256	83926	1973	0	89920
22677	1533	81422	2021	1912	0	86888
22678	62585	1520	1845	1210	0	67160
22679	1665	659	833	61587	0	64744
22680	1002	59263	699	1470	0	62434
22681	61172	1002	523	1294	0	63991
22682	1534	679	516	61237	0	63966
22683	1306	358	576	59412	0	61652
22684	852	331	693	60747	0	62623
22685	771	511	731	60466	0	62479
22686	787	61581	702	1858	0	64928
22687	896	66138	575	1097	0	68706
22688	66862	1408	644	775	0	69689
22689	1813	67748	578	641	0	70780
22690	1157	1357	598	67786	0	70898
22691	1056	797	418	68758	0	71029
22692	994	478	379	69301	0	71152
22693	798	423	413	69854	0	71488
22694	68419	437	454	2121	0	71431
22695	70288	280	478	1114	0	72160
22696	2251	347	69073	685	0	72356
22697	1373	409	1470	69129	0	72381
22698	1021	348	70434	1721	0	73524
22699	888	307	1649	70183	0	73027
22700	800	445	919	71308	0	73472
22701	69737	348	461	2492	0	73038
22702	1856	372	506	70102	0	72836
22703	977	421	68744	1983	0	72125
22704	547	387	66599	1148	0	68681
22705	66540	298	1893	1022	0	69753
22706	1579	376	68742	820	0	71517
22707	854	302	1373	65406	0	67935
22708	450	287	66966	1725	0	69428
22709	347	607	1333	63885	0	66172
22710	238	64732	798	1647	0	67415
22711	362	1346	338	63717	0	65763
22712	193	63511	316	1477	0	65497
22713	198	64265	235	912	0	65610
22714	285	1648	185	62756	0	64874
22715	62238	638	165	1507	0	64548
22716	1049	62896	199	808	0	64952
22717	658	1122	106	62987	0	64873
22718	63100	573	116	1415	0	65204
22719	64107	268	109	933	0	65417
22720	65644	204	137	609	0	66594
22721	1783	189	116	64258	0	66346
22722	832	178	137	65531	0	66678
22723	65782	164	148	1869	0	67963
22724	66203	185	137	1054	0	67579
22725	67018	168	162	651	0	67999
22726	1793	173	166	65866	0	67998
22727	841	252	63000	1296	0	65389
22728	62137	137	1030	868	0	64172
22729	1273	170	529	63094	0	65066
22730	742	64621	351	1295	0	67009
22731	520	1264	182	63343	0	65309
22732	349	64100	224	1319	0	65992
22733	377	1080	166	65297	0	66920
22734	294	631	63575	1479	0	65979
22735	250	62981	1044	909	0	65184
22736	367	940	568	60182	0	62057
22737	326	501	239	60562	0	61628
22738	305	246	178	60598	0	61327
22739	60345	175	137	1727	0	62384
22740	1090	61093	253	951	0	63387
22741	704	1145	149	62473	0	64471
22742	63534	625	123	1481	0	65763
22743	64107	284	154	924	0	65469
22744	1853	210	138	64170	0	66371
22745	939	245	64115	1518	0	66817
22746	508	208	1241	62878	0	64835
22747	350	64156	735	1549	0	66790
22748	375	1263	280	65618	0	67536
22749	64672	635	184	1752	0	67243
22750	1503	276	183	68275	0	70237
22751	885	226	68763	1768	0	71642
22752	392	71813	1323	1110	0	74638
22753	72543	1428	702	702	0	75375
22754	1577	855	72367	547	0	75346
22755	72154	299	1494	579	0	74526
22756	1744	226	796	74680	0	77446
22757	1056	167	333	74628	0	76184
22758	450	75010	313	2263	0	78036
22759	77656	1448	228	1345	0	80677
22760	1770	768	256	78966	0	81760
22761	1171	303	234	80660	0	82368
22762	608	206	231	82642	0	83687
22763	423	280	80703	2686	0	84092
22764	470	205	1578	81472	0	83725
22765	82137	189	869	2184	0	85379
22766	84122	208	346	1415	0	86091
22767	2454	218	257	83412	0	86341
22768	1243	221	218	84887	0	86569
22769	83376	228	199	2686	0	86489
22770	1793	361	82305	1310	0	85769
22771	81073	214	1588	881	0	83756
22772	1955	332	81404	575	0	84266
22773	1102	352	81588	557	0	83599
22774	629	237	2212	80847	0	83925
22775	536	321	82861	1929	0	85647
22776	81415	230	1724	1272	0	84641
22777	1898	224	905	83872	0	86899
22778	1102	334	83909	1917	0	87262
22779	81002	200	1571	1354	0	84127
22780	84694	217	838	897	0	86646
22781	2494	338	85349	685	0	88866
22782	1484	585	1553	79116	0	82738
22783	685	86098	961	1782	0	89526
22784	87397	1429	433	1266	0	90525
22785	1956	899	88148	715	0	91718
22786	79498	563	1411	782	0	82254
22787	1583	83618	820	624	0	86645
22788	80427	997	516	574	0	82514
22789	80045	573	217	629	0	81464
22790	80246	218	280	695	0	81439
22791	1796	362	296	79848	0	82302
22792	925	80370	357	1346	0	82998
22793	608	1162	78753	970	0	81493
22794	449	81644	1200	577	0	83870
22795	633	1252	670	73245	0	75800
22796	439	78813	428	1120	0	80800
22797	388	80282	388	869	0	81927
22798	78121	1312	522	610	0	80565
22799	1281	773	77504	556	0	80114
22800	917	400	78763	528	0	80608
22801	640	366	78496	522	0	80024
22802	556	79896	1390	543	0	82385
22803	79923	893	800	779	0	82395
22804	80088	556	346	718	0	81708
22805	79772	296	285	740	0	81093
22806	1551	78991	372	688	0	81602
22807	870	894	289	81029	0	83082
22808	658	628	79982	1327	0	82595
22809	576	420	79042	994	0	81032
22810	81498	202	1345	907	0	83952
22811	84603	241	699	835	0	86378
22812	84995	184	451	758	0	86388
22813	1761	292	82881	735	0	85669
22814	82520	189	1075	829	0	84613
22815	1492	220	724	84131	0	86567
22816	1077	200	520	84157	0	85954
22817	797	354	85899	1705	0	88755
22818	714	86528	1276	1130	0	89648
22819	685	884	841	87546	0	89956
22820	647	682	85992	1463	0	88784
22821	79776	234	1329	1269	0	82608
22822	1474	202	951	87139	0	89766
22823	1142	164	593	87315	0	89214
22824	86105	157	599	1879	0	88740
22825	1617	177	512	86706	0	89012
22826	86589	196	478	1659	0	88922
22827	86693	187	579	1263	0	88722
22828	1984	226	571	86329	0	89110
22829	1336	240	622	87118	0	89316
22830	85275	249	612	1849	0	87985
22831	1637	224	634	86609	0	89104
22832	87360	244	691	1493	0	89788
22833	87430	256	589	1090	0	89365
22834	87039	258	586	777	0	88660
22835	2264	229	541	85301	0	88335
22836	1400	303	541	85667	0	87911
22837	85403	230	535	1640	0	87808
22838	1472	83835	637	879	0	86823
22839	946	82274	503	391	0	84114
22840	81712	917	556	509	0	83694
22841	1114	600	81002	360	0	83076
22842	78476	266	832	378	0	79952
22843	1088	194	587	82203	0	84072
22844	731	299	82943	740	0	84713
22845	82000	191	770	581	0	83542
22846	1065	213	432	84589	0	86299
22847	856	211	245	87011	0	88323
22848	643	180	240	88924	0	89987
22849	625	250	153	89176	0	90204
22850	85829	216	173	1059	0	87277
22851	728	83799	311	542	0	85380
22852	78715	403	221	371	0	79710
22853	575	445	78994	147	0	80161
22854	495	243	76408	129	0	77275
22855	333	80782	503	163	0	81781
22856	519	578	490	79990	0	81577
22857	229	349	79734	376	0	80688
22858	163	74335	335	460	0	75293
22859	132	272	75330	160	0	75894
22860	106	138	180	73975	0	74399
22861	71	41	91	74554	0	74757
22862	74577	29	36	378	0	75020
22863	201	29	41	73744	0	74015
22864	73161	28	60	329	0	73578
22865	210	118	73250	140	0	73718
22866	105	73124	212	114	0	73555
22867	177	158	76	76734	0	77145
22868	164	131	62	82078	0	82435
22869	114	154	83292	229	0	83789
22870	110	168	77828	136	0	78242
22871	76268	32	247	239	0	76786
22872	84404	28	99	263	0	84794
22873	267	43	39	84152	0	84501
22874	180	27	44	83901	0	84152
22875	58	82721	95	300	0	83174
22876	110	188	55	85386	0	85739
22877	86089	110	42	409	0	86650
22878	86495	49	33	382	0	86959
22879	363	88109	135	153	0	88760
22880	89031	305	24	261	0	89621
22881	87234	182	51	241	0	87708
22882	581	56	37	91918	0	92592
22883	262	93600	134	528	0	94524
22884	157	494	41	95181	0	95873
22885	147	312	29	94731	0	95219
22886	121	226	92399	872	0	93618
22887	91727	57	583	550	0	92917
22888	887	67	324	102966	0	104244
22889	573	63	100	108415	0	109151
22890	153	121599	177	1737	0	123666
22891	229	1714	69	128003	0	130015
22892	128879	857	108	2309	0	132153
22893	134928	254	90	1306	0	136578
22894	3285	314	133937	396	0	137932
22895	1452	277	133809	296	0	135834
22896	591	98	3259	136173	0	140121
22897	452	76	1313	142616	0	144457
22898	329	190	140963	3561	0	145043
22899	289	208	141455	1543	0	143495
22900	363	95	3612	134899	0	138969
22901	257	236	142970	2702	0	146165
22902	314	288	142652	1414	0	144668
22903	364	80	3758	137339	0	141541
22904	142970	81	1582	2874	0	147507
22905	146760	95	603	1687	0	149145
22906	3822	117	399	144712	0	149050
22907	1719	117	278	147338	0	149452
22908	144779	90	264	4052	0	149185
22909	2938	113	237	143223	0	146511
22910	142160	120	233	3253	0	145766
22911	142349	132	234	1914	0	144629
22912	4059	178	199	141939	0	146375
22913	1931	182	218	144201	0	146532
22914	140073	165	240	4244	0	144722
22915	2888	139290	452	2068	0	144698
22916	1688	142248	560	987	0	145483
22917	920	3564	386	138576	0	143446
22918	614	1650	137442	3163	0	142869
22919	691	496	2735	137519	0	141441
22920	137517	331	1590	3487	0	142925
22921	2871	280	699	138462	0	142312
22922	138534	243	548	3495	0	142820
22923	3061	350	137428	2061	0	142900
22924	134942	206	2877	1213	0	139238
22925	3284	198	1622	138114	0	143218
22926	2064	189	666	141721	0	144640
22927	1076	355	143544	4402	0	149377
22928	1058	167	2803	143527	0	147555
22929	901	165	1662	147314	0	150042
22930	937	212	739	150772	0	152660
22931	145913	245	605	5058	0	151821
22932	3117	470	146670	2648	0	152905
22933	2068	441	145045	1447	0	149001
22934	141873	214	4039	1517	0	147643
22935	147289	207	2058	1483	0	151037
22936	4541	423	148357	1196	0	154517
22937	2516	337	3267	141878	0	147998
22938	1166	148414	2242	3343	0	155165
22939	1355	2580	1146	152673	0	157754
22940	151857	1340	1135	4092	0	158424
22941	154028	442	1151	2721	0	158342
22942	4559	363	1158	150941	0	157021
22943	2266	151240	1363	4002	0	158871
22944	1622	2553	1078	146068	0	151321
22945	1330	151038	1234	3684	0	157286
22946	151516	2741	1029	2839	0	158125
22947	147941	1478	1026	2014	0	152459
22948	147698	554	993	2017	0	151262
22949	4617	141921	1163	1995	0	149696
22950	2553	147661	1131	1983	0	153328
22951	1885	3823	824	148495	0	155027
22952	1788	1590	792	150500	0	154670
22953	1763	609	851	150361	0	153584
22954	1743	440	817	152506	0	155506
22955	1575	647	145253	5545	0	153020
22956	137280	485	3119	3562	0	144446
22957	3996	685	148715	2158	0	155554
22958	147155	547	3395	2172	0	153269
22959	4181	724	152184	1943	0	159032
22960	149977	504	3592	2231	0	156304
22961	4183	672	154842	2065	0	161762
22962	149599	457	3602	1955	0	155613
22963	4509	443	2315	155415	0	162682
22964	158751	450	1288	4611	0	165100
22965	4525	481	1084	162104	0	168194
22966	3204	425	1019	163537	0	168185
22967	2030	465	1065	157703	0	161263
22968	1622	151068	1230	5684	0	159604
22969	150575	2878	914	3541	0	157908
22970	150728	1649	856	2489	0	155722
22971	5079	151610	1152	2179	0	160020
22972	3081	2992	776	152868	0	159717
22973	1862	1942	150139	4441	0	158384
22974	146451	722	3259	3312	0	153744
22975	153254	545	2113	2225	0	158137
22976	151937	500	1165	2050	0	155652
22977	5611	463	1017	143894	0	150985
22978	3058	143634	1160	3730	0	151582
22979	2121	2816	987	144900	0	150824
22980	143852	1604	942	4073	0	150471
22981	4258	756	916	138432	0	144362
22982	2437	136412	1124	3578	0	143551
22983	131700	2601	869	2577	0	137747
22984	3710	1735	132316	1473	0	139234
22985	2914	933	130678	1420	0	135945
22986	1555	130805	3831	1321	0	137512
22987	1270	128207	1875	1128	0	132480
22988	2195	3181	119544	1064	0	125984
22989	1690	1758	111651	882	0	115981
22990	1593	3963	2295	91178	0	99029
22991	95192	288	1074	1401	0	97955
22992	1303	387	95195	781	0	97666
22993	659	89989	837	399	0	91884
22994	91185	693	717	553	0	93148
22995	816	90745	276	364	0	92201
22996	87030	552	142	338	0	88062
22997	648	86466	204	208	0	87526
22998	444	88298	196	213	0	89151
22999	377	783	256	88868	0	90284
23000	351	400	256	89274	0	90281
23001	269	323	85183	667	0	86442
23002	274	155	436	83512	0	84377
23003	84544	144	266	720	0	85674
23004	84906	120	138	601	0	85765
23005	735	163	98	83330	0	84326
23006	491	255	81819	543	0	83108
23007	280	222	80929	401	0	81832
23008	260	116	694	82483	0	83553
23009	252	267	84172	544	0	85235
23010	263	130	585	83098	0	84076
23011	251	135	417	82694	0	83497
23012	215	269	91478	830	0	92792
23013	84786	131	880	672	0	86469
23014	91859	143	612	412	0	93026
23015	1274	254	92801	204	0	94533
23016	696	283	94967	207	0	96153
23017	385	123	1624	94586	0	96718
23018	327	128	721	110355	0	111531
23019	306	136	275	113788	0	114505
23020	356	197	210	114337	0	115100
23021	113661	144	215	2411	0	116431
23022	121982	141	176	1175	0	123474
23023	2617	136	208	130804	0	133765
23024	1306	137	185	138778	0	140406
23025	441	275	147026	3501	0	151243
23026	441	138	2685	150378	0	153642
23027	446	102	1499	156986	0	159033
23028	158338	119	414	5040	0	163911
23029	3490	168292	361	2325	0	174468
23030	2056	3621	236	168590	0	174503
23031	757	1828	232	171463	0	174280
23032	464	451	277	168033	0	169225
23033	321	153426	466	6121	0	160334
23034	276	167194	420	2742	0	170632
23035	519	5228	285	165458	0	171490
23036	540	2156	242	165851	0	168789
23037	498	556	235	169315	0	170604
23038	158964	308	260	6537	0	166069
23039	3780	160758	446	3049	0	168033
23040	163451	3880	253	1274	0	168858
23041	165440	2090	245	1038	0	168813
23042	5966	618	252	158507	0	165343
23043	2457	157434	436	4525	0	164852
23044	158438	3996	221	2747	0	165402
23045	4431	2193	203	158836	0	165663
23046	160644	739	303	4943	0	166629
23047	4691	473	288	163026	0	168478
23048	2486	569	161411	5019	0	169485
23049	1008	572	165266	3003	0	169849
23050	869	457	5641	163637	0	170604
23051	906	495	2370	167598	0	171369
23052	876	492	639	163462	0	165469
23053	717	157724	557	6666	0	165664
23054	718	168357	553	3362	0	172990
23055	163487	5629	416	1721	0	171253
23056	161326	2508	416	1536	0	165786
23057	5676	159979	494	1460	0	167609
23058	2387	158071	382	1399	0	162239
23059	909	165144	375	1429	0	167857
23060	156216	5816	332	1454	0	163818
23061	3929	158618	424	1470	0	164441
23062	2604	4306	313	158828	0	166051
23063	158840	2303	293	4707	0	166143
23064	159444	902	324	3018	0	163688
23065	6148	758	331	153358	0	160595
23066	2859	886	150502	4742	0	158989
23067	1232	891	152415	2955	0	157493
23068	1239	732	5417	151971	0	159359
23069	1050	893	156466	4924	0	163333
23070	1280	671	4176	155707	0	161834
23071	1257	677	2222	156816	0	160972
23072	1018	832	154635	6623	0	163108
23073	1080	782	156261	3381	0	161504
23074	1168	706	5813	153903	0	161590
23075	1218	713	2544	161448	0	165923
23076	155624	773	994	7056	0	164447
23077	4302	153577	922	3955	0	162756
23078	2563	161981	867	2417	0	167828
23079	157415	5858	686	2204	0	166163
23080	160981	2796	657	2184	0	166618
23081	6126	156330	796	2244	0	165496
23082	3073	161523	785	2190	0	167571
23083	159649	6040	596	2242	0	168527
23084	4940	2915	566	159136	0	167557
23085	157506	1356	686	5753	0	165301
23086	4922	156542	853	4500	0	166817
23087	159224	4420	592	2761	0	166997
23088	5246	2894	156687	2342	0	167169
23089	154815	1256	4111	2570	0	162752
23090	5334	1287	158152	2374	0	167147
23091	3401	1189	4498	156244	0	165332
23092	155022	1056	2513	6131	0	164722
23093	4909	1207	151977	4310	0	162403
23094	3285	1173	4275	153580	0	162313
23095	152166	1261	2583	5962	0	161972
23096	5086	1510	152319	4283	0	163198
23097	3394	1340	4185	154592	0	163511
23098	151695	1251	2404	6089	0	161439
23099	4793	151041	1215	4372	0	161421
23100	3424	4872	771	154740	0	163807
23101	2150	3146	764	155336	0	161396
23102	2021	1720	672	156107	0	160520
23103	1740	154781	1002	7494	0	165017
23104	2142	5115	701	161142	0	169100
23105	2314	2967	726	163801	0	169808
23106	2405	1689	765	164455	0	169314
23107	2595	1371	743	168116	0	172825
23108	2267	1590	160810	7529	0	172196
23109	151786	1368	4432	4258	0	161844
23110	161648	1198	2619	2518	0	167983
23111	7098	159905	1389	2231	0	170623
23112	3665	4323	969	153976	0	162933
23113	2107	2571	943	155019	0	160640
23114	1705	153143	1344	6867	0	163059
23115	1641	3908	1270	154278	0	161097
23116	146959	2245	1247	5471	0	155922
23117	3984	144167	1478	3679	0	153308
23118	135888	3444	1071	1988	0	142391
23119	4007	1954	862	134235	0	141058
23120	2234	1100	132823	4532	0	140689
23121	1155	132961	3445	2944	0	140505
23122	121582	3312	2300	1739	0	128933
23123	2887	115420	768	1084	0	120159
23124	1640	113184	571	907	0	116302
23125	98870	2578	918	873	0	103239
23126	2131	1157	98626	672	0	102586
23127	888	91868	1499	553	0	94808
23128	80336	2080	3644	789	0	86849
23129	74417	514	340	395	0	75666
23130	962	74674	178	324	0	76138
23131	525	690	82	77270	0	78567
23132	252	520	79580	793	0	81145
23133	258	233	628	78931	0	80050
23134	289	161	362	78931	0	79743
23135	246	156	135	82808	0	83345
23136	229	252	82576	1102	0	84159
23137	278	190	613	79875	0	80956
23138	226	237	82129	831	0	83423
23139	209	226	77924	499	0	78858
23140	68382	170	876	504	0	69932
23141	634	80878	453	209	0	82174
23142	442	82340	215	208	0	83205
23143	401	994	180	84106	0	85681
23144	90470	488	103	1072	0	92133
23145	91256	218	121	640	0	92235
23146	90038	184	126	411	0	90759
23147	90353	190	111	329	0	90983
23148	86587	170	127	320	0	87204
23149	1234	272	84309	209	0	86024
23150	672	182	712	83337	0	84903
23151	258	82743	518	855	0	84374
23152	274	772	199	84579	0	85824
23153	85513	482	130	1080	0	87205
23154	796	84857	207	610	0	86470
23155	551	803	133	86882	0	88369
23156	87103	482	152	1022	0	88759
23157	89333	211	147	852	0	90543
23158	1259	175	171	89425	0	91030
23159	714	152	162	88232	0	89260
23160	359	150	138	89753	0	90400
23161	309	265	87646	1346	0	89566
23162	283	302	88461	721	0	89767
23163	312	189	1124	90367	0	91992
23164	364	170	546	91999	0	93079
23165	91313	164	237	1444	0	93158
23166	90924	181	181	888	0	92174
23167	92124	174	143	584	0	93025
23168	94102	192	139	561	0	94994
23169	91818	180	143	503	0	92644
23170	1378	93295	226	404	0	95303
23171	96706	819	156	604	0	98285
23172	97398	519	151	591	0	98659
23173	97419	260	183	471	0	98333
23174	1540	221	151	99860	0	101772
23175	804	296	98696	1234	0	101030
23176	542	201	1008	100589	0	102340
23177	478	396	107028	1343	0	109245
23178	519	220	1164	101332	0	103235
23179	360	106813	695	1186	0	109054
23180	107861	1147	190	853	0	110051
23181	110478	638	183	635	0	111934
23182	1903	213	178	111624	0	113918
23183	989	196	175	117700	0	119060
23184	512	184	140	117441	0	118277
23185	444	119494	250	1844	0	122032
23186	119236	1218	160	995	0	121609
23187	118899	654	150	587	0	120290
23188	1908	119639	282	426	0	122255
23189	976	1229	166	120742	0	123113
23190	563	680	136	117347	0	118726
23191	441	121038	273	1673	0	123425
23192	123050	1251	144	927	0	125372
23193	123166	641	172	610	0	124589
23194	2089	220	154	123331	0	125794
23195	1006	356	123631	1521	0	126514
23196	587	363	119415	901	0	121266
23197	552	183	1858	126609	0	129202
23198	585	186	774	127572	0	129117
23199	566	238	278	129544	0	130626
23200	127149	185	224	2480	0	130038
23201	127167	198	210	1274	0	128849
23202	2258	131590	342	720	0	134910
23203	131026	1454	463	751	0	133694
23204	1984	884	130290	460	0	133618
23205	1144	448	129024	477	0	131093
23206	544	135978	2158	565	0	139245
23207	131649	1541	1035	619	0	134844
23208	1418	132100	423	536	0	134477
23209	132078	1400	353	655	0	134486
23210	1729	864	131125	427	0	134145
23211	986	507	128696	405	0	130594
23212	670	244	1830	126836	0	129580
23213	591	426	134673	1631	0	137321
23214	613	205	1440	136243	0	138501
23215	614	333	784	123550	0	125281
23216	423	137978	386	2226	0	141013
23217	489	1431	295	140409	0	142624
23218	507	722	268	142826	0	144323
23219	147203	341	222	2536	0	150302
23220	1865	147496	395	1175	0	150931
23221	1163	1700	225	152245	0	155333
23222	683	973	151145	2120	0	154921
23223	132447	365	1925	1627	0	136364
23224	2201	507	151937	764	0	155409
23225	1291	320	1926	147106	0	150643
23226	570	157768	1117	2124	0	161579
23227	701	2208	402	156031	0	159342
23228	160565	1079	321	2608	0	164573
23229	159653	410	310	1617	0	161990
23230	3259	163794	437	718	0	168208
23231	168771	2257	362	1070	0	172460
23232	169372	1225	334	1103	0	172034
23233	171581	489	352	980	0	173402
23234	174255	384	331	876	0	175846
23235	159334	434	535	934	0	161237
23236	3262	587	167860	603	0	172312
23237	1693	385	2366	165934	0	170378
23238	974	425	1264	165578	0	168241
23239	803	396	503	166909	0	168611
23240	642	168806	620	3418	0	173486
23241	832	2289	398	168092	0	171611
23242	817	1403	167112	2632	0	171964
23243	589	163593	2312	1645	0	168139
23244	586	162623	1346	856	0	165411
23245	968	2951	561	162420	0	166900
23246	730	1254	480	163006	0	165470
23247	747	509	464	159449	0	161169
23248	567	156807	605	3419	0	161398
23249	608	160784	571	1753	0	163716
23250	159729	3009	422	1128	0	164288
23251	158843	1338	434	1005	0	161620
23252	3181	160580	657	833	0	165251
23253	163122	2264	498	1073	0	166957
23254	165683	1298	565	1252	0	168798
23255	3449	617	585	167668	0	172319
23256	1847	557	509	173968	0	176881
23257	1111	548	475	174531	0	176665
23258	1023	799	173561	3610	0	178993
23259	1149	785	171033	1797	0	174764
23260	938	181181	3483	1111	0	186713
23261	184089	2601	1522	1178	0	189390
23262	3219	1832	185145	861	0	191057
23263	178723	614	2900	1309	0	183546
23264	3541	830	193940	949	0	199260
23265	189328	611	3320	1262	0	194521
23266	3660	200475	2069	942	0	207146
23267	200438	3371	838	1260	0	205907
23268	3862	1883	689	199684	0	206118
23269	2387	786	661	203225	0	207059
23270	1338	1069	198166	5107	0	205680
23271	997	206295	3215	2825	0	213332
23272	1186	3739	1737	208458	0	215120
23273	1131	2217	206822	3737	0	213907
23274	181283	948	3263	2636	0	188130
23275	3321	203166	1997	1263	0	209747
23276	201062	3104	766	1308	0	206240
23277	3286	196030	772	1238	0	201326
23278	2239	3303	571	195493	0	201606
23279	193629	1827	598	3810	0	199864
23280	3166	195070	828	2291	0	201355
23281	2167	3257	531	195916	0	201871
23282	1124	2088	192125	3535	0	198872
23283	178105	822	2954	2273	0	184154
23284	3631	787	1490	190337	0	196245
23285	2236	953	187457	3372	0	194018
23286	1138	186558	2975	2550	0	193221
23287	1194	2944	1623	188040	0	193801
23288	1241	2050	187829	3336	0	194456
23289	1198	906	2992	179163	0	184259
23290	1017	187749	1932	3163	0	193861
23291	1021	192727	932	2150	0	196830
23292	1317	4179	189169	996	0	195661
23293	1244	1973	2861	186251	0	192329
23294	884	1068	191485	3259	0	196696
23295	183075	697	2947	2233	0	188952
23296	3438	862	1640	182571	0	188511
23297	1904	181216	816	2841	0	186777
23298	977	189140	709	1723	0	192549
23299	184777	3741	477	1202	0	190197
23300	2731	190805	726	917	0	195179
23301	190296	2845	596	1255	0	194992
23302	3050	1894	187557	794	0	193295
23303	175497	754	2566	1057	0	179874
23304	2810	184629	1671	782	0	189892
23305	184849	2731	721	994	0	189295
23306	2758	182011	685	772	0	186226
23307	1847	2857	503	179503	0	184710
23308	1003	1730	409	185737	0	188879
23309	743	1128	182715	3833	0	188419
23310	171017	739	2618	2299	0	176673
23311	2815	975	185313	913	0	190016
23312	184621	710	2822	921	0	189074
23313	3202	654	1649	184229	0	189734
23314	1950	642	672	184855	0	188119
23315	816	186927	845	4211	0	192799
23316	932	3102	609	191042	0	195685
23317	1068	1838	607	194367	0	197880
23318	786	994	189469	4523	0	195772
23319	166833	609	2881	2567	0	172890
23320	2888	181687	1945	947	0	187467
23321	180161	2601	621	1029	0	184412
23322	3057	1672	527	179645	0	184901
23323	1944	792	460	181738	0	184934
23324	177476	485	600	4236	0	182797
23325	2796	179967	724	2349	0	185836
23326	173991	2492	477	1022	0	177982
23327	2756	172470	651	683	0	176560
23328	1555	172857	622	606	0	175640
23329	171891	3478	700	826	0	176895
23330	2962	1655	596	167805	0	173018
23331	1757	934	166759	2565	0	172015
23332	976	630	2425	163579	0	167610
23333	792	605	1410	162944	0	165751
23334	642	164264	748	3763	0	169417
23335	753	2702	359	168040	0	171854
23336	732	1632	409	168569	0	171342
23337	763	708	416	171111	0	172998
23338	687	611	381	174666	0	176345
23339	592	818	169835	4552	0	175797
23340	612	868	172550	2233	0	176263
23341	789	595	3954	175303	0	180641
23342	720	718	176931	3564	0	181933
23343	799	786	174999	2135	0	178719
23344	872	640	4305	174616	0	180433
23345	788	850	181502	3658	0	186798
23346	934	747	3330	169148	0	174159
23347	613	182024	2024	3369	0	188030
23348	191845	3231	798	2393	0	198267
23349	3818	2169	211117	1226	0	218330
23350	2445	806	4176	210113	0	217540
23351	1022	796	218185	4636	0	224639
23352	940	630	4524	228430	0	234524
23353	998	675	2547	235319	0	239539
23354	229885	580	1074	7684	0	239223
23355	5189	660	829	234256	0	240934
23356	223269	568	787	6123	0	230747
23357	226365	508	747	3833	0	231453
23358	6990	222728	982	1827	0	232527
23359	220025	4660	676	1585	0	226946
23360	5094	214357	941	1399	0	221791
23361	2756	219485	973	1340	0	224554
23362	212530	6629	1194	1401	0	221754
23363	5051	3014	212391	1218	0	221674
23364	2816	1082	207596	928	0	212422
23365	197851	847	7090	1193	0	206981
23366	203344	689	2881	1245	0	208159
23367	6123	202877	1271	966	0	211237
23368	207871	4097	809	1294	0	214071
23369	209036	2434	869	1305	0	213644
23370	204904	790	810	1209	0	207713
23371	6947	578	739	198275	0	206539
23372	196146	616	723	4960	0	202445
23373	4961	200587	968	3018	0	209534
23374	3404	4117	691	205759	0	213971
23375	2018	2396	719	206483	0	211616
23376	1468	205516	1152	6589	0	214725
23377	1589	4264	851	209559	0	216263
23378	204421	2675	968	5564	0	213628
23379	208248	1097	874	3842	0	214061
23380	6676	200380	1080	2147	0	210283
23381	3610	207005	1025	1804	0	213444
23382	205867	6032	732	1867	0	214498
23383	5550	3244	202208	1660	0	212662
23384	4021	1390	203304	1577	0	210292
23385	2669	1189	6215	198039	0	208112
23386	2364	1285	3015	205216	0	211880
23387	2345	1476	201090	6662	0	211573
23388	2263	194215	4720	3686	0	204884
23389	2509	5069	2979	186098	0	196655
23390	2312	3385	198652	4937	0	209286
23391	2422	1438	4788	196919	0	205567
23392	2297	1291	3326	194118	0	201032
23393	1969	202709	1871	6602	0	213151
23394	2477	4882	1150	202421	0	210930
23395	2439	3166	1212	205480	0	212297
23396	2428	1604	1248	208390	0	213670
23397	203311	1182	988	7644	0	213125
23398	6275	1339	884	196063	0	204561
23399	4223	201031	1148	5494	0	211896
23400	199727	4700	1038	4059	0	209524
23401	6034	3468	194855	2240	0	206597
23402	4112	1866	194194	2322	0	202494
23403	190601	1368	6542	2544	0	201055
23404	5909	1480	3323	196749	0	207461
23405	4048	1733	197318	5673	0	208772
23406	2688	1309	4845	197225	0	206067
23407	2599	1276	3294	202643	0	209812
23408	198176	1446	1611	7885	0	209118
23409	198402	1546	1424	4658	0	206030
23410	7579	197412	1778	2858	0	209627
23411	4632	4671	1476	195568	0	206347
23412	2718	3355	196387	5699	0	208159
23413	2083	202688	5061	4354	0	214186
23414	201451	4723	3115	3193	0	212482
23415	5288	209098	1947	2500	0	218833
23416	209263	5082	1487	2481	0	218313
23417	5700	3559	206943	2277	0	218479
23418	204806	1849	4800	2582	0	214037
23419	215164	1518	3273	2467	0	222422
23420	7756	1861	215776	2175	0	227568
23421	4332	1903	5098	205310	0	216643
23422	2406	212564	3657	5676	0	224303
23423	2268	220634	1859	4271	0	229032
23424	2164	224942	1588	2758	0	231452
23425	2926	7509	1232	216226	0	227893
23426	2599	3846	219704	5752	0	231901
23427	2498	1948	4710	218136	0	227292
23428	2660	1647	3043	225088	0	232438
23429	2447	1647	220877	7628	0	232599
23430	2031	219988	5473	4374	0	231866
23431	2243	5064	3258	216813	0	227378
23432	218728	3102	1619	6092	0	229541
23433	5469	1592	1536	219571	0	228168
23434	3949	1331	1485	216281	0	223046
23435	2269	214796	1441	7875	0	226381
23436	216161	4884	1017	4609	0	226671
23437	6159	3320	1130	220119	0	230728
23438	4171	1975	216614	5641	0	228401
23439	2144	215967	4794	4243	0	227148
23440	211757	4625	3173	2493	0	222048
23441	5085	3627	213479	1759	0	223950
23442	207291	1932	4597	1959	0	215779
23443	5351	1586	3073	205205	0	215215
23444	3306	212235	2073	4581	0	222195
23445	209675	4487	1593	3461	0	219216
23446	207933	3089	1441	2350	0	214813
23447	6311	210782	1714	1802	0	220609
23448	3693	3809	1245	199447	0	208194
23449	1598	2096	880	187816	0	192390
23450	180417	911	937	4846	0	187111
23451	3249	180659	1072	2715	0	187695
23452	1858	2750	584	166265	0	171457
23453	736	163997	626	2557	0	167916
23454	575	163841	616	1786	0	166818
23455	861	2813	547	160021	0	164242
23456	157903	1334	491	2413	0	162141
23457	1818	159587	547	1523	0	163475
23458	1378	1861	395	159291	0	162925
23459	765	1225	450	160495	0	162935
23460	677	825	157299	2776	0	161577
23461	774	681	150447	1569	0	153471
23462	584	155772	2537	986	0	159879
23463	758	2002	152257	713	0	155730
23464	775	1375	1761	150862	0	154773
23465	723	858	154349	1924	0	157854
23466	696	641	1753	154678	0	157768
23467	805	630	1074	158407	0	160916
23468	723	601	500	159366	0	161190
23469	154973	575	413	3143	0	159104
23470	1975	617	417	155469	0	158478
23471	1460	624	375	154219	0	156678
23472	700	153595	481	2798	0	157574
23473	723	1904	375	150161	0	153163
23474	147062	1348	323	2595	0	151328
23475	1796	150985	460	1677	0	154918
23476	151490	1997	353	1366	0	155206
23477	2161	1575	150497	926	0	155159
23478	1432	1025	152587	893	0	155937
23479	891	777	2518	156447	0	160633
23480	792	769	1345	159367	0	162273
23481	635	160196	841	3121	0	164793
23482	828	2273	630	155542	0	159273
23483	158965	1460	650	2839	0	163914
23484	156847	830	600	2086	0	160363
23485	3076	738	579	161541	0	165934
23486	1591	1040	170560	2788	0	175979
23487	952	699	2170	173251	0	177072
23488	869	741	1444	179368	0	182422
23489	769	737	707	181820	0	184033
23490	663	672	659	179555	0	181549
23491	680	725	558	174969	0	176932
23492	505	176194	794	4193	0	181686
23493	172030	2438	570	2769	0	177807
23494	174294	1586	582	1931	0	178393
23495	175859	764	619	1771	0	179013
23496	3565	178446	765	1471	0	184247
23497	175761	2603	519	1690	0	180573
23498	2725	177202	737	1477	0	182141
23499	1898	3034	174733	1292	0	180957
23500	1185	1782	2410	170199	0	175576
23501	1067	1060	177843	3212	0	183182
23502	803	178615	2817	2531	0	184766
23503	176604	2771	1627	1747	0	182749
23504	2906	2056	180995	1296	0	187253
23505	2138	1150	190078	1311	0	194677
23506	1072	195988	4491	1393	0	202944
23507	1264	3229	2358	197803	0	204654
23508	1154	2485	210303	3856	0	217798
23509	1183	1004	3429	205810	0	211426
23510	1119	704	2281	230190	0	234294
23511	1164	630	884	243027	0	245705
23512	244886	586	573	7268	0	253313
23513	243481	627	543	3995	0	248646
23514	6944	659	485	240983	0	249071
23515	238708	506	603	5513	0	245330
23516	5078	692	232291	3379	0	241440
23517	2922	691	229515	1535	0	234663
23518	1641	580	232536	1253	0	236010
23519	1235	597	233776	1199	0	236807
23520	898	227370	5931	1235	0	235434
23521	1889	3771	3575	220635	0	229870
23522	948	2248	228492	3736	0	235424
23523	209223	731	4199	2673	0	216826
23524	225198	429	2540	1347	0	229514
23525	5251	224774	1652	967	0	232644
23526	224739	3558	1123	1007	0	230427
23527	4360	2070	1073	223168	0	230671
23528	2626	1139	227422	3927	0	235114
23529	1507	778	4073	212105	0	218463
23530	872	231640	2749	3837	0	239098
23531	226718	3760	1128	2820	0	234426
23532	231057	2164	833	1605	0	235659
23533	5549	232371	1011	1279	0	240210
23534	235632	3786	749	1362	0	241529
23535	233738	2278	722	1460	0	238198
23536	5996	234871	985	1262	0	243114
23537	3468	3939	738	224720	0	232865
23538	1440	230777	1004	4148	0	237369
23539	231876	4283	865	2910	0	239934
23540	4760	2781	897	231054	0	239492
23541	231736	1140	1053	4677	0	238606
23542	5142	921	805	231567	0	238435
23543	3233	1235	227712	4629	0	236809
23544	220668	948	4117	3175	0	228908
23545	4999	1113	228790	1508	0	236410
23546	3527	814	4472	225285	0	234098
23547	1887	1115	225278	4572	0	232852
23548	1813	833	4526	223911	0	231083
23549	1566	1129	224888	4986	0	232569
23550	213660	705	4794	3498	0	222657
23551	4529	222222	3332	1804	0	231887
23552	223863	3950	1577	1641	0	231031
23553	5207	2491	1430	220881	0	230009
23554	217884	1075	1415	4854	0	225228
23555	4770	217713	1627	3155	0	227265
23556	3099	217619	1505	1760	0	223983
23557	1785	226895	1517	1437	0	231634
23558	225489	5921	1170	1846	0	234426
23559	5046	3060	1093	224777	0	233976
23560	3626	1461	972	229006	0	235065
23561	2129	1569	222953	6516	0	233167
23562	2081	1606	222519	3397	0	229603
23563	2271	1287	5809	224613	0	233980
23564	2065	1439	230177	4942	0	238623
23565	1669	226504	5087	3491	0	236751
23566	223994	4420	3406	2309	0	234129
23567	5027	3066	227577	1705	0	237375
23568	3465	1553	227728	1686	0	234432
23569	2126	1070	6821	222113	0	232130
23570	228056	879	3753	5339	0	238027
23571	5241	901	2100	229540	0	237782
23572	228457	911	1944	5632	0	236944
23573	5632	1009	1866	229181	0	237688
23574	3727	1268	230646	5118	0	240759
23575	2045	225544	5549	3558	0	236696
23576	2093	4581	230995	2053	0	239722
23577	1678	230508	5570	2080	0	239836
23578	2181	5165	3463	223034	0	233843
23579	221890	2598	1728	5281	0	231497
23580	5064	1650	222735	3408	0	232857
23581	3821	1106	4499	220717	0	230143
23582	2481	1074	2960	228187	0	234702
23583	229113	1132	1608	6719	0	238572
23584	5159	1299	1593	221222	0	229273
23585	3165	228436	1920	4708	0	238229
23586	218584	4394	1570	3392	0	227940
23587	4817	3088	216250	1896	0	226051
23588	206893	1452	4394	1824	0	214563
23589	4938	214610	2995	1554	0	224097
23590	3754	4593	1337	200360	0	210044
23591	1957	217526	1464	4233	0	225180
23592	214754	4304	1194	3105	0	223357
23593	4969	2997	215056	1817	0	224839
23594	207723	1611	4297	1942	0	215573
23595	4763	216929	2866	1640	0	226198
23596	3375	4028	1351	216898	0	225652
23597	219739	2513	1228	4719	0	228199
23598	222485	1263	1320	3117	0	228185
23599	6347	1116	1164	220956	0	229583
23600	3575	1189	1124	222180	0	228068
23601	1928	220705	1478	6005	0	230116
23602	1990	4707	1064	219388	0	227149
23603	1551	253280	1456	4788	0	261075
23604	1447	263502	1455	3365	0	269769
23605	1902	8682	991	231961	0	243536
23606	1336	242939	1191	4906	0	250372
23607	1801	4888	248015	2645	0	257349
23608	2298	2734	249114	1641	0	255787
23609	1145	245487	6779	2270	0	255681
23610	1322	4418	240646	960	0	247346
23611	1104	2570	237638	801	0	242113
23612	847	987	227954	609	0	230397
23613	484	223698	6159	688	0	231029
23614	217022	4124	3671	927	0	225744
23615	3541	217763	1149	711	0	223164
23616	2250	4324	218244	429	0	225247
23617	1035	2157	3911	213290	0	220393
23618	214721	829	2156	4070	0	221776
23619	3941	764	214421	2086	0	221212
23620	2351	471	4092	211995	0	218909
23621	960	677	217336	3938	0	222911
23622	813	475	4380	212083	0	217751
23623	209919	491	2403	4631	0	217444
23624	4048	706	215831	2305	0	222890
23625	2130	218506	4297	1200	0	226133
23626	1313	4135	2272	210626	0	218346
23627	222283	2261	1009	4285	0	229838
23628	4360	1295	219497	2205	0	227357
23629	2771	993	4444	200103	0	208311
23630	964	217405	2769	3753	0	224891
23631	220994	4227	1226	2395	0	228842
23632	226323	2327	1000	1283	0	230933
23633	6511	1157	899	219194	0	227761
23634	2928	227586	1227	4441	0	236182
23635	1133	235682	1066	2602	0	240483
23636	237662	6637	808	1375	0	246482
23637	5344	3312	861	228473	0	237990
23638	2726	239861	1082	4911	0	248580
23639	236647	5225	822	2944	0	245638
23640	5303	2883	829	240641	0	249656
23641	2978	1188	974	244634	0	249774
23642	1284	1106	228082	7461	0	237933
23643	822	238998	4845	3645	0	248310
23644	847	250654	2999	1518	0	256018
23645	1193	7268	1199	246340	0	256000
23646	246159	3392	910	5643	0	256104
23647	5173	247810	1180	3213	0	257376
23648	247844	5484	823	1711	0	255862
23649	5802	247796	1206	1169	0	255973
23650	3460	5893	949	247485	0	257787
23651	248625	3230	800	5755	0	258410
23652	6016	1576	829	250158	0	258579
23653	3424	1568	249114	6021	0	260127
23654	1943	1185	5379	239588	0	248095
23655	1127	247281	3430	5858	0	257696
23656	245050	5866	1301	3528	0	255745
23657	5524	247449	1353	1671	0	255997
23658	3682	6058	1026	238704	0	249470
23659	2070	3586	965	247337	0	253958
23660	1351	2141	240411	7883	0	251786
23661	1363	1723	241558	3837	0	248481
23662	1648	1670	7521	237423	0	248262
23663	1380	1699	238657	6091	0	247827
23664	1091	235528	6238	3771	0	246628
23665	235653	5874	3282	2210	0	247019
23666	5695	3825	241664	1518	0	252702
23667	235305	2001	5512	1915	0	244733
23668	245159	1583	3337	1728	0	251807
23669	245483	1636	1753	1615	0	250487
23670	246441	1668	1296	1671	0	251076
23671	8551	1565	1320	239038	0	250474
23672	4368	1506	1357	234221	0	241452
23673	1991	236409	1837	7608	0	247845
23674	233396	5644	1638	4220	0	244898
23675	5808	3986	231618	2032	0	243444
23676	3928	2014	5562	226812	0	238316
23677	2327	1739	3578	231748	0	239392
23678	1848	1793	226457	7923	0	238021
23679	1672	227490	6081	4265	0	239508
23680	2153	5779	3505	214678	0	226115
23681	2293	3569	1760	232104	0	239726
23682	225209	1939	1538	8178	0	236864
23683	5580	224189	1769	4835	0	236373
23684	4142	5514	1292	219671	0	230619
23685	1995	223066	1852	6117	0	233030
23686	2228	5976	1363	226262	0	235829
23687	222994	3377	1310	6913	0	234594
23688	226215	1942	1305	4273	0	233735
23689	8475	1535	1232	222577	0	233819
23690	221877	1368	1188	6574	0	231007
23691	221177	1575	1213	4231	0	228196
23692	8077	218035	1434	2592	0	230138
23693	4971	5494	1005	210679	0	222149
23694	2527	217735	1584	5849	0	227695
23695	2547	6066	920	217677	0	227210
23696	214558	3614	882	6561	0	225615
23697	6418	2096	1028	214130	0	223672
23698	4486	1694	843	217080	0	224103
23699	2468	1947	209420	8355	0	222190
23700	2139	199667	5003	4535	0	211344
23701	2036	209973	2999	2613	0	217621
23702	201164	6790	1202	2963	0	212119
23703	4806	3255	736	167138	0	175935
23704	159626	1269	590	4254	0	165739
23705	3939	154937	833	3107	0	162816
23706	2358	147878	801	1780	0	152817
23707	1234	153050	753	1541	0	156578
23708	137205	3908	1995	1562	0	144670
23709	2683	139775	732	1136	0	144326
23710	138409	2476	1594	1384	0	143863
23711	135957	1344	367	1190	0	138858
23712	140127	660	341	1089	0	142217
23713	3503	657	335	145303	0	149798
23714	1871	601	330	149289	0	152091
23715	1117	542	353	150658	0	152670
23716	1016	570	332	150521	0	152439
23717	146970	492	302	4330	0	152094
23718	2994	144988	554	2042	0	150578
23719	1808	2539	324	145314	0	149985
23720	145414	1299	347	3229	0	150289
23721	2992	601	315	144153	0	148061
23722	1842	491	295	145369	0	147997
23723	141280	509	313	4083	0	146185
23724	2924	683	137913	1968	0	143488
23725	1764	512	2222	136219	0	140717
23726	874	688	138660	2899	0	143121
23727	868	502	2254	134356	0	137980
23728	867	752	1125	134981	0	137725
23729	130583	373	366	3718	0	135040
23730	2414	127984	497	1728	0	132623
23731	1262	126078	351	843	0	128534
23732	120730	2338	190	764	0	124022
23733	1891	122623	297	625	0	125436
23734	123098	1575	486	1001	0	126160
23735	2059	921	120835	528	0	124343
23736	111993	257	1175	608	0	114033
23737	115331	166	512	559	0	116568
23738	115780	156	152	532	0	116620
23739	1871	160	123	111956	0	114110
23740	871	173	83	112679	0	113806
23741	293	112368	240	1691	0	114592
23742	422	1554	119	111633	0	113728
23743	109555	540	100	1551	0	111746
23744	1173	108182	207	766	0	110328
23745	534	108148	160	352	0	109194
23746	106634	1333	90	489	0	108546
23747	1203	730	105808	220	0	107961
23748	703	212	971	104433	0	106319
23749	333	348	107224	1169	0	109074
23750	308	110	1017	104036	0	105471
23751	210	106893	581	1074	0	108758
23752	299	1123	120	109009	0	110551
23753	106648	495	86	1355	0	108584
23754	1230	192	95	107383	0	108900
23755	626	291	109511	1240	0	111668
23756	99134	149	1118	906	0	101307
23757	1237	109498	695	390	0	111820
23758	697	116705	295	352	0	118049
23759	121004	1687	114	640	0	123445
23760	126770	746	153	521	0	128190
23761	2302	489	126654	300	0	129745
23762	120927	172	1546	499	0	123144
23763	1784	127440	876	307	0	130407
23764	129449	1606	216	541	0	131812
23765	1953	858	151	122467	0	125429
23766	980	117481	245	1590	0	120296
23767	119161	1652	125	1211	0	122149
23768	1945	1073	118531	377	0	121926
23769	1156	310	1553	119134	0	122153
23770	122329	237	783	2136	0	125485
23771	1952	401	121925	1069	0	125347
23772	122093	219	1685	756	0	124753
23773	2086	261	814	121913	0	125074
23774	1193	223	287	125011	0	126714
23775	630	437	125546	2570	0	129183
23776	558	229	1700	125146	0	127633
23777	126715	209	896	2417	0	130237
23778	1875	124768	490	1295	0	128428
23779	126559	1750	243	853	0	129405
23780	127218	947	225	805	0	129195
23781	2835	388	204	126197	0	129624
23782	1466	548	128163	2082	0	132259
23783	774	289	1833	128760	0	131656
23784	129670	244	972	2504	0	133390
23785	2061	128721	533	1322	0	132637
23786	133027	1825	306	874	0	136032
23787	2447	1037	195	132169	0	135848
23788	1434	444	225	135369	0	137472
23789	828	303	278	136695	0	138104
23790	634	469	133105	3170	0	137378
23791	758	287	1983	134575	0	137603
23792	648	496	134366	2423	0	137933
23793	642	517	136093	1307	0	138559
23794	742	323	2934	153598	0	157597
23795	629	505	156516	2988	0	160638
23796	163801	290	3002	2218	0	169311
23797	3682	289	1755	171780	0	177506
23798	2496	294	864	168605	0	172259
23799	1105	173428	717	5220	0	180470
23800	175469	3428	532	2954	0	182383
23801	180659	2130	417	1650	0	184856
23802	5696	182220	600	997	0	189513
23803	3297	3697	316	182763	0	190073
23804	1562	2511	183675	3867	0	191615
23805	175696	927	3650	2802	0	183075
23806	188365	528	2238	1565	0	192696
23807	6135	602	952	180884	0	188573
23808	3389	710	176477	4028	0	184604
23809	1566	175120	3874	2871	0	183431
23810	172896	3660	2225	1567	0	180348
23811	4483	2466	174897	1007	0	182853
23812	2553	172392	3999	966	0	179910
23813	165091	3346	2658	926	0	172021
23814	166136	2095	1162	906	0	170299
23815	5475	935	727	161595	0	168732
23816	3036	164578	794	3471	0	171879
23817	1796	3576	578	173759	0	179709
23818	1344	2165	540	176573	0	180622
23819	1212	1015	493	175564	0	178284
23820	1093	693	506	178350	0	180642
23821	958	980	172944	6298	0	181180
23822	1239	570	3453	176261	0	181523
23823	1224	547	2191	179911	0	183873
23824	1027	763	175836	6096	0	183722
23825	858	175309	3893	3759	0	183819
23826	175721	3515	2490	2118	0	183844
23827	177978	2281	1181	1690	0	183130
23828	6040	1078	802	177097	0	185017
23829	179453	678	772	4681	0	185584
23830	5115	714	723	183297	0	189849
23831	3317	790	183996	5176	0	193279
23832	2175	794	183410	3458	0	189837
23833	1230	183383	6128	2263	0	193004
23834	180147	3969	3299	1770	0	189185
23835	4912	2896	191114	1484	0	200406
23836	3758	1307	4772	175397	0	185234
23837	2327	843	3205	194569	0	200944
23838	1798	859	1532	200708	0	204897
23839	1677	641	1044	201637	0	204999
23840	1536	696	1075	201889	0	205196
23841	1353	1088	192779	9354	0	204574
23842	1627	743	4839	195454	0	202663
23843	191639	829	3364	7044	0	202876
23844	5190	190750	1987	4969	0	202896
23845	192012	4763	1248	3026	0	201049
23846	5771	193357	1496	2325	0	202949
23847	194165	5466	1034	2218	0	202883
23848	199538	3412	998	2298	0	206246
23849	8500	1547	960	193918	0	204925
23850	5062	1039	971	199509	0	206581
23851	193891	985	1078	8566	0	204520
23852	192091	934	1082	5307	0	199414
23853	194895	963	1219	3158	0	200235
23854	8376	185053	1418	2433	0	197280
23855	4644	189803	1244	2240	0	197931
23856	2894	6878	185335	2080	0	197187
23857	2417	4189	4672	181330	0	192608
23858	1818	1874	181630	6111	0	191433
23859	1485	175603	5325	4855	0	187268
23860	1623	4363	3261	169931	0	179178
23861	1650	2885	1595	171763	0	177893
23862	1650	1421	1211	175843	0	180125
23863	169106	1033	1081	8233	0	179453
23864	169793	1039	994	5213	0	177039
23865	6931	170183	1216	3099	0	181429
23866	4434	4300	1116	171894	0	181744
23867	2503	3373	170890	5365	0	182131
23868	2175	1906	167408	4054	0	175543
23869	167130	1317	6465	2802	0	177714
23870	172507	1091	3663	2450	0	179711
23871	7424	818	1818	169826	0	179886
23872	172296	802	1461	6014	0	180573
23873	6009	1041	168391	4614	0	180055
23874	4259	166992	4791	2995	0	179037
23875	2852	4449	3295	166651	0	177247
23876	2077	3389	171983	5595	0	183044
23877	2047	1707	4871	173009	0	181634
23878	1937	1199	3456	177844	0	184436
23879	1822	1317	176361	8414	0	187914
23880	166112	989	4677	5996	0	177774
23881	179429	999	3270	4080	0	187778
23882	7046	185685	2012	3315	0	198058
23883	191847	4692	1443	3094	0	201076
23884	195922	3311	1228	2891	0	203352
23885	9018	1992	191401	2540	0	204951
23886	189558	1414	4909	2598	0	198479
23887	7059	199594	3922	2302	0	212877
23888	204199	5364	1714	2321	0	213598
23889	209163	3602	1465	2160	0	216390
23890	213478	1913	1323	2085	0	218799
23891	205110	1414	1123	2390	0	210037
23892	210509	1208	1114	2430	0	215261
23893	10038	201629	1459	2376	0	215502
23894	186288	4363	885	1828	0	193364
23895	5822	183257	1163	1572	0	191814
23896	3229	165473	877	1340	0	170919
23897	1694	176976	1052	1332	0	181054
23898	173178	5673	1910	1438	0	182199
23899	174130	2744	885	1394	0	179153
23900	6431	1315	168624	1114	0	177484
23901	175442	954	3643	1228	0	181267
23902	176274	742	2405	1411	0	180832
23903	7026	966	177225	1244	0	186461
23904	4013	710	4354	174119	0	183196
23905	2408	766	2747	174644	0	180565
23906	1956	694	1004	185814	0	189468
23907	1838	723	759	186876	0	190196
23908	1898	682	698	187082	0	190360
23909	1708	877	178681	7328	0	188594
23910	1564	177765	4663	3725	0	187717
23911	174437	4328	2687	1705	0	183157
23912	5087	177301	1275	1312	0	184975
23913	177636	4733	851	1221	0	184441
23914	177972	2814	771	1163	0	182720
23915	7501	1352	171289	965	0	181107
23916	4263	1375	4279	154451	0	164368
23917	2008	165467	2858	4030	0	174363
23918	167402	4286	1157	2784	0	175629
23919	169157	2642	792	1635	0	174226
23920	171342	1107	798	1184	0	174431
23921	7414	169873	1011	928	0	179226
23922	173166	4163	728	1053	0	179110
23923	175155	2674	610	1037	0	179476
23924	176200	1208	556	979	0	178943
23925	7915	872	650	168170	0	177607
23926	4522	821	661	171739	0	177743
23927	2826	802	538	174969	0	179135
23928	169165	933	536	6461	0	177095
23929	5466	169024	815	3127	0	178432
23930	168866	3995	447	1375	0	174683
23931	165835	2474	582	980	0	169871
23932	162236	1135	460	908	0	164739
23933	162399	878	445	822	0	164544
23934	7196	155047	687	769	0	163699
23935	145281	3425	329	724	0	149759
23936	4683	141382	455	646	0	147166
23937	2836	143251	474	575	0	147136
23938	143308	4362	368	801	0	148839
23939	4064	140666	437	527	0	145694
23940	2808	145134	421	479	0	148842
23941	144553	4459	462	680	0	150154
23942	146020	2275	280	669	0	149244
23943	5372	1183	261	140565	0	147381
23944	3265	895	268	144323	0	148751
23945	144653	892	310	4635	0	150490
23946	149409	757	343	2389	0	152898
23947	146863	802	384	1268	0	149317
23948	5321	1016	140891	729	0	147957
23949	146747	819	2829	973	0	151368
23950	4588	807	1636	146713	0	153744
23951	3148	751	686	149378	0	153963
23952	2043	690	502	150984	0	154219
23953	1786	718	439	151751	0	154694
23954	1625	882	143485	5079	0	151071
23955	1662	859	145908	2558	0	150987
23956	1749	730	4169	146372	0	153020
23957	1641	946	147220	3730	0	153537
23958	1701	1021	147425	2424	0	152571
23959	2006	796	4411	142543	0	149756
23960	2084	716	2109	150955	0	155864
23961	1844	812	938	155492	0	159086
23962	1861	891	634	154459	0	157845
23963	152480	789	578	5667	0	159514
23964	158172	778	601	3180	0	162731
23965	5993	762	527	153787	0	161069
23966	3720	769	572	155906	0	160967
23967	2423	733	558	156528	0	160242
23968	2216	715	539	156161	0	159631
23969	2115	708	508	154022	0	157353
23970	1883	150648	749	5620	0	158900
23971	150830	3352	468	3292	0	157942
23972	4313	152387	688	1993	0	159381
23973	152614	3590	470	1882	0	158556
23974	153916	2165	363	1766	0	158210
23975	155047	1112	364	1655	0	158178
23976	6506	873	439	144702	0	152520
23977	145916	863	373	3985	0	151137
23978	5048	855	323	142970	0	149196
23979	3754	968	344	141898	0	146964
23980	139885	813	351	5234	0	146283
23981	4464	135366	466	2786	0	143082
23982	2593	129932	368	1371	0	134264
23983	126436	3331	284	1226	0	131277
23984	3517	1769	122936	960	0	129182
23985	113519	863	2341	1015	0	117738
23986	3789	1001	1186	117288	0	123264
23987	2174	109473	506	2433	0	114586
23988	1393	113058	348	1569	0	116368
23989	110789	2748	331	1238	0	115106
23990	2740	1563	185	110008	0	114496
23991	1672	116008	280	2089	0	120049
23992	114937	1966	366	1504	0	118773
23993	115743	1100	166	953	0	117962
23994	116749	594	133	856	0	118332
23995	116841	501	139	899	0	118380
23996	3079	109316	240	1135	0	113770
23997	1221	109726	203	477	0	111627
23998	111128	1953	205	608	0	113894
23999	116914	927	182	629	0	118652
24000	2611	522	114198	410	0	117741
24001	928	111732	1364	309	0	114333
24002	113412	1394	846	403	0	116055
24003	118108	651	138	366	0	119263
24004	2427	424	116418	231	0	119500
24005	111875	194	1718	451	0	114238
24006	2191	266	120788	249	0	123494
24007	989	290	126673	175	0	128127
24008	572	392	2742	111776	0	115482
24009	301	119168	1169	1831	0	122469
24010	129337	2012	302	1151	0	132802
24011	2421	911	158	128785	0	132275
24012	1256	272	115	131224	0	132867
24013	523	165	133	133664	0	134485
24014	130978	129	196	3484	0	134787
24015	2419	143	137	131466	0	134165
24016	1281	144	124	136770	0	138319
24017	509	340	134129	3211	0	138189
24018	124715	184	2298	1729	0	128926
24019	135715	182	1046	688	0	137631
24020	3676	308	134888	384	0	139256
24021	128347	153	2432	436	0	131368
24022	2982	171	1123	127540	0	131816
24023	1417	129669	514	2476	0	134076
24024	742	2420	255	131448	0	134865
24025	128631	1089	246	2927	0	132893
24026	2630	130469	384	1405	0	134888
24027	1619	2553	232	132318	0	136722
24028	821	1237	250	136543	0	138851
24029	717	342	279	137678	0	139016
24030	725	254	261	130434	0	131674
24031	488	137490	406	3722	0	142106
24032	137998	2775	279	1806	0	142858
24033	140681	1408	247	934	0	143270
24034	4206	143711	386	720	0	149023
24035	155201	3035	253	768	0	159257
24036	159670	1553	280	818	0	162321
24037	158611	473	267	825	0	160176
24038	5751	473	151337	635	0	158196
24039	2823	305	3523	150572	0	157223
24040	1278	472	150645	3827	0	156222
24041	147299	341	3658	2332	0	153630
24042	4022	152559	2055	972	0	159608
24043	150778	3545	680	850	0	155853
24044	4318	155395	629	669	0	161011
24045	2842	3919	434	147527	0	154722
24046	1656	1981	487	154017	0	158141
24047	1208	926	153049	5405	0	160588
24048	919	155029	4053	2971	0	162972
24049	152841	3930	2313	1394	0	160478
24050	4566	2377	153586	878	0	161407
24051	152277	984	3980	996	0	158237
24052	5004	737	2190	153412	0	161343
24053	3049	894	154818	4449	0	163210
24054	1455	154523	4183	2970	0	163131
24055	1552	4075	2218	154450	0	162295
24056	1351	2461	155634	4410	0	163856
24057	1410	1179	156994	2715	0	162298
24058	1496	153312	5720	1531	0	162059
24059	1765	4040	2668	149897	0	158370
24060	1784	2277	1168	145735	0	150964
24061	1466	148838	1081	5659	0	157044
24062	150628	3982	1033	2969	0	158612
24063	4870	2424	932	145567	0	153793
24064	2861	148117	1142	4482	0	156602
24065	150431	4079	1092	2943	0	158545
24066	151543	2403	1078	1652	0	156676
24067	154845	1301	1044	1474	0	158664
24068	6566	150011	1139	1489	0	159205
24069	154671	4181	903	1781	0	161536
24070	156053	2678	890	1639	0	161260
24071	6814	1405	796	150817	0	159832
24072	155021	1059	796	5079	0	161955
24073	5534	1213	783	155622	0	163152
24074	3554	1276	152031	5264	0	162125
24075	2284	1120	156255	3301	0	162960
24076	2093	998	5849	156386	0	165326
24077	1850	1187	159573	5141	0	167751
24078	151058	1075	4899	3396	0	160428
24079	5628	1101	2756	159394	0	168879
24080	3776	942	1399	163389	0	169506
24081	2245	1180	158402	7039	0	168866
24082	1887	152806	4745	3892	0	163330
24083	1828	162321	3107	2115	0	169371
24084	1962	6204	1497	156630	0	166293
24085	1983	3050	1153	163142	0	169328
24086	1860	1675	157378	6683	0	167596
24087	1949	1455	161235	3594	0	168233
24088	2172	1246	6047	160683	0	170148
24089	1884	1372	160601	5584	0	169441
24090	153795	1274	4997	3588	0	163654
24091	5916	1339	2802	157602	0	167659
24092	159536	1416	1384	5487	0	167823
24093	6063	1236	1114	158344	0	166757
24094	3956	1197	1132	161507	0	167792
24095	2385	1245	155458	7308	0	166396
24096	1925	157157	5332	4192	0	168606
24097	2316	4406	3068	157249	0	167039
24098	1781	2827	157010	5356	0	166974
24099	1730	150637	4831	3244	0	160442
24100	2040	4045	2868	153035	0	161988
24101	151119	2321	1601	4998	0	160039
24102	4675	1244	151438	3344	0	160701
24103	136962	779	4151	2186	0	144078
24104	4383	950	142315	1539	0	149187
24105	127425	825	4123	1545	0	133918
24106	3694	132646	2792	1565	0	140697
24107	2172	131961	1588	1269	0	136990
24108	1349	5149	1356	123187	0	131041
24109	867	126622	1069	3317	0	131875
24110	125717	2933	921	2787	0	132358
24111	3158	1852	1053	126805	0	132868
24112	2275	933	931	129460	0	133599
24113	1338	712	839	131701	0	134590
24114	961	769	125734	4877	0	132341
24115	1084	769	3023	125927	0	130803
24116	998	871	124435	3831	0	130135
24117	780	120737	3446	2607	0	127570
24118	116943	2588	2037	1623	0	123191
24119	2815	123193	1216	1337	0	128561
24120	126563	2634	917	1562	0	131676
24121	127799	1636	807	1579	0	131821
24122	128766	751	803	1538	0	131858
24123	127163	579	984	1443	0	130169
24124	4154	795	120788	1306	0	127043
24125	2323	721	2909	120363	0	126316
24126	1380	907	2019	122363	0	126669
24127	1295	783	1034	126493	0	129605
24128	112726	793	935	4357	0	118811
24129	114734	696	918	2535	0	118883
24130	3777	119919	866	1705	0	126267
24131	2230	2138	115230	1156	0	120754
24132	1387	1365	115951	1087	0	119790
24133	948	114350	3423	1101	0	119822
24134	793	115492	1951	1217	0	119453
24135	1943	2290	2016	102414	0	108663
24136	737	1103	535	99046	0	101421
24137	102355	499	506	2421	0	105781
24138	1539	102118	591	1512	0	105760
24139	1243	1494	452	104833	0	108022
24140	759	1086	106495	1839	0	110179
24141	757	494	1559	109581	0	112391
24142	730	370	1120	112503	0	114723
24143	786	366	591	114070	0	115813
24144	761	372	552	112414	0	114099
24145	681	415	107945	2606	0	111647
24146	622	103434	1704	1518	0	107278
24147	619	105649	1049	778	0	108095
24148	101707	1751	522	706	0	104686
24149	1476	102962	526	568	0	105532
24150	1046	106930	496	561	0	109033
24151	810	1973	508	105349	0	108640
24152	714	945	398	107250	0	109307
24153	707	458	453	107495	0	109113
24154	604	495	104639	2219	0	107957
24155	506	104061	1413	1488	0	107468
24156	618	1343	817	101645	0	104423
24157	411	105212	523	1569	0	107715
24158	104110	1249	443	1336	0	107138
24159	1253	105017	537	787	0	107594
24160	104365	1362	431	874	0	107032
24161	1388	1033	102431	732	0	105584
24162	101919	536	1312	790	0	104557
24163	1481	621	787	104586	0	107475
24164	1030	635	106096	1451	0	109212
24165	101698	542	1243	1164	0	104647
24166	106333	467	823	786	0	108409
24167	106630	438	415	712	0	108195
24168	2074	461	372	103627	0	106534
24169	1098	583	104065	1600	0	107346
24170	99279	413	1264	1425	0	102381
24171	1510	467	782	107216	0	109975
24172	1044	419	377	107597	0	109437
24173	578	554	108892	1958	0	111982
24174	470	108082	1203	1253	0	111008
24175	568	1422	686	104056	0	106732
24176	404	107923	453	1219	0	109999
24177	105235	1180	336	983	0	107734
24178	105757	716	328	694	0	107495
24179	1652	415	279	104208	0	106554
24180	104685	327	294	1430	0	106736
24181	1234	103901	347	967	0	106449
24182	104245	1059	251	698	0	106253
24183	1256	105630	359	488	0	107733
24184	991	1140	234	105255	0	107620
24185	663	695	232	103915	0	105505
24186	491	105071	349	1478	0	107389
24187	523	1051	299	104732	0	106605
24188	452	797	103047	1298	0	105594
24189	376	100787	965	830	0	102958
24190	97018	826	444	595	0	98883
24191	828	98781	334	446	0	100389
24192	585	806	231	98261	0	99883
24193	418	635	98327	890	0	100270
24194	404	325	703	98888	0	100320
24195	371	196	416	101369	0	102352
24196	95664	154	241	1548	0	97607
24197	994	282	99143	740	0	101159
24198	601	99111	864	689	0	101265
24199	364	1020	104020	386	0	105790
24200	313	568	102310	274	0	103465
24201	288	376	103119	262	0	104045
24202	379	821	1482	97779	0	100461
24203	105882	129	695	1310	0	108016
24204	1069	105599	290	755	0	107713
24205	108377	1158	123	451	0	110109
24206	110493	653	146	494	0	111786
24207	1709	249	123	106969	0	109050
24208	712	109170	206	1196	0	111284
24209	107407	1193	91	850	0	109541
24210	1108	108941	164	424	0	110637
24211	715	1283	132	104242	0	106372
24212	353	648	130	111484	0	112615
24213	176	111357	233	1774	0	113540
24214	257	1199	113	112505	0	114074
24215	265	816	108773	1334	0	111188
24216	257	431	109823	708	0	111219
24217	287	223	1664	110406	0	112580
24218	253	185	731	113093	0	114262
24219	274	288	107516	1743	0	109821
24220	257	311	104876	826	0	106270
24221	93973	181	1783	551	0	96488
24222	1260	103636	809	330	0	106035
24223	799	110632	384	390	0	112205
24224	442	1784	231	105372	0	107829
24225	377	746	201	107363	0	108687
24226	338	313	180	109308	0	110139
24227	307	366	106695	1870	0	109238
24228	320	395	105568	819	0	107102
24229	384	199	1784	108075	0	110442
24230	335	341	108040	1487	0	110203
24231	234	106434	1556	1109	0	109333
24232	105658	1357	1055	636	0	108706
24233	1447	871	105916	362	0	108596
24234	851	416	105475	326	0	107068
24235	464	341	1895	105476	0	108176
24236	344	375	116671	1630	0	119020
24237	262	117892	1862	1296	0	121312
24238	464	1748	985	119027	0	122224
24239	393	1059	119646	1930	0	123028
24240	226	116792	1923	1181	0	120122
24241	115183	1791	1108	616	0	118698
24242	1763	1031	440	114445	0	117679
24243	1050	427	338	116090	0	117905
24244	115219	291	254	2770	0	118534
24245	1718	115514	310	1381	0	118923
24246	116860	1765	273	789	0	119687
24247	117793	1050	288	572	0	119703
24248	118102	373	298	533	0	119306
24249	2873	265	287	114532	0	117957
24250	112416	222	321	2034	0	114993
24251	2067	101533	436	1224	0	105260
24252	1125	109692	407	593	0	111817
24253	113525	2504	311	574	0	116914
24254	2047	1160	274	115588	0	119069
24255	1269	489	261	116996	0	119015
24256	597	337	252	118429	0	119615
24257	443	439	112645	3112	0	116639
24258	288	112875	1978	1597	0	116738
24259	423	1921	1153	115638	0	119135
24260	115446	1114	500	2392	0	119452
24261	2080	440	402	115958	0	118880
24262	1242	466	114100	2448	0	118256
24263	511	114161	2146	1521	0	118339
24264	114890	2015	1252	900	0	119057
24265	115382	1233	608	702	0	117925
24266	116313	564	480	679	0	118036
24267	3324	423	420	115594	0	119761
24268	1706	473	116225	2350	0	120754
24269	828	476	119301	1575	0	122180
24270	585	125047	3322	822	0	129776
24271	793	2579	1490	125249	0	130111
24272	727	1472	531	128700	0	131430
24273	121921	618	362	4092	0	126993
24274	2911	495	304	124802	0	128512
24275	127296	429	387	3373	0	131485
24276	3262	499	124550	1956	0	130267
24277	1860	491	127074	1025	0	130450
24278	1059	354	3992	124849	0	130254
24279	843	377	1858	129218	0	132296
24280	824	372	734	133589	0	135519
24281	136656	386	554	4688	0	142284
24282	144828	377	520	2322	0	148047
24283	4944	355	483	144234	0	150016
24284	2277	481	142236	3940	0	148934
24285	966	475	145487	2390	0	149318
24286	888	335	4985	143718	0	149926
24287	146482	361	2358	4099	0	153300
24288	3860	383	921	145319	0	150483
24289	2314	371	610	148883	0	152178
24290	958	476	146197	5488	0	153119
24291	780	470	146292	2735	0	150277
24292	139780	390	5189	1493	0	146852
24293	3981	527	146316	1025	0	151849
24294	2541	421	3874	140436	0	147272
24295	1412	347	2230	143967	0	147956
24296	142282	296	943	5421	0	148942
24297	3792	140015	988	2754	0	147549
24298	138358	3207	713	1436	0	143714
24299	3705	133483	749	1088	0	139025
24300	131316	3185	518	1081	0	136100
24301	3773	1762	128496	1021	0	135052
24302	118829	796	3594	1016	0	124235
24303	123164	351	1839	864	0	126218
24304	4655	588	835	121816	0	127894
24305	2324	415	121403	3305	0	127447
24306	1250	307	3191	117759	0	122507
24307	1021	370	1872	118059	0	121322
24308	815	117270	1066	4776	0	123927
24309	1150	2753	751	113980	0	118634
24310	926	118334	761	3605	0	123626
24311	1142	2917	645	119014	0	123718
24312	116959	1603	716	3988	0	123266
24313	3623	570	671	118249	0	123113
24314	2381	591	116346	3801	0	123119
24315	114196	454	3164	2568	0	120382
24316	3716	468	119376	1470	0	125030
24317	117940	329	3430	1372	0	123071
24318	120281	359	2015	1257	0	123912
24319	4938	116920	1182	1209	0	124249
24320	2666	122606	1032	1031	0	127335
24321	121456	4423	842	1119	0	127840
24322	125721	1987	819	1215	0	129742
24323	123550	674	788	1266	0	126278
24324	123726	436	717	1455	0	126334
24325	123581	446	670	1388	0	126085
24326	5671	517	708	119356	0	126252
24327	3086	557	843	122805	0	127291
24328	1633	684	120091	5156	0	127564
24329	117391	505	3364	2788	0	124048
24330	4230	502	2036	119091	0	125859
24331	2845	540	978	121516	0	125879
24332	1651	642	119200	5168	0	126661
24333	1481	114538	3559	3067	0	122645
24334	1551	120091	2327	1674	0	125643
24335	116069	4275	1265	1505	0	123114
24336	108444	1852	923	1165	0	112384
24337	4591	101348	837	1103	0	107879
24338	2334	103128	840	925	0	107227
24339	102823	3566	692	1087	0	108168
24340	107027	1647	648	1214	0	110536
24341	4541	668	629	104236	0	110074
24342	2588	521	578	106113	0	109800
24343	1716	446	558	109171	0	111891
24344	105628	489	549	4529	0	111195
24345	107240	512	528	2514	0	110794
24346	4755	496	568	107141	0	112960
24347	109870	495	594	3377	0	114336
24348	4022	579	108977	2258	0	115836
24349	2756	459	2943	109859	0	116017
24350	1637	537	109693	3491	0	115358
24351	1393	107680	3406	2312	0	114791
24352	1732	3230	2193	106274	0	113429
24353	105907	1566	896	3413	0	111782
24354	3637	630	689	105769	0	110725
24355	2546	584	574	106839	0	110543
24356	1461	685	104356	4475	0	110977
24357	1489	631	104939	2459	0	109518
24358	1361	106524	3998	1303	0	113186
24359	107645	2881	1821	1056	0	113403
24360	109351	1740	717	1000	0	112808
24361	109855	752	555	1036	0	112198
24362	110536	504	472	1103	0	112615
24363	5146	482	510	106924	0	113062
24364	2877	487	533	104730	0	108627
24365	1526	107744	665	4226	0	114161
24366	107780	2681	561	2187	0	113209
24367	107739	1566	624	1294	0	111223
24368	4529	736	102164	1017	0	108446
24369	89029	448	2187	763	0	92427
24370	2970	92517	1436	734	0	97657
24371	2150	3168	494	87645	0	93457
24372	1243	92648	508	2347	0	96746
24373	91595	2345	398	1683	0	96021
24374	2644	92319	553	912	0	96428
24375	1964	2029	370	89187	0	93550
24376	1058	1206	339	90984	0	93587
24377	958	490	348	89414	0	91210
24378	756	86733	496	3307	0	91292
24379	1054	2393	389	86548	0	90384
24380	1283	1741	359	83375	0	86758
24381	608	74082	343	2673	0	77706
24382	481	71026	321	1223	0	73051
24383	66910	1816	255	612	0	69593
24384	1521	68159	259	501	0	70440
24385	65713	1349	219	502	0	67783
24386	1683	829	64781	409	0	67702
24387	1021	64197	1157	442	0	66817
24388	64453	1191	766	488	0	66898
24389	64060	768	283	474	0	65585
24390	1918	441	62973	425	0	65757
24391	1163	329	1080	61651	0	64223
24392	637	329	64213	1345	0	66524
24393	502	62885	1259	962	0	65608
24394	62111	1263	726	668	0	64768
24395	1302	62392	372	498	0	64564
24396	958	1263	216	61973	0	64410
24397	604	794	212	64039	0	65649
24398	506	451	63191	1771	0	65919
24399	504	403	61254	966	0	63127
24400	59403	340	1591	659	0	61993
24401	63461	313	742	511	0	65027
24402	63860	326	293	509	0	64988
24403	63641	326	197	548	0	64712
24404	1913	62896	272	480	0	65561
24405	1108	1247	212	62474	0	65041
24406	640	830	194	62325	0	63989
24407	529	64100	262	1760	0	66651
24408	65169	1216	237	1082	0	67704
24409	65760	807	224	579	0	67370
24410	2022	489	64668	462	0	67641
24411	64725	324	1184	462	0	66695
24412	1652	324	729	64776	0	67481
24413	1101	381	64025	1324	0	66831
24414	742	405	1255	63432	0	65834
24415	516	413	64854	1469	0	67252
24416	472	353	63013	863	0	64701
24417	581	664	1566	58922	0	61733
24418	357	61574	847	1122	0	63900
24419	61775	1077	370	820	0	64042
24420	60479	712	232	491	0	61914
24421	1632	63021	311	392	0	65356
24422	829	64228	306	336	0	65699
24423	65635	1417	397	515	0	67964
24424	66394	703	211	432	0	67740
24425	66988	336	202	370	0	67896
24426	66893	284	196	335	0	67708
24427	1789	306	175	66533	0	68803
24428	885	306	65555	1135	0	67881
24429	446	65228	1048	739	0	67461
24430	64615	1003	601	436	0	66655
24431	1152	66349	287	322	0	68110
24432	66374	1063	226	348	0	68011
24433	66394	615	164	341	0	67514
24434	1587	336	66546	229	0	68698
24435	787	69291	1025	221	0	71324
24436	530	1044	525	69519	0	71618
24437	398	626	207	71095	0	72326
24438	400	283	189	70485	0	71357
24439	69925	233	170	1627	0	71955
24440	66822	245	189	798	0	68054
24441	67523	238	168	408	0	68337
24442	1590	67195	231	314	0	69330
24443	65768	915	144	354	0	67181
24444	1076	66399	210	330	0	68015
24445	722	1010	65007	289	0	67028
24446	292	65453	941	247	0	66933
24447	699	1002	924	61110	0	63735
24448	264	361	138	61049	0	61812
24449	246	217	60423	888	0	61774
24450	260	128	630	58760	0	59778
24451	235	139	334	60777	0	61485
24452	60936	145	143	1021	0	62245
24453	59862	162	130	493	0	60647
24454	61002	134	109	271	0	61516
24455	985	61348	181	191	0	62705
24456	60675	592	123	238	0	61628
24457	58589	350	107	241	0	59287
24458	946	60372	155	176	0	61649
24459	534	596	99	60376	0	61605
24460	366	370	94	61142	0	61972
24461	60159	121	110	952	0	61342
24462	768	215	59347	480	0	60810
24463	428	57422	609	267	0	58726
24464	302	895	285	54567	0	56049
24465	233	55242	153	518	0	56146
24466	208	57099	112	350	0	57769
24467	57106	748	189	280	0	58323
24468	56962	334	89	227	0	57612
24469	857	162	89	57448	0	58556
24470	445	139	87	56738	0	57409
24471	280	128	79	57027	0	57514
24472	255	123	92	56812	0	57282
24473	225	175	54918	867	0	56185
24474	238	256	51718	370	0	52582
24475	285	119	700	55164	0	56268
24476	286	220	58840	673	0	60019
24477	214	60410	677	383	0	61684
24478	61460	661	308	294	0	62723
24479	61991	368	121	272	0	62752
24480	1067	171	109	62068	0	63415
24481	547	149	88	63169	0	63953
24482	288	147	93	63557	0	64085
24483	210	64201	159	1014	0	65584
24484	64661	686	110	587	0	66044
24485	64804	429	84	322	0	65639
24486	1157	248	64137	210	0	65752
24487	633	150	732	68395	0	69910
24488	320	241	71511	1104	0	73176
24489	353	155	1010	76720	0	78238
24490	310	161	449	77136	0	78056
24491	304	161	147	77374	0	77986
24492	261	147	128	79058	0	79594
24493	78337	166	142	2013	0	80658
24494	79984	171	129	948	0	81232
24495	82326	144	139	485	0	83094
24496	2278	144	108	81273	0	83803
24497	921	188	79638	1526	0	82273
24498	76768	120	1350	900	0	79138
24499	1613	124	684	80531	0	82952
24500	80925	137	218	1649	0	82929
24501	1640	123	125	80743	0	82631
24502	820	78230	222	1651	0	80923
24503	373	83485	212	1011	0	85081
24504	489	1886	188	83630	0	86193
24505	473	765	168	83963	0	85369
24506	426	239	94	83972	0	84731
24507	272	82482	182	2224	0	85160
24508	81032	1413	151	1070	0	83666
24509	1462	82074	201	522	0	84259
24510	832	1561	81544	377	0	84314
24511	447	763	1405	81010	0	83625
24512	222	84315	762	1648	0	86947
24513	331	1471	272	84439	0	86513
24514	291	763	165	85444	0	86663
24515	324	345	83532	2411	0	86612
24516	76327	176	1420	1380	0	79303
24517	1617	86647	788	634	0	89686
24518	87961	1458	246	598	0	90263
24519	89907	741	180	555	0	91383
24520	90559	295	146	568	0	91568
24521	2657	286	85351	493	0	88787
24522	1312	201	1620	83282	0	86415
24523	673	182	813	85179	0	86847
24524	467	305	83091	2562	0	86425
24525	74310	257	1699	1447	0	77713
24526	1942	317	83804	766	0	86829
24527	1014	334	81426	596	0	83370
24528	446	82879	2132	636	0	86093
24529	510	1614	924	82202	0	85250
24530	456	904	83540	1757	0	86657
24531	77473	328	1533	1242	0	80576
24532	81217	283	818	754	0	83072
24533	2306	382	81424	499	0	84611
24534	1176	329	1541	81498	0	84544
24535	583	401	83913	1775	0	86672
24536	396	84249	1726	1233	0	87604
24537	89061	1560	929	873	0	92423
24538	90658	851	438	726	0	92673
24539	91306	410	334	613	0	92663
24540	2781	299	331	89310	0	92721
24541	1384	282	315	91677	0	93658
24542	716	398	89763	2633	0	93510
24543	86919	260	1773	1372	0	90324
24544	2150	288	958	90173	0	93569
24545	89562	253	557	2156	0	92528
24546	2215	304	89365	1314	0	93198
24547	1246	340	91987	737	0	94310
24548	808	241	2542	87713	0	91304
24549	684	229	1190	93479	0	95582
24550	626	359	92458	2659	0	96102
24551	87484	252	2048	1427	0	91211
24552	2181	346	1155	88239	0	91921
24553	1200	94133	733	1972	0	98038
24554	95012	1757	514	1360	0	98643
24555	2158	96924	615	810	0	100507
24556	96845	1893	576	797	0	100111
24557	2479	1050	98564	664	0	102757
24558	1481	517	96805	655	0	99458
24559	765	98297	2757	683	0	102502
24560	98028	1855	1346	739	0	101968
24561	2364	1084	97886	644	0	101978
24562	93817	403	2052	707	0	96979
24563	2435	97736	1297	647	0	102115
24564	1563	1817	676	99036	0	103092
24565	1006	975	597	96091	0	98669
24566	641	98512	758	2604	0	102515
24567	102495	1852	613	1505	0	106465
24568	104563	1052	553	863	0	107031
24569	106601	424	551	751	0	108327
24570	3253	491	105276	638	0	109658
24571	1663	382	2218	104544	0	108807
24572	932	357	1296	106939	0	109524
24573	822	347	740	109034	0	110943
24574	777	448	106526	3165	0	110916
24575	783	104526	2259	1753	0	109321
24576	100737	1978	1246	891	0	104852
24577	2390	1194	101349	558	0	105491
24578	97526	526	2176	612	0	100840
24579	2343	100628	1409	592	0	104972
24580	101417	1924	747	657	0	104745
24581	2520	1078	619	99370	0	103587
24582	101266	457	717	2216	0	104656
24583	2548	422	615	101024	0	104609
24584	1487	516	102896	2179	0	107078
24585	1086	825	2058	101958	0	105927
24586	895	616	102083	2109	0	105703
24587	90611	413	1807	1198	0	94029
24588	1940	95868	1194	638	0	99640
24589	1298	1523	540	85263	0	88624
24590	623	92550	600	1196	0	94969
24591	92033	1330	606	969	0	94938
24592	91913	709	481	640	0	93743
24593	2011	91357	542	475	0	94385
24594	91341	1216	524	579	0	93660
24595	92965	663	410	614	0	94652
24596	1844	355	376	91532	0	94107
24597	960	338	383	93063	0	94744
24598	95385	314	340	1826	0	97865
24599	96320	306	328	948	0	97902
24600	2160	270	334	94281	0	97045
24601	1214	264	337	99596	0	101411
24602	99217	267	365	2077	0	101926
24603	1773	393	97857	1034	0	101057
24604	91521	267	1496	814	0	94098
24605	1851	408	96425	623	0	99307
24606	1012	95536	1624	557	0	98729
24607	804	1391	858	93897	0	96950
24608	775	841	97083	1377	0	100076
24609	647	100685	1541	878	0	103751
24610	100073	1473	839	757	0	103142
24611	1673	852	100257	419	0	103201
24612	96642	414	1375	531	0	98962
24613	101353	343	663	584	0	102943
24614	102057	295	384	647	0	103383
24615	2197	315	320	96119	0	98951
24616	1113	102148	484	1334	0	105079
24617	99742	1233	356	1048	0	102379
24618	1636	747	101208	515	0	104106
24619	90235	334	1222	638	0	92429
24620	1538	394	100865	437	0	103234
24621	920	100394	1308	531	0	103153
24622	714	1178	700	101100	0	103692
24623	668	667	445	99827	0	101607
24624	617	100096	453	1590	0	102756
24625	710	1243	408	102379	0	104740
24626	740	831	103292	1374	0	106237
24627	624	103696	1360	857	0	106537
24628	781	1324	684	101821	0	104610
24629	101838	733	398	1549	0	104518
24630	105882	414	315	956	0	107567
24631	2317	338	305	106037	0	108997
24632	1248	108474	433	1608	0	111763
24633	927	1430	315	109436	0	112108
24634	846	730	327	108039	0	109942
24635	747	462	101509	2211	0	104929
24636	696	102645	1466	1239	0	106046
24637	670	1250	681	99915	0	102516
24638	564	810	98868	1429	0	101671
24639	495	98603	1363	1022	0	101483
24640	606	1356	764	98878	0	101604
24641	99494	742	469	1437	0	102142
24642	1539	101994	408	812	0	104753
24643	1060	1362	289	102465	0	105176
24644	105241	744	284	1594	0	107863
24645	105994	400	267	1049	0	107710
24646	106374	335	246	708	0	107663
24647	104658	293	271	678	0	105900
24648	2244	366	276	103441	0	106327
24649	1168	428	105316	1533	0	108445
24650	833	625	1279	101423	0	104160
24651	630	104508	827	1451	0	107416
24652	106101	1209	458	1072	0	108840
24653	1592	803	102924	599	0	105918
24654	96717	393	1170	599	0	98879
24655	1490	457	100790	456	0	103193
24656	984	326	1240	99766	0	102316
24657	617	460	100597	1242	0	102916
24658	626	367	1222	97731	0	99946
24659	573	442	99075	1414	0	101504
24660	660	334	1229	97103	0	99326
24661	99127	270	679	1599	0	101675
24662	1348	104443	502	969	0	107262
24663	1061	1221	330	105481	0	108093
24664	819	671	259	105721	0	107470
24665	674	519	109268	1736	0	112197
24666	659	398	104912	948	0	106917
24667	98753	276	1672	837	0	101538
24668	1423	105771	871	566	0	108631
24669	105000	984	499	575	0	107058
24670	105974	570	309	692	0	107545
24671	1664	283	422	102057	0	104426
24672	779	106294	507	1119	0	108699
24673	108828	1075	358	1000	0	111261
24674	110235	610	340	724	0	111909
24675	112165	327	353	719	0	113564
24676	112628	256	314	628	0	113826
24677	111392	225	341	592	0	112550
24678	1793	431	108582	367	0	111173
24679	108009	208	1119	500	0	109836
24680	1507	411	109839	349	0	112106
24681	1061	279	1150	106209	0	108699
24682	694	232	658	112470	0	114054
24683	569	398	110110	1677	0	112754
24684	105789	257	1238	1093	0	108377
24685	1490	247	718	111712	0	114167
24686	1061	261	390	114547	0	116259
24687	655	270	351	116299	0	117575
24688	633	244	316	114924	0	116117
24689	570	259	306	115870	0	117005
24690	524	453	115630	2190	0	118797
24691	632	243	1408	114781	0	117064
24692	557	416	117776	1735	0	120484
24693	587	383	115370	1103	0	117443
24694	114684	215	2179	843	0	117921
24695	122192	179	1132	764	0	124267
24696	130598	199	534	706	0	132037
24697	3162	350	133485	526	0	137523
24698	1583	307	132287	535	0	134712
24699	745	302	134805	548	0	136400
24700	526	138307	3535	673	0	143041
24701	1084	2151	2039	136770	0	142044
24702	143078	1116	763	2424	0	147381
24703	2543	403	461	148478	0	151885
24704	1486	151810	608	2824	0	156728
24705	153441	2400	459	2012	0	158312
24706	2904	1460	405	151710	0	156479
24707	1840	156261	578	2908	0	161587
24708	1088	2497	465	158755	0	162805
24709	808	1542	527	156705	0	159582
24710	152498	468	602	4394	0	157962
24711	3033	406	576	154402	0	158417
24712	1973	561	152807	3298	0	158639
24713	1111	335	2789	151182	0	155417
24714	776	147197	2058	3211	0	153242
24715	740	153431	1150	2293	0	157614
24716	807	3888	835	147750	0	153280
24717	767	1967	723	146325	0	149782
24718	705	144555	793	4380	0	150433
24719	835	146547	752	2471	0	150605
24720	783	149799	675	1476	0	152733
24721	1060	4489	530	137006	0	143085
24722	870	147522	674	3072	0	152138
24723	144920	3228	562	2485	0	151195
24724	3101	2338	147234	1355	0	154028
24725	2213	1085	2750	141472	0	147520
24726	1049	147576	1964	3339	0	153928
24727	145580	3102	770	2757	0	152209
24728	3345	2303	146337	1690	0	153675
24729	2035	146234	3146	1606	0	153021
24730	142514	3084	1973	1671	0	149242
24731	2692	142635	1029	1362	0	147718
24732	1814	145026	802	1497	0	149139
24733	1207	4562	592	141231	0	147592
24734	902	146004	634	3288	0	150828
24735	143586	3459	548	2740	0	150333
24736	3033	2607	621	143764	0	150025
24737	1993	1650	142609	3442	0	149694
24738	1027	1609	142801	2533	0	147970
24739	985	1495	3578	143177	0	149235
24740	942	1601	146205	3437	0	152185
24741	998	1238	2891	146466	0	151593
24742	141676	1283	1822	3954	0	148735
24743	2931	1529	142879	2605	0	149944
24744	2219	1307	2820	138394	0	144740
24745	1009	139635	2136	3307	0	146087
24746	1031	3425	1049	143639	0	149144
24747	1205	2408	785	142621	0	147019
24748	934	140172	1123	4901	0	147130
24749	1070	3361	963	145797	0	151191
24750	946	2574	1008	146880	0	151408
24751	960	1973	143520	4508	0	150961
24752	843	142276	2977	2993	0	149089
24753	142635	3473	1934	2110	0	150152
24754	3105	2572	1212	144142	0	151031
24755	2164	1827	145061	3606	0	152658
24756	1361	1518	2964	143817	0	149660
24757	983	1588	144659	3994	0	151224
24758	134224	1438	3238	3162	0	142062
24759	2996	144510	2379	1912	0	151797
24760	2318	3192	1448	145639	0	152597
24761	1532	2559	1136	149339	0	154566
24762	141217	1494	1263	4943	0	148917
24763	3185	1409	1185	143965	0	149744
24764	2216	1507	141547	4160	0	149430
24765	1277	1557	3091	133998	0	139923
24766	1017	131821	2343	4165	0	139346
24767	966	136463	1572	3312	0	142313
24768	935	140230	1371	2451	0	144987
24769	1140	4880	1161	137159	0	144340
24770	1027	2985	135161	4155	0	143328
24771	845	135658	3217	3452	0	143172
24772	132553	3526	2172	2479	0	140730
24773	2783	135708	1419	2280	0	142190
24774	135457	3551	1093	2397	0	142498
24775	135387	2493	1190	2214	0	141284
24776	4167	1751	133122	2133	0	141173
24777	135784	1552	3172	2245	0	142753
24778	144051	1346	2151	2566	0	150114
24779	142105	1398	1241	2307	0	147051
24780	145438	1434	1058	2204	0	150134
24781	4607	1582	142423	1978	0	150590
24782	139453	1356	3069	1990	0	145868
24783	147432	1564	2120	1848	0	152964
24784	4393	150954	1250	1531	0	158128
24785	2640	3705	768	148945	0	156058
24786	1586	2519	926	149034	0	154065
24787	1190	151035	1257	4792	0	158274
24788	149069	3501	1091	2835	0	156496
24789	3387	151936	1310	1597	0	158230
24790	147743	3582	969	1407	0	153701
24791	150239	2458	787	1404	0	154888
24792	4535	152909	1022	1340	0	159806
24793	2764	3194	797	152998	0	159753
24794	1783	2138	153995	3444	0	161360
24795	1275	148919	3102	2423	0	155719
24796	1402	3849	1797	135142	0	142190
24797	1013	141009	912	2252	0	145186
24798	840	150146	612	1640	0	153238
24799	1342	4845	616	143855	0	150658
24800	1002	1857	145070	2875	0	150804
24801	666	141317	2746	1796	0	146525
24802	612	142495	1677	753	0	145537
24803	129975	3221	684	526	0	134406
24804	2163	1536	192	134151	0	138042
24805	1455	487	133	136430	0	138505
24806	566	313	151	140038	0	141068
24807	423	391	136801	3787	0	141402
24808	468	320	2357	137483	0	140628
24809	316	141470	1526	2741	0	146053
24810	144777	2597	392	1723	0	149489
24811	2862	1619	226	144666	0	149373
24812	1753	638	143458	2835	0	148684
24813	140180	369	2650	1891	0	145090
24814	3030	408	1517	147343	0	152298
24815	1830	540	152695	2946	0	158011
24816	689	549	153571	1819	0	156628
24817	150615	359	4430	864	0	156268
24818	159653	382	1921	729	0	162685
24819	159655	423	582	601	0	161261
24820	160709	457	338	746	0	162250
24821	5025	645	156048	640	0	162358
24822	2282	158083	3028	598	0	163991
24823	158477	3114	1784	819	0	164194
24824	3195	158900	733	574	0	163402
24825	157605	3353	381	728	0	162067
24826	3378	158558	541	627	0	163104
24827	2222	3375	378	157572	0	163547
24828	881	2044	427	159400	0	162752
24829	732	814	435	158240	0	160221
24830	631	153382	610	4867	0	159490
24831	607	158191	524	2452	0	161774
24832	891	4652	361	149184	0	155088
24833	600	153944	578	3271	0	158393
24834	761	3731	151821	2064	0	158377
24835	852	2182	3182	151616	0	157832
24836	741	1151	153904	3539	0	159335
24837	147601	802	3444	2488	0	154335
24838	152891	816	2102	1200	0	157009
24839	5010	967	150838	989	0	157804
24840	2549	987	150061	1000	0	154597
24841	1270	935	4667	147570	0	154442
24842	1016	994	150157	3689	0	155856
24843	1011	885	3675	141454	0	147025
24844	944	134522	2533	3537	0	141536
24845	1225	3748	931	149404	0	155308
24846	1102	2469	736	151130	0	155437
24847	1138	1149	741	152534	0	155562
24848	918	1177	145477	5664	0	153236
24849	1090	923	3534	143363	0	148910
24850	1097	992	2327	143488	0	147904
24851	1239	1087	1072	136377	0	139775
24852	1045	143932	1029	4875	0	150881
24853	144673	3693	792	2873	0	152031
24854	145537	2405	867	1991	0	150800
24855	145889	1132	1000	1787	0	149808
24856	5547	1056	1026	141619	0	149248
24857	2859	1155	140267	4201	0	148482
24858	2085	1180	139268	3091	0	145624
24859	1174	140484	5181	1844	0	148683
24860	136384	3716	2525	1876	0	144501
24861	3643	139876	1576	1765	0	146860
24862	140248	3693	1195	1754	0	146890
24863	3890	140090	1338	1720	0	147038
24864	138641	3947	1216	1637	0	145441
24865	4045	144200	1447	1598	0	151290
24866	3017	4153	1145	143935	0	152250
24867	1901	2860	142219	4356	0	151336
24868	1718	1557	143624	3225	0	150124
24869	1850	1309	5300	140992	0	149451
24870	1784	1253	2981	143543	0	149561
24871	1767	1229	1517	147186	0	151699
24872	1711	1351	142291	6062	0	151415
24873	1859	1095	3734	142046	0	148734
24874	137570	1148	2635	4910	0	146263
24875	139316	1102	1562	3503	0	145483
24876	5298	136331	1542	2180	0	145351
24877	134419	3579	1254	1907	0	141159
24878	4163	131658	1346	1845	0	139012
24879	130939	3811	1230	1814	0	137794
24880	132107	2600	1304	1704	0	137715
24881	129090	1357	1238	1703	0	133388
24882	5746	1320	127813	1522	0	136401
24883	3096	1282	125359	1428	0	131165
24884	121986	979	4851	1517	0	129333
24885	128189	966	2896	1523	0	133574
24886	5617	1147	1439	125966	0	134169
24887	3679	1019	963	131740	0	137401
24888	2133	1010	1022	134867	0	139032
24889	1657	1087	1188	136550	0	140482
24890	1541	1097	1193	139386	0	143217
24891	131058	1124	1022	6111	0	139315
24892	4055	1041	794	130636	0	136526
24893	2565	1150	126495	4345	0	134555
24894	121446	890	3306	3063	0	128705
24895	126320	704	2317	2065	0	131406
24896	4903	124214	1207	1915	0	132239
24897	2250	124200	790	1518	0	128758
24898	112697	3322	713	1025	0	117757
24899	2510	116798	705	909	0	120922
24900	114996	2429	954	850	0	119229
24901	124212	1277	752	909	0	127150
24902	125892	440	452	898	0	127682
24903	4628	390	434	117557	0	123009
24904	2028	118362	609	2936	0	123935
24905	119383	2472	392	1868	0	124115
24906	3237	1402	382	118987	0	124008
24907	2031	417	307	116525	0	119280
24908	109635	244	203	3781	0	113863
24909	2413	108087	369	1859	0	112728
24910	1460	2282	129	108939	0	112810
24911	109960	1243	171	2690	0	114064
24912	2461	111882	267	1659	0	116269
24913	114607	2278	103	942	0	117930
24914	2895	1439	103770	619	0	108723
24915	106256	419	1758	623	0	109056
24916	2662	108451	1099	543	0	112755
24917	108949	2269	463	595	0	112276
24918	107979	1317	154	575	0	110025
24919	3519	108641	264	507	0	112931
24920	109537	2322	179	523	0	112561
24921	2826	107516	217	380	0	110939
24922	110242	2503	119	570	0	113434
24923	3061	1429	143	109202	0	113835
24924	1919	600	106	110560	0	113185
24925	1052	426	109	112404	0	113991
24926	770	633	106925	3683	0	112011
24927	948	421	2177	108113	0	111659
24928	835	540	108320	2740	0	112435
24929	935	444	2380	105766	0	109525
24930	789	107434	1371	2660	0	112254
24931	840	2505	334	109897	0	113576
24932	881	1626	107949	2722	0	113178
24933	810	851	110760	1660	0	114081
24934	831	526	3274	109942	0	114573
24935	109350	434	1466	2815	0	114065
24936	110666	461	537	1828	0	113492
24937	3884	109826	417	1051	0	115178
24938	2205	2563	276	111622	0	116666
24939	1152	1762	113536	2779	0	119229
24940	1080	719	2381	114849	0	119029
24941	947	688	114871	3063	0	119569
24942	111636	506	2648	1941	0	116731
24943	3300	619	1401	115253	0	120573
24944	2213	719	113010	2964	0	118906
24945	1363	578	2501	113475	0	117917
24946	1131	599	1428	116086	0	119244
24947	1069	652	113482	4266	0	119469
24948	1045	527	2606	114204	0	118382
24949	113871	473	1579	3531	0	119454
24950	115870	518	725	2264	0	119377
24951	4305	592	508	115456	0	120861
24952	116853	504	545	3388	0	121290
24953	3421	754	115773	2186	0	122134
24954	2132	669	115520	1338	0	119659
24955	115477	497	3975	1218	0	121167
24956	120458	458	1995	1246	0	124157
24957	4431	516	857	117179	0	122983
24958	2527	491	624	120199	0	123841
24959	1365	597	116673	4534	0	123169
24960	1381	605	2906	104794	0	109686
24961	980	117297	1966	3077	0	123320
24962	119294	2696	884	2101	0	124975
24963	126853	1632	778	1271	0	130534
24964	4689	126095	764	1240	0	132788
24965	122681	3048	644	1264	0	127637
24966	122443	1714	704	1260	0	126121
24967	4687	121970	902	1201	0	128760
24968	122177	3040	779	1341	0	127337
24969	3720	122953	986	1125	0	128784
24970	124314	3248	687	1366	0	129615
24971	4089	1972	122229	1039	0	129329
24972	2625	800	3181	122438	0	129044
24973	1523	549	1906	127598	0	131576
24974	1352	475	1006	133820	0	136653
24975	130542	440	777	5790	0	137549
24976	4229	419	706	136020	0	141374
24977	2738	610	133315	4363	0	141026
24978	133052	494	3655	2853	0	140054
24979	4488	481	2094	132478	0	139541
24980	2610	129001	1199	4253	0	137063
24981	1321	136156	1055	2741	0	141273
24982	1371	4697	834	131910	0	138812
24983	1449	2135	857	133234	0	137675
24984	1609	762	752	134766	0	137889
24985	1217	659	125195	5730	0	132801
24986	1157	123293	3612	2909	0	130971
24987	119191	2970	1822	1508	0	125491
24988	117129	1759	877	1237	0	121002
24989	4475	113410	877	1171	0	119933
24990	2291	116504	764	962	0	120521
24991	1652	4437	930	113123	0	120142
24992	1044	1811	112499	3291	0	118645
24993	107166	1070	2982	2266	0	113484
24994	111471	428	1524	1260	0	114683
24995	4030	320	793	109391	0	114534
24996	2065	323	538	110760	0	113686
24997	106353	319	506	4164	0	111342
24998	3016	467	105165	2169	0	110817
24999	101173	371	2536	1357	0	105437
25000	3015	101679	1597	930	0	107221
25001	1412	1877	406	88901	0	92596
25002	624	92080	433	2137	0	95274
25003	92864	1884	492	1450	0	96690
25004	2226	1008	382	91494	0	95110
25005	1393	426	339	90047	0	92205
25006	766	90207	429	2759	0	94161
25007	91189	1777	382	1436	0	94784
25008	92053	1006	285	887	0	94231
25009	2907	579	89890	650	0	94026
25010	1372	464	84441	593	0	86870
25011	83687	296	2239	638	0	86860
25012	2012	379	85129	510	0	88030
25013	1175	392	81067	466	0	83100
25014	80209	458	2398	628	0	83693
25015	1889	379	88860	522	0	91650
25016	1198	220	2254	87322	0	90994
25017	667	238	1123	90314	0	92342
25018	92929	237	502	3217	0	96885
25019	2624	408	93376	1549	0	97957
25020	96792	314	2411	810	0	100327
25021	3166	289	1315	95948	0	100718
25022	97101	307	577	2737	0	100722
25023	98267	240	356	1712	0	100575
25024	99829	254	275	946	0	101304
25025	4502	285	270	96586	0	101643
25026	98364	255	258	2951	0	101828
25027	3730	234	258	98068	0	102290
25028	2324	302	337	98963	0	101926
25029	1421	241	349	100252	0	102263
25030	1157	251	315	100581	0	102304
25031	97422	318	348	4451	0	102539
25032	99080	262	369	2291	0	102002
25033	4237	382	98266	1213	0	104098
25034	99846	229	2739	1050	0	103864
25035	102549	162	1557	997	0	105265
25036	4538	267	692	97694	0	103191
25037	2346	98029	581	3156	0	104112
25038	99597	2543	421	1878	0	104439
25039	3668	1452	427	96018	0	101565
25040	96048	526	467	3219	0	100260
25041	3547	94249	659	1916	0	100371
25042	96615	2599	419	1098	0	100731
25043	3755	1431	343	92902	0	98431
25044	2179	93040	522	3025	0	98766
25045	95065	2734	337	1981	0	100117
25046	3322	93797	524	1336	0	98979
25047	2014	98403	532	1132	0	102081
25048	98677	3793	496	1087	0	104053
25049	3420	1909	96479	1079	0	102887
25050	98682	852	2627	992	0	103153
25051	4132	519	1504	97663	0	103818
25052	2603	557	98207	3044	0	104411
25053	1947	480	2865	96590	0	101882
25054	1713	443	1601	100505	0	104262
25055	1602	475	97289	4572	0	103938
25056	97285	338	2998	2529	0	103150
25057	4183	311	1615	98795	0	104904
25058	2744	333	714	100731	0	104522
25059	1918	365	463	100341	0	103087
25060	97601	343	542	5405	0	103891
25061	3746	481	94883	3062	0	102172
25062	2441	449	94797	1842	0	99529
25063	1565	406	3395	87807	0	93173
25064	1452	390	88274	3144	0	93260
25065	86247	331	2820	2124	0	91522
25066	3129	87055	1805	1306	0	93295
25067	87976	2284	1009	971	0	92240
25068	3689	1365	686	83308	0	89048
25069	2243	85543	735	2753	0	91274
25070	1718	2837	551	84119	0	89225
25071	1372	87137	632	3042	0	92183
25072	1511	2910	408	87707	0	92536
25073	1336	1674	84740	3242	0	90992
25074	1124	1019	80278	1974	0	84395
25075	1106	80566	2994	1497	0	86163
25076	76253	2072	1619	1283	0	81227
25077	2509	1430	782	74865	0	79586
25078	1911	861	507	76306	0	79585
25079	75915	683	484	3213	0	80295
25080	76236	622	612	2000	0	79470
25081	3611	422	649	75077	0	79759
25082	2210	481	74039	2478	0	79208
25083	1474	73521	2269	1781	0	79045
25084	1258	1891	1454	74000	0	78603
25085	1203	1223	982	71912	0	75320
25086	1050	75819	763	3238	0	80870
25087	76721	2062	629	2195	0	81607
25088	2559	1513	76668	1366	0	82106
25089	1972	782	2109	76060	0	80923
25090	1181	669	1335	76650	0	79835
25091	951	719	75163	3790	0	80623
25092	1105	547	2188	76997	0	80837
25093	77815	521	1571	3138	0	83045
25094	78182	503	1124	2215	0	82024
25095	79455	480	941	1656	0	82532
25096	3555	77291	945	1486	0	83277
25097	83409	2061	844	1258	0	87572
25098	3395	1348	702	82138	0	87583
25099	2304	910	681	80167	0	84062
25100	1574	88750	734	3604	0	94662
25101	94835	2546	599	2416	0	100396
25102	99019	1750	623	1539	0	102931
25103	100216	1036	655	1447	0	103354
25104	103232	868	632	1455	0	106187
25105	103026	692	642	1546	0	105906
25106	4919	752	99424	1202	0	106297
25107	101849	754	3008	1082	0	106693
25108	103879	774	1786	1138	0	107577
25109	103020	527	988	1235	0	105770
25110	5172	464	832	99717	0	106185
25111	3052	496	685	100861	0	105094
25112	1940	552	96449	4363	0	103304
25113	79700	651	2805	2714	0	85870
25114	2983	94170	1839	1856	0	100848
25115	1718	86050	824	1013	0	89605
25116	1274	2489	87025	780	0	91568
25117	900	86987	1965	843	0	90695
25118	794	85939	1214	752	0	88699
25119	1479	3172	939	73783	0	79373
25120	510	79716	424	1540	0	82190
25121	79355	1687	214	1083	0	82339
25122	78780	933	240	653	0	80606
25123	2489	412	262	77379	0	80542
25124	1390	444	76516	1580	0	79930
25125	74579	297	1534	1104	0	77514
25126	1991	374	77165	666	0	80196
25127	1351	264	77746	576	0	79937
25128	898	250	2128	73404	0	76680
25129	860	207	1036	76821	0	78924
25130	741	237	77216	2219	0	80413
25131	637	74754	1585	1231	0	78207
25132	593	80429	942	730	0	82694
25133	78524	1948	554	713	0	81739
25134	79242	883	295	545	0	80965
25135	2277	457	77532	371	0	80637
25136	76338	277	1269	454	0	78338
25137	81681	271	744	510	0	83206
25138	2282	353	312	79392	0	82339
25139	1430	246	213	81548	0	83437
25140	944	279	179	82377	0	83779
25141	82212	262	178	2141	0	84793
25142	83744	262	183	1115	0	85304
25143	85011	195	205	570	0	85981
25144	2762	186	240	83619	0	86807
25145	1692	279	81985	1392	0	85348
25146	80591	159	1306	928	0	82984
25147	81423	161	810	539	0	82933
25148	2471	209	478	78772	0	81930
25149	1504	80182	415	1441	0	83542
25150	1080	1224	267	79537	0	82108
25151	760	80853	338	1602	0	83553
25152	736	1505	295	77981	0	80517
25153	623	80922	405	1597	0	83547
25154	79356	1349	298	923	0	81926
25155	1626	960	262	79151	0	81999
25156	1032	79332	336	1330	0	82030
25157	670	1425	78221	742	0	81058
25158	75474	899	1276	540	0	78189
25159	1540	489	700	78235	0	80964
25160	948	78777	416	1311	0	81452
25161	703	1317	249	76726	0	78995
25162	541	76419	316	1334	0	78610
25163	596	80534	314	801	0	82245
25164	80376	1655	307	642	0	82980
25165	81237	892	376	490	0	82995
25166	1921	596	81291	330	0	84138
25167	80536	294	1294	447	0	82571
25168	81828	287	830	445	0	83390
25169	1822	81343	483	402	0	84050
25170	1111	1254	313	82012	0	84690
25171	804	745	275	81873	0	83697
25172	667	518	80611	1666	0	83462
25173	671	468	78449	842	0	80430
25174	79840	259	1704	533	0	82336
25175	82566	216	870	432	0	84084
25176	82682	180	491	467	0	83820
25177	2162	243	80691	390	0	83486
25178	1313	186	1219	79817	0	82535
25179	81298	187	698	1511	0	83694
25180	1523	212	347	81461	0	83543
25181	974	281	80125	1521	0	82901
25182	75180	255	1194	961	0	77590
25183	1629	400	83013	476	0	85518
25184	1007	81777	1290	403	0	84477
25185	82919	1089	730	490	0	85228
25186	1516	763	81895	372	0	84546
25187	1090	349	1167	80602	0	83208
25188	81994	236	648	1371	0	84249
25189	1473	251	278	82864	0	84866
25190	83971	263	203	1580	0	86017
25191	1539	297	159	83124	0	85119
25192	85291	277	179	1685	0	87432
25193	84813	284	187	1039	0	86323
25194	84669	283	184	609	0	85745
25195	83367	236	204	453	0	84260
25196	2164	364	256	82670	0	85454
25197	971	294	79528	1091	0	81884
25198	689	277	79696	660	0	81322
25199	438	79143	1373	450	0	81404
25200	249	72591	572	245	0	73657
25201	66808	619	1041	197	0	68665
25202	440	219	96	64617	0	65372
25203	238	124	64802	336	0	65500
25204	163	136	64123	232	0	64654
25205	179	128	489	65028	0	65824
25206	65379	53	243	408	0	66083
25207	323	66004	122	235	0	66684
25208	70094	288	44	336	0	70762
25209	388	171	63	71183	0	71805
25210	273	59	66	71335	0	71733
25211	152	39	67	71411	0	71669
25212	126	118	71417	477	0	72138
25213	133	128	70386	255	0	70902
25214	100	70709	486	137	0	71432
25215	142	314	206	72785	0	73447
25216	71195	181	85	465	0	71926
25217	394	133	69352	235	0	70114
25218	279	140	70606	132	0	71157
25219	169	63	536	71630	0	72398
25220	142	51	248	74136	0	74577
25221	124	56	98	74919	0	75197
25222	132	70	77	81290	0	81569
25223	81564	61	82	1003	0	82710
25224	761	45	88	82051	0	82945
25225	81602	58	108	873	0	82641
25226	825	126	82336	406	0	83693
25227	376	82912	755	209	0	84252
25228	238	707	342	83110	0	84397
25229	175	412	84630	771	0	85988
25230	160	176	83983	445	0	84764
25231	154	86653	1055	257	0	88119
25232	196	650	393	84075	0	85314
25233	170	349	149	84841	0	85509
25234	136	177	85723	1014	0	87050
25235	81592	67	842	538	0	83039
25236	807	70	409	86229	0	87515
25237	433	76	164	84133	0	84806
25238	194	151	85739	1118	0	87202
25239	96	85079	985	594	0	86754
25240	82	91485	511	257	0	92335
25241	91439	1361	159	323	0	93282
25242	1203	506	127	91697	0	93533
25243	94428	154	145	1347	0	96074
25244	1431	155	93695	663	0	95944
25245	769	105	1253	93645	0	95772
25246	93999	97	639	1487	0	96222
25247	95094	87	235	831	0	96247
25248	1896	88	143	94574	0	96701
25249	823	187	93590	1390	0	95990
25250	317	172	96211	737	0	97437
25251	281	257	1816	95760	0	98114
25252	235	173	97312	1356	0	99076
25253	91273	96	1385	891	0	93645
25254	1327	95396	756	522	0	98001
25255	97488	1211	343	442	0	99484
25256	98611	621	264	506	0	100002
25257	2000	220	250	98577	0	101047
25258	839	181	326	99970	0	101316
25259	99771	221	205	2064	0	102261
25260	1438	171	249	100287	0	102145
25261	813	275	99623	1576	0	102287
25262	376	100906	1480	861	0	103623
25263	357	1384	727	100034	0	102502
25264	385	663	304	100134	0	101486
25265	448	271	262	100710	0	101691
25266	373	232	97706	2236	0	100547
25267	443	96901	1492	1220	0	100056
25268	447	1313	819	98323	0	100902
25269	398	752	97606	1798	0	100554
25270	464	311	1550	97254	0	99579
25271	97219	276	858	1857	0	100210
25272	1670	260	471	98179	0	100580
25273	998	285	96856	1781	0	99920
25274	94559	174	1591	1302	0	97626
25275	1617	99239	1034	665	0	102555
25276	874	101837	673	651	0	104035
25277	103132	1795	410	838	0	106175
25278	1814	966	104845	571	0	108196
25279	1223	308	1596	103697	0	106824
25280	748	245	908	106993	0	108894
25281	499	387	107686	2292	0	110864
25282	457	107484	1739	1401	0	111081
25283	622	1442	968	97554	0	100586
25284	551	876	105488	1811	0	108726
25285	591	351	1646	104782	0	107370
25286	104904	376	983	2131	0	108394
25287	1742	463	108086	1275	0	111566
25288	1182	371	1597	108755	0	111905
25289	680	348	840	110239	0	112107
25290	577	430	107837	2580	0	111424
25291	708	286	1684	102567	0	105245
25292	527	99141	1183	2224	0	103075
25293	766	1514	766	97390	0	100436
25294	495	106763	654	1892	0	109804
25295	106571	1512	570	1433	0	110086
25296	101834	852	602	1053	0	104341
25297	2210	492	103540	921	0	107163
25298	1155	503	101085	818	0	103561
25299	714	523	100597	819	0	102653
25300	578	100942	2394	902	0	104816
25301	662	1538	1309	103827	0	107336
25302	699	887	105934	1906	0	109426
25303	774	479	1784	101642	0	104679
25304	628	369	1031	105082	0	107110
25305	656	472	105669	2469	0	109266
25306	745	406	1714	105410	0	108275
25307	539	427	1032	103298	0	105296
25308	567	101497	873	2539	0	105476
25309	725	1455	662	103277	0	106119
25310	577	853	672	105273	0	107375
25311	538	557	104375	2705	0	108175
25312	644	367	1743	102349	0	105103
25313	558	442	104644	2332	0	107976
25314	452	593	101099	1629	0	103773
25315	97915	347	2285	1301	0	101848
25316	1688	548	1296	97710	0	101242
25317	929	104836	857	2130	0	108752
25318	665	105990	776	1443	0	108874
25319	686	2299	797	104979	0	108761
25320	619	1053	105834	2209	0	109715
25321	540	105225	1965	1698	0	109428
25322	623	1388	984	99469	0	102464
25323	465	877	104001	1687	0	107030
25324	393	106574	1460	1180	0	109607
25325	114549	1295	1027	1018	0	117889
25326	114199	798	693	904	0	116594
25327	111528	431	512	1111	0	113582
25328	1974	365	496	121113	0	123948
25329	984	358	579	120922	0	122843
25330	522	372	479	118919	0	120292
25331	387	497	116243	2669	0	119796
25332	114390	407	1797	1617	0	118211
25333	1847	335	1108	113536	0	116826
25334	1039	447	111890	1835	0	115211
25335	116449	355	1642	1391	0	119837
25336	120157	319	1056	1086	0	122618
25337	2463	721	94297	941	0	98422
25338	115884	258	1249	946	0	118337
25339	1570	122365	889	866	0	125690
25340	852	1153	119354	524	0	121883
25341	113925	666	1444	692	0	116727
25342	1098	118026	867	619	0	120610
25343	582	911	331	113262	0	115086
25344	195	116488	376	1105	0	118164
25345	247	1001	227	117523	0	118998
25346	227	631	117634	1154	0	119646
25347	103234	181	1253	959	0	105627
25348	1034	327	117952	515	0	119828
25349	526	115302	1196	469	0	117493
25350	185	115812	719	365	0	117081
25351	113649	1343	273	432	0	115697
25352	1040	709	113662	300	0	115711
25353	596	224	1153	111912	0	113885
25354	305	295	113600	1193	0	115393
25355	183	114622	1231	809	0	116845
25356	475	1033	669	102767	0	104944
25357	138	114370	418	980	0	115906
25358	115958	1078	316	774	0	118126
25359	116798	565	255	530	0	118148
25360	116495	257	255	517	0	117524
25361	1539	352	114683	365	0	116939
25362	654	396	109783	329	0	111162
25363	109637	142	1578	497	0	111854
25364	1190	294	117270	339	0	119093
25365	789	181	1320	107141	0	109431
25366	203	116229	798	1134	0	118364
25367	118908	1099	428	837	0	121272
25368	118976	572	324	540	0	120412
25369	122072	209	289	638	0	123208
25370	1763	156	291	121871	0	124081
25371	768	161	265	123034	0	124228
25372	121687	164	283	2021	0	124155
25373	1218	121114	385	936	0	123653
25374	120124	1128	225	592	0	122069
25375	1310	543	180	118264	0	120297
25376	714	196	173	119111	0	120194
25377	115721	153	184	1855	0	117913
25378	1133	114346	276	785	0	116540
25379	115043	1125	209	511	0	116888
25380	1259	116055	285	383	0	117982
25381	114284	1175	214	329	0	116002
25382	1415	605	149	121983	0	124152
25383	123457	206	203	1334	0	125200
25384	128931	172	162	787	0	130052
25385	137089	172	122	441	0	137824
25386	2172	140978	268	329	0	143747
25387	991	1828	136223	212	0	139254
25388	134982	844	1698	300	0	137824
25389	139841	241	779	356	0	141217
25390	2396	138352	378	232	0	141358
25391	1194	1680	237	139337	0	142448
25392	563	831	158	140079	0	141631
25393	139333	293	183	2549	0	142358
25394	2037	204	150	141464	0	143855
25395	1112	317	141291	1935	0	144655
25396	539	309	139029	1012	0	140889
25397	142433	145	2482	583	0	145643
25398	2102	135	956	144384	0	147577
25399	1212	145	295	146499	0	148151
25400	591	146	231	148582	0	149550
25401	440	307	149266	2865	0	152878
25402	516	196	1915	147187	0	149814
25403	574	164	959	151449	0	153146
25404	550	159	310	152882	0	153901
25405	149610	185	218	3175	0	153188
25406	2434	194	238	151047	0	153913
25407	1320	443	151607	2384	0	155754
25408	152210	251	2155	1480	0	156096
25409	2610	429	158430	615	0	162084
25410	157470	257	2495	611	0	160833
25411	151969	349	1344	561	0	154223
25412	3878	301	383	161819	0	166381
25413	1716	162899	479	2871	0	167965
25414	991	2449	288	164260	0	167988
25415	788	1830	335	163250	0	166203
25416	558	166392	573	3850	0	171373
25417	163660	2385	440	1829	0	168314
25418	2615	163657	588	846	0	167706
25419	163736	2546	389	893	0	167564
25420	164700	1273	303	938	0	167214
25421	3955	427	304	162823	0	167509
25422	1891	324	334	163555	0	166104
25423	782	401	156536	3963	0	161682
25424	665	380	147185	2045	0	150275
25425	142806	291	3304	1243	0	147644
25426	148404	173	1521	1095	0	151193
25427	3444	142117	746	966	0	147273
25428	1843	1993	479	138643	0	142958
25429	1019	1156	145396	2506	0	150077
25430	972	1519	2375	144972	0	149838
25431	143913	353	1542	2842	0	148650
25432	141670	260	577	1688	0	144195
25433	3276	142716	536	925	0	147453
25434	1830	2100	313	142890	0	147133
25435	1026	1222	317	144652	0	147217
25436	904	561	279	144702	0	146446
25437	774	670	137449	3571	0	142464
25438	119200	485	2118	2188	0	123991
25439	132611	491	1184	1155	0	135441
25440	3689	578	133547	969	0	138783
25441	1889	133164	2231	976	0	138260
25442	133895	2071	1222	1079	0	138267
25443	134755	1141	622	1125	0	137643
25444	3544	603	131052	1059	0	136258
25445	1980	585	135777	998	0	139340
25446	1343	490	3058	135115	0	140006
25447	1121	585	137686	2372	0	141764
25448	132877	484	2389	1676	0	137426
25449	137177	427	1351	1136	0	140091
25450	138406	479	717	1129	0	140731
25451	3698	444	619	129630	0	134391
25452	2008	140639	761	2423	0	145831
25453	143237	1958	616	1912	0	147723
25454	142650	1262	669	1230	0	145811
25455	3759	813	141091	1200	0	146863
25456	2190	687	136612	1038	0	140527
25457	129172	473	2921	1314	0	133880
25458	2926	454	1489	140126	0	144995
25459	1965	667	139857	2686	0	145175
25460	1308	138844	2497	1977	0	144626
25461	1493	2062	1566	139668	0	144789
25462	139076	1267	892	2648	0	143883
25463	2801	141812	958	1766	0	147337
25464	2172	2134	751	137535	0	142592
25465	1367	138323	961	2425	0	143076
25466	1234	141643	1010	1875	0	145762
25467	1436	2713	944	141639	0	146732
25468	1351	1406	880	140854	0	144491
25469	1244	142529	977	3322	0	148072
25470	141795	2175	774	1994	0	146738
25471	3157	1591	142914	1059	0	148721
25472	137713	743	2312	1354	0	142122
25473	3367	641	1437	146444	0	151889
25474	2360	589	860	147530	0	151339
25475	1647	588	853	148743	0	151831
25476	1632	548	914	148164	0	151258
25477	1525	667	148087	3494	0	153773
25478	1609	534	2547	149258	0	153948
25479	1425	670	1661	149441	0	153197
25480	1273	157526	1062	3734	0	163595
25481	1253	2562	159849	2158	0	165822
25482	1020	163836	2943	1545	0	169344
25483	1422	2893	164693	1237	0	170245
25484	1114	162692	2856	1094	0	167756
25485	1795	2718	1881	148058	0	154452
25486	146680	1375	703	2324	0	151082
25487	2396	148924	783	1831	0	153934
25488	1884	2221	580	150286	0	154971
25489	1095	1528	151217	2433	0	156273
25490	816	153934	2437	1737	0	158924
25491	153006	2272	1617	1083	0	157978
25492	152915	1571	864	1009	0	156359
25493	3241	154669	901	823	0	159634
25494	1917	2393	151034	720	0	156064
25495	144624	1524	2309	795	0	149252
25496	2712	838	1409	153815	0	158774
25497	151985	641	705	2792	0	156123
25498	2593	155061	729	1962	0	160345
25499	1714	159044	670	1125	0	162553
25500	1124	3396	154809	942	0	160271
25501	145710	1741	2346	878	0	150675
25502	2810	1126	1465	153267	0	158668
25503	154066	624	698	2559	0	157947
25504	2373	155563	781	1622	0	160339
25505	155658	2218	658	1121	0	159655
25506	154228	1475	605	943	0	157251
25507	3349	861	155452	824	0	160486
25508	1495	148694	1916	625	0	152730
25509	740	151766	1241	629	0	154376
25510	729	2869	526	141450	0	145574
25511	455	144261	516	1587	0	146819
25512	143031	1860	430	1189	0	146510
25513	1714	144509	416	633	0	147272
25514	1223	2097	255	140993	0	144568
25515	633	141320	356	1507	0	143816
25516	571	138665	379	942	0	140557
25517	656	142047	390	517	0	143610
25518	785	2643	465	140061	0	143954
25519	607	1309	292	142036	0	144244
25520	541	767	283	140771	0	142362
25521	516	138098	343	2435	0	141392
25522	683	1979	135896	1200	0	139758
25523	641	1389	134773	562	0	137365
25524	130428	869	2111	610	0	134018
25525	1847	743	997	137052	0	140639
25526	1177	897	137950	1676	0	141700
25527	787	900	138221	1107	0	141015
25528	554	141944	2239	657	0	145394
25529	676	1977	1047	132392	0	136092
25530	595	1330	434	136865	0	139224
25531	135921	819	379	2634	0	139753
25532	1772	765	388	136266	0	139191
25533	1197	727	455	135961	0	138340
25534	689	889	136768	2513	0	140859
25535	634	763	1653	134844	0	137894
25536	659	744	1066	141364	0	143833
25537	565	946	140539	2541	0	144591
25538	557	805	140883	1472	0	143717
25539	465	139281	2439	1037	0	143222
25540	584	2128	139392	842	0	142946
25541	595	1427	1854	136135	0	140011
25542	853	1131	1391	109776	0	113151
25543	721	854	140429	2708	0	144712
25544	454	139772	1878	1765	0	143869
25545	131618	1945	1285	1256	0	136104
25546	1508	135283	902	1051	0	138744
25547	1158	2089	738	134776	0	138761
25548	692	1477	761	136263	0	139193
25549	434	136382	938	2950	0	140704
25550	593	2109	790	136973	0	140465
25551	529	1465	725	138045	0	140764
25552	581	1052	130300	3019	0	134952
25553	468	129795	2006	2051	0	134320
25554	570	2136	1315	131193	0	135214
25555	610	1586	129939	2425	0	134560
25556	733	943	1908	129103	0	132687
25557	713	860	1304	129948	0	132825
25558	706	761	855	132377	0	134699
25559	676	777	790	132118	0	134361
25560	671	816	745	128374	0	130606
25561	565	131088	882	3080	0	135615
25562	127657	1974	840	2079	0	132550
25563	1800	1644	127614	1532	0	132590
25564	108085	918	2167	1505	0	112675
25565	1802	977	132051	1176	0	136006
25566	1049	138116	2213	1391	0	142769
25567	779	2227	136008	1254	0	140268
25568	430	138000	2306	1563	0	142299
25569	794	2373	1568	120830	0	125565
25570	696	2033	781	125733	0	129243
25571	523	131515	696	3035	0	135769
25572	432	137083	771	1912	0	140198
25573	136004	2892	669	1386	0	140951
25574	137714	1644	647	1381	0	141386
25575	138429	890	687	1262	0	141268
25576	139122	748	738	1263	0	141871
25577	2965	860	681	134572	0	139078
25578	1277	134939	755	2210	0	139181
25579	132224	1965	584	1816	0	136589
25580	1716	1175	474	126196	0	129561
25581	122236	610	457	1901	0	125204
25582	117445	409	388	1481	0	119723
25583	1798	114850	468	798	0	117914
25584	771	112588	399	561	0	114319
25585	378	117348	416	541	0	118683
25586	464	2450	405	109759	0	113078
25587	287	116709	449	1264	0	118709
25588	116759	1217	296	989	0	119261
25589	120046	755	255	762	0	121818
25590	119003	360	271	617	0	120251
25591	120854	310	263	616	0	122043
25592	121629	319	255	623	0	122826
25593	2076	442	124703	414	0	127635
25594	124307	308	1539	550	0	126704
25595	1752	441	126063	362	0	128618
25596	123696	229	1445	550	0	125920
25597	1728	264	837	125232	0	128061
25598	1041	414	119030	1509	0	121994
25599	536	367	129244	908	0	131055
25600	367	137732	2138	490	0	140727
25601	138568	1846	1142	598	0	142154
25602	141794	956	351	489	0	143590
25603	2867	153813	365	369	0	157414
25604	1447	2418	214	174417	0	178496
25605	186751	1296	206	3370	0	191623
25606	3847	641	189887	1763	0	196138
25607	1994	188904	3529	704	0	195131
25608	183781	3559	1796	644	0	189780
25609	3559	189018	717	474	0	193768
25610	2278	4021	319	174652	0	181270
25611	828	190143	483	3127	0	194581
25612	792	4380	273	177285	0	182730
25613	609	185560	414	3473	0	190056
25614	491	192094	390	1990	0	194965
25615	187147	5356	282	964	0	193749
25616	190300	2567	302	763	0	193932
25617	5473	1185	188338	589	0	195585
25618	2742	999	185910	468	0	190119
25619	1185	1006	190296	419	0	192906
25620	1008	778	5623	187329	0	194738
25621	933	893	192555	3730	0	198111
25622	929	816	4274	189222	0	195241
25623	914	772	2431	189500	0	193617
25624	777	190776	1180	5518	0	198251
25625	189344	4077	710	2895	0	197026
25626	3930	193579	904	1358	0	199771
25627	2755	4490	652	196357	0	204254
25628	1395	2578	710	199291	0	203974
25629	1292	1262	736	201098	0	204388
25630	1252	1223	197832	6157	0	206464
25631	1348	1057	4138	197723	0	204266
25632	1371	1060	2422	200414	0	205267
25633	1224	1059	996	203998	0	207277
25634	1113	1454	194914	6593	0	204074
25635	914	195129	4085	3517	0	203645
25636	192217	4534	2256	2066	0	201073
25637	184751	2874	1018	1804	0	190447
25638	5647	192691	983	1562	0	200883
25639	3190	4588	806	191565	0	200149
25640	1662	3037	882	197432	0	203013
25641	1503	1703	193177	6288	0	202671
25642	1220	192213	4520	3813	0	201766
25643	1369	4517	2745	193225	0	201856
25644	1279	2955	194302	4973	0	203509
25645	1407	1572	4475	192951	0	200405
25646	1346	1313	2833	194655	0	200147
25647	1359	1565	193180	6700	0	202804
25648	1456	1344	4474	192418	0	199692
25649	1412	1314	2859	192694	0	198279
25650	1406	1507	194441	6893	0	204247
25651	1280	1290	4565	195351	0	202486
25652	1350	1236	2998	192972	0	198556
25653	1136	1105	1660	199236	0	203137
25654	910	1347	193895	7748	0	203900
25655	1092	1081	4851	194711	0	201735
25656	190533	1094	2999	6444	0	201070
25657	190913	996	1706	4535	0	198150
25658	5902	189605	1639	4179	0	201325
25659	193256	4205	1393	2722	0	201576
25660	4899	2992	197919	2469	0	208279
25661	3220	1400	4600	198383	0	207603
25662	1798	1171	2987	199110	0	205066
25663	1531	1285	1597	204777	0	209190
25664	195288	1087	1305	7824	0	205504
25665	4104	195244	1555	5135	0	206038
25666	2538	4256	1259	180530	0	188583
25667	1220	189059	1387	5323	0	196989
25668	185113	4338	1232	4050	0	194733
25669	3918	188306	1472	2692	0	196388
25670	184167	4432	1093	2741	0	192433
25671	4098	183716	1342	2648	0	191804
25672	2464	184182	1493	2518	0	190657
25673	1523	5911	1275	182139	0	190848
25674	1158	2943	1141	184930	0	190172
25675	1205	1560	1223	185485	0	189473
25676	1117	1415	1074	185444	0	189050
25677	1093	1641	178499	7321	0	188554
25678	1043	178200	4171	4539	0	187953
25679	1246	4133	2436	168124	0	175939
25680	981	177196	1636	5242	0	185055
25681	1241	4552	176044	3759	0	185596
25682	1378	2714	4089	174058	0	182239
25683	1348	1598	2569	181532	0	187047
25684	1248	1337	177002	6788	0	186375
25685	921	173822	4459	4632	0	183834
25686	1013	3821	2809	174088	0	181731
25687	1157	2592	172655	5775	0	182179
25688	770	172488	4413	4424	0	182095
25689	971	4162	2484	169554	0	177171
25690	975	2856	169276	5287	0	178394
25691	1022	1848	165892	3737	0	172499
25692	840	163206	5212	2612	0	171870
25693	944	176794	2712	2188	0	182638
25694	1210	5528	1779	176576	0	185093
25695	1183	3137	1092	188136	0	193548
25696	801	1890	184840	6907	0	194438
25697	176350	1357	4190	4463	0	186360
25698	180262	1317	2717	2834	0	187130
25699	5680	1399	175700	2296	0	185075
25700	2615	166679	3927	2195	0	175416
25701	1092	166230	2641	1905	0	171868
25702	898	163975	1404	1646	0	167923
25703	1253	134073	1659	2009	0	138994
25704	3155	6462	2409	126233	0	138259
25705	468	1365	401	150885	0	153119
25706	366	516	160	151382	0	152424
25707	305	390	179	152190	0	153064
25708	110	150326	362	5104	0	155902
25709	341	3031	196	150827	0	154395
25710	154	150942	351	3614	0	155061
25711	302	3361	204	153471	0	157338
25712	149606	1968	204	3868	0	155646
25713	2985	750	213	152310	0	156258
25714	1801	149674	326	4172	0	155973
25715	896	3114	240	155583	0	159833
25716	637	1973	237	158854	0	161701
25717	566	843	209	160180	0	161798
25718	150912	593	248	6187	0	157940
25719	3206	768	207	156899	0	161080
25720	1985	803	150812	4520	0	158120
25721	669	153680	3100	3040	0	160489
25722	671	3515	1829	157962	0	163977
25723	756	2186	604	162441	0	165987
25724	653	1022	335	165099	0	167109
25725	155334	845	289	6500	0	162968
25726	3550	946	154131	3638	0	162265
25727	2300	758	3142	147399	0	153599
25728	797	151072	2008	4640	0	158517
25729	850	3715	612	154125	0	159302
25730	143055	2451	336	5289	0	151131
25731	3175	148464	614	3668	0	155921
25732	2170	3968	330	150111	0	156579
25733	921	2545	245	151174	0	154885
25734	558	147603	450	6952	0	155563
25735	772	3839	259	153379	0	158249
25736	886	2529	304	155293	0	159012
25737	734	1439	149275	7005	0	158453
25738	474	149510	3547	4676	0	158207
25739	150114	4079	2079	3011	0	159283
25740	3865	2818	149514	2664	0	158861
25741	147577	1281	3548	2797	0	155203
25742	4420	1290	149312	2662	0	157684
25743	2793	1076	3951	150125	0	157945
25744	148712	965	2322	6162	0	158161
25745	4306	1214	963	152080	0	158563
25746	152333	1073	678	6658	0	160742
25747	153053	1244	620	4735	0	159652
25748	151414	1258	838	3288	0	156798
25749	6203	149204	933	2690	0	159030
25750	3554	4341	682	149464	0	158041
25751	1883	2799	813	153735	0	159230
25752	1716	1450	728	155053	0	158947
25753	1410	1378	148274	8060	0	159122
25754	1574	1110	4001	152097	0	158782
25755	150311	1128	2579	6544	0	160562
25756	153295	1151	1232	5036	0	160714
25757	6593	1306	148793	3316	0	160008
25758	152071	1237	4030	2863	0	160201
25759	154405	1223	2778	2843	0	161249
25760	6881	1436	1304	144753	0	154374
25761	144861	1262	988	6371	0	153482
25762	146148	1224	950	5053	0	153375
25763	7105	1153	969	144319	0	153546
25764	145341	1045	1222	6244	0	153852
25765	145557	1164	1237	4723	0	152681
25766	7355	1259	1149	142901	0	152664
25767	4650	1476	123291	5875	0	135292
25768	136711	1243	3799	4580	0	146333
25769	5602	1192	141698	3113	0	151605
25770	4304	1165	141059	2899	0	149427
25771	2751	139508	6161	3063	0	151483
25772	2888	4074	3204	138784	0	148950
25773	2842	2741	1392	143746	0	150721
25774	2882	1229	1154	144695	0	149960
25775	2777	1123	140574	8163	0	152637
25776	2901	1080	140439	5046	0	149466
25777	2539	140636	6216	3410	0	152801
25778	2865	4041	3316	137216	0	147438
25779	2827	2524	1835	143228	0	150414
25780	2808	1141	1548	146394	0	151891
25781	2847	875	140263	8088	0	152073
25782	2574	138059	4804	5462	0	150899
25783	3016	3903	3030	137836	0	147785
25784	2909	2612	141127	6006	0	152654
25785	2902	1287	141747	4693	0	150629
25786	140082	869	6481	3209	0	150641
25787	141566	898	3755	2846	0	149065
25788	144559	1024	1821	2894	0	150298
25789	7844	889	1637	134668	0	145038
25790	4733	942	137303	6050	0	149028
25791	2867	134241	4766	4978	0	146852
25792	2586	139678	3672	3344	0	149280
25793	2644	5031	123269	2511	0	133455
25794	2921	4353	4337	111009	0	122620
25795	2667	1722	3167	103113	0	110669
25796	2085	103695	2254	5063	0	113097
25797	2167	109357	1837	3295	0	116656
25798	107879	4203	1555	2364	0	116001
25799	109367	2091	1394	2231	0	115083
25800	110012	1000	1319	2280	0	114611
25801	107719	827	1363	2242	0	112151
25802	100406	1107	1182	2127	0	104822
25803	5161	94402	1405	2029	0	102997
25804	1904	71603	941	1216	0	75664
25805	985	61552	776	917	0	64230
25806	59033	1628	2362	1000	0	64023
25807	2309	1069	1304	56357	0	61039
25808	1085	268	480	56597	0	58430
25809	55640	204	604	1921	0	58369
25810	1423	55672	633	1126	0	58854
25811	1094	1003	544	56215	0	58856
25812	911	621	519	57231	0	59282
25813	957	300	563	57234	0	59054
25814	54661	243	501	1709	0	57114
25815	1560	278	458	55503	0	57799
25816	1126	342	52813	1263	0	55544
25817	51940	285	1008	933	0	54166
25818	1568	277	644	53686	0	56175
25819	1028	299	53856	1218	0	56401
25820	741	53356	1067	951	0	56115
25821	486	52261	549	432	0	53728
25822	50564	1144	917	432	0	53057
25823	50863	486	363	311	0	52023
25824	1206	54106	222	249	0	55783
25825	626	816	149	57622	0	59213
25826	58692	444	129	1258	0	60523
25827	1185	152	152	62179	0	63668
25828	826	128	140	64345	0	65439
25829	399	137	158	65038	0	65732
25830	323	124	150	64403	0	65000
25831	212	62451	199	2109	0	64971
25832	263	1012	150	64078	0	65503
25833	224	694	147	64149	0	65214
25834	281	273	121	65175	0	65850
25835	239	215	61871	2081	0	64406
25836	158	62151	1157	1183	0	64649
25837	248	1232	763	62207	0	64450
25838	227	774	61467	1330	0	63798
25839	266	354	59040	942	0	60602
25840	152	61535	1750	481	0	63918
25841	60915	1212	984	421	0	63532
25842	1171	785	327	61814	0	64097
25843	61811	306	212	1382	0	63711
25844	1304	62322	217	952	0	64795
25845	891	1228	142	62946	0	65207
25846	60682	803	139	1495	0	63119
25847	62012	347	156	1101	0	63616
25848	1921	258	131	61723	0	64033
25849	1093	202	127	61740	0	63162
25850	482	278	60497	2132	0	63389
25851	380	162	1157	60778	0	62477
25852	345	349	764	62289	0	63747
25853	60096	214	299	2225	0	62834
25854	1233	60108	241	1365	0	62947
25855	828	1210	58991	719	0	61748
25856	56758	766	1095	662	0	59281
25857	1251	59295	759	542	0	61847
25858	870	1178	314	59911	0	62273
25859	59549	796	247	1470	0	62062
25860	1256	369	202	59453	0	61280
25861	870	269	203	59994	0	61336
25862	435	340	58142	2129	0	61046
25863	382	236	1110	59412	0	61140
25864	58732	239	736	1843	0	61550
25865	1366	227	301	59758	0	61652
25866	58402	258	221	1813	0	60694
25867	1440	56594	241	1346	0	59621
25868	962	58923	256	871	0	61012
25869	605	1677	210	59080	0	61572
25870	444	954	221	59860	0	61479
25871	57252	455	214	2293	0	60214
25872	1298	57021	286	1528	0	60133
25873	58249	1245	246	989	0	60729
25874	58375	861	257	830	0	60323
25875	2020	451	247	57593	0	60311
25876	58089	371	239	1709	0	60408
25877	1684	379	55126	1242	0	58431
25878	1218	361	1207	55868	0	58654
25879	688	376	56896	1718	0	59678
25880	604	321	1357	57737	0	60019
25881	56919	302	893	1983	0	60097
25882	57334	311	403	1501	0	59549
25883	2032	56939	329	1081	0	60381
25884	1328	1311	270	56608	0	59517
25885	788	880	246	57066	0	58980
25886	622	56689	329	2379	0	60019
25887	676	1367	228	58845	0	61116
25888	618	896	226	57893	0	59633
25889	525	56915	312	2429	0	60181
25890	55179	1329	234	1608	0	58350
25891	55470	937	235	1144	0	57786
25892	2153	529	252	55059	0	57993
25893	1331	430	276	55896	0	57933
25894	824	496	53913	2426	0	57659
25895	789	436	1215	53109	0	55549
25896	693	53421	889	1907	0	56910
25897	54553	1269	461	1503	0	57786
25898	1574	879	314	54676	0	57443
25899	1177	499	286	54498	0	56460
25900	52499	376	288	2488	0	55651
25901	1553	52498	333	1626	0	56010
25902	1266	1281	243	54238	0	57028
25903	817	911	239	53507	0	55474
25904	691	53039	356	2295	0	56381
25905	53513	1359	310	1530	0	56712
25906	1633	1044	52192	1070	0	55939
25907	1102	574	52568	977	0	55221
25908	785	433	1759	52768	0	55745
25909	626	497	52714	1787	0	55624
25910	51221	442	1302	1413	0	54378
25911	1701	311	832	52992	0	55836
25912	1219	404	53515	1817	0	56955
25913	892	436	53317	1302	0	55947
25914	660	54507	1735	963	0	57865
25915	53955	1184	911	911	0	56961
25916	1464	54639	526	860	0	57489
25917	54940	1226	443	937	0	57546
25918	54781	796	318	929	0	56824
25919	1734	53507	392	764	0	56397
25920	53414	1073	282	772	0	55541
25921	52253	721	220	741	0	53935
25922	1806	492	51196	644	0	54138
25923	1268	2899	831	46352	0	51350
25924	536	44960	534	929	0	46959
25925	306	43590	232	574	0	44702
25926	875	1498	360	40628	0	43361
25927	39376	344	207	818	0	40745
25928	488	125	88	38840	0	39541
25929	345	93	104	40251	0	40793
25930	212	95	80	41142	0	41529
25931	170	42728	125	796	0	43819
25932	203	596	81	45297	0	46177
25933	180	365	46671	769	0	47985
25934	42332	151	672	540	0	43695
25935	47528	114	344	303	0	48289
25936	1017	46394	153	188	0	47752
25937	47186	709	86	203	0	48184
25938	854	395	49	47644	0	48942
25939	483	175	46929	745	0	48332
25940	44800	106	646	481	0	46033
25941	765	47206	368	213	0	48552
25942	431	670	100	47158	0	48359
25943	48596	375	69	847	0	49887
25944	748	48797	93	459	0	50097
25945	399	50270	104	214	0	50987
25946	50018	989	66	282	0	51355
25947	808	517	48729	139	0	50193
25948	49301	186	683	198	0	50368
25949	843	134	373	49357	0	50707
25950	531	119	134	49648	0	50432
25951	266	158	48750	1074	0	50248
25952	233	156	48192	541	0	49122
25953	244	120	1032	48935	0	50331
25954	242	171	48076	849	0	49338
25955	228	194	48380	496	0	49298
25956	293	137	1082	47375	0	48887
25957	263	116	498	49387	0	50264
25958	49172	123	240	1174	0	50709
25959	898	145	168	49492	0	50703
25960	49448	157	152	1002	0	50759
25961	903	49052	198	608	0	50761
25962	624	804	153	49854	0	51435
25963	329	532	51656	869	0	53386
25964	50634	245	758	606	0	52243
25965	53261	211	489	377	0	54338
25966	53933	142	245	323	0	54643
25967	53290	155	201	299	0	53945
25968	53079	140	184	301	0	53704
25969	1395	144	177	51570	0	53286
25970	685	186	50801	904	0	52576
25971	376	164	49992	589	0	51121
25972	302	159	51826	331	0	52618
25973	49870	136	1269	337	0	51612
25974	53010	95	649	314	0	54068
25975	1301	106	334	50761	0	52502
25976	662	53330	315	897	0	55204
25977	428	771	225	54792	0	56216
25978	362	509	54149	1024	0	56044
25979	341	247	52820	664	0	54072
25980	50263	170	1214	432	0	52079
25981	1038	175	55728	345	0	57286
25982	713	165	934	55262	0	57074
25983	58126	107	600	1086	0	59919
25984	57227	138	300	691	0	58356
25985	59913	104	228	400	0	60645
25986	60338	107	246	377	0	61068
25987	1582	222	58149	279	0	60232
25988	56473	116	940	313	0	57842
25989	1206	58387	662	258	0	60513
25990	860	801	317	59521	0	61499
25991	540	540	59695	942	0	61717
25992	539	208	973	59349	0	61069
25993	475	229	61173	1098	0	62975
25994	476	150	1056	60310	0	61992
25995	422	168	692	61685	0	62967
25996	446	196	60525	1480	0	62647
25997	447	162	1084	60166	0	61859
25998	60712	134	705	1277	0	62828
25999	1163	137	411	61345	0	63056
26000	784	155	367	62233	0	63539
26001	61095	136	308	1565	0	63104
26002	1187	61447	387	803	0	63824
26003	62235	876	329	539	0	63979
26004	1274	62968	370	379	0	64991
26005	65172	972	308	532	0	66984
26006	1335	593	64916	342	0	67186
26007	957	224	1011	64561	0	66753
26008	559	202	652	65968	0	67381
26009	64823	131	402	1558	0	66914
26010	1130	64819	465	862	0	67276
26011	816	841	345	64269	0	66271
26012	539	510	362	63708	0	65119
26013	390	62048	408	1550	0	64396
26014	61647	867	348	967	0	63829
26015	1066	62146	408	592	0	64212
26016	777	869	308	61898	0	63852
26017	570	494	307	59975	0	61346
26018	435	60528	319	1519	0	62801
26019	59598	918	268	960	0	61744
26020	1191	613	59194	589	0	61587
26021	57245	281	989	566	0	59081
26022	1231	59164	694	445	0	61534
26023	827	899	325	59542	0	61593
26024	59923	474	293	1122	0	61812
26025	1234	258	280	59703	0	61475
26026	859	222	201	60303	0	61585
26027	59512	165	258	1569	0	61504
26028	1162	58273	294	856	0	60585
26029	725	59427	276	489	0	60917
26030	58699	1001	229	529	0	60458
26031	958	518	59160	407	0	61043
26032	542	55678	728	317	0	57265
26033	476	741	637	58347	0	60201
26034	273	433	68042	625	0	69373
26035	277	207	894	66471	0	67849
26036	67288	125	510	1128	0	69051
26037	953	68903	219	712	0	70787
26038	707	942	146	63618	0	65413
26039	216	69364	160	830	0	70570
26040	69420	987	98	603	0	71108
26041	70605	554	105	381	0	71645
26042	1444	71460	183	405	0	73492
26043	748	1011	90	69451	0	71300
26044	242	71929	177	1038	0	73386
26045	72271	1131	96	741	0	74239
26046	72846	666	139	389	0	74040
26047	1709	279	130	72085	0	74203
26048	899	181	67	73478	0	74625
26049	413	305	71274	1735	0	73727
26050	65884	189	1090	1011	0	68174
26051	1277	271	71686	372	0	73606
26052	869	209	1166	70853	0	73097
26053	70533	186	654	1307	0	72680
26054	1163	72870	262	844	0	75139
26055	69296	1196	185	511	0	71188
26056	1282	878	64759	348	0	67267
26057	67443	306	852	413	0	69014
26058	1410	72273	585	299	0	74567
26059	72486	1191	217	436	0	74330
26060	1376	74588	260	461	0	76685
26061	916	1357	164	74447	0	76884
26062	473	898	73070	1408	0	75849
26063	425	498	70491	813	0	72227
26064	408	300	1632	70800	0	73140
26065	465	400	72049	1343	0	74257
26066	526	309	1199	71417	0	73451
26067	486	315	685	72348	0	73834
26068	361	390	73311	1871	0	75933
26069	61836	260	1263	1184	0	64543
26070	72863	300	745	513	0	74421
26071	1879	72064	318	428	0	74689
26072	71999	1130	200	407	0	73736
26073	1356	717	219	71788	0	74080
26074	883	350	74212	1320	0	76765
26075	493	250	1211	73940	0	75894
26076	518	262	767	74698	0	76245
26077	72716	218	319	1800	0	75053
26078	1241	71797	286	951	0	74275
26079	786	73046	202	466	0	74500
26080	435	1534	198	73120	0	75287
26081	419	737	230	71461	0	72847
26082	386	71290	257	1546	0	73479
26083	477	1104	191	70129	0	71901
26084	405	745	219	69299	0	70668
26085	295	68916	235	1657	0	71103
26086	67730	1028	236	937	0	69931
26087	1083	581	305	67822	0	69791
26088	721	68355	293	1244	0	70613
26089	431	1087	219	68670	0	70407
26090	67460	675	198	1371	0	69704
26091	1139	67884	239	864	0	70126
26092	68717	1151	145	629	0	70642
26093	68781	695	159	566	0	70201
26094	1774	383	156	69259	0	71572
26095	72064	356	150	1410	0	73980
26096	73292	349	141	959	0	74741
26097	74144	330	137	595	0	75206
26098	74608	299	192	452	0	75551
26099	1874	254	174	74342	0	76644
26100	986	265	168	75757	0	77176
26101	466	369	74582	1940	0	77357
26102	558	241	1020	75629	0	77448
26103	589	283	630	77361	0	78863
26104	465	394	75427	1987	0	78273
26105	70992	268	1170	1197	0	73627
26106	1473	249	689	75991	0	78402
26107	1020	364	76558	1486	0	79428
26108	71401	264	1265	1206	0	74136
26109	1635	307	81102	600	0	83644
26110	1060	80955	1489	628	0	84132
26111	606	84952	902	528	0	86988
26112	608	2135	327	87944	0	91014
26113	480	1036	94285	1808	0	97609
26114	90841	392	1713	1335	0	94281
26115	98351	243	986	889	0	100469
26116	2723	342	97895	511	0	101471
26117	96045	244	1770	575	0	98634
26118	99942	201	1042	589	0	101774
26119	2603	99679	615	563	0	103460
26120	100736	1589	409	564	0	103298
26121	2151	900	418	99749	0	103218
26122	1302	463	100458	1871	0	104094
26123	744	428	1689	95731	0	98592
26124	485	101043	1101	1922	0	104551
26125	466	105095	640	1197	0	107398
26126	104241	2256	427	656	0	107580
26127	103854	1080	384	601	0	105919
26128	103226	445	487	559	0	104717
26129	2892	377	370	102454	0	106093
26130	1580	748	393	99431	0	102152
26131	766	99117	437	2453	0	102773
26132	98014	1714	442	1479	0	101649
26133	2008	99751	519	824	0	103102
26134	89078	1281	334	451	0	91144
26135	1648	89544	438	400	0	92030
26136	89196	1336	393	400	0	91325
26137	88236	755	284	427	0	89702
26138	2228	565	320	86025	0	89138
26139	1294	89581	348	1201	0	92424
26140	964	1285	86349	799	0	89397
26141	79382	734	1111	622	0	81849
26142	1435	83737	663	554	0	86389
26143	882	1275	85138	386	0	87681
26144	671	845	85900	353	0	87769
26145	689	529	1313	81342	0	83873
26146	683	343	550	82175	0	83751
26147	538	86341	273	1298	0	88450
26148	88982	1119	130	889	0	91120
26149	1436	741	139	86361	0	88677
26150	941	90240	224	1050	0	92455
26151	721	95080	224	675	0	96700
26152	704	1512	92324	405	0	94945
26153	667	916	92583	341	0	94507
26154	88161	535	1311	460	0	90467
26155	1436	591	93945	343	0	96315
26156	1053	446	1075	91783	0	94357
26157	720	454	584	95879	0	97637
26158	636	612	95224	1539	0	98011
26159	647	513	1093	92862	0	95115
26160	714	414	701	90808	0	92637
26161	91062	424	423	1625	0	93534
26162	94177	486	498	866	0	96027
26163	1601	396	530	93183	0	95710
26164	867	92810	609	1226	0	95512
26165	532	96925	572	860	0	98889
26166	96724	1494	510	652	0	99380
26167	1387	962	96584	518	0	99451
26168	947	488	1256	95619	0	98310
26169	98472	531	804	1580	0	101387
26170	99667	584	570	1009	0	101830
26171	1841	514	512	99186	0	102053
26172	1047	647	99351	1353	0	102398
26173	866	622	92644	885	0	95017
26174	89918	479	1809	708	0	92914
26175	96527	453	1091	738	0	98809
26176	1854	96670	738	765	0	100027
26177	1160	98642	737	679	0	101218
26178	100479	1573	669	877	0	103598
26179	101261	815	557	989	0	103622
26180	2144	524	516	102621	0	105805
26181	1489	478	525	104632	0	107124
26182	1126	461	451	105436	0	107474
26183	104149	525	490	2129	0	107293
26184	1975	611	446	104792	0	107824
26185	1461	671	105788	1470	0	109390
26186	100756	557	1386	1150	0	103849
26187	1893	562	781	106312	0	109548
26188	1318	778	107335	1502	0	110933
26189	102234	644	1285	1108	0	105271
26190	99187	669	866	906	0	101628
26191	1886	110978	673	787	0	114324
26192	1312	113731	651	733	0	116427
26193	1198	1827	109322	684	0	113031
26194	106792	980	1200	859	0	109831
26195	1889	113487	831	710	0	116917
26196	1395	1629	109487	690	0	113201
26197	102692	933	1258	807	0	105690
26198	1908	115924	757	819	0	119408
26199	1278	1515	113852	812	0	117457
26200	106975	921	1228	909	0	110033
26201	1791	114274	768	756	0	117589
26202	1142	1204	429	112175	0	114950
26203	111957	649	367	1626	0	114599
26204	1406	112377	502	1174	0	115459
26205	1040	1348	547	111420	0	114355
26206	110355	504	436	1566	0	112861
26207	1355	392	111434	952	0	114133
26208	787	109244	1238	635	0	111904
26209	751	1163	107058	435	0	109407
26210	499	919	1123	104210	0	106751
26211	442	418	104570	916	0	106346
26212	319	100091	840	564	0	101814
26213	223	96070	471	248	0	97012
26214	457	927	241	94311	0	95936
26215	220	243	107	91310	0	91880
26216	200	121	112	92666	0	93099
26217	189	268	94010	774	0	95241
26218	221	100	551	93876	0	94748
26219	92649	83	338	828	0	93898
26220	91185	106	143	519	0	91953
26221	875	236	95174	238	0	96523
26222	363	93892	623	229	0	95107
26223	93026	522	270	398	0	94216
26224	578	93005	219	246	0	94048
26225	92218	564	167	411	0	93360
26226	92327	284	124	390	0	93125
26227	861	282	92031	230	0	93404
26228	395	94189	623	284	0	95491
26229	312	564	305	94778	0	95959
26230	262	455	94873	608	0	96198
26231	89682	167	666	489	0	91004
26232	754	153	292	94685	0	95884
26233	370	263	93430	615	0	94678
26234	88546	134	626	525	0	89831
26235	837	265	96120	226	0	97448
26236	464	153	726	96577	0	97920
26237	98876	107	341	993	0	100317
26238	787	101796	249	509	0	103341
26239	514	811	101964	209	0	103498
26240	98658	360	771	409	0	100198
26241	107859	139	424	340	0	108762
26242	1314	111413	295	193	0	113215
26243	715	978	138	111874	0	113705
26244	371	547	123	111186	0	112227
26245	110261	206	131	1615	0	112213
26246	1195	155	124	111674	0	113148
26247	662	327	111759	1173	0	113921
26248	365	115	1033	110070	0	111583
26249	109721	114	552	1412	0	111799
26250	1114	108867	324	895	0	111200
26251	731	1157	136	103145	0	105169
26252	260	106005	259	1129	0	107653
26253	106932	1206	176	806	0	109120
26254	1311	660	160	114250	0	116381
26255	765	252	154	115813	0	116984
26256	296	115502	280	2218	0	118296
26257	391	1559	113442	991	0	116383
26258	350	826	1486	111810	0	114472
26259	308	287	807	114569	0	115971
26260	354	206	255	113594	0	114409
26261	231	113156	266	2205	0	115858
26262	352	1579	113217	993	0	116141
26263	295	941	113669	404	0	115309
26264	110719	265	2165	489	0	113638
26265	114145	197	919	472	0	115733
26266	2324	294	115020	312	0	117950
26267	110399	156	1577	509	0	112641
26268	1828	264	117612	355	0	120059
26269	111364	175	1794	420	0	113753
26270	1764	117926	1029	434	0	121153
26271	120230	1611	458	516	0	122815
26272	2114	1066	121525	327	0	125032
26273	1143	548	123921	357	0	125969
26274	582	256	2529	135873	0	139240
26275	139745	226	1140	2798	0	143909
26276	2646	149612	551	1592	0	154401
26277	1554	2996	163947	716	0	169213
26278	791	1420	3573	165524	0	171308
26279	604	435	1714	171207	0	173960
26280	169506	293	517	5300	0	175616
26281	170925	292	342	2321	0	173880
26282	5453	253	294	169206	0	175206
26283	170752	302	338	4102	0	175494
26284	4266	369	167878	2037	0	174550
26285	2268	248	3779	164955	0	171250
26286	1004	287	1821	169608	0	172720
26287	168094	272	556	5551	0	174473
26288	168571	287	473	2379	0	171710
26289	5723	286	362	165925	0	172296
26290	166407	236	439	4173	0	171255
26291	4379	400	162057	2191	0	169027
26292	2216	160681	3896	938	0	167731
26293	1008	3789	162389	673	0	167859
26294	906	2203	4078	161678	0	168865
26295	158758	532	2086	4330	0	165706
26296	4077	158347	899	2360	0	165683
26297	2383	3792	554	156810	0	163539
26298	1157	1927	571	152871	0	156526
26299	764	154442	808	5521	0	161535
26300	1008	4063	627	157889	0	163587
26301	1122	2009	701	159476	0	163308
26302	1276	603	659	161249	0	163787
26303	1369	369	637	160620	0	162995
26304	1439	363	613	157603	0	160018
26305	1213	152340	801	6421	0	160775
26306	1489	3664	647	155761	0	161561
26307	1404	1891	656	156552	0	160503
26308	1305	769	150178	6481	0	158733
26309	1232	149277	4151	3415	0	158075
26310	1478	3791	2158	150963	0	158390
26311	1579	1912	970	152130	0	156591
26312	1660	648	754	151100	0	154162
26313	1354	146873	1005	6618	0	155850
26314	1610	4027	148391	3182	0	157210
26315	1567	2142	4378	150025	0	158112
26316	1339	970	150207	5219	0	157735
26317	1474	854	148386	3224	0	153938
26318	1496	793	5624	147535	0	155448
26319	148542	670	2522	5449	0	157183
26320	4599	784	994	149715	0	156092
26321	2885	773	778	146932	0	151368
26322	1301	148007	1019	6803	0	157130
26323	1290	4045	720	152672	0	158727
26324	1361	2115	801	155178	0	159455
26325	1163	1050	152337	7265	0	161815
26326	1016	152078	4278	4133	0	161505
26327	1165	4116	2295	154659	0	162235
26328	149471	2268	953	6023	0	158715
26329	4149	1323	150801	3899	0	160172
26330	2569	1083	4101	151218	0	158971
26331	1265	1002	2321	154766	0	159354
26332	149008	938	1081	7444	0	158471
26333	4016	148995	1043	4469	0	158523
26334	146642	4079	843	3073	0	154637
26335	3964	146795	1107	2795	0	154661
26336	2405	4257	871	145560	0	153093
26337	141866	2298	888	5916	0	150968
26338	4064	1138	141404	4093	0	150699
26339	2269	137419	4257	2889	0	146834
26340	1077	140930	2687	2708	0	147402
26341	132797	4815	1490	2576	0	141678
26342	3843	2246	1128	127703	0	134920
26343	2093	126516	1244	5260	0	135113
26344	1099	133243	1058	3860	0	139260
26345	1277	4839	859	132062	0	139037
26346	1234	2354	866	134453	0	138907
26347	128374	1140	924	6706	0	137144
26348	3592	128194	1208	4088	0	137082
26349	2354	3926	1091	129461	0	136832
26350	1222	2347	127195	4982	0	135746
26351	995	126805	4064	3765	0	135629
26352	1150	3657	125975	2709	0	133491
26353	1184	125406	4029	2736	0	133355
26354	1785	3561	2368	118850	0	126564
26355	1314	1907	852	116144	0	120217
26356	1181	116897	906	5352	0	124336
26357	1075	3656	117122	3082	0	124935
26358	115661	2163	3110	2307	0	123241
26359	3481	1349	1810	121367	0	128007
26360	1994	1277	939	124796	0	129006
26361	1067	1425	122452	5559	0	130503
26362	1028	1308	3418	123889	0	129643
26363	994	1484	123638	4762	0	130878
26364	1047	1399	3372	123846	0	129664
26365	950	1490	126795	4748	0	133983
26366	776	126818	3596	3761	0	134951
26367	892	4107	129815	2391	0	137205
26368	1061	2392	3421	128714	0	135588
26369	126910	1337	1773	5022	0	135042
26370	3419	124085	1102	3605	0	132211
26371	2297	4237	739	122530	0	129803
26372	1100	2518	120064	4441	0	128123
26373	718	120423	3633	3130	0	127904
26374	913	4044	1744	104120	0	110821
26375	603	1934	104911	2887	0	110335
26376	326	92834	2310	1550	0	97020
26377	74542	2443	1959	910	0	79854
26378	70190	854	562	506	0	72112
26379	1463	200	173	70585	0	72421
26380	70563	191	206	1272	0	72232
26381	1064	159	146	69979	0	71348
26382	670	153	140	71148	0	72111
26383	225	278	72134	1605	0	74242
26384	261	148	976	70952	0	72337
26385	233	171	593	72337	0	73334
26386	70562	153	193	1713	0	72621
26387	69318	163	177	950	0	70608
26388	1430	69805	284	339	0	71858
26389	713	1073	70202	281	0	72269
26390	300	617	1000	69365	0	71282
26391	253	309	68529	1090	0	70181
26392	62319	157	931	801	0	64208
26393	958	242	66026	329	0	67555
26394	670	154	929	62899	0	64652
26395	157	64630	629	876	0	66292
26396	204	842	227	64506	0	65779
26397	188	567	189	64850	0	65794
26398	179	274	65268	1418	0	67139
26399	257	147	840	64743	0	65987
26400	64404	131	588	1198	0	66321
26401	64475	141	202	846	0	65664
26402	64849	124	206	442	0	65621
26403	64585	130	209	480	0	65404
26404	1246	62967	290	378	0	64881
26405	616	63528	281	355	0	64780
26406	414	1206	231	56918	0	58769
26407	315	544	237	62828	0	63924
26408	234	59824	273	1442	0	61773
26409	297	809	216	63529	0	64851
26410	271	625	204	63698	0	64798
26411	309	245	233	63894	0	64681
26412	259	182	258	63956	0	64655
26413	296	209	237	64332	0	65074
26414	61967	208	245	1640	0	64060
26415	952	61668	292	940	0	63852
26416	717	936	60822	525	0	63000
26417	381	625	933	61282	0	63221
26418	320	267	648	61665	0	62900
26419	317	230	287	62048	0	62882
26420	62334	216	299	1738	0	64587
26421	1036	73543	336	1055	0	75970
26422	899	1598	255	72769	0	75521
26423	384	77877	315	2075	0	80651
26424	523	2074	248	73864	0	76709
26425	368	74675	310	2211	0	77564
26426	427	2179	79212	1294	0	83112
26427	449	1075	2376	83311	0	87211
26428	411	484	99080	2862	0	102837
26429	455	312	3190	98682	0	102639
26430	494	368	1553	106083	0	108498
26431	105156	297	534	5046	0	111033
26432	107525	309	339	2347	0	110520
26433	109691	292	350	1055	0	111388
26434	109466	345	324	882	0	111017
26435	109629	295	378	792	0	111094
26436	5150	323	336	101742	0	107551
26437	2044	105024	442	3622	0	111132
26438	991	3339	327	105339	0	109996
26439	655	1759	101739	3956	0	108109
26440	101283	547	3199	2235	0	107264
26441	106263	368	1609	1073	0	109313
26442	4994	311	538	104257	0	110100
26443	2309	322	295	103030	0	105956
26444	929	100209	439	5007	0	106584
26445	859	3267	275	103868	0	108269
26446	753	1732	334	102678	0	105497
26447	609	100444	518	5227	0	106798
26448	788	3309	350	104258	0	108705
26449	97135	1675	383	4414	0	103607
26450	3476	774	99558	2377	0	106185
26451	99224	484	3285	1407	0	104400
26452	3891	613	100548	1152	0	106204
26453	2204	405	3611	98244	0	104464
26454	1186	418	1745	94120	0	97469
26455	890	94367	839	5161	0	101257
26456	890	100162	547	2539	0	104138
26457	1103	4733	507	95144	0	101487
26458	931	1933	95909	4094	0	102867
26459	92123	634	3212	2249	0	98218
26460	3806	417	1641	92212	0	98076
26461	1951	91778	799	3845	0	98373
26462	1307	3122	410	93533	0	98372
26463	1179	1755	317	92317	0	95568
26464	998	90314	427	4793	0	96532
26465	1308	3255	299	87123	0	91985
26466	915	1505	80818	3512	0	86750
26467	847	670	81025	1920	0	84462
26468	818	581	3592	74814	0	79805
26469	503	79861	1522	3047	0	84933
26470	701	2870	585	80234	0	84390
26471	81178	1406	340	3523	0	86447
26472	83681	626	388	1952	0	86647
26473	80796	450	347	1196	0	82789
26474	4018	78003	476	1030	0	83527
26475	1686	2862	77941	1037	0	83526
26476	77763	1477	2776	1110	0	83126
26477	80863	813	1382	1183	0	84241
26478	3868	78418	749	1152	0	84187
26479	1821	2978	427	77976	0	83202
26480	79371	1556	445	3404	0	84776
26481	81196	777	541	1977	0	84491
26482	82522	558	589	1237	0	84906
26483	4425	489	678	77432	0	83024
26484	79251	485	642	3679	0	84057
26485	3605	472	576	79274	0	83927
26486	2081	580	508	80922	0	84091
26487	78463	662	479	4695	0	84299
26488	3698	663	516	78988	0	83865
26489	78617	665	618	3978	0	83878
26490	3987	655	523	78891	0	84056
26491	2395	670	490	81189	0	84744
26492	78076	793	493	5060	0	84422
26493	3801	820	77056	2844	0	84521
26494	2591	718	2948	79412	0	85669
26495	1959	649	1585	81276	0	85469
26496	1760	609	785	80628	0	83782
26497	1639	613	656	82485	0	85393
26498	1617	684	617	79291	0	82209
26499	1424	76770	736	5198	0	84128
26500	1736	3061	614	79055	0	84466
26501	1739	1727	77092	4218	0	84776
26502	1907	888	2822	79050	0	84667
26503	1852	753	1344	80431	0	84380
26504	1790	694	608	82734	0	85826
26505	1452	865	77911	5323	0	85551
26506	1302	929	78328	3001	0	83560
26507	76313	767	4024	2044	0	83148
26508	79541	653	1860	1920	0	83974
26509	4740	79981	991	1808	0	87520
26510	2645	3196	494	82999	0	89334
26511	1546	1793	547	87312	0	91198
26512	1294	941	586	89358	0	92179
26513	85336	720	719	5564	0	92339
26514	88417	675	676	3269	0	93037
26515	4646	662	635	87557	0	93500
26516	2284	829	555	88924	0	92592
26517	1409	888	499	89814	0	92610
26518	1256	676	619	90235	0	92786
26519	84372	666	779	5704	0	91521
26520	3481	673	81247	3167	0	88568
26521	1590	65786	2329	1842	0	71547
26522	764	65210	1164	1415	0	68553
26523	61952	2206	562	1360	0	66080
26524	1952	2540	639	60475	0	65606
26525	1109	694	60394	2506	0	64703
26526	597	528	55068	1558	0	57751
26527	456	55351	1915	1081	0	58803
26528	40633	428	918	403	0	42382
26529	514	247	40208	259	0	41228
26530	31968	161	357	173	0	32659
26531	206	32	89	35683	0	36010
26532	135	73	38	36153	0	36399
26533	67	35795	63	252	0	36177
26534	55	36731	42	172	0	37000
26535	36964	185	25	161	0	37335
26536	37055	100	26	132	0	37313
26537	209	37378	50	114	0	37751
26538	114	191	36233	69	0	36607
26539	105	127	36917	73	0	37222
26540	75	66	215	37134	0	37490
26541	38638	23	125	242	0	39028
26542	158	38651	82	156	0	39047
26543	114	155	26	40012	0	40307
26544	40323	85	29	300	0	40737
26545	203	53	25	40748	0	41029
26546	123	28	26	41689	0	41866
26547	40848	23	27	388	0	41286
26548	219	41025	56	236	0	41536
26549	139	42772	44	131	0	43086
26550	107	348	43154	91	0	43700
26551	73	140	207	44202	0	44622
26552	77	78	139	44907	0	45201
26553	67	83	46222	364	0	46736
26554	36567	48	238	407	0	37260
26555	42699	43	133	204	0	43079
26556	345	83	45900	85	0	46413
26557	36605	49	263	255	0	37172
26558	277	105	46713	100	0	47195
26559	172	48580	268	109	0	49129
26560	147	223	139	51230	0	51739
26561	83	137	75	53273	0	53568
26562	53333	73	48	451	0	53905
26563	53171	45	45	287	0	53548
26564	53005	44	45	221	0	53315
26565	53298	31	48	177	0	53554
26566	52919	45	73	192	0	53229
26567	365	108	51412	133	0	52018
26568	198	52015	251	135	0	52599
26569	151	250	136	52261	0	52798
26570	79	52767	114	241	0	53201
26571	67	53616	88	207	0	53978
26572	94	304	59	52675	0	53132
26573	99	164	48	53306	0	53617
26574	112	147	52916	356	0	53531
26575	47633	49	253	299	0	48234
26576	52897	45	135	177	0	53254
26577	310	52472	126	139	0	53047
26578	52853	208	55	138	0	53254
26579	53913	121	52	224	0	54310
26580	324	64	63	53536	0	53987
26581	220	120	55481	231	0	56052
26582	115	137	54931	160	0	55343
26583	54587	65	260	181	0	55093
26584	55827	43	138	142	0	56150
26585	324	55427	107	82	0	55940
26586	192	57375	77	98	0	57742
26587	150	320	35	58399	0	58904
26588	58481	168	39	311	0	58999
26589	273	172	58300	143	0	58888
26590	202	56	240	58839	0	59337
26591	60139	36	141	421	0	60737
26592	59996	52	93	279	0	60420
26593	412	59	56	60683	0	61210
26594	60781	37	82	414	0	61314
26595	345	114	58279	179	0	58917
26596	220	145	62752	104	0	63221
26597	185	55	358	61220	0	61818
26598	127	43	192	65715	0	66077
26599	112	63	75	65350	0	65600
26600	90	63877	128	433	0	64528
26601	122	65306	95	261	0	65784
26602	134	386	50	66102	0	66672
26603	66208	180	59	442	0	66889
26604	316	97	66	66955	0	67434
26605	235	53	45	66994	0	67327
26606	136	66163	112	420	0	66831
26607	78	68986	124	274	0	69462
26608	98	355	60	69137	0	69650
26609	112	182	39	66895	0	67228
26610	64930	84	30	512	0	65556
26611	299	64012	97	247	0	64655
26612	64734	262	32	285	0	65313
26613	378	141	44	64973	0	65536
26614	256	164	63289	301	0	64010
26615	155	171	61353	227	0	61906
26616	62611	57	447	240	0	63355
26617	339	117	199	67379	0	68034
26618	228	46	96	67733	0	68103
26619	119	48	58	68401	0	68626
26620	108	182	68968	508	0	69766
26621	116	40	265	69651	0	70072
26622	88	69158	216	471	0	69933
26623	119	342	86	72184	0	72731
26624	130	187	52	72098	0	72467
26625	126	73372	88	538	0	74124
26626	122	456	53	74484	0	75115
26627	72268	203	39	703	0	73213
26628	460	72439	112	360	0	73371
26629	74188	543	40	295	0	75066
26630	74485	271	48	297	0	75101
26631	886	103	57	73888	0	74934
26632	459	71	43	73764	0	74337
26633	234	66	44	74947	0	75291
26634	218	152	71629	959	0	72958
26635	114	70572	598	541	0	71825
26636	104	73021	347	233	0	73705
26637	150	796	99	71780	0	72825
26638	71051	318	79	726	0	72174
26639	632	108	68	70480	0	71288
26640	385	194	70842	793	0	72214
26641	144	69950	566	445	0	71105
26642	100	71726	318	242	0	72386
26643	71232	733	97	266	0	72328
26644	71623	307	65	250	0	72245
26645	803	77820	149	207	0	78979
26646	80127	584	108	320	0	81139
26647	808	428	78754	131	0	80121
26648	402	257	77030	176	0	77865
26649	79285	123	955	270	0	80633
26650	81576	101	383	321	0	82381
26651	1152	95	112	81166	0	82525
26652	80382	93	97	1021	0	81593
26653	948	199	80848	470	0	82465
26654	521	247	87763	288	0	88819
26655	336	148	1242	97219	0	98945
26656	292	105	519	110657	0	111573
26657	274	101	141	114390	0	114906
26658	317	142	130	115242	0	115831
26659	270	105	90	121660	0	122125
26660	260	264	116717	3373	0	120614
26661	324	132	1988	116038	0	118482
26662	115727	125	1037	2906	0	119795
26663	2205	131	376	117533	0	120245
26664	116691	123	226	2915	0	119955
26665	2547	129	203	117235	0	120114
26666	118369	138	241	2986	0	121734
26667	121927	167	226	1785	0	124105
26668	3481	158	198	120496	0	124333
26669	1712	157	289	122814	0	124972
26670	120696	120	253	3585	0	124654
26671	121550	126	192	1921	0	123789
26672	3583	337	122939	993	0	127852
26673	2004	149	2150	123216	0	127519
26674	1114	138	1088	127922	0	130262
26675	126234	145	545	3754	0	130678
26676	128897	157	377	2012	0	131443
26677	3675	160	278	128536	0	132649
26678	1858	109	323	130882	0	133172
26679	1055	115	313	131199	0	132682
26680	850	125	317	129685	0	130977
26681	605	121403	513	4646	0	127167
26682	573	125170	495	2414	0	128652
26683	749	2923	266	124418	0	128356
26684	665	124600	458	3138	0	128861
26685	677	2364	292	127245	0	130578
26686	629	1329	124350	3592	0	129900
26687	676	667	121350	2465	0	125158
26688	643	125538	3153	1708	0	131042
26689	801	2302	1404	125706	0	130213
26690	740	1346	125132	3405	0	130623
26691	847	582	2478	123283	0	127190
26692	930	424	1339	127743	0	130436
26693	124238	305	740	4400	0	129683
26694	2943	372	598	127033	0	130946
26695	1893	398	127532	3669	0	133492
26696	1300	364	125489	2474	0	129627
26697	1218	123921	3392	1737	0	130268
26698	1143	132132	1752	1539	0	136566
26699	133855	2931	871	1940	0	139597
26700	3141	1463	145746	1683	0	152033
26701	2136	565	2546	146010	0	151257
26702	148020	342	1479	3852	0	153693
26703	148200	436	922	2623	0	152181
26704	3724	151547	822	1973	0	158066
26705	2486	2489	597	148487	0	154059
26706	1514	1383	585	158328	0	161810
26707	1284	675	505	157730	0	160194
26708	152890	506	574	5179	0	159149
26709	2978	658	152003	3110	0	158749
26710	1761	154947	2670	2208	0	161586
26711	1387	2576	1437	155637	0	161037
26712	1094	1515	951	159711	0	163271
26713	955	1102	156732	4809	0	163598
26714	1116	639	2673	155448	0	159876
26715	1126	611	1588	160249	0	163574
26716	1069	558	980	160494	0	163101
26717	1089	569	965	159686	0	162309
26718	894	752	154785	5319	0	161750
26719	936	651	2926	154937	0	159450
26720	864	715	156443	4729	0	162751
26721	877	154022	3323	3488	0	161710
26722	1052	2347	1841	156591	0	161831
26723	1171	1313	1036	159513	0	163033
26724	1228	872	154465	5067	0	161632
26725	1015	151450	2811	3838	0	159114
26726	1270	2428	1711	151950	0	157359
26727	1349	1635	151830	3843	0	158657
26728	1084	151208	2659	3131	0	158082
26729	1245	2366	1478	153206	0	158295
26730	1379	1560	152201	3630	0	158770
26731	1440	863	2598	151811	0	156712
26732	1296	727	1521	152421	0	155965
26733	1268	703	1019	157054	0	160044
26734	153281	732	744	4924	0	159681
26735	2700	152591	940	3240	0	159471
26736	153763	2237	721	2673	0	159394
26737	2897	1523	153150	2367	0	159937
26738	153186	793	2467	2778	0	159224
26739	162915	622	1465	2718	0	167720
26740	3446	675	1044	162239	0	167404
26741	165129	781	761	4226	0	170897
26742	167276	705	795	3339	0	172115
26743	171456	702	744	2876	0	175778
26744	3757	726	753	170611	0	175847
26745	2064	640	689	165738	0	169131
26746	989	745	159299	3922	0	164955
26747	854	753	149891	2565	0	154063
26748	148388	524	3093	2155	0	154160
26749	2249	976	1625	156992	0	161842
26750	1184	158843	1267	2799	0	164093
26751	158723	1857	931	2345	0	163856
26752	1876	158364	998	1839	0	163077
26753	1153	156019	909	1756	0	159837
26754	1162	2667	145026	1627	0	150482
26755	553	1023	141420	812	0	143808
26756	741	1813	1692	136885	0	141131
26757	402	547	145933	1200	0	148082
26758	340	516	135431	631	0	136918
26759	127995	147	544	667	0	129353
26760	136592	160	279	574	0	137605
26761	555	143	177	138184	0	139059
26762	330	149	168	139801	0	140448
26763	298	406	141238	549	0	142491
26764	201	142725	481	486	0	143893
26765	291	411	250	142375	0	143327
26766	147712	164	180	1041	0	149097
26767	516	103	142	150092	0	150853
26768	293	151131	245	727	0	152396
26769	336	619	149330	451	0	150736
26770	166	153753	622	342	0	154883
26771	154082	511	323	633	0	155549
26772	149484	328	198	541	0	150551
26773	785	162	122	149306	0	150375
26774	465	408	150426	636	0	151935
26775	366	386	142311	455	0	143518
26776	194	150164	978	450	0	151786
26777	387	674	494	145547	0	147102
26778	298	347	202	152240	0	153087
26779	259	395	150776	921	0	152351
26780	275	104	675	148883	0	149937
26781	161	159252	505	911	0	160829
26782	277	917	222	160862	0	162278
26783	268	485	141	161955	0	162849
26784	243	481	160358	1504	0	162586
26785	266	183	1020	156615	0	158084
26786	155071	123	733	1573	0	157500
26787	1138	364	159522	662	0	161686
26788	746	337	159062	321	0	160466
26789	249	161902	1716	306	0	164173
26790	348	1193	786	165363	0	167690
26791	273	704	234	171314	0	172525
26792	239	476	169266	1896	0	171877
26793	156518	161	1425	1244	0	159348
26794	1445	155	813	169137	0	171550
26795	923	442	166862	1396	0	169623
26796	423	154	1401	161302	0	163280
26797	270	367	166660	1570	0	168867
26798	360	321	161761	1042	0	163484
26799	192	162221	2166	463	0	165042
26800	310	1361	954	147830	0	150455
26801	132	154944	475	1342	0	156893
26802	149627	1411	290	1204	0	152532
26803	1345	1125	152719	400	0	155589
26804	764	149352	1500	469	0	152085
26805	322	1364	905	148726	0	151317
26806	146954	854	389	1844	0	150041
26807	1257	148209	462	1277	0	151205
26808	911	1392	298	150417	0	153018
26809	370	910	310	150023	0	151613
26810	172	155564	446	2289	0	158471
26811	156336	1740	317	1437	0	159830
26812	1815	1039	366	179427	0	182647
26813	1136	349	330	189175	0	190990
26814	513	485	185407	4331	0	190736
26815	242	192241	3142	2253	0	197878
26816	426	3178	1795	193903	0	199302
26817	415	1850	683	205889	0	208837
26818	261	211617	652	5250	0	217780
26819	481	3769	415	214354	0	219019
26820	575	2141	497	220325	0	223538
26821	505	680	436	220744	0	222365
26822	215	220323	637	6554	0	227729
26823	217143	4134	521	3230	0	225028
26824	4306	2563	220305	1177	0	228351
26825	210804	745	4403	1308	0	217260
26826	4459	219362	2719	1009	0	227549
26827	2507	4358	916	219523	0	227304
26828	991	2774	220751	4831	0	229347
26829	805	991	4445	221296	0	227537
26830	745	626	2520	223148	0	227039
26831	743	647	982	228581	0	230953
26832	598	921	222771	7261	0	231551
26833	477	219451	4847	4483	0	229258
26834	669	4591	224285	1930	0	231475
26835	453	224942	5289	1977	0	232661
26836	794	5284	227410	1690	0	235178
26837	704	2965	5116	225121	0	233906
26838	218009	1295	2958	6162	0	228424
26839	4201	224964	1545	4195	0	234905
26840	2537	5231	227354	2425	0	237547
26841	834	226055	5136	2348	0	234373
26842	953	5787	226715	2062	0	235517
26843	1055	3257	5335	217106	0	226753
26844	1213	1829	3077	208321	0	214440
26845	835	217671	1825	7591	0	227922
26846	835	227517	1617	4374	0	234343
26847	225610	7407	1233	2850	0	237100
26848	5351	3964	1321	227449	0	238085
26849	3273	2230	227072	6731	0	239306
26850	1644	1571	5597	227918	0	236730
26851	1160	1855	229674	7438	0	240127
26852	1038	1956	230457	4928	0	238379
26853	1270	1577	7983	216454	0	227284
26854	865	225284	4367	6560	0	237076
26855	219674	5788	2136	5007	0	232605
26856	5413	3797	1862	216433	0	227505
26857	3432	2228	1844	209362	0	216866
26858	1188	216036	2259	8388	0	227871
26859	213625	6087	1817	4966	0	226495
26860	217308	3985	1935	3061	0	226289
26861	7751	2189	1972	208560	0	220472
26862	3591	209096	2347	6719	0	221753
26863	1428	221849	2276	4741	0	230294
26864	216275	8131	1987	3239	0	229632
26865	5390	4874	216403	2729	0	229396
26866	207299	2472	6265	2892	0	218928
26867	210732	2266	3901	2911	0	219810
26868	209624	1964	2249	2936	0	216773
26869	7623	205652	2088	2888	0	218251
26870	3993	6077	1934	206991	0	218995
26871	206666	4035	2022	6861	0	219584
26872	207888	2271	2033	4956	0	217148
26873	7163	207006	2554	3050	0	219773
26874	208798	5765	1892	3163	0	219618
26875	5895	3869	1811	210061	0	221636
26876	3766	2342	1885	208936	0	216929
26877	1891	207004	2130	8336	0	219361
26878	2084	5945	1729	211416	0	221174
26879	2134	3948	1517	211691	0	219290
26880	1716	209383	1857	8871	0	221827
26881	2094	5436	1418	194785	0	203733
26882	1561	204529	1784	6784	0	214658
26883	202555	5921	1681	4616	0	214773
26884	196988	4025	1666	3184	0	205863
26885	6922	198588	1756	3170	0	210436
26886	3903	5653	196237	2951	0	208744
26887	2454	4098	4710	196757	0	208019
26888	2380	2795	194781	5949	0	205905
26889	2285	187179	5214	4551	0	199229
26890	2374	193219	3393	2827	0	201813
26891	184489	6440	1697	2428	0	195054
26892	5668	189798	1714	2068	0	199248
26893	4579	5380	1394	179354	0	190707
26894	2641	184652	1873	4678	0	193844
26895	2559	190785	1396	3655	0	198395
26896	187579	6665	1199	2679	0	198122
26897	5644	3579	1164	187420	0	197807
26898	3740	2565	185692	5665	0	197662
26899	2321	2513	182387	4381	0	191602
26900	1991	186423	5968	3030	0	197412
26901	183667	5465	3028	2765	0	194925
26902	5100	188247	1957	2184	0	197488
26903	3720	6022	1236	188606	0	199584
26904	189092	3899	1353	5829	0	200173
26905	5754	2552	1113	192640	0	202059
26906	3916	2258	1278	191903	0	199355
26907	2280	191907	1467	7490	0	203144
26908	2678	5561	1210	194961	0	204410
26909	1923	4225	195864	5864	0	207876
26910	189987	2197	4837	3829	0	200850
26911	5095	199158	3089	2547	0	209889
26912	2490	189225	1280	1521	0	194516
26913	178764	5093	786	1370	0	186013
26914	4572	2998	179482	1057	0	188109
26915	167714	1806	3836	1172	0	174528
26916	3863	191680	2177	1027	0	198747
26917	1779	202345	947	809	0	205880
26918	1042	6117	202179	591	0	209929
26919	618	206522	4687	697	0	212524
26920	1118	5127	2693	183189	0	192127
26921	737	2487	665	190697	0	194586
26922	407	195762	447	5626	0	202242
26923	658	4356	281	196796	0	202091
26924	197097	2483	290	4681	0	204551
26925	4324	1129	196647	2399	0	204499
26926	196293	623	4071	1094	0	202081
26927	203745	639	2223	927	0	207534
26928	202832	678	676	907	0	205093
26929	6931	877	200052	560	0	208420
26930	3247	660	4399	198536	0	206842
26931	1235	844	201710	4561	0	208350
26932	193391	610	4852	2837	0	201690
26933	195823	593	2509	1260	0	200185
26934	6523	197316	1090	759	0	205688
26935	3381	4754	513	194280	0	202928
26936	1210	203656	787	4658	0	210311
26937	1101	5437	204864	2607	0	214009
26938	1293	3135	4868	203150	0	212446
26939	201646	1353	2745	5330	0	211074
26940	204091	799	918	2994	0	208802
26941	7533	931	707	189759	0	198930
26942	3290	193475	880	4798	0	202443
26943	1400	5027	197771	2714	0	206912
26944	1094	3048	200869	1051	0	206062
26945	186562	1152	7252	1017	0	195983
26946	5494	939	200446	858	0	207737
26947	2949	196679	5590	1120	0	206338
26948	1590	5176	2932	194335	0	204033
26949	1151	3041	198844	4854	0	207890
26950	1307	1082	5297	193971	0	201657
26951	1081	895	198032	5579	0	205587
26952	184320	732	5738	3226	0	194016
26953	5574	815	3198	186502	0	196089
26954	3302	188247	1554	4991	0	198094
26955	1484	195227	1248	3153	0	201112
26956	1514	7428	1143	190726	0	200811
26957	1591	3324	983	189874	0	195772
26958	1182	189304	1308	7395	0	199189
26959	1379	5533	189863	3449	0	200224
26960	1544	3155	5395	189924	0	200018
26961	1294	1598	194436	5547	0	202875
26962	1263	1183	190310	3439	0	196195
26963	176138	1055	7725	1833	0	186751
26964	5510	183114	3935	1428	0	193987
26965	185352	5516	1674	1422	0	193964
26966	6227	3496	1373	177035	0	188131
26967	3444	183192	1735	5356	0	193727
26968	2228	5829	1557	185158	0	194772
26969	1837	3638	1586	184302	0	191363
26970	1516	183193	1637	7877	0	194223
26971	1617	5950	182540	4069	0	194176
26972	1778	3640	5818	183412	0	194648
26973	183436	1829	3751	6327	0	195343
26974	6235	1368	1983	184390	0	193976
26975	4177	1435	1682	185185	0	192479
26976	2133	1689	180405	8354	0	192581
26977	1724	179272	6243	4516	0	191755
26978	1948	5905	3665	178156	0	189674
26979	1568	3958	178890	6356	0	190772
26980	1334	2313	178330	4234	0	186211
26981	167923	1729	8486	2756	0	180894
26982	5801	174608	4792	2513	0	187714
26983	174188	5933	2282	2239	0	184642
26984	6244	173546	2273	2265	0	184328
26985	3923	178299	2031	2319	0	186572
26986	174327	8230	1787	2186	0	186530
26987	6544	4175	2049	167106	0	179874
26988	4146	173429	2437	6126	0	186138
26989	2847	5952	1756	177537	0	188092
26990	175333	3735	1688	6813	0	187569
26991	6626	2211	176182	4442	0	189461
26992	4111	2007	175205	2521	0	183844
26993	165272	1689	8564	2372	0	177897
26994	6114	172784	5068	2386	0	186352
26995	4365	5884	173079	2045	0	185373
26996	2553	174091	6622	2191	0	185457
26997	2275	6440	4038	170136	0	182889
26998	1970	4222	174043	6397	0	186632
26999	1846	2146	6203	172964	0	183159
27000	1366	2034	172265	7125	0	182790
27001	159283	1657	6865	4649	0	172454
27002	5890	168927	4669	2620	0	182106
27003	169121	5564	2343	2179	0	179207
27004	6252	3905	2083	161107	0	173347
27005	3475	179373	2279	5830	0	190957
27006	178033	6496	2194	3998	0	190721
27007	177147	3824	2450	2541	0	185962
27008	8292	2255	176522	2196	0	189265
27009	4124	1916	173678	1804	0	181522
27010	150633	1419	7595	1723	0	161370
27011	4990	154502	4186	1909	0	165587
27012	2739	152196	2351	1503	0	158789
27013	2787	8358	2242	142102	0	155489
27014	1542	3118	144102	4658	0	153420
27015	1415	136385	4712	2725	0	145237
27016	1062	125449	2552	1416	0	130479
27017	2854	3478	1287	97084	0	104703
27018	100011	1366	607	2422	0	104406
27019	101853	615	423	1465	0	104356
27020	103390	454	510	728	0	105082
27021	3236	602	101556	482	0	105876
27022	99474	485	2265	585	0	102809
27023	103279	453	1279	574	0	105585
27024	105237	485	530	558	0	106810
27025	3429	561	456	99172	0	103618
27026	1479	100838	504	2187	0	105008
27027	100435	2146	387	1206	0	104174
27028	2229	100950	501	488	0	104168
27029	1252	2028	376	98762	0	102418
27030	604	1161	102333	2075	0	106173
27031	630	588	2099	100968	0	104285
27032	699	378	1086	103546	0	105709
27033	556	492	102928	2745	0	106721
27034	535	101518	2078	1257	0	105388
27035	526	1738	884	94651	0	97799
27036	93374	892	379	1790	0	96435
27037	1648	92266	381	975	0	95270
27038	91376	1586	209	517	0	93688
27039	1799	1030	218	89120	0	92167
27040	995	92395	343	1478	0	95211
27041	92184	1534	311	906	0	94935
27042	1727	93954	356	344	0	96381
27043	959	1652	92622	276	0	95509
27044	91374	885	1705	461	0	94425
27045	94885	488	754	430	0	96557
27046	2232	94774	360	300	0	97666
27047	1064	1717	92048	239	0	95068
27048	424	95703	1589	328	0	98044
27049	888	2582	1180	66625	0	71275
27050	410	982	311	96735	0	98438
27051	392	494	191	97092	0	98169
27052	380	96519	241	2552	0	99692
27053	497	1807	168	97377	0	99849
27054	529	950	161	98242	0	99882
27055	96147	445	177	2585	0	99354
27056	2081	299	195	96003	0	98578
27057	1211	270	146	97555	0	99182
27058	95691	264	133	2685	0	98773
27059	2032	96812	244	1231	0	100319
27060	98402	1905	153	666	0	101126
27061	98432	1055	203	496	0	100186
27062	99404	494	216	483	0	100597
27063	2946	391	221	97124	0	100682
27064	1445	325	249	99933	0	101952
27065	770	431	96906	2686	0	100793
27066	587	475	94824	1327	0	97213
27067	587	444	96508	689	0	98228
27068	87399	430	2796	604	0	91229
27069	2213	533	95593	534	0	98873
27070	1182	95852	2190	660	0	99884
27071	825	2079	991	95722	0	99617
27072	712	1233	487	92701	0	95133
27073	563	97322	454	2483	0	100822
27074	711	2263	98375	1258	0	102607
27075	636	99888	2018	710	0	103252
27076	98946	2253	1024	724	0	102947
27077	2417	1362	99577	580	0	103936
27078	1409	98660	2201	697	0	102967
27079	1015	2255	100559	529	0	104358
27080	881	1242	2210	99309	0	103642
27081	777	802	101476	2283	0	105338
27082	822	567	2236	98374	0	101999
27083	100794	507	1097	2654	0	105052
27084	2415	654	101037	1492	0	105598
27085	1351	101160	2189	1082	0	105782
27086	102435	2163	1146	1008	0	106752
27087	2471	1293	104859	862	0	109485
27088	1433	712	105219	930	0	108294
27089	992	495	2885	102757	0	107129
27090	841	641	104968	2644	0	109094
27091	97722	545	2485	1733	0	102485
27092	2501	103209	1330	989	0	108029
27093	1640	2393	673	101140	0	105846
27094	895	108501	655	2365	0	112416
27095	109002	2478	600	1624	0	113704
27096	2634	1458	108033	1047	0	113172
27097	1573	893	112076	901	0	115443
27098	970	695	3211	109991	0	114867
27099	797	599	1597	112950	0	115943
27100	863	566	965	114199	0	116593
27101	869	653	835	115151	0	117508
27102	833	714	113637	3620	0	118804
27103	728	111018	2635	1992	0	116373
27104	625	2024	1126	101368	0	105143
27105	598	1160	98035	1880	0	101673
27106	452	97108	1991	1175	0	100726
27107	96352	1824	1221	771	0	100168
27108	2419	1088	669	95772	0	99948
27109	94612	525	473	1966	0	97576
27110	1763	94477	597	1178	0	98015
27111	94229	1676	518	802	0	97225
27112	1988	1079	97601	531	0	101199
27113	1222	732	1815	91730	0	95499
27114	667	97341	1133	1679	0	100820
27115	599	1689	96324	1055	0	99667
27116	366	95975	1787	645	0	98773
27117	662	2125	1092	72015	0	75894
27118	90925	798	538	1745	0	94006
27119	1449	90708	607	976	0	93740
27120	90144	1436	472	740	0	92792
27121	1657	884	89005	549	0	92095
27122	956	518	87833	517	0	89824
27123	85586	368	1989	579	0	88522
27124	1530	442	1093	87061	0	90126
27125	929	378	624	88432	0	90363
27126	572	419	89747	1960	0	92698
27127	465	363	87757	963	0	89548
27128	403	90000	2017	587	0	93007
27129	87000	1485	1139	789	0	90413
27130	83930	701	521	503	0	85655
27131	1643	83098	487	388	0	85616
27132	1001	1277	360	84612	0	87250
27133	85189	658	396	1540	0	87783
27134	1274	389	445	85531	0	87639
27135	86471	311	369	1554	0	88705
27136	86922	289	379	952	0	88542
27137	89440	302	367	688	0	90797
27138	1909	334	297	87157	0	89697
27139	970	290	303	91142	0	92705
27140	87733	265	294	1840	0	90132
27141	87547	269	348	1026	0	89190
27142	86770	252	322	627	0	87971
27143	1801	84952	431	404	0	87588
27144	80618	861	239	382	0	82100
27145	965	80404	301	353	0	82023
27146	78112	918	332	466	0	79828
27147	1086	531	77681	301	0	79599
27148	69110	374	844	375	0	70703
27149	791	74362	460	215	0	75828
27150	455	75954	262	214	0	76885
27151	76655	834	180	322	0	77991
27152	782	440	163	76636	0	78021
27153	540	199	145	80189	0	81073
27154	278	80320	228	1021	0	81847
27155	256	85531	228	505	0	86520
27156	87329	1065	143	383	0	88920
27157	1017	641	89611	202	0	91471
27158	647	187	877	92260	0	93971
27159	93165	164	454	1215	0	94998
27160	1214	295	92808	609	0	94926
27161	662	98111	1088	297	0	100158
27162	102599	1285	543	321	0	104748
27163	1862	720	104938	221	0	107741
27164	1067	230	1753	107155	0	110205
27165	434	311	111749	1932	0	114426
27166	103796	174	1983	1116	0	107069
27167	1899	112325	1021	430	0	115675
27168	114018	1872	300	490	0	116680
27169	113588	926	205	380	0	115099
27170	2899	310	133	112175	0	115517
27171	112995	212	158	2157	0	115522
27172	2257	193	158	113323	0	115931
27173	1200	226	146	114167	0	115739
27174	503	361	109159	2728	0	112751
27175	403	110053	1910	1135	0	113501
27176	487	1917	853	110653	0	113910
27177	402	915	247	111652	0	113216
27178	391	330	161	112671	0	113553
27179	350	394	109768	2736	0	113248
27180	323	108886	1867	1178	0	112254
27181	406	1813	827	110460	0	113506
27182	443	857	282	112088	0	113670
27183	375	456	109417	2598	0	112846
27184	432	300	1775	107984	0	110491
27185	108473	187	908	2272	0	111840
27186	1888	108426	439	1159	0	111912
27187	105928	1802	238	552	0	108520
27188	2177	1060	104945	326	0	108508
27189	1273	374	1765	104779	0	108191
27190	109037	264	902	2035	0	112238
27191	109071	217	368	1151	0	110807
27192	2862	332	109135	443	0	112772
27193	1440	250	1976	107831	0	111497
27194	614	305	108870	2098	0	111887
27195	101632	210	2069	1274	0	105185
27196	2018	108256	1158	569	0	112001
27197	111778	1926	465	628	0	114797
27198	110476	944	376	582	0	112378
27199	2935	111324	486	437	0	115182
27200	113176	2086	378	628	0	116268
27201	2509	1080	111106	458	0	115153
27202	111019	390	2041	543	0	113993
27203	2538	351	1069	112109	0	116067
27204	1510	452	115338	2309	0	119609
27205	960	314	2175	115197	0	118646
27206	888	289	1197	115546	0	117920
27207	771	318	649	114294	0	116032
27208	722	115183	643	3140	0	119688
27209	116030	2126	500	1748	0	120404
27210	2541	1197	522	114984	0	119244
27211	1495	115431	628	2563	0	120117
27212	968	2203	580	109737	0	113488
27213	863	112138	609	2765	0	116375
27214	956	2471	111886	1688	0	117001
27215	968	1178	2257	111647	0	116050
27216	908	583	1294	114755	0	117540
27217	861	677	112525	3537	0	117600
27218	101652	590	2397	2107	0	106746
27219	2538	112460	1387	1379	0	117764
27220	1851	2270	735	113209	0	118065
27221	1173	1196	758	110871	0	113998
27222	1182	722	661	109851	0	112416
27223	1044	112021	856	3482	0	117403
27224	110961	2392	801	2231	0	116385
27225	2895	1357	112102	1469	0	117823
27226	1756	712	108481	1305	0	112254
27227	1210	566	3205	107616	0	112597
27228	1112	542	1508	111658	0	114820
27229	110025	602	890	3905	0	115422
27230	2728	108956	938	2208	0	114830
27231	1827	2415	747	110618	0	115607
27232	109368	1418	749	3186	0	114721
27233	3052	859	632	108151	0	112694
27234	108874	653	789	3181	0	113497
27235	3134	768	104960	2108	0	110970
27236	1830	106906	2645	1461	0	112842
27237	107059	2399	1608	1437	0	112503
27238	3038	1581	106525	1223	0	112367
27239	102908	670	2609	1476	0	107663
27240	3028	765	103942	1402	0	109137
27241	104315	642	2670	1277	0	108904
27242	3134	707	1450	103804	0	109095
27243	106120	684	890	2991	0	110685
27244	2999	700	766	105515	0	109980
27245	1970	611	669	107112	0	110362
27246	104778	688	734	3996	0	110196
27247	2849	106048	895	2230	0	112022
27248	1794	2507	708	107503	0	112512
27249	108188	1334	723	3306	0	113551
27250	110809	765	778	2242	0	114594
27251	3740	674	711	109309	0	114434
27252	2167	603	581	112098	0	115449
27253	109785	627	568	4012	0	114992
27254	3229	606	521	110746	0	115102
27255	1952	694	546	108949	0	112141
27256	104972	490	522	3812	0	109796
27257	3005	453	513	103079	0	107050
27258	1424	395	96201	2801	0	100821
27259	91052	308	2152	1809	0	95321
27260	2567	459	97759	843	0	101628
27261	1438	405	90729	705	0	93277
27262	83386	386	2901	569	0	87242
27263	1493	84109	1077	438	0	87117
27264	1172	1057	640	81663	0	84532
27265	574	560	260	83139	0	84533
27266	617	242	141	88972	0	89972
27267	495	156	123	90833	0	91607
27268	89045	127	139	2358	0	91669
27269	95117	172	129	1277	0	96695
27270	99924	147	132	776	0	100979
27271	2718	266	106212	551	0	109747
27272	1456	196	2073	110698	0	114423
27273	759	142	1132	113069	0	115102
27274	728	127	393	107683	0	108931
27275	502	104762	383	3904	0	109551
27276	441	110213	280	2096	0	113030
27277	112082	3421	229	1131	0	116863
27278	2891	1519	206	112581	0	117197
27279	1831	507	241	119142	0	121721
27280	844	306	206	122309	0	123665
27281	650	319	116826	4699	0	122494
27282	580	310	115216	2393	0	118499
27283	114693	207	4168	1153	0	120221
27284	121103	169	1911	904	0	124087
27285	4470	185	756	116409	0	121820
27286	2152	118934	596	3092	0	124774
27287	1221	2777	335	120052	0	124385
27288	950	1531	265	122075	0	124821
27289	640	604	117110	4825	0	123179
27290	114753	278	2698	2514	0	120243
27291	3326	172	1507	122138	0	127143
27292	2163	198	533	120955	0	123849
27293	116543	188	415	4772	0	121918
27294	3359	119866	494	2503	0	126222
27295	122680	2970	350	1339	0	127339
27296	4003	1978	332	118317	0	124630
27297	1990	113651	290	3407	0	119338
27298	115679	3060	229	2248	0	121216
27299	3777	1701	226	115340	0	121044
27300	115142	598	241	3645	0	119626
27301	114461	363	267	2289	0	117380
27302	114886	238	282	1227	0	116633
27303	4965	109529	427	980	0	115901
27304	2516	109440	419	831	0	113206
27305	1342	4292	285	105085	0	111004
27306	845	108765	437	3296	0	113343
27307	110396	3353	279	2178	0	116206
27308	3557	1870	273	110466	0	116166
27309	111029	680	288	3749	0	115746
27310	112932	469	310	2477	0	116188
27311	5155	381	341	109612	0	115489
27312	2791	341	339	114804	0	118275
27313	113219	404	318	5408	0	119349
27314	114931	437	301	2987	0	118656
27315	117917	426	295	1691	0	120329
27316	118911	496	274	1453	0	121134
27317	120469	525	228	1288	0	122510
27318	5937	454	204	115999	0	122594
27319	3250	523	259	118094	0	122126
27320	1912	517	289	120139	0	122857
27321	116042	481	309	5875	0	122707
27322	4219	427	278	115042	0	119966
27323	2684	114147	418	4434	0	121683
27324	1769	3257	254	117512	0	122792
27325	114922	2058	297	4423	0	121700
27326	116637	964	321	2823	0	120745
27327	5646	853	112466	1594	0	120559
27328	3298	749	2954	107263	0	114264
27329	1687	112036	1879	3778	0	119380
27330	113892	3193	588	2867	0	120540
27331	4032	115037	604	1704	0	121377
27332	2943	3509	324	115218	0	121994
27333	117118	2045	316	4082	0	123561
27334	118696	880	280	2741	0	122597
27335	5780	115280	369	1774	0	123203
27336	3512	3325	203	115003	0	122043
27337	2098	2151	113676	4085	0	122010
27338	110342	925	3018	2968	0	117253
27339	4478	859	114767	1702	0	121806
27340	116027	577	3444	1617	0	121665
27341	118775	586	1833	1593	0	122787
27342	6102	641	557	116468	0	123768
27343	119384	636	364	4435	0	124819
27344	120963	705	305	3021	0	124994
27345	122526	764	263	1815	0	125368
27346	6681	691	292	117507	0	125171
27347	117333	569	319	4195	0	122416
27348	4942	620	316	116113	0	121991
27349	3409	539	395	115422	0	119765
27350	1966	113737	609	5599	0	121911
27351	2123	3121	369	108572	0	114185
27352	1817	111798	450	3891	0	117956
27353	110286	3305	169	2659	0	116419
27354	111247	1987	219	1660	0	115113
27355	5409	940	183	108480	0	115012
27356	3341	636	211	110298	0	114486
27357	108009	561	261	5014	0	113845
27358	4248	586	104403	2828	0	112065
27359	106599	472	2652	1751	0	111474
27360	4705	502	1503	104346	0	111056
27361	2979	622	99230	3560	0	106391
27362	99143	493	2646	2506	0	104788
27363	102637	442	1499	1645	0	106223
27364	5289	558	98978	1207	0	106032
27365	98195	375	2546	1292	0	102408
27366	4094	525	94499	1057	0	100175
27367	2775	93480	2697	1035	0	99987
27368	93596	2302	2402	1151	0	99451
27369	91354	1496	852	1057	0	94759
27370	3997	85152	514	821	0	90484
27371	1877	78611	440	702	0	81630
27372	73678	1958	499	677	0	76812
27373	73820	897	240	625	0	75582
27374	2533	541	173	74733	0	77980
27375	1404	402	72787	1625	0	76218
27376	894	411	69850	984	0	72139
27377	71602	240	1748	717	0	74307
27378	1773	352	72826	500	0	75451
27379	68617	332	1656	537	0	71142
27380	1655	187	676	67706	0	70224
27381	1144	143	284	68629	0	70200
27382	700	291	69006	1718	0	71715
27383	68936	121	1092	1130	0	71279
27384	1479	128	739	70797	0	73143
27385	1156	103	353	75435	0	77047
27386	73754	112	252	1895	0	76013
27387	73875	120	221	1198	0	75414
27388	73990	113	234	699	0	75036
27389	1986	75068	335	504	0	77893
27390	947	904	69936	291	0	72078
27391	68129	448	828	390	0	69795
27392	70474	185	495	407	0	71561
27393	1353	68613	328	328	0	70622
27394	65210	556	239	312	0	66317
27395	939	330	133	63971	0	65373
27396	525	284	66430	638	0	67877
27397	65309	194	701	555	0	66759
27398	67607	99	315	445	0	68466
27399	68310	110	152	356	0	68928
27400	68618	89	126	280	0	69113
27401	1056	89	115	68156	0	69416
27402	561	76	111	68762	0	69510
27403	68808	67	128	1046	0	70049
27404	851	53	123	69115	0	70142
27405	529	51	125	68986	0	69691
27406	324	68646	186	927	0	70083
27407	345	534	116	70154	0	71149
27408	328	259	125	70469	0	71181
27409	334	100	115	70924	0	71473
27410	352	78	84	71419	0	71933
27411	243	70144	196	991	0	71574
27412	284	648	69	69083	0	70084
27413	239	330	105	67735	0	68409
27414	263	238	66348	913	0	67762
27415	257	197	62995	484	0	63933
27416	188	64996	807	289	0	66280
27417	74273	529	365	318	0	75485
27418	1004	75636	240	218	0	77098
27419	575	980	103	78514	0	80172
27420	290	576	82093	1158	0	84117
27421	85913	120	1241	835	0	88109
27422	1436	121	522	90768	0	92847
27423	91128	99	222	1602	0	93051
27424	92119	82	119	834	0	93154
27425	1790	92562	227	386	0	94965
27426	92804	1235	87	392	0	94518
27427	1384	97962	221	257	0	99824
27428	829	1619	86	99922	0	102456
27429	314	101955	176	1560	0	104005
27430	330	1690	101096	789	0	103905
27431	212	103496	1562	351	0	105621
27432	400	1700	675	101546	0	104321
27433	103052	724	219	1741	0	105736
27434	1524	105643	240	961	0	108368
27435	949	1668	96	107066	0	109779
27436	415	906	101	109875	0	111297
27437	328	445	109058	2611	0	112442
27438	372	254	1856	108799	0	111281
27439	362	315	109836	2129	0	112642
27440	103143	147	1983	1353	0	106626
27441	2204	298	111107	520	0	114129
27442	1182	111313	2086	469	0	115050
27443	725	2004	963	111666	0	115358
27444	661	1005	308	112380	0	114354
27445	596	501	211	113870	0	115178
27446	113017	329	230	3191	0	116767
27447	2299	427	182	110868	0	113776
27448	1129	111715	390	2305	0	115539
27449	109973	2241	209	1368	0	113791
27450	2067	108888	354	734	0	112043
27451	1311	2354	218	108233	0	112116
27452	108803	1224	212	2402	0	112641
27453	2210	106828	328	1408	0	110774
27454	1161	111421	317	801	0	113700
27455	111136	2967	291	843	0	115237
27456	112748	1305	268	904	0	115225
27457	3037	669	111258	696	0	115660
27458	112440	444	2261	795	0	115940
27459	2716	599	115745	601	0	119661
27460	1571	535	2507	116212	0	120825
27461	732	595	117331	2712	0	121370
27462	712	459	2545	117296	0	121012
27463	576	559	118908	3027	0	123070
27464	710	446	2526	116511	0	120193
27465	640	416	1279	120783	0	123118
27466	117540	478	553	3934	0	122505
27467	2690	607	116890	1867	0	122054
27468	110790	563	2544	1118	0	115015
27469	2850	604	116458	974	0	120886
27470	1604	663	116952	825	0	120044
27471	965	627	3196	115656	0	120444
27472	117783	525	1418	2938	0	122664
27473	2569	118123	738	1725	0	123155
27474	116547	2490	488	991	0	120516
27475	116976	1347	587	919	0	119829
27476	3576	115988	635	867	0	121066
27477	115999	2477	579	823	0	119878
27478	2988	1590	117670	754	0	123002
27479	1823	666	2606	118078	0	123173
27480	118633	519	1390	3009	0	123551
27481	2691	119668	910	1780	0	125049
27482	1766	2486	619	119724	0	124595
27483	1085	1325	650	121052	0	124112
27484	1008	654	652	122739	0	125053
27485	996	518	702	123421	0	125637
27486	120624	449	684	4014	0	125771
27487	122359	453	766	2159	0	125737
27488	123633	440	791	1303	0	126167
27489	120593	432	800	1269	0	123094
27490	3930	571	118097	937	0	123535
27491	115711	506	2682	1067	0	119966
27492	120872	487	1567	1011	0	123937
27493	3969	119212	924	922	0	125027
27494	2057	122593	842	850	0	126342
27495	1506	3351	754	118833	0	124444
27496	1292	1562	740	121045	0	124639
27497	1118	871	118846	3716	0	124551
27498	1028	119920	2861	1946	0	125755
27499	1215	2574	1545	117484	0	122818
27500	1034	121453	990	2764	0	126241
27501	1118	2689	630	125035	0	129472
27502	1151	1438	574	124389	0	127552
27503	1033	129146	835	3939	0	134953
27504	1223	2631	649	131263	0	135766
27505	1169	1625	131106	3299	0	137199
27506	1207	793	128035	2066	0	132101
27507	123888	518	3802	1403	0	129611
27508	132479	485	1815	1283	0	136062
27509	4236	130582	1039	1293	0	137150
27510	132434	2590	666	1084	0	136774
27511	3715	1603	598	130840	0	136756
27512	130906	758	582	3151	0	135397
27513	3359	129553	722	2283	0	135917
27514	2452	2766	127638	1174	0	134030
27515	123005	1542	2926	1223	0	128696
27516	3435	1033	135927	1015	0	141410
27517	1891	653	124324	768	0	127636
27518	1108	660	123775	803	0	126346
27519	856	122799	3094	813	0	127562
27520	118250	2307	2623	928	0	124108
27521	115008	1158	665	874	0	117705
27522	2885	742	485	112989	0	117101
27523	1630	449	470	111816	0	114365
27524	769	114876	648	2658	0	118951
27525	115494	1709	470	1615	0	119288
27526	2002	116604	634	827	0	120067
27527	1233	112469	599	690	0	114991
27528	110333	1980	593	781	0	113687
27529	1867	935	477	108859	0	112138
27530	1220	407	379	109318	0	111324
27531	727	399	370	110136	0	111632
27532	573	108563	438	2250	0	111824
27533	106743	1258	263	1115	0	109379
27534	1758	971	256	104946	0	107931
27535	1024	102234	369	1344	0	104971
27536	481	102917	337	841	0	104576
27537	556	1641	263	99044	0	101504
27538	434	100801	350	1172	0	102757
27539	553	1286	312	100126	0	102277
27540	97242	780	270	1444	0	99736
27541	1238	492	96340	811	0	98881
27542	790	97896	1056	468	0	100210
27543	627	1105	623	98922	0	101277
27544	425	838	100976	1177	0	103416
27545	95590	353	1163	952	0	98058
27546	1520	386	710	101811	0	104427
27547	101766	240	272	1540	0	103818
27548	101585	243	233	974	0	103035
27549	1696	107389	342	460	0	109887
27550	109543	1190	187	578	0	111498
27551	109028	766	207	576	0	110577
27552	109738	334	179	559	0	110810
27553	1985	312	165	107277	0	109739
27554	1031	320	181	107070	0	108602
27555	667	292	148	108275	0	109382
27556	498	448	105910	1896	0	108752
27557	377	104522	1074	982	0	106955
27558	102033	980	601	614	0	104228
27559	927	102568	300	436	0	104231
27560	708	925	118	102069	0	103820
27561	362	744	100624	991	0	102721
27562	89209	283	873	952	0	91317
27563	912	100832	565	362	0	102671
27564	716	932	167	100081	0	101896
27565	361	591	137	100246	0	101335
27566	298	381	98567	1347	0	100593
27567	212	98802	898	730	0	100642
27568	357	918	510	98978	0	100763
27569	344	616	191	99575	0	100726
27570	366	263	176	96827	0	97632
27571	92340	232	176	1639	0	94387
27572	974	344	93674	768	0	95760
27573	647	93058	903	423	0	95031
27574	92259	818	499	519	0	94095
27575	910	93993	275	374	0	95552
27576	734	974	172	91759	0	93639
27577	389	96475	230	897	0	97991
27578	93986	984	141	790	0	95901
27579	95991	665	178	546	0	97380
27580	1606	310	131	99794	0	101841
27581	940	273	147	101159	0	102519
27582	557	231	155	106518	0	107461
27583	447	353	106978	2137	0	109915
27584	353	111084	1470	1239	0	114146
27585	476	1596	863	127335	0	130270
27586	422	998	291	131127	0	132838
27587	460	348	211	132747	0	133766
27588	496	258	211	132729	0	133694
27589	373	456	129251	3800	0	133880
27590	282	135964	2233	2038	0	140517
27591	456	2580	1333	141917	0	146286
27592	489	1670	354	153224	0	155737
27593	424	756	149527	4671	0	155378
27594	484	460	2816	143536	0	147296
27595	299	144218	1905	3623	0	150045
27596	277	150416	763	2477	0	153933
27597	463	4504	367	147632	0	152966
27598	407	2319	143830	3573	0	150129
27599	127774	803	2964	3043	0	134584
27600	2818	141955	2029	1678	0	148480
27601	1777	3130	138862	1128	0	144897
27602	667	2157	140225	1067	0	144116
27603	373	136637	4508	1056	0	142574
27604	671	3177	140163	935	0	144946
27605	801	2734	3548	135311	0	142394
27606	136228	867	2136	3284	0	142515
27607	138401	674	1017	2237	0	142329
27608	139485	742	786	1200	0	142213
27609	143075	758	774	982	0	145589
27610	4570	144240	773	1055	0	150638
27611	144965	3124	695	1223	0	150007
27612	3604	146832	904	1160	0	152500
27613	2435	3617	145060	969	0	152081
27614	1433	2303	3318	137954	0	145008
27615	887	148545	2244	3306	0	154982
27616	1005	3654	975	142663	0	148297
27617	139435	2487	767	4180	0	146869
27618	3546	1117	803	135140	0	140606
27619	2196	141048	927	3984	0	148155
27620	141858	3526	832	2745	0	148961
27621	3679	2424	142217	1709	0	150029
27622	2624	1327	3413	140847	0	148211
27623	1323	959	2309	143307	0	147898
27624	138105	1021	1091	5595	0	145812
27625	3487	138041	1057	3403	0	145988
27626	2464	3831	136980	1713	0	144988
27627	1539	2587	3442	137496	0	145064
27628	1176	1359	140081	4321	0	146937
27629	1045	134010	3852	3425	0	142332
27630	1038	140536	2516	2200	0	146290
27631	137876	5025	1334	1981	0	146216
27632	3581	3172	137933	1872	0	146558
27633	139227	1649	3958	2002	0	146836
27634	3941	1469	2835	133973	0	142218
27635	2374	139327	1869	4168	0	147738
27636	138725	3922	1309	3335	0	147291
27637	3902	2983	141212	2164	0	150261
27638	3091	1716	3859	139824	0	148490
27639	1870	1479	2742	141944	0	148035
27640	1659	1628	1631	138769	0	143687
27641	1431	140300	1617	5706	0	149054
27642	135258	4088	1383	3711	0	144440
27643	3803	136185	1586	2262	0	143836
27644	2713	137718	1606	2025	0	144062
27645	1879	5210	1430	136778	0	145297
27646	136840	3106	1528	4363	0	145837
27647	136990	1883	1434	3400	0	143707
27648	136945	1946	1291	2258	0	142440
27649	5565	129444	1470	1894	0	138373
27650	3648	4006	1318	129770	0	138742
27651	2307	3193	129401	4202	0	139103
27652	2278	1822	3792	129437	0	137329
27653	2251	1759	2646	125152	0	131808
27654	1999	129608	1581	5529	0	138717
27655	130769	4240	1290	3624	0	139923
27656	4449	3181	1399	126202	0	135231
27657	3107	130262	1563	4579	0	139511
27658	130042	4194	1474	3590	0	139300
27659	4334	3319	128067	2491	0	138211
27660	125967	2130	3577	2316	0	133990
27661	4628	129672	2833	2153	0	139286
27662	131701	4370	1422	1993	0	139486
27663	132250	3329	1312	1998	0	138889
27664	5780	2412	130011	1941	0	140144
27665	130841	1964	3791	1838	0	138434
27666	5025	1932	136332	1767	0	145056
27667	3755	1975	137036	1725	0	144491
27668	133980	1803	5187	1700	0	142670
27669	138052	1675	3114	1819	0	144660
27670	6239	1937	137538	1687	0	147401
27671	3956	1538	4406	134786	0	144686
27672	2746	1595	3082	132755	0	140178
27673	2313	141730	2050	5161	0	151254
27674	140506	4050	1639	3358	0	149553
27675	144561	3039	1227	2293	0	151120
27676	6599	2097	141713	1741	0	152150
27677	141277	1561	3654	1894	0	148386
27678	144189	1648	2549	1742	0	150128
27679	6200	141755	1849	1625	0	151429
27680	3877	3910	1368	137171	0	146326
27681	3096	2716	1208	134474	0	141494
27682	2554	1486	1130	132905	0	138075
27683	125596	1165	1250	4693	0	132704
27684	3746	120827	1144	2858	0	128575
27685	2200	2623	687	102715	0	108225
27686	1368	103565	773	2230	0	107936
27687	1276	4365	610	96657	0	102908
27688	1143	99611	711	2098	0	103563
27689	1086	101491	822	1540	0	104939
27690	90843	2440	1330	1248	0	95861
27691	88931	1070	950	1001	0	91952
27692	1529	411	231	82369	0	84540
27693	861	191	227	83535	0	84814
27694	504	205	218	84344	0	85271
27695	396	208	233	84592	0	85429
27696	399	184	206	83584	0	84373
27697	339	82418	233	1533	0	84523
27698	459	1002	193	83383	0	85037
27699	503	553	184	84753	0	85993
27700	82374	275	189	1503	0	84341
27701	1284	237	192	83984	0	85697
27702	792	218	167	83206	0	84383
27703	507	362	82126	1538	0	84533
27704	427	258	952	79612	0	81249
27705	431	439	518	83283	0	84671
27706	486	282	84149	1600	0	86517
27707	326	85707	1082	1050	0	88165
27708	313	1103	86523	426	0	88365
27709	341	562	84529	299	0	85731
27710	158	81051	1231	284	0	82724
27711	82793	898	565	352	0	84608
27712	82190	402	219	312	0	83123
27713	1226	173	88	80225	0	81712
27714	80604	111	105	1114	0	81934
27715	1001	197	82248	506	0	83952
27716	567	95	855	82579	0	84096
27717	294	244	89975	1074	0	91587
27718	263	116	930	90338	0	91647
27719	274	134	439	91210	0	92057
27720	226	105	160	92405	0	92896
27721	91161	130	124	1717	0	93132
27722	1097	117	118	93236	0	94568
27723	92500	128	129	1381	0	94138
27724	93999	129	115	875	0	95118
27725	1350	94032	227	477	0	96086
27726	94260	976	115	525	0	95876
27727	1103	97233	235	386	0	98957
27728	665	1068	163	95403	0	97299
27729	372	549	128	98100	0	99149
27730	331	224	139	99326	0	100020
27731	296	347	96087	1796	0	98526
27732	228	95422	1194	991	0	97835
27733	387	1193	578	89970	0	92128
27734	390	666	239	90184	0	91479
27735	248	95466	252	1472	0	97438
27736	95515	1125	145	922	0	97707
27737	1197	93445	234	654	0	95530
27738	92663	1191	159	635	0	94648
27739	1251	93990	266	572	0	96079
27740	853	1285	145	89336	0	91619
27741	293	94778	237	1289	0	96597
27742	95599	1242	145	1035	0	98021
27743	96729	627	128	753	0	98237
27744	96002	268	139	703	0	97112
27745	95914	222	154	655	0	96945
27746	1868	383	94348	502	0	97101
27747	95219	221	1163	655	0	97258
27748	98354	216	598	743	0	99911
27749	98428	281	248	680	0	99637
27750	1850	430	96167	487	0	98934
27751	95663	287	1077	687	0	97714
27752	1352	98856	655	620	0	101483
27753	100418	1161	259	737	0	102575
27754	1416	835	105689	545	0	108485
27755	104963	280	1095	720	0	107058
27756	107499	289	556	698	0	109042
27757	1765	262	246	106612	0	108885
27758	925	418	106225	1372	0	108940
27759	105807	233	1100	1152	0	108292
27760	1452	239	580	109744	0	112015
27761	937	243	333	112168	0	113681
27762	569	429	111343	1833	0	114174
27763	101663	253	1179	1194	0	104289
27764	111106	239	619	881	0	112845
27765	1716	111113	422	573	0	113824
27766	1029	1316	244	108452	0	111041
27767	697	668	264	108895	0	110524
27768	662	304	281	107544	0	108791
27769	529	109245	431	1717	0	111922
27770	108211	1165	229	1025	0	110630
27771	1492	655	233	107627	0	110007
27772	1027	281	195	108370	0	109873
27773	104764	235	258	1860	0	107117
27774	103920	214	249	1129	0	105512
27775	1768	245	313	105533	0	107859
27776	1101	239	281	104688	0	106309
27777	605	414	99700	1676	0	102395
27778	92045	218	1022	1143	0	94428
27779	1436	101299	671	514	0	103920
27780	1025	1172	241	108218	0	110656
27781	713	610	211	111170	0	112704
27782	583	117326	329	2322	0	120560
27783	661	1855	209	121483	0	124208
27784	129287	1099	295	2548	0	133229
27785	2730	463	235	147443	0	150871
27786	1679	305	169	151380	0	153533
27787	917	303	142	154451	0	155813
27788	691	461	149540	5615	0	156307
27789	732	282	3053	152342	0	156409
27790	608	396	149982	4351	0	155337
27791	471	146209	3502	2586	0	152768
27792	706	2977	1894	147374	0	152951
27793	603	1737	762	150189	0	153291
27794	658	683	352	153905	0	155598
27795	590	340	349	154232	0	155511
27796	519	342	294	156058	0	157213
27797	147032	225	245	6079	0	153581
27798	3239	402	148437	3054	0	155132
27799	1907	144485	3109	1628	0	151129
27800	825	153585	1928	1144	0	157482
27801	681	4517	641	153768	0	159607
27802	646	2180	355	157851	0	161032
27803	635	837	311	157126	0	158909
27804	440	154105	432	5578	0	160555
27805	665	3130	213	156547	0	160555
27806	620	1963	149777	4474	0	156834
27807	321	146749	3021	2788	0	152879
27808	585	3177	1768	148559	0	154089
27809	146033	1838	766	4105	0	152742
27810	3050	880	423	148637	0	152990
27811	2004	580	372	147342	0	150298
27812	851	139242	509	5263	0	145865
27813	618	150002	488	3277	0	154385
27814	672	4150	384	150573	0	155779
27815	570	2062	352	152729	0	155713
27816	445	1091	149292	5665	0	156493
27817	517	681	2866	145951	0	150015
27818	436	600	1820	147779	0	150635
27819	534	560	928	147090	0	149112
27820	504	534	605	150005	0	151648
27821	142823	576	546	6608	0	150553
27822	144585	524	472	4208	0	149789
27823	4807	488	450	146277	0	152022
27824	2657	413	442	150001	0	153513
27825	145084	433	527	6841	0	152885
27826	3626	566	531	150792	0	155515
27827	2276	716	147375	5913	0	156280
27828	1050	147218	3492	4225	0	155985
27829	850	3292	2284	149570	0	155996
27830	672	2196	1158	153482	0	157508
27831	150296	1213	705	6846	0	159060
27832	3286	872	670	155420	0	160248
27833	2235	868	543	158226	0	161872
27834	154880	761	487	7331	0	163459
27835	3660	831	526	157440	0	162457
27836	2307	155652	676	5921	0	164556
27837	1385	3588	611	165007	0	170591
27838	1048	2551	550	169778	0	173927
27839	1023	1387	522	170378	0	173310
27840	842	1047	543	172186	0	174618
27841	684	1315	162578	7896	0	172473
27842	623	1225	161127	5138	0	168113
27843	689	967	5018	164614	0	171288
27844	769	959	2656	163185	0	167569
27845	533	163394	1462	7405	0	172794
27846	798	3877	870	159838	0	165383
27847	688	161471	1060	6207	0	169426
27848	158832	4197	724	4826	0	168579
27849	3621	165140	849	3584	0	173194
27850	2743	4453	503	168230	0	175929
27851	1589	2654	415	172974	0	177632
27852	1011	1715	165864	7873	0	176463
27853	155608	1028	3528	5584	0	165748
27854	159705	989	2347	3934	0	166975
27855	5414	158841	1433	3597	0	169285
27856	3335	3730	862	154736	0	162663
27857	1845	2683	162937	5911	0	173376
27858	1133	166151	4013	4707	0	176004
27859	164218	3894	2347	3898	0	174357
27860	165425	2519	1078	3536	0	172558
27861	6064	1469	158159	3322	0	169014
27862	159818	881	3589	3243	0	167531
27863	5241	860	2270	159942	0	168313
27864	3134	160872	1509	5840	0	171355
27865	161211	3840	815	4749	0	170615
27866	4545	2610	768	162561	0	170484
27867	163763	1389	723	6193	0	172068
27868	169482	1028	766	5083	0	176359
27869	6288	1079	679	167058	0	175104
27870	3550	1241	166860	6350	0	178001
27871	165978	976	3800	5284	0	176038
27872	173095	872	2395	3826	0	180188
27873	173183	864	1214	3401	0	178662
27874	6594	174049	1194	3169	0	185006
27875	3857	4118	738	174003	0	182716
27876	2281	2747	629	181518	0	187175
27877	1435	1854	175377	8152	0	186818
27878	1700	1279	3935	171869	0	178783
27879	1158	171599	2944	6349	0	182050
27880	163641	3654	1232	4344	0	172871
27881	3734	164197	1142	2922	0	171995
27882	2530	3648	155822	1971	0	163971
27883	1143	158206	3594	1939	0	164882
27884	879	154131	2330	1418	0	158758
27885	1577	2764	1170	131917	0	137428
27886	132274	1178	472	2298	0	136222
27887	131950	470	340	1636	0	134396
27888	130045	324	282	1026	0	131677
27889	2663	132879	388	818	0	136748
27890	1462	1872	130904	610	0	134848
27891	130126	1081	1612	799	0	133618
27892	134770	429	986	873	0	137058
27893	2678	133491	527	640	0	137336
27894	135733	1726	310	808	0	138577
27895	2273	1115	296	134915	0	138599
27896	1408	788	140419	2052	0	144667
27897	140187	389	1782	1695	0	144053
27898	142691	390	1042	1053	0	145176
27899	148309	359	445	900	0	150013
27900	3235	434	321	145207	0	149197
27901	1798	452	316	151700	0	154266
27902	956	430	293	158357	0	160036
27903	660	157138	544	3859	0	162201
27904	1068	2769	385	159731	0	163953
27905	905	1588	248	177823	0	180564
27906	805	994	175242	4650	0	181691
27907	918	603	3013	176147	0	180681
27908	867	527	1708	180249	0	183351
27909	926	470	664	180152	0	182212
27910	915	537	460	178779	0	180691
27911	736	177067	641	5391	0	183835
27912	1001	3294	435	180001	0	184731
27913	1022	1892	402	179295	0	182611
27914	174074	737	531	5503	0	180845
27915	3747	810	173507	2716	0	180780
27916	2347	854	169250	1309	0	173760
27917	166203	512	4665	1291	0	172671
27918	173755	508	2153	1174	0	177590
27919	5466	735	878	150161	0	157240
27920	2627	170067	732	3183	0	176609
27921	171314	3189	500	2110	0	177113
27922	4027	1932	504	165623	0	172086
27923	2307	171137	735	3532	0	177711
27924	170075	3070	392	2397	0	175934
27925	3547	172132	576	1223	0	177478
27926	170182	3349	424	1191	0	175146
27927	165697	1863	386	1313	0	169259
27928	4724	162034	629	1093	0	168480
27929	2640	3110	430	162330	0	168510
27930	1379	2201	160744	3649	0	167973
27931	1212	1110	2930	159218	0	164470
27932	158281	664	1596	4217	0	164758
27933	3406	891	156467	2648	0	163412
27934	2074	155508	3062	1757	0	162401
27935	1293	3317	1710	154353	0	160673
27936	1143	2040	152446	3621	0	159250
27937	804	149946	3058	2492	0	156300
27938	148961	3089	1897	1687	0	155634
27939	3288	1680	902	149975	0	155845
27940	2179	809	631	151683	0	155302
27941	1305	711	600	148479	0	151095
27942	821	148762	732	4821	0	155136
27943	148277	2886	516	2885	0	154564
27944	3142	147176	726	1664	0	152708
27945	2024	151391	588	1371	0	155374
27946	150953	3924	470	1418	0	156765
27947	151889	2071	430	1312	0	155702
27948	4438	1262	147720	1066	0	154486
27949	144891	810	2624	1116	0	149441
27950	144389	832	1581	1029	0	147831
27951	4788	754	742	140723	0	147007
27952	2602	1006	139785	3216	0	146609
27953	1733	698	2683	140342	0	145456
27954	142619	587	1666	3894	0	148766
27955	3580	910	147941	2303	0	154734
27956	2572	728	3100	160899	0	167299
27957	1724	676	1850	173664	0	177914
27958	1462	709	869	186654	0	189694
27959	181082	648	700	7945	0	190375
27960	5420	183418	995	3944	0	193777
27961	184876	5361	634	2110	0	192981
27962	6252	2724	183509	1779	0	194264
27963	3303	1146	5272	175622	0	185343
27964	1424	184428	2704	5811	0	194367
27965	186510	5379	1047	3338	0	196274
27966	6144	2628	745	186406	0	195923
27967	3110	1520	182320	6221	0	193171
27968	1754	937	5067	180849	0	188607
27969	175513	881	2467	6442	0	185303
27970	5340	174842	1398	3725	0	185305
27971	3227	5661	702	158175	0	167765
27972	1517	174816	914	5144	0	182391
27973	172626	5422	721	3024	0	181793
27974	172029	2473	682	1825	0	177009
27975	6940	168959	919	1507	0	178325
27976	169505	4987	632	1457	0	176581
27977	6166	2478	513	160752	0	169909
27978	2903	166502	795	5001	0	175201
27979	166779	5075	614	2778	0	175246
27980	169157	2456	598	1646	0	173857
27981	7346	161916	879	1227	0	171368
27982	3330	165204	883	1176	0	170593
27983	161803	6494	530	1138	0	169965
27984	6118	2799	545	160238	0	169700
27985	163106	1284	535	5379	0	170304
27986	6222	1058	410	162551	0	170241
27987	3190	1057	159540	5612	0	169399
27988	1907	924	4647	163080	0	170558
27989	159411	872	2073	6087	0	168443
27990	5837	1003	160734	2898	0	170472
27991	3180	838	4900	160102	0	169020
27992	1975	774	2177	167754	0	172680
27993	1372	925	163219	7235	0	172751
27994	156412	769	5025	3341	0	165547
27995	5855	787	2273	162958	0	171873
27996	2982	915	155095	5541	0	164533
27997	142685	789	4974	3128	0	151576
27998	5076	152812	2654	1963	0	162505
27999	2472	152839	1307	1578	0	158196
28000	1534	156152	1062	1332	0	160080
28001	1485	6013	143744	1191	0	152433
28002	1430	3234	4178	136331	0	145173
28003	1101	1160	138929	4631	0	145821
28004	1125	2967	3906	123402	0	131400
28005	695	120592	1816	4130	0	127233
28006	758	122946	784	1989	0	126477
28007	1197	4583	565	119878	0	126223
28008	120035	1712	490	4114	0	126351
28009	3922	787	396	122363	0	127468
28010	1847	723	393	121276	0	124239
28011	975	120121	545	4760	0	126401
28012	118235	3508	390	2132	0	124265
28013	3661	120798	543	1231	0	126233
28014	2043	3707	445	120761	0	126956
28015	1245	1640	408	121926	0	125219
28016	915	119966	560	5186	0	126627
28017	1219	3641	390	122470	0	127720
28018	121097	1787	363	4842	0	128089
28019	4579	1384	354	121786	0	128103
28020	2689	1285	483	121547	0	126004
28021	1702	119936	864	4853	0	127355
28022	1648	3778	810	122446	0	128682
28023	116877	1972	683	4630	0	124162
28024	121461	1415	501	2627	0	126004
28025	123603	1212	580	1721	0	127116
28026	5827	983	657	120647	0	128114
28027	2805	1031	118044	4719	0	126599
28028	1840	1127	118760	2706	0	124433
28029	1814	1127	4519	120254	0	127714
28030	121338	1438	1624	4621	0	129021
28031	4618	1339	731	122571	0	129259
28032	124413	1287	558	4915	0	131173
28033	5420	1173	546	124616	0	131755
28034	3414	1121	524	126967	0	132026
28035	124930	1247	517	5576	0	132270
28036	4950	1430	121551	2597	0	130528
28037	122465	1169	3550	1945	0	129129
28038	5061	1303	123139	1525	0	131028
28039	3232	1033	3763	121991	0	130019
28040	124617	993	1759	4534	0	131903
28041	4892	1374	126293	2200	0	134759
28042	2660	1454	127214	1456	0	132784
28043	122991	1077	4939	1624	0	130631
28044	5051	980	127656	1788	0	135475
28045	2669	125139	4384	1978	0	134170
28046	1845	3824	2150	130463	0	138282
28047	137431	1790	1394	5532	0	146147
28048	4620	1137	140684	2922	0	149363
28049	141093	690	4385	2221	0	148389
28050	146604	639	2422	2049	0	151714
28051	147102	650	1458	2225	0	151435
28052	147029	673	1198	2259	0	151159
28053	6226	1444	1247	138853	0	147770
28054	2850	139356	1367	4725	0	148298
28055	132241	3500	1091	3045	0	139877
28056	3718	1509	118548	1544	0	125319
28057	1252	99428	1801	838	0	103319
28058	93215	1172	1101	698	0	96186
28059	1261	90305	517	528	0	92611
28060	953	94069	340	427	0	95789
28061	1663	1501	955	92541	0	96660
28062	504	649	398	95782	0	97333
28063	454	245	332	96368	0	97399
28064	97003	206	287	1877	0	99373
28065	100164	185	287	1097	0	101733
28066	2126	150	291	103120	0	105687
28067	1206	163	339	108932	0	110640
28068	641	312	110588	2369	0	113910
28069	105770	152	1778	1392	0	109092
28070	112850	189	1075	619	0	114733
28071	2789	165	471	111179	0	114604
28072	1567	142	293	112412	0	114414
28073	732	245	110632	2740	0	114349
28074	742	155	1839	109977	0	112713
28075	746	213	113727	2079	0	116765
28076	592	111933	2085	1513	0	116123
28077	645	1715	114376	684	0	117420
28078	632	1111	1968	110113	0	113824
28079	469	510	116916	1951	0	119846
28080	494	403	112588	1155	0	114640
28081	113599	278	2751	659	0	117287
28082	2149	349	1305	121826	0	125629
28083	1329	340	122246	2038	0	125953
28084	111290	259	2157	1447	0	115153
28085	2272	388	123043	721	0	126424
28086	1485	387	132095	604	0	134571
28087	813	134909	3010	966	0	139698
28088	705	1802	1304	134849	0	138660
28089	663	1087	134534	2195	0	138479
28090	750	526	132351	1296	0	134923
28091	762	247	2894	129921	0	133824
28092	833	316	1486	130101	0	132736
28093	621	134157	890	2746	0	138414
28094	776	1906	544	135477	0	138703
28095	136832	1030	511	2720	0	141093
28096	136538	412	568	1870	0	139388
28097	138879	296	595	1173	0	140943
28098	3303	295	593	134703	0	138894
28099	1634	136695	759	2455	0	141543
28100	136116	1894	650	1724	0	140384
28101	2173	137964	779	960	0	141876
28102	1342	135043	816	824	0	138025
28103	739	137874	826	835	0	140274
28104	137885	2656	729	987	0	142257
28105	2224	1281	809	137244	0	141558
28106	1515	580	755	137385	0	140235
28107	791	138188	902	2987	0	142868
28108	134936	1923	882	1767	0	139508
28109	2293	1353	135051	843	0	139540
28110	1482	555	2366	135454	0	139857
28111	135693	410	1631	2465	0	140199
28112	2095	138687	1122	1655	0	143559
28113	144175	1959	792	1382	0	148308
28114	2484	1183	825	144183	0	148675
28115	1464	148548	969	2351	0	153332
28116	1028	2078	145474	1586	0	150166
28117	142404	1212	2211	1221	0	147048
28118	2444	632	1434	150721	0	155231
28119	152821	539	780	2661	0	156801
28120	2627	664	675	150955	0	154921
28121	1641	150054	807	2572	0	155074
28122	1195	2163	153521	1592	0	158471
28123	1015	1479	153223	1162	0	156879
28124	969	1446	2732	152108	0	157255
28125	156171	554	1635	2427	0	160787
28126	157126	523	736	1651	0	160036
28127	2941	539	609	155074	0	159163
28128	1687	449	618	157104	0	159858
28129	158198	474	545	3113	0	162330
28130	2425	497	564	159428	0	162914
28131	158751	519	600	2762	0	162632
28132	2359	156631	723	1832	0	161545
28133	154971	1978	615	1387	0	158951
28134	2624	1495	160148	907	0	165174
28135	1821	693	2108	159323	0	163945
28136	1260	537	1384	164112	0	167293
28137	1167	539	889	164046	0	166641
28138	945	159161	840	3351	0	164297
28139	930	149994	805	2145	0	153874
28140	897	2578	650	159667	0	163792
28141	783	1493	156040	2510	0	160826
28142	816	717	2058	155139	0	158730
28143	863	510	1370	158871	0	161614
28144	699	156238	1023	3061	0	161021
28145	153173	1873	797	1765	0	157608
28146	1980	151858	900	1098	0	155836
28147	1354	151666	917	988	0	154925
28148	1079	2624	754	148410	0	152867
28149	1013	1215	658	150994	0	153880
28150	1031	653	555	150769	0	153008
28151	985	539	610	152268	0	154402
28152	147612	466	643	3280	0	152001
28153	1996	149043	846	1825	0	153710
28154	150273	1821	674	1314	0	154082
28155	153574	1080	685	1383	0	156722
28156	2754	715	571	152135	0	156175
28157	1658	613	434	154701	0	157406
28158	152383	503	443	3199	0	156528
28159	154005	564	437	2115	0	157121
28160	2876	617	342	150732	0	154567
28161	1807	584	258	151561	0	154210
28162	1092	689	150114	2859	0	154754
28163	915	145541	1591	1803	0	149850
28164	874	154054	873	1037	0	156838
28165	146701	1757	469	995	0	149922
28166	1654	1030	149389	698	0	152771
28167	813	629	138535	594	0	140571
28168	126983	313	1366	709	0	129371
28169	138746	258	626	641	0	140271
28170	1147	148486	334	478	0	150445
28171	678	155887	264	455	0	157284
28172	481	1113	137	158014	0	159745
28173	163692	520	156	1540	0	165908
28174	165115	305	128	1093	0	166641
28175	166128	246	113	997	0	167484
28176	1324	321	123	164017	0	165785
28177	749	288	121	166284	0	167442
28178	538	449	164547	1310	0	166844
28179	434	431	153014	790	0	154669
28180	452	411	163933	532	0	165328
28181	536	2342	926	159794	0	163598
28182	158842	124	476	1041	0	160483
28183	765	390	165380	537	0	167072
28184	539	155	579	163635	0	164908
28185	299	167965	439	793	0	169496
28186	316	651	149	163911	0	165027
28187	321	346	119	165684	0	166470
28188	279	452	169726	1258	0	171715
28189	315	156	969	167959	0	169399
28190	171953	127	533	1496	0	174109
28191	1534	431	181067	679	0	183711
28192	908	199	1325	180725	0	183157
28193	403	345	185435	1571	0	187754
28194	270	184816	1596	1077	0	187759
28195	519	1599	185691	447	0	188256
28196	423	872	1612	174746	0	177653
28197	340	255	830	188720	0	190145
28198	336	439	194927	2312	0	198014
28199	393	170	1575	189106	0	191244
28200	405	169	898	188752	0	190224
28201	266	190258	501	2377	0	193402
28202	370	1669	193291	1175	0	196505
28203	419	819	1679	190569	0	193486
28204	404	308	939	194664	0	196315
28205	238	197276	575	2558	0	200647
28206	361	1853	298	199481	0	201993
28207	200856	901	292	2388	0	204437
28208	1884	320	296	202025	0	204525
28209	1060	528	202911	2261	0	206760
28210	196028	202	2011	1737	0	199978
28211	212101	212	1168	1057	0	214538
28212	3264	468	215548	617	0	219897
28213	203200	235	2434	1130	0	206999
28214	2510	217731	1674	724	0	222639
28215	1605	2328	575	222604	0	227112
28216	718	1342	503	240348	0	242911
28217	613	444	459	239929	0	241445
28218	612	315	412	244432	0	245771
28219	574	272	437	244621	0	245904
28220	239566	243	444	5574	0	245827
28221	3291	515	238280	2516	0	244602
28222	224158	231	3225	1560	0	229174
28223	3505	559	234672	1118	0	239854
28224	2129	284	3460	232221	0	238094
28225	234275	278	1986	4043	0	240582
28226	3527	315	850	230971	0	235663
28227	2005	235503	845	3774	0	242127
28228	244041	3011	707	2767	0	250526
28229	3761	1765	658	253165	0	259349
28230	2230	831	242580	3865	0	249506
28231	229275	380	3065	2936	0	235656
28232	3658	259026	2081	1547	0	266312
28233	2461	3474	267725	1145	0	274805
28234	1353	1938	3652	262632	0	269575
28235	1210	670	2237	256934	0	261051
28236	874	262754	1073	5560	0	270261
28237	972	3590	263099	3045	0	270706
28238	1132	2049	3489	261791	0	268461
28239	899	1130	273023	4691	0	279743
28240	1035	562	3887	269248	0	274732
28241	1008	437	2334	274502	0	278281
28242	1059	738	272654	6451	0	280902
28243	1297	487	3983	271525	0	277292
28244	1717	974	3190	224194	0	230075
28245	1383	446	1365	289090	0	292284
28246	1216	448	1305	291260	0	294229
28247	279452	437	1122	7552	0	288563
28248	4640	808	278233	4130	0	287811
28249	279798	610	4541	2851	0	287800
28250	5256	650	2885	295484	0	304275
28251	3261	649	1516	301333	0	306759
28252	1751	683	1274	298019	0	301727
28253	1266	294791	1514	8499	0	306070
28254	298717	4603	1136	4823	0	309279
28255	5029	2689	1269	310851	0	319838
28256	2985	313061	1695	5967	0	323708
28257	1618	4367	1275	317581	0	324841
28258	317089	2645	1335	6961	0	328030
28259	315122	1248	1404	4846	0	322620
28260	316167	1027	1427	3304	0	321925
28261	6743	315207	1787	3087	0	326824
28262	3419	4672	317817	3020	0	328928
28263	311329	2659	4931	3498	0	322417
28264	323956	1083	3102	3343	0	331484
28265	6852	324995	1920	3009	0	336776
28266	325550	4520	1319	3288	0	334677
28267	322761	2662	1336	3213	0	329972
28268	328304	979	1109	3435	0	333827
28269	7743	333594	1483	3096	0	345916
28270	4390	4707	1338	332088	0	342523
28271	336476	2712	1145	7269	0	347602
28272	343292	1248	1070	5172	0	350782
28273	338946	1003	1016	3649	0	344614
28274	340547	981	955	3404	0	345887
28275	8903	1078	908	333907	0	344796
28276	4665	1604	331466	6998	0	344733
28277	3195	949	5189	327272	0	336605
28278	2526	333163	3282	7082	0	346053
28279	2889	5388	1292	344741	0	354310
28280	2650	3430	344539	7265	0	357884
28281	335812	1311	5742	4786	0	347651
28282	7703	1055	3267	349290	0	361315
28283	346232	1195	1406	7453	0	356286
28284	348415	1224	1335	5203	0	356177
28285	10008	1147	1123	351439	0	363717
28286	5669	1440	353035	7169	0	367313
28287	3823	1536	327135	4282	0	336776
28288	313451	1173	7241	2776	0	324641
28289	7035	337927	3568	2575	0	351105
28290	4525	336535	1538	2108	0	344706
28291	3174	336695	1292	2024	0	343185
28292	2892	348288	1306	2110	0	354596
28293	338157	7599	2136	2338	0	350230
28294	340737	3075	1109	2263	0	347184
28295	340873	1404	800	2229	0	345306
28296	341869	1350	822	2148	0	346189
28297	8564	1466	831	329565	0	340426
28298	4515	328659	1222	5439	0	339835
28299	327808	4732	1182	3993	0	337715
28300	6630	3132	329345	1882	0	340989
28301	4446	327699	4918	2533	0	339596
28302	3125	4969	328716	2027	0	338837
28303	318439	2669	5109	2261	0	328478
28304	332175	1223	2821	2389	0	338608
28305	333431	1290	1399	2172	0	338292
28306	8632	1157	1140	327526	0	338455
28307	4864	1459	328583	5262	0	340168
28308	2945	327970	4937	3676	0	339528
28309	317938	4549	2734	2247	0	327468
28310	5822	322113	1619	2134	0	331688
28311	3829	315735	1024	1682	0	322270
28312	2654	313775	944	1541	0	318914
28313	2434	313066	1148	1660	0	318308
28314	2700	5725	292069	1333	0	301827
28315	2333	300271	4202	1352	0	308158
28316	280272	3606	1987	1407	0	287272
28317	4325	2059	764	281488	0	288636
28318	2850	1167	649	286036	0	290702
28319	282466	956	771	4866	0	289059
28320	4069	281053	1103	2342	0	288567
28321	3130	3715	285744	1152	0	293741
28322	2392	2000	3138	282045	0	289575
28323	2222	1066	1732	291157	0	296177
28324	2251	982	863	294295	0	298391
28325	1928	1346	288455	4566	0	296295
28326	1800	1461	286397	2077	0	291735
28327	2359	1028	4196	285305	0	292888
28328	1914	1408	283873	3239	0	290434
28329	1797	1336	265766	1781	0	270680
28330	221298	1097	4226	1527	0	228148
28331	3661	268871	2010	1346	0	275888
28332	2261	262572	1009	943	0	266785
28333	1973	268765	971	963	0	272672
28334	2056	4713	875	253886	0	261530
28335	1507	273568	1014	2595	0	278684
28336	277006	3337	991	2093	0	283427
28337	3939	2350	283849	1038	0	291176
28338	285603	1205	3589	1307	0	291704
28339	4628	1093	1974	294666	0	302361
28340	2929	1099	930	297915	0	302873
28341	1451	311246	1243	5205	0	319145
28342	310548	4292	972	2923	0	318735
28343	310396	2487	1396	1595	0	315874
28344	6618	330177	1166	1341	0	339302
28345	3362	5354	728	321235	0	330679
28346	1664	3089	326592	4864	0	336209
28347	1507	1645	328152	2872	0	334176
28348	1210	333663	7249	1681	0	343803
28349	329284	5704	3483	1670	0	340141
28350	5848	3162	335419	670	0	345099
28351	3671	1168	5089	326155	0	336083
28352	335490	915	3081	5341	0	344827
28353	341286	891	1166	3143	0	346486
28354	7670	395375	1283	1239	0	405567
28355	3602	413114	1278	1182	0	419176
28356	411796	10429	929	1183	0	424337
28357	8469	4766	412564	899	0	426698
28358	410073	1700	7749	1215	0	420737
28359	419243	1291	3955	1154	0	425643
28360	12021	1296	1494	412361	0	427172
28361	5236	1569	424024	7844	0	438673
28362	2391	1364	417901	3845	0	425501
28363	395968	928	12102	1862	0	410860
28364	9666	1492	421978	1149	0	434285
28365	395095	975	9175	1243	0	406488
28366	412969	949	4448	1369	0	419735
28367	11711	410103	2380	1462	0	425656
28368	5932	8326	413570	973	0	428801
28369	2379	407599	9329	1085	0	420392
28370	399392	8625	4871	1393	0	414281
28371	9352	4804	397794	906	0	412856
28372	5642	1996	8530	377741	0	393909
28373	3007	1615	396787	7873	0	409282
28374	2694	1440	399285	4005	0	407424
28375	2813	1399	401683	1271	0	407166
28376	2691	1505	401671	1092	0	406959
28377	2129	388222	13068	1753	0	405172
28378	2741	8574	389734	1275	0	402324
28379	2261	383073	9863	1625	0	396822
28380	3006	8837	376261	1183	0	389287
28381	368985	4274	10244	1303	0	384806
28382	10336	2018	5613	328859	0	346826
28383	5744	379556	3642	6152	0	395094
28384	377450	8164	2961	3949	0	392524
28385	379241	4809	3245	1936	0	389231
28386	365312	2559	3093	1671	0	372635
28387	374829	1981	3334	1506	0	381650
28388	12976	370991	3727	1681	0	389375
28389	365841	8541	2917	1704	0	379003
28390	372882	5135	3364	1730	0	383111
28391	12764	360483	3701	1847	0	378795
28392	6993	9350	351256	1368	0	368967
28393	4778	5542	9856	335296	0	355472
28394	3869	360844	7234	7450	0	379397
28395	3900	9406	366027	4227	0	383560
28396	4338	5757	371757	1978	0	383830
28397	3953	361192	14457	1871	0	381473
28398	3940	367846	8189	1700	0	381675
28399	3995	389657	5247	1931	0	400830
28400	4069	385824	4709	1520	0	396122
28401	380912	14587	4408	1659	0	401566
28402	387109	7943	4269	1722	0	401043
28403	15796	4475	391659	1667	0	413597
28404	9069	4064	401561	1463	0	416157
28405	6108	3585	15357	384805	0	409855
28406	6015	3591	8596	397840	0	416042
28407	6225	3564	5074	404265	0	419128
28408	396149	3634	4974	13370	0	418127
28409	12898	397423	5247	6620	0	422188
28410	9083	411960	5266	2791	0	429100
28411	6079	424035	5334	2202	0	437650
28412	411656	16417	4884	2176	0	435133
28413	422373	8576	4957	2151	0	438057
28414	18577	5388	4753	411621	0	440339
28415	427431	4550	5648	10511	0	448140
28416	430430	4786	5112	5927	0	446255
28417	19423	4938	4967	422890	0	452218
28418	426759	5055	5285	11619	0	448718
28419	15586	420241	6588	6672	0	449087
28420	11132	13171	6659	419950	0	450912
28421	7931	8959	416208	10822	0	443920
28422	6758	413124	16011	6911	0	442804
28423	7384	14435	421146	3786	0	446751
28424	7699	9268	15683	384054	0	416704
28425	6889	420163	11839	10539	0	449430
28426	7933	13529	8266	414985	0	444713
28427	7475	9471	7620	426284	0	450850
28428	7513	6343	420953	15975	0	450784
28429	7099	5797	445444	8089	0	466429
28430	7535	5462	19870	431879	0	464746
28431	7655	5737	12003	400155	0	425550
28432	6984	438667	8675	15912	0	470238
28433	415801	15102	6982	8087	0	445972
28434	15954	430563	7448	4986	0	458951
28435	10726	438589	6667	4457	0	460439
28436	7443	18810	412712	4547	0	443512
28437	5440	418083	14766	4904	0	443193
28438	6545	15000	10415	370448	0	402408
28439	5995	408963	7261	11499	0	433718
28440	6129	14339	5836	379279	0	405583
28441	4915	397385	6252	12139	0	420691
28442	389599	14722	5232	7208	0	416761
28443	13789	398291	5831	4626	0	422537
28444	8224	13975	4478	337442	0	364119
28445	5638	374975	4736	9998	0	395347
28446	367587	13708	4577	5882	0	391754
28447	370146	9092	3198	4213	0	386649
28448	15975	365450	3926	3754	0	389105
28449	358454	12874	3019	3407	0	377754
28450	14315	11429	3063	341534	0	370341
28451	7989	5801	348225	11187	0	373202
28452	6177	5122	353165	6427	0	370891
28453	5336	350345	14116	4638	0	374435
28454	281019	7815	6320	2925	0	298079
28455	279850	4536	2198	2772	0	289356
28456	9211	2945	276853	2443	0	291452
28457	4504	2760	273768	2251	0	283283
28458	258603	2568	8419	2542	0	272132
28459	274902	2521	3858	2352	0	283633
28460	8597	2935	267744	2234	0	281510
28461	244474	2688	6294	2242	0	255698
28462	6615	254751	3774	2139	0	267279
28463	3574	267436	2101	2065	0	275176
28464	2589	9057	2434	257745	0	271825
28465	2211	5101	1650	265368	0	274330
28466	262090	3139	1613	8291	0	275133
28467	262548	2851	1823	4259	0	271481
28468	264464	2703	1779	2930	0	271876
28469	8565	2919	1609	259636	0	272729
28470	4716	2872	1395	259348	0	268331
28471	2967	247194	1549	8204	0	259914
28472	2527	255259	1797	4347	0	263930
28473	2520	266075	1770	2486	0	272851
28474	3097	9084	1483	239207	0	252871
28475	2690	255874	1672	5873	0	266109
28476	2799	7604	245225	3338	0	258966
28477	224823	4588	5655	2632	0	237698
28478	6957	3545	250155	2190	0	262847
28479	4385	3208	248699	1954	0	258246
28480	235397	2981	7626	2129	0	248133
28481	6704	250045	3826	2097	0	262672
28482	253083	6922	2081	2204	0	264290
28483	254459	4614	1864	2334	0	263271
28484	9018	3123	246469	1992	0	260602
28485	5169	2836	255873	1869	0	265747
28486	3719	256236	8050	2137	0	270142
28487	3635	7229	260943	1987	0	273794
28488	3777	4411	6822	256606	0	271616
28489	3735	3288	4066	218592	0	229681
28490	3041	258786	2943	7489	0	272259
28491	3173	270155	2579	3780	0	279687
28492	263684	9505	1946	2686	0	277821
28493	271195	5450	1885	2612	0	281142
28494	9706	3423	2191	266941	0	282261
28495	5551	3042	2223	271995	0	282811
28496	262321	2555	2313	8473	0	275662
28497	264925	2763	2229	4437	0	274354
28498	8988	267931	2314	2961	0	282194
28499	252080	6197	1735	1846	0	261858
28500	7329	243513	1752	1497	0	254091
28501	4177	252712	1704	1550	0	260143
28502	249789	7383	1460	1843	0	260475
28503	248833	4100	1607	1863	0	256403
28504	8459	2618	1271	243729	0	256077
28505	243111	2016	1294	5337	0	251758
28506	7074	2373	240706	2796	0	252949
28507	4518	242907	4959	1951	0	254335
28508	238001	5154	2632	2517	0	248304
28509	6182	3037	242329	2048	0	253596
28510	3705	2832	4628	219124	0	230289
28511	2597	228244	2658	3568	0	237067
28512	2882	236129	1587	2014	0	242612
28513	234846	5440	1672	1538	0	243496
28514	5416	2875	229243	1162	0	238696
28515	216764	1411	4116	921	0	223212
28516	5466	1231	2369	220785	0	229851
28517	3447	1295	220728	3293	0	228763
28518	209280	1115	4118	2408	0	216921
28519	4799	225058	2328	1129	0	233314
28520	2581	236209	1685	1041	0	241516
28521	237445	4977	1433	1242	0	245097
28522	237694	2457	880	1581	0	242612
28523	242930	1402	691	1836	0	246859
28524	6129	1382	807	236003	0	244321
28525	3808	1133	887	240088	0	245916
28526	2577	1060	237021	4269	0	244927
28527	2084	1158	230878	2402	0	236522
28528	1783	234246	4120	1810	0	241959
28529	1459	2870	1927	218437	0	224693
28530	216641	1372	711	2503	0	221227
28531	2434	216117	594	1487	0	220632
28532	1508	2556	399	217356	0	221819
28533	215345	1332	404	2696	0	219777
28534	2565	214428	592	1582	0	219167
28535	1724	224334	539	799	0	227396
28536	1527	3019	212183	666	0	217395
28537	204758	1402	2256	887	0	209303
28538	218580	883	1259	921	0	221643
28539	2944	872	213141	603	0	217560
28540	193724	526	1758	658	0	196666
28541	2206	773	211557	403	0	214939
28542	1194	207446	1742	429	0	210811
28543	1060	1964	1248	204397	0	208669
28544	202964	839	544	1619	0	205966
28545	1584	202337	489	846	0	205256
28546	1009	202651	396	482	0	204538
28547	194209	1560	300	542	0	196611
28548	1496	1054	202015	311	0	204876
28549	192547	469	1169	807	0	194992
28550	1342	211071	724	441	0	213578
28551	955	1351	199619	280	0	202205
28552	196029	658	1037	517	0	198241
28553	207098	335	590	496	0	208519
28554	1704	342	276	202288	0	204610
28555	927	271	224	206853	0	208275
28556	461	204805	314	1449	0	207029
28557	560	1472	200730	719	0	203481
28558	612	684	1229	201031	0	203556
28559	506	553	212830	1599	0	215488
28560	486	441	213012	818	0	214757
28561	532	292	2169	217006	0	219999
28562	500	482	223585	1911	0	226478
28563	568	504	218696	925	0	220693
28564	617	274	2645	205574	0	209110
28565	460	472	219571	1975	0	222478
28566	178657	321	2442	1395	0	182815
28567	2015	212082	1222	776	0	216095
28568	1180	2112	214970	402	0	218664
28569	923	1255	229885	349	0	232412
28570	667	525	2724	216152	0	220068
28571	236498	316	1270	2405	0	240489
28572	238312	250	524	1332	0	240418
28573	237216	332	453	738	0	238739
28574	238467	285	432	718	0	239902
28575	3111	290	390	230871	0	234662
28576	1422	686	235912	1990	0	240010
28577	230411	321	2136	1499	0	234367
28578	240592	271	1145	907	0	242915
28579	241819	295	680	881	0	243675
28580	3015	475	234205	420	0	238115
28581	212110	298	2220	746	0	215374
28582	2359	407	1336	242615	0	246717
28583	1190	246098	1081	2172	0	250541
28584	877	2305	744	237256	0	241182
28585	541	241034	927	2235	0	244737
28586	237701	2065	841	1462	0	242069
28587	2491	1264	238675	709	0	243139
28588	1315	488	2620	228322	0	232745
28589	630	235547	1750	2137	0	240064
28590	586	241901	1116	1289	0	244892
28591	240829	2858	930	987	0	245604
28592	240552	1174	842	825	0	243393
28593	3351	852	231625	538	0	236366
28594	231046	406	2683	690	0	234825
28595	3162	287	1462	234389	0	239300
28596	1939	551	239015	2582	0	244087
28597	1505	604	234813	1310	0	238232
28598	1457	280	3276	240953	0	245966
28599	259007	244	1538	3425	0	264214
28600	3838	248	884	257823	0	262793
28601	2410	237	772	258916	0	262335
28602	1444	242	761	256287	0	258734
28603	1200	260199	987	4405	0	266791
28604	1359	2846	716	263517	0	268438
28605	252466	1522	709	4073	0	258770
28606	3557	257642	888	2172	0	264259
28607	2166	3311	738	260693	0	266908
28608	257019	1857	610	4192	0	263678
28609	3601	253840	863	2240	0	260544
28610	2052	258139	879	1187	0	262257
28611	1342	4905	659	255909	0	262815
28612	249691	2187	738	4118	0	256734
28613	4107	1146	252742	2139	0	260134
28614	2477	1009	248039	1148	0	252673
28615	250798	762	5205	1180	0	257945
28616	265091	697	2472	1165	0	269425
28617	6008	269514	1392	943	0	277857
28618	3292	3911	1117	260350	0	268670
28619	1785	2223	265881	4154	0	274043
28620	1414	1040	259423	2637	0	264514
28621	1402	852	278101	1551	0	281906
28622	1135	273877	6969	1565	0	283546
28623	1095	278069	3326	1473	0	283963
28624	274954	5976	1388	1816	0	284134
28625	5334	2857	277116	1402	0	286709
28626	269115	1122	4848	1715	0	276800
28627	277554	885	2613	1877	0	282929
28628	7108	1181	281369	1592	0	291250
28629	3418	290794	5097	1467	0	300776
28630	2272	5495	2614	283972	0	294353
28631	1758	3090	297154	5391	0	307393
28632	1741	1815	282656	3021	0	289233
28633	268686	1466	6848	1976	0	278976
28634	5412	294698	3376	1460	0	304946
28635	3506	5397	1414	281943	0	292260
28636	1941	3195	1193	274221	0	280550
28637	1577	284502	1604	6713	0	294396
28638	1672	293337	1628	3285	0	299922
28639	1873	298465	1655	1712	0	303705
28640	1924	7678	1386	301595	0	312583
28641	307176	3508	1319	6368	0	318371
28642	6818	1713	1280	312842	0	322653
28643	3732	1751	312233	6739	0	324455
28644	1934	1622	311947	3729	0	319232
28645	1829	1342	8872	315973	0	328016
28646	1881	1630	321148	6633	0	331292
28647	1774	319521	7354	4030	0	332679
28648	2027	6591	3841	332931	0	345390
28649	348675	3568	2046	7966	0	362255
28650	345197	1753	1780	4280	0	353010
28651	10470	350431	2033	2366	0	365300
28652	357862	8005	1716	2220	0	369803
28653	363688	4186	1597	2213	0	371684
28654	365819	1934	1754	2412	0	371919
28655	11924	2312	322573	1839	0	338648
28656	338277	1694	6958	2132	0	349061
28657	8677	346252	4315	2735	0	361979
28658	4778	7506	349836	1768	0	363888
28659	2784	4186	350896	1712	0	359578
28660	2132	347486	10365	2177	0	362160
28661	344633	7838	4969	1926	0	359366
28662	8517	4030	2005	329431	0	343983
28663	4464	336333	2079	7425	0	350301
28664	342866	7602	1693	4446	0	356607
28665	8576	4440	1567	344318	0	358901
28666	347463	2099	1721	8790	0	360073
28667	8990	1710	1659	351694	0	364053
28668	4976	2064	346961	8698	0	362699
28669	2610	2295	339539	4897	0	349341
28670	2660	2229	345925	2546	0	353360
28671	2950	2066	11396	327751	0	344163
28672	2970	2136	5240	347097	0	357443
28673	3020	2405	343097	11283	0	359805
28674	3111	341513	8975	5695	0	359294
28675	350760	8449	4980	2666	0	366855
28676	351710	4857	2905	2295	0	361767
28677	12783	357602	3195	2063	0	375643
28678	7141	9588	2681	359695	0	379105
28679	3916	5479	373512	9233	0	392140
28680	357383	2629	10668	5585	0	376265
28681	11070	2466	378181	2810	0	394527
28682	6600	2574	360295	1810	0	371279
28683	3868	2493	370464	1703	0	378528
28684	349566	2232	14001	2081	0	367880
28685	11322	2723	364237	2040	0	380322
28686	6689	350043	11058	2212	0	370002
28687	4194	368562	6934	2228	0	381918
28688	4422	12342	4025	350022	0	370811
28689	4008	5790	3411	361022	0	374231
28690	3359	3066	358322	12158	0	376905
28691	340353	2432	10637	6066	0	359488
28692	364348	2462	6445	3168	0	376423
28693	14160	2184	4136	358118	0	378598
28694	358635	1970	3753	9726	0	374084
28695	10991	356758	3899	5828	0	377476
28696	354827	9640	2985	3447	0	370899
28697	10959	346651	3347	3534	0	364491
28698	6058	349705	3264	3142	0	362169
28699	338719	11433	2915	2973	0	356040
28700	341413	5137	3222	2860	0	352632
28701	348522	2581	3527	2599	0	357229
28702	351246	2173	3663	2643	0	359725
28703	13646	2377	329539	2500	0	348062
28704	322097	2045	10204	2283	0	336629
28705	10928	2231	6288	315864	0	335311
28706	6260	327867	4206	8313	0	346646
28707	326968	8546	3396	4736	0	343646
28708	9962	329127	3424	3440	0	345953
28709	330788	9153	3118	2636	0	345695
28710	11038	4938	2849	326377	0	345202
28711	7024	3023	2838	334667	0	347552
28712	4651	2737	325444	11427	0	344259
28713	4832	2551	328059	5689	0	341131
28714	4334	327609	11799	3649	0	347391
28715	314895	8284	5857	2945	0	331981
28716	10212	315344	3589	2659	0	331804
28717	6757	310542	2943	2481	0	322723
28718	5270	324269	2716	2242	0	334497
28719	5832	11394	306973	1926	0	326125
28720	4668	315712	8343	2010	0	330733
28721	292304	8891	4708	2088	0	307991
28722	294737	4908	2749	1856	0	304250
28723	12292	3022	2357	279416	0	297087
28724	6993	281495	2814	7198	0	298500
28725	4936	290628	2864	4310	0	302738
28726	5356	10200	2176	283654	0	301386
28727	5070	5448	284823	7420	0	302761
28728	4623	278699	7796	4273	0	295391
28729	5305	8694	4139	267852	0	285990
28730	263977	5224	2240	7744	0	279185
28731	265663	3297	2188	4724	0	275872
28732	10354	269005	2749	3124	0	285232
28733	271768	8084	2474	2526	0	284852
28734	272643	4773	2687	2346	0	282449
28735	11517	3240	2691	261114	0	278562
28736	6415	3377	259163	7205	0	276160
28737	4215	263228	7871	4440	0	279754
28738	4171	9369	4491	258153	0	276184
28739	3822	5759	259416	6574	0	275571
28740	3492	253886	7019	3740	0	268137
28741	244323	7626	4351	2428	0	258728
28742	247175	4764	2485	2297	0	256721
28743	9890	3312	2135	236185	0	251522
28744	5497	243339	2498	5953	0	257287
28745	4090	7328	240027	3882	0	255327
28746	3945	5382	6317	234996	0	250640
28747	3375	3761	242142	6307	0	255585
28748	2544	220777	5588	3840	0	232749
28749	4049	5899	3603	201165	0	214716
28750	200046	3493	1816	4619	0	209974
28751	5079	200253	1487	3057	0	209876
28752	196857	4835	1205	1966	0	204863
28753	191891	3326	1077	1683	0	197977
28754	6821	196617	1281	1792	0	206511
28755	4628	4724	1224	194959	0	205535
28756	3427	3776	1137	193177	0	201517
28757	2563	187518	1406	5540	0	197027
28758	2482	196078	1562	3216	0	203338
28759	2538	6037	1129	178952	0	188656
28760	2485	191135	1302	3725	0	198647
28761	190541	4702	1215	2457	0	198915
28762	190176	3085	966	1728	0	195955
28763	6104	2471	187603	1504	0	197682
28764	3668	2128	183159	1559	0	190514
28765	176939	1800	4714	1762	0	185215
28766	189153	1955	2612	1650	0	195370
28767	5115	194705	1874	1617	0	203311
28768	193508	4550	1360	1808	0	201226
28769	191643	3113	1162	1603	0	197521
28770	5604	187702	1199	1480	0	195985
28771	189748	4561	951	1705	0	196965
28772	5306	3353	890	210520	0	220069
28773	3544	2806	1042	217194	0	224586
28774	2566	2130	222305	6669	0	233670
28775	1818	213505	4606	3085	0	223014
28776	1486	221840	2083	1677	0	227086
28777	204380	8490	2715	2654	0	218239
28778	204148	2269	913	1355	0	208685
28779	199191	1036	522	1137	0	201886
28780	205623	910	634	996	0	208163
28781	5368	1042	196996	699	0	204105
28782	2169	1179	201724	564	0	205636
28783	1253	204945	4525	735	0	211458
28784	1477	3976	1738	203619	0	210810
28785	1458	1943	760	197885	0	202046
28786	1336	209456	719	4050	0	215561
28787	1556	4049	573	204439	0	210617
28788	201760	1820	667	3944	0	208191
28789	4189	204426	812	1821	0	211248
28790	2391	4163	208267	1023	0	215844
28791	1305	213846	3730	1129	0	220010
28792	211318	4209	1796	1178	0	218501
28793	4215	2308	211652	1019	0	219194
28794	203286	1258	3956	1186	0	209686
28795	213939	1102	1681	1000	0	217722
28796	5492	1357	211155	728	0	218732
28797	2466	1201	211003	723	0	215393
28798	1713	1154	209206	616	0	212689
28799	188051	1127	5102	736	0	195016
28800	4716	952	210106	671	0	216445
28801	2474	206457	4186	874	0	213991
28802	206283	3613	2065	734	0	212695
28803	4191	1792	207772	559	0	214314
28804	194568	976	4299	739	0	200582
28805	4534	1116	206638	551	0	212839
28806	2540	994	214701	584	0	218819
28807	1659	218438	5050	866	0	226013
28808	1642	4039	220572	623	0	226876
28809	2025	1926	217245	613	0	221809
28810	1492	192944	5506	1108	0	201050
28811	208890	3955	2519	725	0	216089
28812	4435	2172	215061	504	0	222172
28813	2539	1368	4472	189014	0	197393
28814	1556	216215	2494	2929	0	223194
28815	215220	3868	1768	1904	0	222760
28816	215312	2011	1709	1338	0	220370
28817	5452	1562	218440	856	0	226310
28818	2790	212074	4695	832	0	220391
28819	1757	220313	3074	816	0	225960
28820	1940	5538	1826	208462	0	217766
28821	2048	204176	1778	3363	0	211365
28822	2616	4941	1623	184551	0	193731
28823	2551	2442	1565	217667	0	224225
28824	2122	220487	2044	4730	0	229383
28825	2199	4623	1858	215854	0	224534
28826	1935	219978	1920	3912	0	227745
28827	1847	5108	211887	2349	0	221191
28828	1825	2931	4924	212084	0	221764
28829	1872	2322	2776	214500	0	221470
28830	1749	215530	2122	5220	0	224621
28831	1960	223553	1884	2545	0	229942
28832	2156	6153	1600	208069	0	217978
28833	1749	218547	2256	3969	0	226521
28834	211182	5353	2034	2490	0	221059
28835	5173	2981	1922	213063	0	223139
28836	2752	218509	2323	4255	0	227839
28837	211447	5077	1978	2263	0	220765
28838	4918	211935	2274	1485	0	220612
28839	3034	5414	206591	1576	0	216615
28840	2419	3139	5219	205181	0	215958
28841	206791	2345	3273	4501	0	216910
28842	5190	2171	213416	2413	0	223190
28843	2967	2385	5437	200194	0	210983
28844	2423	210414	3203	3965	0	220005
28845	2567	5062	206728	2234	0	216591
28846	2045	214174	5688	1464	0	223371
28847	200762	4844	3399	1409	0	210414
28848	208709	2895	3034	1293	0	215931
28849	5714	208621	3074	1275	0	218684
28850	206978	5076	2664	1438	0	216156
28851	5070	3215	204532	1230	0	214047
28852	2809	2355	5762	196637	0	207563
28853	2229	2430	3360	195984	0	204003
28854	2495	204817	2485	4434	0	214231
28855	216521	5038	2776	2632	0	226967
28856	225483	3281	2128	1874	0	232766
28857	5762	2864	224416	1176	0	234218
28858	220484	2127	5196	1412	0	229219
28859	229586	2156	2883	1549	0	236174
28860	231374	2011	2318	1598	0	237301
28861	6353	2284	2008	223272	0	233917
28862	3314	2392	1927	224768	0	232401
28863	2235	226709	2071	5092	0	236107
28864	220363	5063	2055	2517	0	229998
28865	220029	2749	1543	2158	0	226479
28866	5461	219581	1599	1725	0	228366
28867	2732	5308	1252	209384	0	218676
28868	1872	211660	1153	4009	0	218694
28869	1626	221027	1292	2207	0	226152
28870	211241	5179	1685	1852	0	219957
28871	4525	2801	208877	1809	0	218012
28872	1624	1193	181160	720	0	184697
28873	866	183806	2190	875	0	187737
28874	167642	1712	1420	716	0	171490
28875	1685	1133	170128	500	0	173446
28876	914	155290	1411	671	0	158286
28877	159048	1252	704	504	0	161508
28878	1319	788	157052	312	0	159471
28879	770	468	1162	149840	0	152240
28880	162749	356	586	1469	0	165160
28881	1652	502	164481	709	0	167344
28882	954	546	173652	446	0	175598
28883	587	572	179856	397	0	181412
28884	483	507	176465	292	0	177747
28885	156790	357	2414	530	0	160091
28886	184586	345	860	421	0	186212
28887	1947	184993	463	569	0	187972
28888	960	1697	253	185492	0	188402
28889	504	748	224	192789	0	194265
28890	319	188740	333	2353	0	191745
28891	482	2084	206	187700	0	190472
28892	342	193953	335	2002	0	196632
28893	321	197691	344	1038	0	199394
28894	423	2973	222	193888	0	197506
28895	417	1415	196329	2144	0	200305
28896	273	198359	2280	1194	0	202106
28897	418	2360	1083	198034	0	201895
28898	200099	1185	511	2407	0	204202
28899	2452	713	200199	1163	0	204527
28900	194221	407	2392	650	0	197670
28901	202039	367	1315	575	0	204296
28902	3627	487	600	203779	0	208493
28903	1665	470	209323	2857	0	214315
28904	1007	481	207860	1427	0	210775
28905	614	219206	4367	673	0	224860
28906	790	3425	1909	211273	0	217397
28907	556	1670	214393	3295	0	219914
28908	586	789	217700	1580	0	220655
28909	420	220638	4869	1159	0	227086
28910	223186	3452	2161	707	0	229506
28911	226637	1693	1024	752	0	230106
28912	4989	845	732	235412	0	241978
28913	2325	753	245141	4282	0	252501
28914	1160	683	244774	2300	0	248917
28915	757	251831	6462	1575	0	260625
28916	840	4395	255762	824	0	261821
28917	825	2583	255157	752	0	259317
28918	788	1431	6880	224285	0	233384
28919	604	930	256932	4588	0	263054
28920	236883	571	5794	2579	0	245827
28921	4704	596	3090	256400	0	264790
28922	2662	863	264194	4873	0	272592
28923	1188	264013	5369	2867	0	273437
28924	987	4705	3059	266722	0	275473
28925	963	2677	271072	4927	0	279639
28926	688	277657	5792	3066	0	287203
28927	947	5315	3333	266341	0	275936
28928	696	284609	2203	4875	0	292383
28929	946	5768	1723	283496	0	291933
28930	975	3081	1581	286640	0	292277
28931	815	1799	281885	7791	0	292290
28932	808	283958	6134	4070	0	294970
28933	992	5505	3606	283962	0	294065
28934	1022	3023	2237	285458	0	291740
28935	907	1656	1925	291947	0	296435
28936	918	1406	282429	8457	0	293210
28937	726	280585	6428	4852	0	292591
28938	931	5612	3961	281882	0	292386
28939	1037	3361	281466	6259	0	292123
28940	691	280620	6701	4345	0	292357
28941	905	5864	4191	280230	0	291190
28942	960	3820	283919	6262	0	294961
28943	780	283074	6631	4515	0	295000
28944	954	6073	4244	276527	0	287798
28945	957	3714	2582	287768	0	295021
28946	805	2421	290892	8651	0	302769
28947	255845	1751	6728	5465	0	269789
28948	4991	290427	4392	3263	0	303073
28949	292299	6228	2669	2952	0	304148
28950	5873	4027	294735	2669	0	307304
28951	287721	2420	6993	2797	0	299931
28952	6252	2050	4403	289749	0	302454
28953	3408	2077	2762	303518	0	311765
28954	1718	2118	298086	9179	0	311101
28955	263184	1862	7138	5815	0	277999
28956	278545	1793	4479	3978	0	288795
28957	7381	273564	3217	3349	0	287511
28958	3630	286701	2935	3188	0	296454
28959	284862	8336	2509	3068	0	298775
28960	6247	4877	284064	2943	0	298131
28961	3559	295011	7349	2983	0	308902
28962	2169	6803	4801	300896	0	314669
28963	1732	4243	3184	309473	0	318632
28964	1490	2930	306603	9521	0	320544
28965	285152	2109	7699	6014	0	300974
28966	6489	2388	313987	3701	0	326565
28967	304686	2020	8236	3421	0	318363
28968	7578	2187	325184	2953	0	337902
28969	4176	325554	8712	2864	0	341306
28970	330025	6970	5465	3229	0	345689
28971	333192	4317	3581	3176	0	344266
28972	331286	2476	3139	3094	0	339995
28973	333802	2367	3042	2782	0	341993
28974	10627	2116	2802	326286	0	341831
28975	5482	2398	325305	7838	0	341023
28976	3417	2054	7736	313544	0	326751
28977	2565	323529	5437	7933	0	339464
28978	2793	6749	3333	327319	0	340194
28979	2342	4396	325470	8208	0	340416
28980	2244	2911	325392	4947	0	335494
28981	2509	2605	9479	316877	0	331470
28982	313011	1881	5846	7751	0	328489
28983	305644	1967	3575	5004	0	316190
28984	308811	2079	2888	3490	0	317268
28985	9785	2201	307211	3099	0	322296
28986	5511	2089	308270	2737	0	318607
28987	3225	304435	9460	2672	0	319792
28988	2668	311537	5309	2723	0	322237
28989	303345	7787	3825	2676	0	317633
28990	304055	4244	2598	2809	0	313706
28991	8455	316910	2718	2452	0	330535
28992	314643	5842	2157	2426	0	325068
28993	312009	3569	2169	2506	0	320253
28994	8510	314212	2424	2285	0	327431
28995	316900	5892	2113	2657	0	327562
28996	311712	3803	2116	2533	0	320164
28997	8537	315092	2376	2299	0	328304
28998	317794	5724	2332	2276	0	328126
28999	315617	3562	2238	2638	0	324055
29000	8809	2492	316728	2203	0	330232
29001	5350	1909	316601	2029	0	325889
29002	3079	309878	7387	1983	0	322327
29003	2754	318677	4229	1845	0	327505
29004	315435	6792	4025	2044	0	328296
29005	307120	3288	2195	1718	0	314321
29006	301151	1747	1911	1462	0	306271
29007	7576	301357	2011	1354	0	312298
29008	4507	4235	1360	295572	0	305674
29009	3102	3150	297499	3875	0	307626
29010	2989	4225	4313	280380	0	291907
29011	2581	298835	3120	3856	0	308392
29012	289325	3352	1300	2083	0	296060
29013	4332	286108	1142	1017	0	292599
29014	3348	3563	850	279403	0	287164
29015	297906	2091	935	3643	0	304575
29016	296387	1173	920	2158	0	300638
29017	6210	1483	295255	848	0	303796
29018	295622	1181	3870	1135	0	301808
29019	314833	992	2246	1124	0	319195
29020	316958	1006	1278	1056	0	320298
29021	7023	1304	1126	297828	0	307281
29022	3816	305675	1237	3535	0	314263
29023	2570	4554	954	311984	0	320062
29024	2379	2866	312651	4068	0	321964
29025	2028	316098	4377	2651	0	325154
29026	2071	4350	2357	305941	0	314719
29027	1950	2789	308936	3739	0	317414
29028	1721	306979	4128	2271	0	315099
29029	2076	4291	2335	291638	0	300340
29030	1907	2938	305604	3644	0	314093
29031	263640	1412	4365	3189	0	272606
29032	5063	1527	312586	1075	0	320251
29033	3529	1464	312219	960	0	318172
29034	2121	316590	6055	987	0	325753
29035	2309	4611	2801	315113	0	324834
29036	2277	3036	1259	295969	0	302541
29037	2110	311968	1330	5157	0	320565
29038	2550	4611	1056	311296	0	319513
29039	324173	2770	1128	5230	0	333301
29040	327619	1386	1201	2949	0	333155
29041	7498	1641	306143	1270	0	316552
29042	317026	1375	4168	1441	0	324010
29043	330892	1383	2522	1436	0	336233
29044	7555	1676	330410	1179	0	340820
29045	4035	331172	5131	1227	0	341565
29046	2293	332868	3238	1105	0	339504
29047	2664	7303	1551	281827	0	293345
29048	1972	324383	1564	3885	0	331804
29049	2429	5826	299547	2389	0	310191
29050	2492	3553	316085	1245	0	323375
29051	2181	324394	6982	1073	0	334630
29052	321926	5425	3228	1367	0	331946
29053	330117	3574	1566	1339	0	336596
29054	333698	1921	1347	1432	0	338398
29055	333224	1727	1217	1414	0	337582
29056	316336	1821	1242	1458	0	320857
29057	7890	321524	1358	1135	0	331907
29058	4519	5666	317099	1005	0	328289
29059	3025	3269	4839	315637	0	326770
29060	309360	1718	2905	5121	0	319104
29061	5926	306515	1523	3292	0	317256
29062	4248	5467	1176	298630	0	309521
29063	2633	3277	299390	4538	0	309838
29064	2119	291925	5120	2783	0	301947
29065	1865	299953	3126	1273	0	306217
29066	286296	7585	2561	2101	0	298543
29067	4644	286655	1227	1015	0	293541
29068	3426	4513	904	273946	0	282789
29069	274451	2657	842	4273	0	282223
29070	275476	1366	869	2456	0	280167
29071	277686	1177	896	1224	0	280983
29072	6572	1385	272226	921	0	281104
29073	3191	274527	4388	879	0	282985
29074	279440	4484	2343	1263	0	287530
29075	4998	2872	1023	276979	0	285872
29076	281217	1309	866	4570	0	287962
29077	5163	278506	1091	2780	0	287540
29078	294333	4624	807	1341	0	301105
29079	312690	2988	769	1227	0	317674
29080	8512	1376	878	304473	0	315239
29081	4717	1487	312462	5499	0	324165
29082	3017	1222	5695	315867	0	325801
29083	315660	1047	3303	6368	0	326378
29084	319137	1165	1449	3512	0	325263
29085	9327	314137	1593	1708	0	326765
29086	302434	5461	1208	1360	0	310463
29087	6877	306564	1196	1382	0	316019
29088	307100	6018	833	1623	0	315574
29089	299235	3438	990	1843	0	305506
29090	8059	2131	302812	1498	0	314500
29091	3834	301633	5768	1480	0	312715
29092	2453	6091	3273	303892	0	315709
29093	2118	3668	1587	310055	0	317428
29094	2001	2017	1219	295372	0	300609
29095	1610	303083	1631	8368	0	314692
29096	1876	6132	302836	3607	0	314451
29097	2045	3915	310516	1556	0	318032
29098	1675	360414	8766	1814	0	372669
29099	359697	7948	4242	1502	0	373389
29100	8763	4649	358253	1259	0	372924
29101	343034	2027	8442	1668	0	355171
29102	8833	349525	4771	1535	0	364664
29103	5031	8752	351219	1493	0	366495
29104	2918	4488	7802	345790	0	360998
29105	2344	2431	357939	8414	0	371128
29106	2520	1885	364897	4530	0	373832
29107	3406	1927	11132	310061	0	326526
29108	2910	350649	5311	6430	0	365300
29109	2658	364624	2427	3459	0	373168
29110	359569	10825	1792	1616	0	373802
29111	9421	5560	356709	1151	0	372841
29112	351679	2174	8297	1565	0	363715
29113	357136	1858	4687	1421	0	365102
29114	10752	357813	2189	1149	0	371903
29115	342708	7624	1030	1077	0	352439
29116	344506	4011	924	1201	0	350642
29117	330690	1819	944	1103	0	334556
29118	10906	322049	1359	1158	0	335472
29119	4662	299628	1414	1050	0	306754
29120	2319	317272	1239	970	0	321800
29121	312857	9483	2496	940	0	325776
29122	312255	4385	1648	1169	0	319457
29123	10084	2062	294927	841	0	307914
29124	4763	1798	294970	670	0	302201
29125	298054	1188	8280	1007	0	308529
29126	307506	1098	3711	1202	0	313517
29127	310848	1064	1888	1343	0	315143
29128	9731	991	1489	299364	0	311575
29129	4760	971	1240	306503	0	313474
29130	2711	1174	1056	310449	0	315390
29131	2202	1422	1217	311865	0	316706
29132	2043	1513	290854	8893	0	303303
29133	2066	1350	294791	3712	0	301919
29134	2361	1242	295357	1471	0	300431
29135	2432	1292	292530	1009	0	297263
29136	284396	1202	8735	1098	0	295431
29137	7021	291143	4106	1028	0	303298
29138	4496	301655	2052	1077	0	309280
29139	295682	8077	1496	1237	0	306492
29140	7410	4253	293080	968	0	305711
29141	4292	2236	284200	1075	0	291803
29142	277119	1635	8516	1537	0	288807
29143	291420	1497	4188	1393	0	298498
29144	8997	289615	2192	1342	0	302146
29145	5307	5854	1481	288096	0	300738
29146	293759	3350	1501	5883	0	304493
29147	300069	1931	1279	3209	0	306488
29148	10013	1572	1198	287838	0	300621
29149	5289	303140	1415	5379	0	315223
29150	304952	6134	1149	3624	0	315859
29151	7329	3725	300127	2006	0	313187
29152	291758	1871	6452	2019	0	302100
29153	7120	300606	3838	1893	0	313457
29154	303632	6253	2112	1951	0	313948
29155	299580	3378	1954	1827	0	306739
29156	8731	2100	304028	1369	0	316228
29157	4468	1887	297340	1078	0	304773
29158	293997	1371	9139	1203	0	305710
29159	304896	1569	4519	1242	0	312226
29160	8695	308418	2635	963	0	320711
29161	5130	6337	1858	310040	0	323365
29162	3022	3541	310158	5727	0	322448
29163	302117	1826	6939	3196	0	314078
29164	7452	1606	4068	311064	0	324190
29165	4864	1408	2276	318288	0	326836
29166	313685	1416	1958	8297	0	325356
29167	6999	324792	2326	4083	0	338200
29168	329213	6237	1725	2286	0	339461
29169	331261	3368	1775	1613	0	338017
29170	335710	2061	1557	1715	0	341043
29171	10146	330259	1737	1412	0	343554
29172	332984	6471	1504	1244	0	342203
29173	8647	3542	1668	329785	0	343642
29174	6048	1888	1508	332017	0	341461
29175	4486	1924	329673	8215	0	344298
29176	3858	1854	326382	3694	0	335788
29177	3231	325015	8569	1876	0	338691
29178	2617	328362	4202	1108	0	336289
29179	3559	7069	305688	739	0	317055
29180	2197	313256	5783	916	0	322152
29181	310519	6291	3674	1557	0	322041
29182	313606	2902	1232	1112	0	318852
29183	317413	1513	862	1101	0	320889
29184	8631	1086	1007	301773	0	312497
29185	4492	914	1018	311679	0	318103
29186	2868	1166	313323	7171	0	324528
29187	1729	311706	5468	3623	0	322526
29188	307687	5351	2665	1792	0	317495
29189	5973	313347	1661	1005	0	321986
29190	311830	5629	1099	1034	0	319592
29191	312009	2637	880	1136	0	316662
29192	8838	1223	833	301113	0	312007
29193	4671	963	887	307160	0	313681
29194	3054	1033	716	312888	0	317691
29195	2596	1214	297624	7900	0	309334
29196	1776	292415	5277	4407	0	303875
29197	1454	291262	2959	2149	0	297824
29198	871	237390	734	785	0	239780
29199	860	236429	675	763	0	238727
29200	955	239249	697	738	0	241639
29201	217172	3617	936	897	0	222622
29202	2982	1905	229097	487	0	234471
29203	1794	230087	2530	850	0	235261
29204	1211	2771	221135	592	0	225709
29205	883	230536	2438	795	0	234652
29206	1604	4141	1625	166940	0	174310
29207	1154	1759	628	213584	0	217125
29208	806	222567	710	3077	0	227160
29209	217489	2568	660	1776	0	222493
29210	2798	1874	215741	742	0	221155
29211	1776	218547	2395	892	0	223610
29212	1246	2979	212648	642	0	217515
29213	1238	1742	2397	210061	0	215438
29214	1257	959	1372	196976	0	200564
29215	1031	211089	728	3213	0	216061
29216	1230	2604	508	212843	0	217185
29217	1185	1647	540	211380	0	214752
29218	894	213332	703	3538	0	218467
29219	984	2971	209637	1780	0	215372
29220	955	2134	209583	920	0	213592
29221	196739	1210	3327	1045	0	202321
29222	214505	1165	1498	923	0	218091
29223	3695	1157	742	208117	0	213711
29224	1986	1263	206615	2642	0	212506
29225	1317	1074	2416	198260	0	203067
29226	984	211587	1651	2925	0	217147
29227	1074	2998	210651	1883	0	216606
29228	795	210651	2719	1306	0	215471
29229	1005	3325	208975	1029	0	214334
29230	716	211911	2824	951	0	216402
29231	207798	3241	1780	1128	0	213947
29232	2758	2161	896	206625	0	212440
29233	1933	1420	797	206459	0	210609
29234	1170	1546	206707	3444	0	212867
29235	1369	1432	201884	1908	0	206593
29236	935	206317	3575	1283	0	212110
29237	203954	3052	1805	1544	0	210355
29238	2728	1998	1089	199645	0	205460
29239	1682	1644	206928	2678	0	212932
29240	1017	1643	200072	1748	0	204480
29241	180121	1315	3527	1366	0	186329
29242	194753	1401	1787	1317	0	199258
29243	3590	1406	198204	1022	0	204222
29244	1941	1674	2627	184359	0	190601
29245	1090	195888	1924	2450	0	201352
29246	195226	2683	1171	2001	0	201081
29247	2491	195666	1116	1327	0	200600
29248	187050	2433	844	1293	0	191620
29249	2203	186704	937	1156	0	191000
29250	1334	189819	944	1015	0	193112
29251	1108	3174	770	187876	0	192928
29252	941	1789	774	188202	0	191706
29253	743	189339	930	4051	0	195063
29254	903	2716	186333	1617	0	191569
29255	846	1925	186056	883	0	189710
29256	800	1414	186111	877	0	189202
29257	169383	1099	3249	1128	0	174859
29258	183823	1090	1684	1282	0	187879
29259	2825	199387	1140	1146	0	204498
29260	1632	3568	196045	930	0	202175
29261	853	2344	3077	196024	0	202298
29262	670	1580	209084	3260	0	214594
29263	666	1550	214308	2002	0	218526
29264	882	1237	4921	226823	0	233863
29265	870	1099	2600	240540	0	245109
29266	714	1376	252030	6686	0	260806
29267	230764	1006	4976	4142	0	240888
29268	4797	256212	3798	1957	0	266764
29269	3288	268419	2040	1124	0	274871
29270	1818	8382	1076	254053	0	265329
29271	266092	4589	1042	5103	0	276826
29272	5519	272749	1210	3663	0	283141
29273	271986	6175	727	1901	0	280789
29274	6382	275924	1070	1098	0	284474
29275	283806	6839	806	1208	0	292659
29276	7500	4430	280706	913	0	293549
29277	4568	2547	286408	745	0	294268
29278	2572	2036	9013	272940	0	286561
29279	1403	1312	279159	5923	0	287797
29280	1028	263891	7252	3846	0	276017
29281	879	268346	4544	1594	0	275363
29282	267339	8940	2219	1193	0	279691
29283	6078	4890	1183	254152	0	266303
29284	3816	270198	1266	5400	0	280680
29285	273413	6368	961	3793	0	284535
29286	269489	4324	819	1704	0	276336
29287	278478	2053	750	1171	0	282452
29288	11087	1212	750	269431	0	282480
29289	5928	1110	701	275625	0	283364
29290	2809	1385	273843	9567	0	287604
29291	1882	1242	273441	5293	0	281858
29292	266926	846	9708	2471	0	279951
29293	7265	973	5135	267410	0	280783
29294	4706	1125	270917	6738	0	283486
29295	264672	859	6952	4744	0	277227
29296	6977	279620	5033	2334	0	293964
29297	284938	6513	2339	1692	0	295482
29298	287894	4437	1489	1688	0	295508
29299	290754	2051	1396	1614	0	295815
29300	12394	1483	279158	1235	0	294270
29301	278997	1140	7038	1187	0	288362
29302	9674	1154	4587	264044	0	279459
29303	6166	262108	2737	6318	0	277329
29304	3766	283721	1856	4325	0	293668
29305	281807	9669	1478	2356	0	295310
29306	285525	5369	1388	1599	0	293881
29307	289950	2375	1255	1599	0	295179
29308	13359	1569	1116	276746	0	292790
29309	7801	1518	1208	282877	0	293404
29310	4531	1433	1085	271908	0	278957
29311	3219	279994	1409	11326	0	295948
29312	279905	7090	1308	6301	0	294604
29313	284563	4845	1230	3388	0	294026
29314	291840	2489	1127	2562	0	298018
29315	13453	2012	283316	2156	0	300937
29316	288820	1708	7251	2009	0	299788
29317	11204	1889	4842	268629	0	286564
29318	7377	282248	2766	6968	0	299359
29319	283560	7602	1659	4963	0	297784
29320	283829	5042	1593	2883	0	293347
29321	13435	2957	285273	1840	0	303505
29322	8645	1726	7642	277136	0	295149
29323	4729	287502	5394	7797	0	305422
29324	296805	7828	2693	5677	0	313003
29325	10482	5377	1785	296199	0	313843
29326	7670	2996	1751	296043	0	308460
29327	5107	2012	1518	303437	0	312074
29328	4008	2066	1512	311643	0	319229
29329	3930	2353	299289	14420	0	319992
29330	3598	299853	8544	8270	0	320265
29331	4032	8875	5228	300205	0	318340
29332	3640	6128	303394	9968	0	323130
29333	297767	3392	8643	7110	0	316912
29334	312289	2201	5817	4265	0	324572
29335	14801	2140	3219	306263	0	326423
29336	312633	2107	2366	10200	0	327306
29337	318047	2008	2302	7297	0	329654
29338	15706	2359	310931	4137	0	333133
29339	9791	307963	9275	3222	0	330251
29340	313190	8974	5902	3208	0	331274
29341	12461	5821	3219	311332	0	332833
29342	321130	3027	2619	10201	0	336977
29343	13377	2206	2514	316995	0	335092
29344	9122	2271	2094	324215	0	337702
29345	5841	2785	313112	14535	0	336273
29346	285430	1972	9028	9547	0	305977
29347	11132	316361	6335	5838	0	339666
29348	8677	9045	315598	4526	0	337846
29349	5295	319063	9485	4217	0	338060
29350	313776	10043	6107	3844	0	333770
29351	12014	6224	3430	310729	0	332397
29352	312467	3386	2300	10585	0	328738
29353	12302	308187	2835	7532	0	330856
29354	318520	9085	2377	4859	0	334841
29355	324355	5831	2093	3871	0	336150
29356	327075	2953	2022	3774	0	335824
29357	322252	1914	1965	4015	0	330146
29358	17127	311526	2642	3510	0	334805
29359	306930	8169	1866	3178	0	320143
29360	13216	5754	1930	298451	0	319351
29361	9699	3577	1663	291582	0	306521
29362	6397	272585	2003	11782	0	292767
29363	5325	274224	1879	7203	0	288631
29364	4522	268999	1710	3514	0	278745
29365	250317	9293	1723	3210	0	264543
29366	7858	238161	1599	2610	0	250228
29367	5088	226459	1518	2082	0	235147
29368	222362	7006	2452	2270	0	234090
29369	215965	3456	1321	1941	0	222683
29370	8014	216490	1373	1779	0	227656
29371	212830	5103	1048	1806	0	220787
29372	6771	3255	204168	1498	0	215692
29373	199255	1835	4150	1898	0	207138
29374	6784	1873	202075	1799	0	212531
29375	3977	185897	3681	1546	0	195101
29376	2880	191809	2336	1684	0	198709
29377	5637	6098	2194	179369	0	193298
29378	186624	2324	1357	4183	0	194488
29379	190064	1641	743	2630	0	195078
29380	192368	1570	817	1920	0	196675
29381	192417	1396	807	1854	0	196474
29382	187876	1505	939	1931	0	192251
29383	5749	1762	179273	1695	0	188479
29384	3491	1924	171218	1404	0	178037
29385	179147	1644	3713	1551	0	186055
29386	4596	183122	2001	1309	0	191028
29387	182216	3391	1125	1357	0	188089
29388	186181	2293	741	1385	0	190600
29389	190040	1458	641	1490	0	193629
29390	188928	1264	702	1347	0	192241
29391	188862	1383	677	1462	0	192384
29392	5837	1717	182891	1260	0	191705
29393	187652	1470	2877	1773	0	193772
29394	191491	1353	1900	1748	0	196492
29395	5352	1899	177366	1414	0	186031
29396	172754	1839	2417	1517	0	178527
29397	184478	1930	1561	1503	0	189472
29398	5388	1981	188056	1165	0	196590
29399	3759	1835	187510	1175	0	194279
29400	3281	189982	3632	1005	0	197900
29401	3518	3331	1787	188324	0	196960
29402	3337	2388	191384	2630	0	199739
29403	189123	1433	2905	1928	0	195389
29404	5164	1278	1909	201537	0	209888
29405	3548	1610	207309	2795	0	215262
29406	201975	1269	3292	1929	0	208465
29407	210493	1531	1892	1330	0	215246
29408	212299	1535	994	1210	0	216038
29409	6036	214324	999	1287	0	222646
29410	4349	3694	662	204852	0	213557
29411	3244	213940	1004	2893	0	221081
29412	214857	3557	1215	2055	0	221684
29413	213278	2231	1156	1292	0	217957
29414	5997	1591	209708	667	0	217963
29415	3364	202687	3022	595	0	209668
29416	2239	205254	2020	482	0	209995
29417	2534	3922	1097	200477	0	208030
29418	2460	2239	797	203384	0	208880
29419	200676	1269	603	3619	0	206167
29420	4477	200547	759	1821	0	207604
29421	3334	199393	701	676	0	204104
29422	3476	3880	195396	556	0	203308
29423	2474	201693	2650	490	0	207307
29424	197018	2785	1789	728	0	202320
29425	4179	1980	194065	463	0	200687
29426	166631	826	2323	949	0	170729
29427	3228	879	187187	434	0	191728
29428	155299	548	2080	855	0	158782
29429	2730	188944	1319	418	0	193411
29430	192696	2290	665	526	0	196177
29431	3233	1596	197270	210	0	202309
29432	193357	708	2740	648	0	197453
29433	198162	539	1366	557	0	200624
29434	3918	742	203967	220	0	208847
29435	200736	524	2235	614	0	204109
29436	210598	454	1245	512	0	212809
29437	206946	443	522	528	0	208439
29438	4030	202736	571	424	0	207761
29439	207393	2408	508	675	0	210984
29440	3443	1659	211240	216	0	216558
29441	1928	224058	2555	390	0	228931
29442	227633	2752	1528	595	0	232508
29443	225828	1422	624	597	0	228471
29444	228910	512	465	572	0	230459
29445	4484	225658	615	571	0	231328
29446	2271	3128	392	251078	0	256869
29447	1166	1854	249186	3744	0	255950
29448	1186	663	3960	247885	0	253694
29449	1014	746	254524	4150	0	260434
29450	235767	458	4458	2285	0	242968
29451	4554	255577	2369	808	0	263308
29452	2941	4260	777	248060	0	256038
29453	1289	259259	813	3726	0	265087
29454	1341	4668	508	257170	0	263687
29455	1269	2431	518	255816	0	260034
29456	981	263022	801	6237	0	271041
29457	1366	4975	514	265391	0	272246
29458	1321	2671	574	272697	0	277263
29459	1024	273440	911	7203	0	282578
29460	1096	283647	865	3125	0	288733
29461	1445	7747	572	280589	0	290353
29462	1399	3515	279634	5808	0	290356
29463	1155	283677	5759	3375	0	293966
29464	1468	6318	2749	281448	0	291983
29465	1713	3525	292585	6245	0	304068
29466	1187	295780	6497	3557	0	307021
29467	294108	6740	3239	1715	0	305802
29468	6899	3835	293283	1343	0	305360
29469	288664	1656	6579	1429	0	298328
29470	7414	1443	3358	291070	0	303285
29471	4094	1248	1355	296259	0	302956
29472	2056	1296	1069	298583	0	303004
29473	1529	1619	292098	9930	0	305176
29474	1390	1626	290643	4460	0	298119
29475	280337	1460	9114	2399	0	293310
29476	7084	1450	3989	291302	0	303825
29477	3971	1675	294214	7442	0	307302
29478	286020	1505	6929	4519	0	298973
29479	7434	1573	3684	292944	0	305635
29480	4514	1554	1595	296787	0	304450
29481	2309	1562	1450	293750	0	299071
29482	1631	295714	1634	10360	0	309339
29483	2124	7330	1269	282309	0	293032
29484	1690	288755	1679	7538	0	299662
29485	1570	300725	1727	4573	0	308595
29486	294802	9638	1441	2950	0	308831
29487	283156	4613	1711	2603	0	292083
29488	297189	2180	1477	2555	0	303401
29489	9776	289733	1823	2500	0	303832
29490	289990	7307	1554	2577	0	301428
29491	293898	3996	1571	2519	0	301984
29492	10287	2089	1675	284993	0	299044
29493	5091	1865	1640	290578	0	299174
29494	2564	1946	282053	10733	0	297296
29495	2028	288115	7462	5752	0	303357
29496	283225	7185	4232	3371	0	298013
29497	282910	4090	2217	3032	0	292249
29498	9342	281356	2142	2911	0	295751
29499	281745	7172	1775	3076	0	293768
29500	281305	4023	1427	3293	0	290048
29501	9967	2526	1555	270017	0	284065
29502	4876	268088	1869	7812	0	282645
29503	2623	277557	1768	5253	0	287201
29504	269742	9022	1623	3551	0	283938
29505	7888	4761	1379	265502	0	279530
29506	4310	2855	263934	8136	0	279235
29507	249658	2244	6577	5367	0	263846
29508	7613	2670	269843	3271	0	283397
29509	4546	263845	6907	3140	0	278438
29510	262405	6789	4057	3272	0	276523
29511	7428	4689	263050	3085	0	278252
29512	4890	2824	6499	265224	0	279437
29513	3040	2592	274285	8004	0	287921
29514	2540	275313	7149	5605	0	290607
29515	3122	7189	3742	275069	0	289122
29516	2680	4682	274075	7968	0	289405
29517	251432	2771	6481	5757	0	266441
29518	7227	280137	4017	3709	0	295090
29519	4959	7115	2238	264333	0	278645
29520	2986	283671	2221	7063	0	295941
29521	279532	7561	1806	4945	0	293844
29522	277928	4557	1701	3850	0	288036
29523	9086	278218	2179	3510	0	292993
29524	5464	7286	2033	269155	0	283938
29525	2908	280192	2190	7069	0	292359
29526	274949	7267	2300	5018	0	289534
29527	7714	4853	274745	3172	0	290484
29528	4944	3145	269896	2905	0	280890
29529	3189	270514	7919	2800	0	284422
29530	2783	275572	4706	2504	0	285565
29531	3012	8511	2344	267647	0	281514
29532	266519	4213	1995	6725	0	279452
29533	267671	2449	2101	4375	0	276596
29534	259460	1998	1785	3101	0	266344
29535	9129	266350	2366	2886	0	280731
29536	5197	5967	1778	255161	0	268103
29537	3281	266243	2141	6281	0	277946
29538	266347	6273	1981	4494	0	279095
29539	7463	3715	1640	261846	0	274664
29540	4506	2460	253364	6262	0	266592
29541	2696	247117	5472	4060	0	259345
29542	239461	5256	2964	2515	0	250196
29543	5966	3616	239330	1830	0	250742
29544	228926	2263	4512	2326	0	238027
29545	5971	236097	2813	2052	0	246933
29546	2701	216934	1119	1222	0	221976
29547	210946	4697	928	1236	0	217807
29548	3900	216385	1027	1057	0	222369
29549	210438	3785	807	1174	0	216204
29550	3791	212369	960	934	0	218054
29551	211423	3709	1027	1029	0	217188
29552	211735	2245	815	1016	0	215811
29553	4818	1655	214572	859	0	221904
29554	2557	1362	209304	665	0	213888
29555	1573	212474	3529	910	0	218486
29556	209225	2694	2325	1012	0	215256
29557	2966	1861	204722	641	0	210190
29558	192123	1032	2161	720	0	196036
29559	2567	1011	1234	193047	0	197859
29560	1378	761	196066	1470	0	199675
29561	896	769	187720	896	0	190281
29562	970	750	197274	606	0	199600
29563	617	197615	1935	373	0	200540
29564	2020	3513	2351	189605	0	197489
29565	186931	485	299	956	0	188671
29566	813	279	209	189579	0	190880
29567	191290	186	246	1040	0	192762
29568	1022	232	225	192218	0	193697
29569	192305	221	169	1336	0	194031
29570	190243	266	226	1142	0	191877
29571	214333	228	204	627	0	215392
29572	2187	218909	273	349	0	221718
29573	1248	2021	220751	241	0	224261
29574	682	1036	1772	221098	0	224588
29575	1887	2259	1998	131382	0	137526
29576	549	339	337	229728	0	230953
29577	553	321	238	225624	0	226736
29578	469	217844	473	3183	0	221969
29579	590	2208	215464	1502	0	219764
29580	355	221062	2216	748	0	224381
29581	665	2629	1183	202003	0	206480
29582	433	1419	430	222721	0	225003
29583	574	587	288	224524	0	225973
29584	546	446	324	222381	0	223697
29585	500	216008	528	3453	0	220489
29586	415	218215	519	1733	0	220882
29587	601	3361	212683	865	0	217510
29588	573	1690	2257	214674	0	219194
29589	579	831	1238	219609	0	222257
29590	560	707	465	224610	0	226342
29591	222956	614	345	4275	0	228190
29592	2805	223918	491	2042	0	229256
29593	1852	2880	220717	888	0	226337
29594	219872	1483	2492	1007	0	224854
29595	2918	741	1320	222102	0	227081
29596	225723	665	502	3283	0	230173
29597	3251	709	381	226348	0	230689
29598	227665	632	476	3357	0	232130
29599	3222	642	473	227708	0	232045
29600	225162	592	537	3514	0	229805
29601	3382	845	233239	1857	0	239323
29602	2235	519	2558	228670	0	233982
29603	1201	240744	1684	2714	0	246343
29604	1076	2966	631	244222	0	248895
29605	241995	1813	580	3710	0	248098
29606	3142	244403	883	2163	0	250591
29607	2140	3341	526	252580	0	258587
29608	977	252260	776	3827	0	257840
29609	1017	3925	507	254639	0	260088
29610	1124	2182	416	256942	0	260664
29611	1103	1280	251073	5454	0	258910
29612	1146	681	3651	246431	0	251909
29613	946	953	242259	4415	0	248573
29614	626	237722	4093	3232	0	245673
29615	237796	3650	2099	1751	0	245296
29616	4037	2335	238980	1322	0	246674
29617	230747	875	3810	1544	0	236976
29618	244190	710	2154	1608	0	248662
29619	5714	726	1103	246186	0	253729
29620	2793	970	253826	4695	0	262284
29621	245751	616	4589	3387	0	254343
29622	266772	565	2480	2193	0	272010
29623	6669	659	992	259614	0	267934
29624	3346	679	759	262174	0	266958
29625	1501	264445	976	6911	0	273833
29626	1494	5020	733	261508	0	268755
29627	1064	266861	966	5394	0	274285
29628	1243	4979	262747	3460	0	272429
29629	1051	2541	3922	259514	0	267028
29630	253902	894	2213	5286	0	262295
29631	259254	630	702	3393	0	263979
29632	5751	259766	805	1764	0	268086
29633	2963	4291	597	265229	0	273080
29634	267007	2270	621	5247	0	275145
29635	4531	259954	869	3201	0	268555
29636	263013	4472	447	2018	0	269950
29637	5176	2441	483	273310	0	281410
29638	284229	1032	574	5800	0	291635
29639	6073	1212	297870	3275	0	308430
29640	3123	301092	5961	1776	0	311952
29641	296833	5870	2935	1929	0	307567
29642	5834	307928	1376	1836	0	316974
29643	313767	6252	770	1902	0	322691
29644	319904	3093	664	2161	0	325822
29645	9143	1634	316857	1622	0	329256
29646	4381	976	6131	310524	0	322012
29647	322390	958	3060	7323	0	333731
29648	7110	1242	320422	3882	0	332656
29649	320774	951	6545	2174	0	330444
29650	7614	1014	3114	323444	0	335186
29651	3926	1244	320546	7531	0	333247
29652	2172	795	6376	319002	0	328345
29653	311184	907	3290	7991	0	323372
29654	7982	1468	315890	4051	0	329391
29655	4398	1118	6176	317981	0	329673
29656	2433	1017	3327	322087	0	328864
29657	322005	795	1401	10209	0	334410
29658	320732	757	1192	5052	0	327733
29659	9590	326689	1496	2655	0	340430
29660	5381	6586	1053	324723	0	337743
29661	3083	3679	1186	327793	0	335741
29662	2929	1717	1263	325149	0	331058
29663	318059	1237	1469	10228	0	330993
29664	322896	1452	1392	5031	0	330771
29665	11268	1539	1134	312882	0	326823
29666	5818	310632	1323	7601	0	325374
29667	3964	7062	1337	297298	0	309661
29668	3231	312655	1793	7237	0	324916
29669	309390	6751	1362	4900	0	322403
29670	8205	304929	2131	2876	0	318141
29671	286070	5739	1600	2265	0	295674
29672	8080	3046	1369	279096	0	291591
29673	277299	1297	1650	6788	0	287034
29674	7588	1328	272006	4338	0	285260
29675	4636	276358	5981	2981	0	289956
29676	276881	5511	4086	2845	0	289323
29677	280100	2860	1939	2787	0	287686
29678	9030	1292	1451	266252	0	278025
29679	4703	271524	1846	6690	0	284763
29680	3524	5011	1365	284787	0	294687
29681	3389	2727	1284	286172	0	293572
29682	3412	1425	1415	286141	0	292393
29683	281869	1356	1237	9617	0	294079
29684	285602	1354	1051	5692	0	293699
29685	9584	1372	1160	271828	0	283944
29686	5272	275470	1353	7273	0	289368
29687	281855	5323	1085	5260	0	293523
29688	7833	3467	276490	3560	0	291350
29689	5598	1987	5160	280449	0	293194
29690	3594	2180	279329	7668	0	292771
29691	3475	1945	5274	278641	0	289335
29692	3383	2258	279353	7692	0	292686
29693	3485	2010	5680	278169	0	289344
29694	279446	2086	2988	7711	0	292231
29695	280192	1970	1455	5112	0	288729
29696	9821	272403	1546	3248	0	287018
29697	279048	6041	1269	3386	0	289744
29698	8627	3870	1348	273942	0	287787
29699	5983	2381	1418	276082	0	285864
29700	276571	2085	1643	9255	0	289554
29701	8462	2372	266353	5287	0	282474
29702	6017	2311	264722	3704	0	276754
29703	4397	2236	260363	3729	0	270725
29704	250320	1753	7099	4289	0	263461
29705	8190	1887	264066	4058	0	278201
29706	5846	1864	252384	3894	0	263988
29707	241370	1584	6734	3778	0	253466
29708	7328	249416	3661	3617	0	264022
29709	5328	5067	1898	253910	0	266203
29710	4138	3244	1639	258791	0	267812
29711	3776	2226	257673	8367	0	272042
29712	253753	1502	5883	5795	0	266933
29713	260513	1361	3532	4654	0	270060
29714	248171	1284	2397	4693	0	256545
29715	8148	1682	258281	4132	0	272243
29716	249153	1274	5470	4661	0	260558
29717	7559	1893	244345	4116	0	257913
29718	5481	247200	4964	4064	0	261709
29719	4130	250685	3019	3656	0	261490
29720	238435	5689	2054	3550	0	249728
29721	5947	234751	2025	3709	0	246432
29722	4284	236656	1986	3778	0	246704
29723	234419	5244	1889	3894	0	245446
29724	6062	236804	2367	3333	0	248566
29725	234299	4353	2123	3260	0	244035
29726	6973	2596	2223	241491	0	253283
29727	4920	1935	2166	246528	0	255549
29728	3866	1724	2166	247534	0	255290
29729	3518	1945	2265	237893	0	245621
29730	3416	241099	2617	7198	0	254330
29731	246776	4795	2111	4371	0	258053
29732	6836	273668	2356	3145	0	286005
29733	4222	275692	2385	3740	0	286039
29734	3381	7339	289006	2832	0	302558
29735	275983	2888	7388	3059	0	289318
29736	8793	1844	303831	2373	0	316841
29737	5131	1379	305900	1815	0	314225
29738	2814	299054	7990	1832	0	311690
29739	1098	302640	3105	1275	0	308118
29740	291597	7658	1792	1362	0	302409
29741	5854	303046	1413	1612	0	311925
29742	3325	6111	314173	1098	0	324707
29743	1492	288255	6689	1050	0	297486
29744	1330	5879	311144	762	0	319115
29745	994	2583	302528	592	0	306697
29746	291252	1143	8369	804	0	301568
29747	6221	988	302105	662	0	309976
29748	3054	603	6523	290373	0	300553
29749	283546	464	3086	5879	0	292975
29750	5337	281996	1805	3386	0	292524
29751	2852	5339	293445	1084	0	302720
29752	288529	2261	6156	987	0	297933
29753	6298	955	2903	265326	0	275482
29754	2843	257975	1719	5264	0	267801
29755	1351	5104	282681	2427	0	291563
29756	275719	2217	6089	1140	0	285165
29757	6115	1192	283827	739	0	291873
29758	3225	589	6495	277697	0	288006
29759	1406	852	276354	5873	0	284485
29760	1208	580	6615	273660	0	282063
29761	268457	542	3082	6573	0	278654
29762	5662	277065	1844	3364	0	287935
29763	282769	5786	964	1463	0	290982
29764	6770	2957	281414	744	0	291885
29765	3558	1127	6314	275547	0	286546
29766	1525	978	286738	5941	0	295182
29767	284443	698	7151	2915	0	295207
29768	286753	664	3303	1328	0	292048
29769	8493	289196	1991	955	0	300635
29770	293933	6326	1247	878	0	302384
29771	294743	2937	1165	836	0	299681
29772	9578	1350	986	287095	0	299009
29773	4164	1080	288505	6277	0	300026
29774	1874	273142	6908	3320	0	285244
29775	1845	6295	3170	272122	0	283432
29776	279389	2952	1770	6249	0	290360
29777	6884	1508	283079	2976	0	294447
29778	3419	1160	284785	1296	0	290660
29779	1663	1129	277422	900	0	281114
29780	269333	881	9589	1021	0	280824
29781	7055	1149	274549	761	0	283514
29782	269541	866	7924	919	0	279250
29783	7646	1252	239829	746	0	249473
29784	3540	268060	7011	1129	0	279740
29785	2370	6646	3488	263156	0	275660
29786	1720	3359	267395	6358	0	278832
29787	1393	260115	7727	3172	0	272407
29788	1285	268770	4269	1423	0	275747
29789	2044	8936	2194	261629	0	274803
29790	262176	4210	1715	6575	0	274676
29791	7437	2341	1772	263253	0	274803
29792	259924	1875	1738	7150	0	270687
29793	8120	1876	1754	259236	0	270986
29794	4117	1807	258352	7238	0	271514
29795	2568	1591	261962	3506	0	269627
29796	252202	1393	10198	2081	0	265874
29797	258655	1425	5099	1661	0	266840
29798	9782	1781	254809	1342	0	267714
29799	249153	1737	8089	1254	0	260233
29800	8466	1953	252656	1082	0	264157
29801	4736	241772	9081	1074	0	256663
29802	2985	244294	5492	1120	0	253891
29803	2611	244580	3995	1170	0	252356
29804	3033	9810	3328	234275	0	250446
29805	235921	4625	3140	6530	0	250216
29806	240170	2708	3057	3359	0	249294
29807	10398	2343	2694	234563	0	249998
29808	5210	2450	227978	6986	0	242624
29809	3423	2049	8527	226445	0	240444
29810	2827	1884	227569	7675	0	239955
29811	2956	1619	9509	221883	0	235967
29812	220543	1299	5627	8052	0	235521
29813	225603	1292	3918	4310	0	235123
29814	226643	1229	3445	2761	0	234078
29815	226409	1248	3228	2213	0	233098
29816	11599	1332	2834	215229	0	230994
29817	6273	1251	2909	221354	0	231787
29818	217853	1372	2661	9743	0	231629
29819	222334	1395	2426	4734	0	230889
29820	11293	1513	2387	215215	0	230408
29821	6577	1458	2211	219030	0	229276
29822	4346	1286	2237	217348	0	225217
29823	3780	1234	2474	218294	0	225782
29824	210297	1166	2650	10528	0	224641
29825	8364	1296	206522	5457	0	221639
29826	5355	965	7514	196051	0	209885
29827	194695	975	4288	7655	0	207613
29828	8291	1392	191907	4356	0	205946
29829	5987	1396	7212	190699	0	205294
29830	3894	1292	191902	7087	0	204175
29831	3045	177387	8162	4015	0	192609
29832	3454	4577	4051	145625	0	157707
29833	134291	2210	2434	4653	0	143588
29834	5249	2385	1937	116681	0	126252
29835	3433	114905	1733	4306	0	124377
29836	2433	106068	1450	2338	0	112289
29837	1676	83700	1079	1229	0	87684
29838	1499	77233	1230	1162	0	81124
29839	45567	5035	5386	2906	0	58894
29840	2747	1269	1452	33827	0	39295
29841	716	205	29905	1132	0	31958
29842	554	124	964	28760	0	30402
29843	553	134	28329	1092	0	30108
29844	28202	106	896	652	0	29856
29845	1304	110	425	27958	0	29797
29846	860	118	232	28599	0	29809
29847	555	122	239	28563	0	29479
29848	484	149	203	28707	0	29543
29849	27784	137	176	1407	0	29504
29850	28172	129	178	788	0	29267
29851	1375	108	154	27556	0	29193
29852	26960	105	240	1193	0	28498
29853	1013	152	26341	803	0	28309
29854	576	25829	873	641	0	27919
29855	482	731	461	25799	0	27473
29856	442	312	313	25074	0	26141
29857	364	24949	312	1249	0	26874
29858	447	701	267	24171	0	25586
29859	370	794	280	23728	0	25172
29860	23229	97	285	1200	0	24811
29861	851	119	21174	536	0	22680
29862	393	125	18657	303	0	19478
29863	17533	77	741	307	0	18658
29864	664	100	16633	245	0	17642
29865	8594	57	500	142	0	9293
29866	7250	33	328	114	0	7725
29867	375	270	174	5578	0	6397
29868	106	23	4338	161	0	4628
29869	3765	25	112	88	0	3990
29870	110	3735	71	69	0	3985
29871	2372	210	514	97	0	3193
29872	1635	94	86	100	0	1915
29873	684	7	52	38	0	781
29874	34	22	1	7	0	64
29875	43	2	0	6	0	51
29876	18	1	2	3	0	24
29877	12	1	1	3	0	17
29878	10	1	2	4	0	17
29879	12	0	2	2	0	16
29880	10	1	2	4	0	17
29881	9	0	3	4	0	16
29882	11	1	0	3	0	15
29883	8	0	5	0	0	13
29884	10	2	0	2	0	14
29885	10	1	1	3	0	15
29886	9	1	1	1	0	12
29887	8	1	0	2	0	11
29888	8	1	0	2	0	11
29889	7	2	0	2	0	11
29890	7	0	0	1	0	8
29891	5	0	0	3	0	8
29892	4	0	1	1	0	6
29893	2	0	0	2	0	4
29894	1	0	1	0	0	2
29895	2	0	0	0	0	2
29896	2	0	0	1	0	3
29897	2	0	0	1	0	3
29898	2	0	0	1	0	3
29899	2	0	0	1	0	3
29900	3	0	0	0	0	3
29901	3	0	0	0	0	3
29902	0	0	0	1	0	1
29903	1	0	0	0	0	1
29904	0	0	1	0	0	1
29905	0	0	0	0	0	0
29906	0	0	0	1	0	1
29907	0	0	0	0	0	0
29908	0	1	0	0	0	1
29909	0	0	0	1	0	1
29910	0	0	0	1	0	1
