Pos	A	C	G	T	Other	Total
1	0	0	0	0	0	0
2	0	0	0	0	0	0
3	0	0	0	0	0	0
4	0	0	0	0	0	0
5	0	0	0	0	0	0
6	0	0	0	0	0	0
7	0	0	1	0	0	1
8	0	0	1	0	0	1
9	0	0	0	1	0	1
10	0	0	0	1	0	1
11	0	0	0	6	0	6
12	8	0	0	0	0	8
13	0	0	0	19	0	19
14	46	0	0	1	0	47
15	0	74	0	0	0	74
16	0	129	0	0	0	129
17	0	0	0	264	0	264
18	0	0	0	281	0	281
19	0	333	0	1	0	334
20	0	335	0	3	0	338
21	0	367	0	3	0	370
22	378	1	1	0	0	380
23	1	0	383	0	0	384
24	0	0	380	0	0	380
25	0	0	1	401	0	402
26	417	0	0	1	0	418
27	422	0	0	0	0	422
28	1	417	1	1	0	420
29	506	1	0	0	0	507
30	565	0	0	0	0	565
31	571	0	0	0	0	571
32	1	578	2	0	0	581
33	0	587	0	0	0	587
34	603	1	0	0	0	604
35	612	0	0	0	0	612
36	1	610	0	0	0	611
37	0	644	0	0	0	644
38	658	1	0	0	0	659
39	651	0	0	0	0	651
40	1	653	0	1	0	655
41	0	0	0	668	0	668
42	0	0	0	669	0	669
43	0	0	0	668	0	668
44	0	672	0	1	0	673
45	0	1	666	0	0	667
46	644	0	1	0	0	645
47	1	0	0	683	0	684
48	0	680	0	1	0	681
49	0	1	0	692	0	693
50	1	701	0	1	0	703
51	0	1	0	713	0	714
52	0	0	0	722	0	722
53	0	0	726	1	0	727
54	0	0	1	715	0	716
55	728	0	0	2	0	730
56	1	0	720	0	0	721
57	701	0	1	0	0	702
58	1	0	0	733	0	734
59	3	721	0	2	0	726
60	0	2	0	737	0	739
61	0	0	731	2	0	733
62	0	0	2	717	0	719
63	0	0	0	743	0	743
64	2	735	0	1	0	738
65	0	2	0	743	0	745
66	0	735	0	2	0	737
67	0	2	0	744	0	746
68	740	0	0	2	0	742
69	725	0	0	0	0	725
70	741	0	0	0	0	741
71	2	740	0	1	0	743
72	0	2	722	0	0	724
73	722	0	3	0	0	725
74	774	0	0	0	0	774
75	4	810	0	0	0	814
76	0	5	0	677	0	682
77	0	0	0	709	0	709
78	0	0	0	664	0	664
79	665	0	0	9	0	674
80	673	0	0	2	0	675
81	670	0	0	3	0	673
82	680	0	0	0	0	680
83	11	0	0	670	0	681
84	2	649	1	9	0	661
85	2	8	0	675	0	685
86	0	0	670	12	0	682
87	0	3	7	701	0	711
88	0	0	727	11	0	738
89	0	0	11	742	0	753
90	1	0	759	11	0	771
91	0	3	762	0	0	765
92	0	768	13	5	0	786
93	0	11	2	815	0	828
94	0	0	818	15	0	833
95	1	2	12	809	0	824
96	1	824	0	16	0	841
97	823	13	2	1	0	839
98	13	828	0	4	0	845
99	1	14	0	829	0	844
100	2	826	1	12	0	841
101	0	14	815	2	0	831
102	0	0	824	2	0	826
103	0	817	13	4	0	834
104	0	13	3	839	0	855
105	0	0	827	22	0	849
106	1	821	15	1	0	838
107	841	12	0	4	0	857
108	13	3	2	834	0	852
109	1	2	846	14	0	863
110	2	845	12	1	0	860
111	0	12	0	858	0	870
112	1	2	1	863	0	867
113	834	2	1	13	0	850
114	13	2	821	2	0	838
115	1	1	13	814	0	829
116	2	2	779	14	0	797
117	0	695	17	5	0	717
118	681	15	1	3	0	700
119	14	671	4	0	0	689
120	0	14	1	655	0	670
121	2	656	2	11	0	671
122	651	17	0	1	0	669
123	14	650	2	3	0	669
124	0	16	628	7	0	651
125	4	641	14	0	0	659
126	634	14	1	2	0	651
127	13	0	648	1	0	662
128	0	3	14	644	0	661
129	618	2	0	13	0	633
130	16	0	3	601	0	620
131	607	2	0	17	0	626
132	620	0	2	2	0	624
133	14	3	0	611	0	628
134	3	0	2	623	0	628
135	599	3	0	14	0	616
136	611	1	1	3	0	616
137	15	3	0	588	0	606
138	589	0	1	17	0	607
139	603	3	1	0	0	607
140	17	582	1	3	0	603
141	4	16	1	588	0	609
142	593	0	2	16	0	611
143	614	3	1	0	0	618
144	16	1	1	595	0	613
145	3	0	1	614	0	618
146	594	0	0	18	0	612
147	17	594	2	4	0	617
148	3	15	1	584	0	603
149	3	0	574	19	0	596
150	4	3	15	556	0	578
151	9	558	0	19	0	586
152	1	15	554	3	0	573
153	2	1	14	553	0	570
154	3	5	0	554	0	562
155	3	1	551	16	0	571
156	537	4	15	5	0	561
157	15	559	3	5	0	582
158	559	16	1	2	0	578
159	19	1	563	1	0	584
160	1	3	575	4	0	583
161	554	1	15	4	0	574
162	16	565	2	4	0	587
163	562	14	5	2	0	583
164	18	556	2	3	0	579
165	2	16	570	1	0	589
166	578	1	13	5	0	597
167	13	4	580	4	0	601
168	3	1	13	572	0	589
169	583	3	2	14	0	602
170	581	1	5	4	0	591
171	15	571	3	4	0	593
172	3	28	1	543	0	575
173	3	564	2	11	0	580
174	4	19	1427	2	0	1452
175	4	14	13	1382	0	1413
176	2	1390	3	12	0	1407
177	2	13	2	1385	0	1402
178	1276	0	1	10	0	1287
179	5	2	1	1369	0	1377
180	0	1363	0	9	0	1372
181	3	6	0	1368	0	1377
182	3	0	2	1374	0	1379
183	0	1376	1	10	0	1387
184	0	7	0	1390	0	1397
185	6	2	1367	8	0	1383
186	3	1352	7	4	0	1366
187	1343	6	1	5	0	1355
188	7	3	1330	0	0	1340
189	3	1	1265	2	0	1271
190	1	1273	4	0	0	1278
191	8	4	3	1293	0	1308
192	1	1	1275	4	0	1281
193	1	1172	6	1	0	1180
194	1	3	1	1253	0	1258
195	1	2	0	1269	0	1272
196	1273	0	1	3	0	1277
197	4	1214	1	2	0	1221
198	1	4	1218	3	0	1226
199	1	2	1213	1	0	1217
200	0	0	4	1214	0	1218
201	0	2	1	1240	0	1243
202	2	0	1	1269	0	1272
203	1	1300	1	10	0	1312
204	2	2	1315	2	0	1321
205	0	4	3	1332	0	1339
206	1	1351	4	3	0	1359
207	0	1396	3	3	0	1402
208	1	7	1405	3	0	1416
209	0	6	5	1366	0	1377
210	2	4	1459	6	0	1471
211	2	4	6	1374	0	1386
212	0	2	8	1436	0	1446
213	3	1	1456	14	0	1474
214	4	1407	11	9	0	1431
215	1443	7	5	5	0	1460
216	7	5	1457	8	0	1477
217	4	1430	12	3	0	1449
218	0	1480	4	2	0	1486
219	6	13	1412	1	0	1432
220	1362	6	11	1	0	1380
221	6	7	6	1435	0	1454
222	4	1442	3	6	0	1455
223	1484	8	4	2	0	1498
224	10	4	2	1467	0	1483
225	4	1462	2	9	0	1477
226	1469	13	0	3	0	1485
227	10	5	1442	3	0	1460
228	6	1421	9	4	0	1440
229	1466	8	3	1	0	1478
230	9	1427	2	0	0	1438
231	1447	6	5	0	0	1458
232	6	8	2	1417	0	1433
233	7	1397	1	5	0	1410
234	1	11	1	1435	0	1448
235	1417	5	1	5	0	1428
236	5	5	1368	10	0	1388
237	4	3	1375	5	0	1387
238	3	1	10	1344	0	1358
239	4	2	5	1407	0	1418
240	1	0	5	1415	0	1421
241	0	1351	5	15	0	1371
242	1	7	1337	9	0	1354
243	1	5	4	1357	0	1367
244	0	1343	5	10	0	1358
245	1	1357	1	5	0	1364
246	0	11	1296	4	0	1311
247	0	11	1248	4	0	1263
248	1	5	1304	0	0	1310
249	1	5	10	1323	0	1339
250	0	1	1373	5	0	1379
251	1	1	9	1336	0	1347
252	1	1	1370	7	0	1379
253	1246	1	8	12	0	1267
254	6	1309	10	2	0	1327
255	7	1360	3	4	0	1374
256	2	15	1344	0	0	1361
257	1352	6	11	1	0	1370
258	1407	5	5	0	0	1417
259	1394	4	3	2	0	1403
260	17	3	1333	0	0	1353
261	9	2	1353	1	0	1365
262	6	2	14	1345	0	1367
263	1398	0	5	14	0	1417
264	1382	2	5	7	0	1396
265	15	2	1329	2	0	1348
266	1317	1	12	5	0	1335
267	16	2	5	1353	0	1376
268	9	2	1369	12	0	1392
269	2	0	1315	5	0	1322
270	1200	4	15	5	0	1224
271	12	0	1343	4	0	1359
272	1149	1	20	6	0	1176
273	12	3	1337	1	0	1353
274	7	479	12	5	0	503
275	2	503	10	0	0	515
276	5	13	5	496	0	519
277	2	6	9	501	0	518
278	2	5	484	17	0	508
279	1	5	10	472	0	488
280	0	466	7	16	0	489
281	1	483	4	8	0	496
282	2	473	5	4	0	484
283	3	14	1	461	0	479
284	3	9	449	9	0	470
285	1	6	457	3	0	467
286	3	5	14	436	0	458
287	3	0	4	449	0	456
288	2	1	8	428	0	439
289	2	433	5	10	0	450
290	440	9	4	5	0	458
291	442	4	1	7	0	454
292	13	440	0	4	0	457
293	7	12	435	1	0	455
294	444	5	12	0	0	461
295	15	4	437	2	0	458
296	436	6	13	2	0	457
297	441	1	9	2	0	453
298	452	0	4	0	0	456
299	443	1	5	3	0	452
300	16	436	2	1	0	455
301	416	10	0	4	0	430
302	14	418	1	3	0	436
303	354	10	5	2	0	371
304	9	345	2	2	0	358
305	1	9	299	2	0	311
306	1	30	7	262	0	300
307	1	285	1	10	0	297
308	0	244	0	1	0	245
309	211	17	4	3	0	235
310	1593	0	0	1	0	1594
311	7	1529	0	0	0	1536
312	0	9	0	1591	0	1600
313	0	1550	2	4	0	1556
314	1614	5	0	1	0	1620
315	7	2	1582	0	0	1591
316	1	2	6	1538	0	1547
317	1	0	1	1574	0	1576
318	1	0	0	1605	0	1606
319	1	0	1598	6	0	1605
320	0	1488	10	0	0	1498
321	2	1593	1	1	0	1597
322	0	7	0	1621	0	1628
323	1	0	1579	7	0	1587
324	1	1	6	1527	0	1535
325	1	0	1	1616	0	1618
326	1	0	0	1619	0	1620
327	0	1	1	1619	0	1621
328	1628	1	1	8	0	1638
329	7	1562	1	2	0	1572
330	1623	6	2	0	0	1631
331	8	1	1576	1	0	1586
332	0	6	1476	1	0	1483
333	1	2	8	1522	0	1533
334	1	0	0	1616	0	1617
335	0	1582	2	8	0	1592
336	1	10	1557	0	0	1568
337	1	1569	8	1	0	1579
338	0	7	1587	1	0	1595
339	1397	0	10	0	0	1407
340	6	1586	1	2	0	1595
341	2	7	1591	0	0	1600
342	0	1	6	1522	0	1529
343	1	0	1603	7	0	1611
344	0	1551	6	1	0	1558
345	0	7	1	1605	0	1613
346	0	1583	1	9	0	1593
347	1	9	1557	1	0	1568
348	0	1	5	1510	0	1516
349	1601	2	1	7	0	1611
350	7	1527	1	1	0	1536
351	5	8	1525	0	0	1538
352	1	2	9	1429	0	1441
353	0	2	1498	8	0	1508
354	0	3	1375	2	0	1380
355	1	1363	9	1	0	1374
356	0	2	0	1470	0	1472
357	0	0	0	1470	0	1470
358	0	0	0	1445	0	1445
359	0	3	1416	3	0	1422
360	0	2	1334	0	0	1336
361	1176	0	4	0	0	1180
362	2	0	1403	0	0	1405
363	1277	0	4	1	0	1282
364	2	1347	1	2	0	1352
365	0	2	0	1414	0	1416
366	0	1365	0	2	0	1367
367	0	1353	3	1	0	1357
368	1	4	1314	0	0	1319
369	0	0	2	1295	0	1297
370	0	1	1319	2	0	1322
371	0	1	1225	2	0	1228
372	1226	0	4	1	0	1231
373	2	2	1323	0	0	1327
374	0	3	1241	1	0	1245
375	1250	0	3	1	0	1254
376	2	0	1304	2	0	1308
377	0	4	1274	0	0	1278
378	0	0	3	1266	0	1269
379	1	1236	4	3	0	1244
380	0	2	0	1346	0	1348
381	0	0	0	1324	0	1324
382	1328	0	0	2	0	1330
383	2	0	0	1322	0	1324
384	0	1329	0	4	0	1333
385	1295	2	0	0	0	1297
386	2	0	1294	0	0	1296
387	1123	0	2	2	0	1127
388	2	1	1283	0	0	1286
389	0	1	1281	0	0	1282
390	0	1237	4	1	0	1242
391	1343	2	0	0	0	1345
392	2	1290	1	3	0	1296
393	1	2	1298	0	0	1301
394	0	0	3	1273	0	1276
395	0	1311	1	3	0	1315
396	1347	2	0	1	0	1350
397	1323	0	0	0	0	1323
398	2	1306	1	1	0	1310
399	1355	2	0	2	0	1359
400	2	1	0	1335	0	1338
401	0	1295	3	2	0	1300
402	0	2	0	1350	0	1352
403	0	0	0	1340	0	1340
404	1355	0	0	2	0	1357
405	1317	1	0	2	0	1320
406	1312	1	0	0	0	1313
407	2	1	1334	0	0	1337
408	1265	0	4	0	0	1269
409	2	1	0	1346	0	1349
410	0	0	831	2	0	833
411	2	1	906	0	0	909
412	0	835	101	2	0	938
413	743	109	8	0	0	860
414	96	791	0	1	0	888
415	8	103	2	779	0	892
416	0	8	1	910	0	919
417	1	1	788	117	0	907
418	1	3	111	819	0	934
419	0	1	822	110	0	933
420	0	15	876	8	0	899
421	8	801	101	1	0	911
422	4	120	7	730	0	861
423	1	13	1	894	0	909
424	796	1	4	130	0	931
425	101	4	805	10	0	920
426	7	3	108	827	0	945
427	809	1	28	116	0	954
428	106	3	838	9	0	956
429	820	18	108	5	0	951
430	929	7	16	11	0	963
431	110	6	816	18	0	950
432	18	9	107	796	0	930
433	9	3	28	921	0	961
434	4	7	821	130	0	962
435	826	5	113	22	0	966
436	923	2	31	11	0	967
437	904	9	19	9	0	941
438	934	5	9	7	0	955
439	931	9	28	10	0	978
440	122	6	760	25	0	913
441	20	9	893	25	0	947
442	4	822	135	11	0	972
443	19	113	838	23	0	993
444	32	13	118	798	0	961
445	25	12	28	875	0	940
446	39	6	13	888	0	946
447	33	14	20	962	0	1029
448	13	10	852	131	0	1006
449	22	797	131	33	0	983
450	15	964	39	15	0	1033
451	12	126	35	698	0	871
452	25	862	24	104	0	1015
453	865	112	27	41	0	1045
454	925	19	17	42	0	1003
455	131	847	18	43	0	1039
456	25	109	41	870	0	1045
457	26	25	30	982	0	1063
458	16	23	887	130	0	1056
459	839	19	126	38	0	1022
460	944	28	24	19	0	1015
461	136	881	32	24	0	1073
462	922	114	17	29	0	1082
463	142	30	865	22	0	1059
464	23	856	137	39	0	1055
465	20	958	28	45	0	1051
466	26	997	32	29	0	1084
467	30	131	33	907	0	1101
468	917	16	26	130	0	1089
469	127	32	19	938	0	1116
470	43	17	932	128	0	1120
471	32	13	138	962	0	1145
472	29	30	2021	135	0	2215
473	31	34	238	1771	0	2074
474	41	52	46	1604	0	1743
475	41	2041	24	167	0	2273
476	2047	225	36	47	0	2355
477	237	37	35	1871	0	2180
478	44	2026	63	211	0	2344
479	1971	227	56	68	0	2322
480	1874	63	59	60	0	2056
481	2117	51	56	38	0	2262
482	227	2038	24	62	0	2351
483	55	257	1977	61	0	2350
484	47	47	219	2075	0	2388
485	39	35	47	2057	0	2178
486	45	1979	48	233	0	2305
487	45	225	2042	57	0	2369
488	48	73	2206	51	0	2378
489	2074	44	245	46	0	2409
490	255	37	59	2068	0	2419
491	73	38	2017	237	0	2365
492	58	2034	218	78	0	2388
493	48	223	58	1809	0	2138
494	48	2067	39	217	0	2371
495	50	238	2022	54	0	2364
496	1957	45	252	41	0	2295
497	2177	42	64	30	0	2313
498	263	2060	36	53	0	2412
499	67	243	43	2060	0	2413
500	51	81	1980	257	0	2369
501	56	2078	247	61	0	2442
502	1907	260	67	52	0	2286
503	223	2064	62	41	0	2390
504	82	2225	46	52	0	2405
505	80	251	47	1900	0	2278
506	72	2073	32	243	0	2420
507	2064	245	45	96	0	2450
508	243	79	73	2095	0	2490
509	67	75	2050	267	0	2459
510	26	23	1411	26	0	1486
511	22	19	104	1294	0	1439
512	15	1402	32	101	0	1550
513	1406	109	17	29	0	1561
514	116	32	11	1408	0	1567
515	28	25	1376	119	0	1548
516	18	15	117	1405	0	1555
517	4	25	33	1498	0	1560
518	1379	26	14	127	0	1546
519	111	17	13	1246	0	1387
520	22	22	1381	96	0	1521
521	27	20	1460	18	0	1525
522	17	10	125	1367	0	1519
523	13	17	41	1483	0	1554
524	18	15	1369	128	0	1530
525	1372	14	116	49	0	1551
526	117	27	1371	24	0	1539
527	31	1396	112	28	0	1567
528	17	130	31	1363	0	1541
529	28	37	1394	116	0	1575
530	18	25	1471	44	0	1558
531	23	25	111	1394	0	1553
532	1407	18	33	118	0	1576
533	123	30	1347	39	0	1539
534	38	1391	108	31	0	1568
535	1419	128	35	16	0	1598
536	113	43	1398	18	0	1572
537	1389	23	124	35	0	1571
538	1446	21	31	32	0	1530
539	119	1863	23	26	0	2031
540	39	119	32	1599	0	1789
541	20	1854	40	99	0	2013
542	28	120	1851	35	0	2034
543	1821	29	115	45	0	2010
544	1951	22	52	26	0	2051
545	137	30	1902	26	0	2095
546	45	18	1904	43	0	2010
547	23	1870	131	30	0	2054
548	1891	120	45	29	0	2085
549	133	31	29	1889	0	2082
550	58	17	32	1820	0	1927
551	31	1882	27	124	0	2064
552	1882	119	31	48	0	2080
553	121	30	1871	35	0	2057
554	31	31	119	1934	0	2115
555	1840	26	43	128	0	2037
556	100	1895	35	44	0	2074
557	39	124	1982	31	0	2176
558	39	31	2059	24	0	2153
559	25	33	147	1812	0	2017
560	35	1945	46	108	0	2134
561	30	120	2931	36	0	3117
562	18	37	165	3003	0	3223
563	3038	25	47	174	0	3284
564	163	26	3030	40	0	3259
565	39	25	170	3071	0	3305
566	49	29	3044	170	0	3292
567	39	23	3149	36	0	3247
568	18	28	183	3054	0	3283
569	36	16	3054	174	0	3280
570	2863	22	185	48	0	3118
571	181	23	3098	32	0	3334
572	1848	0	43	8	0	1899
573	51	1897	10	1	0	1959
574	1959	49	3	3	0	2014
575	48	1911	6	4	0	1969
576	8	51	2	1975	0	2036
577	2	7	2	2018	0	2029
578	5	5	1928	50	0	1988
579	0	9	1947	5	0	1961
580	2	0	46	1955	0	2003
581	1	2	1965	55	0	2023
582	2	2	53	1924	0	1981
583	0	1934	10	53	0	1997
584	3	2002	9	9	0	2023
585	1	51	8	1983	0	2043
586	1	7	3	2028	0	2039
587	0	7	1959	51	0	2017
588	1	5	43	1924	0	1973
589	2	1900	4	57	0	1963
590	1	1939	9	6	0	1955
591	3	1971	9	12	0	1995
592	3	57	2	1923	0	1985
593	1	1929	10	44	0	1984
594	1950	56	2	12	0	2020
595	48	10	8	1947	0	2013
596	5	7	1936	56	0	2004
597	4	8	52	1909	0	1973
598	10	1	1923	61	0	1995
599	6	5	1926	9	0	1946
600	6	3	1917	6	0	1932
601	5	1784	56	16	0	1861
602	5	57	1878	2	0	1942
603	1886	7	59	8	0	1960
604	1961	6	7	7	0	1981
605	1964	7	12	7	0	1990
606	54	4	10	1929	0	1997
607	1930	5	7	54	0	1996
608	52	2310	16	9	0	2387
609	10	2440	4	16	0	2470
610	2463	53	11	7	0	2534
611	61	9	2402	6	0	2478
612	4	17	46	2409	0	2476
613	10	6	2414	53	0	2483
614	8	7	2418	12	0	2445
615	2	2364	54	12	0	2432
616	5	53	10	2354	0	2422
617	3	9	13	2482	0	2507
618	2429	9	10	56	0	2504
619	43	2371	9	15	0	2438
620	5	2420	9	13	0	2447
621	14	54	2374	14	0	2456
622	11	2342	55	8	0	2416
623	2375	60	10	14	0	2459
624	2389	10	7	16	0	2422
625	53	8	2452	6	0	2519
626	10	12	2448	14	0	2484
627	11	8	65	2251	0	2335
628	9	10	20	2396	0	2435
629	6	2349	20	66	0	2441
630	6	57	17	2408	0	2488
631	9	6	11	2448	0	2474
632	7	2399	12	59	0	2477
633	14	59	4	2423	0	2500
634	6	14	4	2415	0	2439
635	11	2359	6	62	0	2438
636	11	66	2285	17	0	2379
637	3	11	49	2400	0	2463
638	2402	10	9	65	0	2486
639	1987	10	16	12	0	2025
640	52	9	1918	10	0	1989
641	1897	9	55	18	0	1979
642	1987	5	20	8	0	2020
643	56	1874	17	20	0	1967
644	11	64	1886	6	0	1967
645	15	16	1893	9	0	1933
646	7	11	44	1925	0	1987
647	1961	15	9	55	0	2040
648	2010	10	13	9	0	2042
649	54	14	6	2006	0	2080
650	2032	11	9	59	0	2111
651	2111	9	5	10	0	2135
652	2582	10	10	12	0	2614
653	77	7	2469	14	0	2567
654	20	12	2483	6	0	2521
655	2452	2	74	8	0	2536
656	75	7	2484	14	0	2580
657	6	1393	21	1	0	1421
658	4	11	11	1427	0	1453
659	2	5	1429	15	0	1451
660	1	7	1425	4	0	1437
661	0	3	25	1410	0	1438
662	0	2	1422	17	0	1441
663	2	8	1735	8	0	1753
664	1	1662	63	5	0	1731
665	1	1806	13	6	0	1826
666	1793	62	5	3	0	1863
667	57	8	3	1791	0	1859
668	1796	1	11	56	0	1864
669	62	5	1776	9	0	1852
670	7	1	62	1760	0	1830
671	2	0	9	1853	0	1864
672	2018	1	3	64	0	2086
673	60	1981	4	11	0	2056
674	8	52	1931	2	0	1993
675	2	9	1994	3	0	2008
676	3	1946	62	3	0	2014
677	3	50	1950	1	0	2004
678	2	1941	58	2	0	2003
679	2	1975	12	4	0	1993
680	4	70	1889	5	0	1968
681	1925	12	57	1	0	1995
682	59	2	8	1980	0	2049
683	9	1962	6	57	0	2034
684	4	59	3	2031	0	2097
685	2008	9	5	60	0	2082
686	2063	5	1	11	0	2080
687	2041	2	3	8	0	2054
688	71	4	1946	2	0	2023
689	11	4	61	1942	0	2018
690	4	1933	13	60	0	2010
691	2021	54	4	8	0	2087
692	61	8	3	2003	0	2075
693	11	6	7	2032	0	2056
694	3	10	2	2105	0	2120
695	4	7	1974	68	0	2053
696	1909	3	61	11	0	1984
697	59	1941	10	11	0	2021
698	11	58	6	1988	0	2063
699	6	11	5	2086	0	2108
700	2008	3	8	76	0	2095
701	64	3	1979	14	0	2060
702	16	4	2072	7	0	2099
703	8	1918	68	7	0	2001
704	4	52	1954	7	0	2017
705	1842	11	71	5	0	1929
706	59	1933	15	12	0	2019
707	13	59	1955	4	0	2031
708	1569	14	61	7	0	1651
709	65	6	1615	11	0	1697
710	11	1612	74	8	0	1705
711	13	62	15	1600	0	1690
712	9	9	8	1699	0	1725
713	6	12	1622	74	0	1714
714	7	9	1645	22	0	1683
715	7	1610	69	10	0	1696
716	1572	63	20	4	0	1659
717	63	3960	22	7	0	4052
718	12	69	10	4180	0	4271
719	5	13	4078	72	0	4168
720	3731	13	64	14	0	3822
721	68	12	16	4137	0	4233
722	12	3910	19	64	0	4005
723	12	4068	15	16	0	4111
724	7	69	14	4202	0	4292
725	8	19	16	4240	0	4283
726	4222	14	5	79	0	4320
727	67	12	8	4213	0	4300
728	19	7	4165	75	0	4266
729	4031	5	68	19	0	4123
730	4155	11	22	8	0	4196
731	73	7	4119	12	0	4211
732	3872	11	71	12	0	3966
733	70	18	15	4173	0	4276
734	15	7	17	4211	0	4250
735	14	10	10	4235	0	4269
736	10	11	8	4059	0	4088
737	9	4060	17	74	0	4160
738	4430	64	8	17	0	4519
739	4435	17	12	15	0	4479
740	89	23	4232	11	0	4355
741	4272	5	73	22	0	4372
742	4444	4	15	13	0	4476
743	4495	10	13	10	0	4528
744	4549	7	16	11	0	4583
745	91	4338	14	11	0	4454
746	31	75	9	4535	0	4650
747	13	20	4417	83	0	4533
748	18	24	3991	24	0	4057
749	4084	12	101	16	0	4213
750	4429	7	19	12	0	4467
751	87	4184	15	19	0	4305
752	3937	67	4	7	0	4015
753	66	3722	5	8	0	3801
754	13	56	4	3897	0	3970
755	3917	9	5	68	0	3999
756	3658	3	16	10	0	3687
757	3895	9	5	8	0	3917
758	75	3736	10	7	0	3828
759	3911	61	3	5	0	3980
760	72	12	6	3808	0	3898
761	3898	5	12	66	0	3981
762	76	9	3681	13	0	3779
763	9	3154	20	2	0	3185
764	3443	18	5	4	0	3470
765	25	5	3281	0	0	3311
766	8	1	23	3281	0	3313
767	16	4	3379	21	0	3420
768	14	8	2991	4	0	3017
769	7	8	21	3251	0	3287
770	13	3	3391	21	0	3428
771	8	5	23	3304	0	3340
772	6	2	9	3142	0	3159
773	3189	0	4	25	0	3218
774	28	3027	8	6	0	3069
775	15	3064	2	8	0	3089
776	20	3081	5	2	0	3108
777	17	39	2924	4	0	2984
778	15	11	19	2925	0	2970
779	16	5	3106	20	0	3147
780	2703	8	23	10	0	2744
781	3048	6	7	3	0	3064
782	36	2996	6	4	0	3042
783	15	25	7	3096	0	3143
784	15	2958	5	27	0	3005
785	3155	25	6	7	0	3193
786	31	8	8	3066	0	3113
787	18	10	3036	23	0	3087
788	19	2768	26	13	0	2826
789	13	26	2936	11	0	2986
790	16	12	20	2957	0	3005
791	20	5	3021	19	0	3065
792	2628	13	29	16	0	2686
793	40	11	2917	7	0	2975
794	17	2764	39	6	0	2826
795	14	24	10	3049	0	3097
796	15	10	9	3061	0	3095
797	3030	7	16	28	0	3081
798	3045	7	5	19	0	3076
799	36	2782	19	6	0	2843
800	14	30	2805	10	0	2859
801	9	21	2687	19	0	2736
802	2800	13	30	7	0	2850
803	32	8	2904	11	0	2955
804	20	9	2782	16	0	2827
805	15	15	2724	6	0	2760
806	14	16	2761	8	0	2799
807	15	2687	38	14	0	2754
808	2954	33	12	7	0	3006
809	32	19	12	2801	0	2864
810	2913	12	4	27	0	2956
811	32	2734	18	14	0	2798
812	2917	26	8	13	0	2964
813	25	2821	15	10	0	2871
814	21	29	9	2878	0	2937
815	12	2859	10	24	0	2905
816	26	35	2642	17	0	2720
817	10	806	27	9	0	852
818	9	31	14	877	0	931
819	875	9	17	28	0	929
820	24	11	11	879	0	925
821	20	5	865	31	0	921
822	8	4	31	846	0	889
823	10	871	18	24	0	923
824	15	22	870	14	0	921
825	873	13	35	10	0	931
826	30	13	10	890	0	943
827	917	5	19	26	0	967
828	926	12	10	18	0	966
829	31	931	18	6	0	986
830	950	22	17	10	0	999
831	947	20	10	6	0	983
832	30	930	18	6	0	984
833	14	31	15	944	0	1004
834	13	11	12	946	0	982
835	8	934	15	31	0	988
836	14	26	11	954	0	1005
837	16	15	944	28	0	1003
838	2	6	9	716	0	733
839	1	7	734	6	0	748
840	4	1	697	4	0	706
841	1	685	6	4	0	696
842	3	678	6	3	0	690
843	3	694	2	0	0	699
844	5	4	1	633	0	643
845	1	2	636	7	0	646
846	619	1	2	3	0	625
847	2	0	4	637	0	643
848	2	0	639	3	0	644
849	1	2	637	2	0	642
850	0	628	5	2	0	635
851	6	3	3	631	0	643
852	628	2	1	3	0	634
853	3	616	1	2	0	622
854	3	612	0	1	0	616
855	0	607	0	1	0	608
856	1	4	1	615	0	621
857	1	640	1	4	0	646
858	0	6	0	678	0	684
859	0	2	0	724	0	726
860	3	1	707	7	0	718
861	640	2	3	3	0	648
862	4	1	739	1	0	745
863	3	1	5	736	0	745
864	0	0	750	5	0	755
865	0	739	5	2	0	746
866	753	5	11	2	0	771
867	5	2	0	732	0	739
868	1	1	1	757	0	760
869	762	1	0	5	0	768
870	743	0	1	3	0	747
871	778	0	1	1	0	780
872	7	2	758	0	0	767
873	730	1	3	1	0	735
874	5	741	2	1	0	749
875	3	743	0	2	0	748
876	0	7	2	734	0	743
877	1	4	0	726	0	731
878	2	731	0	7	0	740
879	2	4	0	737	0	743
880	726	3	2	6	0	737
881	5	1	713	3	0	722
882	4	722	3	0	0	729
883	717	5	2	0	0	724
884	4	718	1	1	0	724
885	3	4	720	1	0	728
886	0	4	3	712	0	719
887	0	1	706	5	0	712
888	1	703	5	3	0	712
889	0	3	2	710	0	715
890	0	4	712	4	0	720
891	0	0	706	5	0	711
892	3	1	4	719	0	727
893	707	0	7	4	0	718
894	703	1	0	3	0	707
895	713	0	1	0	0	714
896	5	2	723	0	0	730
897	2	709	3	1	0	715
898	0	3	3	727	0	733
899	0	2	2	718	0	722
900	0	734	0	5	0	739
901	730	3	0	3	0	736
902	4	2	1	735	0	742
903	4	0	739	3	0	746
904	1	725	5	4	0	735
905	739	4	1	2	0	746
906	4	734	2	1	0	741
907	4	4	0	718	0	726
908	0	3	3	716	0	722
909	1	2	0	724	0	727
910	0	3	711	8	0	722
911	1	2	3	705	0	711
912	2	703	2	5	0	712
913	2	687	1	3	0	693
914	1	7	669	2	0	679
915	666	2	4	2	0	674
916	683	3	3	2	0	691
917	7	667	1	1	0	676
918	606	4	2	0	0	612
919	605	2	0	2	0	609
920	5	635	0	3	0	643
921	3	5	0	649	0	657
922	1	2	665	6	0	674
923	2	1	650	4	0	657
924	671	2	8	0	0	681
925	5	678	4	2	0	689
926	5	6	1	691	0	703
927	0	3	2	674	0	679
928	1	4	0	663	0	668
929	644	1	0	10	0	655
930	6	3	0	648	0	657
931	3	0	2	662	0	667
932	1	2	623	10	0	636
933	603	0	8	3	0	614
934	5	621	4	0	0	630
935	623	6	2	2	0	633
936	8	616	3	0	0	627
937	2	7	3	626	0	638
938	629	3	1	9	0	642
939	628	0	0	6	0	634
940	9	1	620	2	0	632
941	625	1	3	1	0	630
942	5	0	629	3	0	637
943	3	3	604	1	0	611
944	0	0	614	3	0	617
945	2	3	2185	3	0	2193
946	4	6	86	2209	0	2305
947	5	2	2241	87	0	2335
948	2	1	125	2351	0	2479
949	2139	2	53	131	0	2325
950	85	4	43	2350	0	2482
951	2014	4	13	141	0	2172
952	106	2255	14	62	0	2437
953	50	91	5	2299	0	2445
954	37	73	1814	105	0	2029
955	9	2342	77	62	0	2490
956	10	96	42	2317	0	2465
957	11	59	2255	105	0	2430
958	2	2232	104	56	0	2394
959	2	2340	52	43	0	2437
960	8	141	2318	14	0	2481
961	3	99	105	2262	0	2469
962	6	55	2305	95	0	2461
963	2238	20	129	61	0	2448
964	2255	9	66	46	0	2376
965	137	2270	54	17	0	2478
966	2299	98	29	14	0	2440
967	134	61	20	2285	0	2500
968	64	46	2234	106	0	2450
969	2284	13	114	81	0	2492
970	117	7	2206	72	0	2402
971	73	2218	146	29	0	2466
972	2259	99	63	26	0	2447
973	119	68	49	2231	0	2467
974	65	55	2221	124	0	2465
975	2262	23	115	64	0	2464
976	2170	30	62	63	0	2325
977	2229	11	63	37	0	2340
978	174	23	36	2201	0	2434
979	97	35	25	2322	0	2479
980	63	24	2134	174	0	2395
981	32	2244	129	116	0	2521
982	15	106	80	2101	0	2302
983	29	61	71	2362	0	2523
984	33	57	2240	155	0	2485
985	33	22	2268	120	0	2443
986	31	32	161	2319	0	2543
987	2017	24	110	139	0	2290
988	100	2256	74	99	0	2529
989	2165	121	60	70	0	2416
990	162	2284	30	55	0	2531
991	70	152	2248	49	0	2519
992	69	91	2359	41	0	2560
993	2197	74	181	42	0	2494
994	2275	41	139	49	0	2504
995	170	2296	110	46	0	2622
996	143	117	2251	60	0	2571
997	98	80	153	2225	0	2556
998	70	69	104	2140	0	2383
999	67	2290	81	188	0	2626
1000	47	130	51	2373	0	2601
1001	68	79	2285	182	0	2614
1002	2248	115	138	122	0	2623
1003	2340	64	102	125	0	2631
1004	2326	29	128	97	0	2580
1005	2487	65	91	64	0	2707
1006	228	49	2298	93	0	2668
1007	2414	43	155	83	0	2695
1008	210	60	2291	66	0	2627
1009	125	2298	198	83	0	2704
1010	125	129	133	2300	0	2687
1011	2269	105	108	171	0	2653
1012	155	105	99	2402	0	2761
1013	129	73	2310	191	0	2703
1014	2344	50	162	146	0	2702
1015	2396	59	141	125	0	2721
1016	230	60	144	2313	0	2747
1017	184	52	76	2468	0	2780
1018	114	70	2268	220	0	2672
1019	114	2349	147	180	0	2790
1020	2339	145	138	148	0	2770
1021	158	122	2274	105	0	2659
1022	2273	101	183	71	0	2628
1023	223	2301	123	90	0	2737
1024	2195	156	130	60	0	2541
1025	241	2238	60	71	0	2610
1026	158	2338	99	92	0	2687
1027	158	200	91	2200	0	2649
1028	125	140	118	2286	0	2669
1029	101	114	68	2356	0	2639
1030	102	72	94	2457	0	2725
1031	95	75	2171	286	0	2627
1032	2248	51	183	192	0	2674
1033	2331	51	124	158	0	2664
1034	2436	48	122	88	0	2694
1035	310	61	72	2221	0	2664
1036	204	36	73	2415	0	2728
1037	2330	44	53	262	0	2689
1038	2201	46	114	169	0	2530
1039	2386	52	84	125	0	2647
1040	262	74	80	2250	0	2666
1041	216	53	63	2371	0	2703
1042	145	49	2079	228	0	2501
1043	121	59	2197	157	0	2534
1044	104	2249	247	146	0	2746
1045	420	12	8	4	0	444
1046	415	3	1	1	0	420
1047	423	1	1	1	0	426
1048	10	0	408	0	0	418
1049	407	0	5	1	0	413
1050	407	0	3	0	0	410
1051	409	0	1	0	0	410
1052	9	0	0	394	0	403
1053	3	0	0	399	0	402
1054	1	0	0	397	0	398
1055	0	0	355	8	0	363
1056	341	1	5	3	0	350
1057	6	351	3	1	0	361
1058	287	5	2	0	0	294
1059	5	280	0	0	0	285
1060	0	297	0	0	0	297
1061	2	5	0	290	0	297
1062	0	2	4	280	0	286
1063	0	281	0	5	0	286
1064	271	3	0	2	0	276
1065	276	0	0	1	0	277
1066	5	1	0	272	0	278
1067	1	0	261	6	0	268
1068	1	0	255	0	0	256
1069	1	0	257	1	0	259
1070	2	0	254	0	0	256
1071	241	3	8	0	0	252
1072	241	0	1	1	0	243
1073	5	0	1	234	0	240
1074	3	0	230	5	0	238
1075	2	0	5	221	0	228
1076	3	226	0	6	0	235
1077	0	241	1	1	0	243
1078	238	5	0	2	0	245
1079	242	0	0	0	0	242
1080	238	1	0	0	0	239
1081	6	1	0	232	0	239
1082	3	0	0	235	0	238
1083	1	0	0	238	0	239
1084	1	0	0	239	0	240
1085	0	0	236	5	0	241
1086	1	0	5	228	0	234
1087	234	0	0	6	0	240
1088	6	0	1	229	0	236
1089	0	0	0	239	0	239
1090	1	0	0	232	0	233
1091	0	230	0	7	0	237
1092	0	224	1	1	0	226
1093	1	214	0	1	0	216
1094	1	3	0	161	0	165
1095	0	0	0	164	0	164
1096	164	0	0	3	0	167
1097	163	0	0	0	0	163
1098	167	0	0	0	0	167
1099	3	0	0	165	0	168
1100	0	0	0	168	0	168
1101	0	173	1	3	0	177
1102	0	178	0	0	0	178
1103	171	3	0	0	0	174
1104	4	0	0	164	0	168
1105	165	0	0	3	0	168
1106	186	0	0	0	0	186
1107	3	0	0	187	0	190
1108	0	190	0	3	0	193
1109	199	3	0	0	0	202
1110	214	0	0	0	0	214
1111	3	0	220	0	0	223
1112	196	0	2	0	0	198
1113	1	194	0	0	0	195
1114	0	0	0	190	0	190
1115	215	0	0	0	0	215
1116	0	0	0	218	0	218
1117	0	0	0	218	0	218
1118	0	223	0	0	0	223
1119	223	0	0	0	0	223
1120	220	0	0	0	0	220
1121	0	221	0	0	0	221
1122	0	233	0	0	0	233
1123	235	0	0	0	0	235
1124	1710	0	0	0	0	1710
1125	0	2	1627	1	0	1630
1126	0	3	1594	0	0	1597
1127	0	1	1634	0	0	1635
1128	0	0	0	1719	0	1719
1129	0	0	0	1717	0	1717
1130	1	0	1712	0	0	1713
1131	1657	1	0	1	0	1659
1132	1750	0	0	0	0	1750
1133	1742	1	0	0	0	1743
1134	1728	0	0	1	0	1729
1135	0	1	1761	0	0	1762
1136	1717	0	0	0	0	1717
1137	1793	0	0	1	0	1794
1138	1761	0	0	0	0	1761
1139	1766	0	0	1	0	1767
1140	1727	0	0	0	0	1727
1141	0	0	1800	0	0	1800
1142	0	1685	1	1	0	1687
1143	1	0	0	1775	0	1776
1144	0	0	0	1810	0	1810
1145	0	3	1764	2	0	1769
1146	1670	0	0	1	0	1671
1147	0	0	0	1804	0	1804
1148	0	2	1821	0	0	1823
1149	0	2	1708	0	0	1710
1150	0	1764	1	0	0	1765
1151	0	0	0	1844	0	1844
1152	0	0	2	1843	0	1845
1153	0	0	0	1836	0	1836
1154	1855	0	0	1	0	1856
1155	1	3	0	1837	0	1841
1156	0	0	1766	1	0	1767
1157	0	5	1589	2	0	1596
1158	1	2	1734	1	0	1738
1159	1	2	1	1741	0	1745
1160	1865	0	0	2	0	1867
1161	2	0	1839	0	0	1841
1162	1784	0	1	0	0	1785
1163	2780	0	0	0	0	2780
1164	1	0	0	2772	0	2773
1165	0	0	0	2771	0	2771
1166	0	2665	2	3	0	2670
1167	4	6	2647	0	0	2657
1168	2595	2	1	1	0	2599
1169	1	0	0	2802	0	2803
1170	0	2731	0	4	0	2735
1171	1	3	0	2839	0	2843
1172	1	0	2803	1	0	2805
1173	0	9	1	2739	0	2749
1174	0	2716	2	1	0	2719
1175	0	1	0	2846	0	2847
1176	2830	0	0	1	0	2831
1177	1	0	0	2828	0	2829
1178	0	2731	1	3	0	2735
1179	1	2746	0	4	0	2751
1180	2797	1	1	0	0	2799
1181	1	2	2784	2	0	2789
1182	0	1	1	2764	0	2766
1183	0	0	0	2855	0	2855
1184	1	1	2784	4	0	2790
1185	0	2702	4	4	0	2710
1186	1	4	2815	0	0	2820
1187	0	0	2	2828	0	2830
1188	0	2790	1	8	0	2799
1189	2948	2	0	2	0	2952
1190	2	2802	2	1	0	2807
1191	0	2825	2	2	0	2829
1192	2981	2	0	1	0	2984
1193	2929	1	2	4	0	2936
1194	3000	0	1	0	0	3001
1195	2	1	0	2969	0	2972
1196	0	16	2924	2	0	2942
1197	2813	1	3	1	0	2818
1198	2944	0	0	0	0	2944
1199	3	0	0	3036	0	3039
1200	1	1	3044	3	0	3049
1201	1	2903	5	2	0	2911
1202	3063	3	0	0	0	3066
1203	3085	1	1	0	0	3087
1204	3	2996	4	2	0	3005
1205	2	3046	1	3	0	3052
1206	3136	3	0	0	0	3139
1207	3091	0	1	1	0	3093
1208	3097	0	0	0	0	3097
1209	3	0	0	3077	0	3080
1210	0	2	3117	5	0	3124
1211	0	1	3	3065	0	3069
1212	0	2	3107	3	0	3112
1213	0	2907	6	2	0	2915
1214	1	3022	5	2	0	3030
1215	1	6	0	3937	0	3944
1216	1	1	0	3887	0	3889
1217	0	0	0	3921	0	3921
1218	0	3800	0	3	0	3803
1219	3935	3	0	0	0	3938
1220	3823	1	1	3	0	3828
1221	2	3856	2	5	0	3865
1222	0	4	0	3944	0	3948
1223	0	3904	1	3	0	3908
1224	0	7	0	2603	0	2610
1225	0	2518	0	3	0	2521
1226	2602	3	0	2	0	2607
1227	3	0	0	2576	0	2579
1228	0	0	2538	3	0	2541
1229	2523	0	4	1	0	2528
1230	2563	0	0	0	0	2563
1231	4	1	2528	0	0	2533
1232	0	0	3	2546	0	2549
1233	3	0	2561	5	0	2569
1234	0	0	2	2539	0	2541
1235	1	1	2538	2	0	2542
1236	2419	0	3	0	0	2422
1237	2	0	0	2534	0	2536
1238	0	2392	2	3	0	2397
1239	2571	2	1	0	0	2574
1240	2	1	0	2561	0	2564
1241	0	0	0	2563	0	2563
1242	1	0	2556	2	0	2559
1243	0	0	2	2528	0	2530
1244	2	2	2603	4	0	2611
1245	1	3	2578	0	0	2582
1246	0	1	4	2654	0	2659
1247	0	2	3332	5	0	3339
1248	3204	0	30	0	0	3234
1249	4233	0	6	1	0	4240
1250	4334	3	1	3	0	4341
1251	99	4445	3	7	0	4554
1252	29	81	1	5425	0	5536
1253	17	25	3	5298	0	5343
1254	7	5520	2	120	0	5649
1255	5518	106	2	39	0	5665
1256	100	33	0	5582	0	5715
1257	37	14	5591	134	0	5776
1258	23	21	5282	44	0	5370
1259	12	5319	144	25	0	5500
1260	5585	102	50	19	0	5756
1261	125	45	5430	12	0	5612
1262	5119	14	130	7	0	5270
1263	116	4367	55	15	0	4553
1264	49	95	4684	7	0	4835
1265	27	43	5470	10	0	5550
1266	22	28	5429	7	0	5486
1267	24	5187	163	8	0	5382
1268	12	125	5447	12	0	5596
1269	5341	37	147	8	0	5533
1270	115	19	69	5426	0	5629
1271	41	16	41	5532	0	5630
1272	27	16	32	5634	0	5709
1273	20	9	32	5697	0	5758
1274	28	21	5355	172	0	5576
1275	18	13	119	5428	0	5578
1276	21	14	43	5646	0	5724
1277	5464	7	25	184	0	5680
1278	5538	7	29	81	0	5655
1279	5449	13	31	50	0	5543
1280	166	26	5105	39	0	5336
1281	71	5843	129	25	0	6068
1282	46	6205	55	48	0	6354
1283	5622	230	30	42	0	5924
1284	179	6075	38	26	0	6318
1285	82	193	30	6046	0	6351
1286	42	93	27	6313	0	6475
1287	39	40	5892	233	0	6204
1288	21	5730	207	101	0	6059
1289	34	193	5937	41	0	6205
1290	5744	81	206	37	0	6068
1291	6152	47	99	35	0	6333
1292	242	34	44	6052	0	6372
1293	86	45	41	6181	0	6353
1294	50	26	57	6214	0	6347
1295	44	39	45	6245	0	6373
1296	40	32	5950	281	0	6303
1297	37	32	199	6072	0	6340
1298	54	18	5983	244	0	6299
1299	52	43	5746	129	0	5970
1300	29	5770	255	94	0	6148
1301	5861	185	102	83	0	6231
1302	186	5909	56	96	0	6247
1303	86	212	59	5808	0	6165
1304	57	84	5916	217	0	6274
1305	5826	51	215	127	0	6219
1306	220	35	5887	83	0	6225
1307	5951	51	228	59	0	6289
1308	6101	51	100	60	0	6312
1309	303	46	57	6002	0	6408
1310	117	30	74	6057	0	6278
1311	88	48	68	6224	0	6428
1312	76	52	5735	300	0	6163
1313	5667	42	234	125	0	6068
1314	236	5722	121	90	0	6169
1315	125	197	77	5196	0	5595
1316	6098	98	65	265	0	6526
1317	6274	68	74	147	0	6563
1318	6350	66	61	121	0	6598
1319	323	61	5905	99	0	6388
1320	6059	76	220	107	0	6462
1321	6171	70	118	111	0	6470
1322	307	51	5634	147	0	6139
1323	149	71	6053	102	0	6375
1324	123	56	285	6052	0	6516
1325	112	45	5983	276	0	6416
1326	95	5735	308	149	0	6287
1327	91	6138	175	97	0	6501
1328	5928	270	136	72	0	6406
1329	249	6061	108	88	0	6506
1330	137	242	121	6104	0	6604
1331	5854	125	114	258	0	6351
1332	252	6050	103	138	0	6543
1333	135	256	104	6098	0	6593
1334	83	130	127	6270	0	6610
1335	100	71	5952	349	0	6472
1336	64	90	259	6070	0	6483
1337	87	72	5946	322	0	6427
1338	96	58	5931	191	0	6276
1339	88	47	286	5967	0	6388
1340	83	49	138	6259	0	6529
1341	6002	56	82	396	0	6536
1342	259	5989	108	212	0	6568
1343	186	215	75	6791	0	7267
1344	104	121	93	7113	0	7431
1345	6619	54	83	392	0	7148
1346	305	6610	64	206	0	7185
1347	155	5924	56	133	0	6268
1348	119	5912	74	95	0	6200
1349	63	5152	59	74	0	5348
1350	4778	183	74	75	0	5110
1351	4876	94	65	85	0	5120
1352	3731	19	8	22	0	3780
1353	3750	15	6	24	0	3795
1354	123	23	7	3610	0	3763
1355	40	21	3472	104	0	3637
1356	31	3423	95	42	0	3591
1357	28	94	30	3579	0	3731
1358	28	28	3506	96	0	3658
1359	27	21	91	3516	0	3655
1360	34	14	29	3623	0	3700
1361	18	22	3489	121	0	3650
1362	8	19	97	3496	0	3620
1363	19	21	37	3476	0	3553
1364	3572	17	18	129	0	3736
1365	2903	14	27	44	0	2988
1366	2899	15	19	30	0	2963
1367	2909	16	9	30	0	2964
1368	128	13	14	2792	0	2947
1369	47	11	10	2864	0	2932
1370	31	9	10	2951	0	3001
1371	2803	8	21	137	0	2969
1372	119	15	10	2838	0	2982
1373	46	20	22	2915	0	3003
1374	38	24	2704	131	0	2897
1375	37	27	92	2689	0	2845
1376	36	2662	23	124	0	2845
1377	35	2804	14	55	0	2908
1378	2715	119	11	34	0	2879
1379	131	42	2669	40	0	2882
1380	60	2666	96	37	0	2859
1381	2095	34	6	14	0	2149
1382	39	4	7	2122	0	2172
1383	11	8	2073	43	0	2135
1384	12	8	35	1995	0	2050
1385	14	2044	11	41	0	2110
1386	2076	31	7	20	0	2134
1387	27	2062	15	24	0	2128
1388	2087	32	9	26	0	2154
1389	2100	8	3	25	0	2136
1390	42	9	10	2060	0	2121
1391	20	10	10	2004	0	2044
1392	19	1998	4	49	0	2070
1393	2079	29	5	18	0	2131
1394	50	4	1987	18	0	2059
1395	1985	10	23	18	0	2036
1396	2059	12	1	14	0	2086
1397	45	12	1962	20	0	2039
1398	10	9	32	1965	0	2016
1399	1973	7	11	56	0	2047
1400	42	8	1933	17	0	2000
1401	15	5	1919	20	0	1959
1402	1827	7	29	30	0	1893
1403	33	1880	17	22	0	1952
1404	13	1889	12	23	0	1937
1405	21	38	12	1863	0	1934
1406	16	22	1808	32	0	1878
1407	1719	18	27	14	0	1778
1408	45	10	1775	15	0	1845
1409	14	1765	39	19	0	1837
1410	1803	33	7	13	0	1856
1411	42	12	6	1815	0	1875
1412	1814	14	14	46	0	1888
1413	50	13	1764	16	0	1843
1414	25	12	26	1743	0	1806
1415	28	1778	11	36	0	1853
1416	15	43	9	1015	0	1082
1417	15	16	8	1087	0	1126
1418	20	13	1017	32	0	1082
1419	25	1025	27	19	0	1096
1420	25	1031	11	25	0	1092
1421	26	34	1010	12	0	1082
1422	1025	12	31	16	0	1084
1423	1050	14	13	20	0	1097
1424	41	11	16	1045	0	1113
1425	1008	6	14	39	0	1067
1426	49	962	19	14	0	1044
1427	18	1021	19	20	0	1078
1428	1034	34	12	26	0	1106
1429	41	15	12	1043	0	1111
1430	1028	15	15	48	0	1106
1431	1061	12	12	14	0	1099
1432	42	12	12	1041	0	1107
1433	20	14	998	45	0	1077
1434	1018	17	33	17	0	1085
1435	1054	14	9	24	0	1101
1436	49	12	13	985	0	1059
1437	23	994	16	44	0	1077
1438	26	36	15	1028	0	1105
1439	19	14	958	39	0	1030
1440	16	16	939	22	0	993
1441	24	983	31	17	0	1055
1442	798	37	13	160	0	1008
1443	2	1	1	134	0	138
1444	2	0	127	7	0	136
1445	130	1	6	0	0	137
1446	137	0	1	1	0	139
1447	134	1	1	2	0	138
1448	138	0	1	2	0	141
1449	8	128	1	3	0	140
1450	2	136	0	3	0	141
1451	138	8	3	0	0	149
1452	6	1	1	139	0	147
1453	1	1	1	149	0	152
1454	2	137	2	7	0	148
1455	0	9	0	142	0	151
1456	1	1	1	147	0	150
1457	2	141	1	6	0	150
1458	1	6	138	1	0	146
1459	2	0	8	139	0	149
1460	143	1	0	7	0	151
1461	146	0	0	0	0	146
1462	7	2	141	1	0	151
1463	2	2	141	2	0	147
1464	3	2	137	0	0	142
1465	1	0	7	130	0	138
1466	3	0	132	7	0	142
1467	2	1	134	2	0	139
1468	2	2	6	128	0	138
1469	1	127	2	8	0	138
1470	2	6	126	3	0	137
1471	1	125	6	0	0	132
1472	124	6	1	1	0	132
1473	6	124	1	2	0	133
1474	1	5	1	120	0	127
1475	121	0	1	5	0	127
1476	5	0	3	119	0	127
1477	1	2	2	126	0	131
1478	1	0	124	6	0	131
1479	0	119	3	2	0	124
1480	2	126	2	1	0	131
1481	3	6	1	114	0	124
1482	1	0	1	122	0	124
1483	1	0	0	120	0	121
1484	3	0	112	5	0	120
1485	1	2	112	0	0	115
1486	102	1	2	0	0	105
1487	4	1	103	0	0	108
1488	0	0	102	1	0	103
1489	1	94	2	0	0	97
1490	0	2	1	98	0	101
1491	0	0	98	3	0	101
1492	0	0	3	97	0	100
1493	0	0	93	4	0	97
1494	0	0	2	97	0	99
1495	0	0	106	1	0	107
1496	0	0	2	107	0	109
1497	0	0	0	109	0	109
1498	0	111	0	1	0	112
1499	0	2	0	111	0	113
1500	0	112	0	2	0	114
1501	0	2	0	113	0	115
1502	0	0	0	114	0	114
1503	112	0	0	2	0	114
1504	3	0	0	110	0	113
1505	1	0	110	2	0	113
1506	1	0	2	109	0	112
1507	0	1	0	111	0	112
1508	0	1	106	2	0	109
1509	1	0	110	0	0	111
1510	0	0	2	108	0	110
1511	0	0	0	110	0	110
1512	0	1	108	4	0	113
1513	0	103	2	1	0	106
1514	0	107	0	1	0	108
1515	104	3	0	0	0	107
1516	3	0	0	101	0	104
1517	109	0	0	1	0	110
1518	105	0	0	0	0	105
1519	2	107	0	0	0	109
1520	110	1	0	0	0	111
1521	110	0	1	0	0	111
1522	1	0	112	0	0	113
1523	0	0	1	113	0	114
1524	0	0	115	1	0	116
1525	0	0	2	116	0	118
1526	0	0	112	1	0	113
1527	0	107	0	0	0	107
1528	0	98	1	0	0	99
1529	0	2	0	97	0	99
1530	96	0	0	0	0	96
1531	0	1	0	94	0	95
1532	0	0	0	96	0	96
1533	1	0	99	0	0	100
1534	0	0	98	1	0	99
1535	0	0	96	1	0	97
1536	0	0	1	95	0	96
1537	0	1	0	97	0	98
1538	0	99	0	0	0	99
1539	0	98	0	1	0	99
1540	99	0	0	1	0	100
1541	0	97	0	1	0	98
1542	0	1	96	0	0	97
1543	0	0	2	94	0	96
1544	1	0	101	1	0	103
1545	0	95	1	0	0	96
1546	0	3	0	94	0	97
1547	94	0	0	1	0	95
1548	1	0	97	2	0	100
1549	0	101	1	0	0	102
1550	0	1	101	0	0	102
1551	0	103	1	0	0	104
1552	2	4	0	92	0	98
1553	93	0	0	1	0	94
1554	94	0	0	0	0	94
1555	1	92	0	0	0	93
1556	92	1	0	0	0	93
1557	1	0	0	93	0	94
1558	93	0	0	1	0	94
1559	1	0	94	0	0	95
1560	0	0	95	0	0	95
1561	0	0	1	95	0	96
1562	0	0	0	98	0	98
1563	0	0	96	1	0	97
1564	0	0	1	100	0	101
1565	100	0	0	1	0	101
1566	102	0	0	0	0	102
1567	1	99	0	0	0	100
1568	0	98	0	0	0	98
1569	98	1	0	0	0	99
1570	1	0	0	98	0	99
1571	94	0	0	1	0	95
1572	1	97	0	0	0	98
1573	97	0	0	0	0	97
1574	1	0	93	1	0	95
1575	0	0	99	0	0	99
1576	0	0	1	99	0	100
1577	0	0	95	1	0	96
1578	0	0	1	94	0	95
1579	0	0	0	94	0	94
1580	0	0	100	1	0	101
1581	0	0	1	94	0	95
1582	0	0	0	99	0	99
1583	0	0	105	1	0	106
1584	0	0	104	0	0	104
1585	104	0	2	0	0	106
1586	1	0	109	0	0	110
1587	122	0	1	0	0	123
1588	139	0	0	0	0	139
1589	3	0	145	0	0	148
1590	0	1	146	0	0	147
1591	0	0	3	146	0	149
1592	0	0	0	144	0	144
1593	0	147	0	3	0	150
1594	0	149	0	0	0	149
1595	0	3	142	0	0	145
1596	140	0	3	0	0	143
1597	146	0	0	0	0	146
1598	3	1	139	0	0	143
1599	0	0	140	0	0	140
1600	0	0	3	138	0	141
1601	0	144	0	3	0	147
1602	0	3	0	145	0	148
1603	0	0	0	149	0	149
1604	146	0	0	3	0	149
1605	147	0	0	0	0	147
1606	3	0	0	147	0	150
1607	0	0	144	3	0	147
1608	147	0	2	0	0	149
1609	3	147	0	0	0	150
1610	150	3	0	0	0	153
1611	153	0	0	1	0	154
1612	3	149	0	0	0	152
1613	0	149	0	1	0	150
1614	0	3	0	148	0	151
1615	0	0	0	149	0	149
1616	0	145	0	3	0	148
1617	0	3	0	141	0	144
1618	0	0	0	140	0	140
1619	0	0	137	3	0	140
1620	136	0	3	0	0	139
1621	143	0	0	0	0	143
1622	141	0	0	0	0	141
1623	3	0	0	137	0	140
1624	136	0	0	3	0	139
1625	3	135	0	0	0	138
1626	0	3	0	131	0	134
1627	0	132	0	3	0	135
1628	0	130	0	0	0	130
1629	136	3	0	0	0	139
1630	135	0	0	0	0	135
1631	132	0	0	0	0	132
1632	133	0	0	0	0	133
1633	131	0	0	0	0	131
1634	3	0	129	0	0	132
1635	131	0	2	0	0	133
1636	3	0	131	0	0	134
1637	129	0	3	0	0	132
1638	133	0	0	0	0	133
1639	134	0	0	0	0	134
1640	3	0	134	0	0	137
1641	0	0	2	132	0	134
1642	0	137	0	2	0	139
1643	137	2	0	0	0	139
1644	137	0	0	0	0	137
1645	2	137	0	0	0	139
1646	138	2	0	0	0	140
1647	2	0	0	137	0	139
1648	0	135	0	2	0	137
1649	136	2	0	0	0	138
1650	137	0	0	0	0	137
1651	2	0	0	133	0	135
1652	133	0	0	2	0	135
1653	2	0	0	134	0	136
1654	1	0	0	136	0	137
1655	0	0	138	2	0	140
1656	0	0	2	135	0	137
1657	0	0	0	141	0	141
1658	0	0	134	2	0	136
1659	0	0	139	0	0	139
1660	0	0	2	137	0	139
1661	0	0	136	2	0	138
1662	133	0	2	0	0	135
1663	2	128	0	0	0	130
1664	0	2	1	129	0	132
1665	0	0	0	134	0	134
1666	0	0	0	134	0	134
1667	131	0	0	2	0	133
1668	135	0	0	0	0	135
1669	131	0	0	0	0	131
1670	2	129	0	0	0	131
1671	0	2	0	132	0	134
1672	0	0	0	132	0	132
1673	131	0	0	2	0	133
1674	131	0	0	0	0	131
1675	2	0	0	129	0	131
1676	0	0	130	2	0	132
1677	132	0	2	0	0	134
1678	135	0	0	0	0	135
1679	2	0	134	0	0	136
1680	127	0	2	0	0	129
1681	2	0	139	0	0	141
1682	131	0	2	0	0	133
1683	2	5	0	129	0	136
1684	0	138	0	2	0	140
1685	1	2	147	0	0	150
1686	0	150	3	0	0	153
1687	0	138	0	0	0	138
1688	120	2	4	3	0	129
1689	1	0	3	117	0	121
1690	0	0	0	116	0	116
1691	125	0	0	1	0	126
1692	0	0	0	129	0	129
1693	0	0	0	130	0	130
1694	0	0	0	132	0	132
1695	0	0	0	132	0	132
1696	1	0	126	3	0	130
1697	0	0	125	0	0	125
1698	0	131	0	0	0	131
1699	146	1	0	0	0	147
1700	1	0	0	152	0	153
1701	0	163	0	1	0	164
1702	0	1	0	166	0	167
1703	1	1	0	166	0	168
1704	0	0	0	167	0	167
1705	0	0	0	169	0	169
1706	0	0	0	170	0	170
1707	0	160	0	1	0	161
1708	0	1	0	167	0	168
1709	0	0	163	1	0	164
1710	0	166	0	0	0	166
1711	0	1	0	167	0	168
1712	0	0	0	166	0	166
1713	0	163	0	2	0	165
1714	0	167	0	0	0	167
1715	164	1	0	0	0	165
1716	1	162	0	0	0	163
1717	168	1	0	0	0	169
1718	167	0	0	0	0	167
1719	1	0	184	1	0	186
1720	0	0	1	190	0	191
1721	0	0	193	1	0	194
1722	0	202	1	0	0	203
1723	0	1	0	203	0	204
1724	0	0	0	204	0	204
1725	0	0	0	212	0	212
1726	0	0	0	211	0	211
1727	0	0	216	1	0	217
1728	0	0	1	218	0	219
1729	0	0	218	1	0	219
1730	0	0	223	0	0	223
1731	231	0	1	0	0	232
1732	240	0	0	0	0	240
1733	241	0	0	0	0	241
1734	1	248	0	0	0	249
1735	0	1	0	248	0	249
1736	0	0	260	1	0	261
1737	0	0	1	257	0	258
1738	0	2	263	1	0	266
1739	270	0	1	0	0	271
1740	267	0	0	0	0	267
1741	268	0	0	0	0	268
1742	1	0	262	0	0	263
1743	0	0	261	0	0	261
1744	0	0	1	267	0	268
1745	0	0	0	276	0	276
1746	0	0	0	272	0	272
1747	0	0	284	1	0	285
1748	0	0	267	0	0	267
1749	284	0	1	0	0	285
1750	1	0	0	1650	0	1651
1751	0	0	0	1617	0	1617
1752	1702	0	0	1	0	1703
1753	1	0	0	1680	0	1681
1754	1719	0	1	1	0	1721
1755	1695	0	0	3	0	1698
1756	1678	0	0	1	0	1679
1757	2	1	1695	0	0	1698
1758	2	1614	3	0	0	1619
1759	1731	2	0	0	0	1733
1760	3	0	0	1728	0	1731
1761	0	1	0	1723	0	1724
1762	0	1672	0	3	0	1675
1763	1760	3	0	1	0	1764
1764	1730	0	0	0	0	1730
1765	1747	0	0	0	0	1747
1766	2	1637	5	0	0	1644
1767	2453	3	0	1	0	2457
1768	2445	0	0	0	0	2445
1769	2463	0	0	0	0	2463
1770	4	1	0	2409	0	2414
1771	0	0	0	2456	0	2456
1772	0	1	2388	3	0	2392
1773	0	1	2	2317	0	2320
1774	0	0	0	2441	0	2441
1775	0	2	2404	3	0	2409
1776	2325	1	4	1	0	2331
1777	2469	0	0	0	0	2469
1778	3	0	0	2448	0	2451
1779	0	2346	2	3	0	2351
1780	1	2379	0	2	0	2382
1781	0	6	0	2470	0	2476
1782	1	0	2405	3	0	2409
1783	2	0	3	2343	0	2348
1784	0	0	2456	3	0	2459
1785	0	4	2387	3	0	2394
1786	0	0	2	2419	0	2421
1787	2532	0	2	2	0	2536
1788	2484	0	0	0	0	2484
1789	2	3	0	2514	0	2519
1790	0	0	0	2525	0	2525
1791	1	0	0	2552	0	2553
1792	0	0	0	2530	0	2530
1793	2563	0	0	4	0	2567
1794	2505	0	0	0	0	2505
1795	2513	0	0	1	0	2514
1796	2	2	2459	0	0	2463
1797	0	0	2	2463	0	2465
1798	0	0	0	2550	0	2550
1799	2562	0	0	2	0	2564
1800	2	2370	3	0	0	2375
1801	2556	1	1	0	0	2558
1802	2531	2	0	1	0	2534
1803	2511	0	0	1	0	2512
1804	2471	0	6	1	0	2478
1805	2	1	2368	0	0	2371
1806	1	4	2137	2	0	2144
1807	2499	0	2	1	0	2502
1808	2541	0	0	1	0	2542
1809	2514	1	1	2	0	2518
1810	2516	0	0	0	0	2516
1811	5	3	2501	0	0	2509
1812	0	2381	10	1	0	2392
1813	1	3	0	2677	0	2681
1814	2684	1	1	3	0	2689
1815	2681	0	0	1	0	2682
1816	2713	0	0	1	0	2714
1817	2732	0	1	0	0	2733
1818	2731	0	0	1	0	2732
1819	2656	0	2	1	0	2659
1820	6	3	2593	1	0	2603
1821	1	1	2522	0	0	2524
1822	1	0	5	2580	0	2586
1823	0	1	2653	4	0	2658
1824	0	2481	9	4	0	2494
1825	1	2523	5	4	0	2533
1826	1	10	0	2684	0	2695
1827	2	4	2658	5	0	2669
1828	1	5	2531	1	0	2538
1829	2571	0	7	0	0	2578
1830	2747	0	3	1	0	2751
1831	6	0	1	2741	0	2748
1832	2803	1	2	5	0	2811
1833	6	2	0	2761	0	2769
1834	2	1	0	2772	0	2775
1835	4	0	2812	9	0	2825
1836	2	4	2645	3	0	2654
1837	3	0	6	2752	0	2761
1838	3	3	2759	7	0	2772
1839	2607	2	6	4	0	2619
1840	2763	0	5	3	0	2771
1841	6	2684	4	5	0	2699
1842	2824	4	2	3	0	2833
1843	4	1	2768	4	0	2777
1844	2774	0	6	1	0	2781
1845	2850	0	3	2	0	2855
1846	2826	4	0	3	0	2833
1847	9	1	2	2801	0	2813
1848	3	2723	5	8	0	2739
1849	2853	5	1	3	0	2862
1850	1611	3	2	0	0	1616
1851	10	1	1	1598	0	1610
1852	1613	0	2	6	0	1621
1853	6	1593	1	5	0	1605
1854	6	5	1	1612	0	1624
1855	12	1	1596	6	0	1615
1856	1425	2	9	12	0	1448
1857	19	0	1584	2	0	1605
1858	5	7	10	1577	0	1599
1859	3	1566	2	16	0	1587
1860	1	1635	8	9	0	1653
1861	5	12	8	1652	0	1677
1862	4	1653	4	19	0	1680
1863	2	12	8	2528	0	2550
1864	12	5	1	2610	0	2628
1865	8	4	2	2654	0	2668
1866	2570	7	2	58	0	2637
1867	47	2	1	2037	0	2087
1868	17	5	1935	47	0	2004
1869	12	1968	38	28	0	2046
1870	1988	39	13	16	0	2056
1871	50	22	5	1951	0	2028
1872	20	7	3	2026	0	2056
1873	9	9	4	2060	0	2082
1874	12	8	1947	64	0	2031
1875	19	1979	38	25	0	2061
1876	1977	44	14	25	0	2060
1877	50	18	9	1920	0	1997
1878	21	2018	5	45	0	2089
1879	2054	40	6	29	0	2129
1880	46	18	2028	17	0	2109
1881	2051	12	44	13	0	2120
1882	51	11	3039	13	0	3114
1883	22	12	2959	17	0	3010
1884	19	2986	80	11	0	3096
1885	10	60	41	2914	0	3025
1886	8	31	2869	65	0	2973
1887	9	2920	60	35	0	3024
1888	12	55	35	2755	0	2857
1889	10	2861	29	60	0	2960
1890	4	80	2835	45	0	2964
1891	12	28	66	2921	0	3027
1892	5	35	2851	72	0	2963
1893	14	22	74	2877	0	2987
1894	8	13	27	2954	0	3002
1895	7	15	2829	86	0	2937
1896	9	12	60	2945	0	3026
1897	2728	6	41	97	0	2872
1898	55	2829	33	59	0	2976
1899	31	61	2804	50	0	2946
1900	2862	36	62	39	0	2999
1901	62	32	40	2572	0	2706
1902	43	2855	26	74	0	2998
1903	2844	68	19	52	0	2983
1904	2834	42	22	31	0	2929
1905	87	32	28	2754	0	2901
1906	66	12	22	2845	0	2945
1907	24	22	32	2859	0	2937
1908	21	19	31	2808	0	2879
1909	24	2784	30	131	0	2969
1910	18	82	37	2585	0	2722
1911	13	2746	22	109	0	2890
1912	21	2739	20	66	0	2846
1913	16	2728	29	66	0	2839
1914	13	131	2427	35	0	2606
1915	24	2711	82	39	0	2856
1916	2507	100	48	39	0	2694
1917	64	2619	53	55	0	2791
1918	38	95	41	2085	0	2259
1919	31	2605	39	107	0	2782
1920	29	93	36	2505	0	2663
1921	30	58	23	2682	0	2793
1922	25	50	2554	119	0	2748
1923	2557	51	77	83	0	2768
1924	2533	44	56	57	0	2690
1925	2502	51	35	53	0	2641
1926	108	2540	41	65	0	2754
1927	71	76	36	2528	0	2711
1928	58	59	2389	102	0	2608
1929	45	2495	83	79	0	2702
1930	42	98	46	1995	0	2181
1931	40	2433	51	97	0	2621
1932	2395	113	22	82	0	2612
1933	2421	60	29	70	0	2580
1934	2436	65	31	55	0	2587
1935	2430	49	38	57	0	2574
1936	116	62	44	2375	0	2597
1937	71	49	71	2297	0	2488
1938	56	2386	45	98	0	2585
1939	45	116	30	2427	0	2618
1940	39	69	2296	122	0	2526
1941	30	86	91	2392	0	2599
1942	28	67	2248	137	0	2480
1943	31	2304	94	96	0	2525
1944	27	120	2272	82	0	2501
1945	20	79	113	2371	0	2583
1946	27	70	2319	132	0	2548
1947	31	68	135	2353	0	2587
1948	41	47	68	2367	0	2523
1949	36	65	80	2310	0	2491
1950	43	55	77	2346	0	2521
1951	2285	57	52	171	0	2565
1952	103	2351	47	105	0	2606
1953	2304	139	62	100	0	2605
1954	101	92	2226	98	0	2517
1955	2277	72	92	90	0	2531
1956	2321	77	63	95	0	2556
1957	155	62	2220	71	0	2508
1958	139	55	2119	67	0	2380
1959	105	2183	101	80	0	2469
1960	78	2212	71	119	0	2480
1961	71	109	2066	120	0	2366
1962	52	2103	79	122	0	2356
1963	41	98	51	1242	0	1432
1964	1169	60	34	69	0	1332
1965	40	63	28	1234	0	1365
1966	1174	66	20	81	0	1341
1967	1148	70	28	53	0	1299
1968	65	1218	28	57	0	1368
1969	1184	60	39	43	0	1326
1970	1223	48	24	57	0	1352
1971	59	59	22	1233	0	1373
1972	1170	55	20	88	0	1333
1973	47	1212	16	90	0	1365
1974	31	57	29	1263	0	1380
1975	1215	62	7	99	0	1383
1976	46	61	1151	71	0	1329
1977	1222	59	38	52	0	1371
1978	76	48	35	1210	0	1369
1979	76	62	1141	36	0	1315
1980	71	53	1150	40	0	1314
1981	1239	56	55	55	0	1405
1982	168	0	0	0	0	168
1983	0	0	0	173	0	173
1984	0	0	0	173	0	173
1985	0	0	0	177	0	177
1986	0	177	0	0	0	177
1987	177	0	0	0	0	177
1988	0	177	0	0	0	177
1989	176	0	0	0	0	176
1990	0	0	175	0	0	175
1991	0	0	0	173	0	173
1992	179	0	0	0	0	179
1993	0	0	0	178	0	178
1994	0	0	0	174	0	174
1995	0	177	0	0	0	177
1996	177	0	0	0	0	177
1997	0	185	0	2	0	187
1998	0	0	0	187	0	187
1999	0	0	184	0	0	184
2000	177	0	0	1	0	178
2001	0	0	184	0	0	184
2002	183	0	0	0	0	183
2003	0	193	0	0	0	193
2004	0	0	0	190	0	190
2005	0	195	0	0	0	195
2006	202	0	0	0	0	202
2007	0	0	0	198	0	198
2008	0	0	0	200	0	200
2009	0	0	197	0	0	197
2010	184	0	0	1	0	185
2011	0	0	0	203	0	203
2012	0	0	201	0	0	201
2013	0	207	0	0	0	207
2014	0	0	0	209	0	209
2015	215	0	0	0	0	215
2016	0	0	0	218	0	218
2017	0	0	222	0	0	222
2018	231	0	0	0	0	231
2019	0	0	0	229	0	229
2020	0	0	265	0	0	265
2021	0	0	0	279	0	279
2022	0	0	0	281	0	281
2023	0	283	0	0	0	283
2024	288	0	0	1	0	289
2025	0	287	0	0	0	287
2026	293	0	0	0	0	293
2027	0	1	0	291	0	292
2028	1	295	0	0	0	296
2029	0	0	0	295	0	295
2030	0	1	284	0	0	285
2031	280	0	0	1	0	281
2032	0	0	1	289	0	290
2033	1	0	0	284	0	285
2034	0	0	0	288	0	288
2035	0	0	282	1	0	283
2036	0	0	284	1	0	285
2037	0	283	1	0	0	284
2038	0	0	1	282	0	283
2039	281	1	0	0	0	282
2040	0	282	0	1	0	283
2041	1	0	0	293	0	294
2042	300	1	0	0	0	301
2043	294	0	0	1	0	295
2044	1	293	0	0	0	294
2045	305	0	0	0	0	305
2046	329	1	0	0	0	330
2047	1	0	0	354	0	355
2048	1	356	0	0	0	357
2049	0	0	0	364	0	364
2050	364	1	0	0	0	365
2051	0	1	360	1	0	362
2052	1	0	0	353	0	354
2053	1	0	1	356	0	358
2054	0	0	352	2	0	354
2055	0	0	0	355	0	355
2056	355	0	1	1	0	357
2057	348	0	0	1	0	349
2058	2	0	1	351	0	354
2059	1	1	349	1	0	352
2060	1	1	338	2	0	342
2061	3	345	2	2	0	352
2062	0	354	0	3	0	357
2063	1	3	0	347	0	351
2064	345	1	1	1	0	348
2065	2	338	0	2	0	342
2066	334	0	2	0	0	336
2067	0	1	1	338	0	340
2068	1	1	0	330	0	332
2069	322	1	2	2	0	327
2070	0	324	2	3	0	329
2071	325	1	0	0	0	326
2072	1	2	320	2	0	325
2073	3	0	309	2	0	314
2074	0	1	2	310	0	313
2075	2	0	300	2	0	304
2076	2	1	301	1	0	305
2077	1	3	1	293	0	298
2078	1	8	2472	2	0	2483
2079	3	2	1	2362	0	2368
2080	1	3	2	2673	0	2679
2081	1	1	2731	4	0	2737
2082	1	1	0	2604	0	2606
2083	1	0	3	2689	0	2693
2084	3	2532	0	3	0	2538
2085	2707	1	2	2	0	2712
2086	2	1	2654	2	0	2659
2087	1	0	1	2657	0	2659
2088	0	3	4	2691	0	2698
2089	0	2	2624	5	0	2631
2090	2306	0	3	3	0	2312
2091	1	2636	4	2	0	2643
2092	2	0	0	2709	0	2711
2093	0	1	3	2684	0	2688
2094	0	2653	3	5	0	2661
2095	4	1	2605	4	0	2614
2096	1	2584	3	1	0	2589
2097	2680	1	1	2	0	2684
2098	1	7	2607	2	0	2617
2099	1	3	1	2605	0	2610
2100	4	1	2577	0	0	2582
2101	0	5	2396	3	0	2404
2102	0	2525	2	2	0	2529
2103	1	5	1	2670	0	2677
2104	2734	2	1	0	0	2737
2105	2649	2	1	1	0	2653
2106	2	2577	1	2	0	2582
2107	1	0	2	2702	0	2705
2108	2690	1	1	3	0	2695
2109	2670	2	2	1	0	2675
2110	1	2584	2	1	0	2588
2111	2712	1	0	1	0	2714
2112	2	1	2	2656	0	2661
2113	1	2623	3	1	0	2628
2114	0	0	0	2701	0	2701
2115	1	1	6	2614	0	2622
2116	1	1	2	2568	0	2572
2117	0	1	2547	3	0	2551
2118	2	5	2231	2	0	2240
2119	2	2425	2	3	0	2432
2120	2598	1	6	0	0	2605
2121	0	2463	2	2	0	2467
2122	0	1	0	2568	0	2569
2123	1	4	2433	1	0	2439
2124	0	0	1	2436	0	2437
2125	0	1	1	2466	0	2468
2126	1	1	0	2557	0	2559
2127	2559	0	0	1	0	2560
2128	0	2	0	2519	0	2521
2129	0	2	2496	2	0	2500
2130	2277	0	1	2	0	2280
2131	2273	0	1	2	0	2276
2132	2418	0	2	1	0	2421
2133	2469	0	1	1	0	2471
2134	2507	1	0	0	0	2508
2135	1	2414	1	1	0	2417
2136	0	1	1	2522	0	2524
2137	1	2406	3	0	0	2410
2138	2539	0	1	0	0	2540
2139	2473	0	0	0	0	2473
2140	2417	0	0	0	0	2417
2141	1	2400	1	1	0	2403
2142	0	2368	0	0	0	2368
2143	0	2420	1	2	0	2423
2144	1	3	2288	0	0	2292
2145	1	9	5	2236	0	2251
2146	0	2269	2	1	0	2272
2147	1	2299	0	2	0	2302
2148	0	1	0	2386	0	2387
2149	0	0	0	2346	0	2346
2150	0	4	2247	0	0	2251
2151	2137	0	1	1	0	2139
2152	0	0	0	2335	0	2335
2153	0	1	0	2306	0	2307
2154	0	1	2218	0	0	2219
2155	0	4	1966	3	0	1973
2156	0	2140	3	0	0	2143
2157	0	0	0	2367	0	2367
2158	0	0	0	2353	0	2353
2159	0	3	2182	2	0	2187
2160	2105	0	0	1	0	2106
2161	2275	0	0	1	0	2276
2162	0	5	2076	0	0	2081
2163	2170	0	0	0	0	2170
2164	0	2	2116	1	0	2119
2165	2182	0	0	0	0	2182
2166	2250	0	0	0	0	2250
2167	2	3	2167	0	0	2172
2168	0	0	1	2149	0	2150
2169	1	1	1	2195	0	2198
2170	0	0	0	2287	0	2287
2171	2302	0	0	2	0	2304
2172	2218	0	1	1	0	2220
2173	0	4	2095	0	0	2099
2174	2	17	1730	1	0	1750
2175	2123	0	0	1	0	2124
2176	2200	0	0	1	0	2201
2177	0	6	2055	0	0	2061
2178	0	1	91	0	0	92
2179	1	0	0	91	0	92
2180	0	0	96	0	0	96
2181	1	0	0	88	0	89
2182	93	0	1	0	0	94
2183	1	0	101	0	0	102
2184	103	0	0	0	0	103
2185	0	0	120	0	0	120
2186	0	0	0	122	0	122
2187	0	0	0	123	0	123
2188	0	0	0	126	0	126
2189	1	125	1	0	0	127
2190	1	0	0	127	0	128
2191	0	0	1	127	0	128
2192	126	0	1	0	0	127
2193	1	0	127	0	0	128
2194	127	0	0	0	0	127
2195	0	0	124	4	0	128
2196	120	0	1	0	0	121
2197	0	123	0	1	0	124
2198	0	0	129	0	0	129
2199	0	0	128	1	0	129
2200	1	2	0	127	0	130
2201	0	0	1	123	0	124
2202	1	0	126	0	0	127
2203	0	0	127	0	0	127
2204	0	1	141	1	0	143
2205	154	0	0	1	0	155
2206	152	0	0	0	0	152
2207	151	1	0	0	0	152
2208	0	0	0	151	0	151
2209	0	0	0	150	0	150
2210	1	0	151	0	0	152
2211	0	0	1	152	0	153
2212	1	0	0	154	0	155
2213	143	0	1	0	0	144
2214	142	0	0	0	0	142
2215	143	1	0	0	0	144
2216	0	0	1	147	0	148
2217	0	0	1	145	0	146
2218	0	0	0	144	0	144
2219	145	0	0	0	0	145
2220	0	0	1	140	0	141
2221	0	145	1	0	0	146
2222	0	0	1	143	0	144
2223	1	140	0	0	0	141
2224	144	0	0	0	0	144
2225	141	0	0	0	0	141
2226	0	142	0	1	0	143
2227	0	144	0	1	0	145
2228	0	0	0	144	0	144
2229	0	0	143	1	0	144
2230	0	0	0	140	0	140
2231	1	0	143	0	0	144
2232	1	145	0	0	0	146
2233	1	0	0	144	0	145
2234	0	0	0	147	0	147
2235	0	0	159	1	0	160
2236	0	0	0	161	0	161
2237	2	0	164	0	0	166
2238	172	0	0	0	0	172
2239	172	1	0	0	0	173
2240	176	0	0	0	0	176
2241	0	1	0	175	0	176
2242	1	0	0	176	0	177
2243	1	0	179	0	0	180
2244	0	2	0	183	0	185
2245	1	187	0	0	0	188
2246	0	0	191	1	0	192
2247	0	0	186	0	0	186
2248	0	2	0	179	0	181
2249	0	0	181	0	0	181
2250	0	0	176	0	0	176
2251	172	0	0	0	0	172
2252	0	204	0	0	0	204
2253	216	0	0	0	0	216
2254	216	0	0	1	0	217
2255	219	0	0	0	0	219
2256	0	0	0	227	0	227
2257	0	0	0	228	0	228
2258	0	0	233	0	0	233
2259	0	0	0	233	0	233
2260	0	233	0	0	0	233
2261	240	0	0	0	0	240
2262	0	230	0	1	0	231
2263	0	244	0	0	0	244
2264	0	0	0	247	0	247
2265	1	0	249	0	0	250
2266	0	0	0	252	0	252
2267	0	0	246	0	0	246
2268	0	244	0	0	0	244
2269	247	0	2	0	0	249
2270	241	0	0	1	0	242
2271	272	0	0	0	0	272
2272	0	0	311	0	0	311
2273	0	0	295	0	0	295
2274	315	0	0	0	0	315
2275	325	0	1	0	0	326
2276	336	0	0	0	0	336
2277	0	0	0	330	0	330
2278	0	0	0	344	0	344
2279	348	0	0	0	0	348
2280	343	0	0	0	0	343
2281	0	1	359	0	0	360
2282	0	1	365	0	0	366
2283	367	0	0	0	0	367
2284	0	0	379	0	0	379
2285	363	0	0	0	0	363
2286	0	0	365	0	0	365
2287	0	0	0	366	0	366
2288	0	0	391	0	0	391
2289	0	0	0	399	0	399
2290	0	0	0	407	0	407
2291	0	425	0	0	0	425
2292	437	0	0	0	0	437
2293	0	1	439	0	0	440
2294	425	0	0	0	0	425
2295	0	448	0	0	0	448
2296	481	0	3	0	0	484
2297	0	0	0	479	0	479
2298	0	0	0	481	0	481
2299	1	503	0	1	0	505
2300	0	0	0	535	0	535
2301	1	0	0	540	0	541
2302	0	0	0	543	0	543
2303	543	0	0	0	0	543
2304	518	0	0	0	0	518
2305	0	0	515	0	0	515
2306	0	512	0	0	0	512
2307	0	0	0	538	0	538
2308	0	0	0	553	0	553
2309	0	0	576	0	0	576
2310	0	0	0	567	0	567
2311	583	0	0	0	0	583
2312	578	0	0	1	0	579
2313	598	0	0	0	0	598
2314	0	0	0	603	0	603
2315	646	0	0	0	0	646
2316	650	0	0	0	0	650
2317	667	0	0	0	0	667
2318	0	0	0	663	0	663
2319	0	0	0	661	0	661
2320	0	0	0	663	0	663
2321	0	0	0	658	0	658
2322	0	0	0	658	0	658
2323	0	0	657	0	0	657
2324	0	0	650	0	0	650
2325	0	633	1	3	0	637
2326	0	0	1	656	0	657
2327	0	0	0	667	0	667
2328	0	0	0	668	0	668
2329	1	0	663	0	0	664
2330	0	0	0	663	0	663
2331	0	0	674	0	0	674
2332	0	0	0	669	0	669
2333	1	0	716	0	0	717
2334	0	707	1	1	0	709
2335	0	0	0	728	0	728
2336	0	0	718	0	0	718
2337	678	0	0	1	0	679
2338	0	722	0	7	0	729
2339	0	0	0	745	0	745
2340	0	737	0	1	0	738
2341	0	2	0	751	0	753
2342	761	0	0	1	0	762
2343	1	0	0	765	0	766
2344	1	748	1	2	0	752
2345	769	1	0	1	0	771
2346	2	0	0	764	0	766
2347	1	1	0	776	0	778
2348	783	1	0	3	0	787
2349	5	0	0	820	0	825
2350	0	1	0	2494	0	2495
2351	1	0	2540	112	0	2653
2352	1	2	2616	60	0	2679
2353	1	0	161	2596	0	2758
2354	2	0	2651	124	0	2777
2355	1	1	2648	62	0	2712
2356	2521	0	186	59	0	2766
2357	104	3	2590	32	0	2729
2358	57	2580	181	17	0	2835
2359	51	106	101	2614	0	2872
2360	2644	53	80	133	0	2910
2361	2735	49	68	74	0	2926
2362	2681	18	48	70	0	2817
2363	221	2657	50	37	0	2965
2364	126	114	57	2460	0	2757
2365	77	72	40	2791	0	2980
2366	2537	57	40	182	0	2816
2367	2688	29	32	119	0	2868
2368	2822	18	22	99	0	2961
2369	244	22	2601	46	0	2913
2370	156	2469	145	72	0	2842
2371	109	2801	117	77	0	3104
2372	56	183	127	2643	0	3009
2373	55	109	69	2946	0	3179
2374	65	75	2800	231	0	3171
2375	2738	36	207	134	0	3115
2376	2901	36	122	94	0	3153
2377	226	41	114	2765	0	3146
2378	156	73	72	2867	0	3168
2379	123	45	31	3020	0	3219
2380	2923	34	34	273	0	3264
2381	232	34	2767	159	0	3192
2382	162	33	2865	121	0	3181
2383	122	63	202	2849	0	3236
2384	70	37	2831	216	0	3154
2385	2771	21	192	183	0	3167
2386	2868	15	102	140	0	3125
2387	2898	11	96	75	0	3080
2388	311	2739	68	66	0	3184
2389	2829	135	91	58	0	3113
2390	215	107	72	2655	0	3049
2391	117	119	62	2702	0	3000
2392	111	48	61	2953	0	3173
2393	92	18	2644	325	0	3079
2394	76	24	214	2563	0	2877
2395	115	2703	128	207	0	3153
2396	2542	135	92	145	0	2914
2397	175	2745	61	163	0	3144
2398	124	198	2606	179	0	3107
2399	115	2719	182	152	0	3168
2400	2586	195	149	110	0	3040
2401	193	2664	171	128	0	3156
2402	125	212	192	1888	0	2417
2403	102	2691	143	194	0	3130
2404	2624	214	130	149	0	3117
2405	2725	123	140	100	0	3088
2406	2787	137	94	61	0	3079
2407	364	95	2605	94	0	3158
2408	242	129	2690	69	0	3130
2409	200	111	2705	113	0	3129
2410	2636	81	286	152	0	3155
2411	260	78	210	2549	0	3097
2412	203	76	157	2749	0	3185
2413	193	72	2599	312	0	3176
2414	125	91	286	2733	0	3235
2415	2471	112	186	307	0	3076
2416	286	2530	178	214	0	3208
2417	2696	209	166	152	0	3223
2418	346	157	2574	122	0	3199
2419	2653	175	261	107	0	3196
2420	2738	149	201	101	0	3189
2421	2758	148	149	150	0	3205
2422	352	134	2481	173	0	3140
2423	307	111	189	2639	0	3246
2424	309	76	2509	239	0	3133
2425	311	56	254	2645	0	3266
2426	281	54	2541	271	0	3147
2427	226	86	275	2589	0	3176
2428	190	77	208	2739	0	3214
2429	2613	58	200	360	0	3231
2430	2686	60	150	277	0	3173
2431	2736	42	155	249	0	3182
2432	363	50	169	2363	0	2945
2433	258	2173	205	259	0	2895
2434	193	2557	122	271	0	3143
2435	2587	216	98	220	0	3121
2436	325	206	2409	174	0	3114
2437	2648	141	203	146	0	3138
2438	363	81	2433	154	0	3031
2439	2646	75	261	143	0	3125
2440	2643	66	160	169	0	3038
2441	357	59	2465	182	0	3063
2442	2587	44	252	190	0	3073
2443	2515	78	196	184	0	2973
2444	2580	55	203	126	0	2964
2445	361	2433	147	145	0	3086
2446	306	198	165	2429	0	3098
2447	223	150	2345	262	0	2980
2448	211	138	2471	207	0	3027
2449	271	2420	291	179	0	3161
2450	6	576	11	3	0	596
2451	30	11	21	447	0	509
2452	450	6	3	8	0	467
2453	13	451	1	5	0	470
2454	7	10	1	448	0	466
2455	5	452	4	6	0	467
2456	445	11	3	6	0	465
2457	12	3	5	423	0	443
2458	7	4	403	11	0	425
2459	7	386	10	6	0	409
2460	6	384	7	5	0	402
2461	4	9	8	360	0	381
2462	5	375	2	7	0	389
2463	4	11	1	372	0	388
2464	375	3	0	10	0	388
2465	367	6	3	2	0	378
2466	380	4	0	7	0	391
2467	387	3	4	2	0	396
2468	14	1	369	3	0	387
2469	5	370	11	1	0	387
2470	7	377	1	2	0	387
2471	2	310	5	2	0	319
2472	3	297	1	1	0	302
2473	258	10	3	1	0	272
2474	243	2	2	0	0	247
2475	239	0	1	0	0	240
2476	243	1	1	0	0	245
2477	4	0	239	1	0	244
2478	257	1	4	1	0	263
2479	260	0	1	2	0	263
2480	262	1	2	0	0	265
2481	3	1	1	261	0	266
2482	0	1	0	261	0	262
2483	262	2	0	3	0	267
2484	4	0	0	257	0	261
2485	1	254	1	5	0	261
2486	1	5	0	258	0	264
2487	2	0	0	258	0	260
2488	1	257	0	4	0	262
2489	1	3	2	258	0	264
2490	0	1	0	264	0	265
2491	261	1	2	3	0	267
2492	3	2	240	2	0	247
2493	250	2	4	0	0	256
2494	3	0	245	3	0	251
2495	1	0	247	1	0	249
2496	2	0	250	0	0	252
2497	250	0	3	0	0	253
2498	3	0	262	0	0	265
2499	259	0	3	0	0	262
2500	274	0	0	0	0	274
2501	278	0	0	0	0	278
2502	3	278	0	0	0	281
2503	279	3	0	0	0	282
2504	2	274	0	1	0	277
2505	0	3	0	283	0	286
2506	0	0	0	279	0	279
2507	0	280	0	3	0	283
2508	0	285	0	0	0	285
2509	1	289	0	0	0	290
2510	285	3	0	0	0	288
2511	4	294	0	0	0	298
2512	300	3	0	0	0	303
2513	2	0	298	0	0	300
2514	296	0	3	0	0	299
2515	307	0	0	0	0	307
2516	4	0	297	0	0	301
2517	0	0	2	315	0	317
2518	0	0	315	4	0	319
2519	2	0	2	313	0	317
2520	0	0	0	322	0	322
2521	325	1	0	3	0	329
2522	326	0	0	1	0	327
2523	3	323	0	1	0	327
2524	326	4	0	0	0	330
2525	3	0	331	1	0	335
2526	328	0	3	1	0	332
2527	4	0	349	1	0	354
2528	0	1	350	0	0	351
2529	359	0	3	0	0	362
2530	372	0	2	0	0	374
2531	2	0	390	0	0	392
2532	1	0	4	377	0	382
2533	2	0	0	393	0	395
2534	0	0	388	3	0	391
2535	1	0	3	379	0	383
2536	0	377	1	4	0	382
2537	1	3	1	393	0	398
2538	0	1	0	390	0	391
2539	1	1	386	3	0	391
2540	366	1	2	1	0	370
2541	379	0	0	2	0	381
2542	368	0	1	1	0	370
2543	366	1	1	0	0	368
2544	4	362	0	0	0	366
2545	1	3	0	353	0	357
2546	2	1	344	3	0	350
2547	0	2	354	0	0	356
2548	1	0	4	356	0	361
2549	0	1	355	3	0	359
2550	353	0	2	0	0	355
2551	3	0	0	373	0	376
2552	0	1	2	370	0	373
2553	1	0	0	375	0	376
2554	371	0	0	3	0	374
2555	2	372	0	2	0	376
2556	387	2	0	1	0	390
2557	385	0	0	0	0	385
2558	3	380	0	0	0	383
2559	1	383	0	0	0	384
2560	393	2	0	0	0	395
2561	2	1	1	391	0	395
2562	1	1	0	390	0	392
2563	399	0	0	2	0	401
2564	2	0	389	2	0	393
2565	391	0	2	1	0	394
2566	398	0	1	0	0	399
2567	3	406	4	0	0	413
2568	446	1	0	1	0	448
2569	455	1	0	1	0	457
2570	5	499	1	1	0	506
2571	2	496	0	1	0	499
2572	5	5	2	476	0	488
2573	470	2	1	5	0	478
2574	4	493	0	2	0	499
2575	1	6	0	504	0	511
2576	510	1	0	7	0	518
2577	7	1	506	3	0	517
2578	2	1	6	503	0	512
2579	2	0	500	6	0	508
2580	498	0	7	2	0	507
2581	502	1	5	1	0	509
2582	8	0	504	2	0	514
2583	4	502	6	0	0	512
2584	2	4	2	521	0	529
2585	1	1	516	6	0	524
2586	0	1	8	516	0	525
2587	2	1	2	520	0	525
2588	1	0	515	9	0	525
2589	488	1	9	3	0	501
2590	506	1	2	3	0	512
2591	9	0	511	2	0	522
2592	5	507	9	0	0	521
2593	2	6	2	513	0	523
2594	2	511	1	4	0	518
2595	0	516	2	1	0	519
2596	524	10	0	1	0	535
2597	9	3	0	524	0	536
2598	2	2	1	514	0	519
2599	1	1	520	8	0	530
2600	1	0	513	3	0	517
2601	0	1	9	508	0	518
2602	0	2	3	516	0	521
2603	1	2	520	9	0	532
2604	0	0	521	6	0	527
2605	3	0	8	522	0	533
2606	528	1	5	8	0	542
2607	5	526	3	5	0	539
2608	539	7	2	2	0	550
2609	10	534	1	2	0	547
2610	4	550	1	0	0	555
2611	539	11	2	0	0	552
2612	9	4	533	1	0	547
2613	6	2	7	528	0	543
2614	1	4	2	543	0	550
2615	3	3	1	586	0	593
2616	0	2	589	15	0	606
2617	1	1	12	577	0	591
2618	587	1	2	14	0	604
2619	13	1	1	599	0	614
2620	3	0	4	628	0	635
2621	618	1	1	16	0	636
2622	615	0	0	5	0	620
2623	14	607	3	5	0	629
2624	4	16	607	3	0	630
2625	7	3	603	2	0	615
2626	4	2	607	2	0	615
2627	0	577	17	4	0	598
2628	4	11	8	554	0	577
2629	2	3	4	573	0	582
2630	560	2	2	17	0	581
2631	15	4	2	544	0	565
2632	2	2	537	17	0	558
2633	2	0	17	550	0	569
2634	4	1	4	560	0	569
2635	2	3	533	21	0	559
2636	0	524	17	6	0	547
2637	3	14	2	505	0	524
2638	11	515	1	13	0	540
2639	0	18	527	5	0	550
2640	527	5	15	2	0	549
2641	542	1	3	6	0	552
2642	542	3	1	4	0	550
2643	18	2	4	528	0	552
2644	4	530	4	15	0	553
2645	529	14	1	5	0	549
2646	541	3	3	4	0	551
2647	532	0	3	4	0	539
2648	18	1	512	2	0	533
2649	517	1	12	3	0	533
2650	20	514	2	3	0	539
2651	501	16	0	3	0	520
2652	17	499	3	1	0	520
2653	508	14	1	2	0	525
2654	17	5	499	1	0	522
2655	516	2	15	1	0	534
2656	513	4	3	1	0	521
2657	503	0	4	3	0	510
2658	515	3	3	2	0	523
2659	20	2	485	3	0	510
2660	6	2	15	490	0	513
2661	482	0	4	16	0	502
2662	21	484	1	5	0	511
2663	5	13	2	476	0	496
2664	3	2	469	18	0	492
2665	4	2	14	473	0	493
2666	3	3	468	16	0	490
2667	3	439	14	4	0	460
2668	2	416	6	3	0	427
2669	5	410	0	3	0	418
2670	1	12	1	344	0	358
2671	2	2	1	347	0	352
2672	1	2	327	12	0	342
2673	5	325	9	2	0	341
2674	298	10	3	1	0	312
2675	10	290	1	2	0	303
2676	1	288	3	0	0	292
2677	2	10	0	281	0	293
2678	283	1	0	9	0	293
2679	288	0	0	2	0	290
2680	8	1	1	276	0	286
2681	276	1	1	9	0	287
2682	10	1	0	277	0	288
2683	2	1	264	9	0	276
2684	271	2	9	2	0	284
2685	9	0	1	272	0	282
2686	1	1	272	8	0	282
2687	1	2	276	1	0	280
2688	1	1	7	266	0	275
2689	281	3	0	7	0	291
2690	283	1	1	1	0	286
2691	8	278	2	1	0	289
2692	285	7	1	2	0	295
2693	290	1	0	2	0	293
2694	291	0	2	1	0	294
2695	6	287	1	0	0	294
2696	283	8	0	1	0	292
2697	292	1	0	1	0	294
2698	10	1	0	284	0	295
2699	268	2	1	8	0	279
2700	10	265	0	1	0	276
2701	4	274	0	0	0	278
2702	2	6	0	272	0	280
2703	2	2	1	261	0	266
2704	3	262	0	7	0	272
2705	262	8	1	1	0	272
2706	7	255	1	2	0	265
2707	249	7	1	0	0	257
2708	8	252	0	1	0	261
2709	1	7	0	257	0	265
2710	0	258	1	6	0	265
2711	264	6	0	2	0	272
2712	269	1	2	0	0	272
2713	273	1	0	0	0	274
2714	7	2	255	1	0	265
2715	0	0	210	0	0	210
2716	0	196	2	0	0	198
2717	0	3	198	0	0	201
2718	1	0	178	0	0	179
2719	0	9	3	137	0	149
2720	0	0	146	1	0	147
2721	0	145	0	0	0	145
2722	144	0	0	0	0	144
2723	0	141	0	0	0	141
2724	0	143	0	1	0	144
2725	154	0	1	0	0	155
2726	157	0	0	0	0	157
2727	0	161	0	0	0	161
2728	163	0	0	0	0	163
2729	163	0	0	0	0	163
2730	161	0	0	0	0	161
2731	0	0	162	0	0	162
2732	0	0	158	0	0	158
2733	0	0	0	165	0	165
2734	0	0	0	164	0	164
2735	167	0	0	0	0	167
2736	0	167	0	0	0	167
2737	0	0	0	171	0	171
2738	0	0	0	173	0	173
2739	0	0	0	176	0	176
2740	0	0	0	175	0	175
2741	0	0	172	1	0	173
2742	0	0	180	0	0	180
2743	0	0	1	179	0	180
2744	0	0	190	1	0	191
2745	188	0	1	0	0	189
2746	1	0	0	218	0	219
2747	0	0	212	1	0	213
2748	209	0	1	0	0	210
2749	1	216	0	0	0	217
2750	218	1	0	0	0	219
2751	1	221	1	0	0	223
2752	0	1	0	226	0	227
2753	0	0	227	1	0	228
2754	0	0	1	213	0	214
2755	0	0	212	1	0	213
2756	217	0	1	0	0	218
2757	1	0	0	221	0	222
2758	224	0	0	1	0	225
2759	1	0	223	0	0	224
2760	230	0	1	0	0	231
2761	240	0	0	0	0	240
2762	1	0	245	0	0	246
2763	1	0	1	242	0	244
2764	0	0	246	1	0	247
2765	0	244	1	1	0	246
2766	250	1	1	0	0	252
2767	252	0	0	0	0	252
2768	1	0	254	1	0	256
2769	4	0	244	0	0	248
2770	0	0	1	254	0	255
2771	1	0	0	256	0	257
2772	253	0	0	1	0	254
2773	1	254	1	0	0	256
2774	263	1	0	1	0	265
2775	258	1	1	0	0	260
2776	1	1	250	1	0	253
2777	245	0	2	0	0	247
2778	2	0	262	1	0	265
2779	0	0	3	265	0	268
2780	1	0	275	1	0	277
2781	0	0	1	271	0	272
2782	1	0	273	2	0	276
2783	269	0	3	0	0	272
2784	269	1	0	0	0	270
2785	3	0	0	263	0	266
2786	273	0	1	1	0	275
2787	1	0	1	284	0	286
2788	1	284	1	1	0	287
2789	285	2	1	0	0	288
2790	2	290	0	2	0	294
2791	1	1	1	283	0	286
2792	0	0	1	285	0	286
2793	0	0	2	280	0	282
2794	1	0	0	281	0	282
2795	1	0	272	2	0	275
2796	264	0	1	1	0	266
2797	277	1	0	0	0	278
2798	2	278	0	1	0	281
2799	1	2	0	280	0	283
2800	1	0	1	282	0	284
2801	1	1	279	1	0	282
2802	270	0	2	1	0	273
2803	1	0	0	281	0	282
2804	0	0	278	2	0	280
2805	280	0	1	2	0	283
2806	286	0	2	0	0	288
2807	288	0	0	0	0	288
2808	3	0	278	1	0	282
2809	0	1	265	1	0	267
2810	273	2	1	1	0	277
2811	1	0	0	277	0	278
2812	0	1	1	278	0	280
2813	2	0	277	2	0	281
2814	274	1	1	1	0	277
2815	1	0	1	285	0	287
2816	310	0	0	2	0	312
2817	312	0	0	1	0	313
2818	308	0	0	1	0	309
2819	1	0	324	0	0	325
2820	1	0	2	327	0	330
2821	336	0	0	1	0	337
2822	1	342	0	1	0	344
2823	0	1	1	350	0	352
2824	1	0	1	351	0	353
2825	344	0	1	1	0	346
2826	343	0	1	1	0	345
2827	2	0	0	337	0	339
2828	1	0	335	1	0	337
2829	333	1	1	0	0	335
2830	2	0	352	0	0	354
2831	350	0	1	1	0	352
2832	349	0	3	0	0	352
2833	1	1	355	0	0	357
2834	1	0	1	354	0	356
2835	0	0	362	4	0	366
2836	2	385	1	1	0	389
2837	1	2	1	382	0	386
2838	2	406	0	1	0	409
2839	1	2	1	407	0	411
2840	2	0	417	2	0	421
2841	2	424	3	1	0	430
2842	2	432	1	1	0	436
2843	3	2	3	442	0	450
2844	434	0	2	2	0	438
2845	3	2	0	483	0	488
2846	493	1	2	2	0	498
2847	4	495	0	1	0	500
2848	564	3	0	2	0	569
2849	4	2	581	1	0	588
2850	3	2	3	580	0	588
2851	0	0	1	576	0	577
2852	0	2	571	4	0	577
2853	573	0	3	1	0	577
2854	580	0	1	0	0	581
2855	5	576	0	1	0	582
2856	1	4	0	551	0	556
2857	1	570	1	1	0	573
2858	0	3	570	2	0	575
2859	0	2	564	1	0	567
2860	0	5	4	558	0	567
2861	556	0	2	3	0	561
2862	3	537	0	3	0	543
2863	554	3	0	0	0	557
2864	3	2	545	0	0	550
2865	546	0	3	0	0	549
2866	558	1	1	0	0	560
2867	4	1	555	0	0	560
2868	2	0	4	547	0	553
2869	561	0	2	4	0	567
2870	560	0	0	2	0	562
2871	559	1	0	1	0	561
2872	6	1	1	557	0	565
2873	3	0	559	3	0	565
2874	551	0	4	2	0	557
2875	5	1	559	2	0	567
2876	1	0	6	557	0	564
2877	2	1	3	543	0	549
2878	3	549	2	5	0	559
2879	2	4	550	1	0	557
2880	1	533	3	2	0	539
2881	3	533	2	2	0	540
2882	0	5	2	541	0	548
2883	2	1	538	6	0	547
2884	0	1	6	541	0	548
2885	2	0	538	5	0	545
2886	2	1	4	531	0	538
2887	1	2	2	521	0	526
2888	2	0	512	5	0	519
2889	2	2	4	511	0	519
2890	4	2	516	3	0	525
2891	2	0	512	6	0	520
2892	1	504	6	1	0	512
2893	518	3	3	2	0	526
2894	6	1	508	1	0	516
2895	508	0	4	4	0	516
2896	5	1	2	514	0	522
2897	2	0	509	5	0	516
2898	4	507	4	4	0	519
2899	3	7	4	511	0	525
2900	0	3	514	6	0	523
2901	1	3	4	501	0	509
2902	1	513	2	7	0	523
2903	518	4	4	2	0	528
2904	5	2	2	519	0	528
2905	521	3	1	4	0	529
2906	521	3	2	5	0	531
2907	531	3	1	4	0	539
2908	529	1	3	3	0	536
2909	517	0	4	3	0	524
2910	6	508	5	1	0	520
2911	3	4	1	514	0	522
2912	2	3	3	505	0	513
2913	2	1	2	514	0	519
2914	5	1	497	6	0	509
2915	4	499	8	2	0	513
2916	517	5	3	2	0	527
2917	508	1	3	2	0	514
2918	7	501	3	0	0	511
2919	2	497	3	2	0	504
2920	491	4	2	3	0	500
2921	4	1	479	4	0	488
2922	3	3	4	467	0	477
2923	468	3	6	6	0	483
2924	4	1	4	461	0	470
2925	4	472	2	4	0	482
2926	4	4	1	484	0	493
2927	4	4	480	7	0	495
2928	480	1	6	5	0	492
2929	499	2	3	4	0	508
2930	9	2	4	479	0	494
2931	7	1	0	488	0	496
2932	484	1	2	7	0	494
2933	7	471	1	7	0	486
2934	3	7	3	475	0	488
2935	2	4	0	472	0	478
2936	439	4	5	7	0	455
2937	6	445	0	6	0	457
2938	425	4	2	4	0	435
2939	4	424	2	3	0	433
2940	4	412	1	4	0	421
2941	409	3	3	3	0	418
2942	4	404	4	1	0	413
2943	4	9	1	398	0	412
2944	5	2	391	4	0	402
2945	2	2	346	2	0	352
2946	2	3	314	3	0	322
2947	4	315	4	1	0	324
2948	257	4	1	1	0	263
2949	2	0	0	246	0	248
2950	0	0	0	251	0	251
2951	1	0	240	1	0	242
2952	247	1	1	0	0	249
2953	2	0	0	254	0	256
2954	0	1	0	254	0	255
2955	0	1	0	251	0	252
2956	250	0	0	1	0	251
2957	1	1	241	0	0	243
2958	245	0	1	1	0	247
2959	1	0	1	245	0	247
2960	0	1	245	1	0	247
2961	240	0	2	0	0	242
2962	1	2	245	0	0	248
2963	1	0	1	235	0	237
2964	0	0	240	1	0	241
2965	0	0	233	0	0	233
2966	224	0	2	0	0	226
2967	1	1	222	0	0	224
2968	0	0	1	222	0	223
2969	219	0	1	2	0	222
2970	2	0	1	221	0	224
2971	1	0	218	2	0	221
2972	0	1	222	0	0	223
2973	2	211	1	0	0	214
2974	1	1	0	218	0	220
2975	217	0	1	2	0	220
2976	2	210	1	0	0	213
2977	217	1	1	0	0	219
2978	1	0	0	218	0	219
2979	212	0	1	3	0	216
2980	1	207	1	2	0	211
2981	2	1	0	215	0	218
2982	215	1	2	1	0	219
2983	2	212	0	1	0	215
2984	2	1	0	214	0	217
2985	0	0	1	212	0	213
2986	212	1	1	1	0	215
2987	2	0	2	213	0	217
2988	0	1	1	213	0	215
2989	0	0	1	216	0	217
2990	1	0	201	1	0	203
2991	195	1	1	1	0	198
2992	2	1	1	208	0	212
2993	0	0	222	3	0	225
2994	226	0	3	0	0	229
2995	3	1	235	1	0	240
2996	2	0	3	234	0	239
2997	2	231	1	4	0	238
2998	0	4	2	244	0	250
2999	2	1	238	5	0	246
3000	1	1	241	2	0	245
3001	1	1	2	243	0	247
3002	1	0	236	7	0	244
3003	230	0	2	5	0	237
3004	3	1	229	2	0	235
3005	1	1	4	224	0	230
3006	2	0	2	224	0	228
3007	2	0	3	211	0	216
3008	209	1	0	5	0	215
3009	213	0	2	3	0	218
3010	212	0	0	2	0	214
3011	5	0	1	211	0	217
3012	2	0	0	214	0	216
3013	3	0	203	5	0	211
3014	1	1	203	4	0	209
3015	2	204	5	1	0	212
3016	2	2	2	160	0	166
3017	1	1	2	160	0	164
3018	0	156	2	3	0	161
3019	153	2	1	3	0	159
3020	1	160	1	2	0	164
3021	147	3	1	2	0	153
3022	2	3	0	151	0	156
3023	149	2	1	3	0	155
3024	3	0	1	144	0	148
3025	1	2	141	3	0	147
3026	3	0	1	143	0	147
3027	135	1	2	2	0	140
3028	4	0	2	136	0	142
3029	1	0	1	137	0	139
3030	2	0	135	4	0	141
3031	1	0	1	142	0	144
3032	2	0	2	135	0	139
3033	2	132	1	4	0	139
3034	3	1	1	138	0	143
3035	1	1	1	140	0	143
3036	0	1	0	136	0	137
3037	0	129	2	5	0	136
3038	0	4	2	126	0	132
3039	117	2	1	5	0	125
3040	1	119	0	2	0	122
3041	1	112	0	3	0	116
3042	1	111	0	2	0	114
3043	2	4	0	102	0	108
3044	1	98	0	1	0	100
3045	1	102	1	2	0	106
3046	92	4	1	2	0	99
3047	3	3	81	1	0	88
3048	78	2	1	3	0	84
3049	2	2	2	89	0	95
3050	2	2	88	5	0	97
3051	90	1	4	2	0	97
3052	2	1	87	2	0	92
3053	3	0	83	4	0	90
3054	84	0	5	1	0	90
3055	5	0	4	84	0	93
3056	3	0	86	3	0	92
3057	84	1	5	3	0	93
3058	87	0	2	5	0	94
3059	3	0	90	5	0	98
3060	89	0	3	2	0	94
3061	91	1	2	0	0	94
3062	6	0	87	2	0	95
3063	91	0	3	2	0	96
3064	90	1	2	3	0	96
3065	5	2	88	1	0	96
3066	3	1	95	1	0	100
3067	3	2	5	92	0	102
3068	3	2	94	3	0	102
3069	90	1	3	5	0	99
3070	2	1	3	92	0	98
3071	5	1	3	93	0	102
3072	3	1	91	3	0	98
3073	3	1	3	94	0	101
3074	2	0	94	7	0	103
3075	94	0	3	6	0	103
3076	94	0	4	3	0	101
3077	4	0	91	3	0	98
3078	94	0	3	4	0	101
3079	97	0	3	3	0	103
3080	6	0	96	4	0	106
3081	96	0	4	3	0	103
3082	95	0	6	1	0	102
3083	5	1	92	2	0	100
3084	96	0	3	4	0	103
3085	5	2	96	1	0	104
3086	4	2	3	98	0	107
3087	4	0	2	98	0	104
3088	3	1	2	102	0	108
3089	3	2	96	5	0	106
3090	93	1	1	7	0	102
3091	5	0	97	4	0	106
3092	3	87	3	2	0	95
3093	1	73	3	0	0	77
3094	63	1	0	1	0	65
3095	1	2	1	62	0	66
3096	1	61	0	1	0	63
3097	52	1	0	0	0	53
3098	51	1	0	0	0	52
3099	1	51	0	1	0	53
3100	1	1	0	51	0	53
3101	1	51	0	0	0	52
3102	52	0	0	1	0	53
3103	50	1	0	0	0	51
3104	1	0	0	51	0	52
3105	53	1	0	0	0	54
3106	0	0	0	53	0	53
3107	2	0	52	0	0	54
3108	52	0	0	2	0	54
3109	1	0	52	0	0	53
3110	1	0	0	49	0	50
3111	49	0	2	0	0	51
3112	1	0	0	55	0	56
3113	1	0	54	0	0	55
3114	0	0	50	2	0	52
3115	1	0	1	52	0	54
3116	52	0	1	1	0	54
3117	0	51	1	1	0	53
3118	1	0	1	56	0	58
3119	0	1	55	1	0	57
3120	56	0	0	1	0	57
3121	56	1	1	0	0	58
3122	1	0	52	1	0	54
3123	56	0	1	0	0	57
3124	0	0	2	56	0	58
3125	2	0	55	0	0	57
3126	55	0	0	2	0	57
3127	0	0	2	56	0	58
3128	2	0	0	55	0	57
3129	56	0	0	2	0	58
3130	0	49	0	2	0	51
3131	1	52	0	0	0	53
3132	52	2	0	0	0	54
3133	50	1	0	0	0	51
3134	2	0	52	0	0	54
3135	2	0	51	0	0	53
3136	0	0	2	50	0	52
3137	51	0	2	0	0	53
3138	48	0	0	2	0	50
3139	52	0	0	0	0	52
3140	2	52	0	0	0	54
3141	2	51	0	0	0	53
3142	0	1	0	54	0	55
3143	0	2	0	56	0	58
3144	0	0	0	59	0	59
3145	0	0	57	3	0	60
3146	0	0	52	2	0	54
3147	53	0	3	0	0	56
3148	57	0	2	0	0	59
3149	3	0	0	47	0	50
3150	2	0	0	48	0	50
3151	0	0	0	48	0	48
3152	0	0	50	3	0	53
3153	0	0	50	2	0	52
3154	0	0	3	49	0	52
3155	0	0	50	1	0	51
3156	0	47	1	1	0	49
3157	0	47	2	0	0	49
3158	47	2	0	0	0	49
3159	1	46	0	0	0	47
3160	2	1	0	45	0	48
3161	0	2	0	45	0	47
3162	0	49	0	3	0	52
3163	0	0	0	51	0	51
3164	0	2	46	1	0	49
3165	0	51	1	2	0	54
3166	0	1	2	45	0	48
3167	0	0	46	1	0	47
3168	0	45	1	0	0	46
3169	0	1	1	43	0	45
3170	0	47	0	0	0	47
3171	0	1	0	44	0	45
3172	0	1	0	43	0	44
3173	0	43	0	2	0	45
3174	41	1	0	1	0	43
3175	41	1	0	0	0	42
3176	2	42	0	0	0	44
3177	1	46	0	0	0	47
3178	0	2	0	45	0	47
3179	0	1	43	1	0	45
3180	42	0	1	1	0	44
3181	43	0	1	0	0	44
3182	2	0	42	0	0	44
3183	43	0	1	0	0	44
3184	43	0	1	0	0	44
3185	2	0	40	0	0	42
3186	41	0	1	0	0	42
3187	1	0	40	0	0	41
3188	1	37	1	0	0	39
3189	42	0	1	0	0	43
3190	43	1	0	0	0	44
3191	2	0	40	0	0	42
3192	43	0	1	0	0	44
3193	42	0	1	0	0	43
3194	2	0	42	0	0	44
3195	45	0	1	0	0	46
3196	45	0	1	0	0	46
3197	2	0	42	0	0	44
3198	43	0	1	0	0	44
3199	1	0	1	43	0	45
3200	1	0	0	43	0	44
3201	0	0	43	2	0	45
3202	0	0	43	1	0	44
3203	0	0	2	42	0	44
3204	0	0	1	44	0	45
3205	45	0	0	0	0	45
3206	1	0	46	1	0	48
3207	47	0	1	0	0	48
3208	1	0	1	49	0	51
3209	1	0	51	1	0	53
3210	53	0	1	1	0	55
3211	1	0	2	55	0	58
3212	1	0	52	1	0	54
3213	52	0	1	1	0	54
3214	1	0	1	54	0	56
3215	56	0	0	1	0	57
3216	1	0	60	1	0	62
3217	1	2	1	52	0	56
3218	0	60	1	1	0	62
3219	61	1	0	0	0	62
3220	62	0	0	0	0	62
3221	1	58	0	0	0	59
3222	62	1	0	0	0	63
3223	62	0	0	0	0	62
3224	62	0	0	0	0	62
3225	1	58	0	0	0	59
3226	0	1	0	62	0	63
3227	0	0	59	1	0	60
3228	0	0	1	59	0	60
3229	0	0	0	61	0	61
3230	0	0	60	1	0	61
3231	0	0	62	0	0	62
3232	0	0	1	60	0	61
3233	0	59	0	1	0	60
3234	66	1	0	0	0	67
3235	66	0	0	0	0	66
3236	1	70	0	0	0	71
3237	77	1	0	0	0	78
3238	76	0	0	0	0	76
3239	1	0	78	0	0	79
3240	74	0	1	0	0	75
3241	1	73	0	0	0	74
3242	0	0	72	0	0	72
3243	0	0	71	0	0	71
3244	0	67	0	0	0	67
3245	67	0	0	0	0	67
3246	0	0	71	0	0	71
3247	0	0	0	72	0	72
3248	0	0	75	0	0	75
3249	73	0	0	0	0	73
3250	2	5	852	0	0	859
3251	1	5	825	0	0	831
3252	917	0	0	0	0	917
3253	0	885	2	1	0	888
3254	988	0	0	0	0	988
3255	985	0	0	0	0	985
3256	0	1	0	985	0	986
3257	0	944	0	1	0	945
3258	1018	0	0	0	0	1018
3259	1	0	994	0	0	995
3260	941	0	0	1	0	942
3261	0	918	0	0	0	918
3262	1017	0	0	0	0	1017
3263	1009	0	0	0	0	1009
3264	0	962	0	1	0	963
3265	0	0	0	1026	0	1026
3266	1035	0	0	0	0	1035
3267	0	977	0	2	0	979
3268	0	0	0	1034	0	1034
3269	1038	0	0	0	0	1038
3270	0	0	0	1028	0	1028
3271	0	0	0	1019	0	1019
3272	0	1006	0	0	0	1006
3273	1019	0	0	0	0	1019
3274	1019	0	0	0	0	1019
3275	1036	0	0	0	0	1036
3276	0	984	1	0	0	985
3277	1056	0	0	0	0	1056
3278	1055	0	0	0	0	1055
3279	0	0	0	1022	0	1022
3280	0	0	0	1041	0	1041
3281	0	0	1012	0	0	1012
3282	0	0	0	961	0	961
3283	0	0	1	966	0	967
3284	0	0	1003	0	0	1003
3285	860	0	2	1	0	863
3286	1	0	1015	0	0	1016
3287	0	1	974	0	0	975
3288	0	0	0	971	0	971
3289	0	0	0	1000	0	1000
3290	0	977	2	1	0	980
3291	1036	0	0	0	0	1036
3292	956	1	0	1	0	958
3293	1	983	0	0	0	984
3294	0	1018	0	0	0	1018
3295	0	0	0	1057	0	1057
3296	0	1008	1	1	0	1010
3297	1065	2	0	0	0	1067
3298	1038	0	0	0	0	1038
3299	2	0	0	1046	0	1048
3300	1	0	0	1043	0	1044
3301	1066	0	0	2	0	1068
3302	2	1	1011	0	0	1014
3303	1029	0	3	0	0	1032
3304	3	0	1006	1	0	1010
3305	1020	0	2	0	0	1022
3306	2	0	0	1036	0	1038
3307	1	0	1051	2	0	1054
3308	1	2	979	1	0	983
3309	1026	0	2	0	0	1028
3310	1063	0	0	0	0	1063
3311	1	1026	0	1	0	1028
3312	0	2	0	1094	0	1096
3313	0	0	0	1095	0	1095
3314	1090	0	0	3	0	1093
3315	3	1050	0	0	0	1053
3316	1087	3	0	0	0	1090
3317	3	1034	0	1	0	1038
3318	0	1029	0	0	0	1029
3319	1084	3	0	0	0	1087
3320	4	0	1047	0	0	1051
3321	0	0	3	1052	0	1055
3322	0	1	0	1063	0	1064
3323	0	0	1065	3	0	1068
3324	0	0	3	1025	0	1028
3325	0	0	2	1016	0	1018
3326	0	1033	1	3	0	1037
3327	1081	3	0	0	0	1084
3328	3	0	1075	0	0	1078
3329	1018	0	2	1	0	1021
3330	3	1031	2	0	0	1036
3331	0	4	0	1091	0	1095
3332	1113	0	0	3	0	1116
3333	3	1	0	1089	0	1093
3334	0	0	0	1100	0	1100
3335	1	0	1077	3	0	1081
3336	1003	1	6	0	0	1010
3337	1079	0	0	0	0	1079
3338	3	0	1076	0	0	1079
3339	0	0	3	1065	0	1068
3340	0	0	1086	3	0	1089
3341	1058	1	3	0	0	1062
3342	1100	0	0	0	0	1100
3343	3	1	0	1064	0	1068
3344	1074	0	1	4	0	1079
3345	4	1	1098	0	0	1103
3346	0	0	3	1071	0	1074
3347	0	0	0	1077	0	1077
3348	0	0	0	1112	0	1112
3349	0	0	0	1102	0	1102
3350	311	0	0	3	0	314
3351	3	0	306	0	0	309
3352	0	0	3	307	0	310
3353	0	0	307	3	0	310
3354	0	0	311	0	0	311
3355	0	0	2	301	0	303
3356	0	0	0	307	0	307
3357	290	0	0	3	0	293
3358	3	0	0	300	0	303
3359	0	0	0	299	0	299
3360	0	0	0	304	0	304
3361	300	0	0	5	0	305
3362	306	0	0	0	0	306
3363	307	0	0	0	0	307
3364	295	0	0	0	0	295
3365	3	308	0	0	0	311
3366	0	4	0	304	0	308
3367	0	0	0	309	0	309
3368	308	0	0	4	0	312
3369	4	316	0	0	0	320
3370	0	4	0	339	0	343
3371	0	0	374	4	0	378
3372	443	0	5	0	0	448
3373	9	460	0	0	0	469
3374	481	10	0	0	0	491
3375	1276	0	0	1	0	1277
3376	79	1	0	1286	0	1366
3377	25	2	1249	82	0	1358
3378	6	1	73	1328	0	1408
3379	1293	0	23	87	0	1403
3380	78	0	6	1322	0	1406
3381	1326	0	3	85	0	1414
3382	84	1299	2	29	0	1414
3383	1358	77	1	7	0	1443
3384	89	25	0	1317	0	1431
3385	27	5	0	1420	0	1452
3386	1373	3	0	108	0	1484
3387	1429	1	0	31	0	1461
3388	1453	1	0	7	0	1461
3389	1454	1	0	4	0	1459
3390	1447	0	0	2	0	1449
3391	115	0	0	1342	0	1457
3392	36	4	1263	83	0	1386
3393	11	1305	76	28	0	1420
3394	1340	76	23	6	0	1445
3395	85	26	1276	5	0	1392
3396	1332	5	78	2	0	1417
3397	82	1297	25	3	0	1407
3398	1323	78	6	3	0	1410
3399	83	28	3	1296	0	1410
3400	33	6	1	1386	0	1426
3401	11	4	1298	106	0	1419
3402	6	1	79	1336	0	1422
3403	6	2	1318	85	0	1411
3404	3	2	1358	32	0	1395
3405	1316	0	101	7	0	1424
3406	1408	0	31	10	0	1449
3407	112	2	1280	6	0	1400
3408	1324	0	79	9	0	1412
3409	1388	1	30	5	0	1424
3410	112	0	1243	9	0	1364
3411	43	1252	80	5	0	1380
3412	18	84	23	1274	0	1399
3413	1293	26	4	82	0	1405
3414	1351	8	5	33	0	1397
3415	1374	5	3	11	0	1393
3416	1386	3	3	11	0	1403
3417	1401	1	3	9	0	1414
3418	125	1	1245	10	0	1381
3419	50	1	1322	6	0	1379
3420	26	2	99	1288	0	1415
3421	1282	0	29	87	0	1398
3422	1368	2	16	30	0	1416
3423	1379	4	5	11	0	1399
3424	1336	3	4	10	0	1353
3425	104	1783	10	7	0	1904
3426	63	1949	6	8	0	2026
3427	1894	108	5	16	0	2023
3428	1950	33	15	9	0	2007
3429	115	1889	6	24	0	2034
3430	1981	84	3	22	0	2090
3431	107	29	1907	25	0	2068
3432	56	16	82	1905	0	2059
3433	24	21	1918	86	0	2049
3434	32	6	1922	38	0	1998
3435	23	4	107	1890	0	2024
3436	18	7	35	1985	0	2045
3437	31	4	3071	114	0	3220
3438	41	4	78	3005	0	3128
3439	40	1	28	3312	0	3381
3440	3274	0	19	113	0	3406
3441	3310	4	10	42	0	3366
3442	124	4	8	3244	0	3380
3443	51	9	3197	92	0	3349
3444	28	3112	82	39	0	3261
3445	3197	85	31	17	0	3330
3446	114	26	3157	6	0	3303
3447	61	3024	84	7	0	3176
3448	30	3185	34	6	0	3255
3449	3252	104	16	7	0	3379
3450	3316	33	10	25	0	3384
3451	115	15	14	3219	0	3363
3452	47	4	3218	97	0	3366
3453	24	3	88	3247	0	3362
3454	23	3	39	3322	0	3387
3455	20	4	34	3381	0	3439
3456	3286	9	13	118	0	3426
3457	114	3166	10	43	0	3333
3458	48	3233	26	17	0	3324
3459	41	108	12	3258	0	3419
3460	42	33	8	3357	0	3440
3461	3315	14	23	107	0	3459
3462	3083	19	10	45	0	3157
3463	3338	10	11	27	0	3386
3464	122	3173	14	16	0	3325
3465	3327	83	11	14	0	3435
3466	116	38	5	3260	0	3419
3467	71	13	3149	84	0	3317
3468	44	16	2907	39	0	3006
3469	3023	4	109	20	0	3156
3470	94	7	3062	15	0	3178
3471	45	9	2911	26	0	2991
3472	2845	2	103	20	0	2970
3473	109	2	2900	10	0	3021
3474	63	10	2941	10	0	3024
3475	1	4	3	2001	0	2009
3476	1	0	2104	0	0	2105
3477	0	2	1	1975	0	1978
3478	0	0	1	2042	0	2043
3479	2	0	2097	1	0	2100
3480	0	1994	1	2	0	1997
3481	2103	1	3	4	0	2111
3482	2	2	2082	1	0	2087
3483	1	3	2062	0	0	2066
3484	1722	2	6	2	0	1732
3485	0	0	2053	1	0	2054
3486	2	1872	4	4	0	1882
3487	1	1861	5	1	0	1868
3488	1	1	1	2031	0	2034
3489	1	3	3	1995	0	2002
3490	2062	1	0	0	0	2063
3491	1994	0	1	2	0	1997
3492	2028	1	0	1	0	2030
3493	1	0	0	2023	0	2024
3494	2073	0	3	1	0	2077
3495	2006	3	3	1	0	2013
3496	2	1	2025	3	0	2031
3497	2	3	1909	1	0	1915
3498	1	1906	3	3	0	1913
3499	0	0	1	2063	0	2064
3500	2073	0	0	0	0	2073
3501	0	1976	2	0	0	1978
3502	0	0	0	2070	0	2070
3503	2078	0	0	0	0	2078
3504	2030	2	0	0	0	2032
3505	1	1990	1	1	0	1993
3506	2070	0	0	2	0	2072
3507	1996	0	0	0	0	1996
3508	1	1	0	2005	0	2007
3509	1	0	2058	2	0	2061
3510	1	1917	5	1	0	1924
3511	1	2008	3	2	0	2014
3512	2062	0	1	0	0	2063
3513	0	2	0	1998	0	2000
3514	3	3	2027	1	0	2034
3515	1	1907	2	2	0	1912
3516	2039	0	1	1	0	2041
3517	2033	0	1	2	0	2036
3518	2	2	2041	0	0	2045
3519	3	0	0	1950	0	1953
3520	1	0	0	2059	0	2060
3521	1	1	2062	0	0	2064
3522	1899	0	5	3	0	1907
3523	2131	0	1	2	0	2134
3524	3	2	1	3298	0	3304
3525	2	2813	3	71	0	2889
3526	1	67	0	2958	0	3026
3527	4	25	2872	89	0	2990
3528	2723	13	76	35	0	2847
3529	73	9	26	2955	0	3063
3530	31	3	2866	91	0	2991
3531	2739	3	83	35	0	2860
3532	76	6	34	2902	0	3018
3533	31	2	18	2982	0	3033
3534	2925	3	14	98	0	3040
3535	87	2857	4	49	0	2997
3536	2924	76	13	26	0	3039
3537	97	30	6	1848	0	1981
3538	1867	16	5	86	0	1974
3539	94	10	1744	46	0	1894
3540	48	1804	73	25	0	1950
3541	25	81	28	1845	0	1979
3542	1800	34	12	85	0	1931
3543	83	1819	8	45	0	1955
3544	38	81	4	1860	0	1983
3545	2310	31	10	92	0	2443
3546	2429	18	11	43	0	2501
3547	186	16	8	2329	0	2539
3548	72	6	2226	170	0	2474
3549	41	17	2313	50	0	2421
3550	2262	14	181	44	0	2501
3551	152	2239	56	38	0	2485
3552	62	2367	32	19	0	2480
3553	2236	175	18	21	0	2450
3554	155	2299	16	22	0	2492
3555	60	156	21	2243	0	2480
3556	39	46	23	2445	0	2553
3557	2305	23	14	197	0	2539
3558	2409	27	14	72	0	2522
3559	2453	21	6	47	0	2527
3560	228	27	2232	26	0	2513
3561	79	31	149	2288	0	2547
3562	53	14	2284	174	0	2525
3563	42	11	2397	68	0	2518
3564	45	14	2433	32	0	2524
3565	30	13	210	2292	0	2545
3566	32	16	2304	169	0	2521
3567	36	15	2412	65	0	2528
3568	35	17	202	2299	0	2553
3569	2289	22	83	174	0	2568
3570	183	13	2276	71	0	2543
3571	86	8	173	2274	0	2541
3572	56	11	73	2444	0	2584
3573	38	21	2313	208	0	2580
3574	24	12	189	2357	0	2582
3575	37	19	2276	203	0	2535
3576	48	24	185	2297	0	2554
3577	33	34	75	2394	0	2536
3578	41	32	28	2454	0	2555
3579	34	26	31	2470	0	2561
3580	2222	22	30	250	0	2524
3581	2388	7	36	114	0	2545
3582	223	12	2150	66	0	2451
3583	105	2139	164	64	0	2472
3584	71	136	2242	49	0	2498
3585	40	42	2344	54	0	2480
3586	2238	18	232	48	0	2536
3587	177	2204	103	45	0	2529
3588	2258	143	81	40	0	2522
3589	179	2288	66	51	0	2584
3590	2324	175	60	37	0	2596
3591	2429	55	64	46	0	2594
3592	221	27	57	2237	0	2542
3593	88	2266	49	188	0	2591
3594	65	155	43	2302	0	2565
3595	58	55	37	2464	0	2614
3596	39	40	2212	243	0	2534
3597	49	2275	174	100	0	2598
3598	35	162	72	2330	0	2599
3599	2126	58	59	204	0	2447
3600	2360	37	53	100	0	2550
3601	2406	22	45	82	0	2555
3602	212	2240	45	82	0	2579
3603	2309	159	43	67	0	2578
3604	202	2333	38	68	0	2641
3605	92	174	29	2445	0	2740
3606	72	68	2320	182	0	2642
3607	69	40	171	2386	0	2666
3608	50	2368	95	182	0	2695
3609	47	169	69	2395	0	2680
3610	41	65	55	2491	0	2652
3611	42	2422	48	220	0	2732
3612	2443	182	40	101	0	2766
3613	203	72	35	2445	0	2755
3614	96	56	2331	207	0	2690
3615	58	54	174	2440	0	2726
3616	54	27	51	2617	0	2749
3617	41	39	2349	248	0	2677
3618	48	26	166	2302	0	2542
3619	45	2355	69	222	0	2691
3620	28	173	2346	114	0	2661
3621	37	69	2466	79	0	2651
3622	37	2317	214	76	0	2644
3623	41	2413	96	53	0	2603
3624	28	1096	22	25	0	1171
3625	991	98	19	23	0	1131
3626	1036	30	14	23	0	1103
3627	1059	19	20	14	0	1112
3628	109	18	15	988	0	1130
3629	33	16	969	97	0	1115
3630	21	16	86	991	0	1114
3631	11	17	30	1069	0	1127
3632	975	22	15	119	0	1131
3633	1034	11	18	47	0	1110
3634	89	976	19	31	0	1115
3635	992	85	18	26	0	1121
3636	1051	31	13	28	0	1123
3637	1063	16	14	30	0	1123
3638	104	16	963	23	0	1106
3639	34	13	1009	33	0	1089
3640	27	13	90	985	0	1115
3641	23	16	957	105	0	1101
3642	968	20	83	39	0	1110
3643	1043	16	31	30	0	1120
3644	107	21	978	25	0	1131
3645	457	0	8	1	0	466
3646	9	452	2	2	0	465
3647	466	8	1	0	0	475
3648	10	1	0	464	0	475
3649	1	1	2	460	0	464
3650	3	461	0	11	0	475
3651	461	9	0	3	0	473
3652	467	1	0	3	0	471
3653	8	463	1	1	0	473
3654	2	9	0	441	0	452
3655	2	2	0	442	0	446
3656	2	442	0	8	0	452
3657	4	8	0	443	0	455
3658	0	1	1	450	0	452
3659	439	1	1	10	0	451
3660	445	0	0	5	0	450
3661	9	1	433	2	0	445
3662	433	0	8	1	0	442
3663	10	0	432	1	0	443
3664	2	2	10	430	0	444
3665	3	1	436	7	0	447
3666	0	424	9	1	0	434
3667	1	9	1	427	0	438
3668	0	1	2	437	0	440
3669	426	1	1	8	0	436
3670	7	1	1	418	0	427
3671	3	2	416	6	0	427
3672	418	0	5	3	0	426
3673	418	1	1	4	0	424
3674	422	0	2	1	0	425
3675	417	0	0	3	0	420
3676	8	1	1	429	0	439
3677	4	0	1	447	0	452
3678	2	0	0	475	0	477
3679	1	1	0	483	0	485
3680	475	0	1	9	0	485
3681	478	0	1	4	0	483
3682	9	1	0	446	0	456
3683	2	450	3	10	0	465
3684	453	8	4	3	0	468
3685	9	2	450	3	0	464
3686	3	451	8	0	0	462
3687	434	7	1	1	0	443
3688	8	434	1	2	0	445
3689	4	9	422	0	0	435
3690	421	1	9	1	0	432
3691	417	3	3	1	0	424
3692	10	2	408	0	0	420
3693	4	2	7	403	0	416
3694	2	2	2	411	0	417
3695	4	407	2	8	0	421
3696	5	7	0	407	0	419
3697	399	2	1	10	0	412
3698	8	400	1	4	0	413
3699	2	8	0	391	0	401
3700	3	2	0	404	0	409
3701	1	4	383	10	0	398
3702	2	385	9	5	0	401
3703	348	9	1	4	0	362
3704	7	278	2	1	0	288
3705	2	246	0	2	0	250
3706	240	6	0	1	0	247
3707	6	2	0	237	0	245
3708	2	2	1	242	0	247
3709	240	1	2	6	0	249
3710	6	2	0	245	0	253
3711	3	1	0	249	0	253
3712	241	0	1	7	0	249
3713	5	0	0	243	0	248
3714	2	232	1	6	0	241
3715	239	5	0	2	0	246
3716	5	2	235	3	0	245
3717	5	225	5	1	0	236
3718	2	6	0	213	0	221
3719	0	3	206	8	0	217
3720	1	3	208	2	0	214
3721	2	6	4	186	0	198
3722	183	3	2	3	0	191
3723	3	2	0	182	0	187
3724	0	0	0	178	0	178
3725	0	0	2	180	0	182
3726	0	0	2	180	0	182
3727	0	0	0	182	0	182
3728	2	0	171	3	0	176
3729	0	0	167	2	0	169
3730	0	0	3	166	0	169
3731	0	0	162	5	0	167
3732	0	165	2	2	0	169
3733	0	3	0	169	0	172
3734	0	0	164	3	0	167
3735	150	1	5	0	0	156
3736	3	153	0	2	0	158
3737	0	160	2	0	0	162
3738	1	165	0	0	0	166
3739	0	4	0	159	0	163
3740	159	0	2	2	0	163
3741	5	0	0	161	0	166
3742	153	2	0	2	0	157
3743	3	149	0	0	0	152
3744	151	5	0	0	0	156
3745	3	0	0	155	0	158
3746	2	0	0	157	0	159
3747	0	151	0	5	0	156
3748	0	3	0	153	0	156
3749	0	2	0	154	0	156
3750	2	0	0	153	0	155
3751	152	0	0	5	0	157
3752	152	0	0	1	0	153
3753	3	1	147	0	0	151
3754	145	0	3	2	0	150
3755	3	0	149	2	0	154
3756	0	0	3	146	0	149
3757	2	0	0	148	0	150
3758	2	0	0	147	0	149
3759	2	0	142	2	0	146
3760	1	0	3	143	0	147
3761	0	0	145	3	0	148
3762	0	0	3	137	0	140
3763	133	0	0	5	0	138
3764	3	0	130	2	0	135
3765	127	0	3	0	0	130
3766	3	0	0	132	0	135
3767	128	0	2	3	0	133
3768	0	130	0	2	0	132
3769	2	3	0	131	0	136
3770	0	0	138	3	0	141
3771	2	0	3	138	0	143
3772	0	2	0	141	0	143
3773	2	131	0	2	0	135
3774	0	4	131	0	0	135
3775	0	132	3	2	0	137
3776	112	1	4	0	0	117
3777	2	105	0	1	0	108
3778	78	0	2	1	0	81
3779	75	1	0	0	0	76
3780	70	0	1	0	0	71
3781	0	1	0	70	0	71
3782	1	0	79	0	0	80
3783	0	1	0	77	0	78
3784	1	76	0	0	0	77
3785	0	0	0	79	0	79
3786	75	0	0	0	0	75
3787	0	76	0	1	0	77
3788	0	0	1	76	0	77
3789	0	0	0	77	0	77
3790	76	1	0	0	0	77
3791	0	0	72	1	0	73
3792	1	71	0	0	0	72
3793	0	1	0	68	0	69
3794	0	0	62	1	0	63
3795	0	0	0	60	0	60
3796	1	56	0	0	0	57
3797	0	0	0	60	0	60
3798	0	1	0	60	0	61
3799	0	0	0	61	0	61
3800	0	0	57	0	0	57
3801	55	0	0	1	0	56
3802	0	0	0	59	0	59
3803	59	0	0	1	0	60
3804	69	0	0	1	0	70
3805	72	0	0	1	0	73
3806	71	0	1	0	0	72
3807	73	0	0	0	0	73
3808	0	0	0	74	0	74
3809	1	71	0	0	0	72
3810	1	0	0	69	0	70
3811	1	68	0	0	0	69
3812	0	0	0	66	0	66
3813	66	0	0	0	0	66
3814	0	0	0	65	0	65
3815	0	0	68	0	0	68
3816	67	0	0	0	0	67
3817	0	68	0	0	0	68
3818	67	0	0	0	0	67
3819	66	0	1	0	0	67
3820	66	0	0	0	0	66
3821	0	69	0	0	0	69
3822	0	0	0	69	0	69
3823	0	0	0	68	0	68
3824	0	0	69	0	0	69
3825	0	0	0	67	0	67
3826	0	0	0	69	0	69
3827	0	0	0	70	0	70
3828	1	69	0	0	0	70
3829	71	0	0	0	0	71
3830	68	0	0	0	0	68
3831	1	0	71	0	0	72
3832	0	71	0	1	0	72
3833	0	1	0	69	0	70
3834	0	0	0	69	0	69
3835	0	1	0	68	0	69
3836	0	0	0	71	0	71
3837	1	0	0	72	0	73
3838	0	0	71	0	0	71
3839	0	0	71	0	0	71
3840	77	0	0	0	0	77
3841	80	1	0	0	0	81
3842	80	0	0	0	0	80
3843	1	0	0	82	0	83
3844	1	0	80	0	0	81
3845	79	1	0	0	0	80
3846	79	0	0	1	0	80
3847	0	0	78	1	0	79
3848	78	0	1	0	0	79
3849	0	0	87	0	0	87
3850	0	0	0	86	0	86
3851	0	0	87	1	0	88
3852	86	1	0	0	0	87
3853	89	0	0	0	0	89
3854	88	0	0	0	0	88
3855	90	0	1	0	0	91
3856	0	1	91	0	0	92
3857	0	91	0	1	0	92
3858	92	0	0	0	0	92
3859	90	0	0	1	0	91
3860	0	0	88	1	0	89
3861	0	0	0	89	0	89
3862	0	0	1	90	0	91
3863	0	0	84	0	0	84
3864	82	0	0	0	0	82
3865	90	0	0	0	0	90
3866	1	93	0	0	0	94
3867	103	0	0	1	0	104
3868	102	0	1	0	0	103
3869	103	0	0	0	0	103
3870	96	0	0	0	0	96
3871	0	0	95	0	0	95
3872	89	0	0	0	0	89
3873	0	1	1	89	0	91
3874	0	94	0	1	0	95
3875	0	0	94	0	0	94
3876	1	97	0	0	0	98
3877	1	3	0	89	0	93
3878	1	0	90	0	0	91
3879	86	0	0	0	0	86
3880	0	0	88	0	0	88
3881	85	1	0	0	0	86
3882	0	0	0	80	0	80
3883	1	0	0	79	0	80
3884	0	79	1	0	0	80
3885	0	84	0	1	0	85
3886	0	0	0	86	0	86
3887	84	1	1	0	0	86
3888	83	0	0	0	0	83
3889	83	0	0	0	0	83
3890	0	1	79	0	0	80
3891	82	0	0	0	0	82
3892	1	0	86	0	0	87
3893	1	0	82	0	0	83
3894	87	0	0	0	0	87
3895	90	0	1	0	0	91
3896	2	0	92	0	0	94
3897	0	0	1	92	0	93
3898	0	1	0	92	0	93
3899	92	0	0	1	0	93
3900	89	0	0	0	0	89
3901	1	0	92	1	0	94
3902	0	87	2	0	0	89
3903	1	89	0	0	0	90
3904	80	1	0	0	0	81
3905	1	0	0	79	0	80
3906	0	0	0	81	0	81
3907	0	0	0	85	0	85
3908	75	0	0	1	0	76
3909	1	0	0	85	0	86
3910	85	0	0	1	0	86
3911	85	0	0	0	0	85
3912	1	1578	6	0	0	1585
3913	2	4	0	2917	0	2923
3914	2	7	2856	78	0	2943
3915	2833	0	80	32	0	2945
3916	2979	0	36	22	0	3037
3917	3065	2	23	18	0	3108
3918	149	3	2903	19	0	3074
3919	79	0	93	2929	0	3101
3920	3048	0	46	83	0	3177
3921	3003	1	29	40	0	3073
3922	2998	2	22	28	0	3050
3923	150	2812	28	22	0	3012
3924	84	2960	13	26	0	3083
3925	68	112	6	2981	0	3167
3926	53	60	4	2934	0	3051
3927	32	2919	4	113	0	3068
3928	3020	101	3	61	0	3185
3929	99	54	2922	38	0	3113
3930	52	34	84	2940	0	3110
3931	30	21	38	3042	0	3131
3932	23	28	2923	125	0	3099
3933	2813	12	102	71	0	2998
3934	3058	3	57	50	0	3168
3935	128	2895	37	43	0	3103
3936	3094	82	25	34	0	3235
3937	135	43	2930	28	0	3136
3938	3026	26	104	13	0	3169
3939	160	19	2968	13	0	3160
3940	3009	17	107	12	0	3145
3941	3144	15	66	3	0	3228
3942	3143	9	51	11	0	3214
3943	3125	10	35	23	0	3193
3944	193	2887	32	16	0	3128
3945	3163	83	27	8	0	3281
3946	3216	42	11	10	0	3279
3947	201	38	2899	5	0	3143
3948	3070	27	88	13	0	3198
3949	165	31	43	3024	0	3263
3950	111	24	2900	102	0	3137
3951	3047	16	98	44	0	3205
3952	145	13	60	3048	0	3266
3953	3123	21	47	110	0	3301
3954	3173	19	23	77	0	3292
3955	164	10	2943	61	0	3178
3956	3091	9	110	38	0	3248
3957	3207	14	49	34	0	3304
3958	3208	11	39	25	0	3283
3959	3218	12	37	17	0	3284
3960	211	10	29	2935	0	3185
3961	139	2908	31	98	0	3176
3962	3046	85	29	42	0	3202
3963	3170	39	28	30	0	3267
3964	3204	32	18	29	0	3283
3965	221	29	2919	24	0	3193
3966	142	2897	100	23	0	3162
3967	121	84	56	3047	0	3308
3968	101	56	53	3130	0	3340
3969	110	45	3021	125	0	3301
3970	106	26	110	3050	0	3292
3971	86	33	3041	135	0	3295
3972	72	26	133	3056	0	3287
3973	59	16	73	3204	0	3352
3974	56	25	3030	177	0	3288
3975	2985	21	121	101	0	3228
3976	3184	16	79	81	0	3360
3977	178	27	2999	63	0	3267
3978	3050	33	122	58	0	3263
3979	3168	11	82	66	0	3327
3980	214	14	3049	39	0	3316
3981	169	28	114	2960	0	3271
3982	137	13	78	3078	0	3306
3983	3143	10	71	138	0	3362
3984	181	2974	44	102	0	3301
3985	2932	99	57	76	0	3164
3986	3117	54	45	57	0	3273
3987	222	3006	24	47	0	3299
3988	3194	120	22	26	0	3362
3989	3132	80	25	24	0	3261
3990	203	3012	24	36	0	3275
3991	140	117	26	2995	0	3278
3992	113	3045	35	97	0	3290
3993	115	122	32	3086	0	3355
3994	108	57	2986	129	0	3280
3995	83	65	2945	71	0	3164
3996	2864	33	136	74	0	3107
3997	3074	36	79	72	0	3261
3998	177	33	2991	51	0	3252
3999	3011	19	133	33	0	3196
4000	3147	11	96	41	0	3295
4001	3160	8	83	32	0	3283
4002	243	2900	48	38	0	3229
4003	146	86	57	3059	0	3348
4004	3115	39	59	104	0	3317
4005	3189	30	27	67	0	3313
4006	230	17	2967	65	0	3279
4007	153	27	98	2979	0	3257
4008	132	31	55	3039	0	3257
4009	115	2872	45	142	0	3174
4010	103	2927	43	76	0	3149
4011	81	2601	36	406	0	3124
4012	95	1696	22	66	0	1879
4013	308	1	0	1	0	310
4014	1	329	0	0	0	330
4015	331	2	0	0	0	333
4016	2	2	344	0	0	348
4017	370	0	2	1	0	373
4018	388	0	1	0	0	389
4019	383	0	0	0	0	383
4020	381	0	0	0	0	381
4021	4	377	0	1	0	382
4022	1	2	0	386	0	389
4023	1	1	0	394	0	396
4024	0	1	397	3	0	401
4025	0	0	2	396	0	398
4026	0	0	1	398	0	399
4027	398	0	0	3	0	401
4028	2	394	0	2	0	398
4029	1	2	0	398	0	401
4030	2	1	0	394	0	397
4031	0	1	0	399	0	400
4032	399	0	0	4	0	403
4033	2	0	0	401	0	403
4034	404	0	0	3	0	407
4035	3	0	0	403	0	406
4036	1	0	0	406	0	407
4037	1	0	384	3	0	388
4038	376	1	2	2	0	381
4039	3	381	2	1	0	387
4040	401	2	1	0	0	404
4041	4	1	0	395	0	400
4042	2	1	0	401	0	404
4043	402	0	0	3	0	405
4044	399	0	0	2	0	401
4045	3	1	0	419	0	423
4046	2	0	432	3	0	437
4047	1	1	421	5	0	428
4048	0	450	4	1	0	455
4049	456	3	2	1	0	462
4050	450	2	1	1	0	454
4051	6	1	0	457	0	464
4052	3	467	0	2	0	472
4053	1	2	0	467	0	470
4054	0	2	0	452	0	454
4055	0	436	0	8	0	444
4056	436	3	0	3	0	442
4057	3	2	0	431	0	436
4058	3	443	1	3	0	450
4059	1	444	0	4	0	449
4060	445	4	0	2	0	451
4061	3	3	451	0	0	457
4062	451	2	3	0	0	456
4063	5	1	2	449	0	457
4064	3	0	1	450	0	454
4065	1	453	0	6	0	460
4066	0	6	0	458	0	464
4067	1	4	455	4	0	464
4068	2	448	3	2	0	455
4069	1	452	2	2	0	457
4070	448	3	1	0	0	452
4071	2	448	0	0	0	450
4072	2	5	0	452	0	459
4073	3	445	0	3	0	451
4074	2	3	1	443	0	449
4075	0	1	0	454	0	455
4076	0	3	439	6	0	448
4077	1	0	3	439	0	443
4078	0	1	2	441	0	444
4079	439	2	0	5	0	446
4080	5	1	447	4	0	457
4081	2	0	3	465	0	470
4082	2	2	470	2	0	476
4083	464	2	3	3	0	472
4084	6	485	3	2	0	496
4085	499	2	3	1	0	505
4086	6	2	0	510	0	518
4087	2	2	0	523	0	527
4088	3	0	515	8	0	526
4089	495	2	5	3	0	505
4090	4	522	1	4	0	531
4091	499	5	3	1	0	508
4092	5	4	0	521	0	530
4093	3	541	0	6	0	550
4094	538	5	1	3	0	547
4095	4	545	0	3	0	552
4096	1	5	1	547	0	554
4097	2	5	1	534	0	542
4098	1	9	0	530	0	540
4099	1	518	0	10	0	529
4100	1	5	2	529	0	537
4101	0	1	0	528	0	529
4102	503	1	0	9	0	513
4103	504	1	0	5	0	510
4104	503	0	2	3	0	508
4105	7	1	507	4	0	519
4106	500	0	7	3	0	510
4107	511	1	3	3	0	518
4108	510	3	3	1	0	517
4109	11	3	494	0	0	508
4110	494	2	5	3	0	504
4111	8	2	1	501	0	512
4112	3	0	511	6	0	520
4113	4	521	5	3	0	533
4114	2	13	3	500	0	518
4115	2	503	1	4	0	510
4116	0	498	2	5	0	505
4117	461	7	6	2	0	476
4118	5	1	1	464	0	471
4119	463	4	0	5	0	472
4120	4	0	1	469	0	474
4121	465	0	0	6	0	471
4122	5	1	1	468	0	475
4123	469	1	0	5	0	475
4124	5	0	448	3	0	456
4125	1	4	5	456	0	466
4126	2	1	469	4	0	476
4127	3	2	462	1	0	468
4128	2	0	477	4	0	483
4129	0	0	7	478	0	485
4130	2	0	475	5	0	482
4131	482	1	4	2	0	489
4132	4	1	2	482	0	489
4133	2	3	711	5	0	721
4134	2	0	4	738	0	744
4135	1	2	1	761	0	765
4136	2	1	778	7	0	788
4137	1	2	9	770	0	782
4138	1	0	1	776	0	778
4139	2	778	0	5	0	785
4140	794	4	1	1	0	800
4141	798	1	1	1	0	801
4142	6	1	780	3	0	790
4143	772	0	4	2	0	778
4144	4	1	772	1	0	778
4145	3	3	762	1	0	769
4146	3	0	751	2	0	756
4147	1	8	9	742	0	760
4148	0	2	749	4	0	755
4149	1	0	3	751	0	755
4150	0	1	1	757	0	759
4151	2	1	0	762	0	765
4152	0	0	0	768	0	768
4153	769	0	1	4	0	774
4154	757	0	0	2	0	759
4155	5	766	1	2	0	774
4156	1	2	2	780	0	785
4157	0	0	772	4	0	776
4158	1	786	4	2	0	793
4159	1	3	1	824	0	829
4160	2	0	822	3	0	827
4161	1	1	4	797	0	803
4162	2	0	820	4	0	826
4163	2	2	796	1	0	801
4164	0	1	5	834	0	840
4165	0	1	3	843	0	847
4166	855	0	2	6	0	863
4167	3	1	1	856	0	861
4168	850	3	3	5	0	861
4169	6	847	1	2	0	856
4170	0	850	1	4	0	855
4171	3	5	0	1078	0	1086
4172	1073	1	1	9	0	1084
4173	8	1085	3	2	0	1098
4174	1	6	0	1117	0	1124
4175	1136	0	0	7	0	1143
4176	1134	2	1	1	0	1138
4177	1124	0	1	4	0	1129
4178	1125	1	1	1	0	1128
4179	1133	1	1	1	0	1136
4180	8	1	1097	0	0	1106
4181	3	0	1068	3	0	1074
4182	3	1066	9	1	0	1079
4183	2	9	7	1087	0	1105
4184	0	2	1079	7	0	1088
4185	1	2	1074	3	0	1080
4186	6	8	6	1114	0	1134
4187	3	2	1137	5	0	1147
4188	3	3	1142	1	0	1149
4189	2	1323	7	2	0	1334
4190	1396	10	3	2	0	1411
4191	14	1498	4	2	0	1518
4192	4	18	1	1540	0	1563
4193	1547	2	1	13	0	1563
4194	16	1546	1	5	0	1568
4195	6	14	3	1568	0	1591
4196	4	7	1567	13	0	1591
4197	1569	4	15	3	0	1591
4198	1592	2	6	5	0	1605
4199	1614	1	7	2	0	1624
4200	22	2	3	1608	0	1635
4201	7	1	1578	15	0	1601
4202	7	1580	13	7	0	1607
4203	2	12	5	1620	0	1639
4204	1611	4	6	14	0	1635
4205	17	7	1588	4	0	1616
4206	4	1540	18	6	0	1568
4207	4	14	1597	5	0	1620
4208	1574	2	19	2	0	1597
4209	1619	7	4	0	0	1630
4210	1631	3	5	8	0	1647
4211	22	1	1583	6	0	1612
4212	10	1547	19	4	0	1580
4213	9	17	4	1575	0	1605
4214	6	4	4	1577	0	1591
4215	4	3	3	1585	0	1595
4216	2	5	1537	23	0	1567
4217	1501	3	17	7	0	1528
4218	17	4	1547	9	0	1577
4219	1551	1	17	4	0	1573
4220	1581	3	7	1	0	1592
4221	1576	5	6	1	0	1588
4222	1562	2	1	6	0	1571
4223	26	2	1531	2	0	1561
4224	8	3	17	1547	0	1575
4225	6	4	1514	23	0	1547
4226	5	1492	20	9	0	1526
4227	6	1533	6	8	0	1553
4228	1543	17	5	5	0	1570
4229	1539	6	1	3	0	1549
4230	25	1529	3	8	0	1565
4231	1563	15	7	3	0	1588
4232	26	6	1493	5	0	1530
4233	1304	5	15	3	0	1327
4234	23	1302	7	6	0	1338
4235	1343	14	10	5	0	1372
4236	1336	6	4	2	0	1348
4237	21	8	4	1309	0	1342
4238	9	2	4	1331	0	1346
4239	1312	0	5	23	0	1340
4240	22	3	2	1319	0	1346
4241	1307	5	7	17	0	1336
4242	23	9	2	1306	0	1340
4243	1300	1	4	22	0	1327
4244	1297	2	4	4	0	1307
4245	25	1270	3	5	0	1303
4246	17	1289	2	5	0	1313
4247	1255	15	7	6	0	1283
4248	20	1252	8	6	0	1286
4249	10	23	2	1256	0	1291
4250	12	7	3	1266	0	1288
4251	1230	5	3	22	0	1260
4252	22	1219	6	11	0	1258
4253	11	1211	4	9	0	1235
4254	13	1204	7	8	0	1232
4255	9	24	1191	4	0	1228
4256	12	10	1201	5	0	1228
4257	9	7	1213	5	0	1234
4258	7	12	24	1097	0	1140
4259	7	1148	9	14	0	1178
4260	1164	17	3	10	0	1194
4261	22	6	1153	9	0	1190
4262	12	5	1149	7	0	1173
4263	11	6	1147	6	0	1170
4264	12	3	21	1131	0	1167
4265	7	3	8	1149	0	1167
4266	10	3	6	1147	0	1166
4267	1135	5	1	21	0	1162
4268	1134	3	4	7	0	1148
4269	1121	8	0	3	0	1132
4270	20	7	7	1098	0	1132
4271	10	1	873	14	0	898
4272	5	1	878	6	0	890
4273	7	2	13	870	0	892
4274	6	5	5	862	0	878
4275	844	2	6	11	0	863
4276	19	836	2	5	0	862
4277	838	13	2	3	0	856
4278	17	832	2	5	0	856
4279	7	11	4	838	0	860
4280	7	4	831	15	0	857
4281	3	3	14	835	0	855
4282	844	3	4	14	0	865
4283	19	2	823	4	0	848
4284	823	3	11	4	0	841
4285	17	4	802	5	0	828
4286	10	1	763	1	0	775
4287	709	1	21	4	0	735
4288	13	3	707	4	0	727
4289	4	2	478	5	0	489
4290	8	445	10	5	0	468
4291	339	6	16	4	0	365
4292	298	2	6	0	0	306
4293	295	2	0	0	0	297
4294	4	0	278	0	0	282
4295	276	1	2	0	0	279
4296	2	276	1	1	0	280
4297	275	2	0	1	0	278
4298	2	1	274	0	0	277
4299	6	2	2	263	0	273
4300	0	0	261	2	0	263
4301	0	256	2	1	0	259
4302	1	1	1	242	0	245
4303	0	0	0	247	0	247
4304	251	0	0	0	0	251
4305	252	0	0	0	0	252
4306	250	0	0	0	0	250
4307	252	0	0	0	0	252
4308	246	0	0	0	0	246
4309	0	0	245	0	0	245
4310	0	0	0	249	0	249
4311	0	0	255	0	0	255
4312	0	0	0	253	0	253
4313	255	0	0	0	0	255
4314	254	0	0	0	0	254
4315	253	0	0	0	0	253
4316	255	0	0	0	0	255
4317	0	0	263	0	0	263
4318	0	0	0	264	0	264
4319	0	0	259	1	0	260
4320	0	272	0	0	0	272
4321	0	274	0	0	0	274
4322	0	0	0	278	0	278
4323	0	0	0	294	0	294
4324	0	1	0	315	0	316
4325	0	0	0	325	0	325
4326	318	0	0	1	0	319
4327	1	314	0	0	0	315
4328	302	1	0	0	0	303
4329	1	0	0	303	0	304
4330	0	0	0	296	0	296
4331	0	301	0	1	0	302
4332	0	1	0	297	0	298
4333	299	0	0	1	0	300
4334	1	290	0	0	0	291
4335	0	262	0	0	0	262
4336	262	1	0	0	0	263
4337	1	0	0	259	0	260
4338	0	254	0	3	0	257
4339	0	1	0	263	0	264
4340	266	0	0	1	0	267
4341	1	0	0	263	0	264
4342	0	0	0	266	0	266
4343	264	0	0	1	0	265
4344	1	0	0	263	0	264
4345	0	270	0	1	0	271
4346	0	1	0	271	0	272
4347	0	264	0	1	0	265
4348	0	1	0	277	0	278
4349	277	0	0	1	0	278
4350	273	0	0	0	0	273
4351	1	0	0	278	0	279
4352	0	0	272	1	0	273
4353	271	0	1	0	0	272
4354	1	0	271	0	0	272
4355	268	0	1	0	0	269
4356	272	0	0	0	0	272
4357	1	0	262	0	0	263
4358	0	259	1	0	0	260
4359	263	1	0	0	0	264
4360	266	0	0	0	0	266
4361	1	0	273	0	0	274
4362	271	0	1	0	0	272
4363	268	0	0	0	0	268
4364	266	0	0	1	0	267
4365	2	0	0	269	0	271
4366	0	1	0	266	0	267
4367	1	266	0	1	0	268
4368	0	1	0	266	0	267
4369	0	0	0	271	0	271
4370	0	1	264	1	0	266
4371	0	0	255	1	0	256
4372	245	0	1	0	0	246
4373	252	1	0	0	0	253
4374	1	247	0	0	0	248
4375	1	1	0	252	0	254
4376	0	0	265	2	0	267
4377	0	0	1	268	0	269
4378	0	0	0	274	0	274
4379	1	0	0	271	0	272
4380	0	269	0	1	0	270
4381	0	1	0	280	0	281
4382	1	0	0	281	0	282
4383	0	0	282	2	0	284
4384	2	1	272	0	0	275
4385	271	0	1	1	0	273
4386	278	1	0	0	0	279
4387	1	0	0	289	0	290
4388	1	0	0	284	0	285
4389	1	0	0	293	0	294
4390	0	0	275	5	0	280
4391	0	271	3	1	0	275
4392	1	4	271	0	0	276
4393	267	0	5	0	0	272
4394	5	0	273	0	0	278
4395	274	0	4	0	0	278
4396	275	0	1	0	0	276
4397	271	1	0	0	0	272
4398	5	0	0	265	0	270
4399	2	0	266	4	0	272
4400	0	271	4	0	0	275
4401	1	4	0	268	0	273
4402	1	0	0	272	0	273
4403	1	0	267	3	0	271
4404	0	258	5	2	0	265
4405	273	6	0	0	0	279
4406	7	282	0	0	0	289
4407	307	7	0	1	0	315
4408	7	0	0	317	0	324
4409	0	0	318	7	0	325
4410	0	319	7	0	0	326
4411	327	8	0	0	0	335
4412	8	0	334	0	0	342
4413	338	1	5	0	0	344
4414	347	0	0	1	0	348
4415	9	0	343	0	0	352
4416	338	0	8	1	0	347
4417	341	0	0	1	0	342
4418	331	0	0	0	0	331
4419	8	325	0	0	0	333
4420	312	8	0	1	0	321
4421	8	324	1	1	0	334
4422	1	8	318	1	0	328
4423	1	315	7	1	0	324
4424	289	7	4	1	0	301
4425	292	0	1	0	0	293
4426	294	1	0	0	0	295
4427	8	1	1	286	0	296
4428	1	1	0	287	0	289
4429	279	0	0	7	0	286
4430	291	1	0	0	0	292
4431	8	0	1	276	0	285
4432	1	1	274	7	0	283
4433	1	271	6	1	0	279
4434	1	278	1	0	0	280
4435	1	8	0	273	0	282
4436	0	0	270	8	0	278
4437	0	0	5	269	0	274
4438	1	275	1	6	0	283
4439	0	8	0	273	0	281
4440	1	0	266	7	0	274
4441	0	1	7	268	0	276
4442	1	1	287	7	0	296
4443	0	1	6	290	0	297
4444	0	0	295	8	0	303
4445	0	2	293	0	0	295
4446	290	0	7	1	0	298
4447	302	1	1	0	0	304
4448	297	0	0	1	0	298
4449	9	291	0	0	0	300
4450	0	8	0	292	0	300
4451	289	0	1	9	0	299
4452	298	0	0	1	0	299
4453	297	0	1	0	0	298
4454	8	1	284	0	0	293
4455	2	284	6	2	0	294
4456	1	298	0	0	0	299
4457	290	8	1	0	0	299
4458	8	2	0	290	0	300
4459	285	0	0	9	0	294
4460	10	0	284	0	0	294
4461	2	0	6	278	0	286
4462	1	0	0	287	0	288
4463	0	1	1	285	0	287
4464	1	288	0	8	0	297
4465	284	9	0	0	0	293
4466	294	0	0	2	0	296
4467	8	285	1	1	0	295
4468	1	9	0	288	0	298
4469	283	1	0	8	0	292
4470	8	0	0	285	0	293
4471	281	0	1	9	0	291
4472	7	286	0	1	0	294
4473	282	10	0	0	0	292
4474	9	0	280	1	0	290
4475	1	286	6	0	0	293
4476	0	7	272	1	0	280
4477	1	2	10	263	0	276
4478	259	1	0	10	0	270
4479	265	0	1	1	0	267
4480	262	0	1	0	0	263
4481	9	1	0	252	0	262
4482	253	0	0	8	0	261
4483	9	2	0	246	0	257
4484	247	3	0	7	0	257
4485	256	0	2	1	0	259
4486	9	0	251	1	0	261
4487	3	0	236	1	0	240
4488	1	0	244	0	0	245
4489	1	0	5	226	0	232
4490	231	0	2	6	0	239
4491	6	0	0	229	0	235
4492	0	0	0	243	0	243
4493	245	0	0	5	0	250
4494	244	0	0	0	0	244
4495	245	0	1	0	0	246
4496	253	0	1	0	0	254
4497	5	0	1	248	0	254
4498	244	0	0	6	0	250
4499	4	238	0	0	0	242
4500	235	5	0	1	0	241
4501	242	0	0	1	0	243
4502	6	0	239	0	0	245
4503	227	0	2	0	0	229
4504	4	0	229	0	0	233
4505	1	0	201	0	0	202
4506	0	0	194	1	0	195
4507	1	2	7	156	0	166
4508	0	0	160	2	0	162
4509	2	4	0	149	0	155
4510	0	0	160	1	0	161
4511	0	0	182	0	0	182
4512	0	0	1	185	0	186
4513	0	1	0	195	0	196
4514	0	1	201	2	0	204
4515	199	0	2	0	0	201
4516	2	0	0	206	0	208
4517	0	0	0	207	0	207
4518	210	0	0	2	0	212
4519	2	0	0	210	0	212
4520	0	0	215	2	0	217
4521	0	1	206	0	0	207
4522	0	0	2	203	0	205
4523	0	0	226	2	0	228
4524	0	230	2	0	0	232
4525	0	2	0	235	0	237
4526	233	0	0	2	0	235
4527	2	0	240	0	0	242
4528	234	0	2	0	0	236
4529	2	0	0	252	0	254
4530	0	0	0	251	0	251
4531	0	0	0	254	0	254
4532	0	0	0	254	0	254
4533	256	0	0	2	0	258
4534	2	286	0	0	0	288
4535	0	2	0	291	0	293
4536	1	0	0	292	0	293
4537	0	0	0	288	0	288
4538	0	0	0	285	0	285
4539	286	0	0	2	0	288
4540	2	284	0	0	0	286
4541	284	2	0	0	0	286
4542	1	257	0	0	0	258
4543	0	261	0	0	0	261
4544	257	2	0	0	0	259
4545	4	0	257	0	0	261
4546	5	0	1	259	0	265
4547	264	0	0	1	0	265
4548	269	0	0	0	0	269
4549	265	0	0	0	0	265
4550	269	0	0	0	0	269
4551	1	280	0	0	0	281
4552	291	1	0	0	0	292
4553	296	0	0	0	0	296
4554	2	315	0	0	0	317
4555	1	1	0	328	0	330
4556	0	1	324	1	0	326
4557	0	0	1	331	0	332
4558	336	0	1	1	0	338
4559	1	0	336	1	0	338
4560	1	329	1	0	0	331
4561	0	2	334	0	0	336
4562	0	1	1	322	0	324
4563	0	328	2	1	0	331
4564	336	1	0	1	0	338
4565	1	348	0	0	0	349
4566	1	1	0	349	0	351
4567	0	1	0	354	0	355
4568	350	0	0	2	0	352
4569	2	0	0	347	0	349
4570	1	347	0	1	0	349
4571	350	2	0	1	0	353
4572	352	1	1	0	0	354
4573	2	355	0	1	0	358
4574	353	2	0	0	0	355
4575	2	350	0	0	0	352
4576	352	2	0	0	0	354
4577	1	345	0	1	0	347
4578	1	1	0	343	0	345
4579	1	1	0	350	0	352
4580	356	0	0	3	0	359
4581	356	1	0	1	0	358
4582	4	350	0	1	0	355
4583	2	2	345	0	0	349
4584	351	2	1	0	0	354
4585	2	0	1	354	0	357
4586	1	350	0	1	0	352
4587	0	1	0	357	0	358
4588	354	2	0	1	0	357
4589	359	0	0	2	0	361
4590	363	0	0	2	0	365
4591	4	0	0	370	0	374
4592	2	0	359	1	0	362
4593	359	1	1	1	0	362
4594	361	0	1	0	0	362
4595	365	0	0	0	0	365
4596	2	354	0	1	0	357
4597	1	2	0	363	0	366
4598	0	358	0	2	0	360
4599	1	1	0	372	0	374
4600	1	1	0	368	0	370
4601	0	1	378	2	0	381
4602	0	4	1	409	0	414
4603	0	0	2	423	0	425
4604	435	0	0	6	0	441
4605	6	436	0	1	0	443
4606	438	5	0	0	0	443
4607	464	2	0	0	0	466
4608	7	0	0	456	0	463
4609	4	1	452	6	0	463
4610	0	445	6	1	0	452
4611	0	423	1	1	0	425
4612	409	6	4	0	0	419
4613	5	404	0	1	0	410
4614	1	5	0	391	0	397
4615	0	1	0	405	0	406
4616	0	1	389	6	0	396
4617	1	0	389	1	0	391
4618	1	396	6	0	0	403
4619	0	5	0	400	0	405
4620	393	1	1	5	0	400
4621	5	0	0	396	0	401
4622	1	1	401	5	0	408
4623	2	0	5	392	0	399
4624	384	1	0	5	0	390
4625	387	0	0	2	0	389
4626	8	382	1	1	0	392
4627	375	5	1	0	0	381
4628	4	376	0	0	0	380
4629	371	6	0	0	0	377
4630	5	1	0	367	0	373
4631	2	0	369	5	0	376
4632	0	0	360	2	0	362
4633	0	1271	7	2	0	1280
4634	2	5	2	1306	0	1315
4635	1	1	0	1307	0	1309
4636	1319	0	0	6	0	1325
4637	1298	1	0	1	0	1300
4638	1308	0	0	0	0	1308
4639	6	3	0	1294	0	1303
4640	3	0	0	1309	0	1312
4641	1	0	0	1318	0	1319
4642	0	0	1290	7	0	1297
4643	0	5	1107	1	0	1113
4644	1253	2	6	0	0	1261
4645	1291	1	1	1	0	1294
4646	7	0	1283	1	0	1291
4647	1249	2	5	0	0	1256
4648	1267	0	1	1	0	1269
4649	7	0	1277	1	0	1285
4650	1	1276	5	2	0	1284
4651	0	6	6	1285	0	1297
4652	1	2	1275	6	0	1284
4653	0	1246	5	1	0	1252
4654	0	5	1	1261	0	1267
4655	1	1239	1	7	0	1248
4656	1	4	1176	0	0	1181
4657	0	2	1186	2	0	1190
4658	1	4	4	1206	0	1215
4659	1258	2	0	5	0	1265
4660	5	1	0	1255	0	1261
4661	1256	0	0	5	0	1261
4662	5	1	0	1249	0	1255
4663	1	0	1247	5	0	1253
4664	1183	0	5	1	0	1189
4665	5	1	1239	0	0	1245
4666	1239	0	5	0	0	1244
4667	5	1	0	1259	0	1265
4668	0	1244	0	5	0	1249
4669	0	5	0	1280	0	1285
4670	1	1244	0	6	0	1251
4671	1	5	0	1277	0	1283
4672	1	1261	0	2	0	1264
4673	1261	5	1	1	0	1268
4674	1240	0	1	1	0	1242
4675	1203	0	0	1	0	1204
4676	5	1	1236	0	0	1242
4677	0	0	6	1239	0	1245
4678	1	0	1257	6	0	1264
4679	1	1239	4	0	0	1244
4680	0	1236	0	1	0	1237
4681	1226	6	0	0	0	1232
4682	7	1	1233	0	0	1241
4683	0	1177	7	1	0	1185
4684	0	7	0	1249	0	1256
4685	1256	0	0	7	0	1263
4686	6	1235	1	1	0	1243
4687	1222	7	0	0	0	1229
4688	6	1	1222	1	0	1230
4689	0	0	6	1213	0	1219
4690	0	1	0	1248	0	1249
4691	0	0	1	1254	0	1255
4692	0	1229	0	7	0	1236
4693	1	7	0	1229	0	1237
4694	0	1	1231	8	0	1240
4695	1	0	5	1199	0	1205
4696	0	0	0	1266	0	1266
4697	0	0	1	1264	0	1265
4698	1	1246	0	6	0	1253
4699	0	7	1	1259	0	1267
4700	1	1	0	1260	0	1262
4701	0	1213	0	7	0	1220
4702	1176	5	0	0	0	1181
4703	4	1174	1	1	0	1180
4704	0	1156	0	0	0	1156
4705	0	3	0	1167	0	1170
4706	2	1	1107	3	0	1113
4707	980	0	2	1	0	983
4708	2	0	0	1116	0	1118
4709	0	1	1097	2	0	1100
4710	0	1106	2	0	0	1108
4711	2	2	0	1138	0	1142
4712	0	0	1109	3	0	1112
4713	0	0	3	1075	0	1078
4714	0	0	0	1107	0	1107
4715	1127	0	0	3	0	1130
4716	2	1104	0	1	0	1107
4717	1078	3	0	0	0	1081
4718	3	2	1073	0	0	1078
4719	0	1072	2	0	0	1074
4720	0	3	1091	0	0	1094
4721	0	0	3	1088	0	1091
4722	1132	0	0	4	0	1136
4723	3	0	0	1108	0	1111
4724	1122	0	0	2	0	1124
4725	1119	0	0	0	0	1119
4726	4	0	0	1091	0	1095
4727	0	2	1139	4	0	1145
4728	0	1	1071	0	0	1072
4729	0	0	3	1119	0	1122
4730	0	0	0	1134	0	1134
4731	1143	0	0	3	0	1146
4732	3	1	0	1150	0	1154
4733	0	239	0	2	0	241
4734	0	3	0	242	0	245
4735	0	0	0	245	0	245
4736	242	0	0	3	0	245
4737	3	248	0	0	0	251
4738	0	3	0	250	0	253
4739	0	0	0	253	0	253
4740	0	256	2	3	0	261
4741	0	3	0	256	0	259
4742	0	0	0	258	0	258
4743	0	249	0	2	0	251
4744	0	3	0	252	0	255
4745	0	0	0	254	0	254
4746	0	248	0	3	0	251
4747	0	3	0	251	0	254
4748	255	0	0	3	0	258
4749	256	0	0	0	0	256
4750	253	0	0	0	0	253
4751	250	0	0	0	0	250
4752	2	248	0	0	0	250
4753	235	2	0	0	0	237
4754	3	234	0	0	0	237
4755	0	230	0	0	0	230
4756	0	3	0	228	0	231
4757	0	1	240	3	0	244
4758	235	0	3	0	0	238
4759	253	0	0	0	0	253
4760	3	0	266	0	0	269
4761	265	0	3	0	0	268
4762	268	0	0	0	0	268
4763	3	255	0	0	0	258
4764	268	3	0	0	0	271
4765	3	0	0	252	0	255
4766	0	0	0	252	0	252
4767	0	1	0	254	0	255
4768	0	0	1	257	0	258
4769	250	0	0	4	0	254
4770	3	1	0	244	0	248
4771	0	0	0	252	0	252
4772	0	1	249	4	0	254
4773	233	1	2	0	0	236
4774	249	0	0	1	0	250
4775	255	0	0	1	0	256
4776	3	249	0	0	0	252
4777	0	247	0	1	0	248
4778	250	2	0	0	0	252
4779	3	0	0	250	0	253
4780	1	260	0	2	0	263
4781	0	2	0	259	0	261
4782	0	259	0	1	0	260
4783	257	1	0	0	0	258
4784	2	256	0	0	0	258
4785	0	3	0	256	0	259
4786	0	0	0	257	0	257
4787	0	0	254	2	0	256
4788	1	256	2	0	0	259
4789	2	2	0	266	0	270
4790	0	0	271	3	0	274
4791	1	0	289	0	0	290
4792	1	0	2	309	0	312
4793	0	1	0	309	0	310
4794	1	296	0	4	0	301
4795	0	305	0	1	0	306
4796	0	6	0	305	0	311
4797	305	0	1	4	0	310
4798	4	0	1	315	0	320
4799	321	0	0	6	0	327
4800	321	1	0	2	0	324
4801	330	1	0	1	0	332
4802	4	1	332	1	0	338
4803	328	0	4	1	0	333
4804	6	0	0	337	0	343
4805	1	0	0	337	0	338
4806	3	1	325	4	0	333
4807	2	1	331	1	0	335
4808	2	0	5	326	0	333
4809	1	317	2	5	0	325
4810	1	329	1	1	0	332
4811	0	3	0	325	0	328
4812	322	2	2	4	0	330
4813	4	1	2	327	0	334
4814	0	1	1	331	0	333
4815	1	328	0	5	0	334
4816	0	4	0	336	0	340
4817	0	1	342	4	0	347
4818	1	2	332	1	0	336
4819	341	0	3	4	0	348
4820	3	339	1	2	0	345
4821	339	3	2	1	0	345
4822	339	1	0	2	0	342
4823	3	1	2	327	0	333
4824	2	337	1	2	0	342
4825	2	4	1	343	0	350
4826	336	1	0	5	0	342
4827	3	326	0	0	0	329
4828	320	3	1	1	0	325
4829	6	317	0	1	0	324
4830	318	5	0	0	0	323
4831	322	1	0	1	0	324
4832	3	316	1	1	0	321
4833	3	4	0	324	0	331
4834	329	1	0	3	0	333
4835	4	2	316	1	0	323
4836	1	1	316	1	0	319
4837	3	1	4	314	0	322
4838	314	0	2	3	0	319
4839	3	1	1	314	0	319
4840	310	1	0	4	0	315
4841	5	1	327	1	0	334
4842	327	0	5	2	0	334
4843	347	0	1	1	0	349
4844	4	0	1	341	0	346
4845	2	0	0	344	0	346
4846	3	1	0	337	0	341
4847	2	336	1	4	0	343
4848	1	3	2	339	0	345
4849	4	0	0	340	0	344
4850	336	0	0	6	0	342
4851	338	0	0	3	0	341
4852	4	0	330	3	0	337
4853	335	1	4	1	0	341
4854	4	1	338	2	0	345
4855	324	1	4	2	0	331
4856	4	1	333	2	0	340
4857	2	0	321	2	0	325
4858	2	7	5	309	0	323
4859	1	0	312	4	0	317
4860	299	0	5	2	0	306
4861	4	2	1	309	0	316
4862	313	1	1	4	0	319
4863	315	0	3	1	0	319
4864	305	0	1	2	0	308
4865	304	0	1	2	0	307
4866	5	1	304	1	0	311
4867	3	1	3	308	0	315
4868	3	0	308	5	0	316
4869	2	0	5	306	0	313
4870	309	1	0	4	0	314
4871	6	0	1	310	0	317
4872	312	1	0	4	0	317
4873	4	1	1	308	0	314
4874	2	0	1	318	0	321
4875	318	1	1	4	0	324
4876	5	315	0	2	0	322
4877	320	3	0	3	0	326
4878	4	316	0	1	0	321
4879	1	5	0	316	0	322
4880	314	0	0	5	0	319
4881	5	2	307	1	0	315
4882	1	1	3	313	0	318
4883	313	1	0	4	0	318
4884	312	1	1	0	0	314
4885	3	1	0	314	0	318
4886	4	312	0	4	0	320
4887	2	315	2	0	0	319
4888	2	16	2	294	0	314
4889	309	2	0	4	0	315
4890	6	293	0	1	0	300
4891	1	280	0	3	0	284
4892	259	7	0	0	0	266
4893	2	252	0	0	0	254
4894	258	3	0	0	0	261
4895	7	1	0	248	0	256
4896	1	4	0	250	0	255
4897	2	248	0	3	0	253
4898	0	251	0	3	0	254
4899	238	3	0	2	0	243
4900	2	241	0	0	0	243
4901	0	253	0	0	0	253
4902	1	3	3	251	0	258
4903	255	3	0	1	0	259
4904	2	1	269	2	0	274
4905	274	0	3	1	0	278
4906	4	0	3	305	0	312
4907	3	0	310	4	0	317
4908	1	0	326	3	0	330
4909	0	0	8	330	0	338
4910	0	0	353	4	0	357
4911	363	0	6	3	0	372
4912	362	0	3	2	0	367
4913	8	0	362	0	0	370
4914	4	0	4	358	0	366
4915	1	0	3	366	0	370
4916	360	0	2	8	0	370
4917	6	0	0	346	0	352
4918	4	352	0	5	0	361
4919	354	5	1	3	0	363
4920	5	350	0	2	0	357
4921	3	361	0	1	0	365
4922	4	7	0	351	0	362
4923	1	4	0	353	0	358
4924	0	2	0	355	0	357
4925	1	1	335	9	0	346
4926	326	2	4	4	0	336
4927	5	333	3	2	0	343
4928	333	5	1	1	0	340
4929	334	4	0	1	0	339
4930	8	2	0	333	0	343
4931	4	324	0	5	0	333
4932	2	6	0	331	0	339
4933	1	3	0	335	0	339
4934	336	1	0	9	0	346
4935	339	0	0	4	0	343
4936	8	1	329	2	0	340
4937	330	2	5	0	0	337
4938	6	333	2	1	0	342
4939	344	5	1	1	0	351
4940	7	372	0	0	0	379
4941	3	7	0	348	0	358
4942	2	3	1	353	0	359
4943	1	340	1	9	0	351
4944	0	7	0	347	0	354
4945	0	3	0	353	0	356
4946	0	2	1	347	0	350
4947	0	341	1	11	0	353
4948	0	6	0	348	0	354
4949	0	4	1	349	0	354
4950	1	1	0	353	0	355
4951	1	0	343	11	0	355
4952	332	0	7	4	0	343
4953	6	1	340	2	0	349
4954	340	0	7	2	0	349
4955	8	0	342	1	0	351
4956	343	0	6	2	0	351
4957	353	1	4	0	0	358
4958	10	0	349	0	0	359
4959	4	1	7	352	0	364
4960	3	1	347	6	0	357
4961	338	0	6	4	0	348
4962	7	0	362	2	0	371
4963	4	1	354	1	0	360
4964	356	0	11	0	0	367
4965	6	350	4	1	0	361
4966	3	7	2	362	0	374
4967	366	3	0	6	0	375
4968	7	0	1	363	0	371
4969	3	0	1	374	0	378
4970	369	1	0	9	0	379
4971	372	1	0	5	0	378
4972	9	0	356	3	0	368
4973	6	0	361	0	0	367
4974	4	0	8	356	0	368
4975	3	0	365	9	0	377
4976	1	0	8	365	0	374
4977	1	1	4	361	0	367
4978	0	0	2	378	0	380
4979	365	1	3	10	0	379
4980	8	377	0	6	0	391
4981	381	6	1	2	0	390
4982	378	4	2	1	0	385
4983	11	372	0	3	0	386
4984	381	6	0	3	0	390
4985	10	3	374	1	0	388
4986	3	1	5	374	0	383
4987	375	2	3	5	0	385
4988	8	0	366	2	0	376
4989	355	3	5	0	0	363
4990	6	369	3	0	0	378
4991	776	4	0	2	0	782
4992	762	2	0	2	0	766
4993	70	798	0	2	0	870
4994	826	28	4	0	0	858
4995	74	44	0	780	0	898
4996	84	32	2	848	0	966
4997	826	22	1	68	0	917
4998	751	24	1	65	0	841
4999	82	796	0	51	0	929
5000	60	849	1	44	0	954
5001	46	75	0	721	0	842
5002	35	838	0	27	0	900
5003	18	888	0	29	0	935
5004	728	115	0	18	0	861
5005	27	886	1	17	0	931
5006	752	81	0	20	0	853
5007	53	849	0	6	0	908
5008	58	79	742	3	0	882
5009	41	843	26	2	0	912
5010	768	88	38	3	0	897
5011	765	64	27	3	0	859
5012	67	51	763	2	0	883
5013	69	28	51	732	0	880
5014	53	24	40	772	0	889
5015	47	11	766	66	0	890
5016	34	4	48	814	0	900
5017	12	7	809	79	0	907
5018	6	9	783	90	0	888
5019	699	6	91	57	0	853
5020	34	750	95	36	0	915
5021	788	32	54	32	0	906
5022	53	48	47	759	0	907
5023	70	35	769	34	0	908
5024	47	33	34	694	0	808
5025	31	773	45	53	0	902
5026	771	37	27	55	0	890
5027	771	52	24	42	0	889
5028	75	46	28	785	0	934
5029	86	31	754	47	0	918
5030	750	40	29	53	0	872
5031	84	778	39	35	0	936
5032	827	43	27	31	0	928
5033	89	55	32	796	0	972
5034	857	48	28	44	0	977
5035	123	49	7	821	0	1000
5036	102	53	775	69	0	999
5037	84	28	787	92	0	991
5038	733	19	72	107	0	931
5039	88	778	77	60	0	1003
5040	815	49	58	40	0	962
5041	756	81	55	27	0	919
5042	103	831	39	14	0	987
5043	848	92	17	30	0	987
5044	107	109	773	26	0	1015
5045	117	92	35	791	0	1035
5046	91	81	55	787	0	1014
5047	76	77	42	880	0	1075
5048	77	48	804	113	0	1042
5049	49	50	836	109	0	1044
5050	44	45	95	784	0	968
5051	46	2005	97	99	0	2247
5052	42	2152	74	92	0	2360
5053	2196	96	71	53	0	2416
5054	2155	97	58	48	0	2358
5055	93	2194	41	55	0	2383
5056	96	109	29	2245	0	2479
5057	72	93	38	2262	0	2465
5058	2255	72	46	111	0	2484
5059	107	51	40	2300	0	2498
5060	90	70	54	2299	0	2513
5061	98	44	54	2348	0	2544
5062	92	57	2155	160	0	2464
5063	80	65	2016	133	0	2294
5064	2183	31	94	131	0	2439
5065	75	30	108	2291	0	2504
5066	91	33	2234	112	0	2470
5067	85	65	2110	89	0	2349
5068	2110	53	127	62	0	2352
5069	112	62	2263	73	0	2510
5070	93	2210	122	85	0	2510
5071	68	70	134	2352	0	2624
5072	87	94	2303	61	0	2545
5073	2298	92	86	75	0	2551
5074	108	71	99	2403	0	2681
5075	102	56	2368	111	0	2637
5076	81	51	97	2410	0	2639
5077	75	40	107	2444	0	2666
5078	2439	34	78	140	0	2691
5079	92	2307	93	118	0	2610
5080	108	67	61	2437	0	2673
5081	2434	77	37	135	0	2683
5082	2423	64	63	119	0	2669
5083	2497	44	27	94	0	2662
5084	2477	66	42	91	0	2676
5085	170	36	59	2450	0	2715
5086	2501	18	55	103	0	2677
5087	2473	32	68	96	0	2669
5088	2413	14	49	113	0	2589
5089	2386	35	38	101	0	2560
5090	175	2303	66	94	0	2638
5091	3	1802	2	2	0	1809
5092	0	8	0	1886	0	1894
5093	0	1798	2	7	0	1807
5094	1883	5	0	2	0	1890
5095	5	5	1	1853	0	1864
5096	1871	0	1	5	0	1877
5097	1854	0	0	4	0	1858
5098	7	0	0	1881	0	1888
5099	4	0	0	1887	0	1891
5100	0	1836	3	8	0	1847
5101	1908	4	1	4	0	1917
5102	6	1847	3	2	0	1858
5103	1921	6	0	1	0	1928
5104	7	2	0	1920	0	1929
5105	5	0	1893	5	0	1903
5106	1870	0	5	6	0	1881
5107	1834	1	1	1	0	1837
5108	9	1	1857	2	0	1869
5109	4	2	1819	2	0	1827
5110	3	1	7	1733	0	1744
5111	1779	0	1	6	0	1786
5112	2863	2	2	2	0	2869
5113	3022	0	0	4	0	3026
5114	3043	3	1	3	0	3050
5115	95	2937	1	1	0	3034
5116	3056	73	1	4	0	3134
5117	84	18	0	3919	0	4021
5118	25	8	0	3920	0	3953
5119	12	2	1	4013	0	4028
5120	10	2	0	4085	0	4097
5121	3935	4	1	103	0	4043
5122	79	5	0	4021	0	4105
5123	21	5	3893	88	0	4007
5124	8	0	78	3982	0	4068
5125	2	0	11	4099	0	4112
5126	7	2	8	4076	0	4093
5127	8	0	1	4108	0	4117
5128	3951	5	3	109	0	4068
5129	82	3803	7	29	0	3921
5130	19	3920	9	19	0	3967
5131	9	99	4	3990	0	4102
5132	3951	26	2	85	0	4064
5133	4013	6	0	27	0	4046
5134	107	5	1	3984	0	4097
5135	40	9	3793	85	0	3927
5136	3856	8	75	28	0	3967
5137	103	2	16	4017	0	4138
5138	38	11	3879	92	0	4020
5139	3714	10	77	36	0	3837
5140	96	3832	26	25	0	3979
5141	4019	78	7	25	0	4129
5142	103	3937	8	21	0	4069
5143	29	99	4	4067	0	4199
5144	23	4730	9	113	0	4875
5145	27	126	3	4922	0	5078
5146	4605	38	9	151	0	4803
5147	127	4663	16	53	0	4859
5148	35	113	4621	38	0	4807
5149	21	46	115	4764	0	4946
5150	9	34	4764	160	0	4967
5151	16	8	130	3542	0	3696
5152	29	19	33	3747	0	3828
5153	16	32	3576	165	0	3789
5154	3308	15	134	76	0	3533
5155	140	11	3591	41	0	3783
5156	58	11	3526	29	0	3624
5157	34	3456	161	36	0	3687
5158	17	121	51	3557	0	3746
5159	27	40	30	3680	0	3777
5160	26	13	19	3677	0	3735
5161	15	17	24	3767	0	3823
5162	11	14	3512	193	0	3730
5163	3350	22	129	75	0	3576
5164	137	26	3524	46	0	3733
5165	53	10	131	3602	0	3796
5166	3503	15	44	170	0	3732
5167	133	3516	26	76	0	3751
5168	48	139	19	3580	0	3786
5169	3489	39	26	154	0	3708
5170	158	3399	23	62	0	3642
5171	58	3557	17	38	0	3670
5172	3415	166	19	30	0	3630
5173	141	3481	7	47	0	3676
5174	3419	148	15	37	0	3619
5175	155	3447	8	38	0	3648
5176	3462	141	12	39	0	3654
5177	3462	48	22	31	0	3563
5178	182	3409	12	21	0	3624
5179	69	131	24	3483	0	3707
5180	35	59	3325	144	0	3563
5181	3373	32	127	61	0	3593
5182	154	26	40	3342	0	3562
5183	69	3257	24	151	0	3501
5184	33	3495	15	80	0	3623
5185	20	153	20	3503	0	3696
5186	3429	49	29	153	0	3660
5187	149	33	3291	73	0	3546
5188	56	25	131	3470	0	3682
5189	34	37	36	3561	0	3668
5190	34	35	23	3598	0	3690
5191	30	23	15	3529	0	3597
5192	23	3341	23	188	0	3575
5193	32	121	32	3526	0	3711
5194	18	54	3317	186	0	3575
5195	29	37	3388	76	0	3530
5196	33	25	3446	62	0	3566
5197	28	36	167	3375	0	3606
5198	3365	38	55	148	0	3606
5199	137	44	3384	67	0	3632
5200	68	23	3437	52	0	3580
5201	44	27	180	3308	0	3559
5202	3363	27	65	168	0	3623
5203	145	3319	31	95	0	3590
5204	3408	135	42	49	0	3634
5205	164	48	35	3368	0	3615
5206	56	35	3279	165	0	3535
5207	29	34	151	3172	0	3386
5208	43	3286	47	146	0	3522
5209	3331	147	32	55	0	3565
5210	168	55	3260	55	0	3538
5211	58	3274	160	45	0	3537
5212	2136	57	32	18	0	2243
5213	52	30	17	2129	0	2228
5214	33	16	8	2181	0	2238
5215	2140	9	15	80	0	2244
5216	2161	8	15	40	0	2224
5217	1503	13	14	18	0	1548
5218	88	11	19	1391	0	1509
5219	34	1411	10	73	0	1528
5220	1415	55	14	38	0	1522
5221	75	1418	5	23	0	1521
5222	1410	64	6	15	0	1495
5223	70	1392	11	23	0	1496
5224	33	58	9	1362	0	1462
5225	1349	37	8	57	0	1451
5226	1395	24	11	26	0	1456
5227	1418	19	5	13	0	1455
5228	1431	17	3	18	0	1469
5229	1427	17	4	19	0	1467
5230	87	11	1318	19	0	1435
5231	48	11	49	1350	0	1458
5232	37	8	1333	55	0	1433
5233	35	17	1351	25	0	1428
5234	1356	13	68	10	0	1447
5235	1375	20	36	12	0	1443
5236	1402	7	15	20	0	1444
5237	78	13	14	1335	0	1440
5238	1307	12	18	58	0	1395
5239	74	1318	13	27	0	1432
5240	41	1338	6	14	0	1399
5241	34	1314	3	14	0	1365
5242	1197	55	12	15	0	1279
5243	56	1250	8	21	0	1335
5244	432	5	1	0	0	438
5245	428	3	0	1	0	432
5246	10	1	420	0	0	431
5247	5	0	5	420	0	430
5248	1	2	2	437	0	442
5249	436	0	1	8	0	445
5250	443	0	1	3	0	447
5251	9	1	2	434	0	446
5252	3	2	432	7	0	444
5253	2	0	430	5	0	437
5254	3	1	6	425	0	435
5255	6	0	2	428	0	436
5256	3	1	0	432	0	436
5257	421	0	2	10	0	433
5258	422	0	2	4	0	428
5259	9	419	2	2	0	432
5260	5	9	0	419	0	433
5261	2	2	0	425	0	429
5262	3	422	0	10	0	435
5263	5	7	0	425	0	437
5264	419	4	1	8	0	432
5265	11	1	0	412	0	424
5266	4	2	0	427	0	433
5267	405	1	1	13	0	420
5268	413	1	0	5	0	419
5269	413	0	1	2	0	416
5270	12	0	2	398	0	412
5271	5	0	377	11	0	393
5272	4	0	382	4	0	390
5273	2	3	367	2	0	374
5274	7	349	6	3	0	365
5275	352	7	4	2	0	365
5276	10	3	340	2	0	355
5277	335	0	8	2	0	345
5278	9	3	3	326	0	341
5279	329	1	2	8	0	340
5280	335	3	0	4	0	342
5281	11	331	1	3	0	346
5282	334	8	3	1	0	346
5283	336	1	4	2	0	343
5284	10	328	1	4	0	343
5285	5	5	1	332	0	343
5286	5	3	333	8	0	349
5287	6	1	6	316	0	329
5288	8	0	2	330	0	340
5289	324	1	3	11	0	339
5290	10	2	2	320	0	334
5291	3	326	3	11	0	343
5292	2	9	3	325	0	339
5293	4	1	0	340	0	345
5294	6	0	321	11	0	338
5295	4	325	8	2	0	339
5296	1	332	2	5	0	340
5297	322	9	1	5	0	337
5298	9	324	0	7	0	340
5299	3	8	1	330	0	342
5300	5	5	329	8	0	347
5301	5	328	8	5	0	346
5302	335	11	3	2	0	351
5303	8	2	2	333	0	345
5304	5	2	1	344	0	352
5305	5	2	339	9	0	355
5306	2	1	10	326	0	339
5307	3	3	2	330	0	338
5308	326	0	3	10	0	339
5309	316	0	2	8	0	326
5310	11	309	2	4	0	326
5311	294	8	1	4	0	307
5312	10	290	1	3	0	304
5313	3	8	1	233	0	245
5314	3	239	0	8	0	250
5315	2	243	0	3	0	248
5316	212	7	3	5	0	227
5317	208	3	1	1	0	213
5318	5	213	0	3	0	221
5319	212	3	1	2	0	218
5320	215	1	0	3	0	219
5321	218	1	0	3	0	222
5322	8	1	0	216	0	225
5323	217	0	0	8	0	225
5324	6	2	209	1	0	218
5325	212	1	6	1	0	220
5326	6	1	212	1	0	220
5327	1	1	7	210	0	219
5328	1	2	1	221	0	225
5329	1	3	223	5	0	232
5330	224	0	7	1	0	232
5331	234	2	1	0	0	237
5332	7	1	245	1	0	254
5333	1	0	5	247	0	253
5334	1	1	0	251	0	253
5335	2	0	2	251	0	255
5336	247	1	1	7	0	256
5337	251	0	0	3	0	254
5338	7	2	2	238	0	249
5339	2	241	0	6	0	249
5340	1	232	0	3	0	236
5341	223	5	1	1	0	230
5342	7	222	0	0	0	229
5343	0	218	0	1	0	219
5344	1	7	0	185	0	193
5345	0	1	184	2	0	187
5346	2	180	2	0	0	184
5347	1	2	0	182	0	185
5348	1	178	0	3	0	182
5349	0	3	0	173	0	176
5350	179	0	0	2	0	181
5351	3	180	0	0	0	183
5352	183	2	0	0	0	185
5353	181	0	0	1	0	182
5354	3	0	179	0	0	182
5355	178	0	3	0	0	181
5356	3	1	0	1187	0	1191
5357	0	0	1170	1	0	1171
5358	0	1108	7	0	0	1115
5359	0	1	0	1214	0	1215
5360	0	0	0	1217	0	1217
5361	1206	0	0	1	0	1207
5362	1	0	0	1191	0	1192
5363	0	0	0	1197	0	1197
5364	1223	0	0	1	0	1224
5365	1	1146	0	3	0	1150
5366	1198	1	1	1	0	1201
5367	1	3	1176	0	0	1180
5368	1059	0	2	3	0	1064
5369	1	1	1176	0	0	1178
5370	0	1090	3	1	0	1094
5371	1231	1	0	0	0	1232
5372	1183	1	1	0	0	1185
5373	1	3	1169	0	0	1173
5374	0	3	1138	0	0	1141
5375	0	3	1120	0	0	1123
5376	0	1173	5	1	0	1179
5377	0	2	0	1226	0	1228
5378	4	0	1232	2	0	1238
5379	0	1	1185	0	0	1186
5380	0	0	2	1234	0	1236
5381	0	2	1253	2	0	1257
5382	1185	0	2	1	0	1188
5383	1268	0	1	0	0	1269
5384	2	1	1263	1	0	1267
5385	0	1246	3	1	0	1250
5386	0	3	0	1313	0	1316
5387	1	0	1296	1	0	1298
5388	0	1209	3	1	0	1213
5389	2	1	0	1276	0	1279
5390	1292	0	0	1	0	1293
5391	1280	0	0	0	0	1280
5392	1	1250	2	1	0	1254
5393	0	2	0	1314	0	1316
5394	0	0	0	1310	0	1310
5395	0	0	0	1274	0	1274
5396	0	0	0	1296	0	1296
5397	0	0	1277	1	0	1278
5398	0	1	1	1254	0	1256
5399	1	0	1265	1	0	1267
5400	0	1202	1	1	0	1204
5401	1283	2	0	0	0	1285
5402	2	1224	1	2	0	1229
5403	0	1	0	1301	0	1302
5404	0	1	0	1292	0	1293
5405	1298	0	0	2	0	1300
5406	1	0	1	1264	0	1266
5407	0	1233	0	2	0	1235
5408	0	1	0	1301	0	1302
5409	1	0	0	1275	0	1276
5410	1279	0	0	1	0	1280
5411	1	2	1264	0	0	1267
5412	0	1171	0	1	0	1172
5413	0	1260	0	3	0	1263
5414	1	1	0	1290	0	1292
5415	1280	0	0	2	0	1282
5416	1	1243	1	1	0	1246
5417	0	1	0	1291	0	1292
5418	0	2	1240	1	0	1243
5419	0	2	1	1220	0	1223
5420	1279	0	0	2	0	1281
5421	1164	1	0	0	0	1165
5422	1	0	0	1258	0	1259
5423	1259	0	0	2	0	1261
5424	1229	0	0	1	0	1230
5425	1	4	1219	1	0	1225
5426	1187	1	0	0	0	1188
5427	1	1168	4	2	0	1175
5428	1272	1	0	1	0	1274
5429	2	2	1172	0	0	1176
5430	0	0	1	1206	0	1207
5431	1241	0	1	1	0	1243
5432	2	3	1137	0	0	1142
5433	2	5	1085	2	0	1094
5434	2	0	1	1126	0	1129
5435	0	1	1160	1	0	1162
5436	1152	0	2	1	0	1155
5437	1	1	1181	0	0	1183
5438	1	0	1	1161	0	1163
5439	1	0	1	1186	0	1188
5440	1219	1	0	4	0	1224
5441	3	0	1189	1	0	1193
5442	1	2	1189	0	0	1192
5443	1	0	2	1211	0	1214
5444	2	0	1248	4	0	1254
5445	1161	0	4	1	0	1166
5446	5	1	1	1238	0	1245
5447	1	0	1234	4	0	1239
5448	0	1	5	2084	0	2090
5449	0	0	1	2182	0	2183
5450	2220	0	0	57	0	2277
5451	41	0	2170	23	0	2234
5452	2142	1	43	11	0	2197
5453	52	2	2184	6	0	2244
5454	2150	0	52	4	0	2206
5455	2163	0	22	4	0	2189
5456	1289	1	13	1	0	1304
5457	69	1277	0	4	0	1350
5458	1301	40	3	3	0	1347
5459	1292	23	1	1	0	1317
5460	65	11	2	1300	0	1378
5461	33	3	1259	43	0	1338
5462	1279	2	43	25	0	1349
5463	47	2	1276	13	0	1338
5464	29	0	47	1281	0	1357
5465	13	0	22	1347	0	1382
5466	1273	1	14	64	0	1352
5467	41	1290	7	37	0	1375
5468	30	39	5	1296	0	1370
5469	14	23	3	1348	0	1388
5470	8	12	1241	69	0	1330
5471	11	1	40	1311	0	1363
5472	10	4	25	1314	0	1353
5473	10	5	15	1204	0	1234
5474	11	1292	2	67	0	1372
5475	1267	41	7	32	0	1347
5476	1258	27	3	13	0	1301
5477	67	1277	5	10	0	1359
5478	1256	37	2	5	0	1300
5479	49	26	5	1244	0	1324
5480	32	15	1199	50	0	1296
5481	22	1208	42	32	0	1304
5482	7	1287	24	19	0	1337
5483	1201	66	13	13	0	1293
5484	1264	32	5	15	0	1316
5485	71	13	8	1230	0	1322
5486	38	4	10	1292	0	1344
5487	25	6	3	1342	0	1376
5488	1285	4	4	85	0	1378
5489	56	5	1232	40	0	1333
5490	1294	6	42	21	0	1363
5491	65	4	22	1245	0	1336
5492	35	9	17	1250	0	1311
5493	30	1250	3	69	0	1352
5494	17	39	9	1302	0	1367
5495	13	29	3	1338	0	1383
5496	12	19	1238	74	0	1343
5497	20	1283	44	58	0	1405
5498	1282	44	28	36	0	1390
5499	1168	24	19	25	0	1236
5500	1339	19	12	22	0	1392
5501	1382	5	12	19	0	1418
5502	89	13	1271	18	0	1391
5503	1344	6	50	19	0	1419
5504	86	4	1277	20	0	1387
5505	57	7	64	1220	0	1348
5506	43	1302	31	57	0	1433
5507	33	50	21	1329	0	1433
5508	37	29	16	1371	0	1453
5509	29	28	1292	87	0	1436
5510	1298	7	57	57	0	1419
5511	1310	8	33	30	0	1381
5512	85	1274	33	22	0	1414
5513	59	48	1274	31	0	1412
5514	37	30	52	1350	0	1469
5515	36	23	1295	63	0	1417
5516	30	21	1320	57	0	1428
5517	33	18	64	1347	0	1462
5518	43	8	1314	75	0	1440
5519	32	15	80	1343	0	1470
5520	31	8	1305	91	0	1435
5521	32	9	73	1365	0	1479
5522	1312	13	37	95	0	1457
5523	1364	20	26	61	0	1471
5524	1369	20	12	47	0	1448
5525	1343	22	16	31	0	1412
5526	108	1313	13	27	0	1461
5527	79	55	18	1292	0	1444
5528	39	38	18	1362	0	1457
5529	23	27	1264	101	0	1415
5530	23	16	53	1363	0	1455
5531	21	33	1279	80	0	1413
5532	29	28	1275	52	0	1384
5533	1260	17	68	43	0	1388
5534	78	1298	43	34	0	1453
5535	1328	50	28	41	0	1447
5536	1309	31	14	55	0	1409
5537	82	1327	21	49	0	1479
5538	1366	50	25	43	0	1484
5539	81	40	1258	38	0	1417
5540	54	1328	56	40	0	1478
5541	1343	52	35	39	0	1469
5542	66	56	1269	31	0	1422
5543	1266	25	45	48	0	1384
5544	74	1280	33	47	0	1434
5545	1310	60	33	27	0	1430
5546	1210	47	22	28	0	1307
5547	94	1306	27	29	0	1456
5548	3	294	0	0	0	297
5549	1	314	0	1	0	316
5550	1	4	0	301	0	306
5551	0	2	0	297	0	299
5552	295	2	0	2	0	299
5553	295	0	0	2	0	297
5554	2	0	297	2	0	301
5555	2	0	299	0	0	301
5556	2	0	299	0	0	301
5557	0	0	4	310	0	314
5558	0	0	331	2	0	333
5559	0	0	4	324	0	328
5560	335	0	0	4	0	339
5561	2	0	342	0	0	344
5562	340	0	2	2	0	344
5563	348	0	0	0	0	348
5564	2	1	357	0	0	360
5565	2	361	2	0	0	365
5566	1	2	0	380	0	383
5567	0	0	376	2	0	378
5568	0	1	2	380	0	383
5569	0	0	0	400	0	400
5570	395	0	2	2	0	399
5571	3	0	0	402	0	405
5572	0	0	398	5	0	403
5573	2	0	1	397	0	400
5574	403	0	0	5	0	408
5575	2	407	2	2	0	413
5576	411	3	2	3	0	419
5577	6	1	0	415	0	422
5578	0	1	419	3	0	423
5579	2	0	404	0	0	406
5580	0	2	399	2	0	403
5581	0	388	4	1	0	393
5582	380	3	7	3	0	393
5583	4	355	1	1	0	361
5584	348	2	1	0	0	351
5585	2	350	0	1	0	353
5586	1	2	0	356	0	359
5587	0	1	0	358	0	359
5588	0	0	0	359	0	359
5589	0	349	1	2	0	352
5590	0	2	1	367	0	370
5591	0	0	1	393	0	394
5592	419	1	0	4	0	424
5593	4	1	0	459	0	464
5594	1	0	507	4	0	512
5595	509	1	8	0	0	518
5596	527	0	1	0	0	528
5597	12	534	0	0	0	546
5598	537	9	0	1	0	547
5599	557	1	0	1	0	559
5600	10	0	0	542	0	552
5601	1	1	0	556	0	558
5602	0	0	0	574	0	574
5603	563	0	1	12	0	576
5604	575	0	0	1	0	576
5605	11	0	560	3	0	574
5606	555	1	11	0	0	567
5607	566	0	0	1	0	567
5608	561	0	0	0	0	561
5609	11	2	546	1	0	560
5610	3	0	553	1	0	557
5611	1	0	10	550	0	561
5612	1	0	558	10	0	569
5613	1	0	10	544	0	555
5614	1	0	3	537	0	541
5615	4	554	0	13	0	571
5616	558	10	0	1	0	569
5617	11	2	562	0	0	575
5618	560	0	12	0	0	572
5619	12	1	2	566	0	581
5620	557	0	2	11	0	570
5621	12	551	4	9	0	576
5622	4	564	1	3	0	572
5623	1	14	0	559	0	574
5624	3	2	2	565	0	572
5625	4	0	558	13	0	575
5626	3	0	10	558	0	571
5627	550	1	1	14	0	566
5628	12	549	1	4	0	566
5629	4	10	553	1	0	568
5630	6	3	10	551	0	570
5631	0	2	553	13	0	568
5632	5	0	10	552	0	567
5633	4	3	547	11	0	565
5634	3	2	532	3	0	540
5635	2	0	12	522	0	536
5636	528	1	4	12	0	545
5637	529	1	3	3	0	536
5638	521	0	3	4	0	528
5639	10	511	3	3	0	527
5640	518	11	1	2	0	532
5641	519	3	4	2	0	528
5642	12	1	509	2	0	524
5643	2	508	15	1	0	526
5644	3	9	3	506	0	521
5645	502	1	2	12	0	517
5646	13	501	3	2	0	519
5647	505	12	0	3	0	520
5648	509	4	1	2	0	516
5649	497	2	0	3	0	502
5650	500	0	1	3	0	504
5651	10	4	3	487	0	504
5652	501	1	1	12	0	515
5653	15	0	0	495	0	510
5654	4	492	2	10	0	508
5655	1	13	2	488	0	504
5656	484	1	1	13	0	499
5657	13	7	2498	5	0	2523
5658	3	5	10	2442	0	2460
5659	2741	0	6	11	0	2758
5660	11	2478	5	4	0	2498
5661	2693	9	1	4	0	2707
5662	2699	2	1	1	0	2703
5663	13	2519	7	4	0	2543
5664	2685	9	1	3	0	2698
5665	11	4	2533	2	0	2550
5666	4	5	2455	2	0	2466
5667	2349	0	12	5	0	2366
5668	13	2	2604	0	0	2619
5669	2	4	8	2471	0	2485
5670	2	2516	2	12	0	2532
5671	2652	9	1	2	0	2664
5672	10	2447	3	1	0	2461
5673	5	2363	10	1	0	2379
5674	4	9	1	2645	0	2659
5675	3	3	1	2585	0	2592
5676	6	6	3	2355	0	2370
5677	1	0	1	2529	0	2531
5678	2	2	2533	11	0	2548
5679	3	1	10	2452	0	2466
5680	1	3	2	2602	0	2608
5681	2625	3	1	11	0	2640
5682	10	4	0	2601	0	2615
5683	3	2	2534	10	0	2549
5684	2316	2	8	6	0	2332
5685	10	1	2	2575	0	2588
5686	3	2	2587	10	0	2602
5687	2	1	10	2510	0	2523
5688	2	2429	3	10	0	2444
5689	2505	9	2	4	0	2520
5690	14	4	2484	1	0	2503
5691	4	2211	12	3	0	2230
5692	2440	5	4	1	0	2450
5693	7	2233	1	4	0	2245
5694	0	2211	4	1	0	2216
5695	2344	2	5	1	0	2352
5696	2	2225	0	0	0	2227
5697	2	2222	0	5	0	2229
5698	2	3	2	2269	0	2276
5699	2	2	2221	2	0	2227
5700	1	2109	4	2	0	2116
5701	1	3	0	2274	0	2278
5702	0	2105	0	4	0	2109
5703	2258	0	0	0	0	2258
5704	0	4	2117	0	0	2121
5705	0	1	0	2172	0	2173
5706	2276	0	0	0	0	2276
5707	0	1	0	2210	0	2211
5708	1	4	2148	0	0	2153
5709	1997	1	0	0	0	1998
5710	2126	0	0	0	0	2126
5711	0	2054	4	1	0	2059
5712	0	0	0	2238	0	2238
5713	0	0	0	2236	0	2236
5714	2230	0	0	0	0	2230
5715	2094	0	0	0	0	2094
5716	0	0	2093	0	0	2093
5717	0	2020	4	0	0	2024
5718	2208	2	0	1	0	2211
5719	0	0	0	2182	0	2182
5720	0	1	2195	0	0	2196
5721	2	2	1992	1	0	1997
5722	0	2	1	2107	0	2110
5723	2246	0	0	0	0	2246
5724	0	2012	6	1	0	2019
5725	2240	0	2	1	0	2243
5726	0	1	0	2178	0	2179
5727	0	0	0	2180	0	2180
5728	0	0	0	2244	0	2244
5729	2271	0	0	0	0	2271
5730	0	2146	2	0	0	2148
5731	1	0	0	2257	0	2258
5732	0	0	0	2261	0	2261
5733	0	1	2170	0	0	2171
5734	1	2	0	2096	0	2099
5735	2	1	2218	0	0	2221
5736	0	1955	9	4	0	1968
5737	0	0	1	2233	0	2234
5738	2190	1	1	1	0	2193
5739	3	2	2117	0	0	2122
5740	0	1	0	2745	0	2746
5741	1	0	2714	4	0	2719
5742	2480	0	6	0	0	2486
5743	1	4	2779	1	0	2785
5744	1	0	1	2581	0	2583
5745	2763	1	0	0	0	2764
5746	3	2357	17	1	0	2378
5747	2683	0	0	1	0	2684
5748	1	2374	7	1	0	2383
5749	0	0	1	2558	0	2559
5750	1	4	2484	0	0	2489
5751	0	13	2286	2	0	2301
5752	1	3	4	2294	0	2302
5753	2469	0	0	2	0	2471
5754	2275	0	4	1	0	2280
5755	0	2	0	2282	0	2284
5756	0	2	1	2376	0	2379
5757	914	1	0	0	0	915
5758	0	872	0	2	0	874
5759	1	898	0	0	0	899
5760	929	0	1	0	0	930
5761	1	1	940	1	0	943
5762	0	0	1	889	0	890
5763	1	0	946	0	0	947
5764	0	0	0	898	0	898
5765	0	0	942	1	0	943
5766	1	1	906	1	0	909
5767	0	1	0	929	0	930
5768	1	879	0	0	0	880
5769	951	1	0	0	0	952
5770	0	922	2	1	0	925
5771	0	0	1	957	0	958
5772	958	0	1	0	0	959
5773	0	0	0	961	0	961
5774	970	0	0	0	0	970
5775	953	0	0	0	0	953
5776	962	0	0	1	0	963
5777	0	936	0	1	0	937
5778	974	0	0	1	0	975
5779	0	1	0	980	0	981
5780	1003	1	0	1	0	1005
5781	0	0	1	989	0	990
5782	1003	0	1	1	0	1005
5783	995	0	0	4	0	999
5784	2	988	0	0	0	990
5785	1	1	0	1036	0	1038
5786	1	1	1	1047	0	1050
5787	1	1077	3	3	0	1084
5788	0	4	0	1133	0	1137
5789	1128	5	0	6	0	1139
5790	1159	0	0	5	0	1164
5791	1150	3	1	0	0	1154
5792	12	0	1148	3	0	1163
5793	1130	0	4	1	0	1135
5794	1180	0	3	1	0	1184
5795	1213	0	0	1	0	1214
5796	10	1192	2	0	0	1204
5797	5	5	0	1207	0	1217
5798	1	5	0	1223	0	1229
5799	4	1	0	1208	0	1213
5800	1	3	1210	11	0	1225
5801	1	0	6	1189	0	1196
5802	1222	0	4	8	0	1234
5803	8	1	0	1216	0	1225
5804	5	1	2	1236	0	1244
5805	0	1	1225	13	0	1239
5806	1	1174	9	9	0	1193
5807	1277	8	3	2	0	1290
5808	7	6	0	1264	0	1277
5809	1260	1	1	8	0	1270
5810	9	2	1239	6	0	1256
5811	1164	0	8	1	0	1173
5812	7	1218	6	7	0	1238
5813	5	7	1255	3	0	1270
5814	1	4	1253	0	0	1258
5815	2	2	10	1193	0	1207
5816	2	2	1289	8	0	1301
5817	0	1235	11	5	0	1251
5818	1	8	3	1294	0	1306
5819	0	5	0	1304	0	1309
5820	0	0	2	1294	0	1296
5821	1304	1	1	10	0	1316
5822	7	1279	0	6	0	1292
5823	3	6	0	1329	0	1338
5824	0	5	0	1322	0	1327
5825	1317	0	0	12	0	1329
5826	7	1283	3	9	0	1302
5827	1326	7	0	2	0	1335
5828	1330	4	0	1	0	1335
5829	1296	1	1	2	0	1300
5830	12	1	1305	1	0	1319
5831	6	0	6	1275	0	1287
5832	3	1272	4	7	0	1286
5833	2	1298	0	6	0	1306
5834	2	10	1	1312	0	1325
5835	2	1287	2	9	0	1300
5836	1340	8	2	5	0	1355
5837	8	5	1326	1	0	1340
5838	1280	0	11	3	0	1294
5839	1340	1	2	2	0	1345
5840	12	2	0	808	0	822
5841	815	0	1	10	0	826
5842	7	849	0	6	0	862
5843	863	7	1	2	0	873
5844	867	6	2	1	0	876
5845	2743	4	2	2	0	2751
5846	128	5	2762	4	0	2899
5847	67	3	2792	3	0	2865
5848	60	0	177	2739	0	2976
5849	14	2745	117	112	0	2988
5850	16	2887	58	63	0	3024
5851	3	171	16	2910	0	3100
5852	2788	119	10	134	0	3051
5853	115	61	1	2925	0	3102
5854	72	13	2	3076	0	3163
5855	2828	8	4	203	0	3043
5856	123	2764	8	141	0	3036
5857	74	94	2801	76	0	3045
5858	54	71	2856	24	0	3005
5859	2860	49	183	9	0	3101
5860	126	20	117	2880	0	3143
5861	74	8	2850	122	0	3054
5862	65	1	124	2918	0	3108
5863	14	1	77	2998	0	3090
5864	12	1	58	3077	0	3148
5865	7	4	15	2992	0	3018
5866	10	2852	9	251	0	3122
5867	4	118	12	3012	0	3146
5868	2850	71	11	186	0	3118
5869	134	2909	4	98	0	3145
5870	2974	138	12	74	0	3198
5871	3078	80	11	24	0	3193
5872	3137	62	0	33	0	3232
5873	264	29	2787	11	0	3091
5874	3007	17	117	17	0	3158
5875	3088	5	70	26	0	3189
5876	3026	10	65	8	0	3109
5877	3045	12	13	19	0	3089
5878	255	2900	17	17	0	3189
5879	3013	121	14	4	0	3152
5880	191	87	2850	8	0	3136
5881	92	62	124	2817	0	3095
5882	72	13	82	2961	0	3128
5883	2936	15	59	187	0	3197
5884	133	2926	13	151	0	3223
5885	2939	116	18	79	0	3152
5886	178	2979	5	41	0	3203
5887	2941	179	5	32	0	3157
5888	2898	79	10	25	0	3012
5889	189	2973	8	18	0	3188
5890	3003	137	7	11	0	3158
5891	3047	75	12	25	0	3159
5892	245	2767	16	8	0	3036
5893	157	3002	33	18	0	3210
5894	3500	168	54	16	0	3738
5895	228	122	27	3494	0	3871
5896	3533	93	9	216	0	3851
5897	3760	51	15	125	0	3951
5898	3835	38	5	112	0	3990
5899	3771	24	11	55	0	3861
5900	420	3279	19	51	0	3769
5901	230	3578	29	56	0	3893
5902	3712	278	33	39	0	4062
5903	258	179	3447	35	0	3919
5904	156	104	231	3543	0	4034
5905	104	59	145	3757	0	4065
5906	3462	30	101	333	0	3926
5907	250	3465	36	238	0	3989
5908	139	206	32	3633	0	4010
5909	106	128	23	3827	0	4084
5910	3556	97	20	379	0	4052
5911	257	52	20	3776	0	4105
5912	3640	34	30	359	0	4063
5913	3700	59	39	196	0	3994
5914	3804	47	32	143	0	4026
5915	458	42	25	3522	0	4047
5916	252	53	36	3715	0	4056
5917	185	50	3418	354	0	4007
5918	137	38	3575	232	0	3982
5919	3599	31	295	168	0	4093
5920	287	19	207	3682	0	4195
5921	213	34	3614	270	0	4131
5922	171	30	3763	174	0	4138
5923	132	39	321	3779	0	4271
5924	120	46	3731	270	0	4167
5925	85	71	295	3732	0	4183
5926	100	47	156	3950	0	4253
5927	92	28	3641	379	0	4140
5928	88	25	244	3824	0	4181
5929	82	29	126	4001	0	4238
5930	127	13	92	4042	0	4274
5931	110	75	3500	425	0	4110
5932	123	44	204	3911	0	4282
5933	3658	56	120	360	0	4194
5934	307	3652	89	184	0	4232
5935	3892	234	50	133	0	4309
5936	391	145	3577	78	0	4191
5937	3893	95	217	72	0	4277
5938	3938	51	139	52	0	4180
5939	4029	56	97	49	0	4231
5940	473	55	45	3677	0	4250
5941	298	57	41	3879	0	4275
5942	195	45	3348	379	0	3967
5943	3460	43	210	232	0	3945
5944	343	3559	143	154	0	4199
5945	62	1598	28	42	0	1730
5946	28	1652	27	39	0	1746
5947	42	128	16	1559	0	1745
5948	1545	64	20	114	0	1743
5949	1603	22	13	77	0	1715
5950	154	16	1493	45	0	1708
5951	75	15	91	1528	0	1709
5952	51	20	46	1596	0	1713
5953	38	12	1483	142	0	1675
5954	41	8	1516	80	0	1645
5955	1494	5	121	47	0	1667
5956	109	1470	57	44	0	1680
5957	1538	88	24	43	0	1693
5958	1601	55	21	34	0	1711
5959	159	19	22	1504	0	1704
5960	81	13	16	1608	0	1718
5961	1508	11	16	154	0	1689
5962	128	11	16	1531	0	1686
5963	75	21	17	1575	0	1688
5964	1493	13	14	165	0	1685
5965	129	8	11	1549	0	1697
5966	1518	9	19	138	0	1684
5967	1578	4	20	92	0	1694
5968	159	9	1415	52	0	1635
5969	1497	11	108	47	0	1663
5970	1541	10	60	36	0	1647
5971	1567	5	30	41	0	1643
5972	163	7	1336	34	0	1540
5973	1456	11	96	28	0	1591
5974	135	1399	52	24	0	1610
5975	1491	89	25	26	0	1631
5976	1540	40	21	39	0	1640
5977	161	13	22	1448	0	1644
5978	78	12	25	1513	0	1628
5979	47	1411	16	164	0	1638
5980	38	82	17	1477	0	1614
5981	29	42	14	1555	0	1640
5982	1433	14	10	177	0	1634
5983	124	14	13	1482	0	1633
5984	79	14	15	1521	0	1629
5985	44	15	11	1519	0	1589
5986	53	1368	8	149	0	1578
5987	1335	93	19	82	0	1529
5988	134	1358	14	46	0	1552
5989	1359	96	16	35	0	1506
5990	145	54	1228	25	0	1452
5991	1312	23	87	30	0	1452
5992	133	16	1258	30	0	1437
5993	87	1194	116	33	0	1430
5994	688	22	16	2	0	728
5995	668	5	4	1	0	678
5996	20	626	3	8	0	657
5997	10	614	2	7	0	633
5998	544	11	2	5	0	562
5999	545	8	2	3	0	558
6000	15	3	0	546	0	564
6001	9	3	1	548	0	561
6002	7	1	528	14	0	550
6003	521	4	8	7	0	540
6004	11	3	4	523	0	541
6005	8	521	3	8	0	540
6006	6	9	1	537	0	553
6007	6	4	2	541	0	553
6008	5	1	522	15	0	543
6009	4	2	10	534	0	550
6010	528	1	4	15	0	548
6011	10	524	3	7	0	544
6012	6	526	1	2	0	535
6013	525	10	1	4	0	540
6014	527	4	0	2	0	533
6015	524	3	3	2	0	532
6016	14	510	2	3	0	529
6017	9	435	2	1	0	447
6018	467	8	3	1	0	479
6019	466	5	3	6	0	480
6020	11	458	0	4	0	473
6021	3	358	1	4	0	366
6022	342	3	2	4	0	351
6023	7	1	1	333	0	342
6024	333	2	0	5	0	340
6025	4	2	0	332	0	338
6026	4	345	0	3	0	352
6027	3	342	2	1	0	348
6028	361	2	5	1	0	369
6029	389	2	2	0	0	393
6030	390	2	0	0	0	392
6031	6	388	1	0	0	395
6032	4	3	357	0	0	364
6033	1	367	4	0	0	372
6034	352	8	1	3	0	364
6035	350	1	0	0	0	351
6036	5	0	337	1	0	343
6037	1	321	2	0	0	324
6038	0	4	1	328	0	333
6039	0	1	0	320	0	321
6040	0	323	0	4	0	327
6041	0	5	322	1	0	328
6042	329	0	4	0	0	333
6043	5	0	1	332	0	338
6044	335	0	0	4	0	339
6045	338	0	0	2	0	340
6046	6	1	0	339	0	346
6047	2	0	1	349	0	352
6048	0	1	0	365	0	366
6049	1	1	0	366	0	368
6050	357	0	0	6	0	363
6051	354	0	1	2	0	357
6052	9	1	348	0	0	358
6053	1	0	5	356	0	362
6054	0	1	1	362	0	364
6055	0	2	0	362	0	364
6056	0	0	353	5	0	358
6057	1	0	5	348	0	354
6058	340	0	0	6	0	346
6059	6	0	0	340	0	346
6060	1	0	334	5	0	340
6061	0	1	5	334	0	340
6062	1	0	329	6	0	336
6063	336	0	5	1	0	342
6064	5	0	2	337	0	344
6065	337	1	0	5	0	343
6066	337	0	0	3	0	340
6067	5	0	1	335	0	341
6068	338	1	0	6	0	345
6069	5	0	1	331	0	337
6070	2	339	0	5	0	346
6071	351	6	1	1	0	359
6072	344	2	0	2	0	348
6073	344	0	0	1	0	345
6074	7	0	0	341	0	348
6075	1	0	1	344	0	346
6076	0	1	0	348	0	349
6077	0	1	324	7	0	332
6078	2	318	5	0	0	325
6079	1	5	1	307	0	314
6080	2	0	310	5	0	317
6081	299	0	5	2	0	306
6082	5	1	1	300	0	307
6083	3	0	295	7	0	305
6084	304	0	9	2	0	315
6085	5	3	1	309	0	318
6086	3	0	2	316	0	321
6087	2	1	0	316	0	319
6088	314	0	1	7	0	322
6089	316	0	0	3	0	319
6090	305	0	2	2	0	309
6091	6	299	0	2	0	307
6092	3	302	1	3	0	309
6093	303	7	0	2	0	312
6094	5	0	294	2	0	301
6095	2	0	7	293	0	302
6096	5	0	1	295	0	301
6097	291	0	1	7	0	299
6098	268	2	1	2	0	273
6099	9	268	1	1	0	279
6100	1	6	0	268	0	275
6101	3	1	265	7	0	276
6102	1	0	273	5	0	279
6103	2	0	5	270	0	277
6104	2	1	1	276	0	280
6105	272	0	2	7	0	281
6106	5	1	1	271	0	278
6107	276	2	1	7	0	286
6108	280	0	2	2	0	284
6109	7	0	275	2	0	284
6110	272	0	6	3	0	281
6111	273	0	2	2	0	277
6112	272	0	0	1	0	273
6113	8	261	0	3	0	272
6114	1	266	1	3	0	271
6115	0	11	0	263	0	274
6116	2	1	264	6	0	273
6117	5	264	6	1	0	276
6118	3	5	0	228	0	236
6119	1	0	1	221	0	223
6120	3	220	0	4	0	227
6121	224	2	0	6	0	232
6122	232	0	0	1	0	233
6123	4	1	240	2	0	247
6124	234	1	5	3	0	243
6125	6	0	230	1	0	237
6126	206	0	4	1	0	211
6127	5	1	216	0	0	222
6128	0	187	2	3	0	192
6129	2	1	4	154	0	161
6130	1	0	0	159	0	160
6131	160	0	0	2	0	162
6132	160	0	1	0	0	161
6133	158	0	0	0	0	158
6134	1	0	174	1	0	176
6135	0	0	1	172	0	173
6136	0	0	0	184	0	184
6137	182	0	0	1	0	183
6138	4	181	0	0	0	185
6139	187	1	0	0	0	188
6140	1	1	0	190	0	192
6141	0	1	0	201	0	202
6142	1	0	0	193	0	194
6143	0	0	1	198	0	199
6144	0	0	0	204	0	204
6145	0	205	0	2	0	207
6146	1	197	0	0	0	198
6147	1	195	0	0	0	196
6148	0	0	0	182	0	182
6149	0	0	178	0	0	178
6150	172	0	0	0	0	172
6151	0	188	0	0	0	188
6152	0	0	0	191	0	191
6153	0	0	0	195	0	195
6154	204	0	0	0	0	204
6155	201	0	0	0	0	201
6156	204	0	0	0	0	204
6157	0	0	0	220	0	220
6158	0	0	225	0	0	225
6159	0	0	238	0	0	238
6160	0	0	0	247	0	247
6161	0	0	253	0	0	253
6162	246	0	0	0	0	246
6163	0	0	0	243	0	243
6164	0	0	250	0	0	250
6165	0	0	0	244	0	244
6166	0	0	292	0	0	292
6167	1	2	1890	3	0	1896
6168	1	4	0	1841	0	1846
6169	2	2	2002	0	0	2006
6170	1	0	1904	0	0	1905
6171	1	1897	4	2	0	1904
6172	2	2	0	2064	0	2068
6173	2110	0	2	2	0	2114
6174	1	0	1	2066	0	2068
6175	0	1	1	2082	0	2084
6176	2	0	2098	4	0	2104
6177	1916	0	1	1	0	1918
6178	1	1	1	2122	0	2125
6179	0	0	0	2126	0	2126
6180	2149	0	2	1	0	2152
6181	2	2	0	3471	0	3475
6182	3509	1	2	4	0	3516
6183	3433	0	1	1	0	3435
6184	3419	0	1	0	0	3420
6185	2	3271	5	1	0	3279
6186	3491	1	0	1	0	3493
6187	3	3323	3	2	0	3331
6188	1	1	0	3489	0	3491
6189	3524	1	1	2	0	3528
6190	3	3327	2	9	0	3341
6191	3514	1	1	0	0	3516
6192	1	3324	4	9	0	3338
6193	3446	1	0	1	0	3448
6194	2	3170	8	1	0	3181
6195	1	3342	1	6	0	3350
6196	2	3503	1	4	0	3510
6197	2	1	1	3547	0	3551
6198	1	3464	3	2	0	3470
6199	1	4	0	3548	0	3553
6200	1	2	0	3520	0	3523
6201	1	1	1	3495	0	3498
6202	0	2	0	3568	0	3570
6203	3599	0	1	4	0	3604
6204	3526	1	0	2	0	3529
6205	6	0	3472	3	0	3481
6206	3496	1	1	1	0	3499
6207	3609	0	1	1	0	3611
6208	3608	1	0	2	0	3611
6209	4	2	3567	0	0	3573
6210	4	6	4630	0	0	4640
6211	4634	0	145	1	0	4780
6212	163	7	4800	2	0	4972
6213	7	4780	127	5	0	4919
6214	12	147	8	5045	0	5212
6215	5134	6	12	150	0	5302
6216	5143	10	5	10	0	5168
6217	5151	4	7	13	0	5175
6218	166	3	1	5016	0	5186
6219	19	1	12	5226	0	5258
6220	31	5	4951	167	0	5154
6221	19	2	142	4947	0	5110
6222	17	10	16	5220	0	5263
6223	5108	9	20	171	0	5308
6224	164	4906	9	34	0	5113
6225	5145	160	5	24	0	5334
6226	197	11	3	5098	0	5309
6227	5115	12	3	175	0	5305
6228	5149	6	1	30	0	5186
6229	4860	5	10	34	0	4909
6230	157	4840	15	32	0	5044
6231	28	5104	9	35	0	5176
6232	31	164	12	5131	0	5338
6233	5104	25	8	180	0	5317
6234	174	25	6	4990	0	5195
6235	27	24	18	5173	0	5242
6236	52	22	4922	190	0	5186
6237	42	12	150	4976	0	5180
6238	44	17	16	5078	0	5155
6239	39	16	15	5157	0	5227
6240	47	16	4933	200	0	5196
6241	36	25	4804	52	0	4917
6242	38	4750	149	45	0	4982
6243	5071	169	27	51	0	5318
6244	187	14	19	5012	0	5232
6245	36	24	4941	199	0	5200
6246	28	22	159	4909	0	5118
6247	28	15	25	5253	0	5321
6248	5055	9	20	222	0	5306
6249	5121	18	18	61	0	5218
6250	198	4851	26	51	0	5126
6251	5054	166	17	54	0	5291
6252	5156	23	26	32	0	5237
6253	211	31	28	4980	0	5250
6254	71	21	4874	204	0	5170
6255	71	4725	170	47	0	5013
6256	5039	191	37	60	0	5327
6257	5159	48	31	63	0	5301
6258	233	4785	21	65	0	5104
6259	93	176	13	6230	0	6512
6260	6323	29	7	308	0	6667
6261	6538	20	19	65	0	6642
6262	317	17	22	6293	0	6649
6263	6247	24	37	343	0	6651
6264	6505	28	41	93	0	6667
6265	6428	25	43	98	0	6594
6266	340	37	5863	82	0	6322
6267	92	4431	221	63	0	4807
6268	90	4825	27	71	0	5013
6269	4623	283	32	78	0	5016
6270	338	4566	32	76	0	5012
6271	113	282	4473	74	0	4942
6272	119	37	257	4596	0	5009
6273	4694	54	32	300	0	5080
6274	348	48	33	4604	0	5033
6275	4706	66	21	311	0	5104
6276	4894	45	26	65	0	5030
6277	4837	53	32	84	0	5006
6278	355	4339	40	83	0	4817
6279	81	4723	46	101	0	4951
6280	4689	297	48	78	0	5112
6281	3657	49	36	101	0	3843
6282	3719	47	27	87	0	3880
6283	360	50	33	3487	0	3930
6284	3349	32	40	352	0	3773
6285	363	3195	37	73	0	3668
6286	135	3567	35	79	0	3816
6287	137	297	28	3440	0	3902
6288	103	68	3268	332	0	3771
6289	110	66	3486	72	0	3734
6290	109	53	264	3458	0	3884
6291	98	49	3327	337	0	3811
6292	113	58	269	3479	0	3919
6293	3534	56	28	332	0	3950
6294	376	68	35	3474	0	3953
6295	3454	59	29	333	0	3875
6296	356	3376	38	83	0	3853
6297	103	303	3310	100	0	3816
6298	114	48	285	3379	0	3826
6299	91	68	62	3692	0	3913
6300	98	65	3303	324	0	3790
6301	96	51	267	3250	0	3664
6302	111	3322	39	307	0	3779
6303	90	298	49	3345	0	3782
6304	119	47	32	3665	0	3863
6305	127	49	22	3704	0	3902
6306	128	23	3320	380	0	3851
6307	129	34	3447	120	0	3730
6308	3407	42	277	95	0	3821
6309	388	49	3279	82	0	3798
6310	23	1925	117	21	0	2086
6311	1915	117	11	27	0	2070
6312	118	1938	26	26	0	2108
6313	1907	117	22	18	0	2064
6314	1995	20	11	23	0	2049
6315	1977	16	25	20	0	2038
6316	1951	9	10	32	0	2002
6317	144	1797	15	23	0	1979
6318	43	1929	14	28	0	2014
6319	1943	108	18	20	0	2089
6320	146	31	1812	21	0	2010
6321	49	26	112	1846	0	2033
6322	51	18	14	1974	0	2057
6323	30	27	1806	124	0	1987
6324	1869	16	112	25	0	2022
6325	1993	18	17	34	0	2062
6326	1965	27	19	13	0	2024
6327	136	1853	7	47	0	2043
6328	1932	111	13	23	0	2079
6329	135	27	20	1803	0	1985
6330	31	1889	33	123	0	2076
6331	1947	111	22	37	0	2117
6332	2003	17	21	32	0	2073
6333	2108	21	25	19	0	2173
6334	161	15	9	1978	0	2163
6335	54	20	21	2062	0	2157
6336	38	1913	12	133	0	2096
6337	55	113	1911	32	0	2111
6338	37	32	97	2017	0	2183
6339	58	23	16	2071	0	2168
6340	49	19	19	2124	0	2211
6341	39	16	1968	141	0	2164
6342	2022	24	118	40	0	2204
6343	135	26	12	2051	0	2224
6344	28	21	1996	135	0	2180
6345	28	19	109	2053	0	2209
6346	2034	18	22	150	0	2224
6347	121	2026	38	45	0	2230
6348	46	112	19	2090	0	2267
6349	35	20	2010	144	0	2209
6350	2045	21	127	30	0	2223
6351	2152	18	18	52	0	2240
6352	156	10	1993	27	0	2186
6353	37	13	122	1891	0	2063
6354	31	2007	17	108	0	2163
6355	2055	125	29	28	0	2237
6356	132	23	1961	43	0	2159
6357	2037	22	110	33	0	2202
6358	158	6	2013	38	0	2215
6359	5	3	771	2	0	781
6360	740	4	19	1	0	764
6361	15	2192	7	4	0	2218
6362	5	11	2210	3	0	2229
6363	3	2187	17	3	0	2210
6364	8	15	2211	2	0	2236
6365	3	2209	13	3	0	2228
6366	2260	15	5	1	0	2281
6367	10	4	2221	4	0	2239
6368	3	1	2029	2	0	2035
6369	2	9	1939	0	0	1950
6370	2170	1	15	1	0	2187
6371	2233	0	6	0	0	2239
6372	11	3	2	2210	0	2226
6373	5	1	2217	9	0	2232
6374	2	7	2000	3	0	2012
6375	2202	0	13	2	0	2217
6376	9	1	5	2247	0	2262
6377	2258	0	2	9	0	2269
6378	2273	0	3	2	0	2278
6379	12	0	2	2235	0	2249
6380	3	2184	3	13	0	2203
6381	4	10	1	2249	0	2264
6382	4	2	0	2260	0	2266
6383	0	3	2199	13	0	2215
6384	2	2119	10	5	0	2136
6385	1	2166	5	3	0	2175
6386	2	11	2	2247	0	2262
6387	1	5	2208	13	0	2227
6388	1	2060	12	5	0	2078
6389	1	17	2122	2	0	2142
6390	2115	3	13	2	0	2133
6391	2177	2	6	1	0	2186
6392	13	4	2148	1	0	2166
6393	2163	0	12	4	0	2179
6394	14	0	5	2212	0	2231
6395	3	2144	3	12	0	2162
6396	2	13	3	2272	0	2290
6397	2257	2	1	13	0	2273
6398	2186	1	1	3	0	2191
6399	2186	2	2	2	0	2192
6400	2195	0	2	2	0	2199
6401	11	2111	3	1	0	2126
6402	6	2114	2	2	0	2124
6403	2218	12	1	2	0	2233
6404	13	4	2155	0	0	2172
6405	5	10	9	2194	0	2218
6406	2	2185	2	6	0	2195
6407	2	10	1	2245	0	2258
6408	1	2162	3	10	0	2176
6409	2	11	0	2263	0	2276
6410	2	3	2185	10	0	2200
6411	2137	3	8	3	0	2151
6412	2205	3	3	2	0	2213
6413	11	3	2168	2	0	2184
6414	2103	0	10	1	0	2114
6415	2123	2	4	1	0	2130
6416	12	1	2178	2	0	2193
6417	4	1	11	2138	0	2154
6418	2189	0	2	10	0	2201
6419	12	5	2146	2	0	2165
6420	3	2	10	2101	0	2116
6421	2	0	2129	11	0	2142
6422	5	6	1902	3	0	1916
6423	2123	2	13	2	0	2140
6424	2188	0	4	4	0	2196
6425	2163	0	4	2	0	2169
6426	2154	0	2	1	0	2157
6427	12	0	1	2186	0	2199
6428	4	2009	2	8	0	2023
6429	3	2066	3	4	0	2076
6430	3	11	1	2142	0	2157
6431	2174	1	2	8	0	2185
6432	9	2069	2	5	0	2085
6433	1	2016	2	2	0	2021
6434	2105	8	0	0	0	2113
6435	7	1	0	2079	0	2087
6436	2100	0	1	9	0	2110
6437	6	2001	2	4	0	2013
6438	2098	9	1	0	0	2108
6439	13	4	3222	1	0	3240
6440	3343	3	93	0	0	3439
6441	3465	0	21	4	0	3490
6442	3554	2	16	3	0	3575
6443	130	9	3282	0	0	3421
6444	3312	3	86	1	0	3402
6445	113	3263	22	5	0	3403
6446	30	71	3287	2	0	3390
6447	22	25	98	3337	0	3482
6448	5	19	25	3259	0	3308
6449	8	3300	19	105	0	3432
6450	12	82	3	3425	0	3522
6451	11	20	8	3531	0	3570
6452	13	23	3358	115	0	3509
6453	3162	5	105	49	0	3321
6454	106	7	3395	21	0	3529
6455	25	6	113	3360	0	3504
6456	23	3	3400	98	0	3524
6457	9	10	109	3429	0	3557
6458	3432	5	32	115	0	3584
6459	3490	7	20	33	0	3550
6460	113	3	8	3482	0	3606
6461	48	7	1967	109	0	2131
6462	26	3	104	2074	0	2207
6463	14	2	1965	121	0	2102
6464	1995	3	116	32	0	2146
6465	2122	2	28	29	0	2181
6466	2059	4	33	8	0	2104
6467	2034	4	13	20	0	2071
6468	143	1972	16	9	0	2140
6469	57	92	7	2039	0	2195
6470	1905	30	12	106	0	2053
6471	115	1900	17	31	0	2063
6472	28	1936	5	41	0	2010
6473	24	87	1919	11	0	2041
6474	1985	41	99	18	0	2143
6475	2073	16	26	15	0	2130
6476	136	15	1921	7	0	2079
6477	53	9	103	1952	0	2117
6478	30	10	31	2050	0	2121
6479	23	5	1938	128	0	2094
6480	28	10	105	2013	0	2156
6481	1987	12	39	127	0	2165
6482	118	7	1926	41	0	2092
6483	44	10	2035	27	0	2116
6484	2010	10	129	16	0	2165
6485	116	5	1965	13	0	2099
6486	1987	6	127	14	0	2134
6487	134	1951	38	27	0	2150
6488	1998	94	39	15	0	2146
6489	129	28	17	1987	0	2161
6490	41	20	19	2082	0	2162
6491	2002	8	16	133	0	2159
6492	115	10	15	2024	0	2164
6493	1946	12	21	125	0	2104
6494	133	1955	22	47	0	2157
6495	42	99	20	1875	0	2036
6496	50	36	15	2041	0	2142
6497	1963	28	16	130	0	2137
6498	2003	8	22	57	0	2090
6499	1982	16	12	43	0	2053
6500	161	1807	18	25	0	2011
6501	63	1947	15	35	0	2060
6502	1963	105	18	36	0	2122
6503	133	45	1838	20	0	2036
6504	47	1896	107	40	0	2090
6505	1898	98	43	25	0	2064
6506	1912	36	37	22	0	2007
6507	1952	22	22	27	0	2023
6508	180	12	37	1823	0	2052
6509	1886	23	37	107	0	2053
6510	1961	22	28	38	0	2049
6511	186	16	11	1831	0	2044
6512	1880	27	34	107	0	2048
6513	155	25	1712	46	0	1938
6514	65	41	104	1801	0	2011
6515	52	27	53	1841	0	1973
6516	37	22	38	1954	0	2051
6517	1760	9	19	202	0	1990
6518	1876	27	16	81	0	2000
6519	1926	23	21	73	0	2043
6520	1912	3	27	69	0	2011
6521	1921	10	42	52	0	2025
6522	191	5	36	1772	0	2004
6523	94	2	43	1876	0	2015
6524	1736	6	37	157	0	1936
6525	127	1740	35	86	0	1988
6526	1798	93	29	64	0	1984
6527	163	29	1663	52	0	1907
6528	1816	30	110	31	0	1987
6529	1881	13	33	44	0	1971
6530	166	11	2843	31	0	3051
6531	3005	17	117	39	0	3178
6532	159	9	2961	38	0	3167
6533	97	9	3029	28	0	3163
6534	102	16	122	2915	0	3155
6535	75	22	45	3113	0	3255
6536	74	15	3061	143	0	3293
6537	61	32	3046	63	0	3202
6538	41	3043	141	63	0	3288
6539	0	1720	1	2	0	1723
6540	1658	10	5	2	0	1675
6541	6	1593	0	6	0	1605
6542	1618	6	2	0	0	1626
6543	6	1572	1	1	0	1580
6544	1586	7	0	1	0	1594
6545	6	2	1607	2	0	1617
6546	1443	0	10	0	0	1453
6547	6	2	2	1594	0	1604
6548	1	1546	0	6	0	1553
6549	1	7	0	1642	0	1650
6550	1650	2	0	6	0	1658
6551	1599	1	0	1	0	1601
6552	8	1	0	1541	0	1550
6553	3	1	1614	6	0	1624
6554	1	0	1476	1	0	1478
6555	1	1560	9	1	0	1571
6556	1	11	1	1572	0	1585
6557	0	2	1582	5	0	1589
6558	0	1403	12	2	0	1417
6559	1	6	4	1553	0	1564
6560	2	1	0	1560	0	1563
6561	1602	0	0	6	0	1608
6562	4	1	1	1516	0	1522
6563	1	0	1578	3	0	1582
6564	0	1	5	1459	0	1465
6565	1443	0	1	5	0	1449
6566	5	0	1484	2	0	1491
6567	1284	1	8	0	0	1293
6568	4	1431	2	1	0	1438
6569	1522	4	0	2	0	1528
6570	1492	1	0	2	0	1495
6571	6	0	0	1443	0	1449
6572	1	0	1	1438	0	1440
6573	0	1437	1	6	0	1444
6574	1	3	1	1524	0	1529
6575	1499	1	2	4	0	1506
6576	6	0	1481	2	0	1489
6577	2	1	4	1429	0	1436
6578	1	1428	2	4	0	1435
6579	2	4	1	1504	0	1511
6580	1	3	0	1462	0	1466
6581	1515	1	0	7	0	1523
6582	4	1456	1	2	0	1463
6583	1	6	0	1491	0	1498
6584	1489	2	1	5	0	1497
6585	5	1	1	1463	0	1470
6586	2	1	1	1459	0	1463
6587	1495	1	1	7	0	1504
6588	1369	2	1	3	0	1375
6589	7	0	1474	3	0	1484
6590	1289	1	6	1	0	1297
6591	1350	2	2	1	0	1355
6592	1376	1	0	2	0	1379
6593	8	1370	0	1	0	1379
6594	3	1401	0	6	0	1410
6595	3	7	1	1423	0	1434
6596	1443	2	1	6	0	1452
6597	1404	1	1	3	0	1409
6598	8	2	1	1363	0	1374
6599	3	2	1367	5	0	1377
6600	1281	2	6	2	0	1291
6601	1401	3	1	3	0	1408
6602	9	0	1	1314	0	1324
6603	2	6	1	1359	0	1368
6604	1421	1	1	9	0	1432
6605	6	3	3	1328	0	1340
6606	6	1345	1	7	0	1359
6607	2	4	0	1370	0	1376
6608	1376	4	3	7	0	1390
6609	9	0	1363	5	0	1377
6610	1110	3	7	0	0	1120
6611	11	0	1325	1	0	1337
6612	3	1	7	1233	0	1244
6613	1344	1	2	7	0	1354
6614	8	1	2	1228	0	1239
6615	3	6	0	1228	0	1237
6616	1298	2	0	11	0	1311
6617	10	1	1294	3	0	1308
6618	4	3	1261	1	0	1269
6619	2	0	7	1177	0	1186
6620	3	1	3	1269	0	1276
6621	2	1	3	1284	0	1290
6622	2	1	1287	10	0	1300
6623	1108	1	7	4	0	1120
6624	1242	1	2	5	0	1250
6625	1237	1	0	4	0	1242
6626	1227	0	3	2	0	1232
6627	7	1205	4	2	0	1218
6628	2	1234	2	4	0	1242
6629	3	1252	1	3	0	1259
6630	3	3	1	302	0	309
6631	1	0	2	301	0	304
6632	3	0	283	5	0	291
6633	2	249	0	0	0	251
6634	17	0	1	189	0	207
6635	183	0	0	1	0	184
6636	1	187	1	0	0	189
6637	0	0	0	178	0	178
6638	0	182	0	1	0	183
6639	184	0	0	0	0	184
6640	0	0	0	179	0	179
6641	0	0	176	0	0	176
6642	0	0	179	1	0	180
6643	0	0	0	190	0	190
6644	0	0	0	189	0	189
6645	0	0	1	196	0	197
6646	200	0	0	2	0	202
6647	3	0	204	0	0	207
6648	1	201	2	0	0	204
6649	1	2	0	205	0	208
6650	0	1	202	2	0	205
6651	0	197	2	4	0	203
6652	0	3	0	214	0	217
6653	0	0	221	3	0	224
6654	0	0	2	216	0	218
6655	0	0	1	221	0	222
6656	222	1	0	2	0	225
6657	224	0	0	1	0	225
6658	3	0	0	220	0	223
6659	222	1	0	2	0	225
6660	2	1	231	1	0	235
6661	0	1	2	230	0	233
6662	1	0	238	2	0	241
6663	0	0	2	239	0	241
6664	0	235	1	2	0	238
6665	0	240	1	0	0	241
6666	0	235	0	1	0	236
6667	0	2	0	230	0	232
6668	0	0	0	231	0	231
6669	0	0	236	2	0	238
6670	0	0	233	0	0	233
6671	0	0	252	0	0	252
6672	258	1	2	0	0	261
6673	3	0	0	286	0	289
6674	299	0	0	3	0	302
6675	4	313	0	0	0	317
6676	0	6	0	323	0	329
6677	336	0	0	6	0	342
6678	6	2	0	332	0	340
6679	345	0	0	8	0	353
6680	8	0	355	0	0	363
6681	0	359	5	1	0	365
6682	2	5	0	364	0	371
6683	366	1	1	6	0	374
6684	370	2	0	0	0	372
6685	7	0	0	369	0	376
6686	2	0	1	376	0	379
6687	370	1	0	6	0	377
6688	6	0	0	365	0	371
6689	1	0	363	8	0	372
6690	3	365	6	0	0	374
6691	0	4	0	371	0	375
6692	362	0	2	7	0	371
6693	366	2	0	1	0	369
6694	9	0	361	3	0	373
6695	2	349	8	0	0	359
6696	2	369	0	0	0	371
6697	1	5	2	367	0	375
6698	1	2	1	381	0	385
6699	1	3	0	370	0	374
6700	0	0	1	374	0	375
6701	0	357	2	8	0	367
6702	0	5	0	364	0	369
6703	0	0	0	370	0	370
6704	362	2	0	7	0	371
6705	364	0	0	3	0	367
6706	7	354	0	4	0	365
6707	370	6	0	0	0	376
6708	359	0	1	1	0	361
6709	359	2	0	2	0	363
6710	9	1	357	0	0	367
6711	4	0	6	353	0	363
6712	2	1	0	362	0	365
6713	1	1	356	7	0	365
6714	2	1	6	353	0	362
6715	1	0	1	354	0	356
6716	346	1	3	7	0	357
6717	6	0	342	5	0	353
6718	1	0	7	331	0	339
6719	335	0	2	6	0	343
6720	6	330	2	2	0	340
6721	332	6	0	5	0	343
6722	328	0	0	0	0	328
6723	6	324	1	1	0	332
6724	2	5	0	329	0	336
6725	328	1	0	6	0	335
6726	6	320	0	2	0	328
6727	3	5	0	322	0	330
6728	317	0	0	6	0	323
6729	321	3	1	1	0	326
6730	5	316	0	5	0	326
6731	317	7	0	1	0	325
6732	8	2	0	318	0	328
6733	319	2	0	10	0	331
6734	9	0	313	3	0	325
6735	3	0	6	316	0	325
6736	3	2	0	310	0	315
6737	302	1	3	9	0	315
6738	7	298	0	4	0	309
6739	305	6	0	3	0	314
6740	8	301	1	0	0	310
6741	0	8	299	1	0	308
6742	3	0	297	2	0	302
6743	2	7	6	281	0	296
6744	1	2	280	6	0	289
6745	1	0	6	277	0	284
6746	0	1	0	281	0	282
6747	1	0	3	278	0	282
6748	1226	0	3	6	0	1235
6749	1331	1	1	5	0	1338
6750	1364	0	0	3	0	1367
6751	183	1048	4	1	0	1236
6752	15	1295	8	1	0	1319
6753	5	170	1227	2	0	1404
6754	3	13	166	1299	0	1481
6755	3	8	1243	191	0	1445
6756	12	0	180	1285	0	1477
6757	17	3	8	1487	0	1515
6758	23	3	7	1509	0	1542
6759	21	7	1215	210	0	1453
6760	11	16	164	1310	0	1501
6761	1246	16	15	204	0	1481
6762	176	1238	16	20	0	1450
6763	9	181	12	1305	0	1507
6764	1257	7	13	206	0	1483
6765	1443	7	10	33	0	1493
6766	192	0	4	1283	0	1479
6767	16	1	6	1480	0	1503
6768	1257	2	12	211	0	1482
6769	195	2	6	1299	0	1502
6770	1248	5	3	209	0	1465
6771	201	13	1	1254	0	1469
6772	21	9	1087	216	0	1333
6773	28	1033	151	18	0	1230
6774	23	1225	10	20	0	1278
6775	15	171	9	1153	0	1348
6776	21	12	5	1361	0	1399
6777	1138	4	3	216	0	1361
6778	198	4	6	1173	0	1381
6779	25	3	5	1349	0	1382
6780	14	3	7	1293	0	1317
6781	10	1021	16	204	0	1251
6782	9	178	10	1144	0	1341
6783	7	22	8	1320	0	1357
6784	8	9	4	1361	0	1382
6785	1065	8	4	230	0	1307
6786	186	1042	7	43	0	1278
6787	18	153	4	1149	0	1324
6788	16	12	1	1331	0	1360
6789	11	11	2	1357	0	1381
6790	1113	14	3	228	0	1358
6791	201	7	4	1145	0	1357
6792	26	9	4	1342	0	1381
6793	19	12	1021	234	0	1286
6794	22	1075	151	39	0	1287
6795	17	187	15	1134	0	1353
6796	1063	17	10	223	0	1313
6797	185	1077	7	53	0	1322
6798	1102	178	5	51	0	1336
6799	1284	11	9	42	0	1346
6800	205	13	6	1151	0	1375
6801	28	7	13	1352	0	1400
6802	30	9	1057	228	0	1324
6803	37	20	171	1170	0	1398
6804	36	22	1065	227	0	1350
6805	40	25	171	1164	0	1400
6806	1088	34	14	224	0	1360
6807	201	1062	19	41	0	1323
6808	41	180	17	1127	0	1365
6809	19	16	12	1345	0	1392
6810	15	8	22	1344	0	1389
6811	17	8	19	1370	0	1414
6812	1102	4	16	267	0	1389
6813	196	1048	29	69	0	1342
6814	25	192	22	1177	0	1416
6815	1155	28	8	236	0	1427
6816	215	35	1056	53	0	1359
6817	1123	27	171	60	0	1381
6818	1299	13	10	71	0	1393
6819	227	10	145	1002	0	1384
6820	42	17	11	1334	0	1404
6821	1104	19	8	263	0	1394
6822	212	1126	11	72	0	1421
6823	1157	201	9	68	0	1435
6824	1314	14	23	55	0	1406
6825	1323	11	23	59	0	1416
6826	237	11	18	1153	0	1419
6827	44	23	14	1270	0	1351
6828	25	1117	16	236	0	1394
6829	31	184	6	1194	0	1415
6830	1159	29	6	250	0	1444
6831	224	30	1068	70	0	1392
6832	1168	14	180	60	0	1422
6833	1345	13	7	60	0	1425
6834	233	10	9	1192	0	1444
6835	36	19	10	1384	0	1449
6836	1125	19	9	270	0	1423
6837	1309	26	9	78	0	1422
6838	1328	14	3	75	0	1420
6839	245	16	1060	48	0	1369
6840	51	1089	177	45	0	1362
6841	1144	184	18	50	0	1396
6842	223	18	16	1071	0	1328
6843	36	1063	6	238	0	1343
6844	39	185	8	1190	0	1422
6845	1139	17	11	244	0	1411
6846	231	15	10	1181	0	1437
6847	54	8	1142	256	0	1460
6848	1	136	10	2	0	149
6849	1	150	0	3	0	154
6850	3	10	134	0	0	147
6851	107	1	7	8	0	123
6852	9	110	1	0	0	120
6853	0	2	0	76	0	78
6854	74	0	0	2	0	76
6855	3	77	0	0	0	80
6856	1	2	0	78	0	81
6857	81	0	0	2	0	83
6858	2	0	1	81	0	84
6859	80	1	0	2	0	83
6860	3	0	84	0	0	87
6861	0	83	2	1	0	86
6862	100	2	0	0	0	102
6863	101	0	0	1	0	102
6864	105	0	0	0	0	105
6865	2	0	101	1	0	104
6866	100	0	2	0	0	102
6867	103	1	0	0	0	104
6868	2	1	0	101	0	104
6869	101	0	0	2	0	103
6870	3	98	1	0	0	102
6871	0	3	0	100	0	103
6872	0	0	100	3	0	103
6873	0	0	2	95	0	97
6874	0	0	0	103	0	103
6875	101	0	0	3	0	104
6876	102	0	0	0	0	102
6877	2	0	99	1	0	102
6878	97	0	2	0	0	99
6879	2	0	109	0	0	111
6880	0	0	2	105	0	107
6881	1	0	108	2	0	111
6882	1	0	1	111	0	113
6883	1	105	0	3	0	109
6884	0	3	120	0	0	123
6885	1	0	140	0	0	141
6886	1	0	4	131	0	136
6887	139	0	0	5	0	144
6888	148	0	0	0	0	148
6889	146	1	0	0	0	147
6890	4	0	0	142	0	146
6891	0	0	1	147	0	148
6892	0	0	0	148	0	148
6893	0	0	0	150	0	150
6894	1	0	142	4	0	147
6895	1	0	4	141	0	146
6896	0	137	2	3	0	142
6897	0	4	0	142	0	146
6898	149	0	1	4	0	154
6899	5	0	144	1	0	150
6900	137	0	6	0	0	143
6901	5	0	142	0	0	147
6902	0	1	142	0	0	143
6903	0	136	6	0	0	142
6904	0	5	1	142	0	148
6905	0	0	0	147	0	147
6906	1	138	1	5	0	145
6907	151	6	0	0	0	157
6908	7	0	1	162	0	170
6909	0	0	0	180	0	180
6910	1	0	0	182	0	183
6911	203	0	0	7	0	210
6912	235	0	0	2	0	237
6913	9	0	1	225	0	235
6914	0	0	0	232	0	232
6915	220	1	0	9	0	230
6916	10	0	0	226	0	236
6917	1	0	0	232	0	233
6918	0	0	1	235	0	236
6919	4	0	220	9	0	233
6920	213	0	10	1	0	224
6921	225	0	1	1	0	227
6922	10	0	202	1	0	213
6923	2	0	9	199	0	210
6924	1	205	0	11	0	217
6925	205	7	0	2	0	214
6926	6	200	1	1	0	208
6927	0	205	0	5	0	210
6928	0	7	0	203	0	210
6929	202	0	1	7	0	210
6930	207	1	2	1	0	211
6931	10	1	0	199	0	210
6932	1	0	1	204	0	206
6933	0	0	1	206	0	207
6934	1	1	0	205	0	207
6935	2	1	0	205	0	208
6936	2	197	1	6	0	206
6937	0	9	0	201	0	210
6938	197	3	0	8	0	208
6939	208	0	0	3	0	211
6940	205	1	0	0	0	206
6941	8	198	0	2	0	208
6942	1	7	0	203	0	211
6943	2	0	196	11	0	209
6944	198	0	7	3	0	208
6945	7	0	0	203	0	210
6946	196	2	0	11	0	209
6947	200	2	1	3	0	206
6948	202	0	1	3	0	206
6949	11	0	0	193	0	204
6950	195	1	0	8	0	204
6951	9	1	1	192	0	203
6952	2	2	0	201	0	205
6953	192	1	1	11	0	205
6954	11	0	1	189	0	201
6955	190	1	1	9	0	201
6956	195	0	0	4	0	199
6957	12	0	1	184	0	197
6958	5	0	0	189	0	194
6959	4	0	0	195	0	199
6960	3	1	172	10	0	186
6961	5	0	181	3	0	189
6962	1	1	7	170	0	179
6963	1	1	0	175	0	177
6964	2	0	0	175	0	177
6965	2	1	1	177	0	181
6966	3	0	0	179	0	182
6967	171	0	0	10	0	181
6968	8	166	0	6	0	180
6969	2	7	0	173	0	182
6970	166	1	1	12	0	180
6971	7	0	3	169	0	179
6972	0	2	2	177	0	181
6973	168	0	0	12	0	180
6974	174	0	0	4	0	178
6975	12	0	161	4	0	177
6976	2	0	7	171	0	180
6977	3	1	164	10	0	178
6978	2	1	7	166	0	176
6979	1	2	2	163	0	168
6980	2	0	0	168	0	170
6981	3	0	147	10	0	160
6982	2	152	6	4	0	164
6983	2	158	0	4	0	164
6984	5	4	0	141	0	150
6985	129	0	1	7	0	137
6986	6	2	126	3	0	137
6987	1	1	132	4	0	138
6988	1	0	7	126	0	134
6989	2	0	2	129	0	133
6990	0	125	2	8	0	135
6991	1	4	2	128	0	135
6992	1	1	2	139	0	143
6993	0	2	0	143	0	145
6994	134	2	0	9	0	145
6995	139	0	1	4	0	144
6996	8	1	1	135	0	145
6997	0	135	3	6	0	144
6998	1	3	1	132	0	137
6999	127	0	0	7	0	134
7000	4	128	1	4	0	137
7001	0	5	1	127	0	133
7002	1	126	0	10	0	137
7003	128	4	0	3	0	135
7004	126	3	1	2	0	132
7005	6	123	0	4	0	133
7006	3	123	1	2	0	129
7007	2	4	111	5	0	122
7008	1	100	3	3	0	107
7009	3	4	0	86	0	93
7010	2	1	85	4	0	92
7011	0	63	1	0	0	64
7012	0	0	0	36	0	36
7013	0	0	0	38	0	38
7014	1	0	0	37	0	38
7015	34	0	0	0	0	34
7016	0	0	34	0	0	34
7017	0	0	40	0	0	40
7018	0	0	0	39	0	39
7019	0	11	2756	0	0	2767
7020	0	2	2	2441	0	2445
7021	1	1	1	2793	0	2796
7022	1	0	0	2991	0	2992
7023	0	0	0	2999	0	2999
7024	3027	0	0	0	0	3027
7025	2925	0	1	0	0	2926
7026	0	0	0	2981	0	2981
7027	1	0	3012	0	0	3013
7028	0	1	0	2892	0	2893
7029	0	2784	4	0	0	2788
7030	0	0	0	3070	0	3070
7031	3074	0	0	0	0	3074
7032	2994	0	0	0	0	2994
7033	0	0	1	2938	0	2939
7034	0	1	0	2926	0	2927
7035	0	0	0	3021	0	3021
7036	3030	0	0	1	0	3031
7037	1	4	2906	0	0	2911
7038	1	3	2876	1	0	2881
7039	0	2753	1	1	0	2755
7040	3061	0	0	0	0	3061
7041	0	3	0	2793	0	2796
7042	3	0	3046	0	0	3049
7043	0	2816	3	0	0	2819
7044	0	2909	1	0	0	2910
7045	0	0	0	3026	0	3026
7046	0	0	0	2987	0	2987
7047	0	2862	2	1	0	2865
7048	0	0	0	3069	0	3069
7049	0	0	0	3019	0	3019
7050	3075	0	0	0	0	3075
7051	0	2923	1	0	0	2924
7052	0	0	0	3038	0	3038
7053	2	0	2996	0	0	2998
7054	0	0	0	2806	0	2806
7055	3085	0	0	0	0	3085
7056	1	2843	2	0	0	2846
7057	0	0	0	3020	0	3020
7058	2	0	2985	0	0	2987
7059	3	4	2668	0	0	2675
7060	0	0	2	2685	0	2687
7061	0	0	0	2886	0	2886
7062	3065	0	0	0	0	3065
7063	0	2851	0	0	0	2851
7064	3003	0	2	0	0	3005
7065	2	0	2933	0	0	2935
7066	2335	2	2	1	0	2340
7067	2	0	2876	0	0	2878
7068	2440	0	4	2	0	2446
7069	2630	0	2	0	0	2632
7070	1	2	2773	0	0	2776
7071	1	2	2515	0	0	2518
7072	0	2288	8	2	0	2298
7073	0	1	0	2771	0	2772
7074	2863	0	1	0	0	2864
7075	0	1	0	2688	0	2689
7076	1	1	0	2670	0	2672
7077	0	0	0	2772	0	2772
7078	1	14	5008	0	0	5023
7079	4237	1	8	7	0	4253
7080	5010	1	1	0	0	5012
7081	0	4951	7	3	0	4961
7082	0	0	0	5302	0	5302
7083	2	5104	3	3	0	5112
7084	0	1	1	5286	0	5288
7085	5363	0	0	0	0	5363
7086	0	4929	10	0	0	4939
7087	0	0	0	5286	0	5286
7088	5323	0	1	0	0	5324
7089	5097	1	1	1	0	5100
7090	0	1	0	5090	0	5091
7091	2	4	5206	0	0	5212
7092	1	4	0	5040	0	5045
7093	0	4997	4	2	0	5003
7094	5311	0	0	0	0	5311
7095	1	4966	5	0	0	4972
7096	1	1	0	5161	0	5163
7097	5284	0	0	0	0	5284
7098	1	1	1	4983	0	4986
7099	0	2	0	4973	0	4975
7100	3	2	5102	1	0	5108
7101	1	4743	6	3	0	4753
7102	5003	0	1	0	0	5004
7103	4608	2	5	1	0	4616
7104	0	4889	5	2	0	4896
7105	0	5038	5	2	0	5045
7106	0	0	0	5158	0	5158
7107	5171	1	0	0	0	5172
7108	0	4980	0	2	0	4982
7109	0	0	0	5084	0	5084
7110	0	1	4981	0	0	4982
7111	0	3	2	4710	0	4715
7112	5166	0	0	0	0	5166
7113	0	4778	9	2	0	4789
7114	0	3	0	5031	0	5034
7115	1	2	4866	0	0	4869
7116	1	3	4541	1	0	4546
7117	1	5	1	4435	0	4442
7118	1	0	2	4727	0	4730
7119	0	2587	2	1	0	2590
7120	0	0	0	2710	0	2710
7121	2748	0	0	1	0	2749
7122	0	0	1	2661	0	2662
7123	2708	0	1	0	0	2709
7124	1	2549	3	1	0	2554
7125	4	2581	0	0	0	2585
7126	0	1	0	2718	0	2719
7127	0	0	0	2689	0	2689
7128	2	2	2620	2	0	2626
7129	1	1	0	2496	0	2498
7130	2655	0	0	1	0	2656
7131	2	1	2573	1	0	2577
7132	1	0	1	2513	0	2515
7133	1	1	2619	1	0	2622
7134	0	0	1	2565	0	2566
7135	0	1	1	2468	0	2470
7136	0	0	0	2600	0	2600
7137	0	1	2579	1	0	2581
7138	2	1	1	2431	0	2435
7139	0	2402	3	2	0	2407
7140	0	1	0	2643	0	2644
7141	1	0	0	2572	0	2573
7142	2642	0	0	2	0	2644
7143	3	5	2428	1	0	2437
7144	1	0	2	2457	0	2460
7145	1	3	2464	1	0	2469
7146	1	3	2219	2	0	2225
7147	2	2	1	2321	0	2326
7148	0	3	1	2286	0	2290
7149	0	0	0	2469	0	2469
7150	2487	0	0	3	0	2490
7151	2	2	2348	0	0	2352
7152	1493	26	26	24	0	1569
7153	1	0	1	2443	0	2445
7154	0	1	1	2439	0	2441
7155	0	2399	2	2	0	2403
7156	1	1	0	2504	0	2506
7157	0	1	0	2448	0	2449
7158	0	0	0	2426	0	2426
7159	2352	0	4	1	0	2357
7160	1	2	2363	0	0	2366
7161	1817	2	4	7	0	1830
7162	1	2255	1	4	0	2261
7163	2350	2	0	0	0	2352
7164	1	2280	0	2	0	2283
7165	2	2273	0	1	0	2276
7166	0	1	3	2361	0	2365
7167	2358	0	4	1	0	2363
7168	2	1	0	2285	0	2288
7169	0	2251	2	1	0	2254
7170	0	4348	2	1	0	4351
7171	3	205	0	4482	0	4690
7172	2	118	0	4498	0	4618
7173	0	4330	6	332	0	4668
7174	1	237	0	4670	0	4908
7175	0	127	2	4750	0	4879
7176	2	69	0	4889	0	4960
7177	4482	42	4	428	0	4956
7178	226	26	2282	244	0	2778
7179	2600	13	191	137	0	2941
7180	2703	12	117	89	0	2921
7181	2835	15	61	48	0	2959
7182	425	2461	45	38	0	2969
7183	250	223	16	2526	0	3015
7184	2594	133	7	247	0	2981
7185	307	65	2	2658	0	3032
7186	2521	52	5	311	0	2889
7187	307	2488	9	194	0	2998
7188	2753	231	10	90	0	3084
7189	2805	125	11	73	0	3014
7190	2969	73	2	36	0	3080
7191	447	68	1	2585	0	3101
7192	265	39	0	2850	0	3154
7193	2662	28	2	390	0	3082
7194	307	2292	7	250	0	2856
7195	181	2666	4	161	0	3012
7196	2669	330	11	129	0	3139
7197	317	209	7	2656	0	3189
7198	183	138	10	2878	0	3209
7199	135	85	2	2960	0	3182
7200	100	2600	8	470	0	3178
7201	2684	248	5	340	0	3277
7202	281	146	9	2763	0	3199
7203	180	2569	12	388	0	3149
7204	162	278	9	2822	0	3271
7205	120	165	29	2946	0	3260
7206	126	98	10	3036	0	3270
7207	110	78	8	3112	0	3308
7208	2752	45	6	525	0	3328
7209	2909	51	1	329	0	3290
7210	3045	28	6	239	0	3318
7211	494	62	2	2821	0	3379
7212	316	47	2577	373	0	3313
7213	221	52	2722	234	0	3229
7214	156	98	2839	138	0	3231
7215	2789	42	380	164	0	3375
7216	330	35	219	2859	0	3443
7217	221	24	123	3056	0	3424
7218	175	35	74	3193	0	3477
7219	2792	45	55	521	0	3413
7220	2977	58	27	334	0	3396
7221	454	2746	19	242	0	3461
7222	281	287	26	2946	0	3540
7223	207	198	2510	362	0	3277
7224	133	2694	224	317	0	3368
7225	116	278	124	2940	0	3458
7226	107	153	65	3195	0	3520
7227	121	125	54	3224	0	3524
7228	140	126	27	3292	0	3585
7229	142	75	2571	606	0	3394
7230	144	89	2689	377	0	3299
7231	121	2772	313	294	0	3500
7232	78	260	201	2991	0	3530
7233	87	154	119	3254	0	3614
7234	2908	89	81	527	0	3605
7235	366	111	2684	322	0	3483
7236	259	76	244	3026	0	3605
7237	230	47	153	3214	0	3644
7238	189	29	2785	518	0	3521
7239	148	2859	317	317	0	3641
7240	2979	277	202	257	0	3715
7241	291	209	2864	217	0	3581
7242	3106	114	289	171	0	3680
7243	385	105	2937	204	0	3631
7244	276	96	291	3030	0	3693
7245	183	68	2928	418	0	3597
7246	170	57	3571	309	0	4107
7247	134	47	408	3674	0	4263
7248	96	68	235	3931	0	4330
7249	114	64	157	4117	0	4452
7250	109	57	117	4082	0	4365
7251	132	61	60	4210	0	4463
7252	78	65	3374	670	0	4187
7253	74	58	3461	440	0	4033
7254	76	5392	403	317	0	6188
7255	5513	569	264	266	0	6612
7256	625	169	195	5680	0	6669
7257	5664	109	139	726	0	6638
7258	690	113	67	5884	0	6754
7259	5781	66	62	818	0	6727
7260	722	35	56	5915	0	6728
7261	319	44	82	6126	0	6571
7262	158	5246	106	836	0	6346
7263	118	529	95	5960	0	6702
7264	78	166	95	6405	0	6744
7265	71	132	90	6443	0	6736
7266	107	97	58	6244	0	6506
7267	117	5421	59	941	0	6538
7268	5402	560	66	448	0	6476
7269	634	5657	69	359	0	6719
7270	10	310	0	3432	0	3752
7271	3404	13	1	342	0	3760
7272	334	14	3217	18	0	3583
7273	12	13	3465	16	0	3506
7274	10	10	290	3253	0	3563
7275	7	10	15	3631	0	3663
7276	7	11	8	3638	0	3664
7277	11	6	3	3637	0	3657
7278	11	7	2	3564	0	3584
7279	9	3215	11	330	0	3565
7280	9	311	6	3433	0	3759
7281	3323	12	6	354	0	3695
7282	314	9	6	3443	0	3772
7283	23	17	3280	355	0	3675
7284	17	11	294	3400	0	3722
7285	3259	8	10	369	0	3646
7286	311	3280	8	46	0	3645
7287	23	322	3	3952	0	4300
7288	22	30	0	4356	0	4408
7289	31	21	3829	385	0	4266
7290	21	23	4235	58	0	4337
7291	4406	23	328	53	0	4810
7292	377	15	19	4568	0	4979
7293	48	27	15	4974	0	5064
7294	44	27	4610	434	0	5115
7295	35	23	4675	99	0	4832
7296	35	4592	343	77	0	5047
7297	29	367	31	4756	0	5183
7298	33	37	4496	448	0	5014
7299	32	4682	356	88	0	5158
7300	4704	403	34	94	0	5235
7301	5100	54	25	75	0	5254
7302	411	34	20	4656	0	5121
7303	47	4785	16	436	0	5284
7304	4838	424	22	97	0	5381
7305	424	70	29	4204	0	4727
7306	80	64	4508	360	0	5012
7307	101	4682	364	114	0	5261
7308	4763	407	34	122	0	5326
7309	5064	47	29	132	0	5272
7310	452	41	30	4876	0	5399
7311	79	53	36	5297	0	5465
7312	50	41	4596	549	0	5236
7313	57	61	356	4924	0	5398
7314	62	55	35	5174	0	5326
7315	54	40	41	5216	0	5351
7316	72	53	33	5270	0	5428
7317	71	48	30	5054	0	5203
7318	70	4664	29	514	0	5277
7319	4800	430	28	198	0	5456
7320	463	77	4471	170	0	5181
7321	87	4544	397	171	0	5199
7322	72	394	89	4834	0	5389
7323	4655	49	75	556	0	5335
7324	389	59	70	4812	0	5330
7325	78	55	55	5132	0	5320
7326	58	54	50	5191	0	5353
7327	58	58	42	5235	0	5393
7328	56	97	4443	551	0	5147
7329	63	4583	386	231	0	5263
7330	4736	412	67	167	0	5382
7331	444	84	4571	183	0	5282
7332	66	42	453	4783	0	5344
7333	4646	51	87	543	0	5327
7334	443	4634	94	165	0	5336
7335	4658	450	68	167	0	5343
7336	456	77	41	4735	0	5309
7337	90	61	60	5150	0	5361
7338	71	80	81	5099	0	5331
7339	74	56	69	5192	0	5391
7340	4678	41	66	557	0	5342
7341	449	54	70	4734	0	5307
7342	89	43	75	5190	0	5397
7343	4631	39	64	576	0	5310
7344	457	43	4376	201	0	5077
7345	77	78	409	4674	0	5238
7346	3910	57	98	553	0	4618
7347	4283	56	83	186	0	4608
7348	435	66	80	4031	0	4612
7349	97	43	85	4292	0	4517
7350	111	3815	71	527	0	4524
7351	105	420	65	4011	0	4601
7352	87	84	58	4439	0	4668
7353	100	70	3849	590	0	4609
7354	7	8	1906	39	0	1960
7355	7	1914	66	22	0	2009
7356	8	64	12	1897	0	1981
7357	12	7	12	1992	0	2023
7358	1910	8	14	85	0	2017
7359	65	9	13	1891	0	1978
7360	15	8	1838	78	0	1939
7361	13	9	62	1897	0	1981
7362	12	10	1795	82	0	1899
7363	15	10	1845	26	0	1896
7364	13	6	74	1815	0	1908
7365	12	6	20	1907	0	1945
7366	1843	12	12	82	0	1949
7367	1901	2	11	32	0	1946
7368	74	6	14	1859	0	1953
7369	1854	8	10	81	0	1953
7370	1916	4	4	33	0	1957
7371	80	5	9	1858	0	1952
7372	17	7	6	1923	0	1953
7373	1842	6	6	84	0	1938
7374	1895	7	2	25	0	1929
7375	82	4	5	1825	0	1916
7376	18	1809	8	85	0	1920
7377	14	60	8	1851	0	1933
7378	23	9	8	1902	0	1942
7379	15	5	1751	84	0	1855
7380	8	7	51	1866	0	1932
7381	1756	2	13	91	0	1862
7382	67	1803	12	28	0	1910
7383	1809	52	7	40	0	1908
7384	1855	12	9	28	0	1904
7385	1871	8	8	19	0	1906
7386	75	13	7	1806	0	1901
7387	18	5	1114	63	0	1200
7388	18	6	1118	12	0	1154
7389	20	1103	55	9	0	1187
7390	10	853	13	10	0	886
7391	4	463	4	5	0	476
7392	2	415	13	4	0	434
7393	11	16	375	3	0	405
7394	205	4	9	4	0	222
7395	2	0	0	209	0	211
7396	0	0	0	206	0	206
7397	0	0	0	204	0	204
7398	0	204	0	1	0	205
7399	204	2	0	0	0	206
7400	2	0	205	0	0	207
7401	0	189	2	0	0	191
7402	0	4	0	192	0	196
7403	190	0	0	2	0	192
7404	2	0	0	184	0	186
7405	0	0	181	2	0	183
7406	0	0	180	0	0	180
7407	0	0	2	182	0	184
7408	0	0	1	184	0	185
7409	186	0	0	0	0	186
7410	1	0	186	0	0	187
7411	188	0	1	0	0	189
7412	187	0	0	0	0	187
7413	1	0	0	192	0	193
7414	0	0	192	1	0	193
7415	0	0	1	196	0	197
7416	196	0	0	1	0	197
7417	0	193	0	0	0	193
7418	200	1	0	0	0	201
7419	1	0	0	196	0	197
7420	0	195	0	2	0	197
7421	0	2	0	198	0	200
7422	0	0	0	200	0	200
7423	0	201	0	2	0	203
7424	1	2	0	201	0	204
7425	0	0	0	204	0	204
7426	0	0	0	222	0	222
7427	0	0	230	4	0	234
7428	0	230	4	0	0	234
7429	243	5	1	0	0	249
7430	4	1	0	248	0	253
7431	1	266	1	4	0	272
7432	271	4	0	1	0	276
7433	4	1	0	277	0	282
7434	1	1	0	274	0	276
7435	1	0	0	270	0	271
7436	0	0	0	269	0	269
7437	259	0	0	7	0	266
7438	4	0	0	268	0	272
7439	1	0	0	272	0	273
7440	271	0	0	6	0	277
7441	4	0	0	272	0	276
7442	1	0	260	5	0	266
7443	1	0	5	262	0	268
7444	260	0	1	6	0	267
7445	5	0	1	259	0	265
7446	1	0	252	6	0	259
7447	1	0	258	1	0	260
7448	261	0	5	1	0	267
7449	268	0	2	0	0	270
7450	268	0	1	0	0	269
7451	267	0	0	0	0	267
7452	7	1	257	1	0	266
7453	2	0	4	258	0	264
7454	1	0	1	266	0	268
7455	261	0	1	6	0	268
7456	3	0	0	265	0	268
7457	1	0	256	6	0	263
7458	1	4	5	253	0	263
7459	0	0	254	6	0	260
7460	0	252	5	1	0	258
7461	260	5	2	1	0	268
7462	5	1	1	257	0	264
7463	1	1	251	5	0	258
7464	1	0	4	252	0	257
7465	0	0	0	261	0	261
7466	0	0	262	5	0	267
7467	0	0	4	262	0	266
7468	262	0	2	7	0	271
7469	5	1	250	2	0	258
7470	241	0	4	2	0	247
7471	7	240	1	0	0	248
7472	2	5	242	0	0	249
7473	2	2	243	0	0	247
7474	0	5	6	210	0	221
7475	0	0	4	216	0	220
7476	0	1	214	6	0	221
7477	1	0	4	217	0	222
7478	222	0	2	7	0	231
7479	226	1	2	2	0	231
7480	7	0	0	219	0	226
7481	4	0	0	228	0	232
7482	2	222	0	5	0	229
7483	221	3	0	5	0	229
7484	4	2	0	227	0	233
7485	3	230	0	2	0	235
7486	229	4	0	3	0	236
7487	226	2	0	2	0	230
7488	5	230	0	0	0	235
7489	4	3	0	230	0	237
7490	1	2	1	231	0	235
7491	0	2	216	5	0	223
7492	1	0	4	223	0	228
7493	219	1	2	7	0	229
7494	5	0	3	220	0	228
7495	2	0	215	7	0	224
7496	215	0	4	3	0	222
7497	4	0	2	218	0	224
7498	3	0	211	4	0	218
7499	4	0	4	216	0	224
7500	0	0	210	7	0	217
7501	0	0	5	213	0	218
7502	1	0	2	217	0	220
7503	214	0	2	7	0	223
7504	4	214	1	4	0	223
7505	215	4	1	3	0	223
7506	218	2	0	1	0	221
7507	208	2	1	1	0	212
7508	8	211	1	0	0	220
7509	4	6	209	0	0	219
7510	3	2	5	207	0	217
7511	208	1	3	5	0	217
7512	211	0	2	4	0	217
7513	8	0	0	205	0	213
7514	203	0	2	5	0	210
7515	7	0	196	4	0	207
7516	200	0	5	3	0	208
7517	8	0	200	1	0	209
7518	2	197	7	0	0	206
7519	200	5	2	0	0	207
7520	195	2	2	1	0	200
7521	4	197	2	0	0	203
7522	197	5	0	1	0	203
7523	196	2	0	1	0	199
7524	6	2	191	1	0	200
7525	189	0	5	1	0	195
7526	7	0	179	1	0	187
7527	1	5	3	144	0	153
7528	1	149	2	1	0	153
7529	2	2	143	2	0	149
7530	122	6	2	6	0	136
7531	108	1	4	1	0	114
7532	2	0	1	102	0	105
7533	2	0	99	1	0	102
7534	1	0	1	108	0	110
7535	106	0	1	2	0	109
7536	1	107	1	1	0	110
7537	110	1	0	1	0	112
7538	110	1	0	0	0	111
7539	2	107	0	0	0	109
7540	2	1	0	109	0	112
7541	108	1	0	1	0	110
7542	1	1	0	113	0	115
7543	1	0	0	120	0	121
7544	1	0	120	2	0	123
7545	0	0	1	122	0	123
7546	0	0	1	123	0	124
7547	115	0	1	4	0	120
7548	116	0	0	2	0	118
7549	2	0	0	119	0	121
7550	1	0	121	2	0	124
7551	1	0	117	1	0	119
7552	0	0	2	116	0	118
7553	0	0	124	1	0	125
7554	0	0	3	120	0	123
7555	0	0	1	121	0	122
7556	122	0	1	2	0	125
7557	1	0	118	2	0	121
7558	123	0	1	1	0	125
7559	117	0	1	0	0	118
7560	2	0	124	0	0	126
7561	2	0	121	0	0	123
7562	1	5	2	117	0	125
7563	0	112	2	1	0	115
7564	0	112	1	2	0	115
7565	0	1	0	107	0	108
7566	0	0	1	101	0	102
7567	0	0	0	102	0	102
7568	0	0	0	102	0	102
7569	103	0	0	1	0	104
7570	1	0	0	101	0	102
7571	0	0	102	2	0	104
7572	0	0	2	102	0	104
7573	0	101	0	2	0	103
7574	0	1	0	102	0	103
7575	101	0	0	1	0	102
7576	2	0	0	107	0	109
7577	0	0	106	2	0	108
7578	0	98	1	0	0	99
7579	0	1	1	102	0	104
7580	102	0	0	2	0	104
7581	102	0	0	0	0	102
7582	1	0	0	104	0	105
7583	0	0	96	2	0	98
7584	1	0	96	0	0	97
7585	95	0	2	0	0	97
7586	2	1	96	0	0	99
7587	1	0	93	0	0	94
7588	0	0	1	88	0	89
7589	98	0	1	1	0	100
7590	97	0	0	0	0	97
7591	98	1	0	0	0	99
7592	1	1	99	0	0	101
7593	0	0	92	0	0	92
7594	0	95	1	1	0	97
7595	0	1	0	101	0	102
7596	0	0	0	98	0	98
7597	1	0	0	95	0	96
7598	0	0	0	101	0	101
7599	0	0	100	1	0	101
7600	0	95	2	1	0	98
7601	100	2	0	0	0	102
7602	118	0	0	1	0	119
7603	121	0	0	0	0	121
7604	2	126	0	1	0	129
7605	0	2	1	128	0	131
7606	150	1	0	2	0	153
7607	3	156	0	1	0	160
7608	150	2	0	0	0	152
7609	3	151	0	0	0	154
7610	154	2	0	1	0	157
7611	153	0	1	0	0	154
7612	2	0	1	149	0	152
7613	1	0	0	156	0	157
7614	0	0	153	2	0	155
7615	0	0	154	0	0	154
7616	151	0	3	1	0	155
7617	155	0	0	0	0	155
7618	4	0	0	153	0	157
7619	1	0	0	156	0	157
7620	0	0	153	3	0	156
7621	0	0	4	147	0	151
7622	0	1	146	3	0	150
7623	0	0	2	149	0	151
7624	0	0	0	147	0	147
7625	147	0	0	4	0	151
7626	141	0	0	1	0	142
7627	2	0	1	138	0	141
7628	0	1	0	145	0	146
7629	1	0	138	3	0	142
7630	1	0	3	139	0	143
7631	2	0	139	3	0	144
7632	140	0	3	0	0	143
7633	3	1	0	141	0	145
7634	137	0	0	4	0	141
7635	4	134	0	0	0	138
7636	135	4	0	0	0	139
7637	4	1	0	136	0	141
7638	1	1	0	134	0	136
7639	2	132	0	3	0	137
7640	1	3	0	130	0	134
7641	0	1	129	5	0	135
7642	0	0	3	126	0	129
7643	0	1	118	3	0	122
7644	1	112	3	0	0	116
7645	2	3	0	117	0	122
7646	1	0	118	4	0	123
7647	0	0	118	2	0	120
7648	0	0	4	120	0	124
7649	118	0	4	3	0	125
7650	4	0	113	3	0	120
7651	0	0	4	114	0	118
7652	116	0	0	5	0	121
7653	3	111	0	2	0	116
7654	120	3	2	0	0	125
7655	4	0	1	120	0	125
7656	1	0	1	123	0	125
7657	0	0	0	120	0	120
7658	117	0	1	5	0	123
7659	4	0	0	116	0	120
7660	1	0	1	117	0	119
7661	111	0	0	5	0	116
7662	3	0	110	2	0	115
7663	1	0	4	110	0	115
7664	0	1	109	5	0	115
7665	115	0	4	0	0	119
7666	5	0	0	115	0	120
7667	0	0	114	6	0	120
7668	114	1	3	0	0	118
7669	119	1	0	0	0	120
7670	4	0	114	1	0	119
7671	0	0	4	120	0	124
7672	1	0	1	121	0	123
7673	0	2	118	4	0	124
7674	0	119	3	2	0	124
7675	0	4	123	0	0	127
7676	120	0	3	1	0	124
7677	3	0	122	2	0	127
7678	118	1	3	1	0	123
7679	3	1	120	1	0	125
7680	117	0	4	2	0	123
7681	4	123	1	0	0	128
7682	0	4	0	125	0	129
7683	2	0	0	131	0	133
7684	0	1	126	4	0	131
7685	0	0	3	127	0	130
7686	2	126	1	3	0	132
7687	127	5	1	0	0	133
7688	5	129	0	2	0	136
7689	1	3	0	130	0	134
7690	128	0	1	5	0	134
7691	1	130	1	3	0	135
7692	137	4	0	1	0	142
7693	4	1	138	2	0	145
7694	2	0	4	142	0	148
7695	2	0	0	141	0	143
7696	0	0	3	144	0	147
7697	151	0	0	7	0	158
7698	156	0	1	0	0	157
7699	159	0	1	1	0	161
7700	155	0	0	4	0	159
7701	5	0	150	1	0	156
7702	125	0	2	0	0	127
7703	5	125	0	1	0	131
7704	0	117	4	1	0	122
7705	104	3	14	2	0	123
7706	100	0	0	2	0	102
7707	2	0	2	91	0	95
7708	94	1	0	2	0	97
7709	96	0	1	0	0	97
7710	103	0	1	0	0	104
7711	2	1	1	100	0	104
7712	1	103	0	3	0	107
7713	0	105	2	0	0	107
7714	1	2	0	103	0	106
7715	103	1	0	1	0	105
7716	1	103	0	1	0	105
7717	0	1	1	103	0	105
7718	0	0	104	1	0	105
7719	97	0	0	1	0	98
7720	1	107	0	0	0	108
7721	1	109	0	0	0	110
7722	109	2	0	0	0	111
7723	1	1	111	1	0	114
7724	1	0	1	108	0	110
7725	0	115	1	1	0	117
7726	1	1	0	115	0	117
7727	0	1	1	113	0	115
7728	0	113	0	3	0	116
7729	0	1	0	117	0	118
7730	0	1	0	119	0	120
7731	118	0	0	2	0	120
7732	2	115	0	1	0	118
7733	120	1	0	0	0	121
7734	2	1	0	117	0	120
7735	1	120	1	1	0	123
7736	1	1	118	1	0	121
7737	0	1	1	115	0	117
7738	1	1	1	122	0	125
7739	1	0	121	2	0	124
7740	123	0	1	1	0	125
7741	1	0	1	133	0	135
7742	135	0	0	1	0	136
7743	2	0	134	1	0	137
7744	2	0	1	140	0	143
7745	0	0	152	2	0	154
7746	0	1	1	156	0	158
7747	0	1	1	159	0	161
7748	156	0	0	3	0	159
7749	2	157	0	1	0	160
7750	161	2	0	0	0	163
7751	1	1	156	5	0	163
7752	1	0	1	166	0	168
7753	0	0	169	1	0	170
7754	153	0	1	1	0	155
7755	160	0	1	0	0	161
7756	2	0	162	0	0	164
7757	161	0	1	0	0	162
7758	163	0	1	0	0	164
7759	2	0	0	164	0	166
7760	1	0	160	1	0	162
7761	0	0	163	1	0	164
7762	0	0	2	161	0	163
7763	0	0	1	161	0	162
7764	0	151	0	2	0	153
7765	2	161	0	1	0	164
7766	160	2	0	2	0	164
7767	3	1	0	163	0	167
7768	1	159	2	2	0	164
7769	0	163	0	3	0	166
7770	160	1	2	0	0	163
7771	1	1	0	163	0	165
7772	1	162	0	3	0	166
7773	2	1	0	160	0	163
7774	0	3	0	159	0	162
7775	2	0	0	160	0	162
7776	155	0	2	2	0	159
7777	1	157	0	3	0	161
7778	1	2	2	158	0	163
7779	2	1	0	159	0	162
7780	2	0	0	159	0	161
7781	2	0	149	3	0	154
7782	151	0	2	1	0	154
7783	4	0	1	146	0	151
7784	148	0	0	4	0	152
7785	150	0	2	1	0	153
7786	149	0	2	0	0	151
7787	3	0	148	1	0	152
7788	1	145	2	1	0	149
7789	0	4	3	143	0	150
7790	0	3	147	4	0	154
7791	2	0	147	1	0	150
7792	0	0	2	139	0	141
7793	0	136	0	1	0	137
7794	138	3	0	1	0	142
7795	142	1	0	0	0	143
7796	140	0	0	2	0	142
7797	131	2	0	0	0	133
7798	1	0	135	2	0	138
7799	133	0	1	2	0	136
7800	1	131	1	1	0	134
7801	3	1	1	139	0	144
7802	0	3	0	141	0	144
7803	140	0	0	5	0	145
7804	2	0	0	139	0	141
7805	1	1	135	3	0	140
7806	132	0	3	1	0	136
7807	137	0	2	0	0	139
7808	136	0	0	3	0	139
7809	4	0	136	0	0	140
7810	126	0	1	0	0	127
7811	4	124	1	0	0	129
7812	122	1	3	0	0	126
7813	1	3	1	126	0	131
7814	1	0	0	125	0	126
7815	0	122	2	3	0	127
7816	0	1	3	125	0	129
7817	0	125	1	2	0	128
7818	0	3	0	126	0	129
7819	2	123	0	2	0	127
7820	1	2	0	118	0	121
7821	2	119	0	1	0	122
7822	3	1	0	116	0	120
7823	0	121	2	2	0	125
7824	132	2	0	0	0	134
7825	2	3	0	131	0	136
7826	1	0	0	133	0	134
7827	0	0	0	151	0	151
7828	2	1	0	152	0	155
7829	0	0	147	6	0	153
7830	0	0	5	151	0	156
7831	2	0	0	155	0	157
7832	150	0	0	3	0	153
7833	152	1	0	0	0	153
7834	2	158	2	1	0	163
7835	2	3	0	161	0	166
7836	0	2	0	167	0	169
7837	172	0	0	4	0	176
7838	5	1	165	1	0	172
7839	167	0	5	4	0	176
7840	5	167	0	1	0	173
7841	152	4	0	0	0	156
7842	154	0	2	0	0	156
7843	5	143	1	0	0	149
7844	0	149	0	0	0	149
7845	3	6	0	132	0	141
7846	1	0	131	4	0	136
7847	126	1	4	0	0	131
7848	4	0	130	0	0	134
7849	135	0	4	1	0	140
7850	4	0	137	0	0	141
7851	1	135	4	0	0	140
7852	1	2	3	134	0	140
7853	134	0	0	4	0	138
7854	140	0	1	0	0	141
7855	4	1	0	138	0	143
7856	146	0	0	4	0	150
7857	149	0	0	0	0	149
7858	5	143	0	2	0	150
7859	144	3	0	1	0	148
7860	5	147	0	0	0	152
7861	1	4	0	157	0	162
7862	158	0	0	4	0	162
7863	163	0	0	0	0	163
7864	163	1	0	0	0	164
7865	4	0	158	1	0	163
7866	1	0	168	0	0	169
7867	1	0	4	167	0	172
7868	1	0	0	174	0	175
7869	0	178	1	4	0	183
7870	182	4	1	0	0	187
7871	3	0	0	184	0	187
7872	0	0	0	188	0	188
7873	0	1	181	4	0	186
7874	1	179	4	0	0	184
7875	0	189	0	1	0	190
7876	1	4	0	184	0	189
7877	183	0	1	3	0	187
7878	3	1	0	187	0	191
7879	0	1	0	190	0	191
7880	188	0	0	4	0	192
7881	192	0	0	0	0	192
7882	3	0	0	188	0	191
7883	0	0	188	4	0	192
7884	0	0	3	189	0	192
7885	1	0	0	190	0	191
7886	189	0	0	4	0	193
7887	3	0	1	184	0	188
7888	183	0	0	4	0	187
7889	3	0	190	1	0	194
7890	1	0	3	192	0	196
7891	0	0	0	202	0	202
7892	1	0	0	201	0	202
7893	0	0	0	199	0	199
7894	0	0	0	200	0	200
7895	0	0	189	5	0	194
7896	191	0	3	2	0	196
7897	3	0	0	191	0	194
7898	0	0	181	4	0	185
7899	1	0	184	0	0	185
7900	1	1	3	183	0	188
7901	182	0	1	5	0	188
7902	185	0	1	0	0	186
7903	187	0	1	1	0	189
7904	5	0	0	179	0	184
7905	2	182	1	3	0	188
7906	187	3	1	0	0	191
7907	187	0	0	1	0	188
7908	192	1	0	2	0	195
7909	192	2	0	0	0	194
7910	5	0	0	187	0	192
7911	2	1	187	4	0	194
7912	2	1	3	188	0	194
7913	2	1	183	4	0	190
7914	182	0	4	2	0	188
7915	182	1	1	2	0	186
7916	3	0	183	2	0	188
7917	182	0	3	0	0	185
7918	188	1	0	1	0	190
7919	4	0	0	183	0	187
7920	2	185	1	2	0	190
7921	192	2	0	1	0	195
7922	4	0	0	194	0	198
7923	1	182	1	4	0	188
7924	2	3	0	180	0	185
7925	1	0	180	5	0	186
7926	1	182	2	1	0	186
7927	169	2	0	3	0	174
7928	162	0	4	2	0	168
7929	158	1	2	0	0	161
7930	158	1	0	2	0	161
7931	4	0	0	157	0	161
7932	2	157	0	2	0	161
7933	155	1	0	2	0	158
7934	1	0	144	2	0	147
7935	0	147	2	2	0	151
7936	2	0	144	1	0	147
7937	0	0	1	141	0	142
7938	0	137	1	0	0	138
7939	1	0	1	141	0	143
7940	0	0	149	2	0	151
7941	1	1	1	148	0	151
7942	1	0	1	150	0	152
7943	1	0	1	149	0	151
7944	148	0	0	0	0	148
7945	1	145	0	1	0	147
7946	2	0	0	153	0	155
7947	154	0	0	1	0	155
7948	1	150	0	1	0	152
7949	142	0	0	1	0	143
7950	2	0	238	3	0	243
7951	1	2	1	245	0	249
7952	2	254	0	1	0	257
7953	258	0	2	1	0	261
7954	1	0	238	1	0	240
7955	1	235	0	1	0	237
7956	1	0	2	239	0	242
7957	2	0	0	240	0	242
7958	242	0	0	0	0	242
7959	0	0	1	238	0	239
7960	1	1	232	2	0	236
7961	2	0	0	222	0	224
7962	0	0	227	2	0	229
7963	0	3	1	223	0	227
7964	0	220	0	1	0	221
7965	232	0	1	0	0	233
7966	227	1	0	1	0	229
7967	0	216	0	3	0	219
7968	1	222	0	1	0	224
7969	4	0	0	215	0	219
7970	218	0	0	0	0	218
7971	0	1	0	218	0	219
7972	216	0	0	1	0	217
7973	1	213	0	1	0	215
7974	0	0	0	220	0	220
7975	1	0	214	0	0	215
7976	0	1	0	212	0	213
7977	1	0	0	219	0	220
7978	217	0	0	0	0	217
7979	0	213	0	1	0	214
7980	0	0	0	217	0	217
7981	217	0	0	0	0	217
7982	0	0	217	0	0	217
7983	200	0	0	0	0	200
7984	1	0	0	219	0	220
7985	0	307	1	0	0	308
7986	311	9	0	0	0	320
7987	10	1	310	1	0	322
7988	1	2	312	0	0	315
7989	1	317	7	0	0	325
7990	310	10	1	0	0	321
7991	8	1	0	310	0	319
7992	1	0	0	318	0	319
7993	313	0	0	12	0	325
7994	10	0	313	1	0	324
7995	1	0	9	318	0	328
7996	0	0	330	10	0	340
7997	0	0	9	326	0	335
7998	0	329	1	7	0	337
7999	0	10	0	336	0	346
8000	0	1	333	11	0	345
8001	323	0	9	2	0	334
8002	11	0	2	336	0	349
8003	2	0	337	11	0	350
8004	0	0	11	332	0	343
8005	0	0	1	344	0	345
8006	0	1	333	13	0	347
8007	1	2	334	2	0	339
8008	2	0	11	338	0	351
8009	0	0	331	11	0	342
8010	332	1	10	2	0	345
8011	12	2	1	333	0	348
8012	335	0	3	12	0	350
8013	10	0	332	4	0	346
8014	3	0	10	333	0	346
8015	2	0	341	11	0	354
8016	0	326	11	4	0	341
8017	2	9	333	2	0	346
8018	0	2	343	0	0	345
8019	336	1	12	1	0	350
8020	347	3	2	1	0	353
8021	13	0	350	3	0	366
8022	3	0	13	328	0	344
8023	1	0	2	357	0	360
8024	0	0	348	15	0	363
8025	0	325	13	5	0	343
8026	336	11	1	3	0	351
8027	11	2	345	2	0	360
8028	2	0	14	333	0	349
8029	0	0	3	353	0	356
8030	347	0	1	16	0	364
8031	357	0	2	2	0	361
8032	359	0	0	1	0	360
8033	354	0	0	2	0	356
8034	15	0	1	345	0	361
8035	2	0	346	12	0	360
8036	0	1	10	350	0	361
8037	0	0	3	356	0	359
8038	0	1	2	368	0	371
8039	0	0	360	13	0	373
8040	341	2	13	4	0	360
8041	15	0	3	355	0	373
8042	5	0	351	14	0	370
8043	0	358	13	5	0	376
8044	1	11	1	358	0	371
8045	0	3	2	371	0	376
8046	355	0	2	14	0	371
8047	11	353	2	3	0	369
8048	7	11	341	0	0	359
8049	0	6	12	343	0	361
8050	1	0	2	266	0	269
8051	257	0	3	16	0	276
8052	269	0	2	3	0	274
8053	16	2	0	257	0	275
8054	260	0	1	11	0	272
8055	13	254	1	7	0	275
8056	3	10	257	4	0	274
8057	2	3	14	260	0	279
8058	0	0	5	276	0	281
8059	0	0	0	281	0	281
8060	0	0	3	273	0	276
8061	2	263	1	16	0	282
8062	260	13	0	4	0	277
8063	12	3	1	258	0	274
8064	3	257	5	10	0	275
8065	263	11	0	5	0	279
8066	264	3	1	5	0	273
8067	14	264	2	2	0	282
8068	3	11	1	264	0	279
8069	0	5	2	279	0	286
8070	1	0	4	277	0	282
8071	1	0	1	275	0	277
8072	261	0	0	17	0	278
8073	281	0	0	4	0	285
8074	18	270	0	2	0	290
8075	3	11	266	4	0	284
8076	4	5	11	269	0	289
8077	269	2	4	9	0	284
8078	11	266	3	5	0	285
8079	3	279	2	3	0	287
8080	270	16	0	4	0	290
8081	280	2	2	3	0	287
8082	15	1	2	276	0	294
8083	7	2	284	11	0	304
8084	5	1	302	4	0	312
8085	206	0	3	0	0	209
8086	205	0	2	5	0	212
8087	205	0	0	0	0	205
8088	202	0	0	0	0	202
8089	202	0	0	0	0	202
8090	3	209	0	0	0	212
8091	1	2	0	217	0	220
8092	0	223	0	1	0	224
8093	223	1	0	2	0	226
8094	219	3	0	3	0	225
8095	215	0	0	0	0	215
8096	216	0	0	0	0	216
8097	3	212	0	0	0	215
8098	208	0	0	0	0	208
8099	0	209	0	0	0	209
8100	1	2	0	209	0	212
8101	212	0	0	0	0	212
8102	0	0	223	1	0	224
8103	1	0	0	220	0	221
8104	0	0	1	227	0	228
8105	1	0	223	1	0	225
8106	0	226	0	1	0	227
8107	229	0	1	0	0	230
8108	226	1	2	0	0	229
8109	1	229	0	2	0	232
8110	1	0	0	238	0	239
8111	0	1	245	0	0	246
8112	0	252	0	2	0	254
8113	252	0	1	0	0	253
8114	0	2	249	0	0	251
8115	233	0	0	0	0	233
8116	244	0	1	0	0	245
8117	2	1	258	1	0	262
8118	1	261	0	1	0	263
8119	0	0	2	264	0	266
8120	0	0	262	0	0	262
8121	244	2	0	1	0	247
8122	260	0	1	0	0	261
8123	2	276	0	0	0	278
8124	1	0	0	287	0	288
8125	0	1	0	291	0	292
8126	0	0	294	1	0	295
8127	0	294	0	2	0	296
8128	313	1	1	0	0	315
8129	320	1	0	0	0	321
8130	326	0	0	0	0	326
8131	2	0	330	0	0	332
8132	318	0	0	0	0	318
8133	329	1	0	0	0	330
8134	1	0	0	341	0	342
8135	1	1	336	0	0	338
8136	1	0	0	332	0	333
8137	1	0	346	0	0	347
8138	0	0	1	334	0	335
8139	0	338	1	1	0	340
8140	0	366	0	1	0	367
8141	0	1	1	370	0	372
8142	0	1	0	365	0	366
8143	363	0	0	0	0	363
8144	1	0	358	0	0	359
8145	354	1	0	0	0	355
8146	0	373	0	1	0	374
8147	380	0	1	0	0	381
8148	379	1	0	0	0	380
8149	1	0	0	380	0	381
8150	0	1	392	0	0	393
8151	1	0	0	387	0	388
8152	1	408	0	0	0	409
8153	0	3	1	420	0	424
8154	0	1	0	425	0	426
8155	424	0	0	3	0	427
8156	3	0	1	421	0	425
8157	0	414	0	3	0	417
8158	1	2	0	421	0	424
8159	424	1	0	3	0	428
8160	3	425	0	1	0	429
8161	0	3	0	433	0	436
8162	0	0	1	433	0	434
8163	0	1	0	455	0	456
8164	1	0	0	460	0	461
8165	465	0	0	4	0	469
8166	5	0	0	474	0	479
8167	0	0	1	481	0	482
8168	2	0	0	494	0	496
8169	1	495	0	4	0	500
8170	504	3	0	2	0	509
8171	8	1	497	0	0	506
8172	4	499	5	0	0	508
8173	500	3	0	1	0	504
8174	5	0	525	0	0	530
8175	0	537	5	0	0	542
8176	0	6	0	537	0	543
8177	0	535	0	5	0	540
8178	0	3	537	0	0	540
8179	0	0	541	0	0	541
8180	0	527	6	0	0	533
8181	551	4	0	0	0	555
8182	554	0	0	0	0	554
8183	5	0	521	0	0	526
8184	0	0	508	0	0	508
8185	0	1	528	0	0	529
8186	0	0	5	530	0	535
8187	0	0	0	524	0	524
8188	0	0	0	543	0	543
8189	0	0	557	5	0	562
8190	1	0	5	543	0	549
8191	0	0	0	549	0	549
8192	0	0	548	5	0	553
8193	523	0	7	0	0	530
8194	6	0	0	578	0	584
8195	0	0	0	586	0	586
8196	0	588	0	5	0	593
8197	586	4	2	0	0	592
8198	6	0	585	0	0	591
8199	576	0	6	0	0	582
8200	6	0	0	586	0	592
8201	1	0	593	6	0	600
8202	0	0	6	580	0	586
8203	594	0	0	6	0	600
8204	6	0	596	0	0	602
8205	591	0	5	0	0	596
8206	609	0	0	0	0	609
8207	613	0	0	0	0	613
8208	6	601	0	0	0	607
8209	1	6	0	624	0	631
8210	631	0	0	6	0	637
8211	630	0	0	0	0	630
8212	652	0	0	0	0	652
8213	8	0	627	0	0	635
8214	664	0	8	0	0	672
8215	8	0	0	706	0	714
8216	1	0	705	8	0	714
8217	0	0	8	708	0	716
8218	0	0	1	730	0	731
8219	0	0	736	10	0	746
8220	0	0	8	731	0	739
8221	0	0	0	766	0	766
8222	0	0	841	11	0	852
8223	874	0	10	1	0	885
8224	956	0	4	0	0	960
8225	21	0	1	981	0	1003
8226	5	0	969	19	0	993
8227	2	0	19	965	0	986
8228	1	951	3	21	0	976
8229	2	18	2	948	0	970
8230	3	4	1	978	0	986
8231	952	2	1	27	0	982
8232	960	0	3	8	0	971
8233	964	1	1	5	0	971
8234	26	3	1	942	0	972
8235	7	0	0	971	0	978
8236	2	2	918	27	0	949
8237	4	0	16	919	0	939
8238	3	925	4	21	0	953
8239	926	20	2	7	0	955
8240	20	920	0	10	0	950
8241	938	21	1	4	0	964
8242	23	3	3	902	0	931
8243	7	913	0	21	0	941
8244	924	22	2	5	0	953
8245	928	5	1	7	0	941
8246	25	7	1	908	0	941
8247	10	908	1	20	0	939
8248	2	23	1	919	0	945
8249	4	8	906	24	0	942
8250	891	2	20	7	0	920
8251	24	890	6	4	0	924
8252	877	18	2	7	0	904
8253	18	9	1	882	0	910
8254	884	2	3	19	0	908
8255	25	2	883	5	0	915
8256	905	2	17	5	0	929
8257	919	4	6	4	0	933
8258	23	2	898	3	0	926
8259	8	2	16	896	0	922
8260	9	1	5	912	0	927
8261	888	3	4	23	0	918
8262	24	877	0	8	0	909
8263	11	18	2	870	0	901
8264	6	4	868	19	0	897
8265	4	4	853	9	0	870
8266	4	833	19	10	0	866
8267	12	17	826	4	0	859
8268	805	10	20	3	0	838
8269	17	9	7	804	0	837
8270	812	4	5	17	0	838
8271	19	1	799	10	0	829
8272	7	3	12	801	0	823
8273	6	1	10	813	0	830
8274	4	2	775	21	0	802
8275	5	2	17	774	0	798
8276	774	1	7	19	0	801
8277	775	1	5	8	0	789
8278	21	1	3	764	0	789
8279	767	0	2	21	0	790
8280	771	3	4	8	0	786
8281	25	745	3	7	0	780
8282	12	17	4	756	0	789
8283	761	4	2	21	0	788
8284	18	5	1	761	0	785
8285	729	3	2	20	0	754
8286	24	1	2	731	0	758
8287	11	3	717	20	0	751
8288	10	720	14	8	0	752
8289	8	19	7	652	0	686
8290	4	698	4	18	0	724
8291	680	18	1	8	0	707
8292	15	679	4	7	0	705
8293	9	678	4	5	0	696
8294	5	26	2	656	0	689
8295	652	9	3	19	0	683
8296	17	7	1	651	0	676
8297	651	3	4	18	0	676
8298	655	6	2	7	0	670
8299	20	651	1	4	0	676
8300	654	17	1	8	0	680
8301	658	7	1	4	0	670
8302	657	3	2	6	0	668
8303	29	4	619	2	0	654
8304	10	5	14	617	0	646
8305	7	3	7	627	0	644
8306	8	1	600	21	0	630
8307	610	2	13	12	0	637
8308	614	3	7	3	0	627
8309	604	1	5	5	0	615
8310	591	4	1	7	0	603
8311	23	571	4	5	0	603
8312	550	13	5	3	0	571
8313	23	7	0	544	0	574
8314	12	3	517	15	0	547
8315	478	1	12	8	0	499
8316	16	476	5	3	0	500
8317	450	14	2	4	0	470
8318	21	441	0	2	0	464
8319	7	418	2	6	0	433
8320	9	414	4	2	0	429
8321	4	400	4	4	0	412
8322	3	22	286	2	0	313
8323	8	27	7	205	0	247
8324	1	0	167	4	0	172
8325	124	1	0	1	0	126
8326	0	126	1	1	0	128
8327	2	128	0	0	0	130
8328	1	1	0	127	0	129
8329	0	2	0	130	0	132
8330	0	0	128	2	0	130
8331	1	0	128	1	0	130
8332	0	0	1	130	0	131
8333	1	0	129	0	0	130
8334	0	120	0	2	0	122
8335	0	0	1	123	0	124
8336	0	2	0	137	0	139
8337	0	0	135	2	0	137
8338	0	1	1	134	0	136
8339	133	0	1	1	0	135
8340	1	0	0	129	0	130
8341	1	0	0	127	0	128
8342	0	0	126	3	0	129
8343	126	0	1	1	0	128
8344	1	125	1	1	0	128
8345	2	1	0	130	0	133
8346	1	1	129	1	0	132
8347	0	1	1	131	0	133
8348	131	0	1	1	0	133
8349	2	0	130	1	0	133
8350	2	0	1	129	0	132
8351	0	0	129	4	0	133
8352	0	134	1	2	0	137
8353	0	1	130	3	0	134
8354	0	130	2	0	0	132
8355	1	0	104	0	0	105
8356	0	1	1	96	0	98
8357	0	96	0	1	0	97
8358	90	0	0	1	0	91
8359	1	1	0	90	0	92
8360	94	0	0	1	0	95
8361	1	0	0	92	0	93
8362	1	0	0	92	0	93
8363	101	0	0	1	0	102
8364	102	0	0	1	0	103
8365	3	0	0	105	0	108
8366	1	0	104	2	0	107
8367	0	105	1	1	0	107
8368	4	2	103	0	0	109
8369	0	108	1	0	0	109
8370	106	2	1	0	0	109
8371	2	1	107	0	0	110
8372	4	0	98	0	0	102
8373	0	0	3	86	0	89
8374	92	0	1	2	0	95
8375	2	0	102	1	0	105
8376	1	98	2	0	0	101
8377	107	2	1	0	0	110
8378	115	1	0	0	0	116
8379	117	0	0	0	0	117
8380	117	0	0	0	0	117
8381	117	0	0	0	0	117
8382	3	1	112	0	0	116
8383	0	1	2	107	0	110
8384	0	110	1	2	0	113
8385	112	2	0	1	0	115
8386	2	112	0	0	0	114
8387	113	2	0	0	0	115
8388	114	0	0	0	0	114
8389	2	114	0	0	0	116
8390	120	2	0	0	0	122
8391	2	0	0	116	0	118
8392	0	0	0	122	0	122
8393	0	0	111	2	0	113
8394	0	113	2	0	0	115
8395	0	2	0	112	0	114
8396	0	0	0	112	0	112
8397	0	0	0	116	0	116
8398	0	0	110	2	0	112
8399	106	0	2	0	0	108
8400	2	0	0	111	0	113
8401	110	0	0	1	0	111
8402	2	0	0	109	0	111
8403	1	0	118	2	0	121
8404	0	0	131	0	0	131
8405	131	0	2	0	0	133
8406	131	0	0	0	0	131
8407	2	128	0	0	0	130
8408	0	2	131	2	0	135
8409	0	0	2	132	0	134
8410	0	0	0	133	0	133
8411	138	0	0	2	0	140
8412	138	0	0	0	0	138
8413	140	0	0	0	0	140
8414	2	0	135	0	0	137
8415	134	0	1	0	0	135
8416	2	0	0	137	0	139
8417	0	0	0	140	0	140
8418	0	0	0	139	0	139
8419	0	136	0	1	0	137
8420	137	2	0	0	0	139
8421	2	0	0	138	0	140
8422	0	0	141	2	0	143
8423	0	0	2	140	0	142
8424	0	138	0	2	0	140
8425	144	2	0	0	0	146
8426	2	0	0	139	0	141
8427	0	0	0	137	0	137
8428	0	0	139	2	0	141
8429	0	0	1	136	0	137
8430	0	137	0	1	0	138
8431	0	2	0	139	0	141
8432	0	0	136	2	0	138
8433	128	0	2	0	0	130
8434	133	0	0	0	0	133
8435	2	132	0	0	0	134
8436	124	1	0	0	0	125
8437	129	0	0	0	0	129
8438	1	130	0	0	0	131
8439	0	1	0	133	0	134
8440	132	0	2	1	0	135
8441	1	136	0	0	0	137
8442	0	1	130	0	0	131
8443	138	0	1	0	0	139
8444	142	0	0	0	0	142
8445	144	0	0	0	0	144
8446	143	0	0	0	0	143
8447	1	142	0	0	0	143
8448	146	1	0	0	0	147
8449	144	0	0	0	0	144
8450	150	0	0	0	0	150
8451	1	0	0	145	0	146
8452	142	0	0	1	0	143
8453	1	153	0	0	0	154
8454	0	1	164	0	0	165
8455	0	0	1	176	0	177
8456	176	0	0	1	0	177
8457	2	0	174	0	0	176
8458	0	0	2	176	0	178
8459	0	0	173	2	0	175
8460	0	181	1	0	0	182
8461	0	5	0	182	0	187
8462	0	0	187	2	0	189
8463	0	177	1	0	0	178
8464	0	1	0	177	0	178
8465	171	0	0	2	0	173
8466	179	0	0	0	0	179
8467	177	0	0	0	0	177
8468	177	0	0	0	0	177
8469	176	0	0	0	0	176
8470	1	0	174	0	0	175
8471	174	0	1	0	0	175
8472	182	0	0	0	0	182
8473	1	0	0	182	0	183
8474	180	0	0	1	0	181
8475	173	0	0	0	0	173
8476	1	166	0	0	0	167
8477	0	1	0	170	0	171
8478	0	0	0	164	0	164
8479	162	0	0	1	0	163
8480	2	153	0	4	0	159
8481	0	162	0	0	0	162
8482	0	1	0	172	0	173
8483	0	0	0	176	0	176
8484	0	0	0	176	0	176
8485	0	0	0	175	0	175
8486	176	0	0	1	0	177
8487	174	0	0	0	0	174
8488	1	0	179	0	0	180
8489	0	0	1	167	0	168
8490	0	0	0	169	0	169
8491	0	0	173	1	0	174
8492	167	0	1	0	0	168
8493	1	169	0	0	0	170
8494	172	1	0	0	0	173
8495	1	0	0	167	0	168
8496	0	0	171	1	0	172
8497	0	0	1	172	0	173
8498	0	0	175	1	0	176
8499	1	170	1	1	0	173
8500	170	1	0	0	0	171
8501	171	0	0	0	0	171
8502	1	169	0	0	0	170
8503	0	1	0	165	0	166
8504	151	0	0	1	0	152
8505	1	148	0	0	0	149
8506	0	1	0	154	0	155
8507	155	0	0	1	0	156
8508	1	1	149	0	0	151
8509	147	0	1	0	0	148
8510	1	147	0	0	0	148
8511	150	1	0	0	0	151
8512	149	0	0	0	0	149
8513	1	0	150	0	0	151
8514	0	0	1	144	0	145
8515	0	0	0	152	0	152
8516	0	0	155	1	0	156
8517	0	0	1	152	0	153
8518	0	0	0	156	0	156
8519	157	0	0	1	0	158
8520	158	0	0	0	0	158
8521	1	0	0	152	0	153
8522	0	0	153	1	0	154
8523	1	0	1	151	0	153
8524	0	0	0	156	0	156
8525	0	0	155	1	0	156
8526	0	0	1	156	0	157
8527	158	0	0	1	0	159
8528	153	0	0	0	0	153
8529	1	150	0	0	0	151
8530	163	1	0	0	0	164
8531	161	0	0	0	0	161
8532	1	165	0	0	0	166
8533	168	1	0	0	0	169
8534	167	0	0	0	0	167
8535	170	0	0	0	0	170
8536	1	0	162	0	0	163
8537	160	0	1	0	0	161
8538	1	0	0	166	0	167
8539	170	0	0	1	0	171
8540	2	0	167	3	0	172
8541	1	166	2	0	0	169
8542	172	2	1	0	0	175
8543	1	180	0	0	0	181
8544	2	1	0	176	0	179
8545	0	2	0	182	0	184
8546	182	0	0	3	0	185
8547	182	0	0	2	0	184
8548	3	0	183	0	0	186
8549	2	0	177	1	0	180
8550	0	0	178	0	0	178
8551	0	1	3	175	0	179
8552	0	0	169	1	0	170
8553	0	1	160	2	0	163
8554	10	2	3	142	0	157
8555	152	0	2	1	0	155
8556	163	0	0	2	0	165
8557	164	0	0	0	0	164
8558	163	0	0	0	0	163
8559	2	0	0	162	0	164
8560	2	0	0	162	0	164
8561	0	0	172	2	0	174
8562	0	0	0	175	0	175
8563	0	0	2	176	0	178
8564	181	0	0	2	0	183
8565	188	0	0	2	0	190
8566	2	1	0	187	0	190
8567	192	0	0	0	0	192
8568	191	0	0	3	0	194
8569	3	0	0	191	0	194
8570	2	0	0	190	0	192
8571	0	1	192	5	0	198
8572	0	0	189	3	0	192
8573	0	0	4	193	0	197
8574	0	0	3	197	0	200
8575	0	0	194	3	0	197
8576	189	0	1	2	0	192
8577	193	0	3	0	0	196
8578	4	0	189	0	0	193
8579	3	190	1	0	0	194
8580	199	1	3	0	0	203
8581	1	3	200	0	0	204
8582	3	0	1	195	0	199
8583	0	0	3	192	0	195
8584	196	0	0	4	0	200
8585	201	0	0	3	0	204
8586	4	0	0	195	0	199
8587	3	0	0	213	0	216
8588	211	0	0	4	0	215
8589	215	0	0	3	0	218
8590	217	0	0	0	0	217
8591	4	0	215	0	0	219
8592	3	0	1	218	0	222
8593	0	0	3	221	0	224
8594	220	0	0	4	0	224
8595	1	216	0	3	0	220
8596	248	1	0	0	0	249
8597	4	257	0	0	0	261
8598	3	3	0	272	0	278
8599	0	3	0	275	0	278
8600	0	0	273	6	0	279
8601	0	0	3	274	0	277
8602	0	1	277	3	0	281
8603	0	0	2	278	0	280
8604	0	0	3	275	0	278
8605	0	271	0	6	0	277
8606	0	277	0	3	0	280
8607	0	6	0	280	0	286
8608	0	3	0	285	0	288
8609	0	0	0	293	0	293
8610	0	0	0	300	0	300
8611	0	0	0	304	0	304
8612	0	0	295	7	0	302
8613	0	0	4	297	0	301
8614	0	0	3	304	0	307
8615	0	0	292	7	0	299
8616	1	293	4	3	0	301
8617	0	5	3	300	0	308
8618	0	3	291	5	0	299
8619	1	289	4	4	0	298
8620	0	4	4	301	0	309
8621	300	3	0	6	0	309
8622	4	0	1	301	0	306
8623	3	0	0	303	0	306
8624	0	0	0	313	0	313
8625	1	1	1	306	0	309
8626	1	293	0	7	0	301
8627	1	4	0	306	0	311
8628	322	4	1	6	0	333
8629	4	1	1	322	0	328
8630	4	0	0	314	0	318
8631	2	0	0	323	0	325
8632	315	1	2	7	0	325
8633	319	1	0	5	0	325
8634	8	1	0	319	0	328
8635	334	0	2	6	0	342
8636	333	1	0	6	0	340
8637	5	334	1	3	0	343
8638	338	4	2	1	0	345
8639	5	333	0	1	0	339
8640	3	332	0	4	0	339
8641	2	6	1	339	0	348
8642	4	5	333	4	0	346
8643	0	0	3	331	0	334
8644	1	1	0	338	0	340
8645	0	328	1	6	0	335
8646	332	4	0	5	0	341
8647	3	1	1	332	0	337
8648	2	0	369	6	0	377
8649	0	2	4	374	0	380
8650	2	374	1	6	0	383
8651	381	5	0	3	0	389
8652	4	1	1	384	0	390
8653	2	1	378	6	0	387
8654	0	1	3	382	0	386
8655	2	363	2	3	0	370
8656	2	3	0	359	0	364
8657	373	2	0	7	0	382
8658	380	0	1	2	0	383
8659	378	2	0	2	0	382
8660	4	389	0	1	0	394
8661	390	3	0	4	0	397
8662	4	2	1	394	0	401
8663	396	2	0	5	0	403
8664	4	387	0	6	0	397
8665	2	6	1	398	0	407
8666	2	1	393	5	0	401
8667	381	0	4	6	0	391
8668	5	396	2	2	0	405
8669	3	5	1	401	0	410
8670	1	3	0	409	0	413
8671	1	0	2	398	0	401
8672	2	0	0	393	0	395
8673	1	388	0	4	0	393
8674	399	5	0	3	0	407
8675	400	2	0	2	0	404
8676	5	1	406	2	0	414
8677	2	1	3	419	0	425
8678	0	1	423	5	0	429
8679	418	0	5	2	0	425
8680	427	1	1	1	0	430
8681	418	0	1	1	0	420
8682	6	1	0	412	0	419
8683	3	404	1	4	0	412
8684	426	5	0	2	0	433
8685	5	1	1	426	0	433
8686	426	0	1	4	0	431
8687	5	3	414	3	0	425
8688	1	2	411	1	0	415
8689	412	0	3	1	0	416
8690	3	0	1	418	0	422
8691	415	1	0	4	0	420
8692	2	414	1	2	0	419
8693	424	5	1	2	0	432
8694	430	1	0	1	0	432
8695	5	1	435	2	0	443
8696	2	1	400	2	0	405
8697	0	395	4	1	0	400
8698	3	2	3	403	0	411
8699	406	1	2	3	0	412
8700	4	0	1	403	0	408
8701	2	1	1	418	0	422
8702	1	2	413	3	0	419
8703	399	0	2	3	0	404
8704	4	1	2	422	0	429
8705	1	2	422	3	0	428
8706	1	1	418	4	0	424
8707	0	1	5	428	0	434
8708	2	0	423	4	0	429
8709	0	2	420	3	0	425
8710	0	2	4	399	0	405
8711	1	0	432	2	0	435
8712	0	0	1	429	0	430
8713	1	418	3	1	0	423
8714	446	2	1	2	0	451
8715	3	452	0	1	0	456
8716	2	2	1	457	0	462
8717	0	459	1	4	0	464
8718	0	2	467	2	0	471
8719	2	1	3	529	0	535
8720	1	2	662	2	0	667
8721	691	0	5	6	0	702
8722	7	734	4	1	0	746
8723	748	6	4	1	0	759
8724	11	4	0	747	0	762
8725	762	6	1	7	0	776
8726	14	2	743	7	0	766
8727	8	751	7	5	0	771
8728	758	7	7	0	0	772
8729	6	8	3	728	0	745
8730	9	748	4	7	0	768
8731	6	6	2	765	0	779
8732	769	9	0	11	0	789
8733	13	808	0	6	0	827
8734	816	7	0	6	0	829
8735	13	8	785	0	0	806
8736	791	4	11	0	0	806
8737	12	1	8	791	0	812
8738	787	1	4	9	0	801
8739	12	769	1	9	0	791
8740	8	9	1	775	0	793
8741	5	7	0	786	0	798
8742	0	3	754	18	0	775
8743	1	1	8	769	0	779
8744	3	1	7	772	0	783
8745	1	0	3	768	0	772
8746	2	0	1	785	0	788
8747	0	0	757	20	0	777
8748	0	705	10	11	0	726
8749	0	11	7	719	0	737
8750	715	5	4	11	0	735
8751	719	4	0	9	0	732
8752	16	711	2	5	0	734
8753	725	9	0	3	0	737
8754	719	8	1	1	0	729
8755	715	4	0	1	0	720
8756	19	701	0	2	0	722
8757	700	10	1	0	0	711
8758	13	8	1	684	0	706
8759	8	4	676	13	0	701
8760	5	662	10	11	0	688
8761	1	10	9	664	0	684
8762	0	6	649	8	0	663
8763	650	3	8	7	0	668
8764	9	0	7	661	0	677
8765	6	0	4	654	0	664
8766	4	2	0	659	0	665
8767	2	0	0	663	0	665
8768	0	0	629	20	0	649
8769	617	1	9	10	0	637
8770	9	635	7	4	0	655
8771	640	10	4	1	0	655
8772	13	640	1	0	0	654
8773	649	13	0	1	0	663
8774	13	7	0	642	0	662
8775	6	4	631	11	0	652
8776	5	0	624	7	0	636
8777	0	1	13	618	0	632
8778	1	0	10	621	0	632
8779	1	0	5	621	0	627
8780	615	1	0	17	0	633
8781	9	0	606	10	0	625
8782	7	1	8	599	0	615
8783	5	609	8	6	0	628
8784	600	9	3	5	0	617
8785	9	6	593	3	0	611
8786	5	585	16	2	0	608
8787	4	9	594	2	0	609
8788	0	5	11	590	0	606
8789	0	2	597	11	0	610
8790	3	0	592	6	0	601
8791	0	0	15	588	0	603
8792	0	1	585	9	0	595
8793	1	1	582	6	0	590
8794	2	1	15	571	0	589
8795	555	0	10	9	0	574
8796	9	1	554	6	0	570
8797	7	0	8	548	0	563
8798	5	0	6	552	0	563
8799	543	0	4	13	0	560
8800	9	1	1	551	0	562
8801	535	0	0	14	0	549
8802	13	518	1	7	0	539
8803	6	9	1	543	0	559
8804	537	4	0	9	0	550
8805	539	4	0	6	0	549
8806	14	0	1	525	0	540
8807	11	0	520	10	0	541
8808	515	0	9	7	0	531
8809	11	521	6	5	0	543
8810	521	9	5	2	0	537
8811	515	6	0	1	0	522
8812	522	5	1	0	0	528
8813	20	0	500	1	0	521
8814	8	490	9	0	0	507
8815	6	24	6	461	0	497
8816	0	14	3	473	0	490
8817	1	4	453	12	0	470
8818	1	439	8	9	0	457
8819	1	369	5	4	0	379
8820	0	234	0	0	0	234
8821	171	4	23	0	0	198
8822	4	3	0	155	0	162
8823	1	0	0	153	0	154
8824	0	1	153	3	0	157
8825	154	0	3	0	0	157
8826	3	0	0	155	0	158
8827	0	1	1	156	0	158
8828	1	1	151	3	0	156
8829	0	153	3	1	0	157
8830	0	4	1	153	0	158
8831	1	0	153	2	0	156
8832	0	130	2	1	0	133
8833	96	3	0	1	0	100
8834	2	0	101	1	0	104
8835	0	0	0	93	0	93
8836	0	94	1	1	0	96
8837	98	1	0	0	0	99
8838	1	1	0	99	0	101
8839	102	0	0	1	0	103
8840	104	1	0	0	0	105
8841	2	99	0	0	0	101
8842	106	1	0	1	0	108
8843	1382	0	0	0	0	1382
8844	1	1	1326	0	0	1328
8845	1353	0	1	2	0	1356
8846	1	0	1358	0	0	1359
8847	1328	0	1	1	0	1330
8848	1386	0	0	0	0	1386
8849	1	0	1372	0	0	1373
8850	0	0	2	1314	0	1316
8851	0	2	1345	1	0	1348
8852	0	1	1261	0	0	1262
8853	0	3	2297	4	0	2304
8854	0	2	1	2430	0	2433
8855	0	1	0	2620	0	2621
8856	0	0	0	2643	0	2643
8857	0	0	0	2627	0	2627
8858	0	1	2631	1	0	2633
8859	1	2	1	2468	0	2472
8860	0	2469	4	7	0	2480
8861	0	3	2623	0	0	2626
8862	0	1	1	2452	0	2454
8863	1	0	2680	1	0	2682
8864	0	2483	2	2	0	2487
8865	0	2562	0	3	0	2565
8866	0	1	1	2690	0	2692
8867	2	1	2675	3	0	2681
8868	0	6	2509	0	0	2515
8869	1	0	0	2570	0	2571
8870	0	0	3	2555	0	2558
8871	0	0	1	2674	0	2675
8872	4	0	2693	1	0	2698
8873	0	2513	2	4	0	2519
8874	0	2609	3	4	0	2616
8875	0	3	1	2718	0	2722
8876	0	4	2688	0	0	2692
8877	1	6	2502	1	0	2510
8878	0	2530	3	3	0	2536
8879	2728	0	2	0	0	2730
8880	0	2492	3	3	0	2498
8881	2	4	2575	0	0	2581
8882	2523	1	2	1	0	2527
8883	1	2	1	2732	0	2736
8884	2770	0	1	2	0	2773
8885	3	0	0	2701	0	2704
8886	1	1	0	2732	0	2734
8887	2766	0	0	2	0	2768
8888	1	2663	3	4	0	2671
8889	2	4	2619	2	0	2627
8890	1	2592	2	2	0	2597
8891	2751	2	1	0	0	2754
8892	1	2662	1	1	0	2665
8893	2769	3	0	1	0	2773
8894	2748	1	0	1	0	2750
8895	3	2648	5	2	0	2658
8896	2	2	0	2769	0	2773
8897	2769	0	0	2	0	2771
8898	2726	1	0	3	0	2730
8899	2	1	0	2680	0	2683
8900	2	1	2626	2	0	2631
8901	1	3	2454	1	0	2459
8902	0	1	3	2642	0	2646
8903	0	0	2592	2	0	2594
8904	2432	1	3	5	0	2441
8905	1	2370	12	3	0	2386
8906	0	2	1	2647	0	2650
8907	1	1	0	2661	0	2663
8908	0	1	0	2614	0	2615
8909	1	0	0	2558	0	2559
8910	0	0	0	2636	0	2636
8911	0	1	2565	4	0	2570
8912	0	2325	4	7	0	2336
8913	2616	2	1	1	0	2620
8914	2	1	1	2630	0	2634
8915	0	1	0	2631	0	2632
8916	1	0	0	2653	0	2654
8917	0	2495	5	4	0	2504
8918	0	2	0	2670	0	2672
8919	0	1	0	2654	0	2655
8920	2663	1	1	3	0	2668
8921	2	2520	1	4	0	2527
8922	1	2479	3	3	0	2486
8923	1	3	0	2660	0	2664
8924	2624	2	1	2	0	2629
8925	2	3	2527	1	0	2533
8926	2323	0	2	4	0	2329
8927	3	1	2491	1	0	2496
8928	1	0	3	2541	0	2545
8929	1	0	1	2544	0	2546
8930	0	1	1	2583	0	2585
8931	0	0	0	2568	0	2568
8932	1	0	0	2548	0	2549
8933	2545	0	0	5	0	2550
8934	2	2	2503	2	0	2509
8935	1	1	2	2551	0	2555
8936	1	0	2542	2	0	2545
8937	0	2365	11	4	0	2380
8938	2497	2	2	3	0	2504
8939	3	1	2513	0	0	2517
8940	2	2	2	2515	0	2521
8941	1	0	0	2475	0	2476
8942	1	0	2565	3	0	2569
8943	0	2	1357	4	0	1363
8944	1	0	5	1339	0	1345
8945	1412	0	2	2	0	1416
8946	1402	0	1	2	0	1405
8947	2	1358	0	2	0	1362
8948	1443	3	0	0	0	1446
8949	4	1	0	1402	0	1407
8950	1	1342	2	3	0	1348
8951	1	3	0	1427	0	1431
8952	1	1	1407	3	0	1412
8953	0	0	3	257	0	260
8954	0	0	1	263	0	264
8955	257	0	1	4	0	262
8956	3	255	0	2	0	260
8957	253	3	0	1	0	257
8958	4	251	0	0	0	255
8959	242	3	0	0	0	245
8960	3	242	0	0	0	245
8961	0	233	0	0	0	233
8962	238	3	0	0	0	241
8963	3	0	0	233	0	236
8964	0	231	0	3	0	234
8965	237	3	0	0	0	240
8966	238	0	0	0	0	238
8967	244	0	0	0	0	244
8968	236	0	0	0	0	236
8969	3	244	0	0	0	247
8970	0	3	0	251	0	254
8971	0	0	0	253	0	253
8972	253	0	0	3	0	256
8973	3	0	0	255	0	258
8974	255	0	0	3	0	258
8975	3	0	245	0	0	248
8976	243	0	3	0	0	246
8977	3	0	244	0	0	247
8978	0	0	3	250	0	253
8979	249	0	0	3	0	252
8980	3	246	0	1	0	250
8981	239	2	0	0	0	241
8982	1	236	0	0	0	237
8983	0	2	0	251	0	253
8984	0	0	241	2	0	243
8985	235	0	2	0	0	237
8986	2	239	0	0	0	241
8987	0	3	0	237	0	240
8988	0	0	0	234	0	234
8989	0	0	0	236	0	236
8990	0	0	238	2	0	240
8991	0	231	2	0	0	233
8992	237	1	0	0	0	238
8993	233	0	0	0	0	233
8994	1	236	0	0	0	237
8995	262	1	0	1	0	264
8996	1	0	0	266	0	267
8997	2	262	1	1	0	266
8998	269	1	1	1	0	272
8999	1	0	268	1	0	270
9000	1	270	1	1	0	273
9001	1	1	0	285	0	287
9002	0	1	0	286	0	287
9003	1	0	281	1	0	283
9004	0	0	1	277	0	278
9005	0	1	284	1	0	286
9006	0	0	1	285	0	286
9007	0	0	1	293	0	294
9008	0	0	0	289	0	289
9009	0	0	0	296	0	296
9010	1	0	293	1	0	295
9011	0	1	300	0	0	301
9012	1	322	1	0	0	324
9013	0	5	0	345	0	350
9014	1	0	372	5	0	378
9015	0	367	2	0	0	369
9016	0	4	0	387	0	391
9017	1	0	1255	4	0	1260
9018	1224	2	114	1	0	1341
9019	2244	1	9	1	0	2255
9020	184	0	5	2247	0	2436
9021	62	3	2138	183	0	2386
9022	26	2	162	2330	0	2520
9023	2047	1	60	215	0	2323
9024	169	2236	25	69	0	2499
9025	2268	179	11	37	0	2495
9026	2377	57	11	14	0	2459
9027	235	23	8	2256	0	2522
9028	92	6	11	2433	0	2542
9029	44	9	11	2440	0	2504
9030	29	6	11	2402	0	2448
9031	25	5	5	2544	0	2579
9032	2211	8	11	280	0	2510
9033	2395	5	6	115	0	2521
9034	2524	3	9	56	0	2592
9035	284	10	2122	45	0	2461
9036	2311	5	169	42	0	2527
9037	233	8	55	2303	0	2599
9038	100	7	2128	218	0	2453
9039	61	2178	163	91	0	2493
9040	43	177	66	2181	0	2467
9041	45	64	32	2184	0	2325
9042	36	2219	16	254	0	2525
9043	34	186	18	2349	0	2587
9044	35	68	2191	236	0	2530
9045	32	37	2360	110	0	2539
9046	21	16	257	2350	0	2644
9047	2282	16	103	233	0	2634
9048	2438	13	53	106	0	2610
9049	298	16	2147	78	0	2539
9050	134	2075	196	59	0	2464
9051	88	2439	93	77	0	2697
9052	2291	240	71	84	0	2686
9053	228	105	2241	99	0	2673
9054	129	60	208	2351	0	2748
9055	2282	53	85	263	0	2683
9056	279	2183	53	123	0	2638
9057	150	2453	31	91	0	2725
9058	2333	267	36	94	0	2730
9059	258	109	24	2395	0	2786
9060	2316	46	34	318	0	2714
9061	252	30	23	2473	0	2778
9062	126	32	29	2687	0	2874
9063	128	23	2298	349	0	2798
9064	118	30	194	2503	0	2845
9065	131	34	86	2666	0	2917
9066	2510	26	72	329	0	2937
9067	295	24	54	2581	0	2954
9068	142	32	2349	322	0	2845
9069	2467	37	231	172	0	2907
9070	250	54	106	2582	0	2992
9071	2447	64	70	301	0	2882
9072	241	2310	37	188	0	2776
9073	128	2610	37	152	0	2927
9074	2436	282	58	129	0	2905
9075	2595	125	62	126	0	2908
9076	285	67	72	2560	0	2984
9077	165	36	2400	306	0	2907
9078	129	26	223	2620	0	2998
9079	2391	36	111	325	0	2863
9080	300	2432	78	142	0	2952
9081	176	246	58	2476	0	2956
9082	2533	138	73	258	0	3002
9083	297	93	2377	132	0	2899
9084	2534	63	234	111	0	2942
9085	2597	61	123	114	0	2895
9086	348	66	2468	101	0	2983
9087	194	82	2534	117	0	2927
9088	143	91	278	2299	0	2811
9089	129	95	116	2270	0	2610
9090	117	2468	74	312	0	2971
9091	127	228	53	2584	0	2992
9092	104	94	2426	358	0	2982
9093	109	62	229	2619	0	3019
9094	103	37	133	2800	0	3073
9095	102	33	2400	400	0	2935
9096	83	2394	233	260	0	2970
9097	98	212	127	2506	0	2943
9098	92	108	84	2723	0	3007
9099	2483	53	82	398	0	3016
9100	307	34	79	2598	0	3018
9101	160	54	2362	342	0	2918
9102	2365	57	229	189	0	2840
9103	2642	74	125	137	0	2978
9104	2737	91	64	108	0	3000
9105	373	90	2308	111	0	2882
9106	203	68	226	2381	0	2878
9107	140	53	120	2659	0	2972
9108	109	38	98	2758	0	3003
9109	2288	51	73	422	0	2834
9110	262	2395	84	237	0	2978
9111	149	245	2291	177	0	2862
9112	123	2425	236	140	0	2924
9113	110	2484	119	150	0	2863
9114	126	2499	113	114	0	2852
9115	135	306	94	2390	0	2925
9116	149	128	2311	279	0	2867
9117	1271	48	90	94	0	1503
9118	135	1421	111	64	0	1731
9119	417	2	1	0	0	420
9120	5	424	1	1	0	431
9121	430	3	3	3	0	439
9122	4	435	1	3	0	443
9123	2	3	427	6	0	438
9124	2	1	3	421	0	427
9125	3	1	2	424	0	430
9126	426	3	1	4	0	434
9127	3	1	2	460	0	466
9128	2	5	452	4	0	463
9129	1	3	3	463	0	470
9130	0	4	457	5	0	466
9131	0	451	8	4	0	463
9132	1	4	2	455	0	462
9133	3	459	1	4	0	467
9134	462	7	0	1	0	470
9135	5	2	0	468	0	475
9136	3	3	462	3	0	471
9137	4	1	457	4	0	466
9138	455	3	5	2	0	465
9139	3	1	5	461	0	470
9140	1	1	453	8	0	463
9141	4	1	441	3	0	449
9142	2	442	4	2	0	450
9143	0	7	3	409	0	419
9144	1	430	2	5	0	438
9145	0	3	1	429	0	433
9146	427	2	2	4	0	435
9147	3	3	0	434	0	440
9148	1	1	1	438	0	441
9149	439	2	0	5	0	446
9150	5	0	1	474	0	480
9151	1	1	1	475	0	478
9152	1	487	3	6	0	497
9153	487	6	2	3	0	498
9154	496	2	0	2	0	500
9155	7	1	1	494	0	503
9156	3	0	4	483	0	490
9157	1	1	3	490	0	495
9158	0	472	1	8	0	481
9159	0	482	0	6	0	488
9160	0	10	2	462	0	474
9161	405	3	0	6	0	414
9162	395	1	0	4	0	400
9163	4	374	0	4	0	382
9164	328	3	0	2	0	333
9165	7	324	0	2	0	333
9166	1	328	1	3	0	333
9167	1	9	3	312	0	325
9168	298	3	0	3	0	304
9169	6	298	0	2	0	306
9170	3	294	1	4	0	302
9171	1	4	1	288	0	294
9172	0	2	0	297	0	299
9173	0	1	286	7	0	294
9174	285	2	2	2	0	291
9175	291	2	0	2	0	295
9176	5	0	287	2	0	294
9177	4	0	289	1	0	294
9178	3	0	3	288	0	294
9179	1	0	2	294	0	297
9180	0	289	1	9	0	299
9181	0	4	1	296	0	301
9182	0	2	290	10	0	302
9183	1	1	5	296	0	303
9184	1	1	1	296	0	299
9185	286	0	1	7	0	294
9186	5	0	275	4	0	284
9187	274	0	4	2	0	280
9188	5	0	267	3	0	275
9189	1	1	7	268	0	277
9190	0	1	264	5	0	270
9191	2	0	269	2	0	273
9192	3	1	6	257	0	267
9193	250	1	4	6	0	261
9194	240	0	3	3	0	246
9195	4	241	2	2	0	249
9196	243	5	0	2	0	250
9197	238	2	1	2	0	243
9198	8	236	0	2	0	246
9199	4	5	3	238	0	250
9200	2	2	2	247	0	253
9201	0	2	4	247	0	253
9202	2	0	1	249	0	252
9203	0	1	242	9	0	252
9204	239	1	6	4	0	250
9205	6	1	3	241	0	251
9206	4	1	1	240	0	246
9207	4	240	2	8	0	254
9208	2	7	0	248	0	257
9209	1	2	244	10	0	257
9210	243	2	7	4	0	256
9211	6	2	246	5	0	259
9212	3	1	7	244	0	255
9213	243	0	1	10	0	254
9214	7	243	1	5	0	256
9215	5	6	0	249	0	260
9216	2	3	247	7	0	259
9217	4	3	6	251	0	264
9218	239	2	2	9	0	252
9219	6	1	239	7	0	253
9220	2	1	234	4	0	241
9221	4	224	8	3	0	239
9222	218	7	4	1	0	230
9223	10	219	0	1	0	230
9224	3	7	214	3	0	227
9225	2	4	200	3	0	209
9226	3	199	8	2	0	212
9227	163	6	4	1	0	174
9228	4	165	1	2	0	172
9229	3	5	1	157	0	166
9230	0	1	2	165	0	168
9231	1	0	157	7	0	165
9232	1	1	6	156	0	164
9233	1	1	155	5	0	162
9234	151	2	5	2	0	160
9235	159	0	2	0	0	161
9236	158	1	1	1	0	161
9237	8	1	153	0	0	162
9238	157	0	6	0	0	163
9239	5	2	2	152	0	161
9240	2	154	0	4	0	160
9241	156	6	0	2	0	164
9242	5	2	152	1	0	160
9243	142	0	4	2	0	148
9244	147	0	4	0	0	151
9245	7	1	133	1	0	142
9246	3	130	6	0	0	139
9247	2	6	1	128	0	137
9248	1	1	126	5	0	133
9249	2	1	119	2	0	124
9250	0	9	6	80	0	95
9251	1	1	76	5	0	83
9252	1	0	4	68	0	73
9253	1	1	1	70	0	73
9254	3	0	0	69	0	72
9255	2	0	67	3	0	72
9256	1	0	5	69	0	75
9257	2	1	72	3	0	78
9258	0	0	4	74	0	78
9259	78	2	1	3	0	84
9260	4	0	1	82	0	87
9261	0	77	2	4	0	83
9262	1	2	1	80	0	84
9263	86	0	0	5	0	91
9264	2	85	2	1	0	90
9265	0	4	0	92	0	96
9266	87	0	1	4	0	92
9267	3	0	90	1	0	94
9268	0	0	5	88	0	93
9269	0	0	89	5	0	94
9270	1	0	90	0	0	91
9271	0	0	3	91	0	94
9272	88	1	0	4	0	93
9273	3	0	84	2	0	89
9274	84	1	4	0	0	89
9275	3	1	0	88	0	92
9276	1	0	95	4	0	100
9277	0	1	85	1	0	87
9278	0	0	84	1	0	85
9279	0	0	2	77	0	79
9280	77	0	0	2	0	79
9281	2	76	0	0	0	78
9282	0	2	0	77	0	79
9283	0	0	0	80	0	80
9284	82	0	0	2	0	84
9285	88	0	0	0	0	88
9286	2	85	0	0	0	87
9287	87	2	0	0	0	89
9288	88	0	0	0	0	88
9289	2	0	0	84	0	86
9290	0	0	83	3	0	86
9291	84	1	2	0	0	87
9292	2	0	0	87	0	89
9293	0	0	0	89	0	89
9294	87	0	0	2	0	89
9295	2	0	0	87	0	89
9296	0	0	0	89	0	89
9297	89	0	0	2	0	91
9298	2	89	0	0	0	91
9299	89	2	0	0	0	91
9300	2	0	90	0	0	92
9301	86	0	2	0	0	88
9302	2	0	0	87	0	89
9303	0	86	0	2	0	88
9304	0	2	0	88	0	90
9305	0	0	0	89	0	89
9306	0	0	0	93	0	93
9307	93	0	0	1	0	94
9308	1	92	0	0	0	93
9309	0	89	0	0	0	89
9310	88	0	0	0	0	88
9311	0	0	90	0	0	90
9312	0	0	92	0	0	92
9313	85	0	0	0	0	85
9314	1	0	94	0	0	95
9315	0	0	0	90	0	90
9316	0	0	0	95	0	95
9317	0	0	0	97	0	97
9318	0	0	0	98	0	98
9319	0	99	0	0	0	99
9320	0	0	0	101	0	101
9321	0	0	99	0	0	99
9322	0	0	0	98	0	98
9323	0	0	97	0	0	97
9324	0	0	98	0	0	98
9325	0	0	0	99	0	99
9326	0	0	100	0	0	100
9327	0	0	1	100	0	101
9328	98	0	0	1	0	99
9329	0	0	103	0	0	103
9330	98	0	0	0	0	98
9331	0	0	0	103	0	103
9332	3	0	100	0	0	103
9333	0	101	0	0	0	101
9334	1	0	0	104	0	105
9335	0	0	109	1	0	110
9336	0	0	1	110	0	111
9337	110	0	1	0	0	111
9338	108	0	1	0	0	109
9339	108	0	0	1	0	109
9340	0	0	0	112	0	112
9341	0	1	0	114	0	115
9342	0	0	0	118	0	118
9343	117	0	0	1	0	118
9344	1	122	0	0	0	123
9345	1	0	0	126	0	127
9346	0	1	0	126	0	127
9347	126	0	0	0	0	126
9348	1	130	1	0	0	132
9349	0	0	0	132	0	132
9350	132	0	1	0	0	133
9351	131	0	0	0	0	131
9352	0	0	0	133	0	133
9353	135	0	0	1	0	136
9354	1	0	0	137	0	138
9355	0	0	140	0	0	140
9356	0	0	0	144	0	144
9357	0	0	0	140	0	140
9358	0	1	0	139	0	140
9359	130	0	0	0	0	130
9360	0	133	0	0	0	133
9361	132	0	0	0	0	132
9362	0	135	0	0	0	135
9363	0	135	0	0	0	135
9364	134	0	0	0	0	134
9365	0	139	0	0	0	139
9366	0	0	0	139	0	139
9367	137	1	0	0	0	138
9368	134	0	0	0	0	134
9369	0	1	0	134	0	135
9370	0	1	0	136	0	137
9371	1	146	0	0	0	147
9372	150	1	0	0	0	151
9373	152	0	0	1	0	153
9374	1	157	0	0	0	158
9375	1	156	0	0	0	157
9376	0	5	0	155	0	160
9377	156	1	0	4	0	161
9378	2	1	0	163	0	166
9379	2	0	0	163	0	165
9380	1	0	162	3	0	166
9381	0	1	162	1	0	164
9382	0	1	3	160	0	164
9383	0	0	166	3	0	169
9384	1	159	2	1	0	163
9385	0	2	1	161	0	164
9386	1	1	1	162	0	165
9387	0	0	1	172	0	173
9388	0	0	169	4	0	173
9389	1	0	165	2	0	168
9390	164	1	4	0	0	169
9391	1	168	1	1	0	171
9392	166	2	0	2	0	170
9393	3	1	0	170	0	174
9394	179	1	0	3	0	183
9395	2	0	1	184	0	187
9396	2	179	1	2	0	184
9397	183	2	0	1	0	186
9398	2	2	175	1	0	180
9399	3	172	1	0	0	176
9400	176	2	1	2	0	181
9401	3	1	1	182	0	187
9402	1	173	0	4	0	178
9403	0	4	0	184	0	188
9404	185	1	0	4	0	190
9405	4	0	1	185	0	190
9406	177	2	0	3	0	182
9407	4	0	177	1	0	182
9408	1	1	3	174	0	179
9409	174	2	2	2	0	180
9410	3	0	175	3	0	181
9411	2	175	4	0	0	181
9412	0	2	1	178	0	181
9413	2	1	176	3	0	182
9414	2	8	3040	7	0	3057
9415	0	6	4	2902	0	2912
9416	2	1	3268	4	0	3275
9417	1	6	3071	4	0	3082
9418	2	1	3	3230	0	3236
9419	3413	0	0	3	0	3416
9420	3	2	1	3276	0	3282
9421	1	1	1	3285	0	3288
9422	2	0	3336	5	0	3343
9423	1	0	3	3177	0	3181
9424	3362	0	2	3	0	3367
9425	4	0	3276	3	0	3283
9426	2	3169	6	1	0	3178
9427	0	1	2	3351	0	3354
9428	3382	1	0	5	0	3388
9429	2	0	2	3345	0	3349
9430	1	3216	1	5	0	3223
9431	4	4	3300	3	0	3311
9432	1	1	3	3173	0	3178
9433	3411	1	1	3	0	3416
9434	6	0	3305	2	0	3313
9435	2	1	3	3319	0	3325
9436	3428	0	1	4	0	3433
9437	3346	2	1	1	0	3350
9438	4	3277	5	0	0	3286
9439	3389	3	0	2	0	3394
9440	5	1	0	3357	0	3363
9441	4	0	3406	3	0	3413
9442	0	3180	5	7	0	3192
9443	2	3272	2	1	0	3277
9444	1	5	2	3393	0	3401
9445	1	3	1	3368	0	3373
9446	4	0	3328	8	0	3340
9447	2	3034	5	6	0	3047
9448	0	3166	6	2	0	3174
9449	1	6	0	3353	0	3360
9450	3423	1	1	4	0	3429
9451	3	3136	5	3	0	3147
9452	3	5	0	3359	0	3367
9453	3408	2	2	3	0	3415
9454	2	3	0	3327	0	3332
9455	2	1	0	3273	0	3276
9456	1	0	0	3338	0	3339
9457	0	2	0	3359	0	3361
9458	3396	2	0	5	0	3403
9459	3	0	1	3364	0	3368
9460	4	1	3198	4	0	3207
9461	3048	2	5	6	0	3061
9462	4	3	3025	0	0	3032
9463	5	2	3017	2	0	3026
9464	1	1	5	3066	0	3073
9465	1	0	2	3187	0	3190
9466	0	1	0	3223	0	3224
9467	3255	0	1	6	0	3262
9468	5	0	3166	3	0	3174
9469	2983	0	4	1	0	2988
9470	3088	1	2	2	0	3093
9471	6	5	2990	1	0	3002
9472	2809	0	6	2	0	2817
9473	5	4	2988	1	0	2998
9474	2	2851	6	1	0	2860
9475	1	3	1	3113	0	3118
9476	0	0	1	3107	0	3108
9477	3	0	1	3028	0	3032
9478	1	3	1	2948	0	2953
9479	2	3	3051	2	0	3058
9480	2	3	2924	2	0	2931
9481	0	0	3	3021	0	3024
9482	0	4	3071	3	0	3078
9483	2671	2	4	3	0	2680
9484	3049	2	1	1	0	3053
9485	2	0	0	3037	0	3039
9486	3101	0	0	1	0	3102
9487	1	2942	4	4	0	2951
9488	3044	1	0	2	0	3047
9489	4	2	3039	1	0	3046
9490	1	1	2	2944	0	2948
9491	0	2871	6	2	0	2879
9492	3115	1	2	3	0	3121
9493	2	2	0	3034	0	3038
9494	5	0	3062	1	0	3068
9495	0	1	1	2921	0	2923
9496	3049	0	2	2	0	3053
9497	3	3	3013	4	0	3023
9498	4	0	2	2925	0	2931
9499	0	3	3	2920	0	2926
9500	2	0	2967	5	0	2974
9501	0	2654	8	8	0	2670
9502	1	2412	26	9	0	2448
9503	1	2	2	2995	0	3000
9504	1	2	3	2881	0	2887
9505	2	6	0	2919	0	2927
9506	2969	2	1	3	0	2975
9507	2807	1	3	3	0	2814
9508	3	1	0	2929	0	2933
9509	2996	0	1	5	0	3002
9510	2	2819	9	4	0	2834
9511	1	2	1	2960	0	2964
9512	0	3	1	2962	0	2966
9513	2	1	1	2961	0	2965
9514	271	1	0	6	0	278
9515	2	265	3	3	0	273
9516	3	2	1	273	0	279
9517	273	1	0	4	0	278
9518	3	0	1	276	0	280
9519	4	2	0	270	0	276
9520	1	264	0	4	0	269
9521	1	270	0	4	0	275
9522	1	2	1	278	0	282
9523	0	3	0	267	0	270
9524	269	2	0	5	0	276
9525	3	2	0	270	0	275
9526	3	0	270	6	0	279
9527	0	1	3	269	0	273
9528	2	275	3	4	0	284
9529	288	1	0	4	0	293
9530	2	3	3	292	0	300
9531	2	1	0	293	0	296
9532	2	286	0	6	0	294
9533	274	2	2	2	0	280
9534	3	289	0	2	0	294
9535	4	3	0	282	0	289
9536	0	3	282	3	0	288
9537	4	4	2	264	0	274
9538	264	1	1	2	0	268
9539	1	264	0	3	0	268
9540	3	1	1	270	0	275
9541	0	269	0	2	0	271
9542	2	1	0	277	0	280
9543	0	5	270	1	0	276
9544	0	0	1	272	0	273
9545	0	1	2	270	0	273
9546	0	0	0	280	0	280
9547	269	0	1	2	0	272
9548	276	1	0	3	0	280
9549	3	275	0	2	0	280
9550	279	1	0	2	0	282
9551	4	270	0	1	0	275
9552	1	272	0	1	0	274
9553	266	5	0	0	0	271
9554	3	3	267	1	0	274
9555	1	3	1	264	0	269
9556	0	2	1	271	0	274
9557	3	0	1	274	0	278
9558	268	0	2	4	0	274
9559	1	266	1	4	0	272
9560	2	1	0	274	0	277
9561	2	263	0	3	0	268
9562	277	2	0	1	0	280
9563	2	4	0	270	0	276
9564	2	1	0	330	0	333
9565	2	2831	1	3	0	2837
9566	3	57	1	2994	0	3055
9567	1	6	1	3093	0	3101
9568	2723	11	1	68	0	2803
9569	45	2694	9	28	0	2776
9570	3	2794	14	20	0	2831
9571	12	75	0	3042	0	3129
9572	9	43	2816	96	0	2964
9573	21	36	2824	44	0	2925
9574	15	21	55	3051	0	3142
9575	16	42	2779	87	0	2924
9576	14	36	67	2967	0	3084
9577	3	40	27	3053	0	3123
9578	8	26	44	3113	0	3191
9579	2866	11	40	129	0	3046
9580	61	19	50	3032	0	3162
9581	10	18	34	2949	0	3011
9582	13	2760	30	134	0	2937
9583	13	69	25	3115	0	3222
9584	22	38	2708	152	0	2920
9585	19	28	70	3081	0	3198
9586	27	18	19	3158	0	3222
9587	2845	50	31	154	0	3080
9588	68	60	22	3024	0	3174
9589	15	58	27	3065	0	3165
9590	37	31	31	3176	0	3275
9591	2541	29	58	191	0	2819
9592	76	2789	43	114	0	3022
9593	25	84	22	3095	0	3226
9594	33	30	55	3160	0	3278
9595	29	33	2707	207	0	2976
9596	24	16	84	3181	0	3305
9597	2667	33	48	213	0	2961
9598	94	2908	30	151	0	3183
9599	36	91	23	2950	0	3100
9600	29	51	32	3170	0	3282
9601	41	51	2699	219	0	3010
9602	2789	28	88	164	0	3069
9603	100	2879	48	143	0	3170
9604	2866	120	33	158	0	3177
9605	97	65	30	3094	0	3286
9606	44	55	45	3152	0	3296
9607	62	42	42	3196	0	3342
9608	55	54	37	3208	0	3354
9609	2970	50	26	222	0	3268
9610	140	72	24	2964	0	3200
9611	53	2862	34	263	0	3212
9612	56	96	47	3061	0	3260
9613	47	42	60	3198	0	3347
9614	2835	59	62	254	0	3210
9615	106	2777	57	232	0	3172
9616	75	109	24	3145	0	3353
9617	2825	69	48	246	0	3188
9618	2925	61	25	258	0	3269
9619	159	42	22	3149	0	3372
9620	83	71	2637	241	0	3032
9621	2947	79	73	199	0	3298
9622	136	85	28	3119	0	3368
9623	82	57	2735	255	0	3129
9624	113	35	104	3104	0	3356
9625	76	45	59	3057	0	3237
9626	97	39	59	2899	0	3094
9627	105	2692	41	273	0	3111
9628	86	84	44	3078	0	3292
9629	72	47	42	3132	0	3293
9630	61	65	33	3204	0	3363
9631	77	45	37	3179	0	3338
9632	99	58	29	3147	0	3333
9633	79	98	27	3206	0	3410
9634	2948	106	35	320	0	3409
9635	117	63	2602	295	0	3077
9636	91	2808	102	275	0	3276
9637	2801	128	49	240	0	3218
9638	117	2875	48	300	0	3340
9639	2939	121	71	219	0	3350
9640	179	52	68	3082	0	3381
9641	2880	56	72	312	0	3320
9642	181	48	94	2950	0	3273
9643	117	88	61	2712	0	2978
9644	117	2800	29	309	0	3255
9645	2911	121	45	261	0	3338
9646	153	92	2714	247	0	3206
9647	106	42	73	3131	0	3352
9648	91	62	2703	329	0	3185
9649	104	67	2709	244	0	3124
9650	2870	65	82	280	0	3297
9651	148	82	60	3072	0	3362
9652	99	58	2705	326	0	3188
9653	113	47	2636	244	0	3040
9654	95	60	136	2989	0	3280
9655	102	63	64	3095	0	3324
9656	2927	68	61	250	0	3306
9657	187	53	69	3013	0	3322
9658	120	60	2624	273	0	3077
9659	114	52	137	2987	0	3290
9660	108	67	82	2717	0	2974
9661	120	2853	69	257	0	3299
9662	2663	127	55	251	0	3096
9663	165	2864	66	246	0	3341
9664	2931	99	81	267	0	3378
9665	4	113	0	0	0	117
9666	0	90	5	0	0	95
9667	0	6	0	83	0	89
9668	2	0	0	84	0	86
9669	0	0	0	85	0	85
9670	77	0	0	3	0	80
9671	3	0	80	0	0	83
9672	0	0	3	75	0	78
9673	75	0	0	3	0	78
9674	3	79	0	0	0	82
9675	0	81	0	0	0	81
9676	0	7	0	76	0	83
9677	0	0	0	80	0	80
9678	0	0	0	84	0	84
9679	0	82	0	3	0	85
9680	0	2	0	82	0	84
9681	0	0	81	3	0	84
9682	0	0	73	0	0	73
9683	2122	0	1	0	0	2123
9684	1	0	0	2107	0	2108
9685	2166	0	0	1	0	2167
9686	2026	1	0	0	0	2027
9687	1	2004	1	0	0	2006
9688	2154	1	0	0	0	2155
9689	2127	0	0	0	0	2127
9690	1	0	0	2010	0	2011
9691	0	1	0	1890	0	1891
9692	0	0	2063	1	0	2064
9693	0	2000	1	0	0	2001
9694	2	2	1	1864	0	1869
9695	0	0	0	2032	0	2032
9696	2180	0	0	1	0	2181
9697	1	3	0	2050	0	2054
9698	2135	0	0	1	0	2136
9699	1	1	0	2096	0	2098
9700	0	2014	3	1	0	2018
9701	2175	1	0	0	0	2176
9702	1	0	0	2103	0	2104
9703	0	2	0	1913	0	1915
9704	0	0	0	2113	0	2113
9705	1	0	2188	3	0	2192
9706	0	1	4	1846	0	1851
9707	2172	0	0	3	0	2175
9708	3	1	0	2094	0	2098
9709	0	1	1	2085	0	2087
9710	0	1	0	2133	0	2134
9711	0	2133	0	4	0	2137
9712	0	2153	2	1	0	2156
9713	2217	6	0	0	0	2223
9714	4	2093	0	2	0	2099
9715	2172	2	0	0	0	2174
9716	1978	1	0	0	0	1979
9717	1755	0	1	0	0	1756
9718	5	2	1951	0	0	1958
9719	1	1915	5	0	0	1921
9720	2050	3	1	0	0	2054
9721	3	2	1	1906	0	1912
9722	2	3	0	1810	0	1815
9723	0	0	0	1962	0	1962
9724	0	1973	1	3	0	1977
9725	0	3	0	2062	0	2065
9726	2062	1	0	3	0	2066
9727	3	0	0	1910	0	1913
9728	1	0	0	1869	0	1870
9729	1	0	1960	4	0	1965
9730	0	1	1789	1	0	1791
9731	1	1	4	1785	0	1791
9732	0	0	1	1897	0	1898
9733	0	1938	0	4	0	1942
9734	0	3	0	1948	0	1951
9735	0	1	0	1876	0	1877
9736	0	0	0	1877	0	1877
9737	1932	1	0	4	0	1937
9738	4	2	1891	1	0	1898
9739	1	1	3	1807	0	1812
9740	1942	0	1	3	0	1946
9741	1812	1	0	1	0	1814
9742	3	0	0	1827	0	1830
9743	1	0	0	1867	0	1868
9744	1908	0	0	4	0	1912
9745	2	1813	0	1	0	1816
9746	1	1879	0	2	0	1882
9747	1	7	0	1921	0	1929
9748	1924	1	0	3	0	1928
9749	1775	0	1	1	0	1777
9750	1736	0	2	0	0	1738
9751	5	0	1781	0	0	1786
9752	1385	1	8	2	0	1396
9753	4	0	1715	0	0	1719
9754	1564	0	2	2	0	1568
9755	2	1613	5	0	0	1620
9756	3	3	1660	0	0	1666
9757	0	5	4	1440	0	1449
9758	0	0	1654	3	0	1657
9759	2	2	3	1373	0	1380
9760	1595	0	1	3	0	1599
9761	3	0	1587	1	0	1591
9762	2	1	3	1462	0	1468
9763	0	1476	1	2	0	1479
9764	0	3	0	1597	0	1600
9765	0	2	0	1444	0	1446
9766	2	1	0	1388	0	1391
9767	1567	0	0	4	0	1571
9768	1427	1	0	1	0	1429
9769	4	1	0	1462	0	1467
9770	2	0	1448	3	0	1453
9771	2	3	1303	2	0	1310
9772	0	1	5	1392	0	1398
9773	2	0	1482	3	0	1487
9774	0	0	5	1353	0	1358
9775	1	6	5	1161	0	1173
9776	0	0	0	1424	0	1424
9777	0	1404	0	4	0	1408
9778	0	1382	3	1	0	1386
9779	0	3	0	1446	0	1449
9780	0	2	1	1335	0	1338
9781	0	1	0	1301	0	1302
9782	1336	0	0	4	0	1340
9783	3	0	170	1	0	174
9784	1	0	3	165	0	169
9785	170	0	1	3	0	174
9786	3	167	0	1	0	171
9787	1	2	0	176	0	179
9788	0	1	0	177	0	178
9789	0	0	0	172	0	172
9790	0	0	0	174	0	174
9791	0	0	167	4	0	171
9792	167	0	3	1	0	171
9793	176	0	1	0	0	177
9794	4	0	176	0	0	180
9795	181	0	3	0	0	184
9796	179	0	1	0	0	180
9797	3	0	181	0	0	184
9798	4	177	3	0	0	184
9799	0	4	1	174	0	179
9800	0	1	184	3	0	188
9801	1	181	3	0	0	185
9802	0	1	171	0	0	172
9803	0	166	0	0	0	166
9804	0	8	1	159	0	168
9805	0	1	164	1	0	166
9806	0	0	1	167	0	168
9807	0	0	178	1	0	179
9808	0	173	0	1	0	174
9809	164	0	0	0	0	164
9810	0	165	1	0	0	166
9811	0	186	0	0	0	186
9812	0	2	0	182	0	184
9813	0	0	0	182	0	182
9814	0	0	0	182	0	182
9815	0	0	0	180	0	180
9816	0	0	0	184	0	184
9817	0	0	206	0	0	206
9818	0	0	0	203	0	203
9819	1	0	0	208	0	209
9820	215	0	0	0	0	215
9821	213	0	0	0	0	213
9822	214	0	0	0	0	214
9823	0	0	0	222	0	222
9824	250	0	0	0	0	250
9825	282	0	0	1	0	283
9826	292	0	0	0	0	292
9827	1	0	297	0	0	298
9828	298	0	1	0	0	299
9829	323	0	0	0	0	323
9830	332	0	1	0	0	333
9831	2	0	0	336	0	338
9832	0	0	341	2	0	343
9833	0	0	2	342	0	344
9834	368	0	0	2	0	370
9835	2	0	0	375	0	377
9836	1	407	0	2	0	410
9837	0	2	0	433	0	435
9838	438	0	0	2	0	440
9839	445	0	1	0	0	446
9840	440	0	0	0	0	440
9841	3	6	2378	1	0	2388
9842	1	4	2	2249	0	2256
9843	0	0	0	2570	0	2570
9844	3	0	2575	3	0	2581
9845	0	2414	2	2	0	2418
9846	2	3	2574	0	0	2579
9847	0	1	2	2468	0	2471
9848	2630	1	0	2	0	2633
9849	4	0	2617	1	0	2622
9850	0	1	3	2567	0	2571
9851	3	0	2623	5	0	2631
9852	2557	0	5	1	0	2563
9853	4	0	1	2670	0	2675
9854	2	0	2713	5	0	2720
9855	1	0	6	2625	0	2632
9856	1	0	2715	5	0	2721
9857	0	2591	5	3	0	2599
9858	0	5	1	2756	0	2762
9859	2771	1	0	4	0	2776
9860	5	1	1	2716	0	2723
9861	0	0	1	2730	0	2731
9862	2774	0	0	5	0	2779
9863	4	2668	3	0	0	2675
9864	1	2678	0	3	0	2682
9865	0	4	1	2779	0	2784
9866	1	2674	2	5	0	2682
9867	0	4	0	2788	0	2792
9868	0	0	1	2764	0	2765
9869	2780	1	0	5	0	2786
9870	4	2619	2	3	0	2628
9871	3	4	2689	2	0	2698
9872	0	2622	5	1	0	2628
9873	2793	4	0	1	0	2798
9874	2799	0	0	1	0	2800
9875	5	1	0	2781	0	2787
9876	2847	1	0	5	0	2853
9877	6	1	0	2806	0	2813
9878	2860	2	0	5	0	2867
9879	2866	0	0	2	0	2868
9880	6	1	0	2869	0	2876
9881	2925	0	0	7	0	2932
9882	7	2	2865	1	0	2875
9883	3620	1	5	0	0	3626
9884	6	5	0	3648	0	3659
9885	3755	0	1	5	0	3761
9886	7	3571	2	1	0	3581
9887	1	5	0	3738	0	3744
9888	2	0	1	3681	0	3684
9889	3730	0	0	9	0	3739
9890	10	2	3614	3	0	3629
9891	1	3408	8	7	0	3424
9892	1	6	0	3739	0	3746
9893	2	3550	4	9	0	3565
9894	1	5	1	3738	0	3745
9895	4	2	1	3631	0	3638
9896	1	1	1	3698	0	3701
9897	3758	0	2	6	0	3766
9898	4	1	0	3719	0	3724
9899	3781	0	0	7	0	3788
9900	3722	1	1	1	0	3725
9901	6	2	0	3763	0	3771
9902	3783	0	4	7	0	3794
9903	3656	1	1	1	0	3659
9904	7	0	3732	0	0	3739
9905	1	2	8	3559	0	3570
9906	3815	0	0	8	0	3823
9907	5	3561	6	2	0	3574
9908	3832	5	0	2	0	3839
9909	3799	0	1	2	0	3802
9910	7	3	3698	4	0	3712
9911	3	2	6	3428	0	3439
9912	3853	0	1	8	0	3862
9913	8	2	1	3799	0	3810
9914	2	0	0	3745	0	3747
9915	3	1	0	3783	0	3787
9916	1	1	0	3824	0	3826
9917	3877	0	1	9	0	3887
9918	11	2	3804	0	0	3817
9919	1	1	6	3858	0	3866
9920	3	4	4003	7	0	4017
9921	3	4	5420	2	0	5429
9922	5302	1	212	2	0	5517
9923	218	0	5864	4	0	6086
9924	156	5514	258	4	0	5932
9925	5964	218	169	2	0	6353
9926	6093	150	57	6	0	6306
9927	377	56	27	5694	0	6154
9928	222	22	5829	205	0	6278
9929	81	12	5736	159	0	5988
9930	5608	7	374	59	0	6048
9931	230	4	206	5906	0	6346
9932	6053	4	78	225	0	6360
9933	273	5771	34	170	0	6248
9934	6143	219	11	58	0	6431
9935	6114	155	14	34	0	6317
9936	408	5799	9	8	0	6224
9937	216	243	8	5905	0	6372
9938	5954	153	9	224	0	6340
9939	257	65	5702	170	0	6194
9940	180	5645	222	67	0	6114
9941	72	211	157	3988	0	4428
9942	3962	160	60	219	0	4401
9943	221	3969	30	168	0	4388
9944	4162	246	16	63	0	4487
9945	306	163	3934	35	0	4438
9946	4104	67	234	9	0	4414
9947	301	46	4104	14	0	4465
9948	4111	9	282	6	0	4408
9949	4215	11	196	9	0	4431
9950	427	9	3868	23	0	4327
9951	235	3835	260	23	0	4353
9952	106	227	172	3890	0	4395
9953	61	166	3932	222	0	4381
9954	39	3879	236	178	0	4332
9955	44	242	156	3937	0	4379
9956	20	177	72	4169	0	4438
9957	31	68	3914	390	0	4403
9958	45	32	227	3998	0	4302
9959	21	21	177	4194	0	4413
9960	25	22	3888	438	0	4373
9961	34	18	247	3975	0	4274
9962	31	3832	183	296	0	4342
9963	3934	243	66	193	0	4436
9964	241	180	40	3910	0	4371
9965	182	3926	28	263	0	4399
9966	101	269	40	3266	0	3676
9967	79	4012	77	204	0	4372
9968	71	295	3805	116	0	4287
9969	51	4002	280	45	0	4378
9970	3903	322	196	33	0	4454
9971	4123	215	79	15	0	4432
9972	4271	93	43	35	0	4442
9973	481	53	3855	61	0	4450
9974	283	42	3981	25	0	4331
9975	135	3862	430	53	0	4480
9976	104	227	269	3667	0	4267
9977	74	4074	125	256	0	4529
9978	119	304	89	3667	0	4179
9979	84	4134	52	263	0	4533
9980	4034	322	56	169	0	4581
9981	5618	246	35	77	0	5976
9982	569	142	26	5547	0	6284
9983	357	62	4601	414	0	5434
9984	5414	37	365	280	0	6096
9985	532	5361	288	162	0	6343
9986	318	459	167	5371	0	6315
9987	210	258	101	5425	0	5994
9988	168	5476	57	638	0	6339
9989	5479	557	35	370	0	6441
9990	558	317	5283	195	0	6353
9991	336	205	479	5489	0	6509
9992	5572	125	268	492	0	6457
9993	5729	103	196	291	0	6319
9994	781	5339	117	210	0	6447
9995	478	457	99	5082	0	6116
9996	249	5599	122	434	0	6404
9997	5555	611	72	266	0	6504
9998	521	362	5364	209	0	6456
9999	344	225	5624	122	0	6315
10000	224	184	655	5196	0	6259
10001	189	79	389	5355	0	6012
10002	99	5353	262	656	0	6370
10003	94	459	196	5698	0	6447
10004	107	282	5224	686	0	6299
10005	5362	157	482	418	0	6419
10006	475	120	344	5569	0	6508
10007	286	93	5329	615	0	6323
10008	182	122	519	5607	0	6430
10009	167	73	296	5526	0	6062
10010	72	5326	191	811	0	6400
10011	64	515	114	5617	0	6310
10012	73	282	96	5828	0	6279
10013	56	222	103	6025	0	6406
10014	5092	124	102	916	0	6234
10015	461	5087	73	541	0	6162
10016	329	5510	62	339	0	6240
10017	5220	672	50	209	0	6151
10018	5354	387	58	129	0	5928
10019	717	4961	101	124	0	5903
10020	446	5396	91	123	0	6056
10021	3119	299	13	48	0	3479
10022	298	3086	10	33	0	3427
10023	124	3209	12	29	0	3374
10024	2902	344	36	21	0	3303
10025	304	3067	10	42	0	3423
10026	3023	323	26	40	0	3412
10027	3083	177	24	39	0	3323
10028	3085	152	19	39	0	3295
10029	385	2811	20	43	0	3259
10030	218	3028	14	52	0	3312
10031	172	317	16	2754	0	3259
10032	127	2970	14	221	0	3332
10033	116	330	27	2941	0	3414
10034	2897	173	28	325	0	3423
10035	283	139	36	2929	0	3387
10036	172	2876	32	347	0	3427
10037	2836	294	38	165	0	3333
10038	300	2834	22	161	0	3317
10039	154	3091	20	138	0	3403
10040	142	373	20	2725	0	3260
10041	130	2978	29	265	0	3402
10042	2910	363	53	138	0	3464
10043	284	189	2711	154	0	3338
10044	167	2885	233	140	0	3425
10045	162	316	118	2886	0	3482
10046	152	183	2771	297	0	3403
10047	110	160	269	2943	0	3482
10048	95	165	149	3087	0	3496
10049	120	132	105	3140	0	3497
10050	102	109	119	3200	0	3530
10051	99	109	2735	487	0	3430
10052	97	2833	271	358	0	3559
10053	2827	286	154	291	0	3558
10054	278	163	2811	252	0	3504
10055	2867	164	280	212	0	3523
10056	350	140	2828	192	0	3510
10057	215	122	301	2934	0	3572
10058	198	98	2868	349	0	3513
10059	158	114	3010	186	0	3468
10060	134	118	359	2926	0	3537
10061	124	110	229	3061	0	3524
10062	121	97	186	3125	0	3529
10063	85	122	140	3228	0	3575
10064	2838	125	115	498	0	3576
10065	283	101	2733	363	0	3480
10066	2841	115	263	300	0	3519
10067	3062	114	148	205	0	3529
10068	3119	107	113	182	0	3521
10069	3134	116	92	148	0	3490
10070	3232	104	79	130	0	3545
10071	530	83	51	2881	0	3545
10072	338	107	2620	306	0	3371
10073	257	128	2754	189	0	3328
10074	193	2801	276	195	0	3465
10075	2766	310	146	180	0	3402
10076	302	189	110	2691	0	3292
10077	192	200	75	2783	0	3250
10078	207	2588	51	380	0	3226
10079	169	2768	39	251	0	3227
10080	191	2936	45	197	0	3369
10081	1076	132	19	31	0	1258
10082	126	69	11	957	0	1163
10083	89	971	6	110	0	1176
10084	1	4	0	356	0	361
10085	2	2	349	9	0	362
10086	1	2	368	1	0	372
10087	2	0	5	397	0	404
10088	424	2	1	6	0	433
10089	472	2	0	2	0	476
10090	472	0	0	3	0	475
10091	10	0	475	1	0	486
10092	5	3	8	476	0	492
10093	0	1	2	496	0	499
10094	3	2	476	8	0	489
10095	460	1	8	3	0	472
10096	7	2	472	2	0	483
10097	3	2	476	1	0	482
10098	0	1	475	3	0	479
10099	0	1	11	449	0	461
10100	1	1	5	469	0	476
10101	2	0	479	11	0	492
10102	3	0	9	482	0	494
10103	503	1	5	8	0	517
10104	10	1	2	503	0	516
10105	3	1	519	11	0	534
10106	2	1	543	6	0	552
10107	0	0	11	533	0	544
10108	539	2	4	11	0	556
10109	12	568	1	4	0	585
10110	606	9	2	2	0	619
10111	615	2	5	1	0	623
10112	11	1	614	2	0	628
10113	4	0	9	607	0	620
10114	615	2	4	11	0	632
10115	608	2	2	2	0	614
10116	14	602	1	5	0	622
10117	9	9	1	603	0	622
10118	0	2	5	615	0	622
10119	3	1	603	14	0	621
10120	4	0	12	600	0	616
10121	3	1	602	12	0	618
10122	2	2	593	5	0	602
10123	1	1	12	572	0	586
10124	574	0	4	13	0	591
10125	12	549	4	4	0	569
10126	559	9	2	4	0	574
10127	553	3	3	3	0	562
10128	11	549	3	3	0	566
10129	5	7	3	529	0	544
10130	530	4	3	8	0	545
10131	12	529	0	5	0	546
10132	521	8	1	1	0	531
10133	9	491	0	0	0	500
10134	3	9	0	473	0	485
10135	2	1	0	487	0	490
10136	471	0	1	10	0	482
10137	475	1	2	2	0	480
10138	9	461	0	4	0	474
10139	2	7	450	2	0	461
10140	0	2	460	1	0	463
10141	1	3	8	445	0	457
10142	4	451	1	6	0	462
10143	1	8	1	454	0	464
10144	1	2	1	457	0	461
10145	1	0	3	459	0	463
10146	1	1	452	9	0	463
10147	0	1	463	3	0	467
10148	3	466	7	1	0	477
10149	1	8	0	472	0	481
10150	2	1	2	477	0	482
10151	3	1	475	10	0	489
10152	450	1	9	3	0	463
10153	8	1	5	477	0	491
10154	5	1	483	7	0	496
10155	475	1	9	6	0	491
10156	9	478	4	2	0	493
10157	3	8	497	0	0	508
10158	2	1	8	500	0	511
10159	496	0	3	12	0	511
10160	9	0	504	2	0	515
10161	3	1	8	498	0	510
10162	2	3	3	503	0	511
10163	1	0	2	541	0	544
10164	554	0	5	10	0	569
10165	10	549	4	4	0	567
10166	4	10	2	550	0	566
10167	5	5	541	13	0	564
10168	0	2	9	543	0	554
10169	3	540	6	12	0	561
10170	5	560	1	4	0	570
10171	553	13	3	2	0	571
10172	560	6	2	4	0	572
10173	15	0	549	0	0	564
10174	545	2	10	2	0	559
10175	11	545	7	1	0	564
10176	556	9	0	4	0	569
10177	11	5	1	553	0	570
10178	5	0	548	9	0	562
10179	3	0	9	551	0	563
10180	1	2	550	10	0	563
10181	535	1	12	6	0	554
10182	11	0	3	546	0	560
10183	7	566	1	8	0	582
10184	0	12	0	565	0	577
10185	2	6	562	10	0	580
10186	4	537	8	7	0	556
10187	508	9	2	5	0	524
10188	8	493	1	3	0	505
10189	5	454	0	1	0	460
10190	7	10	1	437	0	455
10191	1	436	1	5	0	443
10192	3	6	1	437	0	447
10193	4	5	431	7	0	447
10194	407	2	5	3	0	417
10195	421	1	3	1	0	426
10196	9	1	426	0	0	436
10197	426	0	4	2	0	432
10198	4	421	5	1	0	431
10199	432	4	0	0	0	436
10200	5	4	0	428	0	437
10201	4	1	428	4	0	437
10202	1	428	5	4	0	438
10203	0	4	3	409	0	416
10204	1	3	0	413	0	417
10205	380	0	1	6	0	387
10206	360	0	1	3	0	364
10207	6	361	1	1	0	369
10208	3	352	0	0	0	355
10209	0	327	0	1	0	328
10210	2	7	2	296	0	307
10211	295	4	1	3	0	303
10212	289	1	0	3	0	293
10213	5	2	0	288	0	295
10214	4	1	0	290	0	295
10215	288	0	0	5	0	293
10216	2	1	1	303	0	307
10217	4	1	311	3	0	319
10218	320	1	2	3	0	326
10219	325	0	0	0	0	325
10220	5	0	319	1	0	325
10221	328	0	4	0	0	332
10222	2	1	2	335	0	340
10223	2	1	1	331	0	335
10224	2	0	1	334	0	337
10225	329	0	0	6	0	335
10226	2	335	1	2	0	340
10227	2	3	0	340	0	345
10228	0	331	1	3	0	335
10229	333	3	0	3	0	339
10230	3	3	1	332	0	339
10231	3	1	0	334	0	338
10232	1	344	0	5	0	350
10233	3	3	335	1	0	342
10234	0	5	2	347	0	354
10235	343	0	4	4	0	351
10236	380	0	1	4	0	385
10237	8	0	424	0	0	432
10238	6	0	6	444	0	456
10239	0	452	4	8	0	464
10240	2	9	0	467	0	478
10241	460	6	0	10	0	476
10242	469	0	1	4	0	474
10243	13	1	0	463	0	477
10244	7	464	1	9	0	481
10245	525	10	1	3	0	539
10246	9	6	0	538	0	553
10247	539	0	0	11	0	550
10248	565	1	0	6	0	572
10249	14	0	0	557	0	571
10250	5	2	1	572	0	580
10251	2	2	0	587	0	591
10252	1	583	0	13	0	597
10253	1	8	1	601	0	611
10254	4	5	0	593	0	602
10255	1	1	568	14	0	584
10256	1	0	568	8	0	577
10257	1	1	13	564	0	579
10258	559	2	7	8	0	576
10259	8	551	1	8	0	568
10260	562	8	2	2	0	574
10261	9	5	578	1	0	593
10262	6	1	585	0	0	592
10263	1	579	10	1	0	591
10264	3	6	6	572	0	587
10265	1	4	568	7	0	580
10266	2	0	1386	4	0	1392
10267	0	1	7	1374	0	1382
10268	1434	0	2	7	0	1443
10269	1419	2	0	2	0	1423
10270	9	0	0	1425	0	1434
10271	4	0	1465	7	0	1476
10272	0	0	8	1421	0	1429
10273	0	1	2	1453	0	1456
10274	1	1449	1	9	0	1460
10275	1481	6	0	1	0	1488
10276	1469	3	0	1	0	1473
10277	9	1419	1	2	0	1431
10278	2	6	3	1469	0	1480
10279	1	1444	1	8	0	1454
10280	1487	8	0	3	0	1498
10281	9	3	1450	1	0	1463
10282	5	0	1408	0	0	1413
10283	0	2	1420	1	0	1423
10284	0	3	8	1406	0	1417
10285	1	2	1	1421	0	1425
10286	1463	1	0	7	0	1471
10287	6	0	1	1448	0	1455
10288	2	0	1	1484	0	1487
10289	4	3	2543	11	0	2561
10290	3	2	2464	5	0	2474
10291	2502	0	7	3	0	2512
10292	9	2490	2	1	0	2502
10293	2636	7	0	2	0	2645
10294	8	3	0	2637	0	2648
10295	3	0	2	2610	0	2615
10296	2	2567	3	12	0	2584
10297	3	8	0	2655	0	2666
10298	2640	3	2	7	0	2652
10299	7	1	2	2640	0	2650
10300	5	1	2616	10	0	2632
10301	1	2485	8	9	0	2503
10302	2623	7	2	2	0	2634
10303	2632	2	0	3	0	2637
10304	2595	0	0	4	0	2599
10305	2619	2	1	2	0	2624
10306	9	0	2	2614	0	2625
10307	2	1	0	2631	0	2634
10308	6	2	2598	8	0	2614
10309	2	1	7	2547	0	2557
10310	6	0	2615	7	0	2628
10311	3	1	6	2593	0	2603
10312	2643	1	2	9	0	2655
10313	8	2599	1	5	0	2613
10314	2	8	2	2680	0	2692
10315	1	2	1	2687	0	2691
10316	2677	1	4	10	0	2692
10317	2539	0	3	5	0	2547
10318	12	1	2581	3	0	2597
10319	3	2526	7	2	0	2538
10320	3	10	2	2623	0	2638
10321	3	1	0	2619	0	2623
10322	2653	0	3	10	0	2666
10323	2547	2	3	7	0	2559
10324	11	1	2651	1	0	2664
10325	6	4	2550	1	0	2561
10326	1	2	11	2554	0	2568
10327	1	1	3	2614	0	2619
10328	6	0	2595	12	0	2613
10329	2446	3	6	2	0	2457
10330	9	2	4	2634	0	2649
10331	2654	0	1	10	0	2665
10332	8	2551	5	6	0	2570
10333	2637	7	2	4	0	2650
10334	10	1	2681	5	0	2697
10335	6	2549	12	4	0	2571
10336	0	2622	5	2	0	2629
10337	2630	5	9	1	0	2645
10338	2564	0	1	1	0	2566
10339	3	3	0	2546	0	2552
10340	2	2529	2	5	0	2538
10341	0	2556	2	7	0	2565
10342	0	4	1	2621	0	2626
10343	2619	0	0	3	0	2622
10344	2528	1	1	3	0	2533
10345	3	0	2514	0	0	2517
10346	2383	1	2	4	0	2390
10347	6	3312	0	5	0	3323
10348	3400	88	2	2	0	3492
10349	84	3519	4	3	0	3610
10350	8	3681	3	4	0	3696
10351	16	97	7	4443	0	4563
10352	4530	18	2	150	0	4700
10353	4618	14	0	35	0	4667
10354	184	8	4407	43	0	4642
10355	71	3	135	4501	0	4710
10356	4600	2	31	175	0	4808
10357	202	3	37	4561	0	4803
10358	4616	4	31	194	0	4845
10359	4726	4	26	67	0	4823
10360	219	11	6418	66	0	6714
10361	96	4	143	6257	0	6500
10362	76	3	34	6714	0	6827
10363	71	4	41	6859	0	6975
10364	38	10	6593	232	0	6873
10365	21	10	159	6523	0	6713
10366	16	9	39	5847	0	5911
10367	14	5673	55	235	0	5977
10368	25	162	5528	111	0	5826
10369	11	5704	155	81	0	5951
10370	5846	185	38	76	0	6145
10371	160	64	39	5744	0	6007
10372	43	66	30	5794	0	5933
10373	51	5705	29	184	0	5969
10374	5769	176	8	87	0	6040
10375	5811	40	19	76	0	5946
10376	197	5601	21	73	0	5892
10377	91	5782	12	52	0	5937
10378	5856	203	5	43	0	6107
10379	235	89	5649	27	0	6000
10380	87	81	5489	23	0	5680
10381	5544	63	175	28	0	5810
10382	196	5647	75	23	0	5941
10383	5893	169	78	18	0	6158
10384	209	57	5712	25	0	6003
10385	5555	50	170	28	0	5803
10386	230	5565	64	32	0	5891
10387	86	188	56	5786	0	6116
10388	104	55	36	5863	0	6058
10389	73	56	34	4731	0	4894
10390	75	42	27	4826	0	4970
10391	35	38	28	4840	0	4941
10392	38	4622	14	289	0	4963
10393	4770	172	12	167	0	5121
10394	186	45	4635	134	0	5000
10395	64	50	158	4755	0	5027
10396	73	52	4684	224	0	5033
10397	62	48	186	4646	0	4942
10398	57	20	85	4868	0	5030
10399	4701	34	78	251	0	5064
10400	185	18	4613	135	0	4951
10401	64	4449	189	109	0	4811
10402	69	167	55	4718	0	5009
10403	51	64	59	4907	0	5081
10404	64	56	4639	232	0	4991
10405	36	64	176	4576	0	4852
10406	45	48	56	4915	0	5064
10407	4644	39	62	279	0	5024
10408	179	4564	42	140	0	4925
10409	4715	185	46	115	0	5061
10410	4815	56	21	105	0	4997
10411	239	58	31	4679	0	5007
10412	128	62	4571	206	0	4967
10413	106	62	4539	77	0	4784
10414	107	31	183	4596	0	4917
10415	72	31	96	4539	0	4738
10416	48	4537	95	222	0	4902
10417	4614	168	81	105	0	4968
10418	160	4476	53	127	0	4816
10419	76	4676	36	91	0	4879
10420	4649	220	40	83	0	4992
10421	203	105	22	4555	0	4885
10422	93	4577	24	200	0	4894
10423	74	233	22	4683	0	5012
10424	64	88	4434	251	0	4837
10425	61	78	4394	122	0	4655
10426	39	57	184	4560	0	4840
10427	34	49	4575	241	0	4899
10428	29	32	225	4548	0	4834
10429	34	33	110	4575	0	4752
10430	30	18	96	4783	0	4927
10431	4513	30	64	293	0	4900
10432	166	4309	65	165	0	4705
10433	64	4543	29	160	0	4796
10434	4460	200	35	117	0	4812
10435	4546	91	19	96	0	4752
10436	232	75	30	4381	0	4718
10437	101	88	4355	204	0	4748
10438	92	65	158	4374	0	4689
10439	96	40	4347	232	0	4715
10440	65	4200	187	110	0	4562
10441	40	173	77	4552	0	4842
10442	4494	63	81	229	0	4867
10443	182	59	57	4483	0	4781
10444	70	58	4329	237	0	4694
10445	4069	55	177	116	0	4417
10446	221	44	4421	108	0	4794
10447	82	19	3466	66	0	3633
10448	44	3248	134	59	0	3485
10449	45	3153	101	18	0	3317
10450	38	3220	76	37	0	3371
10451	2341	21	19	29	0	2410
10452	2235	1	1	2	0	2239
10453	2	2	0	2184	0	2188
10454	1	2	0	2175	0	2178
10455	2	2	0	2293	0	2297
10456	1	2196	0	2	0	2199
10457	2332	3	0	1	0	2336
10458	3	2214	2	1	0	2220
10459	0	2	0	2299	0	2301
10460	442	1	0	3	0	446
10461	4	0	0	437	0	441
10462	0	1	0	453	0	454
10463	460	0	0	4	0	464
10464	458	0	0	0	0	458
10465	4	0	476	1	0	481
10466	1	0	473	1	0	475
10467	1	1	500	0	0	502
10468	1	0	3	491	0	495
10469	0	0	1	508	0	509
10470	0	499	1	3	0	503
10471	506	3	1	0	0	510
10472	3	0	0	515	0	518
10473	0	0	0	515	0	515
10474	0	539	1	3	0	543
10475	1	568	0	0	0	569
10476	0	3	0	591	0	594
10477	0	0	0	656	0	656
10478	669	1	0	7	0	677
10479	674	1	0	1	0	676
10480	5	0	0	667	0	672
10481	0	1	667	6	0	674
10482	1	2	653	1	0	657
10483	1	0	5	666	0	672
10484	0	0	1	668	0	669
10485	0	665	1	7	0	673
10486	674	5	0	1	0	680
10487	5	1	0	680	0	686
10488	3	1	683	5	0	692
10489	1	4	5	687	0	697
10490	0	1	691	6	0	698
10491	1	3	999	1	0	1004
10492	0	2	8	1007	0	1017
10493	1058	1	2	6	0	1067
10494	5	0	1034	3	0	1042
10495	1	1	4	1039	0	1045
10496	1	1	1097	4	0	1103
10497	1	0	3	1080	0	1084
10498	0	0	2	1101	0	1103
10499	0	0	1090	6	0	1096
10500	2	1	1049	2	0	1054
10501	0	1	7	1010	0	1018
10502	0	0	1	1082	0	1083
10503	1	0	1	1102	0	1104
10504	1	1	1	1091	0	1094
10505	1094	0	1	6	0	1101
10506	1089	0	1	3	0	1093
10507	5	1065	3	1	0	1074
10508	1111	4	1	2	0	1118
10509	4	1	1	1117	0	1123
10510	1125	0	3	4	0	1132
10511	4	0	1081	3	0	1088
10512	1093	0	4	2	0	1099
10513	4	0	1	1102	0	1107
10514	2	0	0	1119	0	1121
10515	1121	0	0	7	0	1128
10516	7	0	0	1148	0	1155
10517	2	1	1203	7	0	1213
10518	2844	1	9	2	0	2856
10519	203	2835	5	5	0	3048
10520	25	193	3	3104	0	3325
10521	12	27	3699	219	0	3957
10522	8	10	204	3834	0	4056
10523	7	13	3659	242	0	3921
10524	4	5	211	3679	0	3899
10525	6	3739	37	233	0	4015
10526	4	220	15	3714	0	3953
10527	1	3805	17	222	0	4045
10528	2	222	10	3864	0	4098
10529	5	35	8	4149	0	4197
10530	6	23	8	4172	0	4209
10531	7	14	3	4157	0	4181
10532	9	16	6	4220	0	4251
10533	7	15	3764	305	0	4091
10534	14	13	215	3966	0	4208
10535	14	18	34	4153	0	4219
10536	3863	19	24	303	0	4209
10537	221	3892	30	97	0	4240
10538	3933	239	25	68	0	4265
10539	232	43	27	3981	0	4283
10540	34	33	3698	283	0	4048
10541	16	3892	207	85	0	4200
10542	3837	244	32	70	0	4183
10543	224	3830	17	63	0	4134
10544	39	4117	11	63	0	4230
10545	3861	277	19	72	0	4229
10546	228	48	14	4048	0	4338
10547	3944	28	25	295	0	4292
10548	244	28	13	4027	0	4312
10549	56	24	3885	297	0	4262
10550	31	29	3983	88	0	4131
10551	3831	27	247	76	0	4181
10552	4109	18	48	66	0	4241
10553	280	26	36	3880	0	4222
10554	72	38	23	4143	0	4276
10555	3813	24	20	308	0	4165
10556	245	3744	31	88	0	4108
10557	50	4013	30	55	0	4148
10558	4168	279	16	46	0	4509
10559	4357	73	14	58	0	4502
10560	279	4149	22	52	0	4502
10561	74	277	17	4233	0	4601
10562	84	56	4125	279	0	4544
10563	58	47	4270	90	0	4465
10564	4173	33	265	72	0	4543
10565	282	33	4124	65	0	4504
10566	69	29	264	4045	0	4407
10567	59	24	73	4192	0	4348
10568	66	4124	42	303	0	4535
10569	4166	262	35	93	0	4556
10570	269	57	37	4197	0	4560
10571	81	58	3961	304	0	4404
10572	70	4060	226	107	0	4463
10573	45	307	46	4154	0	4552
10574	52	92	4005	309	0	4458
10575	71	58	4082	97	0	4308
10576	63	4038	271	94	0	4466
10577	3830	268	88	95	0	4281
10578	237	4403	78	105	0	4823
10579	4463	275	72	75	0	4885
10580	301	79	4327	68	0	4775
10581	4264	84	258	66	0	4672
10582	287	4386	70	91	0	4834
10583	75	276	49	4419	0	4819
10584	64	78	48	4726	0	4916
10585	4452	71	58	349	0	4930
10586	294	46	4353	156	0	4849
10587	4320	67	290	100	0	4777
10588	4641	78	71	87	0	4877
10589	323	85	4253	86	0	4747
10590	101	52	4479	111	0	4743
10591	71	58	285	4129	0	4543
10592	4117	52	82	329	0	4580
10593	4214	63	65	113	0	4455
10594	317	3986	57	87	0	4447
10595	115	282	55	4080	0	4532
10596	101	79	67	4237	0	4484
10597	87	61	51	4304	0	4503
10598	93	72	29	4384	0	4578
10599	4086	65	38	349	0	4538
10600	297	63	39	4188	0	4587
10601	132	46	3938	348	0	4464
10602	108	36	4086	118	0	4348
10603	3810	55	293	78	0	4236
10604	313	3864	92	79	0	4348
10605	133	4149	68	61	0	4411
10606	100	318	88	4453	0	4959
10607	97	97	48	4736	0	4978
10608	95	42	44	4657	0	4838
10609	88	49	58	4829	0	5024
10610	85	67	4375	377	0	4904
10611	69	63	267	4579	0	4978
10612	70	60	80	4794	0	5004
10613	80	45	4352	395	0	4872
10614	4164	39	272	153	0	4628
10615	296	4350	76	146	0	4868
10616	4452	275	55	123	0	4905
10617	318	80	4032	109	0	4539
10618	17	5	2099	12	0	2133
10619	7	2126	43	4	0	2180
10620	1388	696	30	19	0	2133
10621	1336	9	8	7	0	1360
10622	1338	3	8	1	0	1350
10623	31	1305	3	5	0	1344
10624	1322	24	3	2	0	1351
10625	25	8	1288	1	0	1322
10626	11	1301	18	1	0	1331
10627	1257	21	18	4	0	1300
10628	23	1259	3	2	0	1287
10629	1243	19	7	3	0	1272
10630	1236	9	2	2	0	1249
10631	33	3	1198	1	0	1235
10632	7	1220	20	5	0	1252
10633	1221	16	6	2	0	1245
10634	25	6	1195	2	0	1228
10635	6	1224	20	3	0	1253
10636	5	20	8	1233	0	1266
10637	6	6	1209	18	0	1239
10638	2	4	1198	4	0	1208
10639	3	3	19	1191	0	1216
10640	1195	1	7	21	0	1224
10641	21	1161	7	9	0	1198
10642	14	18	1197	2	0	1231
10643	5	5	1184	3	0	1197
10644	1163	5	22	3	0	1193
10645	22	1149	6	8	0	1185
10646	1122	18	9	2	0	1151
10647	20	1120	4	2	0	1146
10648	1142	17	3	6	0	1168
10649	1146	8	2	1	0	1157
10650	28	1114	2	1	0	1145
10651	4	21	4	1138	0	1167
10652	1154	5	1	17	0	1177
10653	22	2	1	1149	0	1174
10654	6	5	3	1181	0	1195
10655	1173	1	3	24	0	1201
10656	25	1160	2	7	0	1194
10657	1191	20	3	3	0	1217
10658	25	6	1169	3	0	1203
10659	8	4	19	1172	0	1203
10660	3	4	6	1199	0	1212
10661	1190	2	2	24	0	1218
10662	1197	4	4	11	0	1216
10663	23	0	3	1187	0	1213
10664	6	4	1183	21	0	1214
10665	5	2	17	1179	0	1203
10666	6	3	6	1199	0	1214
10667	5	1	3	1200	0	1209
10668	3	4	3	1202	0	1212
10669	1181	1	2	28	0	1212
10670	27	4	1168	6	0	1205
10671	9	1122	23	4	0	1158
10672	5	15	5	1179	0	1204
10673	4	9	5	1202	0	1220
10674	6	0	1178	31	0	1215
10675	5	5	1176	10	0	1196
10676	5	1	23	1189	0	1218
10677	3	2	2	1211	0	1218
10678	10	2	807	24	0	843
10679	2	3	22	822	0	849
10680	817	3	3	26	0	849
10681	23	825	7	10	0	865
10682	11	23	823	3	0	860
10683	5	835	21	4	0	865
10684	8	19	5	829	0	861
10685	7	6	815	24	0	852
10686	3	821	23	10	0	857
10687	5	23	7	815	0	850
10688	6	8	833	26	0	873
10689	4	2	22	835	0	863
10690	4	4	8	875	0	891
10691	857	5	3	31	0	896
10692	25	4	3	864	0	896
10693	872	2	4	25	0	903
10694	870	5	4	9	0	888
10695	888	5	3	2	0	898
10696	25	2	4	862	0	893
10697	7	4	851	22	0	884
10698	8	3	858	12	0	881
10699	863	1	26	7	0	897
10700	26	3	866	6	0	901
10701	853	2	22	7	0	884
10702	23	849	7	9	0	888
10703	873	23	1	4	0	901
10704	23	7	874	8	0	912
10705	9	2	900	7	0	918
10706	0	0	5	400	0	405
10707	2	0	413	6	0	421
10708	2	0	420	2	0	424
10709	0	0	6	451	0	457
10710	0	0	0	461	0	461
10711	2	0	0	481	0	483
10712	1	485	0	4	0	490
10713	0	5	1	479	0	485
10714	0	489	0	7	0	496
10715	492	5	0	3	0	500
10716	497	0	2	1	0	500
10717	5	4	0	485	0	494
10718	0	477	0	8	0	485
10719	0	6	499	2	0	507
10720	503	2	6	2	0	513
10721	8	0	1	503	0	512
10722	3	1	0	509	0	513
10723	1	1	0	513	0	515
10724	498	1	2	6	0	507
10725	10	477	1	1	0	489
10726	4	477	1	1	0	483
10727	467	7	1	4	0	479
10728	7	469	3	6	0	485
10729	477	7	2	2	0	488
10730	471	1	0	2	0	474
10731	7	470	2	1	0	480
10732	4	7	0	463	0	474
10733	1	465	0	7	0	473
10734	3	8	0	462	0	473
10735	3	0	1	480	0	484
10736	488	2	1	7	0	498
10737	503	1	0	3	0	507
10738	8	1	2	499	0	510
10739	1	2	495	10	0	508
10740	488	0	8	5	0	501
10741	10	481	1	3	0	495
10742	2	6	0	486	0	494
10743	1	2	2	493	0	498
10744	2	0	1	489	0	492
10745	464	4	1	9	0	478
10746	468	2	1	4	0	475
10747	9	444	1	4	0	458
10748	2	448	0	6	0	456
10749	4	9	0	438	0	451
10750	3	2	2	436	0	443
10751	4	1	422	9	0	436
10752	2	6	8	413	0	429
10753	3	2	403	10	0	418
10754	2	1	393	5	0	401
10755	1	382	6	5	0	394
10756	0	6	2	388	0	396
10757	382	1	4	9	0	396
10758	7	1	2	376	0	386
10759	0	3	375	7	0	385
10760	372	2	7	3	0	384
10761	379	2	1	1	0	383
10762	8	3	373	2	0	386
10763	3	2	7	378	0	390
10764	376	2	1	7	0	386
10765	9	370	1	1	0	381
10766	380	6	0	2	0	388
10767	390	1	2	2	0	395
10768	8	0	1	386	0	395
10769	3	1	0	399	0	403
10770	395	2	1	6	0	404
10771	10	1	0	394	0	405
10772	3	0	391	11	0	405
10773	380	2	10	2	0	394
10774	401	2	0	2	0	405
10775	11	391	1	5	0	408
10776	3	410	3	5	0	421
10777	3	10	1	401	0	415
10778	5	402	1	11	0	419
10779	5	13	0	402	0	420
10780	400	7	1	10	0	418
10781	384	4	0	4	0	392
10782	13	384	0	2	0	399
10783	381	12	1	5	0	399
10784	11	387	1	2	0	401
10785	384	10	1	5	0	400
10786	392	6	2	3	0	403
10787	13	1	383	3	0	400
10788	377	4	11	0	0	392
10789	12	370	2	5	0	389
10790	6	384	1	2	0	393
10791	375	12	2	4	0	393
10792	13	5	3	370	0	391
10793	7	3	380	11	0	401
10794	7	4	10	383	0	404
10795	3	3	2	384	0	392
10796	3	3	369	16	0	391
10797	368	2	11	4	0	385
10798	14	356	3	5	0	378
10799	349	11	5	3	0	368
10800	13	2	0	345	0	360
10801	341	2	1	12	0	356
10802	10	336	0	9	0	355
10803	12	15	1	335	0	363
10804	338	3	1	12	0	354
10805	14	1	320	5	0	340
10806	5	2	311	5	0	323
10807	288	2	14	2	0	306
10808	13	281	2	4	0	300
10809	5	247	1	1	0	254
10810	10	12	3	224	0	249
10811	5	232	1	9	0	247
10812	4	9	1	225	0	239
10813	3	3	0	231	0	237
10814	4	0	0	228	0	232
10815	0	225	0	10	0	235
10816	1	9	1	220	0	231
10817	0	3	217	12	0	232
10818	1	215	7	4	0	227
10819	1	6	2	196	0	205
10820	3	191	1	5	0	200
10821	192	6	1	1	0	200
10822	192	6	0	0	0	198
10823	200	1	0	1	0	202
10824	9	192	0	0	0	201
10825	5	4	0	191	0	200
10826	3	2	189	6	0	200
10827	2	0	193	3	0	198
10828	189	1	5	2	0	197
10829	188	2	3	0	0	193
10830	9	2	1	194	0	206
10831	4	2	1	202	0	209
10832	2	1	196	10	0	209
10833	0	195	7	4	0	206
10834	1	201	2	3	0	207
10835	0	9	187	3	0	199
10836	0	4	8	170	0	182
10837	2	0	3	165	0	170
10838	2	3	0	176	0	181
10839	2	0	0	177	0	179
10840	169	1	1	10	0	181
10841	8	1	167	2	0	178
10842	169	2	6	1	0	178
10843	6	2	2	170	0	180
10844	172	0	0	7	0	179
10845	8	0	1	173	0	182
10846	4	0	180	6	0	190
10847	2	2	6	181	0	191
10848	1	2	190	7	0	200
10849	0	3	7	191	0	201
10850	1	0	188	14	0	203
10851	2	196	6	2	0	206
10852	1	6	3	194	0	204
10853	1	2	0	194	0	197
10854	0	191	0	9	0	200
10855	195	9	1	2	0	207
10856	7	3	0	195	0	205
10857	2	1	2	201	0	206
10858	195	1	2	8	0	206
10859	213	0	0	6	0	219
10860	217	2	0	2	0	221
10861	224	0	1	1	0	226
10862	10	0	202	1	0	213
10863	208	1	6	0	0	215
10864	214	2	3	0	0	219
10865	9	0	0	207	0	216
10866	3	0	2	208	0	213
10867	194	1	1	8	0	204
10868	8	188	0	4	0	200
10869	4	5	0	182	0	191
10870	0	2	193	7	0	202
10871	0	186	7	4	0	197
10872	181	3	3	0	0	187
10873	184	4	0	0	0	188
10874	175	0	0	0	0	175
10875	178	0	0	0	0	178
10876	4	0	0	176	0	180
10877	0	0	177	4	0	181
10878	0	0	194	0	0	194
10879	0	0	4	201	0	205
10880	213	0	0	4	0	217
10881	4	0	0	218	0	222
10882	0	0	217	4	0	221
10883	228	0	4	0	0	232
10884	226	0	0	0	0	226
10885	4	0	0	225	0	229
10886	0	0	234	4	0	238
10887	0	0	234	2	0	236
10888	229	0	4	0	0	233
10889	3	230	0	0	0	233
10890	0	3	223	0	0	226
10891	0	0	3	222	0	225
10892	225	0	0	3	0	228
10893	3	213	0	0	0	216
10894	0	217	0	0	0	217
10895	218	3	0	0	0	221
10896	3	0	0	219	0	222
10897	229	0	0	3	0	232
10898	2	0	0	236	0	238
10899	0	0	0	241	0	241
10900	0	0	237	3	0	240
10901	0	0	234	0	0	234
10902	0	0	254	0	0	254
10903	0	0	3	247	0	250
10904	252	0	1	3	0	256
10905	3	0	250	1	0	254
10906	1	0	3	249	0	253
10907	0	1	260	4	0	265
10908	0	260	3	2	0	265
10909	0	3	1	271	0	275
10910	0	1	0	274	0	275
10911	0	0	0	273	0	273
10912	270	0	0	4	0	274
10913	3	0	0	266	0	269
10914	1	0	0	269	0	270
10915	265	0	0	4	0	269
10916	3	0	265	1	0	269
10917	262	0	3	0	0	265
10918	263	0	1	2	0	266
10919	4	0	262	0	0	266
10920	255	0	3	0	0	258
10921	3	0	1	268	0	272
10922	1	0	275	3	0	279
10923	270	0	3	1	0	274
10924	282	0	1	0	0	283
10925	4	0	0	279	0	283
10926	1	0	0	284	0	285
10927	0	0	0	282	0	282
10928	278	0	0	4	0	282
10929	3	276	0	1	0	280
10930	268	1	0	0	0	269
10931	2	264	0	0	0	266
10932	2	260	0	0	0	262
10933	1	3	0	271	0	275
10934	0	2	1	270	0	273
10935	1	0	0	272	0	273
10936	1	0	0	269	0	270
10937	0	0	262	3	0	265
10938	261	0	2	1	0	264
10939	1	0	2	262	0	265
10940	1	0	276	1	0	278
10941	0	1	1	278	0	280
10942	0	0	2	286	0	288
10943	0	0	291	3	0	294
10944	1	0	1	295	0	297
10945	0	0	1	302	0	303
10946	290	1	0	2	0	293
10947	2	0	292	2	0	296
10948	282	0	1	1	0	284
10949	1	287	1	0	0	289
10950	290	1	0	1	0	292
10951	282	1	1	1	0	285
10952	2	0	1	287	0	290
10953	3	1	282	1	0	287
10954	0	299	2	1	0	302
10955	0	2	1	296	0	299
10956	2	311	0	0	0	313
10957	317	1	1	1	0	320
10958	1	2	310	2	0	315
10959	1	0	300	0	0	301
10960	0	1	2	307	0	310
10961	3	2	2098	1	0	2104
10962	0	0	2	2075	0	2077
10963	0	0	2	2231	0	2233
10964	2259	0	1	3	0	2263
10965	2	2183	1	5	0	2191
10966	1	2	1	2279	0	2283
10967	1	1	0	2244	0	2246
10968	0	0	2	2249	0	2251
10969	1	2188	2	3	0	2194
10970	1	2213	0	3	0	2217
10971	2243	2	1	2	0	2248
10972	2222	1	1	3	0	2227
10973	2186	0	0	2	0	2188
10974	2	1	2217	1	0	2221
10975	2	1	0	2156	0	2159
10976	4	0	2200	1	0	2205
10977	0	2140	4	4	0	2148
10978	2234	0	6	1	0	2241
10979	2	4	2186	1	0	2193
10980	1	0	1	2176	0	2178
10981	3	0	2210	2	0	2215
10982	2091	1	0	3	0	2095
10983	2210	0	2	1	0	2213
10984	2227	0	0	0	0	2227
10985	2155	0	0	1	0	2156
10986	2	1	2212	1	0	2216
10987	2114	0	0	2	0	2116
10988	2220	0	1	1	0	2222
10989	3	2141	4	3	0	2151
10990	2241	0	0	1	0	2242
10991	2226	1	0	0	0	2227
10992	1	0	0	2204	0	2205
10993	1	2169	1	1	0	2172
10994	2257	0	2	2	0	2261
10995	2314	1	1	1	0	2317
10996	7	4	3613	6	0	3630
10997	5	5	3726	1	0	3737
10998	7	6	3767	0	0	3780
10999	3	1	197	3681	0	3882
11000	3712	0	117	98	0	3927
11001	89	3708	64	67	0	3928
11002	3748	96	14	54	0	3912
11003	144	3760	2	19	0	3925
11004	3736	145	4	2	0	3887
11005	147	3682	12	3	0	3844
11006	75	3786	14	3	0	3878
11007	3688	164	7	3	0	3862
11008	101	3705	4	9	0	3819
11009	55	157	0	3747	0	3959
11010	58	73	3628	98	0	3857
11011	20	64	3653	60	0	3797
11012	7	21	144	3632	0	3804
11013	6	8	111	3793	0	3918
11014	6	12	3700	153	0	3871
11015	3	11	114	3704	0	3832
11016	5	7	63	3856	0	3931
11017	3692	5	52	172	0	3921
11018	98	3663	24	120	0	3905
11019	60	109	12	3572	0	3753
11020	55	3724	20	94	0	3893
11021	5608	152	15	57	0	5832
11022	100	5421	14	59	0	5594
11023	5649	153	10	21	0	5833
11024	5672	75	6	14	0	5767
11025	178	57	4	5492	0	5731
11026	122	26	4	5524	0	5676
11027	77	18	9	5560	0	5664
11028	21	14	20	5667	0	5722
11029	14	20	5367	227	0	5628
11030	4783	19	109	147	0	5058
11031	108	5171	75	90	0	5444
11032	85	103	56	5520	0	5764
11033	69	72	20	5566	0	5727
11034	32	5404	18	173	0	5627
11035	5529	122	20	121	0	5792
11036	108	5395	36	82	0	5621
11037	65	158	31	5527	0	5781
11038	68	85	22	5595	0	5770
11039	45	76	14	5641	0	5776
11040	22	51	8	5687	0	5768
11041	5550	26	14	254	0	5844
11042	121	31	5371	145	0	5668
11043	84	29	111	5467	0	5691
11044	80	30	98	5507	0	5715
11045	35	35	105	5661	0	5836
11046	20	29	57	5681	0	5787
11047	5470	21	22	285	0	5798
11048	151	30	5328	180	0	5689
11049	98	40	111	5367	0	5616
11050	82	5261	84	132	0	5559
11051	55	5466	79	83	0	5683
11052	5425	190	33	83	0	5731
11053	131	139	5313	63	0	5646
11054	5036	121	115	45	0	5317
11055	213	53	5362	36	0	5664
11056	120	35	141	5227	0	5523
11057	5485	34	92	164	0	5775
11058	132	5225	96	132	0	5585
11059	71	132	65	5246	0	5514
11060	75	5091	50	157	0	5373
11061	3725	166	40	111	0	4042
11062	3747	104	34	96	0	3981
11063	191	77	41	3671	0	3980
11064	155	44	3490	193	0	3882
11065	123	36	3459	137	0	3755
11066	55	59	160	3434	0	3708
11067	42	3436	127	165	0	3770
11068	36	160	69	3696	0	3961
11069	63	115	28	3637	0	3843
11070	59	106	13	3694	0	3872
11071	58	65	3486	271	0	3880
11072	63	27	109	3636	0	3835
11073	40	27	97	3679	0	3843
11074	27	3331	74	260	0	3692
11075	28	119	30	3613	0	3790
11076	19	76	32	3779	0	3906
11077	20	53	38	3793	0	3904
11078	35	29	31	3812	0	3907
11079	47	25	27	3824	0	3923
11080	33	33	26	3874	0	3966
11081	28	33	22	3826	0	3909
11082	32	56	23	3811	0	3922
11083	46	63	3410	286	0	3805
11084	47	48	99	3607	0	3801
11085	3513	46	72	244	0	3875
11086	152	17	69	3564	0	3802
11087	99	15	3396	256	0	3766
11088	3098	25	110	168	0	3401
11089	3446	26	82	130	0	3684
11090	3491	38	74	93	0	3696
11091	3555	32	37	89	0	3713
11092	257	29	26	3381	0	3693
11093	169	24	3186	201	0	3580
11094	112	3036	130	158	0	3436
11095	67	3287	105	141	0	3600
11096	5	3	10	1718	0	1736
11097	1	2	0	1721	0	1724
11098	1	2	2	1620	0	1625
11099	0	0	0	1693	0	1693
11100	0	0	1	1716	0	1717
11101	1757	0	0	3	0	1760
11102	5	1670	1	2	0	1678
11103	0	1692	1	1	0	1694
11104	0	6	1	1767	0	1774
11105	1	1	0	1791	0	1793
11106	1	1	0	1731	0	1733
11107	1	0	0	1722	0	1723
11108	3	2	1664	6	0	1675
11109	6	1453	11	6	0	1476
11110	0	5	1	1739	0	1745
11111	1705	1	2	4	0	1712
11112	4	4	0	1676	0	1684
11113	1	1	1600	8	0	1610
11114	3	2	1448	3	0	1456
11115	4	2	1557	5	0	1568
11116	0	2	13	1366	0	1381
11117	1623	2	2	6	0	1633
11118	5	1	4	1588	0	1598
11119	0	2	0	1604	0	1606
11120	1581	1	0	7	0	1589
11121	5	0	0	378	0	383
11122	0	0	1	338	0	339
11123	2	1	344	6	0	353
11124	1	350	6	4	0	361
11125	1	6	1	368	0	376
11126	369	1	2	6	0	378
11127	6	2	1	373	0	382
11128	1	0	366	9	0	376
11129	3	0	6	372	0	381
11130	1	367	1	10	0	379
11131	2	5	4	382	0	393
11132	1	2	372	8	0	383
11133	0	1700	8	2	0	1710
11134	2	156	1	1746	0	1905
11135	1	71	2	1936	0	2010
11136	3	63	1	2016	0	2083
11137	1	18	2	2119	0	2140
11138	0	7	1645	327	0	1979
11139	2	1769	155	166	0	2092
11140	1794	155	69	95	0	2113
11141	1934	74	50	28	0	2086
11142	237	64	18	1824	0	2143
11143	147	22	1744	167	0	2080
11144	1873	10	160	85	0	2128
11145	182	12	78	1896	0	2168
11146	83	15	1829	206	0	2133
11147	72	4	180	1928	0	2184
11148	21	0	80	2044	0	2145
11149	4	4	73	2098	0	2179
11150	3	9	1708	329	0	2049
11151	11	13	169	1870	0	2063
11152	22	1789	76	248	0	2135
11153	1838	161	66	101	0	2166
11154	1986	71	25	83	0	2165
11155	2056	66	16	38	0	2176
11156	322	1817	15	20	0	2174
11157	1980	166	7	25	0	2178
11158	260	76	16	1840	0	2192
11159	1894	67	14	196	0	2171
11160	2031	21	6	113	0	2171
11161	265	8	1695	111	0	2079
11162	155	1760	161	56	0	2132
11163	1868	168	91	20	0	2147
11164	199	91	55	1820	0	2165
11165	106	86	1654	177	0	2023
11166	107	1792	154	87	0	2140
11167	1804	174	67	83	0	2128
11168	194	106	59	1831	0	2190
11169	95	76	18	2004	0	2193
11170	93	22	11	2051	0	2177
11171	44	1742	7	368	0	2161
11172	34	167	16	1948	0	2165
11173	28	1811	41	267	0	2147
11174	26	259	17	1898	0	2200
11175	57	116	1720	261	0	2154
11176	51	81	165	1913	0	2210
11177	20	33	100	2068	0	2221
11178	22	28	109	2085	0	2244
11179	48	34	1681	370	0	2133
11180	32	14	175	2023	0	2244
11181	28	17	106	2094	0	2245
11182	30	17	77	2113	0	2237
11183	25	30	37	2157	0	2249
11184	27	31	33	2178	0	2269
11185	37	32	1707	391	0	2167
11186	40	29	175	2028	0	2272
11187	40	23	102	2096	0	2261
11188	1802	10	88	332	0	2232
11189	217	1655	44	229	0	2145
11190	125	1872	29	168	0	2194
11191	90	249	33	1854	0	2226
11192	59	132	35	1964	0	2190
11193	33	1786	17	335	0	2171
11194	58	176	15	1937	0	2186
11195	61	1795	27	314	0	2197
11196	41	246	44	1908	0	2239
11197	46	134	21	2060	0	2261
11198	67	97	1640	326	0	2130
11199	66	1666	177	264	0	2173
11200	61	1883	89	159	0	2192
11201	1585	274	78	68	0	2005
11202	197	1810	42	60	0	2109
11203	112	276	18	1763	0	2169
11204	100	119	1603	266	0	2088
11205	55	101	175	1828	0	2159
11206	1685	76	96	299	0	2156
11207	191	49	1657	176	0	2073
11208	108	1700	182	147	0	2137
11209	103	170	106	1783	0	2162
11210	45	91	100	1925	0	2161
11211	1707	96	46	337	0	2186
11212	182	65	21	1900	0	2168
11213	115	40	25	1997	0	2177
11214	94	36	37	1993	0	2160
11215	39	44	19	2074	0	2176
11216	1674	24	27	447	0	2172
11217	1854	26	33	273	0	2186
11218	269	18	22	1889	0	2198
11219	1810	21	42	282	0	2155
11220	263	26	57	1803	0	2149
11221	117	24	1543	340	0	2024
11222	100	37	1683	223	0	2043
11223	90	22	226	1562	0	1900
11224	39	1640	141	240	0	2060
11225	18	199	99	1772	0	2088
11226	1612	98	31	344	0	2085
11227	190	78	19	1833	0	2120
11228	1733	46	11	344	0	2134
11229	276	32	21	1812	0	2141
11230	135	47	1518	314	0	2014
11231	101	1566	178	189	0	2034
11232	51	1829	109	188	0	2177
11233	0	3	0	236	0	239
11234	0	0	230	1	0	231
11235	0	198	1	1	0	200
11236	0	3	0	190	0	193
11237	189	0	0	1	0	190
11238	0	0	187	0	0	187
11239	0	0	0	193	0	193
11240	0	0	0	191	0	191
11241	0	0	194	1	0	195
11242	0	1	199	0	0	200
11243	0	0	202	0	0	202
11244	0	0	1	206	0	207
11245	0	1	210	0	0	211
11246	218	0	1	0	0	219
11247	2	0	0	239	0	241
11248	0	0	296	2	0	298
11249	1	301	3	0	0	305
11250	1	3	312	0	0	316
11251	0	2	3	309	0	314
11252	329	0	0	3	0	332
11253	3	0	0	336	0	339
11254	0	0	0	339	0	339
11255	374	0	0	3	0	377
11256	3	0	0	387	0	390
11257	0	0	386	5	0	391
11258	382	0	5	0	0	387
11259	5	382	0	1	0	388
11260	399	5	1	0	0	405
11261	6	0	0	399	0	405
11262	0	1	401	5	0	407
11263	1	0	401	0	0	402
11264	0	0	5	405	0	410
11265	0	0	1	406	0	407
11266	0	0	405	6	0	411
11267	0	0	390	1	0	391
11268	384	0	6	1	0	391
11269	5	0	2	392	0	399
11270	388	0	2	7	0	397
11271	8	0	0	393	0	401
11272	1	1	421	7	0	430
11273	3	3	434	0	0	440
11274	1	1	5	437	0	444
11275	1	0	2	442	0	445
11276	0	0	443	8	0	451
11277	449	0	9	2	0	460
11278	7	0	1	462	0	470
11279	477	0	3	9	0	489
11280	9	555	2	2	0	568
11281	2	11	2	591	0	606
11282	594	1	1	11	0	607
11283	14	2	577	3	0	596
11284	2	1	11	599	0	613
11285	3	0	3	604	0	610
11286	1	0	5	617	0	623
11287	0	0	601	16	0	617
11288	0	0	12	611	0	623
11289	0	596	3	16	0	615
11290	2	10	5	618	0	635
11291	2	1	607	15	0	625
11292	2	3	615	4	0	624
11293	3	2	11	615	0	631
11294	1	2	5	624	0	632
11295	1	1	5	630	0	637
11296	2	0	2	638	0	642
11297	624	0	2	17	0	643
11298	623	0	2	8	0	633
11299	12	0	604	8	0	624
11300	4	620	10	5	0	639
11301	4	10	2	633	0	649
11302	653	3	4	11	0	671
11303	632	5	1	5	0	643
11304	644	2	1	5	0	652
11305	655	0	4	3	0	662
11306	14	0	640	2	0	656
11307	616	0	10	4	0	630
11308	14	618	1	7	0	640
11309	2	10	4	627	0	643
11310	2	1	626	13	0	642
11311	4	5	10	624	0	643
11312	3	1	629	14	0	647
11313	1	1	14	647	0	663
11314	0	2	4	659	0	665
11315	653	1	3	15	0	672
11316	14	0	1	662	0	677
11317	5	0	666	17	0	688
11318	8	1	11	685	0	705
11319	686	0	2	16	0	704
11320	15	0	6	688	0	709
11321	8	8	2426	16	0	2458
11322	7	2472	12	5	0	2496
11323	2628	12	2	8	0	2650
11324	12	1	3	2595	0	2611
11325	2	2551	4	12	0	2569
11326	2608	11	1	3	0	2623
11327	15	4	2588	7	0	2614
11328	2	2298	19	7	0	2326
11329	8	12	2	2612	0	2634
11330	3	4	2563	14	0	2584
11331	0	6	15	2455	0	2476
11332	2563	2	3	19	0	2587
11333	15	1	2533	6	0	2555
11334	2	0	12	2484	0	2498
11335	6	1	2564	15	0	2586
11336	3	3	14	2513	0	2533
11337	3	5	3	2595	0	2606
11338	2600	2	3	15	0	2620
11339	12	2473	1	12	0	2498
11340	4	12	2	2599	0	2617
11341	2615	3	2	11	0	2631
11342	2570	6	1	4	0	2581
11343	13	2	2	2559	0	2576
11344	3	2435	5	14	0	2457
11345	9	2506	2	5	0	2522
11346	3	14	2	2576	0	2595
11347	0	6	2	2544	0	2552
11348	2488	4	3	12	0	2507
11349	8	2	2	2485	0	2497
11350	1	4	2424	15	0	2444
11351	2186	1	9	7	0	2203
11352	9	2293	8	11	0	2321
11353	2398	9	5	2	0	2414
11354	16	3	2357	4	0	2380
11355	6	2147	20	3	0	2176
11356	2426	8	2	2	0	2438
11357	2386	0	3	3	0	2392
11358	10	6	2350	2	0	2368
11359	2318	2	7	0	0	2327
11360	2428	1	0	2	0	2431
11361	10	2283	4	2	0	2299
11362	5	7	1	2449	0	2462
11363	6	2	2372	8	0	2388
11364	4	3	8	2342	0	2357
11365	3	3	2409	13	0	2428
11366	1	2	9	2378	0	2390
11367	2445	0	5	11	0	2461
11368	8	0	3	2467	0	2478
11369	2	3	2454	12	0	2471
11370	2430	1	9	5	0	2445
11371	10	0	4	4166	0	4180
11372	6	5	4003	104	0	4118
11373	3909	2	101	18	0	4030
11374	106	2	17	4134	0	4259
11375	19	5	4051	123	0	4198
11376	31	7	4564	24	0	4626
11377	19	9	114	4456	0	4598
11378	13	7	4579	123	0	4722
11379	6	4291	136	26	0	4459
11380	5	98	35	4554	0	4692
11381	4547	13	29	118	0	4707
11382	104	29	4496	23	0	4652
11383	19	18	4494	27	0	4558
11384	4174	10	121	34	0	4339
11385	119	11	4505	20	0	4655
11386	4248	2	134	9	0	4393
11387	138	4	4470	14	0	4626
11388	35	1	149	4394	0	4579
11389	35	2	4501	115	0	4653
11390	27	1	147	4352	0	4527
11391	22	6	4477	137	0	4642
11392	14	14	4400	47	0	4475
11393	3979	6	144	53	0	4182
11394	115	5419	75	39	0	5648
11395	5764	98	63	26	0	5951
11396	120	5507	61	25	0	5713
11397	46	131	33	5697	0	5907
11398	42	43	26	5861	0	5972
11399	5769	31	24	122	0	5946
11400	125	25	31	5705	0	5886
11401	33	17	5666	167	0	5883
11402	5495	9	121	51	0	5676
11403	5742	5	41	56	0	5844
11404	136	2	50	5705	0	5893
11405	67	4	5659	118	0	5848
11406	61	5	122	5528	0	5716
11407	34	5505	49	139	0	5727
11408	31	109	46	5646	0	5832
11409	23	33	34	5821	0	5911
11410	14	30	5586	162	0	5792
11411	4828	25	124	89	0	5066
11412	122	5444	37	73	0	5676
11413	5621	116	32	47	0	5816
11414	118	5469	47	34	0	5668
11415	53	129	28	5514	0	5724
11416	60	5427	23	114	0	5624
11417	57	150	5258	44	0	5509
11418	28	44	119	5248	0	5439
11419	18	38	45	5530	0	5631
11420	21	38	36	5715	0	5810
11421	4017	18	31	163	0	4229
11422	116	8	23	4081	0	4228
11423	4019	5	33	169	0	4226
11424	4113	8	26	65	0	4212
11425	4122	21	17	50	0	4210
11426	172	20	3857	47	0	4096
11427	80	14	100	3964	0	4158
11428	62	13	42	4081	0	4198
11429	63	20	44	4139	0	4266
11430	4104	19	41	184	0	4348
11431	132	10	46	4086	0	4274
11432	45	17	32	4246	0	4340
11433	4133	13	31	212	0	4389
11434	152	16	42	4172	0	4382
11435	52	20	4585	193	0	4850
11436	53	21	4574	99	0	4747
11437	60	18	175	4720	0	4973
11438	4657	16	78	218	0	4969
11439	4516	13	103	68	0	4700
11440	208	14	55	4654	0	4931
11441	79	9	4528	219	0	4835
11442	91	4438	187	75	0	4791
11443	84	150	61	4644	0	4939
11444	55	27	73	4805	0	4960
11445	45	36	60	4849	0	4990
11446	4702	26	47	258	0	5033
11447	192	20	4557	118	0	4887
11448	4576	13	190	97	0	4876
11449	202	13	69	4551	0	4835
11450	58	4565	76	217	0	4916
11451	4675	154	45	79	0	4953
11452	4679	37	33	68	0	4817
11453	210	43	4573	73	0	4899
11454	91	4426	181	56	0	4754
11455	76	4698	52	50	0	4876
11456	4634	184	43	66	0	4927
11457	193	50	41	4604	0	4888
11458	66	43	33	4716	0	4858
11459	70	30	37	4696	0	4833
11460	62	4367	41	226	0	4696
11461	54	4619	37	109	0	4819
11462	4584	175	16	115	0	4890
11463	179	69	17	4623	0	4888
11464	68	54	4535	220	0	4877
11465	73	36	159	4620	0	4888
11466	59	28	5476	223	0	5786
11467	38	41	5471	97	0	5647
11468	44	53	5407	72	0	5576
11469	67	5163	340	57	0	5627
11470	68	247	1771	3677	0	5763
11471	1	3706	105	114	0	3926
11472	4	186	63	3695	0	3948
11473	2	70	30	3923	0	4025
11474	3760	70	13	192	0	4035
11475	131	45	10	3878	0	4064
11476	3248	24	2	233	0	3507
11477	3384	10	6	93	0	3493
11478	196	8	5	3222	0	3431
11479	104	3178	7	181	0	3470
11480	101	130	11	3228	0	3470
11481	63	3208	10	183	0	3464
11482	30	176	5	3302	0	3513
11483	12	75	3117	207	0	3411
11484	9	65	121	3242	0	3437
11485	8	53	35	3427	0	3523
11486	3119	23	49	225	0	3416
11487	129	3168	38	128	0	3463
11488	47	135	20	3297	0	3499
11489	54	39	11	3343	0	3447
11490	46	3213	12	192	0	3463
11491	31	171	6	3286	0	3494
11492	3103	54	10	239	0	3406
11493	3200	64	10	101	0	3375
11494	160	2023	12	104	0	2299
11495	93	158	8	2071	0	2330
11496	2026	42	8	180	0	2256
11497	185	2040	10	61	0	2296
11498	67	170	7	2008	0	2252
11499	70	2012	14	175	0	2271
11500	2053	196	12	69	0	2330
11501	160	81	4094	76	0	4411
11502	44	78	4297	64	0	4483
11503	69	59	153	4235	0	4516
11504	62	37	4359	166	0	4624
11505	39	20	234	4250	0	4543
11506	4372	15	120	215	0	4722
11507	152	20	4358	100	0	4630
11508	57	32	174	4269	0	4532
11509	74	21	63	4375	0	4533
11510	4432	29	66	219	0	4746
11511	155	4231	53	130	0	4569
11512	4396	141	26	151	0	4714
11513	4435	51	23	95	0	4604
11514	231	4201	18	71	0	4521
11515	132	176	21	4416	0	4745
11516	131	70	4198	172	0	4571
11517	86	69	132	4144	0	4431
11518	43	4163	43	215	0	4464
11519	4384	177	64	114	0	4739
11520	158	63	39	4435	0	4695
11521	52	76	4299	215	0	4642
11522	74	49	150	4256	0	4529
11523	52	39	58	4486	0	4635
11524	43	25	68	4517	0	4653
11525	39	29	52	4484	0	4604
11526	39	42	29	4309	0	4419
11527	26	31	4245	335	0	4637
11528	30	38	4137	203	0	4408
11529	18	4030	155	193	0	4396
11530	20	4262	91	118	0	4491
11531	4335	172	92	92	0	4691
11532	176	78	4202	49	0	4505
11533	3986	105	170	51	0	4312
11534	213	77	4050	53	0	4393
11535	89	44	3528	38	0	3699
11536	89	37	162	3351	0	3639
11537	3656	30	110	127	0	3923
11538	114	20	109	3565	0	3808
11539	63	25	64	3622	0	3774
11540	78	8	3532	185	0	3803
11541	59	18	123	3480	0	3680
11542	30	9	54	3659	0	3752
11543	24	16	65	3731	0	3836
11544	29	18	50	3685	0	3782
11545	31	22	25	3715	0	3793
11546	3553	17	25	246	0	3841
11547	110	8	22	3711	0	3851
11548	43	16	3496	241	0	3796
11549	64	21	80	3590	0	3755
11550	64	18	3508	203	0	3793
11551	54	25	130	3468	0	3677
11552	41	21	3525	190	0	3777
11553	28	18	146	3430	0	3622
11554	12	19	84	3627	0	3742
11555	15	11	3446	202	0	3674
11556	2978	7	137	151	0	3273
11557	94	24	3456	138	0	3712
11558	54	14	134	3433	0	3635
11559	3532	10	77	150	0	3769
11560	134	9	77	3422	0	3642
11561	64	13	62	3527	0	3666
11562	75	9	3402	190	0	3676
11563	62	3140	95	152	0	3449
11564	25	3246	49	137	0	3457
11565	32	3348	74	118	0	3572
11566	12	5	4	2354	0	2375
11567	2376	3	2	3	0	2384
11568	2	2	0	2285	0	2289
11569	1	1	0	2301	0	2303
11570	0	1	0	2321	0	2322
11571	2	0	0	2317	0	2319
11572	0	2242	1	5	0	2248
11573	1	4	0	2365	0	2370
11574	0	4	0	2350	0	2354
11575	0	2253	1	6	0	2260
11576	2377	3	0	2	0	2382
11577	2	3	0	2336	0	2341
11578	2338	0	0	4	0	2342
11579	2297	2	0	2	0	2301
11580	5	2274	2	0	0	2281
11581	2	2	0	2386	0	2390
11582	1	5	2292	8	0	2306
11583	3	2	2206	2	0	2213
11584	0	4	4	2221	0	2229
11585	2399	0	2	2	0	2403
11586	2321	0	1	3	0	2325
11587	2	1	1	2297	0	2301
11588	2403	0	0	2	0	2405
11589	7	2301	2	3	0	2313
11590	2365	1	0	0	0	2366
11591	0	2315	1	1	0	2317
11592	4	1	0	2383	0	2388
11593	0	3	0	2355	0	2358
11594	1	2338	0	2	0	2341
11595	2370	2	0	2	0	2374
11596	1	3	2304	1	0	2309
11597	2	0	1	2299	0	2302
11598	0	3	2363	1	0	2367
11599	1	0	2	2224	0	2227
11600	2375	0	3	3	0	2381
11601	1	0	0	433	0	434
11602	423	0	1	1	0	425
11603	417	0	0	3	0	420
11604	3	0	0	438	0	441
11605	2	0	446	2	0	450
11606	1	482	1	2	0	486
11607	1	1	1	483	0	486
11608	484	1	0	2	0	487
11609	1	0	486	2	0	489
11610	2	2	1	486	0	491
11611	0	0	2	493	0	495
11612	1	0	0	503	0	504
11613	502	0	1	3	0	506
11614	1	0	0	495	0	496
11615	2	0	0	502	0	504
11616	0	0	524	4	0	528
11617	1	0	0	522	0	523
11618	0	0	3	545	0	548
11619	0	0	0	552	0	552
11620	0	530	1	4	0	535
11621	0	1	0	538	0	539
11622	0	3	0	527	0	530
11623	526	0	0	5	0	531
11624	3	1	521	3	0	528
11625	3	0	501	1	0	505
11626	0	516	5	1	0	522
11627	1	3	3	543	0	550
11628	546	3	1	3	0	553
11629	3	0	2	545	0	550
11630	3	1	0	546	0	550
11631	0	0	0	553	0	553
11632	1	0	0	541	0	542
11633	0	0	0	534	0	534
11634	0	0	529	7	0	536
11635	0	0	2	533	0	535
11636	535	0	3	4	0	542
11637	3	511	0	4	0	518
11638	3	3	1	535	0	542
11639	0	3	0	547	0	550
11640	1	0	518	6	0	525
11641	0	1	3	512	0	516
11642	0	0	4	550	0	554
11643	551	0	0	8	0	559
11644	3	557	1	6	0	567
11645	6	4	0	569	0	579
11646	0	6	0	577	0	583
11647	0	0	0	575	0	575
11648	0	1	584	12	0	597
11649	0	1	572	7	0	580
11650	0	564	12	1	0	577
11651	0	595	6	1	0	602
11652	0	11	0	585	0	596
11653	0	586	1	4	0	591
11654	0	11	0	617	0	628
11655	0	5	0	690	0	695
11656	0	0	0	721	0	721
11657	0	0	0	2251	0	2251
11658	2	5	2092	173	0	2272
11659	1	2	148	2384	0	2535
11660	0	2	109	2410	0	2521
11661	1	0	33	2607	0	2641
11662	2178	1	39	398	0	2616
11663	156	2244	64	250	0	2714
11664	126	157	36	2150	0	2469
11665	37	2429	64	300	0	2830
11666	2239	198	29	284	0	2750
11667	1934	181	15	182	0	2312
11668	282	2294	9	149	0	2734
11669	185	2519	17	108	0	2829
11670	107	420	2068	64	0	2659
11671	105	2497	156	102	0	2860
11672	99	307	134	2380	0	2920
11673	2331	264	44	217	0	2856
11674	237	2405	48	196	0	2886
11675	169	306	66	2404	0	2945
11676	67	311	47	2561	0	2986
11677	79	131	79	2764	0	3053
11678	2426	151	48	437	0	3062
11679	222	150	2222	354	0	2948
11680	2496	78	157	243	0	2974
11681	277	2373	138	206	0	2994
11682	222	263	41	2549	0	3075
11683	127	213	2253	346	0	2939
11684	2364	114	233	270	0	2981
11685	332	2378	171	110	0	2991
11686	258	266	108	2280	0	2912
11687	154	2478	71	268	0	2971
11688	103	330	80	2479	0	2992
11689	102	261	62	2646	0	3071
11690	54	154	2268	431	0	2907
11691	109	119	2339	319	0	2886
11692	81	164	298	2459	0	3002
11693	63	105	2379	386	0	2933
11694	48	108	260	2543	0	2959
11695	37	71	242	2593	0	2943
11696	25	38	162	2816	0	3041
11697	2310	21	167	535	0	3033
11698	225	38	185	2619	0	3067
11699	186	40	2276	464	0	2966
11700	2353	64	233	385	0	3035
11701	227	74	182	2551	0	3034
11702	227	31	87	2756	0	3101
11703	2331	39	96	553	0	3019
11704	316	2287	123	315	0	3041
11705	246	202	91	2510	0	3049
11706	97	182	103	2679	0	3061
11707	2390	93	64	529	0	3076
11708	294	75	2141	414	0	2924
11709	194	102	183	2523	0	3002
11710	151	63	183	2617	0	3014
11711	135	101	79	2612	0	2927
11712	110	2208	93	552	0	2963
11713	91	174	126	2640	0	3031
11714	2306	155	70	474	0	3005
11715	238	2270	88	445	0	3041
11716	2351	218	40	353	0	2962
11717	276	2395	29	291	0	2991
11718	2445	264	38	270	0	3017
11719	325	274	2196	174	0	2969
11720	278	170	2298	221	0	2967
11721	2445	116	312	155	0	3028
11722	353	177	2304	120	0	2954
11723	334	128	258	2260	0	2980
11724	147	130	254	2450	0	2981
11725	166	87	180	2632	0	3065
11726	2367	70	182	473	0	3092
11727	289	53	2273	330	0	2945
11728	2437	66	266	271	0	3040
11729	319	57	227	2466	0	3069
11730	2421	91	95	454	0	3061
11731	337	74	85	2590	0	3086
11732	2520	81	103	402	0	3106
11733	428	42	104	2598	0	3172
11734	337	56	2328	375	0	3096
11735	2592	74	240	298	0	3204
11736	2653	68	194	267	0	3182
11737	519	44	109	2530	0	3202
11738	306	53	112	2646	0	3117
11739	229	2291	151	488	0	3159
11740	2425	185	109	321	0	3040
11741	360	2398	132	213	0	3103
11742	2577	216	94	246	0	3133
11743	383	184	2240	277	0	3084
11744	266	113	2317	298	0	2994
11745	219	84	2416	227	0	2946
11746	2402	142	372	142	0	3058
11747	402	2292	238	124	0	3056
11748	277	253	192	2361	0	3083
11749	2354	167	177	300	0	2998
11750	333	2315	206	232	0	3086
11751	304	253	137	2303	0	2997
11752	165	2251	110	310	0	2836
11753	183	2214	80	321	0	2798
11754	187	2561	61	150	0	2959
11755	2001	452	53	188	0	2694
11756	336	2389	77	193	0	2995
11757	3	561	3	3	0	570
11758	1	508	1	5	0	515
11759	498	10	6	2	0	516
11760	492	6	0	1	0	499
11761	10	1	476	3	0	490
11762	468	3	6	0	0	477
11763	464	1	3	2	0	470
11764	10	3	1	440	0	454
11765	453	1	1	7	0	462
11766	8	2	448	2	0	460
11767	3	472	7	1	0	483
11768	477	5	4	1	0	487
11769	8	4	1	500	0	513
11770	501	2	1	7	0	511
11771	8	1	496	4	0	509
11772	501	1	5	1	0	508
11773	6	2	1	495	0	504
11774	6	0	491	5	0	502
11775	1	477	6	3	0	487
11776	2	500	1	1	0	504
11777	3	12	1	473	0	489
11778	2	3	3	469	0	477
11779	0	478	1	7	0	486
11780	475	7	1	1	0	484
11781	472	3	0	1	0	476
11782	459	2	2	2	0	465
11783	6	466	0	6	0	478
11784	3	5	1	452	0	461
11785	3	468	0	5	0	476
11786	472	4	3	1	0	480
11787	461	2	1	0	0	464
11788	6	457	0	1	0	464
11789	465	7	0	1	0	473
11790	7	1	0	464	0	472
11791	3	1	0	463	0	467
11792	468	3	0	6	0	477
11793	464	0	2	0	0	466
11794	464	0	0	2	0	466
11795	8	1	0	462	0	471
11796	4	0	0	472	0	476
11797	2	0	457	9	0	468
11798	1	1	5	453	0	460
11799	1	1	1	450	0	453
11800	2	1	428	7	0	438
11801	0	4	419	1	0	424
11802	2	0	426	2	0	430
11803	0	0	7	424	0	431
11804	1	1	419	5	0	426
11805	2	0	7	415	0	424
11806	3	0	2	424	0	429
11807	2	1	418	9	0	430
11808	0	1	422	3	0	426
11809	1	0	6	417	0	424
11810	1	2	429	6	0	438
11811	1	1	431	3	0	436
11812	1	421	9	1	0	432
11813	427	7	2	1	0	437
11814	441	2	2	0	0	445
11815	428	0	2	1	0	431
11816	6	425	0	2	0	433
11817	2	418	1	0	0	421
11818	2	7	0	418	0	427
11819	3	1	0	412	0	416
11820	1	2	400	7	0	410
11821	0	1	7	402	0	410
11822	414	0	2	7	0	423
11823	6	0	1	400	0	407
11824	1	417	2	6	0	426
11825	432	6	1	2	0	441
11826	430	1	2	0	0	433
11827	435	1	1	1	0	438
11828	8	1	422	1	0	432
11829	2	4	5	412	0	423
11830	452	1	3	5	0	461
11831	5	1	451	5	0	462
11832	2	429	6	1	0	438
11833	0	375	1	2	0	378
11834	330	0	1	0	0	331
11835	0	320	0	0	0	320
11836	0	1	0	312	0	313
11837	0	2	316	0	0	318
11838	1	3	0	315	0	319
11839	313	1	0	0	0	314
11840	0	314	0	1	0	315
11841	312	0	0	0	0	312
11842	0	0	313	1	0	314
11843	1	2	0	294	0	297
11844	0	308	0	0	0	308
11845	1	4	0	302	0	307
11846	308	0	1	0	0	309
11847	311	0	0	1	0	312
11848	307	1	0	0	0	308
11849	309	0	0	1	0	310
11850	1	0	0	305	0	306
11851	1	0	318	0	0	319
11852	1	0	0	319	0	320
11853	1	321	0	0	0	322
11854	324	0	0	1	0	325
11855	0	0	317	0	0	317
11856	308	0	0	1	0	309
11857	0	1	0	311	0	312
11858	1	4	1284	0	0	1289
11859	0	0	1	1300	0	1301
11860	1384	1	0	0	0	1385
11861	1350	0	1	2	0	1353
11862	1325	0	1	0	0	1326
11863	0	0	1361	1	0	1362
11864	1	1	0	1309	0	1311
11865	1	1	1336	0	0	1338
11866	1	1318	2	1	0	1322
11867	1349	1	1	0	0	1351
11868	0	1287	0	4	0	1291
11869	1305	2	0	0	0	1307
11870	4	0	0	1287	0	1291
11871	0	1250	3	1	0	1254
11872	1306	0	0	0	0	1306
11873	0	2	1232	0	0	1234
11874	0	0	0	1265	0	1265
11875	1300	0	1	0	0	1301
11876	0	0	1267	0	0	1267
11877	0	1	0	1241	0	1242
11878	0	1241	3	2	0	1246
11879	0	0	0	1325	0	1325
11880	0	0	0	1309	0	1309
11881	1319	0	0	1	0	1320
11882	0	1251	1	2	0	1254
11883	0	0	0	1319	0	1319
11884	0	1260	1	5	0	1266
11885	0	0	0	1309	0	1309
11886	0	1271	0	1	0	1272
11887	1298	0	0	0	0	1298
11888	0	0	1292	0	0	1292
11889	0	0	0	1262	0	1262
11890	0	0	0	1271	0	1271
11891	1	0	0	1306	0	1307
11892	0	0	0	1269	0	1269
11893	0	0	1285	0	0	1285
11894	1	1209	1	0	0	1211
11895	1308	1	0	0	0	1309
11896	1292	0	0	0	0	1292
11897	0	1255	1	1	0	1257
11898	1314	0	0	0	0	1314
11899	1284	0	1	0	0	1285
11900	0	1259	1	1	0	1261
11901	0	0	1	1308	0	1309
11902	2	1265	1	1	0	1269
11903	1304	0	0	0	0	1304
11904	0	1	1276	0	0	1277
11905	1171	0	1	2	0	1174
11906	0	1	1264	0	0	1265
11907	0	0	0	1261	0	1261
11908	1289	1	0	0	0	1290
11909	0	2	1201	0	0	1203
11910	1204	1	1	0	0	1206
11911	1263	0	0	0	0	1263
11912	0	0	1	1274	0	1275
11913	0	1200	1	1	0	1202
11914	1290	0	0	1	0	1291
11915	0	1	0	1277	0	1278
11916	1	1173	1	3	0	1178
11917	1269	0	1	0	0	1270
11918	0	1	0	1280	0	1281
11919	1	3220	11	3	0	3235
11920	1	1	0	3567	0	3569
11921	3603	1	0	0	0	3604
11922	3526	0	0	4	0	3530
11923	3527	1	1	0	0	3529
11924	2	1	0	3486	0	3489
11925	0	0	0	3471	0	3471
11926	1	3	3455	0	0	3459
11927	6	4	1	3231	0	3242
11928	1	1	3479	3	0	3484
11929	3	14	3072	6	0	3095
11930	1	5	3198	4	0	3208
11931	0	3211	11	5	0	3227
11932	2	4	6	3453	0	3465
11933	0	3270	10	1	0	3281
11934	3561	2	0	3	0	3566
11935	3507	1	2	2	0	3512
11936	4	0	0	3523	0	3527
11937	2	2	3562	3	0	3569
11938	1	1	4	3387	0	3393
11939	1	1	3573	9	0	3584
11940	2	1	3	3452	0	3458
11941	2	3397	2	6	0	3407
11942	0	3496	3	5	0	3504
11943	3518	6	0	1	0	3525
11944	6	5	3583	1	0	3595
11945	3	3	4	3505	0	3515
11946	1	2	2	3591	0	3596
11947	3626	1	1	6	0	3634
11948	4	3447	3	5	0	3459
11949	3645	4	1	4	0	3654
11950	5	3472	6	6	0	3489
11951	3628	3	1	3	0	3635
11952	3570	3	1	2	0	3576
11953	6	2	3	4349	0	4360
11954	4	6	4336	90	0	4436
11955	3999	4	79	15	0	4097
11956	78	4243	14	7	0	4342
11957	4441	88	3	2	0	4534
11958	83	17	3	3477	0	3580
11959	20	6	0	3516	0	3542
11960	7	3450	2	92	0	3551
11961	3	90	1	3485	0	3579
11962	1	3482	3	88	0	3574
11963	4	90	0	3559	0	3653
11964	0	16	2	3604	0	3622
11965	3482	7	3	105	0	3597
11966	92	6	3435	19	0	3552
11967	17	3294	71	11	0	3393
11968	7	79	14	3525	0	3625
11969	3514	13	6	89	0	3622
11970	3550	4	2	18	0	3574
11971	3569	3	2	6	0	3580
11972	110	3	3426	5	0	3544
11973	3378	1	77	2	0	3458
11974	94	2	11	3537	0	3644
11975	3496	0	7	91	0	3594
11976	87	3421	2	20	0	3530
11977	17	88	3	3536	0	3644
11978	3506	14	3	88	0	3611
11979	78	3452	2	21	0	3553
11980	14	87	0	3549	0	3650
11981	10	17	3436	92	0	3555
11982	3222	7	72	21	0	3322
11983	3462	8	11	7	0	3488
11984	105	2	3419	14	0	3540
11985	19	3306	81	10	0	3416
11986	13	3474	20	8	0	3515
11987	4	100	9	3468	0	3581
11988	11	29	9	3386	0	3435
11989	2	8	3	3556	0	3569
11990	9	7	3401	107	0	3524
11991	3245	6	78	28	0	3357
11992	3533	0	13	16	0	3562
11993	3594	7	8	6	0	3615
11994	3604	3	3	9	0	3619
11995	3599	3	2	10	0	3614
11996	3629	2	1	6	0	3638
11997	111	7	5	3519	0	3642
11998	27	4	3488	96	0	3615
11999	9	9	3491	23	0	3532
12000	7	8	94	3468	0	3577
12001	9	6	19	3443	0	3477
12002	9	5	10	3550	0	3574
12003	13	3431	12	106	0	3562
12004	3566	94	3	25	0	3688
12005	97	3507	17	11	0	3632
12006	32	104	4	3561	0	3701
12007	3537	28	7	107	0	3679
12008	103	3481	3	30	0	3617
12009	25	103	2	3544	0	3674
12010	11	27	3	3605	0	3646
12011	10	17	6	3620	0	3653
12012	6	3458	10	125	0	3599
12013	13	98	4	3606	0	3721
12014	16	26	3464	115	0	3621
12015	14	12	90	3482	0	3598
12016	18	15	16	3574	0	3623
12017	10	13	12	3624	0	3659
12018	16	9	3	3654	0	3682
12019	11	9	1477	139	0	1636
12020	11	1524	87	41	0	1663
12021	14	104	23	1554	0	1695
12022	18	23	12	3495	0	3548
12023	24	10	12	3330	0	3376
12024	29	3206	12	164	0	3411
12025	25	3542	9	67	0	3643
12026	3453	178	5	46	0	3682
12027	162	52	5	3445	0	3664
12028	46	52	3211	194	0	3503
12029	39	3392	123	75	0	3629
12030	3424	176	32	60	0	3692
12031	175	53	3379	63	0	3670
12032	51	49	3450	76	0	3626
12033	48	43	3401	68	0	3560
12034	40	58	190	3368	0	3656
12035	58	45	3214	171	0	3488
12036	45	3279	189	67	0	3580
12037	43	169	88	3248	0	3548
12038	29	55	3247	191	0	3522
12039	43	49	183	3353	0	3628
12040	3323	39	88	214	0	3664
12041	171	25	3269	77	0	3542
12042	3283	29	206	71	0	3589
12043	181	3323	87	78	0	3669
12044	3315	166	85	63	0	3629
12045	198	63	45	3343	0	3649
12046	3328	54	46	262	0	3690
12047	3429	67	52	109	0	3657
12048	3282	77	33	104	0	3496
12049	262	3314	59	68	0	3703
12050	3353	166	59	80	0	3658
12051	3508	48	65	80	0	3701
12052	259	83	3149	43	0	3534
12053	138	2455	64	35	0	2692
12054	121	95	47	2359	0	2622
12055	82	44	83	2450	0	2659
12056	84	41	93	2529	0	2747
12057	97	30	2393	122	0	2642
12058	76	37	100	2521	0	2734
12059	67	56	2405	123	0	2651
12060	2467	79	101	80	0	2727
12061	2546	34	74	111	0	2765
12062	110	39	2419	89	0	2657
12063	2478	28	114	111	0	2731
12064	2546	28	73	85	0	2732
12065	2549	15	80	84	0	2728
12066	175	36	64	2502	0	2777
12067	116	69	2356	135	0	2676
12068	123	2420	122	85	0	2750
12069	130	80	64	2451	0	2725
12070	163	38	2436	97	0	2734
12071	157	35	2422	48	0	2662
12072	2465	41	118	71	0	2695
12073	150	2496	87	57	0	2790
12074	2536	112	62	52	0	2762
12075	2523	45	82	71	0	2721
12076	127	2497	116	67	0	2807
12077	2523	143	89	89	0	2844
12078	140	60	2456	119	0	2775
12079	92	75	2472	114	0	2753
12080	87	63	2432	92	0	2674
12081	109	2460	187	63	0	2819
12082	2459	113	121	77	0	2770
12083	2484	48	123	33	0	2688
12084	211	2398	78	46	0	2733
12085	163	2488	94	38	0	2783
12086	138	116	112	2365	0	2731
12087	142	85	80	2495	0	2802
12088	2459	66	94	95	0	2714
12089	161	2459	96	89	0	2805
12090	2492	117	89	115	0	2813
12091	2546	86	88	54	0	2774
12092	171	111	2305	82	0	2669
12093	132	2411	109	88	0	2740
12094	115	154	98	2401	0	2768
12095	2417	78	84	112	0	2691
12096	193	85	60	2437	0	2775
12097	2426	83	52	145	0	2706
12098	202	71	2243	69	0	2585
12099	159	2274	83	68	0	2584
12100	168	2402	49	68	0	2687
12101	169	99	115	1856	0	2239
12102	104	2343	132	84	0	2663
12103	2385	127	128	70	0	2710
12104	139	103	2292	73	0	2607
12105	2408	100	91	84	0	2683
12106	231	74	2248	52	0	2605
12107	122	81	119	2310	0	2632
12108	112	120	69	2347	0	2648
12109	90	108	82	2429	0	2709
12110	2387	66	75	175	0	2703
12111	137	76	2242	132	0	2587
12112	125	77	108	2374	0	2684
12113	134	93	62	2306	0	2595
12114	188	2160	76	132	0	2556
12115	134	2313	117	82	0	2646
12116	113	2374	97	85	0	2669
12117	64	144	60	2380	0	2648
12118	89	91	36	2346	0	2562
12119	123	2080	42	168	0	2413
12120	102	2335	57	132	0	2626
12121	2404	144	73	94	0	2715
12122	0	2	0	355	0	357
12123	0	346	1	0	0	347
12124	359	0	2	0	0	361
12125	1	0	0	368	0	369
12126	430	0	0	2	0	432
12127	1	0	0	450	0	451
12128	1	2	490	1	0	494
12129	0	493	2	1	0	496
12130	496	1	1	0	0	498
12131	1	1	498	0	0	500
12132	1	490	1	1	0	493
12133	0	0	3	491	0	494
12134	0	1	0	493	0	494
12135	0	0	0	502	0	502
12136	0	1	0	507	0	508
12137	0	0	493	2	0	495
12138	0	493	0	1	0	494
12139	0	1	0	499	0	500
12140	482	1	0	1	0	484
12141	1	476	0	1	0	478
12142	1	1	0	521	0	523
12143	1	1	510	2	0	514
12144	0	519	2	2	0	523
12145	3	2	2	472	0	479
12146	0	544	0	2	0	546
12147	554	3	1	1	0	559
12148	562	2	0	1	0	565
12149	5	0	545	1	0	551
12150	555	1	2	1	0	559
12151	564	0	2	1	0	567
12152	4	1	542	0	0	547
12153	2	556	3	0	0	561
12154	1	3	2	560	0	566
12155	3	2	0	568	0	573
12156	569	0	1	4	0	574
12157	2	1	0	575	0	578
12158	2	0	571	2	0	575
12159	547	0	3	3	0	553
12160	3	0	567	1	0	571
12161	3	563	2	1	0	569
12162	556	2	3	0	0	561
12163	4	2	554	1	0	561
12164	2	1	554	1	0	558
12165	2	547	4	2	0	555
12166	2	2	1	570	0	575
12167	0	2	568	2	0	572
12168	1	0	3	541	0	545
12169	0	1	2	552	0	555
12170	0	1	541	6	0	548
12171	1	536	3	2	0	542
12172	0	2	3	560	0	565
12173	533	2	1	3	0	539
12174	529	1	1	2	0	533
12175	4	1	0	532	0	537
12176	2	1	532	3	0	538
12177	2	0	562	2	0	566
12178	1	0	4	554	0	559
12179	0	0	555	3	0	558
12180	556	2	3	2	0	563
12181	2	0	2	563	0	567
12182	3	0	0	572	0	575
12183	1	560	1	5	0	567
12184	1	1	0	583	0	585
12185	0	2	574	3	0	579
12186	555	1	3	3	0	562
12187	565	1	2	2	0	570
12188	5	0	557	1	0	563
12189	5	0	3	558	0	566
12190	1	0	2	577	0	580
12191	1	0	564	5	0	570
12192	0	0	4	574	0	578
12193	1	0	2	583	0	586
12194	0	591	2	5	0	598
12195	2	1	1	636	0	640
12196	1	2	0	647	0	650
12197	665	0	1	8	0	674
12198	683	2	0	4	0	689
12199	693	0	0	4	0	697
12200	687	0	2	1	0	690
12201	686	0	0	1	0	687
12202	10	1	671	1	0	683
12203	6	1	6	658	0	671
12204	2	0	3	681	0	686
12205	2	0	680	10	0	692
12206	657	0	6	2	0	665
12207	668	0	4	2	0	674
12208	9	0	669	2	0	680
12209	678	1	6	1	0	686
12210	687	0	4	1	0	692
12211	10	0	683	1	0	694
12212	5	0	5	652	0	662
12213	2	705	5	3	0	715
12214	3	5	1	716	0	725
12215	3	3	1	720	0	727
12216	2	0	1	713	0	716
12217	0	1	705	10	0	716
12218	686	1	6	6	0	699
12219	700	0	2	3	0	705
12220	8	0	2	701	0	711
12221	4	0	687	7	0	698
12222	3	3	7	687	0	700
12223	4	0	693	7	0	704
12224	2	1	687	7	0	697
12225	1	701	11	2	0	715
12226	0	5	4	651	0	660
12227	629	2	5	6	0	642
12228	581	0	3	3	0	587
12229	587	2	1	1	0	591
12230	8	1	1	579	0	589
12231	5	592	1	6	0	604
12232	3	6	1	607	0	617
12233	3	2	618	6	0	629
12234	664	0	7	5	0	676
12235	701	2	4	1	0	708
12236	12	1	0	702	0	715
12237	6	0	3	704	0	713
12238	4	1	1	711	0	717
12239	3	0	680	12	0	695
12240	621	0	9	9	0	639
12241	8	688	4	6	0	706
12242	3	672	2	2	0	679
12243	1	9	658	1	0	669
12244	2	9	8	643	0	662
12245	3	2	650	8	0	663
12246	607	6	10	6	0	629
12247	7	1	3	639	0	650
12248	3	0	621	8	0	632
12249	4	628	8	6	0	646
12250	645	7	4	1	0	657
12251	8	5	645	1	0	659
12252	3	650	8	1	0	662
12253	1	655	4	3	0	663
12254	662	11	3	0	0	676
12255	8	3	2	659	0	672
12256	3	2	678	9	0	692
12257	1	676	8	4	0	689
12258	688	9	4	3	0	704
12259	701	2	2	1	0	706
12260	12	687	1	1	0	701
12261	6	9	701	0	0	716
12262	3	4	9	712	0	728
12263	713	2	3	11	0	729
12264	708	1	3	4	0	716
12265	12	1	708	2	0	723
12266	7	0	9	701	0	717
12267	4	1	5	716	0	726
12268	3	2	711	12	0	728
12269	3	0	713	3	0	719
12270	729	0	14	5	0	748
12271	758	1	5	3	0	767
12272	761	1	3	1	0	766
12273	765	0	3	1	0	769
12274	14	0	748	1	0	763
12275	749	2	10	0	0	761
12276	12	1	3	741	0	757
12277	8	5	1544	10	0	1567
12278	4	7	1555	5	0	1571
12279	4	1600	15	5	0	1624
12280	3	12	5	1675	0	1695
12281	2	5	1657	12	0	1676
12282	1540	3	12	5	0	1560
12283	10	2	6	1624	0	1642
12284	5	1609	3	8	0	1625
12285	1680	8	2	5	0	1695
12286	1658	4	6	1	0	1669
12287	12	4	1643	3	0	1662
12288	4	1596	12	3	0	1615
12289	5	10	3	1697	0	1715
12290	1699	3	1	9	0	1712
12291	11	1	3	1682	0	1697
12292	4	3	1637	10	0	1654
12293	1457	2	14	7	0	1480
12294	11	1541	12	5	0	1569
12295	4	1534	3	1	0	1542
12296	3	1594	3	3	0	1603
12297	1626	16	8	1	0	1651
12298	1592	4	2	0	0	1598
12299	1601	2	0	2	0	1605
12300	8	1	3	1592	0	1604
12301	6	0	1583	7	0	1596
12302	3	0	5	1595	0	1603
12303	1621	1	4	6	0	1632
12304	7	0	1	1625	0	1633
12305	1655	1	1	6	0	1663
12306	1622	0	2	6	0	1630
12307	1629	1	1	1	0	1632
12308	7	1604	1	4	0	1616
12309	1663	5	1	0	0	1669
12310	6	3	1581	1	0	1591
12311	4	3	1577	1	0	1585
12312	3	1603	9	1	0	1616
12313	1	5	6	1611	0	1623
12314	1614	4	1	3	0	1622
12315	4	2	1579	4	0	1589
12316	1395	1	7	3	0	1406
12317	7	0	2	1600	0	1609
12318	4	1580	3	5	0	1592
12319	2	5	1	1645	0	1653
12320	0	6	1578	5	0	1589
12321	1429	4	5	6	0	1444
12322	10	2	1575	1	0	1588
12323	3	1	1498	1	0	1503
12324	1522	0	6	1	0	1529
12325	6	1464	4	1	0	1475
12326	1585	3	1	3	0	1592
12327	1571	2	1	0	0	1574
12328	8	2	1507	1	0	1518
12329	1490	1	6	0	0	1497
12330	5	0	1541	1	0	1547
12331	2	5	1512	0	0	1519
12332	3	0	1491	1	0	1495
12333	1	1447	7	0	0	1455
12334	1492	2	15	1	0	1510
12335	1483	0	2	0	0	1485
12336	1494	0	0	0	0	1494
12337	1484	0	0	2	0	1486
12338	1	3	1442	0	0	1446
12339	1	0	1	1433	0	1435
12340	0	1	0	1492	0	1493
12341	1500	0	0	1	0	1501
12342	1	1426	3	1	0	1431
12343	0	1	0	1486	0	1487
12344	1488	0	0	1	0	1489
12345	1	1	1463	0	0	1465
12346	0	0	1	1422	0	1423
12347	0	0	1473	1	0	1474
12348	0	1407	4	2	0	1413
12349	0	1	5	1485	0	1491
12350	1464	1	0	1	0	1466
12351	1	0	0	1442	0	1443
12352	3	2	1450	1	0	1456
12353	0	1364	3	2	0	1369
12354	1449	0	0	1	0	1450
12355	0	2	1434	0	0	1436
12356	1368	0	0	0	0	1368
12357	0	1371	1	0	0	1372
12358	1450	0	2	0	0	1452
12359	1416	1	0	0	0	1417
12360	0	0	0	1433	0	1433
12361	1	1	2244	0	0	2246
12362	0	2184	4	1	0	2189
12363	0	3	0	2336	0	2339
12364	1	1	0	2317	0	2319
12365	0	0	0	2350	0	2350
12366	0	1	0	2368	0	2369
12367	0	3301	3	3	0	3307
12368	3482	15	1	2	0	3500
12369	16	3420	0	3	0	3439
12370	4	20	0	3591	0	3615
12371	3579	4	1	19	0	3603
12372	18	0	0	3558	0	3576
12373	6	7	3498	20	0	3531
12374	2	3416	20	11	0	3449
12375	7	21	4	3530	0	3562
12376	1	6	0	3609	0	3616
12377	2748	1	4	21	0	2774
12378	23	9	2690	7	0	2729
12379	2651	1	22	5	0	2679
12380	2689	4	6	8	0	2707
12381	2726	6	1	4	0	2737
12382	32	3	2684	2	0	2721
12383	10	13	19	2593	0	2635
12384	13	1	7	2698	0	2719
12385	15	8	2664	29	0	2716
12386	4	6	2651	19	0	2680
12387	2663	4	27	5	0	2699
12388	23	6	5	2721	0	2755
12389	2722	0	12	28	0	2762
12390	2737	7	7	14	0	2765
12391	37	1	5	2754	0	2797
12392	10	3	2724	35	0	2772
12393	2619	3	24	10	0	2656
12394	33	0	12	2806	0	2851
12395	18	4	2724	29	0	2775
12396	10	2742	27	12	0	2791
12397	2773	24	7	10	0	2814
12398	27	2748	9	13	0	2797
12399	14	30	14	2574	0	2632
12400	11	3406	12	27	0	3456
12401	3374	70	9	16	0	3469
12402	3408	29	13	18	0	3468
12403	109	3396	8	9	0	3522
12404	3456	77	5	18	0	3556
12405	3450	33	8	11	0	3502
12406	111	3373	10	9	0	3503
12407	3416	79	4	15	0	3514
12408	92	36	13	3346	0	3487
12409	58	22	9	3435	0	3524
12410	3391	18	5	106	0	3520
12411	94	13	10	3167	0	3284
12412	41	3314	6	84	0	3445
12413	3311	75	6	43	0	3435
12414	3259	46	9	26	0	3340
12415	106	3311	7	19	0	3443
12416	3357	88	10	12	0	3467
12417	3385	37	11	14	0	3447
12418	129	25	2	3316	0	3472
12419	69	23	3207	79	0	3378
12420	48	3247	68	49	0	3412
12421	3337	76	30	24	0	3467
12422	3382	42	23	26	0	3473
12423	143	36	3225	18	0	3422
12424	3336	23	78	22	0	3459
12425	124	28	3200	28	0	3380
12426	3300	21	83	26	0	3430
12427	119	16	44	3281	0	3460
12428	71	26	3216	92	0	3405
12429	47	25	3238	56	0	3366
12430	51	24	92	3214	0	3381
12431	48	17	43	3304	0	3412
12432	39	22	3159	120	0	3340
12433	45	21	90	3241	0	3397
12434	48	25	3159	99	0	3331
12435	47	28	85	3214	0	3374
12436	55	25	49	3164	0	3293
12437	56	3106	31	109	0	3302
12438	51	3129	27	67	0	3274
12439	45	3232	27	51	0	3355
12440	50	121	15	3196	0	3382
12441	46	62	29	3273	0	3410
12442	49	45	3087	120	0	3301
12443	3047	24	92	71	0	3234
12444	3207	28	42	51	0	3328
12445	150	3139	30	48	0	3367
12446	3238	82	33	33	0	3386
12447	126	54	24	3190	0	3394
12448	3226	29	42	95	0	3392
12449	3256	35	18	74	0	3383
12450	144	23	25	3211	0	3403
12451	3141	28	30	107	0	3306
12452	125	3091	33	65	0	3314
12453	79	3199	24	52	0	3354
12454	57	130	21	2992	0	3200
12455	49	3186	35	95	0	3365
12456	53	111	25	3090	0	3279
12457	53	55	22	3216	0	3346
12458	3146	36	24	139	0	3345
12459	113	3107	15	88	0	3323
12460	3078	88	29	60	0	3255
12461	2220	63	25	42	0	2350
12462	140	2263	26	43	0	2472
12463	2324	98	30	36	0	2488
12464	141	64	2125	51	0	2381
12465	103	2227	85	45	0	2460
12466	2260	126	50	33	0	2469
12467	104	47	1128	29	0	1308
12468	64	1036	70	23	0	1193
12469	65	1094	37	24	0	1220
12470	1014	82	27	23	0	1146
12471	1042	51	21	20	0	1134
12472	1026	39	12	34	0	1111
12473	111	952	11	38	0	1112
12474	64	66	14	976	0	1120
12475	974	43	8	88	0	1113
12476	1012	47	13	52	0	1124
12477	91	27	12	996	0	1126
12478	75	27	914	84	0	1100
12479	51	23	962	49	0	1085
12480	59	21	72	949	0	1101
12481	48	25	38	1006	0	1117
12482	38	22	920	105	0	1085
12483	35	18	71	947	0	1071
12484	31	956	34	85	0	1106
12485	983	67	26	37	0	1113
12486	87	56	13	960	0	1116
12487	967	44	24	63	0	1098
12488	96	918	24	37	0	1075
12489	57	972	27	37	0	1093
12490	974	83	13	23	0	1093
12491	87	51	903	26	0	1067
12492	912	34	64	16	0	1026
12493	89	884	45	24	0	1042
12494	58	63	25	861	0	1007
12495	867	33	16	87	0	1003
12496	77	27	20	894	0	1018
12497	878	18	16	94	0	1006
12498	866	9	30	58	0	963
12499	98	852	27	57	0	1034
12500	165	0	0	0	0	165
12501	1	160	0	0	0	161
12502	162	1	0	0	0	163
12503	1	1	0	162	0	164
12504	176	0	0	1	0	177
12505	1	0	0	174	0	175
12506	185	0	0	1	0	186
12507	183	0	0	1	0	184
12508	187	0	0	0	0	187
12509	187	0	0	0	0	187
12510	186	0	0	0	0	186
12511	2	0	0	184	0	186
12512	182	0	0	1	0	183
12513	1	178	0	1	0	180
12514	1	1	183	0	0	185
12515	0	0	1	182	0	183
12516	0	0	191	1	0	192
12517	0	0	1	198	0	199
12518	0	0	198	1	0	199
12519	192	0	1	1	0	194
12520	1	0	1	204	0	206
12521	1	0	203	1	0	205
12522	0	0	208	1	0	209
12523	0	1	2	210	0	213
12524	219	0	1	1	0	221
12525	1	224	0	1	0	226
12526	225	0	0	0	0	225
12527	228	1	0	0	0	229
12528	2	712	4	1	0	719
12529	799	1	0	0	0	800
12530	1	1	0	796	0	798
12531	1	0	0	796	0	797
12532	0	1	0	809	0	810
12533	806	0	0	2	0	808
12534	1	777	1	2	0	781
12535	1	1	0	824	0	826
12536	0	2	0	821	0	823
12537	832	0	0	4	0	836
12538	2	0	0	817	0	819
12539	2	0	834	3	0	839
12540	0	848	5	4	0	857
12541	880	3	2	0	0	885
12542	3	4	0	876	0	883
12543	3	873	0	5	0	881
12544	896	3	0	1	0	900
12545	4	3	870	1	0	878
12546	3	844	4	2	0	853
12547	896	3	3	0	0	902
12548	3	3	0	884	0	890
12549	3	1	0	893	0	897
12550	0	0	871	6	0	877
12551	0	0	3	868	0	871
12552	0	2	901	4	0	907
12553	1	1	843	3	0	848
12554	1	4	866	0	0	871
12555	899	0	7	0	0	906
12556	923	0	3	0	0	926
12557	933	0	0	0	0	933
12558	6	0	0	931	0	937
12559	3	907	0	4	0	914
12560	0	924	0	4	0	928
12561	958	6	0	0	0	964
12562	958	3	0	0	0	961
12563	6	928	2	1	0	937
12564	949	2	1	0	0	952
12565	2	3	905	0	0	910
12566	3	3	1445	1	0	1452
12567	0	2	4	1447	0	1453
12568	0	0	3	1578	0	1581
12569	0	0	1560	4	0	1564
12570	0	0	2	1520	0	1522
12571	1574	0	5	3	0	1582
12572	3	1	1534	3	0	1541
12573	1481	0	2	2	0	1485
12574	4	0	2	1586	0	1592
12575	4	1	1583	2	0	1590
12576	1	1525	3	4	0	1533
12577	1625	2	2	1	0	1630
12578	2	2	1573	0	0	1577
12579	1561	1	2	0	0	1564
12580	3	0	2	1612	0	1617
12581	1598	0	1	2	0	1601
12582	5	2	1622	2	0	1631
12583	2	0	2	1645	0	1649
12584	1668	0	2	2	0	1672
12585	1636	0	1	3	0	1640
12586	1676	0	1	2	0	1679
12587	1688	1	0	0	0	1689
12588	5	0	0	1666	0	1671
12589	3	0	0	1670	0	1673
12590	1	0	1657	4	0	1662
12591	0	0	2	1642	0	1644
12592	1	0	3	1639	0	1643
12593	0	1648	2	5	0	1655
12594	1702	3	0	3	0	1708
12595	1704	2	1	1	0	1708
12596	6	1744	0	3	0	1753
12597	5	9	0	2269	0	2283
12598	1	2	0	2315	0	2318
12599	2284	1	2	26	0	2313
12600	22	4	2288	6	0	2320
12601	4	0	18	2348	0	2370
12602	2	3	2309	22	0	2336
12603	2209	2	20	6	0	2237
12604	2312	0	3	5	0	2320
12605	2365	0	3	1	0	2369
12606	29	0	0	2304	0	2333
12607	6	0	3	2353	0	2362
12608	2361	0	0	26	0	2387
12609	24	4	2296	6	0	2330
12610	7	0	22	2325	0	2354
12611	2356	0	5	26	0	2387
12612	22	0	2	2368	0	2392
12613	7	1	2365	24	0	2397
12614	2	7	2261	6	0	2276
12615	2301	0	20	6	0	2327
12616	30	2288	10	6	0	2334
12617	2460	20	2	6	0	2488
12618	3908	3	6	1	0	3918
12619	23	2	1	3910	0	3936
12620	8	0	4	3883	0	3895
12621	6	3792	3	29	0	3830
12622	3921	22	3	11	0	3957
12623	24	3802	4	7	0	3837
12624	6	3834	5	8	0	3853
12625	8	29	1	3953	0	3991
12626	3947	8	1	26	0	3982
12627	3899	3	1	6	0	3909
12628	28	2	3	3386	0	3419
12629	11	2	1	3362	0	3376
12630	6	1	2	3361	0	3370
12631	3379	2	4	30	0	3415
12632	28	2	3329	17	0	3376
12633	8	3244	25	6	0	3283
12634	3414	24	2	9	0	3449
12635	26	4	3	3329	0	3362
12636	14	3	3354	31	0	3402
12637	11	3	3281	10	0	3305
12638	6	3204	33	10	0	3253
12639	6	3361	12	4	0	3383
12640	9	26	9	3336	0	3380
12641	11	3093	8	22	0	3134
12642	13	25	4	3302	0	3344
12643	10	5	0	3383	0	3398
12644	3405	5	4	31	0	3445
12645	23	4	3	3368	0	3398
12646	9	4	7	3393	0	3413
12647	10	5	3363	33	0	3411
12648	9	4	24	3331	0	3368
12649	3373	3	4	32	0	3412
12650	3353	1	6	12	0	3372
12651	27	3296	5	14	0	3342
12652	3417	25	7	7	0	3456
12653	37	8	3258	9	0	3312
12654	12	3168	28	8	0	3216
12655	17	26	6	3329	0	3378
12656	10	5	4	3379	0	3398
12657	8	6	5	3394	0	3413
12658	3406	4	8	42	0	3460
12659	3158	8	11	15	0	3192
12660	32	11	3316	17	0	3376
12661	14	12	3152	10	0	3188
12662	21	8	3209	11	0	3249
12663	19	3119	33	10	0	3181
12664	17	3172	16	14	0	3219
12665	3372	32	5	13	0	3422
12666	2778	6	2	23	0	2809
12667	36	7	5	2759	0	2807
12668	17	5	11	2736	0	2769
12669	7	2720	10	47	0	2784
12670	16	24	3	2830	0	2873
12671	16	8	2738	36	0	2798
12672	13	2664	27	24	0	2728
12673	8	23	16	2822	0	2869
12674	11	12	2774	35	0	2832
12675	12	11	29	2640	0	2692
12676	14	2697	10	32	0	2753
12677	2811	36	6	10	0	2863
12678	2757	11	5	17	0	2790
12679	3283	10	4	22	0	3319
12680	47	9	6	3258	0	3320
12681	24	7	9	3337	0	3377
12682	3330	13	7	55	0	3405
12683	45	3268	3	26	0	3342
12684	3374	39	9	24	0	3446
12685	54	24	3333	14	0	3425
12686	3373	4	48	13	0	3438
12687	3529	8	14	16	0	3567
12688	66	9	6	3464	0	3545
12689	3533	8	5	62	0	3608
12690	3529	7	9	24	0	3569
12691	62	9	12	3547	0	3630
12692	26	13	3432	57	0	3528
12693	3187	9	45	29	0	3270
12694	60	9	3347	24	0	3440
12695	26	3416	58	13	0	3513
12696	546	42	25	2976	0	3589
12697	2	11	4	3017	0	3034
12698	3066	6	2	36	0	3110
12699	34	6	2975	17	0	3032
12700	9	1	29	2948	0	2987
12701	5	2987	13	28	0	3033
12702	1	3026	7	12	0	3046
12703	0	38	2	3104	0	3144
12704	3	18	2982	30	0	3033
12705	2	7	31	2926	0	2966
12706	2	3	13	2982	0	3000
12707	5	11	2862	41	0	2919
12708	4	2896	27	19	0	2946
12709	2948	29	9	5	0	2991
12710	28	3011	6	4	0	3049
12711	12	37	0	3036	0	3085
12712	2952	12	1	24	0	2989
12713	30	2892	2	16	0	2940
12714	14	25	2818	7	0	2864
12715	2795	9	28	5	0	2837
12716	27	2903	11	5	0	2946
12717	2940	29	6	4	0	2979
12718	36	12	1721	1	0	1770
12719	1725	7	29	3	0	1764
12720	36	0	10	1733	0	1779
12721	16	4	1690	29	0	1739
12722	9	2	27	1712	0	1750
12723	7	1712	10	38	0	1767
12724	5	27	7	1758	0	1797
12725	2	12	3	1769	0	1786
12726	6	3	1673	42	0	1724
12727	1	1	35	1747	0	1784
12728	10	11	1488	36	0	1545
12729	7	1730	30	19	0	1786
12730	5	31	7	1745	0	1788
12731	14	14	1686	32	0	1746
12732	7	1698	31	18	0	1754
12733	10	1754	13	13	0	1790
12734	11	43	1748	3	0	1805
12735	14	18	1730	10	0	1772
12736	13	6	46	1746	0	1811
12737	1730	9	22	35	0	1796
12738	39	1716	5	25	0	1785
12739	26	31	6	1719	0	1782
12740	1710	14	7	39	0	1770
12741	46	1709	6	20	0	1781
12742	1711	30	6	17	0	1764
12743	41	1735	8	7	0	1791
12744	1743	38	5	9	0	1795
12745	1736	15	3	16	0	1770
12746	1743	9	8	15	0	1775
12747	61	1782	6	23	0	1872
12748	36	36	3	1844	0	1919
12749	24	24	1749	55	0	1852
12750	23	1797	37	34	0	1891
12751	26	37	27	1764	0	1854
12752	26	24	17	1796	0	1863
12753	27	20	1682	52	0	1781
12754	25	1674	45	38	0	1782
12755	1668	39	19	31	0	1757
12756	61	1666	12	12	0	1751
12757	36	37	6	1689	0	1768
12758	20	19	1658	63	0	1760
12759	1647	14	50	26	0	1737
12760	53	11	22	1690	0	1776
12761	22	11	1645	50	0	1728
12762	1588	24	46	31	0	1689
12763	43	1598	23	36	0	1700
12764	1644	44	22	23	0	1733
12765	1648	29	10	21	0	1708
12766	55	13	15	2757	0	2840
12767	32	25	2636	129	0	2822
12768	18	2634	119	32	0	2803
12769	13	118	2649	34	0	2814
12770	6	38	125	2636	0	2805
12771	6	32	36	2815	0	2889
12772	2728	17	27	154	0	2926
12773	119	17	2547	59	0	2742
12774	34	2680	110	40	0	2864
12775	26	128	30	2605	0	2789
12776	25	41	19	2803	0	2888
12777	2645	40	18	142	0	2845
12778	118	2693	13	64	0	2888
12779	19	96	4	2166	0	2285
12780	2011	24	17	130	0	2182
12781	91	2118	40	31	0	2280
12782	2088	123	20	18	0	2249
12783	2135	28	38	15	0	2216
12784	114	2021	17	52	0	2204
12785	1898	87	5	44	0	2034
12786	132	1882	9	14	0	2037
12787	1932	104	33	9	0	2078
12788	1948	44	11	19	0	2022
12789	102	1848	5	45	0	2000
12790	1845	85	6	55	0	1991
12791	1940	27	11	17	0	1995
12792	1932	55	7	15	0	2009
12793	122	21	1775	44	0	1962
12794	57	13	1786	29	0	1885
12795	43	36	1819	14	0	1912
12796	1852	19	109	6	0	1986
12797	141	17	1721	5	0	1884
12798	40	53	1680	8	0	1781
12799	63	23	95	1646	0	1827
12800	1678	35	24	98	0	1835
12801	145	21	1638	19	0	1823
12802	67	25	1726	17	0	1835
12803	42	34	100	1670	0	1846
12804	67	15	27	1728	0	1837
12805	71	13	17	1758	0	1859
12806	74	7	1601	113	0	1795
12807	31	9	141	1701	0	1882
12808	1645	21	64	107	0	1837
12809	114	1647	61	26	0	1848
12810	56	93	32	1677	0	1858
12811	42	19	51	1773	0	1885
12812	27	28	1611	132	0	1798
12813	26	1651	118	77	0	1872
12814	1675	105	48	35	0	1863
12815	118	1625	78	39	0	1860
12816	39	95	58	1702	0	1894
12817	44	19	1589	160	0	1812
12818	34	29	116	1720	0	1899
12819	21	27	50	1821	0	1919
12820	1684	29	52	152	0	1917
12821	113	20	34	1697	0	1864
12822	81	1516	17	152	0	1766
12823	58	1741	19	55	0	1873
12824	35	131	1630	84	0	1880
12825	1698	35	114	80	0	1927
12826	141	45	60	1720	0	1966
12827	59	58	33	1786	0	1936
12828	90	38	18	1834	0	1980
12829	1731	53	19	149	0	1952
12830	130	1730	30	79	0	1969
12831	1783	119	46	56	0	2004
12832	152	49	1699	63	0	1963
12833	77	39	1728	75	0	1919
12834	1779	28	111	54	0	1972
12835	145	39	51	1672	0	1907
12836	74	53	39	1777	0	1943
12837	84	47	36	1825	0	1992
12838	69	25	1703	131	0	1928
12839	1741	24	148	54	0	1967
12840	1806	17	71	83	0	1977
12841	1801	10	67	78	0	1956
12842	170	13	40	1771	0	1994
12843	90	17	1640	137	0	1884
12844	60	46	1688	61	0	1855
12845	84	18	1665	66	0	1833
12846	55	1657	182	29	0	1923
12847	47	108	123	1582	0	1860
12848	1618	17	70	122	0	1827
12849	125	28	1526	109	0	1788
12850	1591	10	101	137	0	1839
12851	117	9	54	1686	0	1866
12852	43	16	82	1668	0	1809
12853	99	1416	36	143	0	1694
12854	104	1540	16	52	0	1712
12855	78	1619	30	63	0	1790
12856	30	108	50	1683	0	1871
12857	1573	36	82	136	0	1827
12858	1700	37	86	44	0	1867
12859	132	42	1558	51	0	1783
12860	1628	60	110	57	0	1855
12861	125	32	1537	93	0	1787
12862	70	15	138	1641	0	1864
12863	57	14	1548	127	0	1746
12864	1636	19	119	80	0	1854
12865	150	10	26	1710	0	1896
12866	4	0	436	8	0	448
12867	4	0	430	3	0	437
12868	418	0	11	3	0	432
12869	433	0	0	4	0	437
12870	9	421	4	5	0	439
12871	1	11	5	440	0	457
12872	0	2	439	13	0	454
12873	2	5	435	2	0	444
12874	2	1	9	427	0	439
12875	432	1	7	11	0	451
12876	13	427	2	4	0	446
12877	3	10	3	434	0	450
12878	428	2	0	12	0	442
12879	10	1	2	425	0	438
12880	3	435	0	14	0	452
12881	0	12	5	440	0	457
12882	442	4	1	11	0	458
12883	13	1	1	441	0	456
12884	436	2	2	14	0	454
12885	12	453	2	5	0	472
12886	457	10	2	5	0	474
12887	13	1	431	5	0	450
12888	428	2	10	6	0	446
12889	441	3	1	3	0	448
12890	12	435	4	4	0	455
12891	5	11	4	418	0	438
12892	3	0	411	14	0	428
12893	3	0	410	4	0	417
12894	389	3	10	1	0	403
12895	377	1	1	3	0	382
12896	11	367	0	1	0	379
12897	3	383	0	2	0	388
12898	372	10	2	1	0	385
12899	9	367	3	3	0	382
12900	2	391	2	0	0	395
12901	1	7	1	381	0	390
12902	2	0	0	372	0	374
12903	1	2	362	9	0	374
12904	2	1	6	371	0	380
12905	374	0	3	6	0	383
12906	10	0	363	1	0	374
12907	3	1	369	0	0	373
12908	1	2	5	363	0	371
12909	1	0	1	376	0	378
12910	1	0	3	371	0	375
12911	0	0	362	6	0	368
12912	3	1	6	353	0	363
12913	3	2	0	380	0	385
12914	371	1	1	5	0	378
12915	6	368	2	0	0	376
12916	375	3	1	0	0	379
12917	6	2	376	1	0	385
12918	345	1	5	0	0	351
12919	4	344	0	0	0	348
12920	307	2	5	0	0	314
12921	2	304	1	1	0	308
12922	287	3	0	0	0	290
12923	3	277	0	0	0	280
12924	0	279	0	0	0	279
12925	0	5	2	275	0	282
12926	285	0	0	1	0	286
12927	282	0	0	0	0	282
12928	284	0	0	0	0	284
12929	1	0	288	0	0	289
12930	0	0	288	0	0	288
12931	0	0	1	299	0	300
12932	0	300	0	1	0	301
12933	0	306	0	0	0	306
12934	0	1	0	305	0	306
12935	302	0	1	1	0	304
12936	307	0	0	0	0	307
12937	306	0	0	0	0	306
12938	1	0	314	0	0	315
12939	0	0	1	319	0	320
12940	0	0	328	1	0	329
12941	328	0	1	0	0	329
12942	334	0	0	0	0	334
12943	1	0	331	0	0	332
12944	0	0	1	336	0	337
12945	2280	0	0	2	0	2282
12946	1	0	1	2271	0	2273
12947	0	0	0	2289	0	2289
12948	0	0	0	2327	0	2327
12949	2343	0	0	2	0	2345
12950	2	1	0	2368	0	2371
12951	2417	0	0	5	0	2422
12952	6	3626	3	5	0	3640
12953	3	53	3	3902	0	3961
12954	2	23	0	3956	0	3981
12955	4	9	0	3967	0	3980
12956	3835	4	0	97	0	3936
12957	62	1	1	3864	0	3928
12958	30	3	2	3801	0	3836
12959	3915	0	1	81	0	3997
12960	3930	2	0	33	0	3965
12961	3955	4	0	12	0	3971
12962	104	3	3716	10	0	3833
12963	47	3	3532	8	0	3590
12964	3799	1	83	7	0	3890
12965	73	0	34	3879	0	3986
12966	33	0	11	3885	0	3929
12967	3916	1	8	85	0	4010
12968	3890	0	4	33	0	3927
12969	3818	4	1	15	0	3838
12970	97	3759	1	8	0	3865
12971	3935	52	4	5	0	3996
12972	3798	24	5	4	0	3831
12973	97	3685	1	7	0	3790
12974	36	3673	6	8	0	3723
12975	18	63	2	3767	0	3850
12976	3923	27	0	54	0	4004
12977	3923	10	0	24	0	3957
12978	3899	6	1	9	0	3915
12979	100	7	0	3843	0	3950
12980	3902	1	0	58	0	3961
12981	83	3	3677	27	0	3790
12982	3716	4	63	17	0	3800
12983	78	4	3735	8	0	3825
12984	40	10	3558	7	0	3615
12985	17	2	84	3726	0	3829
12986	3740	5	32	65	0	3842
12987	66	4	17	3816	0	3903
12988	34	2	3778	81	0	3895
12989	15	9	3632	44	0	3700
12990	13	1	86	3755	0	3855
12991	3665	5	29	76	0	3775
12992	65	3642	17	38	0	3762
12993	34	56	9	3793	0	3892
12994	20	22	4	3853	0	3899
12995	19	10	3741	92	0	3862
12996	13	10	3579	40	0	3642
12997	6	2	101	3777	0	3886
12998	3760	2	34	71	0	3867
12999	69	2	3633	41	0	3745
13000	36	4	58	3726	0	3824
13001	23	5	26	3776	0	3830
13002	17	1	12	3834	0	3864
13003	3754	6	7	107	0	3874
13004	84	35	3206	50	0	3375
13005	38	3614	51	37	0	3740
13006	22	61	21	3816	0	3920
13007	20	35	3698	79	0	3832
13008	14	3586	70	48	0	3718
13009	16	3748	32	43	0	3839
13010	3749	92	13	38	0	3892
13011	83	3743	12	35	0	3873
13012	3841	76	5	22	0	3944
13013	96	42	3710	29	0	3877
13014	56	32	72	3737	0	3897
13015	3805	17	43	92	0	3957
13016	100	3623	24	80	0	3827
13017	62	76	3677	58	0	3873
13018	38	45	87	3437	0	3607
13019	45	3666	42	99	0	3852
13020	57	81	15	3809	0	3962
13021	3783	52	16	118	0	3969
13022	120	3702	21	82	0	3925
13023	3846	77	20	59	0	4002
13024	3864	35	18	47	0	3964
13025	165	27	3658	16	0	3866
13026	72	3606	96	50	0	3824
13027	73	73	37	3829	0	4012
13028	75	40	3739	103	0	3957
13029	66	24	3764	59	0	3913
13030	83	21	108	3837	0	4049
13031	3894	21	63	106	0	4084
13032	3859	15	40	56	0	3970
13033	183	16	17	3849	0	4065
13034	91	22	3850	112	0	4075
13035	73	3699	90	75	0	3937
13036	3904	100	45	45	0	4094
13037	4001	50	30	24	0	4105
13038	157	3795	27	41	0	4020
13039	3981	105	25	27	0	4138
13040	156	44	3811	25	0	4036
13041	3867	16	100	36	0	4019
13042	3910	32	52	37	0	4031
13043	147	29	3812	31	0	4019
13044	91	16	108	3717	0	3932
13045	70	17	2123	106	0	2316
13046	68	2081	116	56	0	2321
13047	41	2177	82	38	0	2338
13048	40	113	30	2141	0	2324
13049	51	40	2065	110	0	2266
13050	26	2023	115	73	0	2237
13051	36	2082	82	56	0	2256
13052	480	12	5	0	0	497
13053	492	4	0	1	0	497
13054	12	2	0	482	0	496
13055	2	1	1	481	0	485
13056	0	484	1	11	0	496
13057	482	12	0	3	0	497
13058	490	4	1	0	0	495
13059	13	490	0	0	0	503
13060	4	11	0	491	0	506
13061	1	2	485	12	0	500
13062	1	0	9	489	0	499
13063	484	2	2	10	0	498
13064	12	0	0	489	0	501
13065	3	1	0	502	0	506
13066	497	2	0	12	0	511
13067	11	0	0	495	0	506
13068	2	496	2	9	0	509
13069	0	10	0	512	0	522
13070	2	2	0	519	0	523
13071	0	0	0	515	0	515
13072	1	503	1	15	0	520
13073	2	10	2	510	0	524
13074	0	2	497	14	0	513
13075	1	2	10	499	0	512
13076	2	0	490	13	0	505
13077	1	494	10	5	0	510
13078	0	10	4	502	0	516
13079	0	4	1	506	0	511
13080	2	1	0	510	0	513
13081	3	1	1	507	0	512
13082	1	1	492	16	0	510
13083	1	483	11	2	0	497
13084	1	13	2	508	0	524
13085	2	2	506	14	0	524
13086	3	1	11	516	0	531
13087	518	1	3	14	0	536
13088	12	0	509	6	0	527
13089	508	0	13	2	0	523
13090	12	3	4	514	0	533
13091	3	1	513	15	0	532
13092	0	512	14	6	0	532
13093	1	11	3	521	0	536
13094	3	2	521	11	0	537
13095	0	2092	25	5	0	2122
13096	6	14	3	2331	0	2354
13097	2362	3	1	15	0	2381
13098	2328	0	2	4	0	2334
13099	2326	3	0	4	0	2333
13100	14	3	2301	3	0	2321
13101	5	2203	14	3	0	2225
13102	4	14	4	2334	0	2356
13103	2	5	1	2387	0	2395
13104	2416	2	0	17	0	2435
13105	13	2268	5	6	0	2292
13106	2407	12	1	3	0	2423
13107	2393	3	1	1	0	2398
13108	2378	5	1	2	0	2386
13109	14	1	2268	7	0	2290
13110	2290	2	12	4	0	2308
13111	16	1	4	2389	0	2410
13112	4	5	1	2373	0	2383
13113	2413	2	0	18	0	2433
13114	15	1	1	2343	0	2360
13115	9	2300	1	15	0	2325
13116	2	14	2	2379	0	2397
13117	2360	3	0	15	0	2378
13118	14	2	2303	7	0	2326
13119	5	2226	15	7	0	2253
13120	4	11	3	2360	0	2378
13121	2354	6	2	14	0	2376
13122	15	2	2285	7	0	2309
13123	3	11	18	2251	0	2283
13124	11	3	2298	15	0	2327
13125	2	3	2177	8	0	2190
13126	1	4	2196	3	0	2204
13127	2	3	2207	8	0	2220
13128	5	3	2166	4	0	2178
13129	2035	7	17	2	0	2061
13130	5	2015	3	3	0	2026
13131	2104	2	1	0	0	2107
13132	2092	1	0	0	0	2093
13133	3	2029	0	2	0	2034
13134	2	2035	1	1	0	2039
13135	2113	3	0	1	0	2117
13136	2111	1	0	1	0	2113
13137	3	2	0	2056	0	2061
13138	2	2001	1	4	0	2008
13139	2111	2	0	2	0	2115
13140	2	2006	3	1	0	2012
13141	1	4	1	2087	0	2093
13142	2101	1	0	5	0	2107
13143	2073	1	0	2	0	2076
13144	3	0	1	2050	0	2054
13145	2	0	0	2074	0	2076
13146	4	1	2026	3	0	2034
13147	0	0	4	1956	0	1960
13148	3	0	2041	3	0	2047
13149	0	0	4	2002	0	2006
13150	0	0	2	2068	0	2070
13151	2067	0	1	4	0	2072
13152	1984	2	0	2	0	1988
13153	5	1	2022	1	0	2029
13154	1958	0	3	0	0	1961
13155	3	1	1	2027	0	2032
13156	3	1	2031	2	0	2037
13157	2	0	2	1969	0	1973
13158	2	0	1	2041	0	2044
13159	1	0	2049	5	0	2055
13160	0	2	4	1979	0	1985
13161	4	0	2062	3	0	2069
13162	0	1	3	2038	0	2042
13163	3478	0	4	4	0	3486
13164	83	3457	5	12	0	3557
13165	3578	85	0	4	0	3667
13166	116	3584	3	5	0	3708
13167	3624	117	0	3	0	3744
13168	120	3579	5	2	0	3706
13169	3569	129	0	1	0	3699
13170	123	3527	1	2	0	3653
13171	76	126	0	3577	0	3779
13172	48	70	3518	84	0	3720
13173	25	59	3481	63	0	3628
13174	27	23	147	3535	0	3732
13175	3508	25	102	91	0	3726
13176	103	3492	40	78	0	3713
13177	81	100	12	3605	0	3798
13178	62	80	3523	87	0	3752
13179	27	60	3509	74	0	3670
13180	22	29	154	3322	0	3527
13181	17	3449	113	76	0	3655
13182	3547	92	56	62	0	3757
13183	100	73	4541	52	0	4766
13184	91	52	4436	23	0	4602
13185	60	4410	163	25	0	4658
13186	4654	102	104	24	0	4884
13187	4697	85	52	14	0	4848
13188	167	61	27	4605	0	4860
13189	4751	23	36	100	0	4910
13190	4664	21	31	75	0	4791
13191	173	4520	24	51	0	4768
13192	4665	103	26	21	0	4815
13193	162	86	4458	17	0	4723
13194	108	60	105	4501	0	4774
13195	69	32	81	3047	0	3229
13196	2988	35	52	156	0	3231
13197	123	2927	19	122	0	3191
13198	2999	92	28	66	0	3185
13199	149	2943	28	34	0	3154
13200	104	2986	17	34	0	3141
13201	82	159	2906	22	0	3169
13202	56	111	2923	19	0	3109
13203	2877	73	164	21	0	3135
13204	3012	30	122	21	0	3185
13205	188	43	2853	33	0	3117
13206	148	2716	108	33	0	3005
13207	90	2954	73	25	0	3142
13208	2968	168	55	15	0	3206
13209	3030	144	25	9	0	3208
13210	196	85	28	2923	0	3232
13211	3057	62	30	97	0	3246
13212	156	47	34	3009	0	3246
13213	130	21	2902	145	0	3198
13214	90	33	2859	93	0	3075
13215	2914	23	167	70	0	3174
13216	148	50	115	2669	0	2982
13217	121	2912	56	84	0	3173
13218	3023	133	30	81	0	3267
13219	3056	85	44	58	0	3243
13220	205	65	2922	31	0	3223
13221	3029	25	109	64	0	3227
13222	3117	46	97	37	0	3297
13223	224	33	72	2863	0	3192
13224	159	2800	60	106	0	3125
13225	100	2972	58	75	0	3205
13226	64	178	42	3008	0	3292
13227	86	122	19	3036	0	3263
13228	79	83	29	3126	0	3317
13229	90	35	2937	219	0	3281
13230	91	52	2943	144	0	3230
13231	84	52	182	2976	0	3294
13232	79	60	3030	128	0	3297
13233	82	46	3058	97	0	3283
13234	70	58	196	2932	0	3256
13235	54	52	3001	164	0	3271
13236	64	2906	152	131	0	3253
13237	3041	123	110	98	0	3372
13238	124	97	80	3007	0	3308
13239	137	2935	58	125	0	3255
13240	91	131	2989	100	0	3311
13241	43	105	146	3019	0	3313
13242	58	68	3093	134	0	3353
13243	38	27	193	3081	0	3339
13244	55	33	134	3934	0	4156
13245	62	38	3751	271	0	4122
13246	66	34	205	3767	0	4072
13247	51	3692	176	236	0	4155
13248	74	195	107	3947	0	4323
13249	64	171	3752	256	0	4243
13250	69	103	198	3929	0	4299
13251	3685	43	179	276	0	4183
13252	187	3697	115	225	0	4224
13253	177	155	60	3897	0	4289
13254	119	141	3697	232	0	4189
13255	64	3649	210	197	0	4120
13256	79	3919	161	128	0	4287
13257	55	298	3748	76	0	4177
13258	45	228	183	3673	0	4129
13259	53	109	175	3908	0	4245
13260	63	56	3681	320	0	4120
13261	60	3536	221	253	0	4070
13262	72	3872	189	156	0	4289
13263	2224	117	29	30	0	2400
13264	57	2262	21	9	0	2349
13265	2287	104	7	12	0	2410
13266	93	78	7	2176	0	2354
13267	2275	34	7	73	0	2389
13268	101	22	2159	72	0	2354
13269	2199	11	72	40	0	2322
13270	102	7	67	2183	0	2359
13271	76	2168	34	84	0	2362
13272	2294	70	17	68	0	2449
13273	82	68	11	2123	0	2284
13274	69	2151	19	74	0	2313
13275	35	2312	14	62	0	2423
13276	2295	117	8	36	0	2456
13277	2354	84	6	25	0	2469
13278	2398	41	12	22	0	2473
13279	159	25	12	2202	0	2398
13280	108	2158	12	70	0	2348
13281	52	2282	7	65	0	2406
13282	31	116	8	2289	0	2444
13283	1315	85	5	91	0	1496
13284	1328	42	4	75	0	1449
13285	1424	25	10	36	0	1495
13286	157	20	1281	18	0	1476
13287	112	12	1329	10	0	1463
13288	1386	8	125	12	0	1531
13289	93	9	90	1343	0	1535
13290	80	13	43	1400	0	1536
13291	41	11	18	1446	0	1516
13292	24	10	11	1474	0	1519
13293	17	18	1292	174	0	1501
13294	19	10	65	1438	0	1532
13295	20	7	1343	126	0	1496
13296	1303	11	91	93	0	1498
13297	80	1315	71	45	0	1511
13298	75	74	37	1364	0	1550
13299	36	71	18	1427	0	1552
13300	1384	41	7	132	0	1564
13301	1423	21	4	101	0	1549
13302	1500	10	4	52	0	1566
13303	1520	8	7	29	0	1564
13304	176	9	1327	26	0	1538
13305	116	16	1371	12	0	1515
13306	61	12	132	1366	0	1571
13307	1391	10	90	83	0	1574
13308	1436	6	41	84	0	1567
13309	144	6	1348	55	0	1553
13310	101	12	83	1371	0	1567
13311	1388	9	72	96	0	1565
13312	101	8	44	1420	0	1573
13313	90	8	1323	116	0	1537
13314	48	7	78	1470	0	1603
13315	1388	12	73	113	0	1586
13316	74	1419	36	99	0	1628
13317	1483	74	25	52	0	1634
13318	1507	66	16	38	0	1627
13319	1566	30	12	29	0	1637
13320	172	20	16	1443	0	1651
13321	1476	21	8	80	0	1585
13322	117	1350	12	79	0	1558
13323	89	1482	14	43	0	1628
13324	42	115	13	1463	0	1633
13325	1450	83	9	82	0	1624
13326	94	1515	10	74	0	1693
13327	1767	96	7	41	0	1911
13328	1802	71	14	25	0	1912
13329	160	1827	13	25	0	2025
13330	117	91	13	1826	0	2047
13331	63	76	8	1918	0	2065
13332	50	36	1782	148	0	2016
13333	35	22	80	1942	0	2079
13334	22	17	1844	132	0	2015
13335	28	1792	102	106	0	2028
13336	27	79	77	1877	0	2060
13337	1801	64	38	106	0	2009
13338	1887	31	25	89	0	2032
13339	155	20	13	1864	0	2052
13340	109	17	1720	105	0	1951
13341	1785	24	68	85	0	1962
13342	115	1702	74	51	0	1942
13343	104	1830	39	37	0	2010
13344	8	1018	2	5	0	1033
13345	5	15	3	1004	0	1027
13346	3	7	1006	10	0	1026
13347	2	5	9	999	0	1015
13348	2	4	1006	11	0	1023
13349	3	4	986	7	0	1000
13350	1	4	1015	4	0	1024
13351	1	2	16	1003	0	1022
13352	2	1	10	1017	0	1030
13353	2	1	5	1032	0	1040
13354	1	2	6	1018	0	1027
13355	1001	4	3	17	0	1025
13356	9	989	4	11	0	1013
13357	1007	9	3	7	0	1026
13358	9	1016	3	6	0	1034
13359	7	11	1	1020	0	1039
13360	2	7	3	1038	0	1050
13361	1046	3	3	16	0	1068
13362	1045	4	2	10	0	1061
13363	1056	3	2	6	0	1067
13364	1054	4	1	4	0	1063
13365	1040	1	0	8	0	1049
13366	18	1034	1	6	0	1059
13367	1034	10	0	3	0	1047
13368	16	1006	0	3	0	1025
13369	1008	11	1	1	0	1021
13370	15	8	1006	2	0	1031
13371	13	5	9	989	0	1016
13372	5	1011	6	7	0	1029
13373	6	14	1	1010	0	1031
13374	9	11	993	13	0	1026
13375	6	2	12	978	0	998
13376	964	2	9	13	0	988
13377	12	977	3	11	0	1003
13378	8	998	5	5	0	1016
13379	3	16	1053	10	0	1082
13380	5	10	13	1038	0	1066
13381	6	2062	12	15	0	2095
13382	3	14	3	2164	0	2184
13383	5	9	2133	17	0	2164
13384	2	2062	12	18	0	2094
13385	7	13	2126	5	0	2151
13386	4	13	2077	8	0	2102
13387	3	5	17	2082	0	2107
13388	2145	6	9	15	0	2175
13389	14	3	6	2143	0	2166
13390	12	4	2165	15	0	2196
13391	7	2	14	2172	0	2195
13392	6	7	2250	18	0	2281
13393	5	2	2212	13	0	2232
13394	2217	3	22	6	0	2248
13395	2291	6	8	7	0	2312
13396	2285	5	8	7	0	2305
13397	18	3	2262	9	0	2292
13398	10	5	2253	5	0	2273
13399	7	1	23	2212	0	2243
13400	7	2	11	2259	0	2279
13401	2277	2	8	20	0	2307
13402	16	2	8	2267	0	2293
13403	8	2	2284	21	0	2315
13404	5	2	2239	20	0	2266
13405	10	1257	21	1027	0	2315
13406	6	14	9	2303	0	2332
13407	7	8	2329	16	0	2360
13408	6	4	15	2288	0	2313
13409	2327	4	13	16	0	2360
13410	16	5	2328	13	0	2362
13411	6	5	17	2339	0	2367
13412	5	2	10	2350	0	2367
13413	8	3	2324	23	0	2358
13414	7	2	16	2275	0	2300
13415	9	1	2292	20	0	2322
13416	2181	3	15	13	0	2212
13417	16	1	9	2265	0	2291
13418	10	2249	10	15	0	2284
13419	2279	15	6	11	0	2311
13420	2262	6	3	5	0	2276
13421	18	2271	6	4	0	2299
13422	27	82	7	2142	0	2258
13423	6	2229	5	13	0	2253
13424	10	2205	3	10	0	2228
13425	23	25	2140	6	0	2194
13426	6	2104	16	7	0	2133
13427	12	19	1881	8	0	1920
13428	1675	8	9	2	0	1694
13429	1710	3	1	0	0	1714
13430	6	1773	0	2	0	1781
13431	1	1770	1	2	0	1774
13432	0	1787	1	0	0	1788
13433	1808	3	0	0	0	1811
13434	4	0	0	1768	0	1772
13435	1	0	1816	2	0	1819
13436	0	1791	4	0	0	1795
13437	0	3	0	1839	0	1842
13438	0	0	0	1821	0	1821
13439	0	1902	0	3	0	1905
13440	2001	4	0	0	0	2005
13441	5	1	2014	2	0	2022
13442	2	6	4	2662	0	2674
13443	1	2872	6	48	0	2927
13444	2888	60	2	15	0	2965
13445	68	22	2832	5	0	2927
13446	21	2795	68	2	0	2886
13447	7	61	15	2890	0	2973
13448	2	20	2861	68	0	2951
13449	2758	7	66	20	0	2851
13450	63	2	21	2868	0	2954
13451	25	1	2834	82	0	2942
13452	9	2849	66	32	0	2956
13453	2882	69	18	11	0	2980
13454	68	2884	32	6	0	2990
13455	2905	101	6	1	0	3013
13456	2954	28	5	34	0	3021
13457	88	25	30	2839	0	2982
13458	60	2793	16	69	0	2938
13459	27	53	2766	49	0	2895
13460	6	28	102	2817	0	2953
13461	11	52	30	2658	0	2751
13462	30	8	21	2900	0	2959
13463	18	34	15	2891	0	2958
13464	41	24	3	2888	0	2956
13465	2833	14	11	100	0	2958
13466	2817	20	22	85	0	2944
13467	2819	82	5	32	0	2938
13468	143	2695	37	24	0	2899
13469	63	66	2742	143	0	3014
13470	41	187	2780	85	0	3093
13471	144	84	2814	110	0	3152
13472	61	37	268	2690	0	3056
13473	59	153	117	2812	0	3141
13474	61	63	40	3000	0	3164
13475	43	33	2835	209	0	3120
13476	181	2617	151	85	0	3034
13477	126	104	2708	161	0	3099
13478	57	71	2877	85	0	3090
13479	63	171	175	2626	0	3035
13480	208	78	2708	74	0	3068
13481	103	152	99	1764	0	2118
13482	1811	114	40	156	0	2121
13483	1894	67	61	91	0	2113
13484	184	18	1685	215	0	2102
13485	63	159	114	1774	0	2110
13486	36	82	1791	183	0	2092
13487	25	1653	184	257	0	2119
13488	1655	85	78	304	0	2122
13489	137	46	1644	258	0	2085
13490	99	1583	119	263	0	2064
13491	104	1599	80	234	0	2017
13492	206	1616	64	100	0	1986
13493	223	128	1524	62	0	1937
13494	234	60	147	1464	0	1905
13495	125	1583	128	100	0	1936
13496	72	155	189	1524	0	1940
13497	70	74	207	1599	0	1950
13498	1453	44	279	171	0	1947
13499	81	1467	168	222	0	1938
13500	1438	139	79	263	0	1919
13501	80	1478	91	263	0	1912
13502	45	1504	229	143	0	1921
13503	44	217	1475	147	0	1883
13504	36	134	279	1453	0	1902
13505	44	63	1588	160	0	1855
13506	89	1380	165	240	0	1874
13507	126	90	1538	96	0	1850
13508	69	82	1501	181	0	1833
13509	195	1378	162	131	0	1866
13510	1510	117	126	62	0	1815
13511	147	1429	205	46	0	1827
13512	1424	122	125	179	0	1850
13513	107	74	1521	138	0	1840
13514	42	191	1489	83	0	1805
13515	149	1460	152	59	0	1820
13516	1346	191	215	50	0	1802
13517	92	1486	184	38	0	1800
13518	39	286	97	1372	0	1794
13519	1352	278	62	121	0	1813
13520	87	157	1450	91	0	1785
13521	79	63	163	1510	0	1815
13522	1356	141	94	169	0	1760
13523	123	1399	74	174	0	1770
13524	88	141	52	1499	0	1780
13525	179	83	1314	185	0	1761
13526	1376	229	120	71	0	1796
13527	221	127	87	1325	0	1760
13528	121	183	2407	101	0	2812
13529	42	154	180	2404	0	2780
13530	28	2573	206	100	0	2907
13531	52	150	2618	133	0	2953
13532	25	102	277	2540	0	2944
13533	2569	177	125	114	0	2985
13534	123	98	204	2545	0	2970
13535	2547	100	226	95	0	2968
13536	130	2574	108	79	0	2891
13537	2595	145	85	52	0	2877
13538	143	196	2431	56	0	2826
13539	731	124	1827	35	0	2717
13540	172	68	2321	24	0	2585
13541	86	2214	257	37	0	2594
13542	15	10	25	1354	0	1404
13543	1	1	4	1339	0	1345
13544	0	1	1	1305	0	1307
13545	0	1	0	1327	0	1328
13546	0	1	1328	2	0	1331
13547	1153	1	2	2	0	1158
13548	1	1308	0	3	0	1312
13549	1110	1	3	1	0	1115
13550	1	1	1	1369	0	1372
13551	1	1297	0	3	0	1301
13552	0	3	1	1374	0	1378
13553	1381	1	0	1	0	1383
13554	2	1294	0	2	0	1298
13555	1372	2	0	0	0	1374
13556	1350	0	0	1	0	1351
13557	1	0	1	1350	0	1352
13558	0	1	1303	0	0	1304
13559	1273	1	1	0	0	1275
13560	2	1	0	1359	0	1362
13561	1373	1	0	1	0	1375
13562	1351	0	1	0	0	1352
13563	1345	0	0	0	0	1345
13564	0	0	1328	1	0	1329
13565	1	0	0	1290	0	1291
13566	1351	0	0	1	0	1352
13567	0	2	1309	0	0	1311
13568	0	1282	2	1	0	1285
13569	0	0	1	1249	0	1250
13570	2	1	1324	0	0	1327
13571	0	2	1176	2	0	1180
13572	2	3	1	1259	0	1265
13573	0	0	1	1325	0	1326
13574	0	1	1	1322	0	1324
13575	0	0	2	1301	0	1303
13576	0	1	1318	2	0	1321
13577	1	1210	2	1	0	1214
13578	0	0	0	1331	0	1331
13579	1350	0	0	3	0	1353
13580	1304	1	1	0	0	1306
13581	1333	1	0	0	0	1334
13582	0	0	1	1326	0	1327
13583	1	0	1	1344	0	1346
13584	1	1282	1	0	0	1284
13585	1	1291	0	3	0	1295
13586	0	0	0	1350	0	1350
13587	1341	0	0	1	0	1342
13588	1310	1	0	0	0	1311
13589	1303	1	0	0	0	1304
13590	1316	0	0	1	0	1317
13591	1320	0	0	0	0	1320
13592	1	1282	1	2	0	1286
13593	1	0	0	1332	0	1333
13594	1347	0	0	1	0	1348
13595	1328	0	0	0	0	1328
13596	0	1	0	1304	0	1305
13597	0	1	0	1332	0	1333
13598	1	0	1311	0	0	1312
13599	1	0	0	1266	0	1267
13600	0	0	0	1315	0	1315
13601	0	0	1307	1	0	1308
13602	0	0	1	1291	0	1292
13603	0	1278	0	2	0	1280
13604	0	4	1224	1	0	1229
13605	0	1243	3	0	0	1246
13606	1	0	0	1291	0	1292
13607	0	0	0	1313	0	1313
13608	0	1246	0	1	0	1247
13609	0	1280	1	0	0	1281
13610	1336	0	0	0	0	1336
13611	1305	0	0	1	0	1306
13612	0	3	1194	0	0	1197
13613	1875	1	0	1	0	1877
13614	1903	0	0	0	0	1903
13615	1888	0	0	1	0	1889
13616	1856	1	8	0	0	1865
13617	0	5	1764	1	0	1770
13618	2	15	1533	0	0	1550
13619	1855	0	0	0	0	1855
13620	0	1713	10	3	0	1726
13621	0	4	1832	0	0	1836
13622	1823	0	1	2	0	1826
13623	1874	0	0	0	0	1874
13624	2	2	1806	0	0	1810
13625	1736	0	2	1	0	1739
13626	0	0	0	1887	0	1887
13627	0	0	1864	1	0	1865
13628	696	0	1	1	0	698
13629	0	714	1	0	0	715
13630	1539	0	0	1	0	1540
13631	1569	0	0	1	0	1570
13632	0	0	0	1522	0	1522
13633	0	0	0	1524	0	1524
13634	1	0	0	1561	0	1562
13635	1558	0	0	0	0	1558
13636	1572	0	1	0	0	1573
13637	0	0	0	1563	0	1563
13638	0	0	1	1560	0	1561
13639	0	1	1522	0	0	1523
13640	1434	1	1	0	0	1436
13641	0	0	0	1573	0	1573
13642	0	0	0	1567	0	1567
13643	0	1508	4	1	0	1513
13644	0	0	0	1586	0	1586
13645	0	0	0	1576	0	1576
13646	1563	0	0	0	0	1563
13647	0	1522	4	2	0	1528
13648	0	0	0	1592	0	1592
13649	0	0	0	1546	0	1546
13650	0	0	0	1561	0	1561
13651	1	2	1563	0	0	1566
13652	0	1	0	1535	0	1536
13653	1535	0	1	0	0	1536
13654	3	2	1551	0	0	1556
13655	1	0	0	1551	0	1552
13656	0	0	0	1576	0	1576
13657	1592	0	0	0	0	1592
13658	1529	0	0	0	0	1529
13659	1	1	1564	0	0	1566
13660	1417	2	1	4	0	1424
13661	1	0	1538	0	0	1539
13662	1463	1	0	0	0	1464
13663	4	1536	2	1	0	1543
13664	1644	0	0	0	0	1644
13665	1	1560	1	1	0	1563
13666	1657	1	0	0	0	1658
13667	1	1578	3	2	0	1584
13668	0	1	0	1664	0	1665
13669	0	0	0	1648	0	1648
13670	0	0	0	1659	0	1659
13671	0	1590	3	2	0	1595
13672	0	1	0	1681	0	1682
13673	0	1613	3	2	0	1618
13674	0	1	0	1686	0	1687
13675	1685	0	0	1	0	1686
13676	1611	1	0	0	0	1612
13677	1	1604	1	2	0	1608
13678	0	1	0	1672	0	1673
13679	1671	0	0	1	0	1672
13680	1	1602	0	1	0	1604
13681	0	1606	0	0	0	1606
13682	1699	2	1	0	0	1702
13683	1674	1	1	0	0	1676
13684	1	1638	4	2	0	1645
13685	1703	1	0	1	0	1705
13686	1	0	0	1696	0	1697
13687	1	1	1704	1	0	1707
13688	1668	0	2	0	0	1670
13689	1677	0	0	1	0	1678
13690	1	2	1680	0	0	1683
13691	1624	0	1	1	0	1626
13692	1714	0	0	1	0	1715
13693	1731	0	0	0	0	1731
13694	1	1678	1	0	0	1680
13695	1765	1	0	0	0	1766
13696	1755	0	0	2	0	1757
13697	1	1	1	1720	0	1723
13698	3	0	0	2367	0	2370
13699	2	0	0	2436	0	2438
13700	2435	0	0	9	0	2444
13701	7	0	1	2419	0	2427
13702	2426	2	0	12	0	2440
13703	2416	0	2	10	0	2428
13704	9	1	0	2411	0	2421
13705	9	2	1	2409	0	2421
13706	3	0	0	2468	0	2471
13707	2458	0	0	14	0	2472
13708	15	2389	4	21	0	2429
13709	5	8	0	2489	0	2502
13710	16	1	0	2504	0	2521
13711	2480	2	2	33	0	2517
13712	2461	1	2	15	0	2479
13713	29	9	1862	17	0	1917
13714	17	2	1792	31	0	1842
13715	1908	2	11	22	0	1943
13716	27	0	4	1961	0	1992
13717	26	1	4	3372	0	3403
13718	16	13	3271	199	0	3499
13719	9	11	168	3047	0	3235
13720	14	3259	22	171	0	3466
13721	14	3570	7	36	0	3627
13722	3330	207	8	19	0	3564
13723	179	56	3142	19	0	3396
13724	35	3309	162	27	0	3533
13725	28	186	26	3410	0	3650
13726	22	35	3350	205	0	3612
13727	19	17	190	3307	0	3533
13728	10	14	51	3508	0	3583
13729	14	16	3256	228	0	3514
13730	8	2693	174	60	0	2935
13731	4	206	31	2695	0	2936
13732	2726	38	10	219	0	2993
13733	2883	22	25	44	0	2974
13734	2830	27	16	30	0	2903
13735	208	2739	9	36	0	2992
13736	2598	198	27	20	0	2843
13737	179	43	9	2756	0	2987
13738	37	19	2627	229	0	2912
13739	2634	9	190	47	0	2880
13740	194	2728	32	35	0	2989
13741	47	188	19	2710	0	2964
13742	29	41	20	2750	0	2840
13743	27	2688	16	231	0	2962
13744	35	202	21	2730	0	2988
13745	21	68	17	2911	0	3017
13746	47	26	15	3009	0	3097
13747	2734	45	36	266	0	3081
13748	2924	44	28	86	0	3082
13749	251	46	2682	76	0	3055
13750	51	77	225	2689	0	3042
13751	48	41	48	3905	0	4042
13752	42	36	48	3947	0	4073
13753	3778	64	45	278	0	4165
13754	220	38	3614	118	0	3990
13755	3669	30	230	90	0	4019
13756	3889	38	50	99	0	4076
13757	254	16	30	3828	0	4128
13758	3827	23	51	253	0	4154
13759	251	44	3604	93	0	3992
13760	3570	24	193	91	0	3878
13761	253	3630	61	81	0	4025
13762	118	202	3689	64	0	4073
13763	115	40	3812	63	0	4030
13764	64	69	245	3644	0	4022
13765	106	33	3660	248	0	4047
13766	3595	35	214	102	0	3946
13767	226	3627	80	73	0	4006
13768	3768	226	36	68	0	4098
13769	235	80	43	3754	0	4112
13770	87	43	3665	276	0	4071
13771	73	46	3645	134	0	3898
13772	42	66	244	3780	0	4132
13773	3700	32	81	275	0	4088
13774	219	3559	43	153	0	3974
13775	70	3817	63	123	0	4073
13776	3681	230	50	113	0	4074
13777	253	3715	48	103	0	4119
13778	3803	231	68	79	0	4181
13779	263	78	34	3825	0	4200
13780	3807	43	54	274	0	4178
13781	268	36	59	3840	0	4203
13782	3814	50	39	281	0	4184
13783	287	19	73	3678	0	4057
13784	113	3620	57	253	0	4043
13785	3673	224	44	98	0	4039
13786	259	3667	61	112	0	4099
13787	127	248	3525	70	0	3970
13788	95	76	241	3161	0	3573
13789	84	3599	85	203	0	3971
13790	3610	259	44	66	0	3979
13791	3644	82	76	65	0	3867
13792	301	3598	82	51	0	4032
13793	101	251	3524	87	0	3963
13794	77	78	254	3412	0	3821
13795	91	3513	79	238	0	3921
13796	62	260	62	3671	0	4055
13797	103	74	68	3866	0	4111
13798	2969	42	37	282	0	3330
13799	225	2886	54	98	0	3263
13800	81	215	51	3032	0	3379
13801	2981	86	32	268	0	3367
13802	3194	42	30	77	0	3343
13803	3177	63	28	65	0	3333
13804	260	70	12	3004	0	3346
13805	2998	48	23	238	0	3307
13806	244	2931	26	81	0	3282
13807	2942	218	28	67	0	3255
13808	258	2936	21	80	0	3295
13809	3016	218	19	69	0	3322
13810	3129	65	13	81	0	3288
13811	283	36	20	2953	0	3292
13812	100	35	2875	242	0	3252
13813	72	59	2874	80	0	3085
13814	101	2836	205	42	0	3184
13815	2970	237	56	55	0	3318
13816	252	91	2921	40	0	3304
13817	1272	0	6	3	0	1281
13818	2	1293	6	0	0	1301
13819	1	1316	5	2	0	1324
13820	1	5	0	1440	0	1446
13821	1	1368	0	3	0	1372
13822	0	5	1386	1	0	1392
13823	1	1	4	1409	0	1415
13824	1	1369	4	6	0	1380
13825	1	3	0	1486	0	1490
13826	1492	1	0	4	0	1497
13827	5	0	1	1465	0	1471
13828	2	1	1449	4	0	1456
13829	0	1360	10	4	0	1374
13830	0	5	2	1504	0	1511
13831	1	1	0	1505	0	1507
13832	0	1	1	1512	0	1514
13833	1490	1	0	7	0	1498
13834	1431	0	1	5	0	1437
13835	6	2	1402	1	0	1411
13836	1	2	1380	2	0	1385
13837	5	1304	19	1	0	1329
13838	1490	4	1	0	0	1495
13839	5	2	1	1466	0	1474
13840	1	1	1	1463	0	1466
13841	1	0	0	1489	0	1490
13842	1	1	0	1481	0	1483
13843	1	1	1395	7	0	1404
13844	1356	0	5	4	0	1365
13845	7	0	1	1530	0	1538
13846	1	1	1487	10	0	1499
13847	2377	0	9	5	0	2391
13848	2517	2	9	4	0	2532
13849	63	2	2532	1	0	2598
13850	37	5	2589	1	0	2632
13851	29	1	73	1819	0	1922
13852	1803	1	38	54	0	1896
13853	1846	1	29	20	0	1896
13854	77	2	14	1762	0	1855
13855	39	0	6	1889	0	1934
13856	36	1	1775	81	0	1893
13857	19	1	56	1846	0	1922
13858	8	1	1783	88	0	1880
13859	1772	1	71	37	0	1881
13860	51	1790	30	28	0	1899
13861	1778	56	24	16	0	1874
13862	77	1779	15	12	0	1883
13863	1790	65	12	3	0	1870
13864	80	30	4	1726	0	1840
13865	34	21	7	1788	0	1850
13866	1782	13	1	76	0	1872
13867	1820	10	3	34	0	1867
13868	1821	1	0	36	0	1858
13869	1846	7	2	24	0	1879
13870	112	1	1691	7	0	1811
13871	1775	4	53	7	0	1839
13872	1798	0	21	5	0	1824
13873	1801	2	20	2	0	1825
13874	104	2	12	1738	0	1856
13875	1693	2	5	59	0	1759
13876	100	1689	2	22	0	1813
13877	43	54	7	1723	0	1827
13878	34	17	4	1792	0	1847
13879	27	16	1643	86	0	1772
13880	23	14	58	1675	0	1770
13881	12	1714	22	86	0	1834
13882	1674	57	21	40	0	1792
13883	62	1734	14	34	0	1844
13884	1728	73	10	21	0	1832
13885	82	35	5	1731	0	1853
13886	1696	24	9	67	0	1796
13887	86	1690	10	33	0	1819
13888	1709	64	11	28	0	1812
13889	1733	24	8	25	0	1790
13890	105	24	9	1686	0	1824
13891	57	18	3	1753	0	1831
13892	43	14	1637	95	0	1789
13893	37	4	59	1709	0	1809
13894	13	11	24	1787	0	1835
13895	19	2	1668	106	0	1795
13896	17	4	72	1734	0	1827
13897	15	7	1664	106	0	1792
13898	1677	6	81	44	0	1808
13899	78	7	40	1690	0	1815
13900	44	4	1638	83	0	1769
13901	1664	5	74	38	0	1781
13902	82	6	33	1670	0	1791
13903	43	4	1619	87	0	1753
13904	1659	6	76	39	0	1780
13905	93	5	22	1664	0	1784
13906	43	2	27	1731	0	1803
13907	1662	3	23	94	0	1782
13908	91	7	12	1658	0	1768
13909	43	2	9	1716	0	1770
13910	32	8	12	1627	0	1679
13911	37	1606	13	103	0	1759
13912	1591	58	9	65	0	1723
13913	1643	28	3	49	0	1723
13914	94	20	7	1607	0	1728
13915	1627	22	4	76	0	1729
13916	1642	10	5	42	0	1699
13917	1653	3	13	43	0	1712
13918	1515	13	13	32	0	1573
13919	1623	6	11	30	0	1670
13920	131	10	1463	20	0	1624
13921	77	10	1481	18	0	1586
13922	1468	7	76	24	0	1575
13923	84	1443	40	29	0	1596
13924	45	57	51	1419	0	1572
13925	38	25	1407	82	0	1552
13926	41	23	1432	34	0	1530
13927	35	20	84	1429	0	1568
13928	1400	17	46	80	0	1543
13929	83	7	43	1427	0	1560
13930	40	11	1371	89	0	1511
13931	1440	5	66	56	0	1567
13932	82	5	36	1442	0	1565
13933	45	3	23	1484	0	1555
13934	42	3	24	1489	0	1558
13935	37	2	17	1508	0	1564
13936	32	0	1357	126	0	1515
13937	19	5	67	1468	0	1559
13938	1413	4	27	119	0	1563
13939	72	4	1363	60	0	1499
13940	1384	4	72	43	0	1503
13941	1478	2	28	39	0	1547
13942	1474	6	24	29	0	1533
13943	1451	6	22	24	0	1503
13944	114	1341	10	26	0	1491
13945	73	1347	11	19	0	1450
13946	55	1413	5	36	0	1509
13947	363	20	10	5	0	398
13948	17	7	325	1	0	350
13949	182	2	4	0	0	188
13950	7	2	1	167	0	177
13951	169	0	0	2	0	171
13952	3	0	0	169	0	172
13953	172	0	0	2	0	174
13954	2	1	0	173	0	176
13955	1	1	0	181	0	183
13956	154	1	0	4	0	159
13957	2	180	0	1	0	183
13958	1	2	177	0	0	180
13959	1	174	2	0	0	177
13960	0	2	164	1	0	167
13961	1	3	3	153	0	160
13962	158	0	1	3	0	162
13963	3	0	0	152	0	155
13964	155	0	0	3	0	158
13965	4	173	0	2	0	179
13966	1	2	170	0	0	173
13967	0	169	2	0	0	171
13968	0	164	1	0	0	165
13969	164	3	0	0	0	167
13970	162	0	2	0	0	164
13971	0	167	0	0	0	167
13972	0	0	0	172	0	172
13973	0	0	1	170	0	171
13974	171	0	0	0	0	171
13975	0	0	172	1	0	173
13976	0	0	174	1	0	175
13977	0	0	1	177	0	178
13978	0	0	180	1	0	181
13979	167	0	2	0	0	169
13980	168	0	0	2	0	170
13981	2	167	0	1	0	170
13982	0	0	190	1	0	191
13983	2	0	1	183	0	186
13984	2	0	216	0	0	218
13985	1	0	0	223	0	224
13986	224	0	0	2	0	226
13987	0	231	0	2	0	233
13988	0	1	235	1	0	237
13989	0	245	0	1	0	246
13990	2	260	0	3	0	265
13991	274	0	2	0	0	276
13992	269	1	0	0	0	270
13993	2	0	277	1	0	280
13994	3	287	0	0	0	290
13995	2	0	0	300	0	302
13996	2	1	0	295	0	298
13997	0	2	0	293	0	295
13998	0	2	302	1	0	305
13999	3	1	0	299	0	303
14000	1	1	1	306	0	309
14001	319	0	1	0	0	320
14002	318	0	0	1	0	319
14003	317	0	1	2	0	320
14004	317	0	0	2	0	319
14005	320	0	0	1	0	321
14006	1	313	0	2	0	316
14007	308	1	0	2	0	311
14008	2	0	315	3	0	320
14009	1	0	2	322	0	325
14010	324	1	1	1	0	327
14011	1	334	1	0	0	336
14012	339	0	0	0	0	339
14013	351	0	1	1	0	353
14014	2	1	0	354	0	357
14015	1	0	0	350	0	351
14016	1	384	0	3	0	388
14017	1	1	0	390	0	392
14018	0	2	391	1	0	394
14019	0	1	2	390	0	393
14020	0	2	392	2	0	396
14021	371	1	1	0	0	373
14022	4	0	0	399	0	403
14023	2	1	405	1	0	409
14024	0	395	2	1	0	398
14025	0	401	1	2	0	404
14026	407	2	0	1	0	410
14027	2	0	2	398	0	402
14028	1	5	1472	4	0	1482
14029	2	1455	8	2	0	1467
14030	1	2	1537	3	0	1543
14031	1543	0	2	0	0	1545
14032	1567	0	0	0	0	1567
14033	1575	0	0	1	0	1576
14034	1	1	0	1578	0	1580
14035	1	1	1569	2	0	1573
14036	0	1535	3	0	0	1538
14037	0	2	0	1622	0	1624
14038	1	2	1557	3	0	1563
14039	2	1	1473	1	0	1477
14040	0	1	2	1556	0	1559
14041	1624	0	0	2	0	1626
14042	1	0	0	1613	0	1614
14043	0	0	0	1612	0	1612
14044	0	2	1603	2	0	1607
14045	0	0	2	1577	0	1579
14046	0	0	0	1593	0	1593
14047	1	2	1611	2	0	1616
14048	0	2	1569	1	0	1572
14049	0	0	2	1571	0	1573
14050	2	1	1608	2	0	1613
14051	0	0	2	1609	0	1611
14052	1643	0	0	2	0	1645
14053	2	1624	0	3	0	1629
14054	0	3	0	1683	0	1686
14055	1	0	1652	5	0	1658
14056	1425	2	5	4	0	1436
14057	3	1597	1	1	0	1602
14058	1680	2	0	0	0	1682
14059	2	1	0	1663	0	1666
14060	0	0	0	1650	0	1650
14061	1679	0	1	3	0	1683
14062	4	1	1673	0	0	1678
14063	1627	0	2	0	0	1629
14064	2	0	0	1677	0	1679
14065	1662	0	0	2	0	1664
14066	1659	0	0	0	0	1659
14067	2	0	0	1673	0	1675
14068	0	1644	1	3	0	1648
14069	1721	3	1	0	0	1725
14070	1677	0	0	2	0	1679
14071	6	2	1714	0	0	1722
14072	1649	0	7	1	0	1657
14073	7	0	0	1730	0	1737
14074	0	2540	4	5	0	2549
14075	0	5	0	2667	0	2672
14076	1	2525	3	6	0	2535
14077	2664	6	3	2	0	2675
14078	2627	0	2	0	0	2629
14079	7	0	0	2684	0	2691
14080	4	1	2656	7	0	2668
14081	3	2	2559	1	0	2565
14082	0	1	7	2662	0	2670
14083	2709	0	0	8	0	2717
14084	2723	1	0	1	0	2725
14085	9	2648	5	3	0	2665
14086	0	9	0	2754	0	2763
14087	3	0	2784	12	0	2799
14088	1	3	2714	4	0	2722
14089	0	0	14	2766	0	2780
14090	3899	1	3	21	0	3924
14091	84	0	1	3897	0	3982
14092	17	3	3830	83	0	3933
14093	3844	0	84	16	0	3944
14094	93	2	12	3877	0	3984
14095	19	2	12	3954	0	3987
14096	14	1	12	3923	0	3950
14097	10	3711	13	105	0	3839
14098	10	73	3789	35	0	3907
14099	5	21	3795	33	0	3854
14100	3	14	96	3850	0	3963
14101	12	13	3831	96	0	3952
14102	3767	7	105	18	0	3897
14103	89	2	29	3849	0	3969
14104	22	0	17	3887	0	3926
14105	14	2	12	3931	0	3959
14106	15	3789	11	108	0	3923
14107	3904	90	8	40	0	4042
14108	87	18	8	3928	0	4041
14109	3878	14	10	114	0	4016
14110	105	3798	12	28	0	3943
14111	3858	94	6	26	0	3984
14112	3830	12	13	21	0	3876
14113	3813	14	8	18	0	3853
14114	118	3630	11	14	0	3773
14115	43	3786	8	14	0	3851
14116	3780	92	5	13	0	3890
14117	106	3721	8	17	0	3852
14118	33	102	3669	12	0	3816
14119	23	3652	88	21	0	3784
14120	22	3771	18	17	0	3828
14121	3774	111	22	10	0	3917
14122	106	35	3660	9	0	3810
14123	21	36	3693	8	0	3758
14124	25	24	99	3601	0	3749
14125	3751	12	31	99	0	3893
14126	103	16	3696	20	0	3835
14127	30	8	105	3637	0	3780
14128	22	15	2607	105	0	2749
14129	22	11	2638	33	0	2704
14130	2590	11	109	27	0	2737
14131	99	15	2605	17	0	2736
14132	22	10	117	2564	0	2713
14133	25	4	39	2605	0	2673
14134	23	2549	29	101	0	2702
14135	20	2642	22	34	0	2718
14136	15	100	14	2638	0	2767
14137	20	28	2585	107	0	2740
14138	15	23	98	2589	0	2725
14139	12	22	23	2708	0	2765
14140	12	17	2588	121	0	2738
14141	15	8	94	2606	0	2723
14142	3387	10	30	125	0	3552
14143	164	19	3296	41	0	3520
14144	3339	20	171	27	0	3557
14145	182	11	28	3340	0	3561
14146	40	9	33	3473	0	3555
14147	38	3334	26	182	0	3580
14148	15	153	25	3426	0	3619
14149	20	30	10	3606	0	3666
14150	3415	25	13	218	0	3671
14151	171	19	23	3451	0	3664
14152	38	12	17	3622	0	3689
14153	3375	6	16	225	0	3622
14154	181	6	27	3428	0	3642
14155	52	12	17	3431	0	3512
14156	37	3307	27	213	0	3584
14157	3366	162	25	73	0	3626
14158	173	28	25	3421	0	3647
14159	36	34	14	3580	0	3664
14160	40	27	3298	219	0	3584
14161	40	22	159	3396	0	3617
14162	22	15	29	3610	0	3676
14163	3314	9	34	242	0	3599
14164	3471	15	23	86	0	3595
14165	192	19	17	3451	0	3679
14166	65	17	3248	215	0	3545
14167	58	3164	157	71	0	3450
14168	49	3392	33	66	0	3540
14169	38	177	30	3351	0	3596
14170	3324	42	13	198	0	3577
14171	181	38	15	3357	0	3591
14172	3363	32	8	212	0	3615
14173	194	28	17	3376	0	3615
14174	65	19	12	2674	0	2770
14175	2500	15	14	216	0	2745
14176	2556	20	12	79	0	2667
14177	191	2438	19	60	0	2708
14178	55	2665	12	59	0	2791
14179	45	196	17	2446	0	2704
14180	45	53	15	2607	0	2720
14181	40	56	2343	198	0	2637
14182	2367	37	164	74	0	2642
14183	186	2364	28	76	0	2654
14184	47	2472	39	70	0	2628
14185	2391	159	43	48	0	2641
14186	189	52	2634	58	0	2933
14187	57	43	2743	45	0	2888
14188	51	34	2710	48	0	2843
14189	58	2596	179	43	0	2876
14190	11	80	23	1521	0	1635
14191	10	13	7	1594	0	1624
14192	11	9	5	1606	0	1631
14193	1519	3	4	104	0	1630
14194	1557	9	7	27	0	1600
14195	87	1492	6	27	0	1612
14196	26	90	4	1510	0	1630
14197	26	24	1475	90	0	1615
14198	24	1524	75	23	0	1646
14199	1549	76	24	29	0	1678
14200	89	9	1524	30	0	1652
14201	1476	16	76	40	0	1608
14202	96	15	1504	31	0	1646
14203	20	12	75	1488	0	1595
14204	25	2655	15	106	0	2801
14205	2806	69	11	45	0	2931
14206	94	2684	7	43	0	2828
14207	2802	95	9	33	0	2939
14208	88	33	5	2803	0	2929
14209	24	23	2738	124	0	2909
14210	26	28	74	2700	0	2828
14211	29	15	17	2959	0	3020
14212	37	12	2755	113	0	2917
14213	2634	19	82	48	0	2783
14214	93	2755	18	43	0	2909
14215	2860	86	16	38	0	3000
14216	94	2822	17	42	0	2975
14217	26	104	13	2904	0	3047
14218	41	18	2820	105	0	2984
14219	4155	29	78	47	0	4309
14220	150	4291	19	46	0	4506
14221	39	138	25	4278	0	4480
14222	30	40	15	4532	0	4617
14223	4727	35	16	180	0	4958
14224	4819	17	6	64	0	4906
14225	196	4696	16	49	0	4957
14226	4854	152	23	33	0	5062
14227	4930	48	21	24	0	5023
14228	4956	42	14	36	0	5048
14229	227	37	4691	35	0	4990
14230	76	4634	154	41	0	4905
14231	57	4913	40	37	0	5047
14232	38	196	28	4737	0	4999
14233	38	73	11	4983	0	5105
14234	4878	45	10	215	0	5148
14235	183	4809	16	88	0	5096
14236	4937	169	18	45	0	5169
14237	223	51	14	4862	0	5150
14238	69	58	15	5031	0	5173
14239	4901	33	19	202	0	5155
14240	4980	22	19	73	0	5094
14241	233	32	4735	48	0	5048
14242	44	12	87	3991	0	4134
14243	26	8	3957	94	0	4085
14244	13	17	3879	33	0	3942
14245	13	7	3970	24	0	4014
14246	3953	4	130	16	0	4103
14247	103	5	40	3943	0	4091
14248	39	7	18	3957	0	4021
14249	30	6	5	4098	0	4139
14250	19	6	3911	145	0	4081
14251	13	3	94	3913	0	4023
14252	15	7	34	4046	0	4102
14253	3974	9	24	122	0	4129
14254	4025	13	15	49	0	4102
14255	4052	11	6	32	0	4101
14256	4081	7	5	26	0	4119
14257	155	8	10	3973	0	4146
14258	4017	10	13	105	0	4145
14259	129	17	7	3995	0	4148
14260	53	23	3807	127	0	4010
14261	3903	13	91	52	0	4059
14262	124	3829	33	39	0	4025
14263	59	90	26	3934	0	4109
14264	49	38	11	3961	0	4059
14265	33	3915	12	128	0	4088
14266	3918	94	9	65	0	4086
14267	114	3838	14	54	0	4020
14268	72	91	3767	31	0	3961
14269	58	46	3813	21	0	3938
14270	3825	28	119	23	0	3995
14271	4000	14	47	30	0	4091
14272	149	13	3845	33	0	4040
14273	3853	17	105	29	0	4004
14274	144	10	3840	30	0	4024
14275	3849	19	127	32	0	4027
14276	144	24	3825	36	0	4029
14277	72	27	3851	43	0	3993
14278	50	23	140	3699	0	3912
14279	47	13	68	3868	0	3996
14280	5257	14	36	141	0	5448
14281	5249	12	24	75	0	5360
14282	5224	11	25	52	0	5312
14283	5236	20	21	43	0	5320
14284	187	5016	30	30	0	5263
14285	97	89	29	5148	0	5363
14286	60	4729	33	126	0	4948
14287	51	113	29	4845	0	5038
14288	49	52	21	4715	0	4837
14289	57	40	20	4870	0	4987
14290	55	23	4709	182	0	4969
14291	4213	17	104	102	0	4436
14292	149	4576	35	72	0	4832
14293	84	4748	22	53	0	4907
14294	66	128	4665	52	0	4911
14295	49	56	108	4507	0	4720
14296	41	39	58	4577	0	4715
14297	4822	18	36	158	0	5034
14298	132	11	35	4767	0	4945
14299	74	19	35	4752	0	4880
14300	50	15	35	4835	0	4935
14301	39	20	40	4855	0	4954
14302	4801	13	50	167	0	5031
14303	4701	18	55	73	0	4847
14304	3746	11	40	56	0	3853
14305	170	8	27	3651	0	3856
14306	3717	12	31	139	0	3899
14307	144	9	31	3685	0	3869
14308	76	12	36	3730	0	3854
14309	66	4	3597	179	0	3846
14310	62	8	3415	94	0	3579
14311	80	9	3484	51	0	3624
14312	3158	13	144	39	0	3354
14313	154	9	57	3404	0	3624
14314	90	3417	35	114	0	3656
14315	3560	100	24	61	0	3745
14316	153	36	3414	69	0	3672
14317	3334	26	108	56	0	3524
14318	138	3433	70	45	0	3686
14319	1995	29	5	4	0	2033
14320	35	11	6	1977	0	2029
14321	2013	5	2	37	0	2057
14322	37	1947	7	16	0	2007
14323	5	1594	5	3	0	1607
14324	1599	7	1	2	0	1609
14325	8	1557	1	2	0	1568
14326	6	1445	1	0	0	1452
14327	3	1471	2	3	0	1479
14328	1454	2	5	1	0	1462
14329	1396	2	4	1	0	1403
14330	1379	0	0	1	0	1380
14331	4	0	1	1320	0	1325
14332	1	1	1	1376	0	1379
14333	0	1	1378	3	0	1382
14334	2	1	2	1231	0	1236
14335	5	0	1361	3	0	1369
14336	1	1	3	1269	0	1274
14337	2	0	1	1336	0	1339
14338	1380	0	1	4	0	1385
14339	1249	0	0	3	0	1252
14340	3	1327	1	1	0	1332
14341	2	2	0	1349	0	1353
14342	3	2	1332	3	0	1340
14343	1	0	2	1234	0	1237
14344	1	2	2	1229	0	1234
14345	1	2	0	1322	0	1325
14346	2	0	1318	3	0	1323
14347	0	4	1158	1	0	1163
14348	1152	0	5	1	0	1158
14349	2	0	2	1311	0	1315
14350	2	1	1323	3	0	1329
14351	1120	0	4	2	0	1126
14352	2	1257	1	1	0	1261
14353	1318	2	1	0	0	1321
14354	3	3	1304	0	0	1310
14355	1163	0	2	0	0	1165
14356	2	0	1	1192	0	1195
14357	2	0	1289	2	0	1293
14358	1	1218	5	1	0	1225
14359	1262	3	2	0	0	1267
14360	3	1	0	1226	0	1230
14361	1	0	1	1233	0	1235
14362	1	1280	0	2	0	1283
14363	0	3	0	1297	0	1300
14364	0	1	1263	2	0	1266
14365	0	1197	5	1	0	1203
14366	1265	2	1	0	0	1268
14367	2	1	0	1238	0	1241
14368	1	0	0	1257	0	1258
14369	0	1	1263	3	0	1267
14370	0	0	2	1186	0	1188
14371	1	0	1270	2	0	1273
14372	0	1176	3	1	0	1180
14373	1243	2	1	0	0	1246
14374	1188	1	0	2	0	1191
14375	1199	0	1	0	0	1200
14376	3	1242	2	0	0	1247
14377	0	2	0	1241	0	1243
14378	0	1	1	1211	0	1213
14379	3	2	6	1095	0	1106
14380	150	0	0	3	0	153
14381	148	0	0	1	0	149
14382	4	0	0	144	0	148
14383	1	1	160	2	0	164
14384	0	0	2	164	0	166
14385	0	0	1	164	0	165
14386	0	0	0	162	0	162
14387	1	0	0	161	0	162
14388	161	0	0	3	0	164
14389	2	0	0	165	0	167
14390	1	0	1	176	0	178
14391	0	173	0	4	0	177
14392	0	2	0	178	0	180
14393	0	182	0	3	0	185
14394	0	2	0	184	0	186
14395	182	1	0	2	0	185
14396	2	180	0	2	0	184
14397	182	2	0	0	0	184
14398	2	2	183	0	0	187
14399	1	0	2	187	0	190
14400	0	1	199	2	0	202
14401	0	0	2	200	0	202
14402	1	1	1	194	0	197
14403	0	194	0	2	0	196
14404	1	198	0	1	0	200
14405	0	214	1	0	0	215
14406	215	1	0	1	0	217
14407	1	202	1	0	0	204
14408	0	193	0	1	0	194
14409	5	0	0	194	0	199
14410	196	0	0	0	0	196
14411	0	202	0	4	0	206
14412	210	0	0	0	0	210
14413	208	0	0	0	0	208
14414	0	0	233	0	0	233
14415	0	0	0	224	0	224
14416	0	0	0	228	0	228
14417	0	0	0	230	0	230
14418	0	0	0	231	0	231
14419	0	0	230	0	0	230
14420	1	0	217	0	0	218
14421	216	0	0	0	0	216
14422	0	227	0	0	0	227
14423	0	227	0	0	0	227
14424	235	0	0	0	0	235
14425	0	240	0	0	0	240
14426	0	0	0	248	0	248
14427	251	1	0	0	0	252
14428	0	0	252	1	0	253
14429	1	0	0	258	0	259
14430	1	0	255	2	0	258
14431	255	0	0	1	0	256
14432	0	0	270	1	0	271
14433	277	0	0	1	0	278
14434	296	0	1	2	0	299
14435	299	0	0	1	0	300
14436	299	0	0	1	0	300
14437	297	0	0	0	0	297
14438	1	0	1	295	0	297
14439	325	0	0	0	0	325
14440	0	1	0	326	0	327
14441	1	1	0	321	0	323
14442	1	0	0	324	0	325
14443	0	1	326	1	0	328
14444	0	0	0	318	0	318
14445	1	0	1	330	0	332
14446	0	0	328	1	0	329
14447	305	0	0	3	0	308
14448	0	0	1	331	0	332
14449	2	0	337	1	0	340
14450	1	0	334	1	0	336
14451	1	1	2	327	0	331
14452	1	0	353	1	0	355
14453	1	0	0	356	0	357
14454	1	0	1	361	0	363
14455	1	353	0	2	0	356
14456	0	363	0	1	0	364
14457	372	2	0	0	0	374
14458	1	1	0	374	0	376
14459	1	0	0	370	0	371
14460	0	0	0	391	0	391
14461	0	0	402	2	0	404
14462	0	0	1	393	0	394
14463	400	0	1	2	0	403
14464	2	0	413	1	0	416
14465	2	0	2	422	0	426
14466	0	0	0	428	0	428
14467	1	0	1	436	0	438
14468	0	459	1	1	0	461
14469	471	2	0	2	0	475
14470	478	2	1	0	0	481
14471	3	502	0	1	0	506
14472	1	2	0	550	0	553
14473	0	1	550	3	0	554
14474	0	1	537	1	0	539
14475	562	0	7	0	0	569
14476	6	0	2	587	0	595
14477	617	1	0	9	0	627
14478	8	1892	4	4	0	1908
14479	3	2018	2	1	0	2024
14480	1881	47	1	2	0	1931
14481	34	2010	4	0	0	2048
14482	15	42	1	1962	0	2020
14483	10	20	6	1769	0	1805
14484	4	1985	0	47	0	2036
14485	2059	50	0	24	0	2133
14486	44	45	1989	7	0	2085
14487	2056	46	36	4	0	2142
14488	62	25	2000	5	0	2092
14489	2031	25	46	14	0	2116
14490	49	30	1958	27	0	2064
14491	31	1938	52	29	0	2050
14492	23	66	22	2062	0	2173
14493	2051	55	19	42	0	2167
14494	71	32	1991	24	0	2118
14495	59	24	2023	15	0	2121
14496	42	27	73	2066	0	2208
14497	27	18	2057	64	0	2166
14498	33	16	64	2058	0	2171
14499	19	33	46	2096	0	2194
14500	32	20	2005	77	0	2134
14501	34	6	71	2112	0	2223
14502	2103	11	57	57	0	2228
14503	48	2070	67	38	0	2223
14504	2126	45	42	41	0	2254
14505	55	32	42	2125	0	2254
14506	2113	29	39	75	0	2256
14507	2146	8	16	83	0	2253
14508	79	10	37	1966	0	2092
14509	45	2037	45	63	0	2190
14510	2158	51	29	56	0	2294
14511	82	40	2054	36	0	2212
14512	43	31	2065	33	0	2172
14513	2142	9	61	51	0	2263
14514	68	8	37	2111	0	2224
14515	72	14	2018	57	0	2161
14516	52	14	48	2149	0	2263
14517	2126	33	31	69	0	2259
14518	2179	35	29	31	0	2274
14519	2159	7	30	28	0	2224
14520	92	2083	44	38	0	2257
14521	81	45	29	2141	0	2296
14522	62	28	17	2206	0	2313
14523	2152	19	30	106	0	2307
14524	72	2135	32	53	0	2292
14525	2193	47	21	45	0	2306
14526	106	25	38	2161	0	2330
14527	2191	32	29	65	0	2317
14528	106	48	1991	50	0	2195
14529	53	2129	49	67	0	2298
14530	55	79	38	1784	0	1956
14531	63	2146	17	95	0	2321
14532	74	81	11	2168	0	2334
14533	2210	50	13	89	0	2362
14534	107	40	2068	61	0	2276
14535	2110	45	62	47	0	2264
14536	106	2109	53	45	0	2313
14537	66	69	55	2163	0	2353
14538	66	55	33	2242	0	2396
14539	2192	54	38	83	0	2367
14540	100	44	2044	70	0	2258
14541	71	27	65	2193	0	2356
14542	74	33	52	2172	0	2331
14543	57	18	61	2159	0	2295
14544	54	45	44	2239	0	2382
14545	2176	38	44	130	0	2388
14546	2211	31	39	104	0	2385
14547	104	26	2164	95	0	2389
14548	85	20	2166	80	0	2351
14549	2181	16	101	84	0	2382
14550	2242	24	59	93	0	2418
14551	93	34	36	2189	0	2352
14552	73	20	17	2309	0	2419
14553	2204	27	24	121	0	2376
14554	128	2112	42	69	0	2351
14555	90	46	56	2215	0	2407
14556	73	18	60	2298	0	2449
14557	90	23	2117	114	0	2344
14558	69	22	51	2275	0	2417
14559	74	24	2096	123	0	2317
14560	69	27	76	2254	0	2426
14561	2229	17	72	93	0	2411
14562	89	31	70	2226	0	2416
14563	74	29	2056	113	0	2272
14564	69	2072	68	113	0	2322
14565	51	40	58	2246	0	2395
14566	41	27	2120	128	0	2316
14567	64	2130	67	108	0	2369
14568	77	56	38	2216	0	2387
14569	70	59	2096	109	0	2334
14570	2033	43	66	95	0	2237
14571	57	2056	61	114	0	2288
14572	54	1915	63	68	0	2100
14573	56	2075	39	79	0	2249
14574	54	89	47	2102	0	2292
14575	50	69	1990	98	0	2207
14576	75	2020	44	89	0	2228
14577	61	56	64	2125	0	2306
14578	687	0	5	4	0	696
14579	4	2	0	906	0	912
14580	1	1	1117	17	0	1136
14581	3	1162	10	4	0	1179
14582	1147	15	3	3	0	1168
14583	14	1167	4	3	0	1188
14584	6	20	1147	2	0	1175
14585	6	1153	12	1	0	1172
14586	4	21	3	1156	0	1184
14587	2	8	1144	14	0	1168
14588	0	1136	20	4	0	1160
14589	3	18	5	1143	0	1169
14590	3	10	6	1140	0	1159
14591	0	1136	5	18	0	1159
14592	0	20	4	1159	0	1183
14593	0	9	1142	26	0	1177
14594	0	7	1155	11	0	1173
14595	0	7	19	1143	0	1169
14596	1131	5	7	21	0	1164
14597	1126	2	8	11	0	1147
14598	15	5	5	1114	0	1139
14599	7	1116	2	20	0	1145
14600	7	15	5	1132	0	1159
14601	1120	3	7	19	0	1149
14602	19	5	3	1117	0	1144
14603	8	2	1	1125	0	1136
14604	1106	4	0	22	0	1132
14605	20	1082	1	14	0	1117
14606	6	20	0	1092	0	1118
14607	1090	6	1	25	0	1122
14608	23	7	1046	9	0	1085
14609	1053	2	15	11	0	1081
14610	21	3	4	1070	0	1098
14611	1073	0	5	21	0	1099
14612	1081	3	3	6	0	1093
14613	1065	4	4	10	0	1083
14614	29	1046	2	6	0	1083
14615	15	16	1027	5	0	1063
14616	13	1043	17	3	0	1076
14617	1049	20	5	5	0	1079
14618	21	1036	5	4	0	1066
14619	11	23	3	1028	0	1065
14620	994	5	4	19	0	1022
14621	22	991	1	4	0	1018
14622	7	22	975	5	0	1009
14623	6	10	19	983	0	1018
14624	7	11	971	21	0	1010
14625	4	969	20	17	0	1010
14626	2	23	6	975	0	1006
14627	4	3	7	998	0	1012
14628	1	10	4	994	0	1009
14629	2	5	5	971	0	983
14630	2	951	5	31	0	989
14631	942	19	6	18	0	985
14632	22	8	941	11	0	982
14633	3	9	17	958	0	987
14634	945	3	5	30	0	983
14635	22	5	934	16	0	977
14636	8	921	19	13	0	961
14637	9	27	7	907	0	950
14638	8	11	903	22	0	944
14639	10	908	24	7	0	949
14640	888	21	11	11	0	931
14641	23	906	8	5	0	942
14642	9	26	6	901	0	942
14643	6	10	6	922	0	944
14644	894	12	3	32	0	941
14645	23	888	6	14	0	931
14646	7	33	5	898	0	943
14647	873	12	5	24	0	914
14648	867	12	4	11	0	894
14649	27	843	2	15	0	887
14650	851	25	3	13	0	892
14651	864	8	3	7	0	882
14652	30	13	1	836	0	880
14653	11	9	825	29	0	874
14654	13	7	22	826	0	868
14655	10	7	6	846	0	869
14656	8	5	811	35	0	859
14657	8	814	23	15	0	860
14658	8	22	9	820	0	859
14659	6	6	7	843	0	862
14660	2	5	9	846	0	862
14661	3	4	11	825	0	843
14662	5	801	3	39	0	848
14663	805	21	7	17	0	850
14664	806	11	4	14	0	835
14665	781	9	1	14	0	805
14666	29	753	0	16	0	798
14667	15	21	0	756	0	792
14668	11	8	734	29	0	782
14669	8	15	18	743	0	784
14670	13	756	5	27	0	801
14671	746	24	5	8	0	783
14672	762	8	6	10	0	786
14673	740	12	3	5	0	760
14674	27	728	3	12	0	770
14675	13	710	7	7	0	737
14676	13	719	5	8	0	745
14677	10	25	685	7	0	727
14678	13	18	618	6	0	655
14679	13	92	22	292	0	419
14680	142	9	13	8	0	172
14681	138	0	0	1	0	139
14682	5	0	0	136	0	141
14683	1	0	1	135	0	137
14684	0	2	1	136	0	139
14685	0	0	0	138	0	138
14686	133	1	1	4	0	139
14687	144	1	0	0	0	145
14688	6	141	0	0	0	147
14689	145	5	0	0	0	150
14690	149	0	0	1	0	150
14691	147	0	0	2	0	149
14692	5	1	139	0	0	145
14693	143	1	3	1	0	148
14694	4	141	2	2	0	149
14695	1	4	1	151	0	157
14696	1	1	0	151	0	153
14697	1	148	1	5	0	155
14698	1	4	0	153	0	158
14699	154	0	0	6	0	160
14700	4	0	0	154	0	158
14701	0	1	145	5	0	151
14702	146	0	4	1	0	151
14703	6	152	0	1	0	159
14704	1	5	1	155	0	162
14705	1	2	0	156	0	159
14706	1	0	0	156	0	157
14707	2	0	152	5	0	159
14708	0	150	4	2	0	156
14709	1	5	0	153	0	159
14710	1	2	148	4	0	155
14711	2	0	4	144	0	150
14712	0	0	145	5	0	150
14713	1	6	4	139	0	150
14714	0	149	0	5	0	154
14715	1	5	0	143	0	149
14716	140	0	2	5	0	147
14717	147	0	2	0	0	149
14718	5	1	143	1	0	150
14719	0	0	138	0	0	138
14720	0	0	147	0	0	147
14721	0	0	1	148	0	149
14722	0	0	0	151	0	151
14723	0	0	0	156	0	156
14724	0	157	0	1	0	158
14725	0	1	0	157	0	158
14726	0	0	0	158	0	158
14727	0	0	0	162	0	162
14728	162	0	0	1	0	163
14729	163	0	0	0	0	163
14730	1	0	163	0	0	164
14731	0	0	165	0	0	165
14732	166	0	1	0	0	167
14733	167	0	0	0	0	167
14734	1	0	174	0	0	175
14735	0	0	172	0	0	172
14736	166	0	1	0	0	167
14737	168	0	0	0	0	168
14738	1	0	167	0	0	168
14739	0	0	1	168	0	169
14740	0	0	0	168	0	168
14741	0	176	0	1	0	177
14742	0	1	0	177	0	178
14743	0	0	185	1	0	186
14744	0	0	1	184	0	185
14745	0	0	0	186	0	186
14746	0	0	185	1	0	186
14747	182	0	2	0	0	184
14748	186	0	0	1	0	187
14749	2	0	0	184	0	186
14750	0	0	0	186	0	186
14751	183	0	0	2	0	185
14752	186	0	0	0	0	186
14753	180	0	0	1	0	181
14754	181	0	0	0	0	181
14755	3	173	0	0	0	176
14756	172	2	1	0	0	175
14757	2	170	1	0	0	173
14758	1	1	0	168	0	170
14759	1	0	0	163	0	164
14760	0	156	1	2	0	159
14761	0	2	1	159	0	162
14762	1	0	0	160	0	161
14763	1	162	0	2	0	165
14764	0	1	1	160	0	162
14765	0	0	0	165	0	165
14766	0	0	0	165	0	165
14767	0	1	157	2	0	160
14768	0	152	2	1	0	155
14769	0	1	1	149	0	151
14770	0	154	0	2	0	156
14771	152	2	0	1	0	155
14772	2	0	154	0	0	156
14773	1	1	153	0	0	155
14774	143	2	2	0	0	147
14775	3	1	1	134	0	139
14776	0	0	134	3	0	137
14777	1	0	129	0	0	130
14778	3	0	2	125	0	130
14779	125	2	0	2	0	129
14780	123	0	1	0	0	124
14781	2	1	1	122	0	126
14782	2	0	120	1	0	123
14783	1	121	2	0	0	124
14784	0	2	1	123	0	126
14785	0	0	121	1	0	122
14786	0	123	2	1	0	126
14787	0	3	0	116	0	119
14788	115	0	0	3	0	118
14789	2	1	1	112	0	116
14790	0	111	0	2	0	113
14791	112	1	0	2	0	115
14792	2	0	111	1	0	114
14793	1	110	3	0	0	114
14794	1	2	107	0	0	110
14795	103	0	2	1	0	106
14796	2	1	0	104	0	107
14797	2	0	0	104	0	106
14798	110	0	1	2	0	113
14799	4	0	1	104	0	109
14800	2	0	102	2	0	106
14801	98	1	3	1	0	103
14802	4	102	1	0	0	107
14803	1	1	1	98	0	101
14804	97	0	1	4	0	102
14805	3	96	1	1	0	101
14806	2	2	0	99	0	103
14807	102	0	0	3	0	105
14808	2	0	2	102	0	106
14809	0	98	0	2	0	100
14810	0	1	97	3	0	101
14811	0	0	3	102	0	105
14812	0	1	0	100	0	101
14813	96	0	2	3	0	101
14814	3	1	0	101	0	105
14815	100	0	0	5	0	105
14816	102	1	1	0	0	104
14817	4	0	0	102	0	106
14818	1	104	2	2	0	109
14819	0	3	1	105	0	109
14820	97	0	1	2	0	100
14821	5	95	0	1	0	101
14822	1	104	2	0	0	107
14823	108	2	1	1	0	112
14824	109	0	0	1	0	110
14825	3	107	0	1	0	111
14826	110	2	1	0	0	113
14827	104	1	1	1	0	107
14828	2	0	0	102	0	104
14829	0	0	115	2	0	117
14830	0	0	2	117	0	119
14831	0	0	114	2	0	116
14832	0	0	2	116	0	118
14833	0	0	116	2	0	118
14834	115	0	1	0	0	116
14835	1	0	0	113	0	114
14836	117	0	0	1	0	118
14837	1	0	0	116	0	117
14838	0	131	0	2	0	133
14839	130	1	0	0	0	131
14840	1	0	131	0	0	132
14841	121	0	1	0	0	122
14842	1	124	0	0	0	125
14843	120	1	0	0	0	121
14844	120	0	0	0	0	120
14845	1	120	0	0	0	121
14846	0	0	0	123	0	123
14847	125	0	0	0	0	125
14848	0	123	0	0	0	123
14849	0	0	0	124	0	124
14850	124	0	0	1	0	125
14851	0	0	0	126	0	126
14852	0	0	0	127	0	127
14853	0	0	0	127	0	127
14854	0	0	125	0	0	125
14855	0	0	0	127	0	127
14856	129	0	0	0	0	129
14857	0	0	136	0	0	136
14858	0	0	0	134	0	134
14859	0	0	0	133	0	133
14860	0	0	133	0	0	133
14861	137	0	0	0	0	137
14862	140	0	0	0	0	140
14863	0	0	141	0	0	141
14864	0	0	0	140	0	140
14865	0	0	0	140	0	140
14866	0	0	142	0	0	142
14867	0	0	0	144	0	144
14868	1	0	0	145	0	146
14869	0	0	146	0	0	146
14870	147	0	1	0	0	148
14871	1	0	0	152	0	153
14872	149	0	0	1	0	150
14873	150	0	0	0	0	150
14874	1	0	153	0	0	154
14875	0	0	1	148	0	149
14876	152	0	0	1	0	153
14877	1	153	0	0	0	154
14878	1	1	0	154	0	156
14879	1	0	0	155	0	156
14880	0	0	1	155	0	156
14881	0	0	156	4	0	160
14882	155	0	1	0	0	156
14883	1	1	0	158	0	160
14884	0	0	0	157	0	157
14885	0	0	159	2	0	161
14886	0	0	1	158	0	159
14887	0	0	1	161	0	162
14888	160	0	0	1	0	161
14889	1	160	0	1	0	162
14890	0	1	163	1	0	165
14891	166	0	2	0	0	168
14892	1	0	0	168	0	169
14893	0	0	172	2	0	174
14894	1	0	178	0	0	179
14895	0	1	1	181	0	183
14896	0	0	185	1	0	186
14897	1	0	201	0	0	202
14898	0	190	2	1	0	193
14899	0	1	1	201	0	203
14900	2	0	202	1	0	205
14901	0	0	1	201	0	202
14902	209	0	1	1	0	211
14903	1	0	1	206	0	208
14904	0	1	0	209	0	210
14905	204	0	0	3	0	207
14906	209	0	1	0	0	210
14907	1	0	0	208	0	209
14908	1	0	207	1	0	209
14909	0	204	2	1	0	207
14910	0	2	0	210	0	212
14911	211	0	0	2	0	213
14912	212	0	0	0	0	212
14913	2	207	0	2	0	211
14914	0	207	1	0	0	208
14915	208	2	0	0	0	210
14916	209	0	0	1	0	210
14917	3	1	1702	0	0	1706
14918	1	3	2	1723	0	1729
14919	0	1760	0	3	0	1763
14920	1774	3	0	0	0	1777
14921	3	0	0	1778	0	1781
14922	1	1761	0	2	0	1764
14923	0	3	1764	1	0	1768
14924	0	1	2	1741	0	1744
14925	1	1750	1	3	0	1755
14926	1766	2	0	0	0	1768
14927	1744	0	0	2	0	1746
14928	2	1750	0	2	0	1754
14929	1743	3	1	0	0	1747
14930	1745	0	0	1	0	1746
14931	1	1740	0	1	0	1742
14932	1	1764	1	0	0	1766
14933	6	2	1	1768	0	1777
14934	1760	1	0	4	0	1765
14935	3	2	1753	0	0	1758
14936	1724	0	2	0	0	1726
14937	3	1757	0	1	0	1761
14938	1779	5	0	0	0	1784
14939	1783	0	1	1	0	1785
14940	1782	0	0	0	0	1782
14941	2	2	1	1773	0	1778
14942	2	1761	1	2	0	1766
14943	1774	3	0	1	0	1778
14944	5	1	1763	1	0	1770
14945	1	1731	3	1	0	1736
14946	2	2	1	1788	0	1793
14947	1	1	1756	3	0	1761
14948	1	1	1737	0	0	1739
14949	3	1	2	1736	0	1742
14950	2	1	2	1779	0	1784
14951	1	1	0	1796	0	1798
14952	1	1	0	1782	0	1784
14953	3	1768	1	3	0	1775
14954	0	1791	2	1	0	1794
14955	1805	3	1	1	0	1810
14956	4	0	0	1798	0	1802
14957	0	0	1	1802	0	1803
14958	0	1	2	1804	0	1807
14959	1803	1	1	4	0	1809
14960	1799	1	1	1	0	1802
14961	3	0	2	1800	0	1805
14962	1800	0	0	5	0	1805
14963	1785	2	0	2	0	1789
14964	1793	1	0	2	0	1796
14965	4	0	1	1796	0	1801
14966	1	1	1768	4	0	1774
14967	1	1	1660	2	0	1664
14968	2	0	1697	2	0	1701
14969	2	1	1763	2	0	1768
14970	3	2	1	1761	0	1767
14971	1777	0	2	4	0	1783
14972	1735	0	0	1	0	1736
14973	3	0	1765	0	0	1768
14974	1	2	1740	3	0	1746
14975	1	1775	2	3	0	1781
14976	2	1	1	1828	0	1832
14977	1829	0	1	1	0	1831
14978	1	1	1811	6	0	1819
14979	1787	0	2	0	0	1789
14980	1	1815	1	1	0	1818
14981	1	1	1	1847	0	1850
14982	1	0	1	1863	0	1865
14983	0	0	1	1848	0	1849
14984	1864	0	1	3	0	1868
14985	3	1	0	1861	0	1865
14986	0	0	1	1863	0	1864
14987	1872	0	1	3	0	1876
14988	4	1	1	1861	0	1867
14989	1	0	1884	4	0	1889
14990	1842	1	4	0	0	1847
14991	3	0	1	1891	0	1895
14992	1	0	0	1889	0	1890
14993	1	1850	0	6	0	1857
14994	1888	3	0	1	0	1892
14995	1893	0	0	2	0	1895
14996	2	0	0	1878	0	1880
14997	1	0	1885	3	0	1889
14998	1749	0	4	2	0	1755
14999	5	0	1900	1	0	1906
15000	2	0	4	1896	0	1902
15001	0	0	1	1929	0	1930
15002	1922	0	0	6	0	1928
15003	6	1	0	1954	0	1961
15004	1	0	1957	6	0	1964
15005	1902	0	5	1	0	1908
15006	5	1	1979	6	0	1991
15007	3	2	1927	0	0	1932
15008	1990	1	4	0	0	1995
15009	4	0	2	2056	0	2062
15010	0	2037	2	4	0	2043
15011	2077	4	0	1	0	2082
15012	2040	1	1	1	0	2043
15013	4	0	2046	2	0	2052
15014	2043	0	4	1	0	2048
15015	6	0	0	2094	0	2100
15016	0	0	2088	5	0	2093
15017	2	561	5	0	0	568
15018	561	4	1	1	0	567
15019	4	587	1	0	0	592
15020	0	8	0	582	0	590
15021	1	0	0	593	0	594
15022	0	1	0	600	0	601
15023	1	0	0	597	0	598
15024	0	594	0	4	0	598
15025	0	3	592	1	0	596
15026	1	598	3	1	0	603
15027	615	4	0	0	0	619
15028	4	0	1	607	0	612
15029	609	1	0	4	0	614
15030	5	0	0	613	0	618
15031	661	0	0	5	0	666
15032	5	651	0	0	0	656
15033	670	4	0	1	0	675
15034	684	0	0	0	0	684
15035	667	1	0	0	0	668
15036	682	0	0	0	0	682
15037	5	679	0	0	0	684
15038	2	3	678	0	0	683
15039	1	2	4	687	0	694
15040	682	0	0	5	0	687
15041	694	0	1	0	0	695
15042	4	0	0	708	0	712
15043	1	0	722	5	0	728
15044	2	1	2	715	0	720
15045	0	720	1	6	0	727
15046	729	5	1	3	0	738
15047	5	0	0	714	0	719
15048	0	709	2	6	0	717
15049	2	738	1	1	0	742
15050	1	735	0	4	0	740
15051	2	4	0	757	0	763
15052	753	2	2	5	0	762
15053	5	759	1	1	0	766
15054	4	4	0	763	0	771
15055	755	1	0	5	0	761
15056	6	0	0	757	0	763
15057	755	0	1	6	0	762
15058	766	0	1	0	0	767
15059	5	825	1	2	0	833
15060	2	5	1	817	0	825
15061	1	826	2	4	0	833
15062	838	5	0	2	0	845
15063	837	0	2	1	0	840
15064	848	1	1	1	0	851
15065	6	1	0	845	0	852
15066	3	0	832	4	0	839
15067	831	0	5	3	0	839
15068	846	2	1	1	0	850
15069	6	1	1	842	0	850
15070	1	851	1	4	0	857
15071	2	5	1	869	0	877
15072	2	1	0	880	0	883
15073	883	3	1	5	0	892
15074	852	1	0	4	0	857
15075	7	0	836	2	0	845
15076	2	1	5	829	0	837
15077	831	1	1	5	0	838
15078	8	0	1	846	0	855
15079	0	1	842	7	0	850
15080	3	815	5	1	0	824
15081	1	844	0	1	0	846
15082	925	4	1	0	0	930
15083	3	1	0	984	0	988
15084	1	1	0	1149	0	1151
15085	1147	0	0	20	0	1167
15086	19	0	1134	3	0	1156
15087	5	1	16	1153	0	1175
15088	4	2	1159	23	0	1188
15089	3	1139	21	5	0	1168
15090	1200	20	5	2	0	1227
15091	1241	4	3	4	0	1252
15092	1243	3	4	3	0	1253
15093	24	4	1217	1	0	1246
15094	1785	1	17	1	0	1804
15095	1788	1	4	1	0	1794
15096	27	0	3	1778	0	1808
15097	1717	0	6	20	0	1743
15098	27	0	1755	6	0	1788
15099	1734	0	21	4	0	1759
15100	26	11	1625	3	0	1665
15101	6	1802	18	3	0	1829
15102	7	47	7	1353	0	1414
15103	3	1749	5	17	0	1774
15104	4	29	1646	3	0	1682
15105	3	1781	19	1	0	1804
15106	1578	26	4	4	0	1612
15107	22	1669	3	6	0	1700
15108	7	1592	6	0	0	1605
15109	6	24	1639	0	0	1669
15110	4	6	20	1665	0	1695
15111	1581	4	5	21	0	1611
15112	21	10	1641	4	0	1676
15113	16	1604	19	6	0	1645
15114	17	20	6	1587	0	1630
15115	11	4	1705	31	0	1751
15116	22	4	1642	5	0	1673
15117	13	5	32	1717	0	1767
15118	17	7	1607	33	0	1664
15119	13	7	31	1387	0	1438
15120	7	1681	17	23	0	1728
15121	15	19	11	1532	0	1577
15122	7	1641	15	24	0	1687
15123	11	31	13	1669	0	1724
15124	1606	22	7	24	0	1659
15125	31	18	2	1602	0	1653
15126	10	1595	15	26	0	1646
15127	7	40	7	1682	0	1736
15128	20	9	1588	28	0	1645
15129	8	14	25	1691	0	1738
15130	1675	17	9	23	0	1724
15131	27	10	1522	10	0	1569
15132	11	16	29	1619	0	1675
15133	1543	8	16	30	0	1597
15134	38	1593	23	15	0	1669
15135	60	26	24	1555	0	1665
15136	1626	12	12	55	0	1705
15137	48	14	21	1636	0	1719
15138	58	8	2448	39	0	2553
15139	2421	17	56	26	0	2520
15140	66	2507	33	36	0	2642
15141	42	2496	36	22	0	2596
15142	2649	68	35	24	0	2776
15143	2598	28	15	38	0	2679
15144	49	50	37	2532	0	2668
15145	2620	56	47	39	0	2762
15146	61	54	2499	32	0	2646
15147	2489	38	53	22	0	2602
15148	36	2526	40	30	0	2632
15149	2599	83	30	27	0	2739
15150	65	30	2506	25	0	2626
15151	48	49	43	2611	0	2751
15152	60	50	33	2587	0	2730
15153	49	41	68	2304	0	2462
15154	32	2582	39	82	0	2735
15155	2689	55	32	54	0	2830
15156	60	32	100	2315	0	2507
15157	32	2349	68	68	0	2517
15158	2725	51	35	75	0	2886
15159	2613	49	78	46	0	2786
15160	2630	59	73	51	0	2813
15161	2624	72	29	69	0	2794
15162	2562	45	62	51	0	2720
15163	59	81	51	2605	0	2796
15164	67	72	29	2626	0	2794
15165	2607	44	52	88	0	2791
15166	56	59	44	2645	0	2804
15167	52	91	33	2617	0	2793
15168	58	37	2418	109	0	2622
15169	2525	54	87	65	0	2731
15170	2593	67	37	105	0	2802
15171	2612	56	52	69	0	2789
15172	51	41	90	2324	0	2506
15173	34	2482	38	124	0	2678
15174	2650	67	47	59	0	2823
15175	2511	53	58	82	0	2704
15176	57	60	41	2744	0	2902
15177	2694	41	32	102	0	2869
15178	75	70	2256	86	0	2487
15179	49	2646	90	94	0	2879
15180	118	2709	32	68	0	2927
15181	79	103	2655	72	0	2909
15182	50	2602	72	73	0	2797
15183	107	2535	24	89	0	2755
15184	2428	48	39	65	0	2580
15185	52	2331	41	116	0	2540
15186	107	41	29	2422	0	2599
15187	2462	29	61	60	0	2612
15188	78	50	2324	81	0	2533
15189	2363	57	27	66	0	2513
15190	106	38	2325	43	0	2512
15191	71	28	2220	93	0	2412
15192	2256	49	34	85	0	2424
15193	104	17	2263	109	0	2493
15194	7	1619	9	4	0	1639
15195	5	19	6	1638	0	1668
15196	1658	2	1	6	0	1667
15197	13	1564	0	4	0	1581
15198	2	7	1	1635	0	1645
15199	6	2	1622	8	0	1638
15200	6	3	8	1586	0	1603
15201	1603	3	3	8	0	1617
15202	8	7	1574	8	0	1597
15203	9	1	6	1556	0	1572
15204	1633	3	3	7	0	1646
15205	1602	1	1	7	0	1611
15206	13	0	1	1599	0	1613
15207	5	0	3	1591	0	1599
15208	6	1	1608	8	0	1623
15209	3	5	1505	4	0	1517
15210	1542	0	9	1	0	1552
15211	1605	0	5	1	0	1611
15212	9	1554	2	1	0	1566
15213	1606	6	0	1	0	1613
15214	1599	2	1	0	0	1602
15215	11	1	1618	1	0	1631
15216	3	1542	7	1	0	1553
15217	1650	6	3	0	0	1659
15218	1633	2	1	1	0	1637
15219	1660	2	0	0	0	1662
15220	9	2	0	1560	0	1571
15221	3	0	0	1635	0	1638
15222	1	1589	3	7	0	1600
15223	1	6	0	1654	0	1661
15224	1654	2	1	7	0	1664
15225	6	4	0	1625	0	1635
15226	4	1	1638	8	0	1651
15227	2	0	1566	4	0	1572
15228	0	1	8	1574	0	1583
15229	1	2	1625	6	0	1634
15230	2	1	1547	3	0	1553
15231	1	4	12	1441	0	1458
15232	0	2	4	1560	0	1566
15233	3	1	1583	8	0	1595
15234	3	2	1543	3	0	1551
15235	3	1441	15	3	0	1462
15236	1593	7	4	1	0	1605
15237	8	1530	4	0	0	1542
15238	794	7	2	0	0	803
15239	796	2	1	0	0	799
15240	8	809	1	3	0	821
15241	807	6	1	2	0	816
15242	9	3	0	808	0	820
15243	2	2	815	7	0	826
15244	1	1	6	800	0	808
15245	0	0	3	815	0	818
15246	793	0	2	9	0	804
15247	799	1	1	3	0	804
15248	805	0	1	3	0	809
15249	799	1	2	2	0	804
15250	754	0	0	1	0	755
15251	11	747	1	1	0	760
15252	3	6	1	761	0	771
15253	1	2	752	8	0	763
15254	1	1	8	761	0	771
15255	1	3	3	762	0	769
15256	1	0	1	778	0	780
15257	792	1	0	10	0	803
15258	8	1	1	1477	0	1487
15259	1496	0	1	60	0	1557
15260	63	2	1512	23	0	1600
15261	25	0	56	1687	0	1768
15262	26	4	1679	73	0	1782
15263	1692	0	84	30	0	1806
15264	69	1	32	1706	0	1808
15265	29	2	1716	74	0	1821
15266	29	1	71	1768	0	1869
15267	1768	0	30	92	0	1890
15268	72	2	1711	33	0	1818
15269	1748	1	73	40	0	1862
15270	1814	0	34	13	0	1861
15271	1810	1	27	11	0	1849
15272	1806	2	12	10	0	1830
15273	120	1679	14	8	0	1821
15274	62	1708	10	15	0	1795
15275	51	1753	5	11	0	1820
15276	27	112	10	1514	0	1663
15277	21	1592	12	69	0	1694
15278	1540	91	12	35	0	1678
15279	75	1520	18	39	0	1652
15280	40	1581	19	16	0	1656
15281	35	87	16	1550	0	1688
15282	21	54	13	1621	0	1709
15283	1541	35	13	96	0	1685
15284	75	14	15	1606	0	1710
15285	43	15	1499	108	0	1665
15286	57	10	1512	45	0	1624
15287	35	13	1542	40	0	1630
15288	36	8	105	1455	0	1604
15289	33	13	59	1585	0	1690
15290	31	13	1513	95	0	1652
15291	31	18	1538	52	0	1639
15292	14	22	1590	47	0	1673
15293	1559	23	113	23	0	1718
15294	70	24	67	1580	0	1741
15295	39	25	46	1642	0	1752
15296	1613	21	15	102	0	1751
15297	74	22	16	1608	0	1720
15298	44	1536	16	110	0	1706
15299	44	1630	11	54	0	1739
15300	24	86	15	1654	0	1779
15301	1605	46	12	95	0	1758
15302	1632	34	20	60	0	1746
15303	1672	15	26	56	0	1769
15304	128	12	25	1599	0	1764
15305	66	10	1553	99	0	1728
15306	46	10	84	1611	0	1751
15307	27	8	1572	112	0	1719
15308	1539	4	112	69	0	1724
15309	82	4	64	1585	0	1735
15310	1560	7	58	90	0	1715
15311	108	11	1521	64	0	1704
15312	1532	4	82	62	0	1680
15313	112	4	1538	48	0	1702
15314	66	1475	93	40	0	1674
15315	63	1563	50	24	0	1700
15316	1516	92	36	31	0	1675
15317	96	55	20	1514	0	1685
15318	66	48	1472	81	0	1667
15319	68	1491	69	44	0	1672
15320	49	1578	33	47	0	1707
15321	34	91	43	1536	0	1704
15322	1533	63	30	90	0	1716
15323	1561	46	29	61	0	1697
15324	115	1543	29	54	0	1741
15325	1595	79	18	43	0	1735
15326	110	38	32	1559	0	1739
15327	66	52	1509	88	0	1715
15328	73	1527	79	65	0	1744
15329	49	71	49	1578	0	1747
15330	45	34	58	1619	0	1756
15331	1571	42	35	102	0	1750
15332	90	27	1514	66	0	1697
15333	1568	23	77	57	0	1725
15334	1620	20	41	44	0	1725
15335	108	26	50	1550	0	1734
15336	69	37	28	1615	0	1749
15337	1564	24	33	107	0	1728
15338	93	26	25	1593	0	1737
15339	69	29	1471	112	0	1681
15340	73	27	1482	65	0	1647
15341	47	1463	89	66	0	1665
15342	46	1552	53	44	0	1695
15343	39	103	44	1414	0	1600
15344	26	1528	24	92	0	1670
15345	1479	112	22	54	0	1667
15346	79	1527	18	61	0	1685
15347	45	105	22	1521	0	1693
15348	51	42	31	1572	0	1696
15349	47	47	1452	111	0	1657
15350	35	26	77	1540	0	1678
15351	34	14	47	1565	0	1660
15352	31	1477	50	123	0	1681
15353	33	62	28	1533	0	1656
15354	26	32	33	1591	0	1682
15355	42	36	1423	124	0	1625
15356	19	1420	79	101	0	1619
15357	34	753	58	773	0	1618
15358	2	739	4	9	0	754
15359	6	11	694	6	0	717
15360	2	659	9	7	0	677
15361	502	8	14	4	0	528
15362	480	2	0	1	0	483
15363	478	0	1	0	0	479
15364	2	481	0	0	0	483
15365	479	2	0	0	0	481
15366	3	1	0	476	0	480
15367	462	0	0	2	0	464
15368	2	459	0	2	0	463
15369	468	2	0	0	0	470
15370	469	1	0	1	0	471
15371	4	479	0	0	0	483
15372	2	4	470	3	0	479
15373	7	1	2	512	0	522
15374	2	0	567	5	0	574
15375	0	1	6	598	0	605
15376	0	0	3	626	0	629
15377	0	4	627	12	0	643
15378	0	0	10	644	0	654
15379	647	0	3	10	0	660
15380	9	0	642	4	0	655
15381	4	639	9	0	0	652
15382	0	9	3	637	0	649
15383	1	3	0	659	0	663
15384	0	1	639	11	0	651
15385	0	2	8	629	0	639
15386	1	639	2	9	0	651
15387	620	9	1	4	0	634
15388	6	629	1	0	0	636
15389	605	9	1	2	0	617
15390	6	603	0	2	0	611
15391	4	606	2	0	0	612
15392	0	10	562	2	0	574
15393	4	10	8	565	0	587
15394	0	1	5	562	0	568
15395	0	2	0	575	0	577
15396	2	579	2	12	0	595
15397	0	10	2	593	0	605
15398	596	6	0	13	0	615
15399	10	0	2	601	0	613
15400	594	1	1	13	0	609
15401	11	1	594	7	0	613
15402	595	0	9	1	0	605
15403	10	3	5	594	0	612
15404	7	2	1	619	0	629
15405	631	1	0	20	0	652
15406	15	2	627	7	0	651
15407	5	632	12	0	0	649
15408	0	13	6	638	0	657
15409	636	4	1	14	0	655
15410	641	2	0	6	0	649
15411	19	1	2	623	0	645
15412	6	2	620	15	0	643
15413	594	1	13	7	0	615
15414	13	1	600	2	0	616
15415	8	0	12	601	0	621
15416	2	2	602	16	0	622
15417	4	1	14	593	0	612
15418	1	4	576	14	0	595
15419	2	568	14	8	0	592
15420	4	15	2	534	0	555
15421	1	567	4	15	0	587
15422	578	12	1	7	0	598
15423	580	8	4	3	0	595
15424	21	2	560	2	0	585
15425	6	1	14	559	0	580
15426	565	0	8	13	0	586
15427	16	2	1	556	0	575
15428	6	2	1	566	0	575
15429	4	3	545	18	0	570
15430	536	0	14	9	0	559
15431	18	3	551	4	0	576
15432	7	0	16	548	0	571
15433	4	4	545	15	0	568
15434	537	0	16	14	0	567
15435	548	0	8	6	0	562
15436	537	3	7	1	0	548
15437	19	1	1	530	0	551
15438	5	5	525	13	0	548
15439	6	1	519	9	0	535
15440	2	5	20	482	0	509
15441	2	505	8	14	0	529
15442	490	16	4	6	0	516
15443	17	8	1	492	0	518
15444	6	2	484	16	0	508
15445	4	2	13	494	0	513
15446	4	2	503	15	0	524
15447	4	1	11	503	0	519
15448	3	3	517	14	0	537
15449	4	1	506	13	0	524
15450	6	504	19	5	0	534
15451	2	11	516	6	0	535
15452	7	6	512	4	0	529
15453	3	0	23	453	0	479
15454	5	1	5	468	0	479
15455	2	488	6	16	0	512
15456	492	12	4	6	0	514
15457	16	486	3	2	0	507
15458	10	15	6	480	0	511
15459	487	9	3	14	0	513
15460	15	0	2	490	0	507
15461	490	2	5	15	0	512
15462	18	1	4	499	0	522
15463	9	2	502	17	0	530
15464	3	1	18	512	0	534
15465	7	1	9	518	0	535
15466	497	0	10	19	0	526
15467	509	3	2	14	0	528
15468	502	0	14	2	0	518
15469	18	483	5	9	0	515
15470	6	482	9	3	0	500
15471	472	19	2	5	0	498
15472	15	6	483	4	0	508
15473	8	4	458	3	0	473
15474	3	18	24	376	0	421
15475	4	1	386	8	0	399
15476	2	1	365	3	0	371
15477	327	5	14	7	0	353
15478	335	0	6	2	0	343
15479	10	334	0	8	0	352
15480	6	357	3	3	0	369
15481	0	11	3	305	0	319
15482	6	353	2	6	0	367
15483	366	8	3	2	0	379
15484	10	3	2	352	0	367
15485	7	359	5	6	0	377
15486	369	8	3	5	0	385
15487	11	6	1104	3	0	1124
15488	9	1	1102	2	0	1114
15489	1094	1	11	5	0	1111
15490	10	1	1133	4	0	1148
15491	1085	2	11	3	0	1101
15492	9	1	5	1140	0	1155
15493	8	6	1140	6	0	1160
15494	6	1109	7	6	0	1128
15495	3	1110	7	4	0	1124
15496	1125	10	4	1	0	1140
15497	8	1082	0	6	0	1096
15498	1100	4	6	2	0	1112
15499	1083	2	4	3	0	1092
15500	7	1067	5	2	0	1081
15501	2	4	5	1096	0	1107
15502	2	4	1077	5	0	1088
15503	2	1080	10	2	0	1094
15504	2	17	5	1091	0	1115
15505	1	1	0	1133	0	1135
15506	1124	0	0	4	0	1128
15507	2	0	1	1113	0	1116
15508	3	0	1118	3	0	1124
15509	0	1065	2	2	0	1069
15510	0	6	2	1125	0	1133
15511	1128	2	1	1	0	1132
15512	1113	0	3	2	0	1118
15513	5	1	0	1122	0	1128
15514	1123	0	1	3	0	1127
15515	4	0	1128	3	0	1135
15516	2	1	3	1105	0	1111
15517	2	0	1130	5	0	1137
15518	1	1	3	1763	0	1768
15519	4	0	2	1789	0	1795
15520	0	1	0	1818	0	1819
15521	0	0	1	1830	0	1831
15522	2	0	0	1830	0	1832
15523	1789	1	0	65	0	1855
15524	1832	0	2	12	0	1846
15525	53	1752	1	9	0	1815
15526	1784	52	1	4	0	1841
15527	59	3	0	1793	0	1855
15528	8	7	0	1799	0	1814
15529	6	0	1	1796	0	1803
15530	5	1	1747	66	0	1819
15531	7	1	48	1682	0	1738
15532	3	1703	7	57	0	1770
15533	1782	54	9	6	0	1851
15534	1780	3	0	10	0	1793
15535	59	11	1687	6	0	1763
15536	12	1692	52	9	0	1765
15537	8	49	5	1766	0	1828
15538	3	6	1746	71	0	1826
15539	4	8	48	1696	0	1756
15540	6	1722	5	75	0	1808
15541	1685	56	7	26	0	1774
15542	65	1711	1	21	0	1798
15543	22	58	1703	13	0	1796
15544	24	13	1721	8	0	1766
15545	17	1639	59	7	0	1722
15546	8	1743	14	12	0	1777
15547	1706	55	7	20	0	1788
15548	1757	13	2	20	0	1792
15549	62	10	10	1701	0	1783
15550	14	9	2945	83	0	3051
15551	11	18	57	2649	0	2735
15552	10	11	8	3099	0	3128
15553	3046	8	10	80	0	3144
15554	2821	5	13	25	0	2864
15555	76	8	6	3021	0	3111
15556	28	15	3030	65	0	3138
15557	20	2843	61	16	0	2940
15558	3080	59	10	32	0	3181
15559	63	2969	17	26	0	3075
15560	15	69	5	3100	0	3189
15561	18	21	7	3088	0	3134
15562	10	15	15	3014	0	3054
15563	9	13	19	3071	0	3112
15564	3090	16	14	75	0	3195
15565	66	23	8	3068	0	3165
15566	30	2986	10	61	0	3087
15567	29	68	5	3110	0	3212
15568	3070	12	7	86	0	3175
15569	65	2960	15	26	0	3066
15570	12	51	14	3128	0	3205
15571	11	15	2989	88	0	3103
15572	2727	18	52	33	0	2830
15573	80	16	5	3012	0	3113
15574	31	7	3024	79	0	3141
15575	22	11	2893	21	0	2947
15576	8	15	68	2923	0	3014
15577	3028	22	28	70	0	3148
15578	4725	24	11	19	0	4779
15579	80	4503	2	30	0	4615
15580	4843	62	3	40	0	4948
15581	4666	9	15	49	0	4739
15582	4677	11	14	47	0	4749
15583	4730	7	14	48	0	4799
15584	84	7	8	4594	0	4693
15585	40	20	5	4672	0	4737
15586	41	17	4558	88	0	4704
15587	31	3661	55	39	0	3786
15588	22	3858	19	31	0	3930
15589	21	70	3895	25	0	4011
15590	3572	29	63	27	0	3691
15591	72	19	14	3953	0	4058
15592	4066	10	20	91	0	4187
15593	3905	12	16	33	0	3966
15594	74	11	3890	45	0	4020
15595	24	10	65	3731	0	3830
15596	4002	6	25	75	0	4108
15597	81	17	17	3872	0	3987
15598	27	27	3939	81	0	4074
15599	42	27	56	3782	0	3907
15600	33	3724	11	64	0	3832
15601	31	3870	16	26	0	3943
15602	33	60	3771	27	0	3891
15603	29	3657	65	25	0	3776
15604	3888	67	9	29	0	3993
15605	3811	12	32	29	0	3884
15606	64	18	23	3719	0	3824
15607	15	21	23	3709	0	3768
15608	21	24	19	3899	0	3963
15609	3941	13	13	78	0	4045
15610	74	3704	15	32	0	3825
15611	3867	59	10	25	0	3961
15612	3868	14	10	20	0	3912
15613	82	3683	15	27	0	3807
15614	3914	55	16	26	0	4011
15615	90	3613	16	33	0	3752
15616	3780	58	7	43	0	3888
15617	83	19	3614	34	0	3750
15618	2689	4	5	1	0	2699
15619	1	2884	1	0	0	2886
15620	0	1	2	3066	0	3069
15621	0	1	0	3043	0	3044
15622	0	1	1	2937	0	2939
15623	3120	0	0	2	0	3122
15624	1	1	0	3024	0	3026
15625	2	2	2908	1	0	2913
15626	2803	1	1	3	0	2808
15627	1	3	2931	0	0	2935
15628	0	0	2	2840	0	2842
15629	1	4	2940	1	0	2946
15630	0	0	0	2958	0	2958
15631	0	2914	5	1	0	2920
15632	0	0	1	3035	0	3036
15633	1	2859	5	0	0	2865
15634	1	1	0	3034	0	3036
15635	3049	0	1	0	0	3050
15636	0	1	1	2941	0	2943
15637	3028	0	1	2	0	3031
15638	4	9	2688	0	0	2701
15639	2735	2	2	0	0	2739
15640	2946	2	1	0	0	2949
15641	2818	0	1	1	0	2820
15642	2	1	2	2869	0	2874
15643	2991	0	0	0	0	2991
15644	1	6	2705	0	0	2712
15645	2668	1	0	2	0	2671
15646	1	0	2798	1	0	2800
15647	2677	0	4	1	0	2682
15648	0	0	0	2829	0	2829
15649	1	2	2836	0	0	2839
15650	0	0	1	1722	0	1723
15651	1	0	0	1738	0	1739
15652	0	1	1668	1	0	1670
15653	1449	0	1	1	0	1451
15654	1	1602	3	1	0	1607
15655	1779	0	1	0	0	1780
15656	0	1638	3	2	0	1643
15657	1729	0	1	0	0	1730
15658	0	0	1618	1	0	1619
15659	1524	2	5	0	0	1531
15660	0	1580	2	2	0	1584
15661	0	0	0	1665	0	1665
15662	0	2	0	1669	0	1671
15663	0	2	0	1647	0	1649
15664	0	1	1662	0	0	1663
15665	0	0	1	1583	0	1584
15666	0	1	1661	0	0	1662
15667	1556	0	0	0	0	1556
15668	1628	0	0	0	0	1628
15669	0	1	0	1634	0	1635
15670	0	0	1650	0	0	1650
15671	1385	2	2	3	0	1392
15672	0	0	1675	0	0	1675
15673	1	1	1	1547	0	1550
15674	0	0	1	1655	0	1656
15675	0	0	0	1681	0	1681
15676	0	1	0	1698	0	1699
15677	1667	0	0	0	0	1667
15678	0	188	0	1	0	189
15679	0	0	184	0	0	184
15680	0	185	0	0	0	185
15681	188	0	0	0	0	188
15682	0	0	0	186	0	186
15683	191	0	0	0	0	191
15684	0	0	0	188	0	188
15685	0	0	0	187	0	187
15686	0	0	0	190	0	190
15687	0	0	190	0	0	190
15688	0	186	0	0	0	186
15689	0	0	191	0	0	191
15690	0	0	0	193	0	193
15691	203	0	0	0	0	203
15692	201	0	0	0	0	201
15693	198	0	0	0	0	198
15694	0	201	0	0	0	201
15695	204	0	0	0	0	204
15696	0	0	0	205	0	205
15697	0	0	0	205	0	205
15698	0	0	0	205	0	205
15699	0	209	0	0	0	209
15700	0	0	0	205	0	205
15701	0	205	0	0	0	205
15702	206	0	0	0	0	206
15703	204	0	0	0	0	204
15704	0	0	0	205	0	205
15705	0	8	2373	0	0	2381
15706	2505	0	0	0	0	2505
15707	0	0	0	2731	0	2731
15708	0	1	2702	0	0	2703
15709	2290	0	7	2	0	2299
15710	0	0	0	2742	0	2742
15711	2773	1	0	0	0	2774
15712	0	2599	1	1	0	2601
15713	0	0	0	2730	0	2730
15714	0	2678	3	1	0	2682
15715	0	0	1	2786	0	2787
15716	0	2681	1	1	0	2683
15717	0	0	1	2790	0	2791
15718	1	0	2756	2	0	2759
15719	1776	8	10	8	0	1802
15720	0	2620	0	1	0	2621
15721	4	1	2624	0	0	2629
15722	2479	1	1	0	0	2481
15723	0	0	1	2700	0	2701
15724	0	0	2702	1	0	2703
15725	1	2588	2	5	0	2596
15726	0	0	0	2780	0	2780
15727	4	2	2695	1	0	2702
15728	1	0	0	2595	0	2596
15729	0	3	1	2682	0	2686
15730	1	0	2791	0	0	2792
15731	0	2	0	2638	0	2640
15732	3	0	2798	0	0	2801
15733	0	3	0	2653	0	2656
15734	2	1	2804	0	0	2807
15735	0	1	1	2651	0	2653
15736	0	1	0	2734	0	2735
15737	0	0	0	2777	0	2777
15738	0	2683	2	1	0	2686
15739	2838	1	0	0	0	2839
15740	2704	0	1	1	0	2706
15741	0	0	0	2748	0	2748
15742	2797	2	0	0	0	2799
15743	2	2	2710	1	0	2715
15744	1	2644	0	0	0	2645
15745	2849	1	0	0	0	2850
15746	1	2699	0	3	0	2703
15747	0	2	0	2811	0	2813
15748	0	0	0	2780	0	2780
15749	2813	0	0	0	0	2813
15750	0	1	0	2755	0	2756
15751	1	0	2758	1	0	2760
15752	0	2639	0	0	0	2639
15753	2717	0	0	0	0	2717
15754	1	0	0	2734	0	2735
15755	0	2712	3	1	0	2716
15756	2	0	1	2807	0	2810
15757	1	2698	0	2	0	2701
15758	2819	0	0	1	0	2820
15759	2641	0	2	0	0	2643
15760	1	0	2702	0	0	2703
15761	1	6	2491	1	0	2499
15762	0	0	0	2688	0	2688
15763	0	2617	1	1	0	2619
15764	0	0	0	2789	0	2789
15765	2773	0	0	0	0	2773
15766	1	2	2670	0	0	2673
15767	1	2	0	2519	0	2522
15768	1	1	2627	0	0	2629
15769	4	2	2353	0	0	2359
15770	0	2535	2	0	0	2537
15771	2	5	3	2650	0	2660
15772	2674	1	0	0	0	2675
15773	1	1	2641	1	0	2644
15774	2	2471	2	3	0	2478
15775	2648	0	1	0	0	2649
15776	0	1	0	2637	0	2638
15777	2647	0	1	0	0	2648
15778	2602	0	1	2	0	2605
15779	2469	0	1	1	0	2471
15780	3	2	2630	0	0	2635
15781	2355	0	0	1	0	2356
15782	2619	0	1	0	0	2620
15783	1	2528	3	0	0	2532
15784	1	0	0	2646	0	2647
15785	0	1	0	2579	0	2580
15786	0	0	0	2632	0	2632
15787	2689	0	0	1	0	2690
15788	2455	1	0	2	0	2458
15789	2	3	2570	1	0	2576
15790	1	0	1	2535	0	2537
15791	0	2513	4	0	0	2517
15792	2657	1	0	2	0	2660
15793	2	2	2574	0	0	2578
15794	1	2	0	2460	0	2463
15795	0	1	1	2579	0	2581
15796	0	2530	2	2	0	2534
15797	1	1	0	2674	0	2676
15798	2	4	1	2524	0	2531
15799	0	0	0	2617	0	2617
15800	2671	0	0	1	0	2672
15801	0	0	0	2592	0	2592
15802	1	1	0	2632	0	2634
15803	2636	0	0	3	0	2639
15804	0	1	0	2645	0	2646
15805	2	1464	3	0	0	1469
15806	1504	102	0	1	0	1607
15807	1629	89	0	0	0	1718
15808	1706	26	2	0	0	1734
15809	2782	10	3	0	0	2795
15810	377	2733	1	0	0	3111
15811	2970	270	1	2	0	3243
15812	3165	155	1	2	0	3323
15813	460	76	0	2928	0	3464
15814	238	33	2742	293	0	3306
15815	118	7	254	2993	0	3372
15816	49	7	137	3162	0	3355
15817	19	13	66	3219	0	3317
15818	25	14	25	3266	0	3330
15819	34	11	4	3409	0	3458
15820	2858	18	8	547	0	3431
15821	317	12	12	3144	0	3485
15822	180	12	2794	427	0	3413
15823	93	5	284	2845	0	3227
15824	44	2789	154	369	0	3356
15825	14	276	79	3087	0	3456
15826	18	140	2848	410	0	3416
15827	2840	76	283	237	0	3436
15828	3142	36	150	142	0	3470
15829	473	9	2807	85	0	3374
15830	254	2838	301	60	0	3453
15831	3003	299	147	56	0	3505
15832	3195	169	89	44	0	3497
15833	3300	107	48	45	0	3500
15834	3415	47	25	36	0	3523
15835	595	40	22	2935	0	3592
15836	319	28	2851	336	0	3534
15837	193	32	305	3044	0	3574
15838	134	25	156	3295	0	3610
15839	122	32	2915	500	0	3569
15840	97	61	3120	292	0	3570
15841	2933	29	434	175	0	3571
15842	386	2871	233	141	0	3631
15843	229	298	131	3034	0	3692
15844	142	159	2934	437	0	3672
15845	3012	91	328	295	0	3726
15846	355	42	3011	246	0	3654
15847	3045	34	404	171	0	3654
15848	424	2905	209	169	0	3707
15849	265	337	123	2987	0	3712
15850	202	181	2902	407	0	3692
15851	2949	114	354	248	0	3665
15852	392	2868	231	159	0	3650
15853	264	3231	130	124	0	3749
15854	204	494	109	2798	0	3605
15855	133	296	74	3307	0	3810
15856	3105	131	112	531	0	3879
15857	478	2996	80	300	0	3854
15858	306	346	62	3234	0	3948
15859	3046	217	96	420	0	3779
15860	3370	148	47	319	0	3884
15861	3610	82	76	224	0	3992
15862	684	58	3056	189	0	3987
15863	418	66	3295	173	0	3952
15864	3259	50	487	195	0	3991
15865	413	3113	295	187	0	4008
15866	273	3455	185	202	0	4115
15867	199	503	138	2983	0	3823
15868	158	3395	99	439	0	4091
15869	3245	465	146	255	0	4111
15870	477	224	125	3359	0	4185
15871	327	139	3127	442	0	4035
15872	3356	134	382	265	0	4137
15873	3557	90	245	229	0	4121
15874	602	85	203	3253	0	4143
15875	406	106	123	3457	0	4092
15876	301	82	108	3646	0	4137
15877	219	101	95	3784	0	4199
15878	176	130	3010	690	0	4006
15879	172	3143	378	442	0	4135
15880	143	372	255	2879	0	3649
15881	179	3313	162	440	0	4094
15882	147	492	115	2861	0	3615
15883	132	3331	90	489	0	4042
15884	3221	435	107	329	0	4092
15885	3338	251	94	260	0	3943
15886	622	3245	93	192	0	4152
15887	3417	434	133	157	0	4141
15888	516	247	109	3276	0	4148
15889	3302	178	126	404	0	4010
15890	558	3203	91	264	0	4116
15891	3377	424	126	173	0	4100
15892	3597	265	121	146	0	4129
15893	601	229	114	3190	0	4134
15894	405	146	3009	420	0	3980
15895	252	3150	356	291	0	4049
15896	200	442	211	3237	0	4090
15897	3215	257	150	483	0	4105
15898	489	223	3074	271	0	4057
15899	361	124	333	3061	0	3879
15900	228	116	207	3421	0	3972
15901	3248	80	169	553	0	4050
15902	3380	100	102	377	0	3959
15903	3446	73	97	283	0	3899
15904	657	3136	124	193	0	4110
15905	2125	244	48	132	0	2549
15906	335	113	1890	152	0	2490
15907	161	99	2076	129	0	2465
15908	138	84	2257	90	0	2569
15909	10	26	16	606	0	658
15910	4	8	580	13	0	605
15911	507	1	8	0	0	516
15912	7	3	1	517	0	528
15913	4	0	516	9	0	529
15914	532	1	6	2	0	541
15915	8	0	3	538	0	549
15916	1	1	5	549	0	556
15917	543	2	2	8	0	555
15918	9	0	1	2398	0	2408
15919	3	2	2326	128	0	2459
15920	5	0	122	2519	0	2646
15921	4	6	2338	181	0	2529
15922	2	0	165	2527	0	2694
15923	2211	2	106	197	0	2516
15924	114	2288	67	120	0	2589
15925	79	2477	22	87	0	2665
15926	51	199	23	2337	0	2610
15927	24	140	5	2235	0	2404
15928	17	2259	17	209	0	2502
15929	5	2445	12	147	0	2609
15930	10	208	14	2349	0	2581
15931	5	136	9	2502	0	2652
15932	2204	87	8	236	0	2535
15933	129	2220	6	152	0	2507
15934	86	2243	9	93	0	2431
15935	49	2466	4	46	0	2565
15936	2361	253	4	35	0	2653
15937	143	155	2233	24	0	2555
15938	2333	98	117	24	0	2572
15939	190	47	93	2152	0	2482
15940	113	2042	64	142	0	2361
15941	70	2379	31	101	0	2581
15942	2319	200	21	63	0	2603
15943	157	150	8	1985	0	2300
15944	96	2326	17	129	0	2568
15945	2319	169	17	96	0	2601
15946	2472	119	21	82	0	2694
15947	235	69	2254	54	0	2612
15948	2412	38	123	43	0	2616
15949	2473	39	98	24	0	2634
15950	259	41	49	2227	0	2576
15951	163	2163	33	131	0	2490
15952	104	2348	19	121	0	2592
15953	62	218	13	2377	0	2670
15954	2180	165	12	176	0	2533
15955	148	122	2168	118	0	2556
15956	114	72	2298	87	0	2571
15957	83	37	2384	72	0	2576
15958	62	30	2330	54	0	2476
15959	37	2164	288	40	0	2529
15960	17	2232	177	41	0	2467
15961	28	249	2230	34	0	2541
15962	36	182	2235	22	0	2475
15963	38	2201	237	29	0	2505
15964	32	178	161	2010	0	2381
15965	23	133	2145	144	0	2445
15966	23	102	171	2142	0	2438
15967	18	74	132	2162	0	2386
15968	30	65	81	2277	0	2453
15969	31	47	44	2399	0	2521
15970	33	42	2074	324	0	2473
15971	31	31	135	2336	0	2533
15972	2160	45	112	239	0	2556
15973	158	48	2127	164	0	2497
15974	2230	35	158	119	0	2542
15975	212	19	135	2167	0	2533
15976	156	19	2110	205	0	2490
15977	2220	32	178	143	0	2573
15978	163	53	115	2252	0	2583
15979	2258	48	80	193	0	2579
15980	209	46	62	2120	0	2437
15981	161	2069	64	241	0	2535
15982	116	145	2118	161	0	2540
15983	53	125	182	2283	0	2643
15984	2170	97	161	207	0	2635
15985	2251	75	103	207	0	2636
15986	2383	69	81	125	0	2658
15987	2350	88	63	109	0	2610
15988	2260	98	60	90	0	2508
15989	309	2204	61	114	0	2688
15990	2318	184	50	121	0	2673
15991	245	190	2149	87	0	2671
15992	2315	151	151	89	0	2706
15993	252	110	129	1406	0	1897
15994	184	88	2157	177	0	2606
15995	145	61	2259	149	0	2614
15996	92	78	261	2214	0	2645
15997	2118	91	181	202	0	2592
15998	179	2237	114	162	0	2692
15999	2191	196	69	112	0	2568
16000	251	2268	76	80	0	2675
16001	194	227	79	2114	0	2614
16002	145	166	50	2334	0	2695
16003	2211	144	47	284	0	2686
16004	222	105	55	2356	0	2738
16005	212	82	2131	255	0	2680
16006	2277	39	144	228	0	2688
16007	231	82	125	2239	0	2677
16008	204	73	91	2356	0	2724
16009	153	60	2138	304	0	2655
16010	2126	48	196	192	0	2562
16011	2169	43	128	142	0	2482
16012	338	2170	105	87	0	2700
16013	259	162	2162	88	0	2671
16014	161	149	2226	62	0	2598
16015	113	125	278	2090	0	2606
16016	103	74	215	2044	0	2436
16017	122	2211	150	281	0	2764
16018	3	5	255	1	0	264
16019	2	3	1	255	0	261
16020	1	2	254	5	0	262
16021	0	1	6	244	0	251
16022	1	245	2	7	0	255
16023	2	5	3	251	0	261
16024	0	0	1	254	0	255
16025	1	1	2	248	0	252
16026	248	1	2	5	0	256
16027	3	1	249	4	0	257
16028	2	244	5	3	0	254
16029	2	3	3	272	0	280
16030	282	2	1	3	0	288
16031	4	1	0	285	0	290
16032	289	1	3	4	0	297
16033	7	0	297	2	0	306
16034	300	0	4	5	0	309
16035	7	1	0	313	0	321
16036	1	1	306	8	0	316
16037	1	308	5	1	0	315
16038	3	3	2	310	0	318
16039	0	0	2	316	0	318
16040	310	1	2	4	0	317
16041	6	302	0	3	0	311
16042	3	307	1	2	0	313
16043	3	318	0	2	0	323
16044	297	6	0	2	0	305
16045	3	303	2	3	0	311
16046	2	4	1	297	0	304
16047	2	2	1	297	0	302
16048	297	3	0	3	0	303
16049	3	294	0	2	0	299
16050	2	2	1	298	0	303
16051	301	1	0	5	0	307
16052	304	0	1	1	0	306
16053	310	0	1	3	0	314
16054	7	309	0	0	0	316
16055	307	3	0	2	0	312
16056	3	1	1	307	0	312
16057	1	308	0	3	0	312
16058	2	315	0	1	0	318
16059	1	2	2	308	0	313
16060	294	2	0	10	0	306
16061	300	1	0	1	0	302
16062	2	1	0	286	0	289
16063	0	281	0	2	0	283
16064	284	3	1	0	0	288
16065	2	0	286	1	0	289
16066	2	1	281	2	0	286
16067	279	0	2	1	0	282
16068	2	0	274	1	0	277
16069	1	1	2	237	0	241
16070	243	0	0	3	0	246
16071	2	0	2	252	0	256
16072	0	1	251	2	0	254
16073	1	262	1	0	0	264
16074	0	1	1	266	0	268
16075	1	0	269	2	0	272
16076	268	1	5	0	0	274
16077	2	1	0	280	0	283
16078	0	1	287	2	0	290
16079	1	1	3	284	0	289
16080	0	282	0	3	0	285
16081	0	3	1	284	0	288
16082	1	0	0	283	0	284
16083	0	0	0	279	0	279
16084	0	278	2	2	0	282
16085	284	3	0	2	0	289
16086	4	1	0	288	0	293
16087	0	0	0	292	0	292
16088	0	1	0	293	0	294
16089	0	1	289	4	0	294
16090	1	1	2	289	0	293
16091	287	0	0	4	0	291
16092	3	289	0	0	0	292
16093	0	3	0	300	0	303
16094	0	0	0	301	0	301
16095	300	0	1	3	0	304
16096	5	302	0	1	0	308
16097	304	3	0	0	0	307
16098	308	2	0	0	0	310
16099	4	0	0	306	0	310
16100	307	0	1	4	0	312
16101	4	293	1	0	0	298
16102	303	4	0	0	0	307
16103	4	0	1	310	0	315
16104	329	0	0	4	0	333
16105	331	0	0	1	0	332
16106	3	0	330	1	0	334
16107	335	1	2	0	0	338
16108	343	1	0	0	0	344
16109	382	0	0	2	0	384
16110	5	0	396	0	0	401
16111	3	388	3	0	0	394
16112	0	6	2	397	0	405
16113	392	1	1	5	0	399
16114	6	378	0	2	0	386
16115	385	6	0	0	0	391
16116	5	1	1	395	0	402
16117	2	1	395	6	0	404
16118	403	0	5	3	0	411
16119	6	1	1	409	0	417
16120	1	1	409	5	0	416
16121	415	1	5	2	0	423
16122	5	0	432	3	0	440
16123	3	0	6	457	0	466
16124	1	1	3	474	0	479
16125	474	0	0	10	0	484
16126	475	0	2	2	0	479
16127	9	490	1	0	0	500
16128	498	6	1	1	0	506
16129	6	2	473	0	0	481
16130	2	0	478	0	0	480
16131	476	0	7	0	0	483
16132	5	467	2	0	0	474
16133	455	6	0	1	0	462
16134	5	447	0	5	0	457
16135	453	6	0	0	0	459
16136	7	3	0	446	0	456
16137	2	1	449	7	0	459
16138	1	0	5	455	0	461
16139	0	0	3	457	0	460
16140	454	1	1	8	0	464
16141	8	0	449	2	0	459
16142	447	1	7	0	0	455
16143	8	446	2	1	0	457
16144	451	8	2	0	0	461
16145	9	3	0	445	0	457
16146	3	0	439	7	0	449
16147	0	0	8	442	0	450
16148	448	0	2	8	0	458
16149	7	0	0	448	0	455
16150	2	0	1	446	0	449
16151	1	435	0	8	0	444
16152	2	7	0	438	0	447
16153	1	3	430	7	0	441
16154	1	0	8	422	0	431
16155	0	1	2	432	0	435
16156	423	0	1	10	0	434
16157	7	0	0	421	0	428
16158	3	1	410	7	0	421
16159	1	412	7	4	0	424
16160	0	7	2	419	0	428
16161	0	5	1	422	0	428
16162	427	0	1	9	0	437
16163	8	420	1	3	0	432
16164	1	7	2	422	0	432
16165	412	2	0	9	0	423
16166	417	0	0	3	0	420
16167	11	0	0	411	0	422
16168	3	0	422	8	0	433
16169	427	2	7	2	0	438
16170	9	2	2	433	0	446
16171	431	1	1	10	0	443
16172	433	0	1	3	0	437
16173	11	408	1	0	0	420
16174	406	8	0	1	0	415
16175	8	402	1	1	0	412
16176	4	8	1	394	0	407
16177	4	2	0	397	0	403
16178	2	389	0	9	0	400
16179	392	7	3	2	0	404
16180	394	2	1	2	0	399
16181	9	1	383	2	0	395
16182	4	0	383	2	0	389
16183	0	2	8	380	0	390
16184	400	1	1	6	0	408
16185	8	2	1	399	0	410
16186	5	1	1	402	0	409
16187	2	1	399	11	0	413
16188	1	0	401	2	0	404
16189	1	0	396	3	0	400
16190	390	0	9	0	0	399
16191	400	1	4	2	0	407
16192	9	389	1	3	0	402
16193	1	398	1	2	0	402
16194	2	8	1	395	0	406
16195	1	2	398	8	0	409
16196	389	1	7	4	0	401
16197	7	0	403	2	0	412
16198	3	1	5	393	0	402
16199	1	1	3	403	0	408
16200	1	0	2	404	0	407
16201	2	1	1	407	0	411
16202	400	2	0	8	0	410
16203	7	0	1	389	0	397
16204	3	0	390	9	0	402
16205	386	1	6	3	0	396
16206	6	0	387	3	0	396
16207	3	1	381	1	0	386
16208	2	379	7	2	0	390
16209	6	3	7	325	0	341
16210	316	3	1	1	0	321
16211	3	1	0	319	0	323
16212	1	0	324	2	0	327
16213	1	0	1	327	0	329
16214	326	1	0	1	0	328
16215	2	324	0	2	0	328
16216	320	1	0	0	0	321
16217	1	310	0	1	0	312
16218	308	0	1	1	0	310
16219	1	296	0	0	0	297
16220	1	287	1	0	0	289
16221	0	2	263	0	0	265
16222	1	260	1	0	0	262
16223	219	3	4	1	0	227
16224	2	0	0	217	0	219
16225	220	0	0	1	0	221
16226	1	221	0	1	0	223
16227	215	1	1	0	0	217
16228	1	1	217	0	0	219
16229	1	0	1	222	0	224
16230	0	223	0	2	0	225
16231	1	1	0	229	0	231
16232	0	1	0	230	0	231
16233	267	0	0	1	0	268
16234	3	271	2	0	0	276
16235	280	3	0	1	0	284
16236	3	2	286	0	0	291
16237	1	0	275	1	0	277
16238	1	273	4	1	0	279
16239	0	2	2	279	0	283
16240	2	2	278	3	0	285
16241	1	2	3	272	0	278
16242	0	1	2	284	0	287
16243	1	1	275	5	0	282
16244	1	0	278	2	0	281
16245	1	0	282	1	0	284
16246	1	0	286	1	0	288
16247	2	276	5	10	0	293
16248	0	3	1	290	0	294
16249	1	3	1	296	0	301
16250	0	2	295	6	0	303
16251	2	0	4	295	0	301
16252	0	1	317	5	0	323
16253	0	1	4	315	0	320
16254	1	0	3	315	0	319
16255	0	319	1	5	0	325
16256	1	3	2	319	0	325
16257	0	2	1	324	0	327
16258	1	1	0	318	0	320
16259	1	1	303	6	0	311
16260	1	304	3	5	0	313
16261	308	3	3	0	0	314
16262	305	1	0	4	0	310
16263	5	1	1	311	0	318
16264	1	1	0	313	0	315
16265	1	313	0	6	0	320
16266	318	6	0	1	0	325
16267	5	319	0	1	0	325
16268	305	3	0	1	0	309
16269	2	2	295	2	0	301
16270	286	0	4	0	0	290
16271	2	300	1	0	0	303
16272	4	2	0	298	0	304
16273	1	1	1	299	0	302
16274	1	298	0	5	0	304
16275	293	4	0	3	0	300
16276	4	2	1	299	0	306
16277	2	0	1	303	0	306
16278	298	1	1	5	0	305
16279	306	1	1	1	0	309
16280	4	1	308	1	0	314
16281	309	0	3	2	0	314
16282	4	1	1	309	0	315
16283	1	1	310	4	0	316
16284	1	0	3	301	0	305
16285	0	1	308	3	0	312
16286	3	0	309	2	0	314
16287	0	1	4	313	0	318
16288	0	1	322	5	0	328
16289	1	321	4	2	0	328
16290	0	3	1	330	0	334
16291	0	1	1	341	0	343
16292	1	2	334	5	0	342
16293	0	332	3	3	0	338
16294	340	3	2	0	0	345
16295	5	1	0	345	0	351
16296	345	0	1	5	0	351
16297	5	358	1	2	0	366
16298	1	6	357	1	0	365
16299	1	1	6	361	0	369
16300	366	2	1	5	0	374
16301	6	0	355	2	0	363
16302	357	0	6	1	0	364
16303	6	361	1	0	0	368
16304	1	364	0	0	0	365
16305	352	6	0	0	0	358
16306	8	1	0	349	0	358
16307	2	0	0	347	0	349
16308	0	345	0	6	0	351
16309	0	5	1	354	0	360
16310	0	1	0	358	0	359
16311	350	0	0	6	0	356
16312	5	0	0	348	0	353
16313	2	0	358	5	0	365
16314	0	1	5	362	0	368
16315	0	2	1	2121	0	2124
16316	3	0	2173	6	0	2182
16317	0	0	5	2018	0	2023
16318	2153	0	1	6	0	2160
16319	2064	1	0	1	0	2066
16320	2049	0	0	1	0	2050
16321	6	0	0	2114	0	2120
16322	3	1	2125	5	0	2134
16323	0	2011	6	2	0	2019
16324	0	5	2	2187	0	2194
16325	0	0	2169	6	0	2175
16326	0	0	3	2020	0	2023
16327	0	0	1	2129	0	2130
16328	2173	0	0	7	0	2180
16329	5	2081	3	1	0	2090
16330	3	5	2154	0	0	2162
16331	1770	3	6	0	0	1779
16332	5	2076	4	1	0	2086
16333	1	2063	0	1	0	2065
16334	2170	3	3	0	0	2176
16335	3	0	0	2140	0	2143
16336	1	0	2206	3	0	2210
16337	0	0	4	2099	0	2103
16338	0	2107	1	5	0	2113
16339	2258	4	0	0	0	2262
16340	4	0	0	2202	0	2206
16341	2248	0	0	4	0	2252
16342	4	0	0	2201	0	2205
16343	0	2138	1	4	0	2143
16344	2268	4	0	0	0	2272
16345	2121	1	2	0	0	2124
16346	4	2173	0	0	0	2177
16347	2260	4	0	0	0	2264
16348	4	0	1	2229	0	2234
16349	0	2117	4	4	0	2125
16350	2281	5	0	0	0	2286
16351	5	2166	0	2	0	2173
16352	2238	4	0	1	0	2243
16353	5	0	0	2172	0	2177
16354	2240	0	0	6	0	2246
16355	2209	1	0	0	0	2210
16356	2175	0	1	0	0	2176
16357	5	2	0	2169	0	2176
16358	0	1	0	2167	0	2168
16359	2200	0	0	4	0	2204
16360	5	1	2166	1	0	2173
16361	1	1	3	2129	0	2134
16362	2	2116	1	5	0	2124
16363	1	6	0	2207	0	2214
16364	2	0	0	2146	0	2148
16365	2	5	3023	6	0	3036
16366	1	1	4	2947	0	2953
16367	2	2977	5	7	0	2991
16368	2	6	0	3292	0	3300
16369	1	5	3320	8	0	3334
16370	2	2	9	3152	0	3165
16371	1	1	4	3363	0	3369
16372	3355	1	3	13	0	3372
16373	3200	0	3	7	0	3210
16374	13	5	0	3363	0	3381
16375	6	3188	2	7	0	3203
16376	5	3195	3	6	0	3209
16377	7	17	3249	3	0	3276
16378	1	12	8	3124	0	3145
16379	3373	2	5	9	0	3389
16380	9	2	2	3306	0	3319
16381	8	0	3348	12	0	3368
16382	1	1	9	3223	0	3234
16383	1	1	4	3239	0	3245
16384	3	0	1	3261	0	3265
16385	7	0	3290	15	0	3312
16386	0	3091	9	9	0	3109
16387	3304	10	3	5	0	3322
16388	3215	7	2	2	0	3226
16389	12	1	2	3234	0	3249
16390	9	4	3253	11	0	3277
16391	2	3058	14	12	0	3086
16392	2	13	4	3293	0	3312
16393	2	3127	5	9	0	3143
16394	0	3163	5	8	0	3176
16395	3175	8	3	4	0	3190
16396	10	7	3222	0	0	3239
16397	6	7	3055	1	0	3069
16398	2	3	14	2925	0	2944
16399	3	0	5	3177	0	3185
16400	5	1	3194	15	0	3215
16401	2	2	10	2901	0	2915
16402	2	2	3202	9	0	3215
16403	2628	0	20	11	0	2659
16404	7	1	4	3123	0	3135
16405	5	3	3213	10	0	3231
16406	3	1	7	3072	0	3083
16407	2	2990	11	7	0	3010
16408	3253	5	4	4	0	3266
16409	6	3055	7	7	0	3075
16410	3218	7	4	3	0	3232
16411	8	7	3111	2	0	3128
16412	2936	3	9	2	0	2950
16413	8	0	5	3119	0	3132
16414	7	4	3148	7	0	3166
16415	4	1	6	1577	0	1588
16416	1	1	1565	7	0	1574
16417	1412	1	9	6	0	1428
16418	6	1500	5	5	0	1516
16419	7	6	2	1567	0	1582
16420	2	1546	3	8	0	1559
16421	1592	8	2	6	0	1608
16422	1574	6	1	0	0	1581
16423	12	1525	1	4	0	1542
16424	7	7	0	1599	0	1613
16425	1	6	3	1586	0	1596
16426	1	1	1	1578	0	1581
16427	1596	1	3	12	0	1612
16428	8	1508	5	7	0	1528
16429	5	9	1	1572	0	1587
16430	3	5	0	1567	0	1575
16431	1563	2	6	12	0	1583
16432	11	5	1457	9	0	1482
16433	6	5	1367	4	0	1382
16434	1402	2	11	2	0	1417
16435	8	2	1442	3	0	1455
16436	7	0	1366	3	0	1376
16437	2	10	8	1335	0	1355
16438	1408	2	10	6	0	1426
16439	8	1	2	1387	0	1398
16440	4	2	1386	9	0	1401
16441	1282	0	6	8	0	1296
16442	5	1	1367	4	0	1377
16443	6	1329	14	1	0	1350
16444	1	6	7	1442	0	1456
16445	1454	4	3	9	0	1470
16446	7	0	1	1419	0	1427
16447	4	0	4	1429	0	1437
16448	1465	1	0	10	0	1476
16449	7	2	0	1435	0	1444
16450	6	0	0	1444	0	1450
16451	2	1	1438	12	0	1453
16452	2	2	6	1426	0	1436
16453	1452	1	5	6	0	1464
16454	1435	2	2	6	0	1445
16455	1440	1	1	4	0	1446
16456	11	1	0	1417	0	1429
16457	7	1353	2	11	0	1373
16458	1453	5	2	4	0	1464
16459	7	1411	3	3	0	1424
16460	1430	6	1	3	0	1440
16461	7	3	0	1424	0	1434
16462	1431	2	2	6	0	1441
16463	1413	0	3	6	0	1422
16464	1400	1	1	3	0	1405
16465	13	594	0	0	0	607
16466	6	582	1	2	0	591
16467	546	5	1	1	0	553
16468	4	543	0	2	0	549
16469	5	1456	6	2	0	1469
16470	2	1734	3	2	0	1741
16471	1690	188	8	0	0	1886
16472	135	125	2	1729	0	1991
16473	103	57	2	1915	0	2077
16474	1811	30	0	248	0	2089
16475	158	31	2975	165	0	3329
16476	129	5	129	3240	0	3503
16477	63	1	91	3445	0	3600
16478	18	2	49	3632	0	3701
16479	20	3	17	3595	0	3635
16480	8	3069	27	310	0	3414
16481	3	4426	10	192	0	4631
16482	4441	241	6	100	0	4788
16483	172	154	1	4551	0	4878
16484	122	66	1	4767	0	4956
16485	68	31	4356	320	0	4775
16486	28	30	173	4636	0	4867
16487	31	10	4522	278	0	4841
16488	9	3	222	4680	0	4914
16489	4	8	4505	295	0	4812
16490	2	4410	245	188	0	4845
16491	9	169	145	4693	0	5016
16492	4554	128	81	204	0	4967
16493	4679	72	28	164	0	4943
16494	311	26	24	4642	0	5003
16495	199	27	4478	230	0	4934
16496	87	16	4322	185	0	4610
16497	4391	9	291	99	0	4790
16498	203	4422	197	49	0	4871
16499	4729	171	88	59	0	5047
16500	4769	126	57	37	0	4989
16501	328	86	4420	26	0	4860
16502	226	36	179	4425	0	4866
16503	109	41	117	4729	0	4996
16504	67	20	67	4890	0	5044
16505	51	14	29	4887	0	4981
16506	25	9	43	4879	0	4956
16507	8	19	4324	453	0	4804
16508	25	15	4393	273	0	4706
16509	28	11	293	4585	0	4917
16510	23	21	191	4706	0	4941
16511	28	15	94	4882	0	5019
16512	4568	10	75	411	0	5064
16513	192	15	45	4788	0	5040
16514	4692	12	18	350	0	5072
16515	271	16	11	4803	0	5101
16516	4703	16	26	317	0	5062
16517	4787	17	12	214	0	5030
16518	4819	14	26	149	0	5008
16519	4889	7	34	81	0	5011
16520	4894	5	26	83	0	5008
16521	436	23	20	4593	0	5072
16522	4700	20	30	231	0	4981
16523	329	4385	18	188	0	4920
16524	4622	182	31	124	0	4959
16525	286	130	19	4617	0	5052
16526	175	71	4440	277	0	4963
16527	117	34	195	4687	0	5033
16528	68	34	4528	296	0	4926
16529	70	14	252	4637	0	4973
16530	42	13	170	4802	0	5027
16531	47	16	4443	374	0	4880
16532	38	17	4360	277	0	4692
16533	54	16	333	4614	0	5017
16534	4535	22	201	276	0	5034
16535	241	15	4321	203	0	4780
16536	165	4176	242	139	0	4722
16537	111	170	4503	85	0	4869
16538	4458	128	258	84	0	4928
16539	243	78	167	4511	0	4999
16540	4648	29	108	233	0	5018
16541	4723	35	46	192	0	4996
16542	353	11	54	4616	0	5034
16543	258	17	4360	255	0	4890
16544	127	12	199	4620	0	4958
16545	99	9	147	4743	0	4998
16546	4394	13	88	392	0	4887
16547	211	4323	51	282	0	4867
16548	144	165	65	4581	0	4955
16549	112	121	4255	271	0	4759
16550	4115	71	200	236	0	4622
16551	240	4280	148	141	0	4809
16552	181	193	89	4457	0	4920
16553	113	132	47	4632	0	4924
16554	69	70	59	4778	0	4976
16555	4454	29	42	422	0	4947
16556	4564	29	25	289	0	4907
16557	360	18	18	4559	0	4955
16558	245	22	4224	276	0	4767
16559	143	4282	192	226	0	4843
16560	4435	187	160	119	0	4901
16561	4605	126	92	68	0	4891
16562	344	74	40	4431	0	4889
16563	225	37	52	4609	0	4923
16564	125	41	4265	371	0	4802
16565	93	4293	186	276	0	4848
16566	4412	180	140	156	0	4888
16567	4399	134	98	95	0	4726
16568	341	4440	55	102	0	4938
16569	3080	50	9	17	0	3156
16570	66	32	6	3038	0	3142
16571	41	16	2974	58	0	3089
16572	30	8	49	3001	0	3088
16573	21	8	2922	64	0	3015
16574	2856	6	50	39	0	2951
16575	50	1605	29	32	0	1716
16576	28	39	14	1578	0	1659
16577	22	19	1505	54	0	1600
16578	16	14	1501	30	0	1561
16579	1425	15	57	21	0	1518
16580	45	1490	36	23	0	1594
16581	377	4	13	1	0	395
16582	370	2	1	2	0	375
16583	365	1	3	2	0	371
16584	5	0	2	367	0	374
16585	2	2	372	5	0	381
16586	5	358	4	0	0	367
16587	2	3	4	370	0	379
16588	1	1	374	6	0	382
16589	2	2	349	1	0	354
16590	0	4	2	338	0	344
16591	0	1	337	2	0	340
16592	317	0	5	2	0	324
16593	2	0	1	340	0	343
16594	1	0	4	351	0	356
16595	351	1	1	2	0	355
16596	6	343	0	4	0	353
16597	356	1	1	3	0	361
16598	2	0	4	354	0	360
16599	1	3	0	356	0	360
16600	3	1	1	356	0	361
16601	3	0	1	351	0	355
16602	347	2	0	3	0	352
16603	3	0	351	3	0	357
16604	2	341	2	3	0	348
16605	3	0	1	349	0	353
16606	345	2	2	1	0	350
16607	348	2	0	3	0	353
16608	1	343	1	5	0	350
16609	336	0	2	1	0	339
16610	2	330	0	2	0	334
16611	1	344	1	1	0	347
16612	8	0	0	341	0	349
16613	0	2	350	1	0	353
16614	0	4	0	334	0	338
16615	334	0	2	1	0	337
16616	1	324	0	0	0	325
16617	1	2	0	336	0	339
16618	1	0	379	4	0	384
16619	403	1	0	2	0	406
16620	411	0	0	3	0	414
16621	410	0	1	1	0	412
16622	4	0	405	0	0	409
16623	392	0	0	1	0	393
16624	1	398	2	0	0	401
16625	2	0	0	382	0	384
16626	0	384	0	1	0	385
16627	391	1	1	1	0	394
16628	389	1	0	0	0	390
16629	1	0	402	1	0	404
16630	1	388	1	1	0	391
16631	0	0	1	401	0	402
16632	0	1	1	395	0	397
16633	1	0	0	387	0	388
16634	0	1	0	401	0	402
16635	0	0	0	409	0	409
16636	0	0	399	3	0	402
16637	0	392	2	2	0	396
16638	400	2	1	0	0	403
16639	2	2	429	0	0	433
16640	2	428	3	2	0	435
16641	444	3	1	0	0	448
16642	4	1	473	0	0	478
16643	475	0	5	1	0	481
16644	473	0	4	0	0	477
16645	469	1	0	0	0	470
16646	6	468	0	4	0	478
16647	1	5	459	0	0	465
16648	0	475	6	1	0	482
16649	0	8	1	444	0	453
16650	0	469	2	4	0	475
16651	483	5	1	1	0	490
16652	502	1	1	2	0	506
16653	503	0	1	1	0	505
16654	12	0	489	0	0	501
16655	1	505	7	4	0	517
16656	1	5	1	557	0	564
16657	593	1	0	6	0	600
16658	6	592	0	2	0	600
16659	3	5	0	596	0	604
16660	0	2	610	10	0	622
16661	622	0	8	2	0	632
16662	7	2	648	1	0	658
16663	5	1	670	1	0	677
16664	653	0	13	1	0	667
16665	10	2	663	0	0	675
16666	651	1	8	0	0	660
16667	9	642	7	1	0	659
16668	686	9	0	0	0	695
16669	12	3	1	2136	0	2152
16670	6	4	1	2013	0	2024
16671	0	3	0	2108	0	2111
16672	2144	2	3	13	0	2162
16673	2054	3	0	5	0	2062
16674	2062	0	0	5	0	2067
16675	14	1992	2	2	0	2010
16676	8	10	0	2118	0	2136
16677	5	5	2077	9	0	2096
16678	4	1	9	2016	0	2030
16679	2	2023	7	12	0	2044
16680	1	11	1	2097	0	2110
16681	3	3	2	2086	0	2094
16682	2030	1	1	14	0	2046
16683	12	3	1	2048	0	2064
16684	5	1	2068	12	0	2086
16685	1	6	1833	7	0	1847
16686	2	2	11	2058	0	2073
16687	2108	1	7	13	0	2129
16688	10	1	3	1990	0	2004
16689	7	0	0	3562	0	3569
16690	0	2	3527	19	0	3548
16691	5	3402	11	8	0	3426
16692	2	11	4	3668	0	3685
16693	3659	3	1	11	0	3674
16694	11	3422	7	9	0	3449
16695	4	11	0	3644	0	3659
16696	3	5	3573	14	0	3595
16697	3	3	10	3415	0	3431
16698	3588	4	8	11	0	3611
16699	10	3446	3	11	0	3470
16700	5	13	3513	2	0	3533
16701	1	7	11	3242	0	3261
16702	2	0	3547	12	0	3561
16703	3342	4	11	7	0	3364
16704	3364	4	6	3	0	3377
16705	17	2	3495	4	0	3518
16706	5	3	13	3367	0	3388
16707	5	2	3458	13	0	3478
16708	5	3379	11	8	0	3403
16709	2	10	9	4457	0	4478
16710	4	6	4361	142	0	4513
16711	2	2	145	4159	0	4308
16712	5	4256	33	132	0	4426
16713	4	150	3	4504	0	4661
16714	2	35	4319	154	0	4510
16715	4048	6	154	39	0	4247
16716	145	4244	38	12	0	4439
16717	4486	157	9	23	0	4675
16718	160	40	4238	14	0	4452
16719	4078	11	161	30	0	4280
16720	164	23	4176	22	0	4385
16721	4175	12	160	22	0	4369
16722	4445	16	55	16	0	4532
16723	194	12	15	4250	0	4471
16724	45	18	28	4435	0	4526
16725	4322	11	23	183	0	4539
16726	171	4144	19	44	0	4378
16727	4407	162	22	20	0	4611
16728	182	33	32	4227	0	4474
16729	73	4119	24	158	0	4374
16730	29	165	23	4406	0	4623
16731	39	40	17	4417	0	4513
16732	28	9	15	4377	0	4429
16733	30	4153	18	198	0	4399
16734	4284	175	13	75	0	4547
16735	181	54	20	4275	0	4530
16736	63	30	4137	192	0	4422
16737	32	45	3811	68	0	3956
16738	43	32	3949	45	0	4069
16739	4005	25	198	48	0	4276
16740	4188	24	49	57	0	4318
16741	195	25	4089	60	0	4369
16742	74	15	174	3736	0	3999
16743	46	41	55	4083	0	4225
16744	46	32	4084	233	0	4395
16745	42	26	3938	83	0	4089
16746	61	21	217	4006	0	4305
16747	4043	40	69	195	0	4347
16748	3986	21	56	62	0	4125
16749	3971	17	55	46	0	4089
16750	217	3783	39	49	0	4088
16751	76	3978	58	67	0	4179
16752	59	193	52	4068	0	4372
16753	4025	39	41	217	0	4322
16754	187	39	3833	94	0	4153
16755	3501	29	160	80	0	3770
16756	183	3615	71	81	0	3950
16757	89	3806	38	65	0	3998
16758	3730	233	44	45	0	4052
16759	212	3669	39	54	0	3974
16760	75	3857	36	68	0	4036
16761	3731	240	56	71	0	4098
16762	177	3661	65	88	0	3991
16763	83	216	51	3687	0	4037
16764	49	88	80	3869	0	4086
16765	3731	53	65	252	0	4101
16766	3705	71	67	110	0	3953
16767	218	3470	58	113	0	3859
16768	118	3617	80	69	0	3884
16769	87	234	2445	67	0	2833
16770	2530	108	222	58	0	2918
16771	2759	61	86	69	0	2975
16772	2767	83	87	70	0	3007
16773	302	54	61	2558	0	2975
16774	126	52	72	2752	0	3002
16775	2646	67	75	266	0	3054
16776	280	58	76	2602	0	3016
16777	127	84	2538	242	0	2991
16778	153	73	189	2378	0	2793
16779	146	2544	83	179	0	2952
16780	127	222	46	2614	0	3009
16781	135	99	58	2674	0	2966
16782	124	93	44	2794	0	3055
16783	2586	85	41	285	0	2997
16784	247	2536	29	174	0	2986
16785	116	225	61	2684	0	3086
16786	88	80	2503	302	0	2973
16787	84	90	2506	133	0	2813
16788	77	98	229	2491	0	2895
16789	98	89	85	1419	0	1691
16790	1288	74	69	252	0	1683
16791	240	88	58	1183	0	1569
16792	130	1218	76	250	0	1674
16793	105	212	1198	127	0	1642
16794	94	98	210	1343	0	1745
16795	92	54	1266	275	0	1687
16796	107	65	191	1381	0	1744
16797	1281	25	118	285	0	1709
16798	1413	45	101	146	0	1705
16799	249	1305	74	111	0	1739
16800	106	214	91	1288	0	1699
16801	1268	90	81	224	0	1663
16802	1387	76	53	118	0	1634
16803	1529	58	64	102	0	1753
16804	1512	67	48	108	0	1735
16805	1405	69	63	109	0	1646
16806	257	1292	49	121	0	1719
16807	1382	230	48	119	0	1779
16808	266	102	1350	124	0	1842
16809	3	0	3	323	0	329
16810	325	0	1	3	0	329
16811	323	1	1	2	0	327
16812	323	0	0	2	0	325
16813	5	0	330	0	0	335
16814	2	0	1	346	0	349
16815	348	1	2	2	0	353
16816	3	349	1	3	0	356
16817	369	3	0	0	0	372
16818	366	0	1	1	0	368
16819	369	0	0	2	0	371
16820	4	0	0	384	0	388
16821	394	1	0	2	0	397
16822	4	2	399	0	0	405
16823	2	0	396	1	0	399
16824	408	0	5	0	0	413
16825	3	0	427	2	0	432
16826	407	0	4	0	0	411
16827	4	0	408	0	0	412
16828	0	0	4	404	0	408
16829	404	0	0	4	0	408
16830	4	409	1	0	0	414
16831	418	4	0	0	0	422
16832	3	410	1	0	0	414
16833	0	431	0	1	0	432
16834	1	4	0	437	0	442
16835	0	1	0	438	0	439
16836	1	0	0	442	0	443
16837	0	1	446	4	0	451
16838	437	1	4	0	0	442
16839	461	0	0	1	0	462
16840	456	0	0	1	0	457
16841	458	0	0	1	0	459
16842	459	0	3	0	0	462
16843	6	0	459	0	0	465
16844	2	1	447	0	0	450
16845	1	0	5	450	0	456
16846	1	0	449	4	0	454
16847	453	0	4	2	0	459
16848	4	471	1	0	0	476
16849	1	5	1	513	0	520
16850	516	1	0	8	0	525
16851	7	0	1	548	0	556
16852	2	0	564	6	0	572
16853	0	1	560	1	0	562
16854	0	0	6	574	0	580
16855	1	0	568	7	0	576
16856	557	0	5	2	0	564
16857	7	0	2	568	0	577
16858	1	0	575	7	0	583
16859	0	579	8	2	0	589
16860	0	7	2	599	0	608
16861	1	1	607	8	0	617
16862	0	0	9	587	0	596
16863	1	0	2	614	0	617
16864	2	1	606	12	0	621
16865	0	0	9	615	0	624
16866	0	0	2	614	0	616
16867	0	0	1	619	0	620
16868	611	0	0	11	0	622
16869	8	599	2	2	0	611
16870	1	619	0	4	0	624
16871	1	9	624	0	0	634
16872	599	2	8	0	0	609
16873	7	1	618	0	0	626
16874	1	0	613	0	0	614
16875	1	0	8	597	0	606
16876	600	0	2	7	0	609
16877	7	599	1	0	0	607
16878	608	7	0	1	0	616
16879	599	1	0	0	0	600
16880	8	617	0	0	0	625
16881	614	6	1	0	0	621
16882	609	1	0	0	0	610
16883	8	613	0	0	0	621
16884	2	8	0	1696	0	1706
16885	1	1	0	1808	0	1810
16886	1701	1	0	36	0	1738
16887	29	1801	0	10	0	1840
16888	1823	25	0	1	0	1849
16889	1752	7	0	1	0	1760
16890	1848	2	1	0	0	1851
16891	41	1	3	1830	0	1875
16892	9	1	0	1902	0	1912
16893	1833	0	1	41	0	1875
16894	1764	0	2	11	0	1777
16895	1823	0	0	4	0	1827
16896	39	0	1	1896	0	1936
16897	14	0	1831	34	0	1879
16898	3	3	30	1864	0	1900
16899	4	1	8	3051	0	3064
16900	3	4	2961	85	0	3053
16901	5	3	3091	21	0	3120
16902	3	1	86	3178	0	3268
16903	7	5	3034	94	0	3140
16904	3049	6	88	33	0	3176
16905	92	0	27	3158	0	3277
16906	22	8	28	3203	0	3261
16907	3048	3	20	113	0	3184
16908	95	1	20	3108	0	3224
16909	42	4	10	3084	0	3140
16910	27	2	9	3236	0	3274
16911	32	3	8	3346	0	3389
16912	29	14	3014	136	0	3193
16913	41	3	79	3229	0	3352
16914	33	12	2824	136	0	3005
16915	31	3098	85	69	0	3283
16916	23	77	27	3154	0	3281
16917	19	16	3031	145	0	3211
16918	3011	10	102	78	0	3201
16919	109	3136	46	63	0	3354
16920	3114	100	38	52	0	3304
16921	126	19	27	2857	0	3029
16922	49	3125	40	137	0	3351
16923	2998	89	26	105	0	3218
16924	126	3169	28	90	0	3413
16925	3137	107	25	83	0	3352
16926	149	40	27	3068	0	3284
16927	3052	33	22	132	0	3239
16928	149	3136	26	87	0	3398
16929	3198	99	28	87	0	3412
16930	137	27	3042	98	0	3304
16931	64	25	107	3249	0	3445
16932	3004	21	45	150	0	3220
16933	3161	29	42	114	0	3346
16934	159	30	55	3196	0	3440
16935	82	26	3018	182	0	3308
16936	60	2794	128	235	0	3217
16937	84	3161	67	100	0	3412
16938	3071	112	54	111	0	3348
16939	149	54	58	3100	0	3361
16940	87	42	68	3293	0	3490
16941	3133	47	54	197	0	3431
16942	3227	46	51	122	0	3446
16943	193	33	3041	124	0	3391
16944	136	37	90	3227	0	3490
16945	112	29	3010	221	0	3372
16946	94	3144	109	174	0	3521
16947	2741	122	85	146	0	3094
16948	130	3018	74	180	0	3402
16949	90	3128	96	151	0	3465
16950	102	122	90	3210	0	3524
16951	2903	68	82	232	0	3285
16952	194	3048	92	128	0	3462
16953	2904	152	66	164	0	3286
16954	163	3006	102	144	0	3415
16955	116	155	82	3179	0	3532
16956	3105	72	55	247	0	3479
16957	210	88	2972	145	0	3415
16958	190	62	118	3187	0	3557
16959	126	84	2904	262	0	3376
16960	138	2741	156	169	0	3204
16961	105	3132	77	170	0	3484
16962	2714	154	91	176	0	3135
16963	157	3107	100	180	0	3544
16964	3006	167	107	156	0	3436
16965	3203	89	111	169	0	3572
16966	200	98	3012	148	0	3458
16967	3164	88	177	130	0	3559
16968	226	113	2977	140	0	3456
16969	152	3093	150	164	0	3559
16970	2983	157	110	163	0	3413
16971	220	3089	79	161	0	3549
16972	165	162	67	3176	0	3570
16973	3188	134	60	217	0	3599
16974	205	109	57	3250	0	3621
16975	135	105	3023	261	0	3524
16976	128	130	149	3127	0	3534
16977	140	105	83	3339	0	3667
16978	3234	105	97	203	0	3639
16979	212	128	3016	181	0	3537
16980	3108	84	163	172	0	3527
16981	3289	100	103	116	0	3608
16982	256	107	105	3147	0	3615
16983	160	118	113	3311	0	3702
16984	1933	44	43	112	0	2132
16985	135	1951	40	71	0	2197
16986	97	121	27	1978	0	2223
16987	110	38	1836	122	0	2106
16988	73	84	1851	75	0	2083
16989	77	1944	70	69	0	2160
16990	85	115	34	1846	0	2080
16991	74	71	34	1959	0	2138
16992	1875	71	44	129	0	2119
16993	150	44	45	1905	0	2144
16994	1772	77	53	129	0	2031
16995	142	1783	27	96	0	2048
16996	117	1782	42	67	0	2008
16997	74	1949	50	87	0	2160
16998	1962	95	40	100	0	2197
16999	693	3	1	4	0	701
17000	9	686	2	2	0	699
17001	572	2	4	0	0	578
17002	2	566	0	1	0	569
17003	1	5	0	561	0	567
17004	2	554	2	2	0	560
17005	569	2	2	2	0	575
17006	569	0	0	1	0	570
17007	3	0	1	559	0	563
17008	555	1	1	3	0	560
17009	2	1	0	570	0	573
17010	1	582	1	3	0	587
17011	1	5	0	590	0	596
17012	1	595	1	2	0	599
17013	604	1	0	0	0	605
17014	3	0	592	0	0	595
17015	576	1	4	1	0	582
17016	2	0	0	596	0	598
17017	2	0	592	2	0	596
17018	582	1	2	0	0	585
17019	2	1	626	1	0	630
17020	0	0	3	603	0	606
17021	1	0	1	616	0	618
17022	0	1	0	606	0	607
17023	0	0	1	612	0	613
17024	0	593	2	8	0	603
17025	2	2	0	615	0	619
17026	608	0	0	4	0	612
17027	2	0	605	0	0	607
17028	0	614	2	1	0	617
17029	636	3	0	1	0	640
17030	676	2	0	0	0	678
17031	4	0	1	766	0	771
17032	2	0	764	5	0	771
17033	1	1	5	764	0	771
17034	1	0	1	850	0	852
17035	0	1	837	9	0	847
17036	1	887	10	1	0	899
17037	918	15	2	0	0	935
17038	939	3	0	1	0	943
17039	945	2	1	0	0	948
17040	17	0	1	931	0	949
17041	6	1	0	964	0	971
17042	973	0	0	17	0	990
17043	15	1	0	935	0	951
17044	5	955	1	12	0	973
17045	993	14	0	5	0	1012
17046	1055	2	2	4	0	1063
17047	1090	2	3	1	0	1096
17048	1096	2	0	0	0	1098
17049	23	1	1046	2	0	1072
17050	8	2	1056	0	0	1066
17051	6	0	19	1049	0	1074
17052	2	0	6	1082	0	1090
17053	4	2	1051	20	0	1077
17054	3	1	1062	6	0	1072
17055	0	0	17	1059	0	1076
17056	1057	3	8	14	0	1082
17057	18	0	2	1046	0	1066
17058	9	0	1035	17	0	1061
17059	5	1039	18	5	0	1067
17060	1046	15	7	3	0	1071
17061	1058	4	5	4	0	1071
17062	1049	3	2	1	0	1055
17063	1029	0	2	6	0	1037
17064	19	2	981	2	0	1004
17065	8	1	17	987	0	1013
17066	982	0	6	17	0	1005
17067	20	0	5	980	0	1005
17068	8	1	1	964	0	974
17069	10	958	4	20	0	992
17070	3	16	4	973	0	996
17071	963	5	2	19	0	989
17072	20	963	1	6	0	990
17073	958	16	2	6	0	982
17074	21	952	3	3	0	979
17075	9	18	2	898	0	927
17076	6	916	3	17	0	942
17077	9	936	1	8	0	954
17078	935	16	4	3	0	958
17079	19	8	911	7	0	945
17080	9	5	888	3	0	905
17081	6	1	873	11	0	891
17082	839	2	20	8	0	869
17083	14	874	12	5	0	905
17084	9	882	7	4	0	902
17085	838	21	4	5	0	868
17086	24	833	2	5	0	864
17087	13	849	4	5	0	871
17088	5	18	5	851	0	879
17089	7	13	831	22	0	873
17090	9	5	837	8	0	859
17091	9	3	19	833	0	864
17092	824	6	11	16	0	857
17093	23	835	7	6	0	871
17094	14	15	4	833	0	866
17095	13	6	814	18	0	851
17096	14	6	790	4	0	814
17097	5	5	20	779	0	809
17098	778	4	12	17	0	811
17099	791	6	3	11	0	811
17100	22	2	767	14	0	805
17101	776	4	23	5	0	808
17102	19	4	777	8	0	808
17103	14	2	20	741	0	777
17104	12	766	7	18	0	803
17105	780	15	5	11	0	811
17106	19	11	8	775	0	813
17107	10	10	6	779	0	805
17108	12	3	4	793	0	812
17109	10	3	5	785	0	803
17110	9	4	736	22	0	771
17111	11	732	21	9	0	773
17112	12	12	8	733	0	765
17113	725	7	8	22	0	762
17114	24	4	7	728	0	763
17115	11	3	6	746	0	766
17116	6	6	705	24	0	741
17117	5	11	715	14	0	745
17118	6	698	16	21	0	741
17119	10	698	10	6	0	724
17120	4	26	9	685	0	724
17121	683	10	6	21	0	720
17122	19	8	675	13	0	715
17123	12	675	20	8	0	715
17124	5	23	9	651	0	688
17125	7	665	5	13	0	690
17126	8	23	4	639	0	674
17127	9	660	6	20	0	695
17128	11	15	10	625	0	661
17129	608	10	8	18	0	644
17130	19	570	9	7	0	605
17131	8	16	3	475	0	502
17132	468	6	4	16	0	494
17133	14	472	2	8	0	496
17134	4	368	2	9	0	383
17135	9	356	1	12	0	378
17136	7	12	4	301	0	324
17137	2	3	7	295	0	307
17138	4	283	1	8	0	296
17139	1	10	1	282	0	294
17140	4	3	285	6	0	298
17141	0	278	4	3	0	285
17142	1	21	0	231	0	253
17143	2	245	4	2	0	253
17144	1	4	243	4	0	252
17145	2	207	3	3	0	215
17146	130	6	0	7	0	143
17147	0	1	0	130	0	131
17148	132	0	0	0	0	132
17149	0	0	131	1	0	132
17150	0	0	0	138	0	138
17151	0	0	150	1	0	151
17152	0	0	0	153	0	153
17153	166	0	1	0	0	167
17154	0	1	0	166	0	167
17155	162	0	0	1	0	163
17156	1	171	0	0	0	172
17157	171	0	0	1	0	172
17158	0	0	176	1	0	177
17159	0	201	1	0	0	202
17160	0	0	1	204	0	205
17161	0	1	0	205	0	206
17162	0	0	203	0	0	203
17163	0	199	0	1	0	200
17164	1	0	0	203	0	204
17165	6	196	1	0	0	203
17166	0	1	0	201	0	202
17167	0	202	0	1	0	203
17168	201	1	0	1	0	203
17169	0	0	0	209	0	209
17170	0	1	212	0	0	213
17171	0	220	0	1	0	221
17172	1	223	0	0	0	224
17173	0	2	222	0	0	224
17174	0	223	1	1	0	225
17175	0	0	0	232	0	232
17176	0	1	230	0	0	231
17177	0	0	0	229	0	229
17178	0	0	0	234	0	234
17179	0	0	230	0	0	230
17180	219	0	2	0	0	221
17181	0	0	0	236	0	236
17182	0	0	260	0	0	260
17183	0	253	0	0	0	253
17184	261	0	0	0	0	261
17185	0	255	0	0	0	255
17186	0	0	0	263	0	263
17187	254	0	2	0	0	256
17188	0	0	0	251	0	251
17189	0	0	256	0	0	256
17190	0	0	0	266	0	266
17191	0	0	263	0	0	263
17192	263	0	0	0	0	263
17193	0	0	270	0	0	270
17194	286	0	0	0	0	286
17195	286	0	0	0	0	286
17196	0	0	297	0	0	297
17197	0	0	295	0	0	295
17198	0	295	0	0	0	295
17199	309	0	0	0	0	309
17200	0	0	0	317	0	317
17201	0	0	0	319	0	319
17202	341	0	0	0	0	341
17203	347	0	0	0	0	347
17204	343	0	0	0	0	343
17205	342	0	0	0	0	342
17206	0	0	0	338	0	338
17207	347	0	0	0	0	347
17208	0	0	0	350	0	350
17209	0	0	0	346	0	346
17210	0	0	0	349	0	349
17211	0	0	348	0	0	348
17212	0	343	0	0	0	343
17213	0	350	0	0	0	350
17214	0	0	0	356	0	356
17215	359	0	0	0	0	359
17216	0	0	0	352	0	352
17217	350	0	0	0	0	350
17218	0	0	374	2	0	376
17219	370	0	0	0	0	370
17220	0	0	0	390	0	390
17221	407	0	0	0	0	407
17222	404	0	0	0	0	404
17223	428	0	0	0	0	428
17224	0	0	0	432	0	432
17225	0	0	439	0	0	439
17226	0	0	0	437	0	437
17227	437	0	0	0	0	437
17228	2	0	503	0	0	505
17229	0	0	0	533	0	533
17230	556	0	1	0	0	557
17231	1	0	565	0	0	566
17232	587	0	1	0	0	588
17233	614	0	0	0	0	614
17234	3	0	0	617	0	620
17235	1	0	0	624	0	625
17236	629	0	0	7	0	636
17237	3	0	0	669	0	672
17238	670	0	0	5	0	675
17239	4	671	0	0	0	675
17240	0	672	1	1	0	674
17241	2	5	1	684	0	692
17242	1	1	682	5	0	689
17243	0	690	4	0	0	694
17244	683	5	0	1	0	689
17245	4	670	0	3	0	677
17246	0	6	699	0	0	705
17247	1	0	4	704	0	709
17248	1	2	709	7	0	719
17249	4	720	6	0	0	730
17250	0	5	0	733	0	738
17251	2	708	0	4	0	714
17252	0	6	727	0	0	733
17253	0	0	5	704	0	709
17254	0	1	735	5	0	741
17255	0	0	6	730	0	736
17256	735	0	1	6	0	742
17257	5	1	722	0	0	728
17258	696	1	5	1	0	703
17259	6	0	726	1	0	733
17260	0	0	6	724	0	730
17261	1	1	766	7	0	775
17262	1	0	6	776	0	783
17263	0	1	0	787	0	788
17264	1	0	2	785	0	788
17265	1	0	0	788	0	789
17266	0	0	840	10	0	850
17267	827	1	5	2	0	835
17268	5	0	0	889	0	894
17269	890	1	0	6	0	897
17270	911	0	1	0	0	912
17271	908	1	0	2	0	911
17272	6	1	1	930	0	938
17273	1	0	0	961	0	962
17274	2	1059	1	6	0	1068
17275	1161	10	1	1	0	1173
17276	1261	0	1	2	0	1264
17277	1293	4	1	1	0	1299
17278	25	1	1289	1	0	1316
17279	8	0	21	1285	0	1314
17280	6	0	1284	21	0	1311
17281	1289	1	25	3	0	1318
17282	1306	0	5	6	0	1317
17283	23	2	4	1289	0	1318
17284	7	1	3	1291	0	1302
17285	11	1314	0	18	0	1343
17286	1344	20	1	8	0	1373
17287	1353	2	1	8	0	1364
17288	25	1319	1	6	0	1351
17289	1349	23	2	0	0	1374
17290	28	2	1	1348	0	1379
17291	5	4	1	1379	0	1389
17292	1370	2	0	25	0	1397
17293	23	1	1361	7	0	1392
17294	1351	1	19	8	0	1379
17295	1374	0	2	3	0	1379
17296	25	1337	4	1	0	1367
17297	1356	22	1	2	0	1381
17298	28	2	1349	0	0	1379
17299	7	6	18	1355	0	1386
17300	1370	1	2	24	0	1397
17301	26	0	6	1356	0	1388
17302	4	0	1356	27	0	1387
17303	7	1	21	1341	0	1370
17304	4	1412	2	29	0	1447
17305	2	24	6	1448	0	1480
17306	3	3	0	1478	0	1484
17307	4	5	1	1470	0	1480
17308	2	3	0	1481	0	1486
17309	2	1	1442	35	0	1480
17310	2	2	21	1463	0	1488
17311	1460	1	6	29	0	1496
17312	24	1443	6	4	0	1477
17313	4	22	1	1477	0	1504
17314	8	4	1497	27	0	1536
17315	3	5	19	1501	0	1528
17316	1517	3	4	30	0	1554
17317	2485	1	5	5	0	2496
17318	2398	0	6	5	0	2409
17319	33	2	0	2432	0	2467
17320	14	1	2436	21	0	2472
17321	10	2381	21	8	0	2420
17322	2454	22	3	7	0	2486
17323	23	2	6	2397	0	2428
17324	5	5	3	2450	0	2463
17325	10	2	2413	28	0	2453
17326	10	2346	23	11	0	2390
17327	4	2428	5	9	0	2446
17328	3	29	7	2383	0	2422
17329	8	10	2325	21	0	2364
17330	2178	11	22	9	0	2220
17331	29	3	2305	10	0	2347
17332	2160	2	25	7	0	2194
17333	26	4925	10	11	0	4972
17334	11	20	5105	4	0	5140
17335	4677	4	19	5	0	4705
17336	29	5030	10	5	0	5074
17337	5246	23	7	3	0	5279
17338	29	5	5205	7	0	5246
17339	11	5030	25	7	0	5073
17340	5372	20	4	3	0	5399
17341	30	9	5146	4	0	5189
17342	5119	7	23	4	0	5153
17343	25	2	5	5295	0	5327
17344	5398	2	5	22	0	5427
17345	25	1	3	5302	0	5331
17346	5353	5	1	23	0	5382
17347	28	3	5257	13	0	5301
17348	7	6	19	5189	0	5221
17349	9	1	3	5319	0	5332
17350	5	3	5246	26	0	5280
17351	5	3	23	5058	0	5089
17352	3	4655	30	34	0	4722
17353	6	18	5	5445	0	5474
17354	2	5	3	5399	0	5409
17355	7	5	0	5535	0	5547
17356	4	7	5462	31	0	5504
17357	5047	2	27	17	0	5093
17358	29	5	6	5723	0	5763
17359	6	3	5717	33	0	5759
17360	5369	1	32	6	0	5408
17361	5716	3	6	11	0	5736
17362	5840	2	8	7	0	5857
17363	40	5	4	5785	0	5834
17364	13	3	4	6015	0	6035
17365	14	3	3	6055	0	6075
17366	7	5795	5	48	0	5855
17367	6090	33	2	23	0	6148
17368	5877	6	6	18	0	5907
17369	44	5	5	5889	0	5943
17370	19	8	5792	44	0	5863
17371	27	6	5618	10	0	5661
17372	8	5673	51	15	0	5747
17373	5	3041	11	2805	0	5862
17374	5796	40	10	9	0	5855
17375	32	5411	7	7	0	5457
17376	6513	24	6	7	0	6550
17377	6447	3	3	7	0	6460
17378	6390	5	3	5	0	6403
17379	47	5	2	6218	0	6272
17380	16	4	1	6474	0	6495
17381	6541	3	2	37	0	6583
17382	46	3	1	6510	0	6560
17383	15	7	6383	45	0	6450
17384	6374	1	38	9	0	6422
17385	36	4	6	6481	0	6527
17386	12	8	8	6344	0	6372
17387	12	5	0	6571	0	6588
17388	9	8	6355	46	0	6418
17389	5665	1	40	19	0	5725
17390	43	3	6303	20	0	6369
17391	11	0	42	6258	0	6311
17392	21	2	6361	41	0	6425
17393	13	2	50	6192	0	6257
17394	18	5	7	6288	0	6318
17395	11	7	6356	43	0	6417
17396	19	8	43	5927	0	5997
17397	21	6077	19	49	0	6166
17398	6278	34	9	21	0	6342
17399	6097	6	12	27	0	6142
17400	55	8	11	6169	0	6243
17401	27	5	6269	59	0	6360
17402	20	5696	55	27	0	5798
17403	16	6172	18	25	0	6231
17404	6254	45	17	20	0	6336
17405	51	15	5995	19	0	6080
17406	5989	6	50	16	0	6061
17407	50	5	12	6115	0	6182
17408	17	7	22	6186	0	6232
17409	6154	6	10	57	0	6227
17410	50	5978	20	41	0	6089
17411	26	42	5942	34	0	6044
17412	20	13	51	5545	0	5629
17413	13	16	5983	64	0	6076
17414	16	5746	57	26	0	5845
17415	16	46	14	6100	0	6176
17416	6033	9	18	55	0	6115
17417	4984	14	18	24	0	5040
17418	60	13	5056	28	0	5157
17419	29	4915	59	20	0	5023
17420	5160	38	19	24	0	5241
17421	58	5025	25	14	0	5122
17422	31	55	10	5123	0	5219
17423	5159	11	19	58	0	5247
17424	55	20	10	5066	0	5151
17425	27	7	5058	69	0	5161
17426	25	15	55	4963	0	5058
17427	19	12	5037	67	0	5135
17428	28	14	49	4839	0	4930
17429	5069	7	15	73	0	5164
17430	54	4927	32	25	0	5038
17431	5055	45	15	32	0	5147
17432	57	17	26	4825	0	4925
17433	27	17	19	2601	0	2664
17434	28	15	2457	63	0	2563
17435	18	24	2542	30	0	2614
17436	29	2509	54	31	0	2623
17437	24	46	2478	28	0	2576
17438	2379	16	61	26	0	2482
17439	47	2437	21	26	0	2531
17440	25	2437	18	37	0	2517
17441	30	2464	9	21	0	2524
17442	23	57	21	2434	0	2535
17443	27	21	2406	60	0	2514
17444	17	2430	47	45	0	2539
17445	26	49	25	2222	0	2322
17446	19	2437	17	52	0	2525
17447	2398	49	22	27	0	2496
17448	2419	17	19	29	0	2484
17449	59	22	21	2387	0	2489
17450	32	13	15	2427	0	2487
17451	2330	15	17	63	0	2425
17452	52	2296	19	29	0	2396
17453	26	2319	19	38	0	2402
17454	24	61	16	2257	0	2358
17455	17	25	2035	56	0	2133
17456	15	2039	45	23	0	2122
17457	1895	53	22	29	0	1999
17458	40	1851	25	20	0	1936
17459	21	1848	17	25	0	1911
17460	1743	48	25	16	0	1832
17461	31	2520	15	18	0	2584
17462	27	46	2483	18	0	2574
17463	31	3486	40	22	0	3579
17464	3446	46	14	17	0	3523
17465	31	3301	17	18	0	3367
17466	3401	32	12	26	0	3471
17467	40	15	12	3359	0	3426
17468	14	24	13	3414	0	3465
17469	28	16	3336	35	0	3415
17470	9	3258	28	30	0	3325
17471	13	32	17	3415	0	3477
17472	3387	25	12	30	0	3454
17473	3355	26	4	22	0	3407
17474	30	3287	19	21	0	3357
17475	26	38	12	3452	0	3528
17476	2534	2	0	8	0	2544
17477	2498	2	0	1	0	2501
17478	10	1	2465	2	0	2478
17479	2	4	2275	2	0	2283
17480	1	6	2315	2	0	2324
17481	1	2338	5	1	0	2345
17482	2379	3	5	1	0	2388
17483	4	2267	4	0	0	2275
17484	2347	4	1	2	0	2354
17485	4	2304	1	1	0	2310
17486	0	3	0	2383	0	2386
17487	2392	1	0	4	0	2397
17488	4	0	2368	1	0	2373
17489	2261	0	4	0	0	2265
17490	2408	0	0	0	0	2408
17491	5	2316	0	3	0	2324
17492	0	2342	1	0	0	2343
17493	2421	5	0	0	0	2426
17494	5	1	2393	0	0	2399
17495	2328	2	6	0	0	2336
17496	2391	0	2	3	0	2396
17497	2	1	2	2387	0	2392
17498	2436	0	1	1	0	2438
17499	1	1	1	2378	0	2381
17500	0	2	1	2389	0	2392
17501	1	2	0	2424	0	2427
17502	0	2350	0	2	0	2352
17503	2443	2	2	1	0	2448
17504	2420	2	1	0	0	2423
17505	2	2	0	2399	0	2403
17506	1	4	1	2374	0	2380
17507	1	2338	2	3	0	2344
17508	2434	1	0	2	0	2437
17509	3	3	2348	3	0	2357
17510	2	2	1	2383	0	2388
17511	8	0	2362	3	0	2373
17512	2	3	2	2321	0	2328
17513	3	3	2392	3	0	2401
17514	1	0	1	2241	0	2243
17515	2326	2	2	3	0	2333
17516	4	2	2328	1	0	2335
17517	2182	1	2	1	0	2186
17518	2	2323	4	1	0	2330
17519	2	5	1	2440	0	2448
17520	3	1	0	2447	0	2451
17521	2487	2	3	3	0	2495
17522	2	3	1	2464	0	2470
17523	6	2	2499	2	0	2509
17524	2308	3	2	1	0	2314
17525	2432	3	1	2	0	2438
17526	2471	4	0	1	0	2476
17527	2475	2	1	4	0	2482
17528	2	2385	1	3	0	2391
17529	2	2	1	2519	0	2524
17530	2526	1	2	5	0	2534
17531	1	5	1	2442	0	2449
17532	2480	1	3	2	0	2486
17533	6	1	2449	4	0	2460
17534	3	2	2416	3	0	2424
17535	8	10	5	2223	0	2246
17536	3	2320	3	3	0	2329
17537	0	2418	2	2	0	2422
17538	2445	0	1	2	0	2448
17539	2	3	2426	1	0	2432
17540	2140	3	3	3	0	2149
17541	3	2358	2	0	0	2363
17542	2474	1	1	0	0	2476
17543	0	2	0	2403	0	2405
17544	2	1	2478	3	0	2484
17545	2	2	0	2345	0	2349
17546	2	0	0	2433	0	2435
17547	2	2401	5	0	0	2408
17548	3	2436	2	2	0	2443
17549	1	2	0	2507	0	2510
17550	2	2431	1	3	0	2437
17551	4	2	2327	2	0	2335
17552	2	8	2284	2	0	2296
17553	2052	2	5	6	0	2065
17554	2363	0	1	1	0	2365
17555	2	2321	5	1	0	2329
17556	2	1	0	2375	0	2378
17557	0	2	1	2378	0	2381
17558	2	1	2366	2	0	2371
17559	2	1	2	2218	0	2223
17560	1	2215	6	3	0	2225
17561	3	1	1569	0	0	1573
17562	1	3	1586	1	0	1591
17563	0	688	3	1	0	692
17564	2	1	719	2	0	724
17565	0	1	1	715	0	717
17566	1	0	1	696	0	698
17567	0	1	746	3	0	750
17568	0	2	1	734	0	737
17569	0	720	1	1	0	722
17570	0	751	1	2	0	754
17571	0	11	0	752	0	763
17572	1	1	784	4	0	790
17573	1	786	5	2	0	794
17574	0	5	10	791	0	806
17575	0	2	783	3	0	788
17576	759	1	4	1	0	765
17577	797	1	0	0	0	798
17578	795	1	1	0	0	797
17579	3	1	0	784	0	788
17580	0	0	1	796	0	797
17581	0	1	827	4	0	832
17582	0	0	4	819	0	823
17583	2	0	1	835	0	838
17584	1	1	830	4	0	836
17585	740	0	5	0	0	745
17586	5	771	1	0	0	777
17587	782	5	0	1	0	788
17588	4	775	1	2	0	782
17589	0	4	1	792	0	797
17590	0	0	792	6	0	798
17591	1	0	3	782	0	786
17592	5	0	786	5	0	796
17593	696	0	5	1	0	702
17594	13	0	717	0	0	730
17595	0	0	4	697	0	701
17596	0	1	729	4	0	734
17597	0	710	6	0	0	716
17598	0	4	1	752	0	757
17599	0	0	0	768	0	768
17600	0	0	0	780	0	780
17601	1	0	784	4	0	789
17602	0	0	790	0	0	790
17603	0	1	4	799	0	804
17604	3	3	2	3320	0	3328
17605	1	2	2	3781	0	3786
17606	3588	1	0	386	0	3975
17607	231	0	0	3912	0	4143
17608	177	0	3658	315	0	4150
17609	3935	0	228	201	0	4364
17610	253	1	170	4015	0	4439
17611	4140	0	71	266	0	4477
17612	5022	0	16	205	0	5243
17613	430	0	8	4889	0	5327
17614	5029	0	11	285	0	5325
17615	5125	0	7	209	0	5341
17616	448	2	4607	113	0	5170
17617	277	4681	252	50	0	5260
17618	139	229	170	4288	0	4826
17619	53	162	68	5005	0	5288
17620	4765	74	28	443	0	5310
17621	4908	16	17	289	0	5230
17622	5124	9	16	172	0	5321
17623	553	11	4539	75	0	5178
17624	345	4651	251	58	0	5305
17625	4726	248	197	73	0	5244
17626	330	4840	90	47	0	5307
17627	4939	314	24	51	0	5328
17628	388	197	23	4749	0	5357
17629	4897	97	20	283	0	5297
17630	4994	33	16	219	0	5262
17631	5186	26	41	119	0	5372
17632	569	51	4549	53	0	5222
17633	4878	43	243	81	0	5245
17634	404	4654	187	89	0	5334
17635	5013	271	90	72	0	5446
17636	5070	201	31	84	0	5386
17637	5251	86	40	73	0	5450
17638	621	42	50	5132	0	5845
17639	392	5529	36	275	0	6232
17640	5825	284	33	210	0	6352
17641	417	235	5365	118	0	6135
17642	344	5599	252	86	0	6281
17643	238	309	174	4728	0	5449
17644	195	5642	113	246	0	6196
17645	5678	353	53	184	0	6268
17646	5883	236	42	127	0	6288
17647	571	127	49	5617	0	6364
17648	422	63	5311	318	0	6114
17649	236	5505	271	249	0	6261
17650	250	359	285	3254	0	4148
17651	196	245	105	5175	0	5721
17652	180	134	62	5813	0	6189
17653	5691	89	62	461	0	6303
17654	5883	92	35	303	0	6313
17655	6034	75	47	172	0	6328
17656	6169	92	44	109	0	6414
17657	659	79	43	5690	0	6471
17658	413	74	5416	426	0	6329
17659	250	67	281	5974	0	6572
17660	245	73	214	6107	0	6639
17661	280	78	111	6304	0	6773
17662	393	75	118	6306	0	6892
17663	5916	63	138	783	0	6900
17664	521	68	235	6102	0	6926
17665	6133	51	91	556	0	6831
17666	6306	55	44	549	0	6954
17667	898	52	5576	359	0	6885
17668	748	53	5643	286	0	6730
17669	500	48	5879	383	0	6810
17670	503	63	609	5672	0	6847
17671	458	143	5825	404	0	6830
17672	312	143	546	5771	0	6772
17673	235	232	293	6101	0	6861
17674	5862	101	161	841	0	6965
17675	645	57	105	5853	0	6660
17676	697	5546	104	560	0	6907
17677	5888	290	179	364	0	6721
17678	701	5838	172	225	0	6936
17679	465	469	5723	240	0	6897
17680	320	6118	401	177	0	7016
17681	6036	537	234	200	0	7007
17682	588	430	143	5888	0	7049
17683	672	199	5552	495	0	6918
17684	6005	78	371	515	0	6969
17685	792	119	285	5887	0	7083
17686	688	81	5737	414	0	6920
17687	527	91	449	5969	0	7036
17688	378	160	428	5938	0	6904
17689	478	173	189	5923	0	6763
17690	408	5802	98	651	0	6959
17691	6106	363	92	433	0	6994
17692	788	267	79	5613	0	6747
17693	627	5737	79	505	0	6948
17694	370	420	108	6044	0	6942
17695	310	461	5608	520	0	6899
17696	407	5841	415	367	0	7030
17697	5681	438	442	278	0	6839
17698	5890	527	220	225	0	6862
17699	716	279	113	5688	0	6796
17700	563	269	128	6039	0	6999
17701	6011	135	142	681	0	6969
17702	5661	118	178	552	0	6509
17703	687	5755	216	484	0	7142
17704	2872	44	13	59	0	2988
17705	70	15	2793	47	0	2925
17706	66	18	2708	45	0	2837
17707	39	2660	44	64	0	2807
17708	45	2666	29	38	0	2778
17709	2424	53	43	50	0	2570
17710	51	2498	25	33	0	2607
17711	2479	44	25	49	0	2597
17712	1802	37	21	27	0	1887
17713	1821	17	15	38	0	1891
17714	47	21	21	1835	0	1924
17715	1820	33	20	37	0	1910
17716	69	24	1723	42	0	1858
17717	45	9	1746	33	0	1833
17718	39	1773	49	28	0	1889
17719	35	37	1778	40	0	1890
17720	42	12	38	1791	0	1883
17721	29	10	1740	77	0	1856
17722	28	20	1764	51	0	1863
17723	47	11	41	1823	0	1922
17724	1830	18	23	52	0	1923
17725	1845	31	18	37	0	1931
17726	59	19	1816	41	0	1935
17727	1866	21	54	27	0	1968
17728	49	22	1866	28	0	1965
17729	1877	20	59	23	0	1979
17730	1920	27	24	29	0	2000
17731	67	10	18	1928	0	2023
17732	42	24	16	1880	0	1962
17733	52	1760	30	48	0	1890
17734	47	1879	27	31	0	1984
17735	56	38	21	1895	0	2010
17736	47	17	27	2530	0	2621
17737	2477	21	26	69	0	2593
17738	20	1536	4	5	0	1565
17739	1508	21	1	4	0	1534
17740	22	1534	3	3	0	1562
17741	4	22	1525	2	0	1553
17742	2	3	17	1554	0	1576
17743	1547	3	4	18	0	1572
17744	1560	2	4	5	0	1571
17745	22	1563	2	8	0	1595
17746	9	1597	3	3	0	1612
17747	7	1630	2	2	0	1641
17748	5	35	3	1741	0	1784
17749	8	9	1752	26	0	1795
17750	10	1767	20	8	0	1805
17751	10	27	7	1821	0	1865
17752	7	11	7	1878	0	1903
17753	5	12	1824	27	0	1868
17754	4	5	1842	13	0	1864
17755	1870	6	24	9	0	1909
17756	35	9	1860	3	0	1907
17757	1897	9	28	3	0	1937
17758	1875	13	4	12	0	1904
17759	1887	12	5	13	0	1917
17760	1883	13	3	10	0	1909
17761	32	15	1777	8	0	1832
17762	15	1817	35	6	0	1873
17763	6	37	14	1846	0	1903
17764	4	11	1813	41	0	1869
17765	12	6	29	1787	0	1834
17766	19	1778	18	28	0	1843
17767	15	30	15	1830	0	1890
17768	14	20	8	1833	0	1875
17769	12	20	7	1856	0	1895
17770	1841	8	7	39	0	1895
17771	40	5	12	1841	0	1898
17772	22	11	14	1839	0	1886
17773	24	16	7	1843	0	1890
17774	9	1768	12	46	0	1835
17775	1769	33	14	26	0	1842
17776	27	1677	29	16	0	1749
17777	17	1697	24	15	0	1753
17778	23	32	15	1726	0	1796
17779	24	17	8	1746	0	1795
17780	1725	10	5	42	0	1782
17781	45	15	3	1740	0	1803
17782	1749	10	6	37	0	1802
17783	1983	15	11	24	0	2033
17784	34	17	14	1988	0	2053
17785	17	18	13	1960	0	2008
17786	12	1990	11	58	0	2071
17787	2026	34	10	49	0	2119
17788	43	2098	8	28	0	2177
17789	2124	55	17	23	0	2219
17790	53	24	2064	35	0	2176
17791	2120	12	36	37	0	2205
17792	2168	6	22	23	0	2219
17793	77	10	8	2121	0	2216
17794	44	7	2050	64	0	2165
17795	31	2074	38	40	0	2183
17796	30	41	15	2137	0	2223
17797	24	31	2075	60	0	2190
17798	21	36	36	2139	0	2232
17799	2123	33	21	54	0	2231
17800	49	26	2051	40	0	2166
17801	31	2060	38	43	0	2172
17802	26	2115	31	24	0	2196
17803	28	54	18	1869	0	1969
17804	31	2061	8	62	0	2162
17805	2090	40	9	31	0	2170
17806	2064	24	15	36	0	2139
17807	2068	22	13	39	0	2142
17808	56	25	1960	35	0	2076
17809	2025	26	41	29	0	2121
17810	60	27	23	1990	0	2100
17811	50	24	15	1999	0	2088
17812	30	20	21	2004	0	2075
17813	27	16	21	2033	0	2097
17814	32	20	1938	76	0	2066
17815	24	17	1939	54	0	2034
17816	22	10	1935	39	0	2006
17817	1897	21	54	28	0	2000
17818	67	1908	29	26	0	2030
17819	48	38	21	1916	0	2023
17820	1902	21	17	63	0	2003
17821	63	1878	15	44	0	2000
17822	45	1958	22	20	0	2045
17823	1927	58	18	22	0	2025
17824	1917	49	10	33	0	2009
17825	63	1896	15	30	0	2004
17826	25	50	25	1779	0	1879
17827	37	1846	16	48	0	1947
17828	1866	38	12	25	0	1941
17829	1823	23	18	34	0	1898
17830	1839	26	20	17	0	1902
17831	71	1784	13	33	0	1901
17832	40	40	13	1844	0	1937
17833	28	25	1754	71	0	1878
17834	21	22	31	1845	0	1919
17835	33	20	16	1871	0	1940
17836	3	7	1168	35	0	1213
17837	1171	3	25	19	0	1218
17838	26	3	19	1181	0	1229
17839	16	3	7	1177	0	1203
17840	7	1161	6	33	0	1207
17841	1150	21	4	18	0	1193
17842	28	11	4	1134	0	1177
17843	16	1151	4	26	0	1197
17844	1110	28	2	19	0	1159
17845	29	1102	2	9	0	1142
17846	1057	25	12	6	0	1100
17847	30	14	1030	6	0	1080
17848	18	6	920	5	0	949
17849	9	4	863	4	0	880
17850	8	846	30	1	0	885
17851	12	19	24	729	0	784
17852	4	774	4	19	0	801
17853	767	17	6	13	0	803
17854	16	14	756	6	0	792
17855	761	5	14	2	0	782
17856	737	3	11	6	0	757
17857	27	5	5	718	0	755
17858	735	3	9	14	0	761
17859	20	3	5	739	0	767
17860	20	2	711	18	0	751
17861	719	1	17	15	0	752
17862	19	714	12	11	0	756
17863	16	18	6	724	0	764
17864	722	10	5	22	0	759
17865	17	5	6	730	0	758
17866	18	4	703	18	0	743
17867	7	5	12	711	0	735
17868	3	705	12	19	0	739
17869	714	15	3	12	0	744
17870	18	14	3	712	0	747
17871	721	4	3	18	0	746
17872	19	3	5	726	0	753
17873	20	4	1	714	0	739
17874	7	709	3	27	0	746
17875	707	15	2	16	0	740
17876	18	737	7	8	0	770
17877	12	17	1	698	0	728
17878	6	704	4	16	0	730
17879	697	17	5	13	0	732
17880	705	12	5	6	0	728
17881	692	6	2	8	0	708
17882	24	664	3	5	0	696
17883	5	409	0	1	0	415
17884	383	9	0	1	0	393
17885	12	393	0	0	0	405
17886	6	16	1	338	0	361
17887	2	2	313	9	0	326
17888	247	2	5	1	0	255
17889	258	0	0	0	0	258
17890	253	2	0	0	0	255
17891	2	251	0	2	0	255
17892	260	2	1	0	0	263
17893	4	1	273	0	0	278
17894	3	269	1	2	0	275
17895	2	4	1	255	0	262
17896	0	255	0	1	0	256
17897	250	1	0	0	0	251
17898	1	257	1	0	0	259
17899	0	1	0	249	0	250
17900	0	248	0	1	0	249
17901	0	1	0	252	0	253
17902	0	0	0	249	0	249
17903	0	0	256	1	0	257
17904	0	0	1	250	0	251
17905	256	0	0	1	0	257
17906	255	0	0	0	0	255
17907	1	0	0	259	0	260
17908	0	0	253	1	0	254
17909	0	0	1	251	0	252
17910	257	0	0	1	0	258
17911	266	0	0	0	0	266
17912	268	0	0	0	0	268
17913	2	273	0	0	0	275
17914	280	1	0	0	0	281
17915	1	0	275	0	0	276
17916	303	0	1	0	0	304
17917	1	0	0	312	0	313
17918	0	0	0	311	0	311
17919	0	0	0	309	0	309
17920	304	0	0	1	0	305
17921	292	0	0	0	0	292
17922	1	0	0	301	0	302
17923	0	0	335	1	0	336
17924	0	0	1	333	0	334
17925	0	0	0	342	0	342
17926	0	0	336	1	0	337
17927	0	339	1	0	0	340
17928	0	1	0	353	0	354
17929	359	0	0	1	0	360
17930	0	0	0	356	0	356
17931	0	0	0	357	0	357
17932	364	0	0	1	0	365
17933	1	362	0	1	0	364
17934	0	362	0	1	0	363
17935	369	1	0	0	0	370
17936	1	0	366	0	0	367
17937	367	0	1	0	0	368
17938	0	0	399	0	0	399
17939	0	410	1	0	0	411
17940	420	0	0	0	0	420
17941	430	0	0	0	0	430
17942	431	0	0	0	0	431
17943	435	0	0	0	0	435
17944	0	0	445	0	0	445
17945	0	0	0	456	0	456
17946	458	0	0	1	0	459
17947	0	0	473	0	0	473
17948	0	2	475	0	0	477
17949	0	481	1	0	0	482
17950	484	0	0	0	0	484
17951	0	0	0	480	0	480
17952	486	0	0	1	0	487
17953	1	492	0	0	0	493
17954	0	1	0	531	0	532
17955	0	1	0	528	0	529
17956	1	0	0	529	0	530
17957	0	0	550	1	0	551
17958	1	545	1	1	0	548
17959	607	1	1	0	0	609
17960	3	1	0	613	0	617
17961	616	0	0	3	0	619
17962	616	0	0	0	0	616
17963	4	0	0	609	0	613
17964	1	0	634	3	0	638
17965	0	0	5	630	0	635
17966	0	635	1	5	0	641
17967	1	3	0	645	0	649
17968	0	0	642	4	0	646
17969	630	0	5	1	0	636
17970	4	1	0	642	0	647
17971	643	0	0	4	0	647
17972	6	0	644	1	0	651
17973	628	0	5	0	0	633
17974	4	1	648	0	0	653
17975	632	0	4	1	0	637
17976	4	624	0	1	0	629
17977	0	647	1	1	0	649
17978	0	4	1	653	0	658
17979	0	1	0	649	0	650
17980	0	0	0	652	0	652
17981	656	0	0	5	0	661
17982	5	0	0	692	0	697
17983	0	0	692	4	0	696
17984	684	0	5	1	0	690
17985	5	711	1	0	0	717
17986	727	4	0	1	0	732
17987	721	1	0	0	0	722
17988	5	0	714	1	0	720
17989	0	0	6	705	0	711
17990	1	0	0	733	0	734
17991	0	1	745	5	0	751
17992	1	733	5	0	0	739
17993	740	5	1	0	0	746
17994	756	0	0	0	0	756
17995	5	0	1	774	0	780
17996	1	0	0	775	0	776
17997	0	1	0	810	0	811
17998	795	1	0	6	0	802
17999	6	803	0	2	0	811
18000	808	6	1	1	0	816
18001	806	0	0	2	0	808
18002	8	3	869	2	0	882
18003	0	1	11	859	0	871
18004	0	886	1	14	0	901
18005	1	10	0	897	0	908
18006	0	1	0	932	0	933
18007	2	0	933	12	0	947
18008	969	0	12	1	0	982
18009	1054	0	1	0	0	1055
18010	1104	0	0	1	0	1105
18011	16	0	0	1109	0	1125
18012	3	0	2	1111	0	1116
18013	1	1088	0	19	0	1108
18014	4	1142	0	3	0	1149
18015	1153	16	0	2	0	1171
18016	17	1118	2	6	0	1143
18017	3	16	1113	3	0	1135
18018	0	5	17	1143	0	1165
18019	1149	2	3	19	0	1173
18020	18	3	1141	5	0	1167
18021	6	2	1151	0	0	1159
18022	1160	1	24	2	0	1187
18023	1146	2	3	2	0	1153
18024	28	1	2	1123	0	1154
18025	4	1	1125	23	0	1153
18026	5	2	20	1142	0	1169
18027	5	1	1137	23	0	1166
18028	7	3	2088	9	0	2107
18029	5	2092	25	4	0	2126
18030	2155	23	6	3	0	2187
18031	2162	6	4	3	0	2175
18032	29	2114	6	6	0	2155
18033	12	21	3	2153	0	2189
18034	8	5	2	2126	0	2141
18035	6	3	2	2173	0	2184
18036	2173	5	5	24	0	2207
18037	27	2089	2	7	0	2125
18038	2128	24	1	8	0	2161
18039	2109	10	8	4	0	2131
18040	28	6	2082	6	0	2122
18041	11	2028	26	6	0	2071
18042	9	22	7	2106	0	2144
18043	7	4	2071	22	0	2104
18044	2030	2	26	8	0	2066
18045	2086	3	9	5	0	2103
18046	2095	3	2	7	0	2107
18047	2078	2	5	9	0	2094
18048	27	0	7	2061	0	2095
18049	13	3	2050	28	0	2094
18050	8	2	27	2027	0	2064
18051	2065	4	6	24	0	2099
18052	2073	7	6	6	0	2092
18053	31	2024	8	7	0	2070
18054	2036	21	6	7	0	2070
18055	25	10	2009	6	0	2050
18056	12	10	1989	7	0	2018
18057	1936	6	22	10	0	1974
18058	28	1948	11	9	0	1996
18059	16	18	2	1929	0	1965
18060	8	1902	3	16	0	1929
18061	13	18	1	1951	0	1983
18062	8	7	2	1940	0	1957
18063	3	5	6	1961	0	1975
18064	1937	6	4	24	0	1971
18065	1930	2	4	11	0	1947
18066	1923	2	4	4	0	1933
18067	29	2	1910	4	0	1945
18068	1846	3	18	3	0	1870
18069	30	0	7	1945	0	1982
18070	14	0	4	1970	0	1988
18071	10	1	1962	25	0	1998
18072	6	2	22	2601	0	2631
18073	2732	2	4	77	0	2815
18074	75	5	2679	28	0	2787
18075	26	3	64	2748	0	2841
18076	2765	6	22	72	0	2865
18077	2777	1	27	33	0	2838
18078	97	7	2732	33	0	2869
18079	62	3	2746	19	0	2830
18080	49	3	92	2754	0	2898
18081	2790	5	54	71	0	2920
18082	2792	3	33	38	0	2866
18083	104	8	14	2639	0	2765
18084	64	2658	10	73	0	2805
18085	2730	59	17	35	0	2841
18086	73	2688	17	39	0	2817
18087	42	82	9	2750	0	2883
18088	61	31	2668	79	0	2839
18089	38	33	2650	37	0	2758
18090	27	14	2703	40	0	2784
18091	24	14	102	2590	0	2730
18092	20	12	54	2712	0	2798
18093	2674	8	37	85	0	2804
18094	71	2623	28	65	0	2787
18095	2679	61	20	55	0	2815
18096	102	25	21	2541	0	2689
18097	39	2577	28	75	0	2719
18098	39	2677	14	44	0	2774
18099	27	90	8	2686	0	2811
18100	2653	55	7	79	0	2794
18101	78	2653	20	38	0	2789
18102	2571	70	18	38	0	2697
18103	88	2574	22	32	0	2716
18104	2608	89	20	23	0	2740
18105	107	44	2547	20	0	2718
18106	48	41	2502	30	0	2621
18107	58	2480	85	26	0	2649
18108	2453	70	64	14	0	2601
18109	77	2386	37	12	0	2512
18110	42	2349	21	17	0	2429
18111	57	86	22	2350	0	2515
18112	2360	55	24	65	0	2504
18113	76	2348	26	37	0	2487
18114	2335	72	16	33	0	2456
18115	94	2297	17	30	0	2438
18116	2299	85	17	20	0	2421
18117	95	2289	15	20	0	2419
18118	50	2348	9	25	0	2432
18119	58	92	11	2211	0	2372
18120	35	2295	17	55	0	2402
18121	2275	93	14	27	0	2409
18122	73	55	2224	39	0	2391
18123	47	53	52	2266	0	2418
18124	47	34	2278	69	0	2428
18125	25	28	76	2275	0	2404
18126	25	23	40	2363	0	2451
18127	19	25	2259	105	0	2408
18128	1314	21	63	73	0	1471
18129	82	1311	50	53	0	1496
18130	1366	63	46	44	0	1519
18131	103	1351	30	36	0	1520
18132	61	94	20	1373	0	1548
18133	1413	48	20	77	0	1558
18134	1420	51	29	43	0	1543
18135	1449	29	23	50	0	1551
18136	123	33	16	1385	0	1557
18137	103	27	12	1376	0	1518
18138	87	1374	21	77	0	1559
18139	1425	80	24	77	0	1606
18140	1490	45	18	58	0	1611
18141	1512	56	20	29	0	1617
18142	1516	29	19	33	0	1597
18143	133	1382	38	31	0	1584
18144	80	62	37	1428	0	1607
18145	65	54	1392	75	0	1586
18146	1438	55	65	42	0	1600
18147	1517	38	29	64	0	1648
18148	126	27	1399	42	0	1594
18149	96	37	1418	33	0	1584
18150	80	47	74	1396	0	1597
18151	44	48	52	1488	0	1632
18152	39	30	46	1531	0	1646
18153	1434	49	42	107	0	1632
18154	92	28	33	1485	0	1638
18155	56	28	1369	114	0	1567
18156	53	30	79	1467	0	1629
18157	42	27	1383	124	0	1576
18158	45	30	76	1425	0	1576
18159	46	31	37	1533	0	1647
18160	54	25	1448	106	0	1633
18161	1412	23	81	89	0	1605
18162	77	1464	52	57	0	1650
18163	1495	85	38	53	0	1671
18164	113	46	23	1519	0	1701
18165	1492	66	19	82	0	1659
18166	114	1508	10	69	0	1701
18167	73	1608	19	57	0	1757
18168	72	122	13	1699	0	1906
18169	64	76	1686	78	0	1904
18170	54	67	1716	50	0	1887
18171	67	1733	110	50	0	1960
18172	942	15	8	1	0	966
18173	9	7	3	940	0	959
18174	933	3	2	10	0	948
18175	10	920	2	7	0	939
18176	3	933	1	2	0	939
18177	7	18	2	920	0	947
18178	908	10	3	10	0	931
18179	909	2	0	6	0	917
18180	15	3	896	4	0	918
18181	11	2	869	1	0	883
18182	878	4	11	2	0	895
18183	11	881	6	1	0	899
18184	889	11	3	3	0	906
18185	16	6	2	882	0	906
18186	8	2	852	10	0	872
18187	845	1	14	4	0	864
18188	19	841	7	2	0	869
18189	9	859	2	1	0	871
18190	4	15	2	859	0	880
18191	856	6	2	13	0	877
18192	12	3	1	870	0	886
18193	868	3	3	13	0	887
18194	15	4	852	6	0	877
18195	829	4	10	4	0	847
18196	838	1	4	4	0	847
18197	19	0	803	4	0	826
18198	796	0	13	2	0	811
18199	14	789	7	3	0	813
18200	10	10	3	779	0	802
18201	5	795	4	12	0	816
18202	800	12	2	4	0	818
18203	16	5	2	773	0	796
18204	4	782	6	12	0	804
18205	8	10	0	777	0	795
18206	1	778	0	16	0	795
18207	3	13	1	786	0	803
18208	775	8	0	16	0	799
18209	14	3	1	781	0	799
18210	5	2	765	17	0	789
18211	766	4	11	6	0	787
18212	11	3	6	3590	0	3610
18213	7	5	3586	17	0	3615
18214	7	9	3206	10	0	3232
18215	4	4	3478	5	0	3491
18216	3	1	17	3461	0	3482
18217	2	4	10	3602	0	3618
18218	5	3	3	3553	0	3564
18219	1	2	4	3563	0	3570
18220	3704	0	7	17	0	3728
18221	3586	1	5	8	0	3600
18222	3634	2	4	5	0	3645
18223	3687	0	1	7	0	3695
18224	19	2	0	3628	0	3649
18225	8	4	3551	24	0	3587
18226	3463	1	12	9	0	3485
18227	3661	0	6	5	0	3672
18228	19	0	4	3632	0	3655
18229	12	1	1	3654	0	3668
18230	3719	0	2	19	0	3740
18231	15	1	3	3585	0	3604
18232	7	3525	5	19	0	3556
18233	3694	11	2	7	0	3714
18234	3478	4	0	6	0	3488
18235	16	5	3579	7	0	3607
18236	8	1	12	3482	0	3503
18237	8	1	5	3705	0	3719
18238	3731	2	4	15	0	3752
18239	3615	3	2	6	0	3626
18240	19	1	2	3636	0	3658
18241	11	1	3639	13	0	3664
18242	3	4	3477	11	0	3495
18243	4	1	15	3543	0	3563
18244	6	1	5	3597	0	3609
18245	3664	1	3	16	0	3684
18246	15	3530	4	10	0	3559
18247	3	3479	3	9	0	3494
18248	8	3613	4	4	0	3629
18249	2	16	2	3672	0	3692
18250	3643	8	8	12	0	3671
18251	3501	4	1	6	0	3512
18252	18	3484	1	7	0	3510
18253	3652	11	2	2	0	3667
18254	12	6	0	3606	0	3624
18255	6	5	3517	12	0	3540
18256	6	2	9	3376	0	3393
18257	6	1	3	3561	0	3571
18258	4	1	2	3603	0	3610
18259	3632	2	2	17	0	3653
18260	11	4	2	3513	0	3530
18261	5	3468	3	16	0	3492
18262	3564	11	5	8	0	3588
18263	10	3452	3	6	0	3471
18264	5	3430	1	9	0	3445
18265	4	3399	1	7	0	3411
18266	13	15	3180	3	0	3211
18267	1	3095	15	8	0	3119
18268	3	18	2965	1	0	2987
18269	2813	5	1	5	0	2824
18270	2951	0	1	0	0	2952
18271	2	2	2955	0	0	2959
18272	2677	2	2	2	0	2683
18273	2912	1	1	0	0	2914
18274	2	1	2937	1	0	2941
18275	1	2876	4	2	0	2883
18276	0	3	0	3050	0	3053
18277	3110	1	0	1	0	3112
18278	4	0	0	2994	0	2998
18279	3133	0	0	1	0	3134
18280	2988	0	1	1	0	2990
18281	2	3	3041	1	0	3047
18282	2929	0	3	3	0	2935
18283	1	2976	5	1	0	2983
18284	3159	1	0	0	0	3160
18285	2	0	0	3088	0	3090
18286	0	2	3135	2	0	3139
18287	2	2	1	2967	0	2972
18288	3135	1	0	3	0	3139
18289	5	3010	3	2	0	3020
18290	5	2	3008	0	0	3015
18291	1	4	4	2752	0	2761
18292	3	6	3058	2	0	3069
18293	1	2921	10	1	0	2933
18294	3098	2	0	1	0	3101
18295	3	0	0	2998	0	3001
18296	1	1	3044	1	0	3047
18297	4	8	2685	3	0	2700
18298	2804	1	2	1	0	2808
18299	2	1	1	2923	0	2927
18300	2	1	1	2935	0	2939
18301	3	3	3011	3	0	3020
18302	1	3	2827	0	0	2831
18303	1	2824	5	3	0	2833
18304	2	2	1	3008	0	3013
18305	1	0	0	2990	0	2991
18306	0	2816	6	2	0	2824
18307	1	4	2777	1	0	2783
18308	2462	2	7	2	0	2473
18309	4	2	1	2917	0	2924
18310	0	1	2945	5	0	2951
18311	2	3	5	2789	0	2799
18312	0	587	3	5	0	595
18313	1	2	612	1	0	616
18314	596	1	2	1	0	600
18315	5	1	621	0	0	627
18316	1	0	613	1	0	615
18317	0	1	613	1	0	615
18318	0	1	652	1	0	654
18319	2	2	2	660	0	666
18320	2	0	719	4	0	725
18321	0	2	5	688	0	695
18322	1	707	1	3	0	712
18323	805	4	0	1	0	810
18324	6	2	0	823	0	831
18325	2	0	834	7	0	843
18326	1	838	8	1	0	848
18327	0	9	2	864	0	875
18328	861	2	0	9	0	872
18329	8	836	2	2	0	848
18330	0	9	0	864	0	873
18331	881	2	1	8	0	892
18332	10	1	871	1	0	883
18333	853	1	9	1	0	864
18334	10	0	854	1	0	865
18335	816	0	11	0	0	827
18336	837	0	2	0	0	839
18337	13	3	807	0	0	823
18338	2	806	9	0	0	817
18339	2	13	1	812	0	828
18340	0	1	838	6	0	845
18341	0	2	9	815	0	826
18342	0	1	1	842	0	844
18343	1	0	833	10	0	844
18344	0	2	828	3	0	833
18345	1	0	10	844	0	855
18346	863	1	2	9	0	875
18347	8	846	2	2	0	858
18348	2	873	1	1	0	877
18349	883	11	1	1	0	896
18350	907	1	0	3	0	911
18351	10	3	0	905	0	918
18352	3	1	2	905	0	911
18353	3	0	0	929	0	932
18354	918	0	2	9	0	929
18355	9	891	0	3	0	903
18356	2	897	1	3	0	903
18357	2	8	0	916	0	926
18358	1	4	1	923	0	929
18359	0	2	0	926	0	928
18360	916	1	1	10	0	928
18361	8	911	0	6	0	925
18362	935	7	1	4	0	947
18363	11	2	910	1	0	924
18364	6	921	10	0	0	937
18365	2	12	1	945	0	960
18366	947	3	1	10	0	961
18367	9	3	929	3	0	944
18368	4	3	942	2	0	951
18369	2	1	13	944	0	960
18370	2	0	4	953	0	959
18371	0	0	2	931	0	933
18372	0	2	2	911	0	915
18373	1	0	2	907	0	910
18374	3	881	0	14	0	898
18375	2	9	2	878	0	891
18376	862	6	0	10	0	878
18377	8	863	2	5	0	878
18378	875	9	0	2	0	886
18379	10	4	829	2	0	845
18380	5	1	839	2	0	847
18381	2	3	11	838	0	854
18382	3	0	1004	10	0	1017
18383	1	0	17	1002	0	1020
18384	0	2	8	1035	0	1045
18385	1061	2	2	19	0	1084
18386	1074	0	2	9	0	1085
18387	21	1139	5	3	0	1168
18388	10	1182	1	3	0	1196
18389	4	21	0	1167	0	1192
18390	1170	11	2	16	0	1199
18391	16	6	1170	9	0	1201
18392	10	3	16	1166	0	1195
18393	4	2	9	1193	0	1208
18394	3	2	1170	25	0	1200
18395	3	1155	19	13	0	1190
18396	3	15	11	1188	0	1217
18397	1	11	1166	20	0	1198
18398	2	4	17	1173	0	1196
18399	1122	3	12	19	0	1156
18400	17	1126	4	12	0	1159
18401	8	1150	2	9	0	1169
18402	2	23	5	1139	0	1169
18403	1126	10	1	20	0	1157
18404	18	1121	1	12	0	1152
18405	1144	19	3	3	0	1169
18406	18	9	1131	7	0	1165
18407	12	4	1158	4	0	1178
18408	6	5	27	1123	0	1161
18409	4	5	11	1181	0	1201
18410	1156	2	5	31	0	1194
18411	19	1	7	1159	0	1186
18412	14	3	1150	25	0	1192
18413	8	4	19	1148	0	1179
18414	5	5	10	1184	0	1204
18415	7	6	1160	32	0	1205
18416	1119	4	21	20	0	1164
18417	20	5	12	1168	0	1205
18418	1133	2	4	26	0	1165
18419	24	1073	4	16	0	1117
18420	1062	15	5	9	0	1091
18421	23	1045	5	6	0	1079
18422	9	1042	7	8	0	1066
18423	9	24	6	937	0	976
18424	926	10	6	19	0	961
18425	3089	4	4	10	0	3107
18426	45	7	1	3190	0	3243
18427	3101	7	4	44	0	3156
18428	3152	4	3	26	0	3185
18429	63	2	3	3195	0	3263
18430	2902	8	3	47	0	2960
18431	44	3124	3	26	0	3197
18432	3201	41	3	9	0	3254
18433	52	27	3065	5	0	3149
18434	3168	10	40	6	0	3224
18435	52	4	18	3098	0	3172
18436	35	3	7	3176	0	3221
18437	19	2	4	3166	0	3191
18438	16	4	5	3176	0	3201
18439	14	2	3	2968	0	2987
18440	22	2895	10	81	0	3008
18441	24	3169	6	48	0	3247
18442	3172	62	65	31	0	3330
18443	87	31	3125	30	0	3273
18444	3229	11	46	39	0	3325
18445	104	12	3102	32	0	3250
18446	76	18	53	2996	0	3143
18447	75	16	21	3214	0	3326
18448	3185	22	21	101	0	3329
18449	111	27	3011	56	0	3205
18450	96	14	62	3205	0	3377
18451	56	23	3001	108	0	3188
18452	66	3100	58	82	0	3306
18453	53	67	31	3231	0	3382
18454	3197	32	23	117	0	3369
18455	2990	25	22	84	0	3121
18456	2984	40	13	70	0	3107
18457	98	3092	12	66	0	3268
18458	57	3261	25	61	0	3404
18459	2609	99	31	51	0	2790
18460	92	3059	37	125	0	3313
18461	86	3141	37	82	0	3346
18462	64	99	3027	88	0	3278
18463	88	3009	72	67	0	3236
18464	88	3096	43	84	0	3311
18465	68	81	47	3160	0	3356
18466	88	60	3156	84	0	3388
18467	66	63	3163	78	0	3370
18468	3248	36	114	73	0	3471
18469	124	45	3176	90	0	3435
18470	3341	22	82	68	0	3513
18471	171	29	59	2889	0	3148
18472	112	3168	25	188	0	3493
18473	4862	92	30	113	0	5097
18474	4860	116	23	90	0	5089
18475	164	90	22	4794	0	5070
18476	131	97	62	4767	0	5057
18477	135	117	43	4887	0	5182
18478	4835	88	48	145	0	5116
18479	4459	86	89	103	0	4737
18480	4721	77	53	97	0	4948
18481	135	4592	71	124	0	4922
18482	4407	108	45	154	0	4714
18483	102	4361	64	119	0	4646
18484	120	4495	78	76	0	4769
18485	108	133	89	3956	0	4286
18486	79	4453	89	125	0	4746
18487	4461	110	100	86	0	4757
18488	142	96	79	4457	0	4774
18489	4318	59	66	158	0	4601
18490	244	4032	45	131	0	4452
18491	217	4258	73	114	0	4662
18492	4376	95	69	155	0	4695
18493	206	4331	35	195	0	4767
18494	217	126	71	4464	0	4878
18495	237	121	43	4538	0	4939
18496	4552	126	35	200	0	4913
18497	272	117	65	4473	0	4927
18498	223	118	4311	155	0	4807
18499	209	146	93	4472	0	4920
18500	4362	169	69	159	0	4759
18501	185	4349	68	174	0	4776
18502	4600	121	92	170	0	4983
18503	4359	155	72	182	0	4768
18504	4599	150	44	202	0	4995
18505	154	130	4282	197	0	4763
18506	135	223	4166	160	0	4684
18507	4239	215	84	154	0	4692
18508	165	4370	96	123	0	4754
18509	190	192	113	4360	0	4855
18510	176	151	118	4178	0	4623
18511	188	4005	112	186	0	4491
18512	140	4331	140	203	0	4814
18513	187	103	115	4491	0	4896
18514	189	77	117	4500	0	4883
18515	149	103	4204	215	0	4671
18516	177	93	3932	187	0	4389
18517	4283	105	131	138	0	4657
18518	4370	136	102	147	0	4755
18519	184	120	69	4457	0	4830
18520	212	104	4255	182	0	4753
18521	222	107	92	4399	0	4820
18522	4472	129	64	152	0	4817
18523	279	141	4164	106	0	4690
18524	277	167	71	4398	0	4913
18525	1	2	1948	6	0	1957
18526	1	1651	23	1	0	1676
18527	3	6	1871	4	0	1884
18528	3	1	6	1865	0	1875
18529	1971	0	4	6	0	1981
18530	6	1	1	1961	0	1969
18531	1995	0	2	8	0	2005
18532	1985	3	1	4	0	1993
18533	1969	0	4	2	0	1975
18534	8	3	1826	3	0	1840
18535	1916	0	7	1	0	1924
18536	9	1	1	1941	0	1952
18537	4	1	2	1954	0	1961
18538	5	1	1928	6	0	1940
18539	3	1	6	1887	0	1897
18540	1979	0	4	7	0	1990
18541	7	1783	4	4	0	1798
18542	1976	4	0	3	0	1983
18543	1975	2	1	3	0	1981
18544	1980	1	2	2	0	1985
18545	7	1	0	1877	0	1885
18546	4	1	1923	5	0	1933
18547	1	2	4	1952	0	1959
18548	3	0	4	2002	0	2009
18549	2002	0	2	7	0	2011
18550	1928	0	2	4	0	1934
18551	9	2	1927	3	0	1941
18552	8	0	7	1864	0	1879
18553	4	0	1881	7	0	1892
18554	1824	0	8	6	0	1838
18555	7	1833	13	8	0	1861
18556	2053	5	3	1	0	2062
18557	5	3276	5	6	0	3292
18558	3357	52	3	4	0	3416
18559	53	3305	6	4	0	3368
18560	29	61	0	3324	0	3414
18561	7	28	2	3446	0	3483
18562	3389	11	1	84	0	3485
18563	3364	10	3	31	0	3408
18564	3435	10	3	9	0	3457
18565	3332	13	7	7	0	3359
18566	3445	7	0	13	0	3465
18567	91	5	0	3294	0	3390
18568	45	3205	4	65	0	3319
18569	24	63	3	3282	0	3372
18570	23	3248	6	69	0	3346
18571	22	71	2	3313	0	3408
18572	25	3287	5	71	0	3388
18573	12	80	0	2188	0	2280
18574	10	40	2045	81	0	2176
18575	2036	22	55	44	0	2157
18576	69	2103	23	22	0	2217
18577	2178	67	6	14	0	2265
18578	84	38	2078	12	0	2212
18579	2128	12	62	20	0	2222
18580	85	9	2124	8	0	2226
18581	44	11	67	2136	0	2258
18582	21	2148	28	63	0	2260
18583	14	74	2201	38	0	2327
18584	18	33	75	2262	0	2388
18585	2179	15	34	79	0	2307
18586	75	16	17	2273	0	2381
18587	35	14	10	2308	0	2367
18588	13	13	16	2371	0	2413
18589	24	11	2189	105	0	2329
18590	20	17	68	2186	0	2291
18591	26	2226	32	80	0	2364
18592	24	68	20	2209	0	2321
18593	21	30	10	2318	0	2379
18594	2223	15	15	105	0	2358
18595	70	10	15	2298	0	2393
18596	30	20	2229	91	0	2370
18597	18	19	2262	46	0	2345
18598	13	24	2243	32	0	2312
18599	20	2244	95	40	0	2399
18600	2230	73	36	34	0	2373
18601	75	2249	17	33	0	2374
18602	2207	75	18	33	0	2333
18603	83	35	22	2201	0	2341
18604	43	23	2170	80	0	2316
18605	24	22	2129	48	0	2223
18606	19	2158	96	25	0	2298
18607	24	76	34	2121	0	2255
18608	27	38	18	2213	0	2296
18609	21	32	11	2317	0	2381
18610	26	25	2160	113	0	2324
18611	2173	27	94	60	0	2354
18612	82	20	2203	39	0	2344
18613	50	22	78	2199	0	2349
18614	39	22	35	2301	0	2397
18615	43	22	2148	122	0	2335
18616	2200	13	79	58	0	2350
18617	107	2190	50	38	0	2385
18618	2245	74	30	29	0	2378
18619	93	52	27	2139	0	2311
18620	46	2192	26	98	0	2362
18621	27	95	16	2282	0	2420
18622	2211	63	20	112	0	2406
18623	96	32	11	2272	0	2411
18624	56	35	2141	108	0	2340
18625	2194	26	90	64	0	2374
18626	2271	17	57	49	0	2394
18627	129	34	2072	40	0	2275
18628	77	28	77	2236	0	2418
18629	2212	30	46	114	0	2402
18630	107	26	41	2206	0	2380
18631	71	16	24	2239	0	2350
18632	59	27	28	2255	0	2369
18633	33	16	24	2307	0	2380
18634	32	42	2081	134	0	2289
18635	24	20	89	2256	0	2389
18636	33	16	2131	131	0	2311
18637	2159	12	89	88	0	2348
18638	2216	29	53	66	0	2364
18639	2244	17	32	60	0	2353
18640	2263	16	32	52	0	2363
18641	124	15	42	2208	0	2389
18642	2171	21	35	126	0	2353
18643	103	28	2116	78	0	2325
18644	73	25	2115	54	0	2267
18645	2079	12	108	60	0	2259
18646	103	2029	53	65	0	2250
18647	65	2123	23	68	0	2279
18648	31	93	56	2123	0	2303
18649	28	32	2040	116	0	2216
18650	2057	20	117	60	0	2254
18651	94	30	2047	42	0	2213
18652	73	2040	85	38	0	2236
18653	47	103	1995	41	0	2186
18654	46	2025	84	60	0	2215
18655	1838	74	48	74	0	2034
18656	94	1962	57	51	0	2164
18657	2	545	2	2	0	551
18658	1	11	3	536	0	551
18659	4	1	522	10	0	537
18660	6	2	11	500	0	519
18661	4	2	2	515	0	523
18662	2	2	508	14	0	526
18663	3	0	10	498	0	511
18664	2	501	4	11	0	518
18665	3	8	3	507	0	521
18666	507	2	4	11	0	524
18667	12	2	2	512	0	528
18668	3	6	1826	12	0	1847
18669	0	4	14	1678	0	1696
18670	4	1	1874	11	0	1890
18671	1762	1	13	4	0	1780
18672	12	1	3	1875	0	1891
18673	1870	1	2	12	0	1885
18674	10	3	1882	3	0	1898
18675	1503	2	16	3	0	1524
18676	12	1803	3	2	0	1820
18677	5	10	1888	3	0	1906
18678	1	10	12	1750	0	1773
18679	2	3	1881	14	0	1900
18680	4	1767	10	5	0	1786
18681	2	1798	4	2	0	1806
18682	1832	8	2	2	0	1844
18683	10	1781	0	3	0	1794
18684	1847	10	3	2	0	1862
18685	10	3	1	1817	0	1831
18686	2	3	1808	12	0	1825
18687	1	1757	12	4	0	1774
18688	2	12	3	1841	0	1858
18689	2	1	0	1825	0	1828
18690	0	0	4	1838	0	1842
18691	3	1	2	1817	0	1823
18692	3	1806	3	13	0	1825
18693	2	1833	1	3	0	1839
18694	1820	12	9	3	0	1844
18695	13	1804	1	8	0	1826
18696	5	11	1	1819	0	1836
18697	2	5	1793	12	0	1812
18698	1	1740	10	3	0	1754
18699	3	13	2	1768	0	1786
18700	0	5	2	1781	0	1788
18701	0	1746	2	12	0	1760
18702	1748	11	4	3	0	1766
18703	10	4	1722	4	0	1740
18704	1487	2	8	2	0	1499
18705	8	1672	5	2	0	1687
18706	1728	9	0	1	0	1738
18707	9	1692	3	0	0	1704
18708	8	9	0	1721	0	1738
18709	1	3	0	1716	0	1720
18710	1737	2	1	10	0	1750
18711	8	1	3	1683	0	1695
18712	5	1	1715	11	0	1732
18713	0	1610	10	4	0	1624
18714	3	1651	1	2	0	1657
18715	1	11	1	1691	0	1704
18716	3	4	1667	8	0	1682
18717	1	3	8	1572	0	1584
18718	1	2	3	1604	0	1610
18719	3	1	1610	12	0	1626
18720	1	4	1499	3	0	1507
18721	1	1539	10	3	0	1553
18722	1624	9	2	2	0	1637
18723	7	3	2	1610	0	1622
18724	2	1508	3	9	0	1522
18725	1615	10	0	2	0	1627
18726	10	3	0	1577	0	1590
18727	2	0	1	1562	0	1565
18728	0	1541	2	10	0	1553
18729	2	9	0	1609	0	1620
18730	1600	2	0	12	0	1614
18731	7	1	2	1523	0	1533
18732	3	3	2	1538	0	1546
18733	0	1	1531	14	0	1546
18734	3	2	1354	2	0	1361
18735	1447	1	11	4	0	1463
18736	8	2	2	1516	0	1528
18737	4	0	2	1501	0	1507
18738	0	0	2	1546	0	1548
18739	2	2	1518	11	0	1533
18740	1423	1	9	3	0	1436
18741	8	0	2	1529	0	1539
18742	3	0	0	1515	0	1518
18743	1508	1	2	11	0	1522
18744	10	1448	2	4	0	1464
18745	4	8	1482	2	0	1496
18746	0	2	8	1453	0	1463
18747	3	1424	5	9	0	1441
18748	0	11	1	1529	0	1541
18749	1496	2	3	9	0	1510
18750	9	0	0	1463	0	1472
18751	1478	1	1	9	0	1489
18752	1465	0	1	5	0	1471
18753	12	0	0	1446	0	1458
18754	2	1438	2	10	0	1452
18755	4	1453	2	4	0	1463
18756	3	14	1381	1	0	1399
18757	0	6	11	1254	0	1271
18758	1	2	2	1406	0	1411
18759	0	4	0	1450	0	1454
18760	1459	1	3	11	0	1474
18761	9	1	0	1435	0	1445
18762	2	1	1442	11	0	1456
18763	1361	0	8	5	0	1374
18764	13	1	2	1415	0	1431
18765	3	1	0	1437	0	1441
18766	3	1	1390	11	0	1405
18767	1222	2	11	3	0	1238
18768	8	0	2	270	0	280
18769	2	1	263	11	0	277
18770	0	1	10	263	0	274
18771	2	1	4	254	0	261
18772	1	269	0	11	0	281
18773	270	8	2	5	0	285
18774	270	2	2	3	0	277
18775	12	261	1	1	0	275
18776	263	10	0	2	0	275
18777	260	2	1	1	0	264
18778	12	0	1	258	0	271
18779	3	3	256	8	0	270
18780	3	0	233	3	0	239
18781	2	0	216	1	0	219
18782	1	0	208	3	0	212
18783	0	7	8	160	0	175
18784	0	0	6	166	0	172
18785	1	0	1	161	0	163
18786	0	0	1	168	0	169
18787	164	0	0	3	0	167
18788	1	167	1	1	0	170
18789	189	1	1	1	0	192
18790	2	1	200	1	0	204
18791	2	0	212	1	0	215
18792	0	1	1	216	0	218
18793	223	0	2	1	0	226
18794	205	0	1	1	0	207
18795	2	214	1	1	0	218
18796	1	219	1	2	0	223
18797	1	2	1	218	0	222
18798	219	0	0	1	0	220
18799	1	217	0	1	0	219
18800	223	1	1	0	0	225
18801	220	1	1	2	0	224
18802	220	2	0	0	0	222
18803	0	1	215	2	0	218
18804	3	225	0	0	0	228
18805	223	3	0	1	0	227
18806	223	0	0	0	0	223
18807	2	221	1	0	0	224
18808	1	206	0	0	0	207
18809	213	0	1	0	0	214
18810	0	1	0	213	0	214
18811	3	0	221	0	0	224
18812	226	0	0	0	0	226
18813	1	1	0	235	0	237
18814	0	245	0	0	0	245
18815	2	0	0	252	0	254
18816	0	0	258	1	0	259
18817	0	0	2	257	0	259
18818	275	0	0	1	0	276
18819	2	0	0	276	0	278
18820	1	1	0	277	0	279
18821	0	1	283	2	0	286
18822	0	1	2	279	0	282
18823	0	289	0	3	0	292
18824	290	1	0	0	0	291
18825	285	1	0	1	0	287
18826	2	1	290	1	0	294
18827	1	0	2	289	0	292
18828	1	286	0	2	0	289
18829	0	295	1	0	0	296
18830	294	2	0	0	0	296
18831	3	0	0	300	0	303
18832	1	0	296	1	0	298
18833	0	0	294	0	0	294
18834	0	2	1	298	0	301
18835	301	1	0	1	0	303
18836	297	0	0	1	0	298
18837	1	0	1	315	0	317
18838	1	0	319	3	0	323
18839	0	320	2	1	0	323
18840	325	2	0	1	0	328
18841	2	324	0	1	0	327
18842	325	1	1	1	0	328
18843	1	0	0	329	0	330
18844	1	0	325	1	0	327
18845	0	1	1	326	0	328
18846	336	0	0	2	0	338
18847	1	1	344	0	0	346
18848	1	348	1	1	0	351
18849	0	2	0	356	0	358
18850	353	0	1	1	0	355
18851	2	0	344	1	0	347
18852	1	0	2	345	0	348
18853	0	0	1	355	0	356
18854	0	1	349	1	0	351
18855	0	1	1	342	0	344
18856	2	0	340	1	0	343
18857	338	0	2	1	0	341
18858	1	0	1	366	0	368
18859	0	0	395	2	0	397
18860	0	404	2	1	0	407
18861	419	1	0	1	0	421
18862	1503	0	2	0	0	1505
18863	88	3	0	1483	0	1574
18864	29	1584	1	81	0	1695
18865	1598	92	1	30	0	1721
18866	112	34	0	1643	0	1789
18867	37	21	1580	115	0	1753
18868	1602	20	86	34	0	1742
18869	111	1597	30	23	0	1761
18870	34	92	20	1656	0	1802
18871	1678	33	20	96	0	1827
18872	122	21	1630	34	0	1807
18873	37	23	1743	25	0	1828
18874	28	4	125	1637	0	1794
18875	27	2	1651	101	0	1781
18876	5	6	121	1561	0	1693
18877	6	1633	55	102	0	1796
18878	5	97	24	1740	0	1866
18879	1700	34	29	120	0	1883
18880	108	20	1635	54	0	1817
18881	35	1731	86	32	0	1884
18882	25	95	33	1734	0	1887
18883	32	41	1687	106	0	1866
18884	14	30	110	1620	0	1774
18885	6	1662	41	119	0	1828
18886	8	1814	26	55	0	1903
18887	1642	132	21	28	0	1823
18888	90	1722	12	38	0	1862
18889	39	140	1686	10	0	1875
18890	1709	60	103	9	0	1881
18891	119	33	1701	18	0	1871
18892	40	23	124	1689	0	1876
18893	35	10	1683	108	0	1836
18894	26	1674	114	47	0	1861
18895	8	100	52	1727	0	1887
18896	21	39	28	1827	0	1915
18897	16	25	34	1861	0	1936
18898	23	29	1697	167	0	1916
18899	15	17	94	1805	0	1931
18900	11	25	47	1888	0	1971
18901	1735	11	41	178	0	1965
18902	1807	14	35	86	0	1942
18903	142	19	1680	66	0	1907
18904	80	1662	99	40	0	1881
18905	59	114	1738	19	0	1930
18906	35	50	122	1757	0	1964
18907	31	32	1760	120	0	1943
18908	18	26	149	1743	0	1936
18909	12	9	86	1869	0	1976
18910	13	14	1735	182	0	1944
18911	1669	22	137	79	0	1907
18912	111	1753	53	76	0	1993
18913	41	130	27	1793	0	1991
18914	40	45	1750	138	0	1973
18915	54	28	1809	65	0	1956
18916	1743	42	150	48	0	1983
18917	105	1762	80	57	0	2004
18918	50	106	65	1805	0	2026
18919	1807	54	51	130	0	2042
18920	131	36	27	1832	0	2026
18921	51	53	17	1932	0	2053
18922	44	41	1761	174	0	2020
18923	1796	21	112	84	0	2013
18924	1901	31	53	76	0	2061
18925	144	12	62	1858	0	2076
18926	1894	14	52	127	0	2087
18927	165	8	47	1827	0	2047
18928	77	1616	33	161	0	1887
18929	42	1855	39	80	0	2016
18930	44	148	25	1880	0	2097
18931	1815	67	18	185	0	2085
18932	112	42	40	1897	0	2091
18933	1845	39	30	174	0	2088
18934	1908	27	45	104	0	2084
18935	174	18	29	1864	0	2085
18936	91	20	19	1983	0	2113
18937	85	23	1757	167	0	2032
18938	69	21	1847	84	0	2021
18939	22	24	164	1894	0	2104
18940	21	28	1914	160	0	2123
18941	1878	18	173	65	0	2134
18942	103	20	83	2009	0	2215
18943	51	16	2010	177	0	2254
18944	2032	12	147	97	0	2288
18945	2227	15	54	85	0	2381
18946	162	2142	62	65	0	2431
18947	94	132	42	2257	0	2525
18948	82	62	2202	142	0	2488
18949	2269	38	135	88	0	2530
18950	2405	33	82	52	0	2572
18951	191	26	2213	53	0	2483
18952	2384	20	144	46	0	2594
18953	180	37	57	2218	0	2492
18954	84	27	35	2449	0	2595
18955	2324	10	44	191	0	2569
18956	2440	9	25	110	0	2584
18957	168	14	31	2406	0	2619
18958	94	10	2242	171	0	2517
18959	100	2200	126	75	0	2501
18960	75	111	2279	71	0	2536
18961	46	51	2397	89	0	2583
18962	1	1130	24	3	0	1158
18963	5	17	15	1015	0	1052
18964	2	5	10	1044	0	1061
18965	4	5	1036	21	0	1066
18966	2	2	19	1043	0	1066
18967	1034	4	4	21	0	1063
18968	19	1	1043	8	0	1071
18969	1046	1	21	7	0	1075
18970	1070	2	4	5	0	1081
18971	1071	1	6	4	0	1082
18972	25	0	1034	9	0	1068
18973	13	0	1052	2	0	1067
18974	10	1	20	1040	0	1071
18975	6	1	8	1022	0	1037
18976	7	1035	8	20	0	1070
18977	1042	14	7	11	0	1074
18978	1042	3	5	11	0	1061
18979	24	1034	5	4	0	1067
18980	1046	19	2	3	0	1070
18981	23	1008	5	8	0	1044
18982	1038	18	4	4	0	1064
18983	23	7	0	997	0	1027
18984	9	6	1005	17	0	1037
18985	9	3	1001	6	0	1019
18986	8	2	17	992	0	1019
18987	1	2	7	1009	0	1019
18988	4	2	967	20	0	993
18989	2	3	22	952	0	979
18990	5	2	9	991	0	1007
18991	964	1	7	25	0	997
18992	979	2	6	11	0	998
18993	973	2	5	9	0	989
18994	24	0	952	10	0	986
18995	11	938	18	6	0	973
18996	10	15	6	959	0	990
18997	8	5	975	15	0	1003
18998	7	967	17	7	0	998
18999	996	16	6	4	0	1022
19000	16	7	9	990	0	1022
19001	10	4	3	1003	0	1020
19002	991	4	6	20	0	1021
19003	20	4	3	986	0	1013
19004	9	2	0	1014	0	1025
19005	1009	2	4	21	0	1036
19006	18	4	990	8	0	1020
19007	10	976	13	10	0	1009
19008	1004	16	4	7	0	1031
19009	18	7	1000	5	0	1030
19010	988	6	18	5	0	1017
19011	20	1018	5	5	0	1048
19012	1004	15	8	4	0	1031
19013	1011	5	3	4	0	1023
19014	972	4	5	4	0	985
19015	24	4	7	954	0	989
19016	13	5	1	955	0	974
19017	11	1622	4	24	0	1661
19018	6	1683	7	8	0	1704
19019	5	1693	2	8	0	1708
19020	1711	20	1	7	0	1739
19021	20	7	1681	4	0	1712
19022	9	7	16	1683	0	1715
19023	9	3	3	1682	0	1697
19024	1	1666	6	21	0	1694
19025	2	19	2	1715	0	1738
19026	5	6	2	1699	0	1712
19027	1	1683	6	24	0	1714
19028	1689	18	1	12	0	1720
19029	17	1681	1	8	0	1707
19030	5	19	1670	7	0	1701
19031	1642	5	17	7	0	1671
19032	19	1686	4	3	0	1712
19033	1665	14	6	4	0	1689
19034	23	5	1	1685	0	1714
19035	8	7	3	1675	0	1693
19036	11	3	1685	18	0	1717
19037	6	3	1660	10	0	1679
19038	6	5	16	1674	0	1701
19039	1659	5	7	15	0	1686
19040	1587	3	5	6	0	1601
19041	22	1573	2	5	0	1602
19042	8	1553	4	3	0	1568
19043	4	1484	1	3	0	1492
19044	19	47	19	1386	0	1471
19045	1372	4	11	4	0	1391
19046	1306	0	0	1	0	1307
19047	1299	0	0	0	0	1299
19048	3	0	1276	0	0	1279
19049	0	1875	2	0	0	1877
19050	1	10	0	2034	0	2045
19051	2036	0	0	10	0	2046
19052	8	1	0	2033	0	2042
19053	0	0	0	2114	0	2114
19054	2114	1	0	11	0	2126
19055	2196	2	0	2	0	2200
19056	13	3	2163	1	0	2180
19057	2	1	12	2221	0	2236
19058	5	1	2182	16	0	2204
19059	3	1	11	2225	0	2240
19060	7	0	2168	13	0	2188
19061	2	2	14	2230	0	2248
19062	2162	0	3	16	0	2181
19063	14	2152	4	10	0	2180
19064	1	2216	4	3	0	2224
19065	4	21	1	2061	0	2087
19066	2	2179	5	9	0	2195
19067	2216	14	0	6	0	2236
19068	2138	3	2	0	0	2143
19069	15	5	2073	6	0	2099
19070	3	2098	15	7	0	2123
19071	5	16	2	2201	0	2224
19072	3	6	2142	17	0	2168
19073	2154	0	11	7	0	2172
19074	18	6	3	2186	0	2213
19075	11	3	2145	17	0	2176
19076	5	2	16	2177	0	2200
19077	2193	0	8	16	0	2217
19078	17	2	2155	5	0	2179
19079	2132	0	15	5	0	2152
19080	2185	1	7	5	0	2198
19081	15	4	5	2173	0	2197
19082	7	2	2113	18	0	2140
19083	11	5	2077	7	0	2100
19084	2114	4	14	6	0	2138
19085	2175	4	1	6	0	2186
19086	27	8	2134	7	0	2176
19087	10	4	16	2122	0	2152
19088	11	5	9	2068	0	2093
19089	9	2111	12	17	0	2149
19090	10	16	8	2180	0	2214
19091	2160	3	9	25	0	2197
19092	17	1	10	2176	0	2204
19093	11	4	2100	28	0	2143
19094	2067	1	25	11	0	2104
19095	24	6	12	2123	0	2165
19096	13	6	2073	28	0	2120
19097	10	2049	23	14	0	2096
19098	2090	22	12	14	0	2138
19099	25	2107	5	21	0	2158
19100	2121	19	9	14	0	2163
19101	30	12	2040	23	0	2105
19102	22	2017	29	10	0	2078
19103	15	2091	13	17	0	2136
19104	22	23	9	2076	0	2130
19105	16	12	18	2106	0	2152
19106	22	9	2054	34	0	2119
19107	13	5	26	2097	0	2141
19108	2086	6	15	36	0	2143
19109	30	9	2041	22	0	2102
19110	15	10	27	2057	0	2109
19111	17	11	2009	37	0	2074
19112	1946	12	27	24	0	2009
19113	34	1979	18	28	0	2059
19114	2051	26	14	25	0	2116
19115	2024	15	15	27	0	2081
19116	2057	9	13	25	0	2104
19117	49	16	1271	11	0	1347
19118	26	1318	31	14	0	1389
19119	25	27	19	1290	0	1361
19120	24	13	16	1360	0	1413
19121	1378	14	23	34	0	1449
19122	32	14	15	1383	0	1444
19123	1389	9	29	37	0	1464
19124	1393	10	18	27	0	1448
19125	1388	8	14	27	0	1437
19126	1381	14	27	21	0	1443
19127	36	8	15	1381	0	1440
19128	1377	4	14	45	0	1440
19129	38	12	1321	20	0	1391
19130	1360	8	29	25	0	1422
19131	1392	7	18	14	0	1431
19132	42	15	1283	18	0	1358
19133	1360	12	27	16	0	1415
19134	1379	7	24	17	0	1427
19135	41	11	20	1340	0	1412
19136	33	12	13	1361	0	1419
19137	1354	18	19	38	0	1429
19138	34	11	19	1360	0	1424
19139	26	9	12	1325	0	1372
19140	30	1302	21	35	0	1388
19141	18	20	17	1351	0	1406
19142	1325	9	14	38	0	1386
19143	40	10	10	1323	0	1383
19144	20	5	17	1310	0	1352
19145	24	1257	24	29	0	1334
19146	28	18	15	1254	0	1315
19147	37	10	15	1268	0	1330
19148	1266	13	19	25	0	1323
19149	7	6	1	531	0	545
19150	5	3	447	7	0	462
19151	2	428	5	3	0	438
19152	4	389	4	2	0	399
19153	351	6	7	0	0	364
19154	6	363	0	4	0	373
19155	256	2	3	1	0	262
19156	2	254	4	0	0	260
19157	257	1	0	1	0	259
19158	1	1	0	251	0	253
19159	1	1	0	257	0	259
19160	0	250	0	3	0	253
19161	3	1	0	262	0	266
19162	0	1	255	2	0	258
19163	256	0	1	2	0	259
19164	1	276	1	0	0	278
19165	284	2	0	0	0	286
19166	290	0	0	0	0	290
19167	298	0	1	0	0	299
19168	2	0	0	290	0	292
19169	1	0	0	291	0	292
19170	0	294	0	2	0	296
19171	299	2	0	1	0	302
19172	3	299	0	0	0	302
19173	304	1	0	1	0	306
19174	2	1	307	0	0	310
19175	318	1	2	0	0	321
19176	2	0	0	319	0	321
19177	1	0	326	2	0	329
19178	0	0	328	1	0	329
19179	0	0	3	328	0	331
19180	0	0	326	3	0	329
19181	0	0	3	325	0	328
19182	317	0	0	4	0	321
19183	4	0	0	326	0	330
19184	0	1	321	4	0	326
19185	0	313	3	0	0	316
19186	0	316	0	0	0	316
19187	0	3	1	314	0	318
19188	317	0	0	2	0	319
19189	2	1	0	311	0	314
19190	2	0	1	313	0	316
19191	1	2	1	313	0	317
19192	2	0	0	317	0	319
19193	0	0	312	3	0	315
19194	1	0	305	2	0	308
19195	311	1	2	2	0	316
19196	296	0	0	2	0	298
19197	2	1	2	305	0	310
19198	3	1	0	303	0	307
19199	0	2	294	3	0	299
19200	2	292	3	1	0	298
19201	299	3	1	0	0	303
19202	298	2	0	1	0	301
19203	2	0	0	299	0	301
19204	2	0	292	3	0	297
19205	1	1	3	289	0	294
19206	1	288	1	5	0	295
19207	0	3	294	3	0	300
19208	288	1	2	2	0	293
19209	5	0	2	307	0	314
19210	308	1	1	4	0	314
19211	4	0	300	2	0	306
19212	301	0	4	0	0	305
19213	3	1	0	304	0	308
19214	303	0	0	7	0	310
19215	5	0	1	289	0	295
19216	0	280	1	7	0	288
19217	2	290	1	2	0	295
19218	1	3	1	289	0	294
19219	1	1	279	7	0	288
19220	1	279	4	0	0	284
19221	3	3	1	251	0	258
19222	242	1	2	4	0	249
19223	249	1	1	0	0	251
19224	4	2	1	242	0	249
19225	2	1	0	246	0	249
19226	3	234	1	4	0	242
19227	4	242	1	1	0	248
19228	238	3	0	3	0	244
19229	4	2	0	246	0	252
19230	1	2	1	245	0	249
19231	2	1	240	5	0	248
19232	1	2	5	240	0	248
19233	1	4	1	239	0	245
19234	2	0	3	239	0	244
19235	3	1	233	6	0	243
19236	2	1	4	240	0	247
19237	235	2	2	8	0	247
19238	7	2	239	1	0	249
19239	252	1	5	2	0	260
19240	5	1	2	258	0	266
19241	2	1	1	264	0	268
19242	1	3	1	264	0	269
19243	1	2	252	8	0	263
19244	253	2	5	3	0	263
19245	3	261	3	6	0	273
19246	266	3	1	4	0	274
19247	4	274	2	5	0	285
19248	3	2	1	279	0	285
19249	275	0	4	7	0	286
19250	7	1	268	3	0	279
19251	271	1	5	5	0	282
19252	5	1	275	7	0	288
19253	3	2	4	277	0	286
19254	0	1	270	6	0	277
19255	4	256	5	2	0	267
19256	2	5	1	254	0	262
19257	242	0	2	8	0	252
19258	3	3	2	240	0	248
19259	1	235	3	7	0	246
19260	5	4	1	239	0	249
19261	233	3	1	6	0	243
19262	237	0	1	1	0	239
19263	4	229	1	2	0	236
19264	0	216	0	3	0	219
19265	3	2	4	206	0	215
19266	3	1	2	206	0	212
19267	203	0	1	3	0	207
19268	200	1	1	0	0	202
19269	1	200	0	4	0	205
19270	1	3	2	190	0	196
19271	1	3	0	192	0	196
19272	1	1	186	5	0	193
19273	2	183	2	2	0	189
19274	1	176	0	1	0	178
19275	0	5	0	160	0	165
19276	1	1	158	5	0	165
19277	1	0	151	2	0	154
19278	2	0	2	153	0	157
19279	1	1	0	153	0	155
19280	0	1	150	3	0	154
19281	0	0	2	152	0	154
19282	0	0	148	7	0	155
19283	155	0	4	0	0	159
19284	3	1	0	155	0	159
19285	1	2	163	2	0	168
19286	0	0	167	2	0	169
19287	1	0	3	186	0	190
19288	0	0	204	3	0	207
19289	0	0	200	2	0	202
19290	0	197	3	2	0	202
19291	200	2	2	0	0	204
19292	3	0	213	1	0	217
19293	0	1	3	213	0	217
19294	2	0	0	217	0	219
19295	0	1	0	222	0	223
19296	0	0	221	3	0	224
19297	1	0	3	214	0	218
19298	216	0	2	3	0	221
19299	4	0	1	214	0	219
19300	0	0	224	3	0	227
19301	0	2	3	220	0	225
19302	225	0	1	2	0	228
19303	229	1	1	1	0	232
19304	226	0	1	2	0	229
19305	3	0	1	228	0	232
19306	229	1	0	3	0	233
19307	227	1	1	0	0	229
19308	229	0	1	2	0	232
19309	4	218	0	1	0	223
19310	217	2	0	2	0	221
19311	2	1	1	219	0	223
19312	1	1	221	3	0	226
19313	1	219	2	2	0	224
19314	221	1	0	1	0	223
19315	3	0	0	222	0	225
19316	0	0	1	216	0	217
19317	1	219	0	2	0	222
19318	2	220	0	0	0	222
19319	214	1	0	1	0	216
19320	2	212	1	0	0	215
19321	189	1	2	0	0	192
19322	1	190	0	1	0	192
19323	183	1	0	0	0	184
19324	1	183	0	0	0	184
19325	0	182	0	1	0	183
19326	179	1	0	0	0	180
19327	1	1	175	0	0	177
19328	0	180	1	0	0	181
19329	0	1	0	183	0	184
19330	0	0	0	183	0	183
19331	0	0	0	181	0	181
19332	0	0	0	183	0	183
19333	0	0	180	1	0	181
19334	179	0	1	0	0	180
19335	1	0	0	181	0	182
19336	183	0	0	1	0	184
19337	184	0	0	1	0	185
19338	188	0	0	0	0	188
19339	182	0	0	0	0	182
19340	2	0	183	0	0	185
19341	0	0	2	182	0	184
19342	0	0	185	2	0	187
19343	1	189	2	0	0	192
19344	0	4	2	189	0	195
19345	1	1	0	194	0	196
19346	0	0	1	192	0	193
19347	0	0	1	186	0	187
19348	0	1	185	5	0	191
19349	0	0	3	187	0	190
19350	0	0	2	189	0	191
19351	187	0	5	6	0	198
19352	196	2	1	1	0	200
19353	5	1	0	197	0	203
19354	2	0	0	199	0	201
19355	1	1	1	203	0	206
19356	203	0	0	7	0	210
19357	199	2	0	3	0	204
19358	197	1	1	1	0	200
19359	191	1	1	2	0	195
19360	6	190	0	0	0	196
19361	192	4	0	2	0	198
19362	194	1	1	1	0	197
19363	6	1	1	188	0	196
19364	2	1	0	191	0	194
19365	185	0	0	6	0	191
19366	6	182	0	4	0	192
19367	1	189	1	3	0	194
19368	187	5	1	2	0	195
19369	8	1	0	182	0	191
19370	2	0	0	189	0	191
19371	2	2	0	190	0	194
19372	3	0	0	190	0	193
19373	2	0	0	189	0	191
19374	1	178	1	6	0	186
19375	1	4	1	180	0	186
19376	178	2	0	5	0	185
19377	4	0	1	179	0	184
19378	2	2	0	180	0	184
19379	177	1	1	6	0	185
19380	5	185	0	2	0	192
19381	3	3	1	185	0	192
19382	0	184	0	8	0	192
19383	2	6	1	180	0	189
19384	0	4	177	6	0	187
19385	159	1	6	4	0	170
19386	7	155	1	1	0	164
19387	137	5	1	1	0	144
19388	5	1	135	2	0	143
19389	2	1	3	129	0	135
19390	1	131	0	7	0	139
19391	2	136	2	2	0	142
19392	128	7	1	0	0	136
19393	6	1	1	128	0	136
19394	3	1	134	6	0	144
19395	0	2	5	141	0	148
19396	2	0	141	7	0	150
19397	139	0	5	2	0	146
19398	6	0	143	2	0	151
19399	2	0	6	142	0	150
19400	2	136	2	6	0	146
19401	1	5	0	140	0	146
19402	2	138	1	5	0	146
19403	141	5	0	2	0	148
19404	5	2	0	149	0	156
19405	0	0	148	10	0	158
19406	1	0	153	3	0	157
19407	151	2	6	1	0	160
19408	159	1	1	1	0	162
19409	156	0	1	0	0	157
19410	155	0	1	2	0	158
19411	8	151	0	2	0	161
19412	151	6	0	1	0	158
19413	156	1	0	1	0	158
19414	8	0	149	2	0	159
19415	2	1	5	150	0	158
19416	151	1	1	7	0	160
19417	9	0	151	1	0	161
19418	1	0	6	152	0	159
19419	1	0	153	9	0	163
19420	2	2	5	151	0	160
19421	1	150	1	6	0	158
19422	158	6	0	4	0	168
19423	6	3	157	0	0	166
19424	163	0	6	3	0	172
19425	6	1	2	165	0	174
19426	168	0	0	7	0	175
19427	7	1	1	167	0	176
19428	185	0	0	8	0	193
19429	6	1	183	4	0	194
19430	189	1	6	1	0	197
19431	6	2	1	186	0	195
19432	3	1	0	192	0	196
19433	186	1	1	8	0	196
19434	6	0	0	189	0	195
19435	2	0	183	6	0	191
19436	1	1	5	185	0	192
19437	180	1	1	7	0	189
19438	7	176	0	2	0	185
19439	1	178	1	2	0	182
19440	169	4	1	0	0	174
19441	6	180	0	0	0	186
19442	2	4	1	178	0	185
19443	187	0	0	4	0	191
19444	187	0	1	0	0	188
19445	187	0	0	1	0	188
19446	3	1	188	0	0	192
19447	0	4	3	181	0	188
19448	2	181	0	3	0	186
19449	0	2	1	186	0	189
19450	0	0	185	3	0	188
19451	0	178	4	1	0	183
19452	0	3	1	177	0	181
19453	176	0	0	3	0	179
19454	3	182	0	0	0	185
19455	0	2	198	0	0	200
19456	0	0	4	191	0	195
19457	0	0	201	3	0	204
19458	0	0	3	199	0	202
19459	206	0	1	3	0	210
19460	3	0	0	201	0	204
19461	202	0	0	3	0	205
19462	206	0	0	0	0	206
19463	2	222	0	0	0	224
19464	230	3	0	0	0	233
19465	3	233	0	0	0	236
19466	0	4	249	0	0	253
19467	0	0	3	245	0	248
19468	0	0	0	265	0	265
19469	0	0	270	3	0	273
19470	0	261	3	0	0	264
19471	272	3	0	0	0	275
19472	987	0	0	0	0	987
19473	2	0	0	977	0	979
19474	0	0	1	985	0	986
19475	0	1	0	995	0	996
19476	997	0	0	3	0	1000
19477	4	0	973	1	0	978
19478	1	1	1246	0	0	1248
19479	0	0	2	1216	0	1218
19480	1	0	1290	6	0	1297
19481	1	0	1243	1	0	1245
19482	0	0	2	1186	0	1188
19483	1	1	1298	1	0	1301
19484	0	1235	1	2	0	1238
19485	0	1	3	1296	0	1300
19486	1	0	1314	1	0	1316
19487	0	2	2	1262	0	1266
19488	0	1238	2	3	0	1243
19489	0	2	0	1305	0	1307
19490	2	0	1320	2	0	1324
19491	0	1	2	1203	0	1206
19492	1283	0	0	2	0	1285
19493	1	1	1263	0	0	1265
19494	1177	1	2	2	0	1182
19495	1	1236	1	1	0	1239
19496	1306	1	0	1	0	1308
19497	2	0	0	1294	0	1296
19498	0	1247	1	1	0	1249
19499	1317	1	1	0	0	1319
19500	1	1	0	1289	0	1291
19501	2	0	1314	1	0	1317
19502	0	1231	1	2	0	1234
19503	0	1	1	1334	0	1336
19504	1330	0	0	1	0	1331
19505	1264	2	1	1	0	1268
19506	0	0	1	1283	0	1284
19507	1	1	1300	0	0	1302
19508	1120	0	2	1	0	1123
19509	7	1	1281	0	0	1289
19510	1	0	0	1217	0	1218
19511	1320	0	0	1	0	1321
19512	0	1253	1	1	0	1255
19513	1310	0	0	0	0	1310
19514	3	0	1274	0	0	1277
19515	1223	0	0	1	0	1224
19516	1	0	0	1276	0	1277
19517	0	1	0	1296	0	1297
19518	2	0	1304	0	0	1306
19519	0	0	1	1243	0	1244
19520	1307	0	0	0	0	1307
19521	0	0	0	1291	0	1291
19522	0	1244	3	3	0	1250
19523	0	0	1	1315	0	1316
19524	0	1240	3	2	0	1245
19525	1	0	1265	0	0	1266
19526	1139	0	0	0	0	1139
19527	0	1	0	1282	0	1283
19528	3	1	1248	1	0	1253
19529	0	1202	1	3	0	1206
19530	0	0	1	1282	0	1283
19531	1	0	0	1263	0	1264
19532	1287	0	0	1	0	1288
19533	0	1	1	1266	0	1268
19534	1280	1	0	1	0	1282
19535	1278	0	0	1	0	1279
19536	1	1216	3	2	0	1222
19537	1313	0	0	0	0	1313
19538	1	0	0	1676	0	1677
19539	1	0	1658	6	0	1665
19540	1555	0	7	2	0	1564
19541	6	1	2	1661	0	1670
19542	4	0	1639	8	0	1651
19543	1551	2	6	4	0	1563
19544	6	0	4	1642	0	1652
19545	4	4379	4	6	0	4393
19546	2	9	0	4691	0	4702
19547	0	4500	2	8	0	4510
19548	4636	7	0	2	0	4645
19549	8	5	5211	4	0	5228
19550	2	4950	8	3	0	4963
19551	2	8	2	5245	0	5257
19552	2	9	5208	11	0	5230
19553	4	9	4743	4	0	4760
19554	1	4990	12	2	0	5005
19555	0	10	2	5214	0	5226
19556	0	3	1	5201	0	5205
19557	1	7	3	5704	0	5715
19558	5966	1	2	73	0	6042
19559	69	7	5733	8	0	5817
19560	8	5712	70	8	0	5798
19561	4	74	6	5938	0	6022
19562	4	10	3	6144	0	6161
19563	8	6	5960	83	0	6057
19564	1	5	76	5621	0	5703
19565	2	9	5879	84	0	5974
19566	4	13	5344	14	0	5375
19567	1	11	5748	7	0	5767
19568	8	3	84	5461	0	5556
19569	3	1	16	5800	0	5820
19570	2	2	6	5978	0	5988
19571	6018	1	5	84	0	6108
19572	69	5214	3	15	0	5301
19573	5382	77	3	10	0	5472
19574	5320	8	2	6	0	5336
19575	5437	4	3	3	0	5447
19576	83	5235	5	4	0	5327
19577	5453	74	3	2	0	5532
19578	5231	8	4	1	0	5244
19579	86	4	1	5011	0	5102
19580	14	2	1	5016	0	5033
19581	5	3	3	5182	0	5193
19582	6	4	4941	90	0	5041
19583	4473	3	71	16	0	4563
19584	78	2	7	5093	0	5180
19585	5131	0	11	84	0	5226
19586	84	4930	7	14	0	5035
19587	12	73	7	5091	0	5183
19588	7	8	7	5160	0	5182
19589	5125	5	8	85	0	5223
19590	78	6	1	5079	0	5164
19591	5106	5	3	92	0	5206
19592	5047	3	0	20	0	5070
19593	83	4856	9	13	0	4961
19594	16	5061	0	7	0	5084
19595	12	81	5	5450	0	5548
19596	6	5398	10	116	0	5530
19597	8	129	3	5511	0	5651
19598	7	33	5371	138	0	5549
19599	11	25	5084	35	0	5155
19600	4744	12	137	24	0	4917
19601	5434	4	38	18	0	5494
19602	149	5249	24	15	0	5437
19603	5437	121	15	11	0	5584
19604	144	5229	13	11	0	5397
19605	39	138	5	5342	0	5524
19606	20	32	4	5419	0	5475
19607	12	20	8	5320	0	5360
19608	7	13	6	5417	0	5443
19609	5404	7	9	179	0	5599
19610	124	5194	11	60	0	5389
19611	5385	125	12	37	0	5559
19612	5384	23	10	25	0	5442
19613	171	28	5109	15	0	5323
19614	4972	17	120	19	0	5128
19615	151	5036	40	17	0	5244
19616	40	132	19	5272	0	5463
19617	30	26	15	5252	0	5323
19618	15	5072	16	154	0	5257
19619	5272	130	14	51	0	5467
19620	148	37	4964	23	0	5172
19621	4922	19	133	25	0	5099
19622	155	20	5039	25	0	5239
19623	50	11	142	5058	0	5261
19624	32	15	45	5266	0	5358
19625	26	12	24	5336	0	5398
19626	5250	12	14	195	0	5471
19627	153	16	5100	62	0	5331
19628	4986	13	132	41	0	5172
19629	5319	10	35	44	0	5408
19630	5290	18	28	27	0	5363
19631	5342	7	24	27	0	5400
19632	186	14	26	5118	0	5344
19633	71	10	5058	165	0	5304
19634	45	11	134	4944	0	5134
19635	48	10	4924	174	0	5156
19636	42	30	4816	52	0	4940
19637	37	4753	151	48	0	4989
19638	36	132	45	4431	0	4644
19639	31	34	30	4700	0	4795
19640	34	49	22	4210	0	4315
19641	27	19	13	4627	0	4686
19642	4610	16	9	187	0	4822
19643	4618	13	6	66	0	4703
19644	161	14	11	4547	0	4733
19645	71	7	1959	162	0	2199
19646	39	12	128	2063	0	2242
19647	35	10	37	2165	0	2247
19648	41	7	1971	177	0	2196
19649	20	11	123	1533	0	1687
19650	1498	19	31	161	0	1709
19651	1609	11	19	67	0	1706
19652	1640	13	17	42	0	1712
19653	184	10	19	1501	0	1714
19654	1538	12	21	145	0	1716
19655	1623	10	12	52	0	1697
19656	181	16	1476	44	0	1717
19657	43	6	821	35	0	905
19658	18	8	839	34	0	899
19659	740	3	87	25	0	855
19660	75	710	43	13	0	841
19661	743	56	30	13	0	842
19662	86	747	16	12	0	861
19663	47	66	13	739	0	865
19664	34	30	3	796	0	863
19665	23	16	9	829	0	877
19666	20	9	737	98	0	864
19667	749	4	63	52	0	868
19668	72	4	25	782	0	883
19669	42	9	752	70	0	873
19670	31	5	759	42	0	837
19671	754	12	80	18	0	864
19672	67	738	36	25	0	866
19673	790	42	22	29	0	883
19674	812	20	17	26	0	875
19675	75	749	20	29	0	873
19676	809	55	8	17	0	889
19677	79	36	754	19	0	888
19678	46	15	787	24	0	872
19679	32	9	826	20	0	887
19680	22	9	83	797	0	911
19681	26	7	799	71	0	903
19682	781	1	83	38	0	903
19683	842	3	36	31	0	912
19684	83	6	772	29	0	890
19685	52	1	59	796	0	908
19686	798	7	31	69	0	905
19687	73	775	23	40	0	911
19688	52	862	16	16	0	946
19689	852	70	15	25	0	962
19690	86	27	822	16	0	951
19691	59	12	55	805	0	931
19692	34	14	29	856	0	933
19693	30	7	24	876	0	937
19694	17	817	22	100	0	956
19695	0	0	0	347	0	347
19696	365	0	0	0	0	365
19697	1	0	0	369	0	370
19698	0	373	0	2	0	375
19699	397	1	0	0	0	398
19700	1	0	0	399	0	400
19701	0	0	0	404	0	404
19702	408	0	0	1	0	409
19703	406	0	0	0	0	406
19704	4	0	0	417	0	421
19705	448	0	0	4	0	452
19706	451	0	0	1	0	452
19707	5	467	0	0	0	472
19708	469	5	0	0	0	474
19709	5	468	0	0	0	473
19710	2	5	0	477	0	484
19711	0	2	498	5	0	505
19712	0	1	4	488	0	493
19713	1	0	2	493	0	496
19714	0	1	0	500	0	501
19715	496	0	0	10	0	506
19716	5	518	1	2	0	526
19717	549	5	0	0	0	554
19718	5	563	0	2	0	570
19719	588	5	0	2	0	595
19720	597	3	0	0	0	600
19721	594	1	0	1	0	596
19722	598	0	1	1	0	600
19723	9	1	592	3	0	605
19724	4	0	6	602	0	612
19725	1	1	2	636	0	640
19726	2	0	618	8	0	628
19727	602	1	6	2	0	611
19728	5	0	3	626	0	634
19729	2	3	613	7	0	625
19730	1	0	606	4	0	611
19731	1	0	8	626	0	635
19732	3	0	649	7	0	659
19733	2	0	6	659	0	667
19734	0	1	3	670	0	674
19735	1	0	656	10	0	667
19736	633	1	6	6	0	646
19737	7	0	3	667	0	677
19738	4	0	678	7	0	689
19739	1	0	6	682	0	689
19740	684	0	4	6	0	694
19741	7	0	676	2	0	685
19742	660	0	7	3	0	670
19743	688	0	4	1	0	693
19744	8	0	1	688	0	697
19745	4	0	0	676	0	680
19746	1	0	681	9	0	691
19747	2	0	7	677	0	686
19748	1	0	2	663	0	666
19749	0	0	1	690	0	691
19750	0	1	665	10	0	676
19751	655	0	7	3	0	665
19752	676	0	3	4	0	683
19753	706	0	1	3	0	710
19754	727	1	0	1	0	729
19755	11	0	1	726	0	738
19756	723	2	1	8	0	734
19757	714	0	1	4	0	719
19758	698	1	2	1	0	702
19759	708	1	1	3	0	713
19760	10	685	0	4	0	699
19761	712	7	1	2	0	722
19762	681	2	0	4	0	687
19763	11	676	2	2	0	691
19764	689	6	1	2	0	698
19765	7	7	0	688	0	702
19766	7	0	0	691	0	698
19767	682	1	0	11	0	694
19768	8	679	3	5	0	695
19769	8	672	0	2	0	682
19770	3	10	1	689	0	703
19771	3	4	677	11	0	695
19772	5	0	7	674	0	686
19773	3	1	4	675	0	683
19774	667	3	0	10	0	680
19775	662	0	1	5	0	668
19776	10	2	2	661	0	675
19777	6	0	657	11	0	674
19778	2	1	9	672	0	684
19779	672	1	5	7	0	685
19780	10	1	693	11	0	715
19781	3	711	9	4	0	727
19782	744	6	7	1	0	758
19783	9	4	0	744	0	757
19784	5	0	4	734	0	743
19785	4	2	1	747	0	754
19786	3	2	717	13	0	735
19787	658	0	10	5	0	673
19788	11	0	673	5	0	689
19789	6	685	10	6	0	707
19790	2	7	7	698	0	714
19791	2	3	3	708	0	716
19792	5	2	1	741	0	749
19793	2	1	726	15	0	744
19794	5	3	719	7	0	734
19795	1	1	721	6	0	729
19796	0	736	12	8	0	756
19797	1	10	11	765	0	787
19798	791	3	1	11	0	806
19799	2907	1	6	7	0	2921
19800	150	8	2818	2	0	2978
19801	92	2976	142	2	0	3212
19802	90	151	2839	7	0	3087
19803	49	3166	214	4	0	3433
19804	3102	245	121	4	0	3472
19805	3075	127	116	2	0	3320
19806	220	3170	60	4	0	3454
19807	3187	197	41	2	0	3427
19808	279	124	23	2963	0	3389
19809	184	113	8	3205	0	3510
19810	3186	55	21	230	0	3492
19811	3088	64	13	172	0	3337
19812	3038	33	24	138	0	3233
19813	336	2872	15	88	0	3311
19814	219	3163	9	61	0	3452
19815	3192	222	7	21	0	3442
19816	267	182	2927	17	0	3393
19817	162	163	153	3016	0	3494
19818	2919	95	93	166	0	3273
19819	203	2789	110	112	0	3214
19820	170	3039	54	105	0	3368
19821	3136	226	64	54	0	3480
19822	241	204	2938	51	0	3434
19823	3108	167	157	21	0	3453
19824	298	118	2954	20	0	3390
19825	175	95	3068	35	0	3373
19826	206	43	291	2896	0	3436
19827	125	42	3049	174	0	3390
19828	3015	40	304	111	0	3470
19829	3080	49	182	101	0	3412
19830	3136	59	156	69	0	3420
19831	3267	37	71	60	0	3435
19832	438	34	82	2948	0	3502
19833	3058	36	47	176	0	3317
19834	406	2898	42	112	0	3458
19835	230	195	65	2524	0	3014
19836	203	2932	30	208	0	3373
19837	3051	250	43	124	0	3468
19838	3074	165	54	109	0	3402
19839	347	167	31	2996	0	3541
19840	3123	99	48	200	0	3470
19841	3139	101	59	110	0	3409
19842	394	77	42	2989	0	3502
19843	320	54	69	3105	0	3548
19844	253	73	72	3230	0	3628
19845	228	74	2935	379	0	3616
19846	170	82	3046	256	0	3554
19847	155	96	3089	217	0	3557
19848	155	57	358	2998	0	3568
19849	149	62	3103	270	0	3584
19850	169	65	338	3094	0	3666
19851	162	39	3115	316	0	3632
19852	138	74	3112	225	0	3549
19853	2914	66	326	226	0	3532
19854	290	2941	263	163	0	3657
19855	2997	222	202	132	0	3553
19856	377	150	147	2735	0	3409
19857	262	161	121	3032	0	3576
19858	259	121	2802	307	0	3489
19859	196	2943	218	248	0	3605
19860	151	242	149	3013	0	3555
19861	143	144	2915	328	0	3530
19862	130	2990	289	189	0	3598
19863	152	259	199	3123	0	3733
19864	2996	181	204	282	0	3663
19865	3224	189	171	185	0	3769
19866	371	123	213	3113	0	3820
19867	3077	164	159	311	0	3711
19868	418	2960	216	217	0	3811
19869	337	246	159	3091	0	3833
19870	319	198	2960	305	0	3782
19871	290	159	282	3205	0	3936
19872	244	154	3017	379	0	3794
19873	3085	137	306	278	0	3806
19874	376	76	212	2941	0	3605
19875	296	2974	181	349	0	3800
19876	318	215	107	3233	0	3873
19877	283	161	3036	348	0	3828
19878	228	239	3091	245	0	3803
19879	186	158	3130	270	0	3744
19880	2922	200	431	150	0	3703
19881	330	2979	293	179	0	3781
19882	262	210	286	2976	0	3734
19883	2994	162	205	311	0	3672
19884	378	3071	139	242	0	3830
19885	3080	286	109	261	0	3736
19886	3176	230	142	199	0	3747
19887	3334	190	128	171	0	3823
19888	3423	103	194	169	0	3889
19889	501	102	3057	121	0	3781
19890	3259	58	319	168	0	3804
19891	430	61	2965	133	0	3589
19892	3039	46	390	182	0	3657
19893	422	44	314	3006	0	3786
19894	321	72	3027	264	0	3684
19895	340	2829	320	202	0	3691
19896	284	242	227	2616	0	3369
19897	284	2809	198	292	0	3583
19898	196	3136	174	299	0	3805
19899	537	5	8	5	0	555
19900	3	1	477	1	0	482
19901	5	432	2	0	0	439
19902	434	1	0	1	0	436
19903	2	440	0	0	0	442
19904	445	2	0	0	0	447
19905	1	0	0	442	0	443
19906	441	0	1	1	0	443
19907	2	1	0	434	0	437
19908	437	0	0	2	0	439
19909	1	1	0	434	0	436
19910	1	438	0	1	0	440
19911	1	1	0	451	0	453
19912	447	0	1	1	0	449
19913	1	435	0	3	0	439
19914	0	1	1	448	0	450
19915	452	2	0	1	0	455
19916	2	0	0	457	0	459
19917	0	0	0	448	0	448
19918	1	1	467	1	0	470
19919	2	0	452	1	0	455
19920	1	0	3	447	0	451
19921	1	1	506	3	0	511
19922	1	3	1	501	0	506
19923	0	1	0	488	0	489
19924	2	0	0	508	0	510
19925	0	2	532	2	0	536
19926	2	1	1	522	0	526
19927	2	1	0	522	0	525
19928	2	525	0	1	0	528
19929	1	0	0	533	0	534
19930	534	1	1	1	0	537
19931	2	0	1	532	0	535
19932	1	1	609	2	0	613
19933	597	1	4	0	0	602
19934	5	676	1	3	0	685
19935	2	4	2	713	0	721
19936	2	2	711	7	0	722
19937	670	2	5	3	0	680
19938	3	704	2	4	0	713
19939	716	6	2	1	0	725
19940	7	1	0	714	0	722
19941	721	2	1	6	0	730
19942	9	2	732	2	0	745
19943	2	726	4	4	0	736
19944	2	780	2	2	0	786
19945	775	15	4	0	0	794
19946	777	3	0	2	0	782
19947	6	3	772	2	0	783
19948	763	1	4	1	0	769
19949	788	0	1	2	0	791
19950	800	1	2	1	0	804
19951	7	762	2	2	0	773
19952	2	781	1	2	0	786
19953	794	6	0	0	0	800
19954	791	5	1	0	0	797
19955	6	810	0	2	0	818
19956	4	5	2	828	0	839
19957	5	2	821	5	0	833
19958	840	3	6	2	0	851
19959	842	1	4	2	0	849
19960	880	1	4	1	0	886
19961	9	855	0	3	0	867
19962	4	6	858	0	0	868
19963	895	2	3	1	0	901
19964	4	7	1	899	0	911
19965	3	0	2	895	0	900
19966	6	0	3	907	0	916
19967	3	1	891	9	0	904
19968	1	1	5	874	0	881
19969	3	3	879	7	0	892
19970	0	848	5	3	0	856
19971	841	4	2	3	0	850
19972	6	840	4	2	0	852
19973	1	864	2	1	0	868
19974	886	6	0	1	0	893
19975	5	880	0	1	0	886
19976	3	7	1	864	0	875
19977	2	851	1	5	0	859
19978	850	7	1	1	0	859
19979	5	840	1	3	0	849
19980	3	5	0	858	0	866
19981	3	3	849	4	0	859
19982	0	5	5	862	0	872
19983	2	858	1	8	0	869
19984	2	5	2	878	0	887
19985	1	2	0	859	0	862
19986	0	4	1	872	0	877
19987	2	1	1	873	0	877
19988	1	2	1	865	0	869
19989	4	0	0	868	0	872
19990	2	1	861	11	0	875
19991	846	1	5	10	0	862
19992	7	1	4	952	0	964
19993	2	1	950	9	0	962
19994	4	2	958	8	0	972
19995	2	1	11	975	0	989
19996	989	2	7	11	0	1009
19997	10	2	957	6	0	975
19998	963	2	10	4	0	979
19999	13	2	1005	0	0	1020
20000	9	3	13	997	0	1022
20001	5	3	5	1037	0	1050
20002	2	2	1024	17	0	1045
20003	971	2	14	8	0	995
20004	15	0	5	1018	0	1038
20005	8	4	1020	10	0	1042
20006	6	1	1045	9	0	1061
20007	3	2	17	1023	0	1045
20008	2	1042	9	12	0	1065
20009	1064	14	5	7	0	1090
20010	1061	3	3	7	0	1074
20011	17	6	1074	3	0	1100
20012	9	1	12	1047	0	1069
20013	1089	1	7	17	0	1114
20014	14	0	1083	16	0	1113
20015	1069	1	7	8	0	1085
20016	15	1070	10	6	0	1101
20017	8	14	5	1097	0	1124
20018	5	6	3	1112	0	1126
20019	1118	3	4	18	0	1143
20020	14	1	4	1115	0	1134
20021	6	0	3	1091	0	1100
20022	6	0	3	1093	0	1102
20023	1065	2	6	23	0	1096
20024	18	0	1051	9	0	1078
20025	1031	3	13	5	0	1052
20026	1041	2	6	3	0	1052
20027	1047	2	6	4	0	1059
20028	26	1	3	1027	0	1057
20029	15	5	1021	15	0	1056
20030	6	1035	14	10	0	1065
20031	4	1028	10	7	0	1049
20032	6	984	5	4	0	999
20033	1	19	966	4	0	990
20034	3	15	14	1107	0	1139
20035	1138	3	4	20	0	1165
20036	1285	1	1	9	0	1296
20037	22	0	1	1347	0	1370
20038	8	0	1344	24	0	1376
20039	3	0	1354	10	0	1367
20040	5	0	23	1358	0	1386
20041	8	1	1372	20	0	1401
20042	3	1	21	1369	0	1394
20043	3	0	8	1337	0	1348
20044	2	1348	4	23	0	1377
20045	4	22	1	1390	0	1417
20046	2	7	2	1435	0	1446
20047	1401	4	2	30	0	1437
20048	22	1	3	1412	0	1438
20049	7	3	4	1411	0	1425
20050	1382	1	3	32	0	1418
20051	24	1356	2	14	0	1396
20052	1394	19	3	6	0	1422
20053	27	6	1367	5	0	1405
20054	1360	3	22	7	0	1392
20055	1356	0	15	5	0	1376
20056	27	2	1338	5	0	1372
20057	14	1	1331	4	0	1350
20058	5	3	27	1285	0	1320
20059	1286	1	9	27	0	1323
20060	31	4	1251	8	0	1294
20061	9	3	29	1261	0	1302
20062	3	1	1263	30	0	1297
20063	4	0	22	1271	0	1297
20064	6	0	7	1287	0	1300
20065	1274	2	3	31	0	1310
20066	1292	4	5	14	0	1315
20067	1300	1	6	8	0	1315
20068	30	3	1286	10	0	1329
20069	11	4	1296	5	0	1316
20070	5	2	26	1279	0	1312
20071	8	2	8	1293	0	1311
20072	9	1	3	1308	0	1321
20073	1245	2	7	32	0	1286
20074	25	1248	5	12	0	1290
20075	1251	22	4	5	0	1282
20076	1238	7	4	5	0	1254
20077	33	1237	4	4	0	1278
20078	13	1271	5	6	0	1295
20079	1234	31	3	6	0	1274
20080	26	5	3	1244	0	1278
20081	17	1230	3	30	0	1280
20082	13	23	3	1241	0	1280
20083	8	8	1226	32	0	1274
20084	8	2	30	1237	0	1277
20085	1233	0	15	29	0	1277
20086	24	4	1206	13	0	1247
20087	11	4	1211	9	0	1235
20088	7	27	35	1113	0	1182
20089	11	1175	8	30	0	1224
20090	7	1185	3	14	0	1209
20091	6	1202	7	8	0	1223
20092	1139	20	7	11	0	1177
20093	1146	4	5	12	0	1167
20094	1111	2	2	12	0	1127
20095	24	1100	2	12	0	1138
20096	1101	21	3	11	0	1136
20097	1110	5	3	5	0	1123
20098	26	4	1077	8	0	1115
20099	10	1063	20	7	0	1100
20100	10	26	7	1051	0	1094
20101	1050	6	9	21	0	1086
20102	28	5	1040	10	0	1083
20103	9	5	24	1031	0	1069
20104	7	1038	8	29	0	1082
20105	9	19	7	1029	0	1064
20106	9	3	7	1040	0	1059
20107	1018	1	16	29	0	1064
20108	1041	4	10	15	0	1070
20109	20	8	5	1033	0	1066
20110	7	7	1002	35	0	1051
20111	14	2	1000	13	0	1029
20112	1010	4	22	8	0	1044
20113	31	9	1019	7	0	1066
20114	15	4	22	945	0	986
20115	10	965	13	21	0	1009
20116	982	18	11	9	0	1020
20117	26	975	7	11	0	1019
20118	991	16	8	12	0	1027
20119	26	3	10	987	0	1026
20120	10	7	8	1005	0	1030
20121	996	5	7	22	0	1030
20122	1018	3	10	8	0	1039
20123	27	8	6	998	0	1039
20124	9	10	5	1016	0	1040
20125	19	5	988	23	0	1035
20126	12	7	985	8	0	1012
20127	989	10	22	11	0	1032
20128	22	4	970	14	0	1010
20129	969	2	20	16	0	1007
20130	966	4	8	18	0	996
20131	31	3	934	13	0	981
20132	16	909	19	6	0	950
20133	10	918	13	9	0	950
20134	9	13	714	2	0	738
20135	23	74	19	565	0	681
20136	464	12	25	28	0	529
20137	453	2	0	3	0	458
20138	507	3	1	1	0	512
20139	611	1	1	2	0	615
20140	615	1	1	2	0	619
20141	14	623	0	3	0	640
20142	609	12	2	1	0	624
20143	14	608	4	0	0	626
20144	607	10	1	2	0	620
20145	14	3	557	2	0	576
20146	5	2	10	561	0	578
20147	4	0	2	543	0	549
20148	0	551	1	13	0	565
20149	554	11	0	5	0	570
20150	564	4	1	2	0	571
20151	13	1	2	553	0	569
20152	7	0	0	558	0	565
20153	551	0	1	12	0	564
20154	11	0	0	549	0	560
20155	5	0	0	561	0	566
20156	549	0	2	12	0	563
20157	10	1	1	553	0	565
20158	548	2	0	11	0	561
20159	557	0	2	3	0	562
20160	14	1	540	2	0	557
20161	555	0	10	0	0	565
20162	528	0	4	0	0	532
20163	535	1	1	1	0	538
20164	14	1	510	1	0	526
20165	5	1	11	499	0	516
20166	3	1	3	512	0	519
20167	4	0	494	12	0	510
20168	495	1	10	6	0	512
20169	12	0	3	498	0	513
20170	5	0	489	10	0	504
20171	2	0	495	6	0	503
20172	1	1	14	499	0	515
20173	3	1	498	11	0	513
20174	3	1	11	500	0	515
20175	5	0	3	506	0	514
20176	1	0	487	15	0	503
20177	0	1	12	471	0	484
20178	2	465	4	14	0	485
20179	2	488	1	4	0	495
20180	476	13	0	3	0	492
20181	482	4	1	0	0	487
20182	15	473	0	3	0	491
20183	468	10	1	2	0	481
20184	470	3	1	1	0	475
20185	14	2	1	459	0	476
20186	5	3	0	469	0	477
20187	458	0	2	14	0	474
20188	13	453	1	5	0	472
20189	7	460	1	3	0	471
20190	4	12	2	456	0	474
20191	3	4	443	13	0	463
20192	435	0	11	5	0	451
20193	441	2	3	2	0	448
20194	432	1	1	2	0	436
20195	13	430	2	1	0	446
20196	5	12	1	425	0	443
20197	4	3	0	441	0	448
20198	428	1	4	14	0	447
20199	14	425	0	7	0	446
20200	7	11	0	424	0	442
20201	7	7	2	427	0	443
20202	2	1	2	427	0	432
20203	405	1	0	17	0	423
20204	13	409	1	6	0	429
20205	5	14	2	392	0	413
20206	6	402	1	10	0	419
20207	400	12	2	8	0	422
20208	13	3	394	5	0	415
20209	395	3	10	3	0	411
20210	11	2	381	3	0	397
20211	7	5	7	363	0	382
20212	360	0	5	8	0	373
20213	9	0	333	6	0	348
20214	349	1	6	2	0	358
20215	356	0	4	0	0	360
20216	352	1	2	2	0	357
20217	10	1	1	334	0	346
20218	6	0	1	338	0	345
20219	2	0	0	339	0	341
20220	324	1	1	11	0	337
20221	8	324	1	3	0	336
20222	318	6	1	2	0	327
20223	330	3	1	0	0	334
20224	11	1	314	1	0	327
20225	325	0	4	1	0	330
20226	326	1	5	1	0	333
20227	8	1	1	323	0	333
20228	3	0	1	327	0	331
20229	2	0	3	328	0	333
20230	320	1	0	11	0	332
20231	316	1	1	5	0	323
20232	314	1	2	1	0	318
20233	8	294	1	1	0	304
20234	3	276	0	1	0	280
20235	1	276	1	1	0	279
20236	269	10	3	1	0	283
20237	6	3	262	1	0	272
20238	4	1	204	0	0	209
20239	91	1	4	0	0	96
20240	1	0	96	0	0	97
20241	0	0	0	52	0	52
20242	0	52	0	0	0	52
20243	56	0	0	0	0	56
20244	56	0	0	0	0	56
20245	55	0	0	0	0	55
20246	0	0	0	65	0	65
20247	0	0	67	0	0	67
20248	0	0	68	0	0	68
20249	69	0	0	0	0	69
20250	71	0	0	0	0	71
20251	68	0	0	0	0	68
20252	0	0	0	69	0	69
20253	0	0	0	68	0	68
20254	0	0	66	0	0	66
20255	68	0	0	0	0	68
20256	0	0	0	69	0	69
20257	0	0	0	70	0	70
20258	0	0	0	70	0	70
20259	0	69	0	0	0	69
20260	0	0	0	70	0	70
20261	0	0	0	70	0	70
20262	69	0	0	0	0	69
20263	0	0	68	0	0	68
20264	70	0	0	0	0	70
20265	74	0	0	0	0	74
20266	0	0	0	76	0	76
20267	0	0	0	76	0	76
20268	76	0	0	0	0	76
20269	0	0	76	0	0	76
20270	0	77	0	0	0	77
20271	0	0	0	82	0	82
20272	82	0	0	0	0	82
20273	0	0	0	82	0	82
20274	0	0	82	0	0	82
20275	0	0	87	0	0	87
20276	93	0	0	0	0	93
20277	0	0	0	98	0	98
20278	0	0	96	2	0	98
20279	104	0	1	0	0	105
20280	119	0	0	0	0	119
20281	0	0	0	123	0	123
20282	0	0	0	122	0	122
20283	0	120	0	0	0	120
20284	127	0	0	0	0	127
20285	0	0	0	130	0	130
20286	0	0	0	130	0	130
20287	0	0	134	0	0	134
20288	128	0	0	0	0	128
20289	133	0	0	0	0	133
20290	0	133	0	0	0	133
20291	0	0	129	0	0	129
20292	0	0	127	0	0	127
20293	0	0	0	127	0	127
20294	136	0	0	0	0	136
20295	0	0	0	135	0	135
20296	140	0	0	0	0	140
20297	141	0	0	0	0	141
20298	146	0	0	1	0	147
20299	0	0	0	149	0	149
20300	0	0	0	150	0	150
20301	151	0	0	0	0	151
20302	0	0	154	0	0	154
20303	150	0	0	0	0	150
20304	152	0	0	0	0	152
20305	0	0	158	0	0	158
20306	0	0	157	0	0	157
20307	0	154	0	0	0	154
20308	0	0	0	156	0	156
20309	143	1	0	0	0	144
20310	0	0	0	158	0	158
20311	0	0	164	0	0	164
20312	0	161	0	0	0	161
20313	0	161	0	0	0	161
20314	0	1	0	165	0	166
20315	1	0	0	165	0	166
20316	0	159	0	1	0	160
20317	0	1	163	0	0	164
20318	158	0	1	0	0	159
20319	168	0	0	0	0	168
20320	2	166	0	0	0	168
20321	166	1	0	0	0	167
20322	1	0	0	162	0	163
20323	163	0	0	1	0	164
20324	1	0	0	161	0	162
20325	0	164	0	1	0	165
20326	0	1	159	0	0	160
20327	0	0	1	169	0	170
20328	0	0	0	168	0	168
20329	0	0	0	171	0	171
20330	174	0	0	1	0	175
20331	1	0	0	172	0	173
20332	0	0	192	1	0	193
20333	0	0	212	0	0	212
20334	224	0	1	0	0	225
20335	1	0	228	0	0	229
20336	226	0	1	0	0	227
20337	1	0	0	243	0	244
20338	1	0	0	253	0	254
20339	0	0	0	279	0	279
20340	0	0	0	284	0	284
20341	285	0	0	3	0	288
20342	5	0	285	0	0	290
20343	0	0	3	284	0	287
20344	0	293	0	3	0	296
20345	297	3	0	0	0	300
20346	3	0	0	287	0	290
20347	287	0	0	4	0	291
20348	3	1	287	0	0	291
20349	1	0	3	278	0	282
20350	0	288	0	3	0	291
20351	295	3	0	0	0	298
20352	3	0	293	0	0	296
20353	0	0	3	290	0	293
20354	1	1	0	293	0	295
20355	293	0	0	3	0	296
20356	3	0	288	0	0	291
20357	0	0	293	1	0	294
20358	0	0	3	288	0	291
20359	1	0	288	3	0	292
20360	0	0	296	0	0	296
20361	0	0	3	291	0	294
20362	0	1	0	293	0	294
20363	0	0	1	304	0	305
20364	299	0	0	3	0	302
20365	3	299	0	1	0	303
20366	298	3	0	1	0	302
20367	3	0	0	300	0	303
20368	1	303	0	3	0	307
20369	0	4	0	305	0	309
20370	314	0	0	3	0	317
20371	3	315	0	1	0	319
20372	1	4	0	324	0	329
20373	0	1	320	4	0	325
20374	320	0	3	1	0	324
20375	3	1	1	312	0	317
20376	1	0	0	316	0	317
20377	2	0	308	4	0	314
20378	2	0	303	1	0	306
20379	295	0	4	1	0	300
20380	3	288	1	1	0	293
20381	1	3	1	285	0	290
20382	288	0	1	3	0	292
20383	4	0	288	1	0	293
20384	1	286	3	0	0	290
20385	0	3	1	1487	0	1491
20386	1526	1	0	3	0	1530
20387	1456	1	1	1	0	1459
20388	1487	1	0	0	0	1488
20389	4	1376	2	2	0	1384
20390	4	3	1421	0	0	1428
20391	3	2	3	1394	0	1402
20392	1	1	1	1396	0	1399
20393	0	1	0	1478	0	1479
20394	0	1	1	1503	0	1505
20395	1509	0	0	5	0	1514
20396	1420	0	0	4	0	1424
20397	4	1	1466	1	0	1472
20398	2	1	1322	1	0	1326
20399	1373	1	4	0	0	1378
20400	1469	0	1	0	0	1470
20401	4	0	1	1446	0	1451
20402	2	1346	1	4	0	1353
20403	1490	2	0	2	0	1494
20404	3	1380	2	2	0	1387
20405	1	1348	1	1	0	1351
20406	0	6	0	1482	0	1488
20407	1	0	0	1456	0	1457
20408	1	2	0	1415	0	1418
20409	0	1	1	1439	0	1441
20410	1	1	1415	4	0	1421
20411	1366	0	3	2	0	1371
20412	1444	0	1	1	0	1446
20413	3	1	0	1440	0	1444
20414	1	0	1	1448	0	1450
20415	1466	0	0	3	0	1469
20416	3	3	1366	1	0	1373
20417	1388	0	2	1	0	1391
20418	1432	0	1	2	0	1435
20419	4	3	1316	1	0	1324
20420	1378	0	4	0	0	1382
20421	3	0	1	1402	0	1406
20422	2	0	0	1395	0	1397
20423	0	0	1	1416	0	1417
20424	1	0	0	1412	0	1413
20425	1433	0	0	4	0	1437
20426	2	0	0	1431	0	1433
20427	1	0	0	1398	0	1399
20428	0	1316	5	5	0	1326
20429	1	1315	1	3	0	1320
20430	0	3	0	1430	0	1433
20431	1411	1	0	4	0	1416
20432	2	3	0	1372	0	1377
20433	1	1	1320	3	0	1325
20434	2	7	1127	2	0	1138
20435	1134	0	3	2	0	1139
20436	2	1243	4	2	0	1251
20437	1269	2	1	0	0	1272
20438	3	2	1274	0	0	1279
20439	3	5	4	1227	0	1239
20440	1271	1	2	1	0	1275
20441	1	1181	0	1	0	1183
20442	1249	0	0	0	0	1249
20443	2	2	1227	0	0	1231
20444	2	0	0	1204	0	1206
20445	0	0	1	1217	0	1218
20446	1246	0	0	1	0	1247
20447	1164	0	0	1	0	1165
20448	1223	1	0	0	0	1224
20449	1211	0	2	0	0	1213
20450	1232	0	1	0	0	1233
20451	1	1137	1	0	0	1139
20452	1	1	0	1241	0	1243
20453	1253	1	0	0	0	1254
20454	1	2	0	1196	0	1199
20455	1	0	0	1208	0	1209
20456	0	0	0	1244	0	1244
20457	0	1185	1	1	0	1187
20458	1247	0	0	1	0	1248
20459	0	1	0	1227	0	1228
20460	1241	0	0	2	0	1243
20461	1222	0	0	1	0	1223
20462	1	1165	4	0	0	1170
20463	1241	0	0	1	0	1242
20464	3	0	1174	0	0	1177
20465	1163	0	0	0	0	1163
20466	0	0	1	1201	0	1202
20467	4	0	1199	0	0	1203
20468	0	1059	5	4	0	1068
20469	2	2	1158	0	0	1162
20470	0	1094	6	3	0	1103
20471	1203	0	0	0	0	1203
20472	1155	0	0	0	0	1155
20473	1158	0	0	1	0	1159
20474	0	1122	1	0	0	1123
20475	1183	0	1	0	0	1184
20476	3	6	2307	0	0	2316
20477	4	5	2349	3	0	2361
20478	1	2	0	2388	0	2391
20479	0	0	0	2503	0	2503
20480	1	2369	1	2	0	2373
20481	2564	0	0	0	0	2564
20482	0	0	0	2531	0	2531
20483	0	2387	6	0	0	2393
20484	1	1	0	2581	0	2583
20485	1539	0	1	0	0	1540
20486	1508	0	0	0	0	1508
20487	1	1	1472	1	0	1475
20488	0	1	0	1448	0	1449
20489	1	2	1496	2	0	1501
20490	0	0	0	1477	0	1477
20491	1	1	1499	2	0	1503
20492	0	1	0	1471	0	1472
20493	2	0	1507	1	0	1510
20494	0	2	0	1450	0	1452
20495	2	0	1514	0	0	1516
20496	1	1	1	1427	0	1430
20497	0	0	0	1522	0	1522
20498	0	1459	2	1	0	1462
20499	0	0	0	1572	0	1572
20500	2	1	1528	0	0	1531
20501	0	0	0	1479	0	1479
20502	1	0	0	1544	0	1545
20503	1574	0	0	0	0	1574
20504	0	0	0	1554	0	1554
20505	0	0	0	1537	0	1537
20506	2	2	1503	0	0	1507
20507	1411	1	0	0	0	1412
20508	0	1	0	1553	0	1554
20509	0	1	0	1547	0	1548
20510	0	0	0	1569	0	1569
20511	1573	0	0	0	0	1573
20512	0	0	1	1544	0	1545
20513	0	0	0	1542	0	1542
20514	1571	0	0	1	0	1572
20515	0	1515	0	2	0	1517
20516	0	0	0	1563	0	1563
20517	0	0	0	1560	0	1560
20518	1	0	1540	0	0	1541
20519	1084	1	4	6	0	1095
20520	1	0	0	1517	0	1518
20521	1	0	1528	0	0	1529
20522	1468	0	0	2	0	1470
20523	0	0	0	1538	0	1538
20524	0	0	0	1518	0	1518
20525	0	0	0	1548	0	1548
20526	0	0	0	1533	0	1533
20527	2	2	2651	2	0	2657
20528	0	2	93	2636	0	2731
20529	1	0	8	3915	0	3924
20530	2	3	3727	203	0	3935
20531	3802	1	183	43	0	4029
20532	4087	0	39	37	0	4163
20533	4108	0	35	14	0	4157
20534	272	1	13	3935	0	4221
20535	4033	0	4	199	0	4236
20536	4135	1	6	44	0	4186
20537	257	0	0	3956	0	4213
20538	3959	2	8	211	0	4180
20539	4102	0	17	52	0	4171
20540	4073	6	8	63	0	4150
20541	4149	1	7	40	0	4197
20542	287	1	17	3834	0	4139
20543	114	3757	11	199	0	4081
20544	89	3896	12	49	0	4046
20545	59	4000	7	40	0	4106
20546	3862	263	5	38	0	4168
20547	4108	87	3	22	0	4220
20548	284	59	3773	21	0	4137
20549	3894	25	186	24	0	4129
20550	281	9	38	3928	0	4256
20551	105	5	32	4064	0	4206
20552	88	3	14	4152	0	4257
20553	3942	4	8	292	0	4246
20554	232	6	7	3962	0	4207
20555	69	3793	6	270	0	4138
20556	50	218	5	3995	0	4268
20557	40	73	3766	252	0	4131
20558	51	49	185	3921	0	4206
20559	3944	26	49	257	0	4276
20560	240	15	3764	74	0	4093
20561	86	12	195	3805	0	4098
20562	69	15	61	3865	0	4010
20563	39	12	36	4011	0	4098
20564	31	3728	19	310	0	4088
20565	55	197	14	3998	0	4264
20566	3893	40	10	289	0	4232
20567	4065	54	8	91	0	4218
20568	274	26	3773	90	0	4163
20569	105	26	3880	50	0	4061
20570	70	15	238	3787	0	4110
20571	62	12	78	4025	0	4177
20572	46	12	3752	278	0	4088
20573	43	13	208	3521	0	3785
20574	30	3624	75	250	0	3979
20575	3840	195	45	105	0	4185
20576	2783	65	30	78	0	2956
20577	2833	41	21	80	0	2975
20578	335	31	2518	50	0	2934
20579	148	15	198	2636	0	2997
20580	99	17	2498	240	0	2854
20581	2580	13	252	82	0	2927
20582	240	2529	74	97	0	2940
20583	80	193	60	2646	0	2979
20584	2571	47	56	268	0	2942
20585	261	46	26	2627	0	2960
20586	103	40	41	2848	0	3032
20587	116	22	2477	308	0	2923
20588	2619	24	207	125	0	2975
20589	308	2504	49	106	0	2967
20590	125	207	65	2639	0	3036
20591	2633	54	36	284	0	3007
20592	291	52	34	2668	0	3045
20593	2617	36	34	286	0	2973
20594	307	2574	34	120	0	3035
20595	2721	207	25	124	0	3077
20596	349	55	2526	75	0	3005
20597	2728	52	218	95	0	3093
20598	2859	36	69	94	0	3058
20599	2886	43	74	75	0	3078
20600	366	49	31	2627	0	3073
20601	182	60	18	2771	0	3031
20602	171	39	20	2743	0	2973
20603	133	2561	19	325	0	3038
20604	2640	215	33	171	0	3059
20605	321	61	29	2657	0	3068
20606	139	68	33	2842	0	3082
20607	143	36	25	2894	0	3098
20608	2625	33	31	377	0	3066
20609	294	42	21	2727	0	3084
20610	136	43	2439	339	0	2957
20611	111	2555	195	150	0	3011
20612	85	234	47	2674	0	3040
20613	79	81	63	2825	0	3048
20614	58	64	63	2927	0	3112
20615	82	59	2475	354	0	2970
20616	90	21	2649	191	0	2951
20617	62	25	256	2728	0	3071
20618	52	15	2556	359	0	2982
20619	56	20	230	2780	0	3086
20620	2602	30	73	365	0	3070
20621	2805	41	58	177	0	3081
20622	2891	26	51	140	0	3108
20623	336	38	2549	89	0	3012
20624	2723	31	228	97	0	3079
20625	317	33	88	2689	0	3127
20626	134	9	2618	307	0	3068
20627	65	8	1441	67	0	1581
20628	37	1417	145	79	0	1678
20629	5	269	2	0	0	276
20630	214	10	5	0	0	229
20631	6	0	0	206	0	212
20632	1	1	207	2	0	211
20633	1	0	1	215	0	217
20634	220	0	0	3	0	223
20635	2	0	233	1	0	236
20636	241	0	2	0	0	243
20637	250	1	0	0	0	251
20638	251	0	0	0	0	251
20639	2	247	0	0	0	249
20640	257	2	0	1	0	260
20641	3	0	0	263	0	266
20642	1	0	0	261	0	262
20643	0	0	0	264	0	264
20644	0	0	1	264	0	265
20645	259	1	0	2	0	262
20646	2	257	0	2	0	261
20647	0	239	0	1	0	240
20648	0	255	0	1	0	256
20649	258	1	1	0	0	260
20650	254	0	1	0	0	255
20651	256	0	0	1	0	257
20652	255	0	1	0	0	256
20653	2	0	0	256	0	258
20654	1	0	0	256	0	257
20655	258	0	0	2	0	260
20656	2	254	1	0	0	257
20657	250	1	1	0	0	252
20658	256	0	1	1	0	258
20659	1	0	1	250	0	252
20660	0	250	0	2	0	252
20661	1	1	0	261	0	263
20662	260	0	0	1	0	261
20663	2	0	262	0	0	264
20664	0	0	2	263	0	265
20665	1	263	0	1	0	265
20666	266	1	0	0	0	267
20667	260	0	2	0	0	262
20668	0	0	271	0	0	271
20669	0	267	1	0	0	268
20670	0	2	270	0	0	272
20671	1	0	0	262	0	263
20672	0	0	260	2	0	262
20673	0	1	255	1	0	257
20674	1	261	1	1	0	264
20675	267	1	1	0	0	269
20676	265	0	1	0	0	266
20677	3	273	0	0	0	276
20678	2	270	0	0	0	272
20679	1	2	266	0	0	269
20680	1	1	266	0	0	268
20681	1	0	265	0	0	266
20682	0	0	1	272	0	273
20683	0	0	271	3	0	274
20684	0	0	1	269	0	270
20685	1	0	1	266	0	268
20686	0	0	270	2	0	272
20687	0	269	2	0	0	271
20688	0	3	0	270	0	273
20689	269	1	0	1	0	271
20690	3	0	0	272	0	275
20691	2	0	265	4	0	271
20692	2	268	1	0	0	271
20693	1	277	0	1	0	279
20694	0	1	0	275	0	276
20695	271	0	0	1	0	272
20696	266	1	0	1	0	268
20697	2	1	0	267	0	270
20698	2	273	0	1	0	276
20699	1	1	0	277	0	279
20700	0	1	0	276	0	277
20701	0	1	0	279	0	280
20702	308	0	0	2	0	310
20703	1	315	2	0	0	318
20704	324	1	0	0	0	325
20705	326	1	0	2	0	329
20706	327	1	0	0	0	328
20707	340	1	0	0	0	341
20708	4	0	1	331	0	336
20709	1	1	333	3	0	338
20710	0	319	3	2	0	324
20711	336	2	2	2	0	342
20712	338	1	1	2	0	342
20713	341	0	2	0	0	343
20714	3	2	331	0	0	336
20715	331	0	2	0	0	333
20716	340	1	1	0	0	342
20717	4	0	0	337	0	341
20718	1	1	316	2	0	320
20719	1	309	3	2	0	315
20720	0	2	2	310	0	314
20721	304	1	0	4	0	309
20722	2	0	0	305	0	307
20723	2	0	1	310	0	313
20724	320	1	0	4	0	325
20725	4	0	309	2	0	315
20726	310	0	2	1	0	313
20727	310	1	2	1	0	314
20728	308	2	0	1	0	311
20729	308	0	0	1	0	309
20730	5	0	296	1	0	302
20731	3	0	3	299	0	305
20732	0	1	299	2	0	302
20733	1	0	1	291	0	293
20734	1	0	290	1	0	292
20735	262	0	1	3	0	266
20736	1	254	3	0	0	258
20737	2	247	0	0	0	249
20738	0	2	0	271	0	273
20739	1	3	0	272	0	276
20740	0	275	0	4	0	279
20741	279	3	0	4	0	286
20742	297	2	0	0	0	299
20743	311	0	1	0	0	312
20744	338	0	0	0	0	338
20745	6	0	0	345	0	351
20746	2	0	0	353	0	355
20747	360	0	0	5	0	365
20748	3	0	1	353	0	357
20749	2	0	335	4	0	341
20750	0	2	337	3	0	342
20751	0	0	5	348	0	353
20752	0	0	346	3	0	349
20753	347	0	3	2	0	352
20754	3	0	2	355	0	360
20755	355	1	0	4	0	360
20756	4	0	350	3	0	357
20757	2	0	4	348	0	354
20758	2	7	1486	5	0	1500
20759	4	1454	6	4	0	1468
20760	1589	4	5	0	0	1598
20761	1589	2	0	0	0	1591
20762	8	1474	0	0	0	1482
20763	1597	4	0	2	0	1603
20764	5	1	0	1544	0	1550
20765	3	0	1	1555	0	1559
20766	1582	0	0	7	0	1589
20767	5	1513	2	2	0	1522
20768	1	1475	2	1	0	1479
20769	0	6	1	1575	0	1582
20770	1575	3	1	4	0	1583
20771	1534	0	1	3	0	1538
20772	1451	0	2	2	0	1455
20773	8	1	1532	1	0	1542
20774	3	2	1432	5	0	1442
20775	1	1440	8	1	0	1450
20776	1564	4	5	0	0	1573
20777	5	3	0	1526	0	1534
20778	1560	0	0	6	0	1566
20779	1529	0	0	3	0	1532
20780	11	2	0	1500	0	1513
20781	7	0	1535	6	0	1548
20782	1390	1	8	6	0	1405
20783	6	1	4	1551	0	1562
20784	6	0	1535	7	0	1548
20785	1338	1	8	5	0	1352
20786	1459	1	5	0	0	1465
20787	9	1	0	1508	0	1518
20788	5	2	1520	7	0	1534
20789	1	0	7	1430	0	1438
20790	3	1424	6	5	0	1438
20791	1	8	1476	3	0	1488
20792	1	1371	9	2	0	1383
20793	1528	7	4	0	0	1539
20794	1497	3	0	1	0	1501
20795	1473	1	0	1	0	1475
20796	1504	0	1	1	0	1506
20797	9	1	0	1469	0	1479
20798	1516	0	0	7	0	1523
20799	7	0	1	1470	0	1478
20800	1496	0	0	7	0	1503
20801	7	1427	3	4	0	1441
20802	3	5	1	1452	0	1461
20803	1	1413	2	6	0	1422
20804	1437	6	0	3	0	1446
20805	1411	1	0	2	0	1414
20806	9	1383	2	1	0	1395
20807	2	7	0	1428	0	1437
20808	1	2	1395	5	0	1403
20809	1	0	7	1298	0	1306
20810	1	0	1395	6	0	1402
20811	0	2	3	1331	0	1336
20812	0	1301	4	5	0	1310
20813	1423	5	1	1	0	1430
20814	1357	2	0	2	0	1361
20815	7	0	1	1343	0	1351
20816	1422	0	0	6	0	1428
20817	5	1	0	1387	0	1393
20818	3	0	0	1386	0	1389
20819	1	0	0	1415	0	1416
20820	1395	0	0	8	0	1403
20821	1334	0	0	2	0	1336
20822	1345	3	0	3	0	1351
20823	6	1326	2	1	0	1335
20824	1394	5	0	1	0	1400
20825	5	1320	1	0	0	1326
20826	1386	6	0	0	0	1392
20827	6	1	0	1335	0	1342
20828	0	2	0	1346	0	1348
20829	1381	0	0	5	0	1386
20830	1344	1	0	1	0	1346
20831	5	1293	1	0	0	1299
20832	1394	5	0	1	0	1400
20833	5	0	0	1350	0	1355
20834	2	0	0	1326	0	1328
20835	1342	0	0	6	0	1348
20836	6	3	1304	3	0	1316
20837	2	1200	9	0	0	1211
20838	0	4	1	1295	0	1300
20839	2	1	1302	4	0	1309
20840	4	6	3	1210	0	1223
20841	1284	0	2	3	0	1289
20842	3	1174	3	1	0	1181
20843	1	1170	2	2	0	1175
20844	2	1204	4	0	0	1210
20845	0	7	1	1204	0	1212
20846	1220	2	1	3	0	1226
20847	4	2	0	1146	0	1152
20848	1210	1	0	4	0	1215
20849	1199	1	0	1	0	1201
20850	3	1	0	1131	0	1135
20851	1208	0	0	2	0	1210
20852	3	0	0	1160	0	1163
20853	3	0	1154	3	0	1160
20854	1046	0	3	1	0	1050
20855	1	0	1127	2	0	1130
20856	1018	0	2	2	0	1022
20857	4	0	1105	1	0	1110
20858	1	0	3	101	0	105
20859	2	0	1	107	0	110
20860	104	0	1	4	0	109
20861	3	0	0	111	0	114
20862	108	0	1	3	0	112
20863	2	106	0	2	0	110
20864	109	1	0	2	0	112
20865	3	0	0	114	0	117
20866	1	1	0	117	0	119
20867	2	0	0	119	0	121
20868	0	1	0	119	0	120
20869	1	0	114	3	0	118
20870	0	0	114	3	0	117
20871	0	0	2	116	0	118
20872	0	0	120	3	0	123
20873	0	112	4	2	0	118
20874	0	2	1	115	0	118
20875	0	0	114	2	0	116
20876	0	1	111	1	0	113
20877	0	0	1	113	0	114
20878	1	0	1	118	0	120
20879	0	116	1	0	0	117
20880	0	0	0	124	0	124
20881	0	0	124	2	0	126
20882	123	1	0	0	0	124
20883	0	0	0	136	0	136
20884	1209	0	1	2	0	1212
20885	1231	1	0	0	0	1232
20886	1248	0	0	2	0	1250
20887	36	0	1200	1	0	1237
20888	7	3	1176	1	0	1187
20889	1206	0	30	1	0	1237
20890	35	4	1175	1	0	1215
20891	3	0	37	1153	0	1193
20892	5	1	5	1192	0	1203
20893	6	3	1091	25	0	1125
20894	3	1189	32	3	0	1227
20895	1154	29	3	3	0	1189
20896	27	1174	9	4	0	1214
20897	3	1233	4	2	0	1242
20898	1223	34	4	1	0	1262
20899	36	2	1185	3	0	1226
20900	21	6	1202	3	0	1232
20901	23	4	34	1233	0	1294
20902	1210	3	9	33	0	1255
20903	33	1208	23	1	0	1265
20904	1243	33	23	4	0	1303
20905	52	6	1148	5	0	1211
20906	14	1214	47	5	0	1280
20907	12	31	9	1248	0	1300
20908	12	5	1219	46	0	1282
20909	8	7	46	1264	0	1325
20910	7	19	10	1276	0	1312
20911	21	8	4	1279	0	1312
20912	10	17	9	1300	0	1336
20913	1246	13	9	42	0	1310
20914	1306	7	9	12	0	1334
20915	47	2	1228	12	0	1289
20916	1232	7	49	9	0	1297
20917	48	1218	13	16	0	1295
20918	1276	36	13	6	0	1331
20919	44	20	1226	7	0	1297
20920	28	9	42	1269	0	1348
20921	13	9	1210	42	0	1274
20922	15	15	1222	12	0	1264
20923	8	8	47	1274	0	1337
20924	16	7	27	1284	0	1334
20925	18	15	1123	55	0	1211
20926	21	1159	43	27	0	1250
20927	13	1204	17	29	0	1263
20928	15	40	18	1274	0	1347
20929	1174	4	19	47	0	1244
20930	62	1189	22	14	0	1287
20931	28	37	1228	19	0	1312
20932	34	12	1222	22	0	1290
20933	25	31	1229	12	0	1297
20934	39	15	49	1264	0	1367
20935	1244	10	43	41	0	1338
20936	51	1217	34	26	0	1328
20937	11	41	1203	27	0	1282
20938	26	1216	64	24	0	1330
20939	20	45	30	1245	0	1340
20940	28	16	1195	71	0	1310
20941	27	1215	66	24	0	1332
20942	32	54	28	1221	0	1335
20943	51	32	20	1298	0	1401
20944	58	19	1229	53	0	1359
20945	46	18	73	1151	0	1288
20946	30	1241	48	60	0	1379
20947	34	45	1269	29	0	1377
20948	1237	19	87	35	0	1378
20949	62	15	54	1273	0	1404
20950	27	19	38	1228	0	1312
20951	39	1233	32	63	0	1367
20952	1283	73	39	23	0	1418
20953	66	33	1209	24	0	1332
20954	1262	44	62	35	0	1403
20955	64	33	36	1202	0	1335
20956	28	1207	46	65	0	1346
20957	32	61	42	1212	0	1347
20958	28	25	37	1309	0	1399
20959	1241	17	39	86	0	1383
20960	1270	28	44	38	0	1380
20961	64	30	33	1286	0	1413
20962	38	34	1196	60	0	1328
20963	1208	30	79	24	0	1341
20964	64	1207	43	43	0	1357
20965	31	49	26	1245	0	1351
20966	21	30	31	1296	0	1378
20967	24	30	39	1300	0	1393
20968	35	22	1162	78	0	1297
20969	20	14	67	1224	0	1325
20970	37	1192	34	93	0	1356
20971	35	54	31	1131	0	1251
20972	37	1230	26	73	0	1366
20973	37	49	25	1271	0	1382
20974	36	25	1180	80	0	1321
20975	1258	27	62	40	0	1387
20976	81	29	36	1242	0	1388
20977	26	25	1160	87	0	1298
20978	26	1209	85	41	0	1361
20979	1254	50	42	50	0	1396
20980	49	28	1185	52	0	1314
20981	1218	24	72	62	0	1376
20982	56	25	42	1266	0	1389
20983	27	26	38	1315	0	1406
20984	0	112	1	2	0	115
20985	114	2	0	0	0	116
20986	120	0	0	1	0	121
20987	2	114	1	0	0	117
20988	0	4	0	115	0	119
20989	1	0	0	120	0	121
20990	0	0	2	117	0	119
20991	1	0	115	2	0	118
20992	115	0	2	0	0	117
20993	2	1	0	115	0	118
20994	0	0	1	118	0	119
20995	0	0	111	3	0	114
20996	1	1	104	0	0	106
20997	1	1	3	603	0	608
20998	2	0	606	3	0	611
20999	554	0	5	1	0	560
21000	3	0	0	598	0	601
21001	0	1	1	596	0	598
21002	2	1	604	3	0	610
21003	0	0	2	556	0	558
21004	1	0	608	2	0	611
21005	0	566	2	2	0	570
21006	570	2	1	0	0	573
21007	586	0	0	1	0	587
21008	2	566	1	2	0	571
21009	1	1	1	585	0	588
21010	2	1	592	1	0	596
21011	1	0	1	576	0	578
21012	595	0	2	1	0	598
21013	2	569	0	1	0	572
21014	600	1	0	0	0	601
21015	1	0	0	588	0	589
21016	604	0	0	2	0	606
21017	1	580	0	2	0	583
21018	603	1	1	0	0	605
21019	2	0	596	1	0	599
21020	0	576	1	1	0	578
21021	0	2	0	613	0	615
21022	632	0	0	1	0	633
21023	628	0	0	1	0	629
21024	1	0	1	619	0	621
21025	636	0	0	1	0	637
21026	620	0	0	1	0	621
21027	629	0	1	1	0	631
21028	1	1	0	625	0	627
21029	1	0	621	1	0	623
21030	0	0	573	0	0	573
21031	0	1	592	0	0	593
21032	589	0	1	0	0	590
21033	1	0	0	616	0	617
21034	0	591	0	2	0	593
21035	0	2	0	617	0	619
21036	0	587	3	2	0	592
21037	625	1	0	1	0	627
21038	1	1	0	622	0	624
21039	0	0	0	615	0	615
21040	624	1	0	3	0	628
21041	3	0	0	617	0	620
21042	0	0	0	622	0	622
21043	644	0	0	4	0	648
21044	4	0	634	2	0	640
21045	0	0	4	626	0	630
21046	1	1	638	3	0	643
21047	603	0	2	0	0	605
21048	2	0	1	643	0	646
21049	644	0	1	3	0	648
21050	3	0	0	640	0	643
21051	0	0	654	5	0	659
21052	0	2	3	650	0	655
21053	649	0	1	3	0	653
21054	4	608	1	1	0	614
21055	1	4	630	0	0	635
21056	601	0	3	1	0	605
21057	3	616	2	1	0	622
21058	0	617	0	1	0	618
21059	0	619	0	1	0	620
21060	1	5	0	656	0	662
21061	660	1	1	7	0	669
21062	654	0	1	0	0	655
21063	8	0	659	1	0	668
21064	648	0	8	0	0	656
21065	7	649	2	0	0	658
21066	0	5	0	682	0	687
21067	688	0	0	6	0	694
21068	689	1	0	0	0	690
21069	687	1	0	0	0	688
21070	684	0	0	1	0	685
21071	682	0	0	0	0	682
21072	8	0	0	684	0	692
21073	0	2	689	7	0	698
21074	1	0	7	674	0	682
21075	0	0	0	687	0	687
21076	693	0	0	5	0	698
21077	8	660	1	0	0	669
21078	686	7	0	0	0	693
21079	676	0	0	0	0	676
21080	665	0	0	0	0	665
21081	680	0	0	0	0	680
21082	8	0	671	1	0	680
21083	654	0	7	0	0	661
21084	684	0	0	1	0	685
21085	668	3	0	1	0	672
21086	676	0	1	0	0	677
21087	8	0	0	672	0	680
21088	3	0	666	7	0	676
21089	667	0	5	0	0	672
21090	9	665	1	1	0	676
21091	3	7	0	673	0	683
21092	0	674	3	9	0	686
21093	2	7	1	688	0	698
21094	693	0	0	9	0	702
21095	688	0	0	1	0	689
21096	688	1	0	0	0	689
21097	7	1	229	1	0	238
21098	231	0	8	0	0	239
21099	9	1	224	0	0	234
21100	1	1	231	0	0	233
21101	1	1	234	1	0	237
21102	0	1	7	227	0	235
21103	2	0	0	233	0	235
21104	2	0	0	233	0	235
21105	3	0	1	232	0	236
21106	3	0	0	235	0	238
21107	0	1	0	234	0	235
21108	1	228	0	7	0	236
21109	227	6	1	0	0	234
21110	8	224	1	0	0	233
21111	1	7	1	225	0	234
21112	1	1	0	235	0	237
21113	229	0	0	8	0	237
21114	7	226	0	2	0	235
21115	226	7	1	0	0	234
21116	8	0	0	226	0	234
21117	0	0	1	232	0	233
21118	2	1	0	230	0	233
21119	1	1	218	7	0	227
21120	2	1	7	216	0	226
21121	1	0	212	8	0	221
21122	2	0	203	2	0	207
21123	3	2	609	1	0	615
21124	1	1	10	584	0	596
21125	3	0	1	601	0	605
21126	2	0	0	631	0	633
21127	621	0	0	12	0	633
21128	13	1	0	618	0	632
21129	623	0	2	11	0	636
21130	9	624	6	4	0	643
21131	651	10	5	5	0	671
21132	651	2	1	10	0	664
21133	11	653	1	10	0	675
21134	674	12	0	4	0	690
21135	659	2	1	7	0	669
21136	684	0	0	5	0	689
21137	683	5	2	0	0	690
21138	20	3	647	3	0	673
21139	10	639	10	2	0	661
21140	4	16	2	650	0	672
21141	657	6	3	10	0	676
21142	20	0	640	4	0	664
21143	11	622	10	5	0	648
21144	11	10	1	579	0	601
21145	7	614	6	15	0	642
21146	9	12	5	623	0	649
21147	8	7	0	654	0	669
21148	12	3	623	16	0	654
21149	11	5	619	3	0	638
21150	637	6	15	1	0	659
21151	21	4	615	7	0	647
21152	9	7	628	3	0	647
21153	5	10	10	605	0	630
21154	9	5	4	530	0	548
21155	12	600	7	12	0	631
21156	8	638	13	6	0	665
21157	11	14	640	6	0	671
21158	6	8	17	663	0	694
21159	5	5	653	15	0	678
21160	7	1	608	14	0	630
21161	2	636	14	13	0	665
21162	5	16	8	609	0	638
21163	623	12	5	11	0	651
21164	12	9	4	624	0	649
21165	625	4	6	16	0	651
21166	632	2	11	11	0	656
21167	641	1	13	7	0	662
21168	14	6	618	5	0	643
21169	625	7	10	5	0	647
21170	17	6	8	626	0	657
21171	628	5	11	13	0	657
21172	628	2	4	16	0	650
21173	18	613	6	9	0	646
21174	636	10	7	5	0	658
21175	13	10	625	5	0	653
21176	627	7	13	6	0	653
21177	607	3	6	15	0	631
21178	16	621	6	12	0	655
21179	645	9	8	5	0	667
21180	17	11	8	609	0	645
21181	16	8	5	602	0	631
21182	13	603	13	11	0	640
21183	15	8	9	615	0	647
21184	18	4	4	641	0	667
21185	19	5	602	11	0	637
21186	15	6	613	9	0	643
21187	604	8	15	10	0	637
21188	630	5	9	14	0	658
21189	12	8	7	634	0	661
21190	15	5	597	19	0	636
21191	12	602	11	13	0	638
21192	5	17	12	608	0	642
21193	11	9	611	16	0	647
21194	621	8	11	17	0	657
21195	24	3	7	599	0	633
21196	19	615	5	22	0	661
21197	23	11	8	622	0	664
21198	18	8	8	635	0	669
21199	19	9	9	637	0	674
21200	633	12	12	17	0	674
21201	30	7	8	629	0	674
21202	636	5	1	21	0	663
21203	629	13	6	17	0	665
21204	24	10	612	11	0	657
21205	17	625	12	13	0	667
21206	23	11	10	532	0	576
21207	28	624	12	11	0	675
21208	641	10	18	16	0	685
21209	17	14	7	645	0	683
21210	22	13	623	17	0	675
21211	23	7	630	15	0	675
21212	8	10	631	15	0	664
21213	632	14	13	16	0	675
21214	15	649	8	17	0	689
21215	631	20	4	15	0	670
21216	18	647	4	26	0	695
21217	9	9	15	638	0	671
21218	10	2	28	617	0	657
21219	13	645	21	16	0	695
21220	24	8	615	12	0	659
21221	12	640	24	8	0	684
21222	669	17	16	7	0	709
21223	4	0	1	224	0	229
21224	0	2	223	3	0	228
21225	3	0	226	0	0	229
21226	0	1	4	226	0	231
21227	2	1	223	3	0	229
21228	2	1	216	0	0	219
21229	203	1	2	1	0	207
21230	3	200	1	0	0	204
21231	188	4	1	1	0	194
21232	3	0	199	1	0	203
21233	1	188	1	0	0	190
21234	1	186	0	1	0	188
21235	0	1	1	186	0	188
21236	0	1	1	194	0	196
21237	0	0	0	196	0	196
21238	1	0	192	2	0	195
21239	1	0	1	195	0	197
21240	0	0	0	199	0	199
21241	190	0	2	0	0	192
21242	2	188	0	1	0	191
21243	0	1	0	193	0	194
21244	192	0	1	1	0	194
21245	188	1	0	1	0	190
21246	1	0	0	197	0	198
21247	1	1	193	1	0	196
21248	1	0	1	198	0	200
21249	0	0	194	3	0	197
21250	198	0	2	1	0	201
21251	210	0	0	1	0	211
21252	1	0	1	219	0	221
21253	2	0	220	1	0	223
21254	2	240	1	0	0	243
21255	3	1	247	1	0	252
21256	1	2	1	229	0	233
21257	0	237	0	0	0	237
21258	220	0	1	0	0	221
21259	0	0	0	210	0	210
21260	0	213	0	0	0	213
21261	216	0	0	0	0	216
21262	0	0	0	210	0	210
21263	0	216	0	0	0	216
21264	0	0	0	221	0	221
21265	0	0	222	0	0	222
21266	216	1	0	0	0	217
21267	215	0	1	0	0	216
21268	0	0	214	1	0	215
21269	0	211	0	1	0	212
21270	210	0	0	0	0	210
21271	0	1	0	209	0	210
21272	0	0	0	213	0	213
21273	1	0	0	214	0	215
21274	1	0	0	212	0	213
21275	0	0	0	207	0	207
21276	207	0	1	0	0	208
21277	206	0	0	1	0	207
21278	0	0	1	207	0	208
21279	1	0	1	205	0	207
21280	2	0	206	0	0	208
21281	1	0	204	1	0	206
21282	207	0	2	0	0	209
21283	0	2	0	206	0	208
21284	1	2	203	0	0	206
21285	0	0	0	206	0	206
21286	201	1	0	1	0	203
21287	205	0	0	1	0	206
21288	1	0	0	205	0	206
21289	0	1	0	205	0	206
21290	203	0	1	0	0	204
21291	1	0	1	202	0	204
21292	0	195	0	2	0	197
21293	0	0	1	197	0	198
21294	0	0	3	195	0	198
21295	2	0	192	0	0	194
21296	2	1	186	0	0	189
21297	1	186	1	1	0	189
21298	185	0	2	0	0	187
21299	187	1	0	1	0	189
21300	186	1	0	1	0	188
21301	1	187	0	2	0	190
21302	0	186	0	3	0	189
21303	184	1	0	3	0	188
21304	1	179	1	1	0	182
21305	1	2	174	2	0	179
21306	1	1160	7	1	0	1169
21307	1	2	1202	2	0	1207
21308	1196	1	0	1	0	1198
21309	1311	0	2	1	0	1314
21310	2	1211	3	0	0	1216
21311	1342	2	0	0	0	1344
21312	1356	0	0	2	0	1358
21313	1337	0	2	0	0	1339
21314	2	0	0	1326	0	1328
21315	1362	1	1	1	0	1365
21316	3	6	1172	0	0	1181
21317	1320	0	1	1	0	1322
21318	1	0	0	1351	0	1352
21319	1	3	1261	1	0	1266
21320	2	3	1144	3	0	1152
21321	0	4	3	1282	0	1289
21322	1	1	0	1327	0	1329
21323	1359	0	1	2	0	1362
21324	1	1	1	1328	0	1331
21325	1	5	1317	1	0	1324
21326	1	1	1	1314	0	1317
21327	2	1268	1	2	0	1273
21328	1358	1	0	1	0	1360
21329	3	0	0	1333	0	1336
21330	0	2	1324	1	0	1327
21331	1	1234	2	2	0	1239
21332	1318	1	0	1	0	1320
21333	1	1	1	1321	0	1324
21334	2	0	1294	1	0	1297
21335	0	1251	3	1	0	1255
21336	1315	1	0	1	0	1317
21337	1316	0	0	0	0	1316
21338	1302	0	0	1	0	1303
21339	1	0	1	1295	0	1297
21340	0	0	0	1298	0	1298
21341	1338	1	0	1	0	1340
21342	2	1209	1	2	0	1214
21343	1325	1	1	2	0	1329
21344	1	0	1	1311	0	1313
21345	1334	1	0	1	0	1336
21346	2	0	0	1303	0	1305
21347	0	1	0	1318	0	1319
21348	0	0	1	1316	0	1317
21349	0	1	0	1279	0	1280
21350	1	1	1218	2	0	1222
21351	1	2	1056	2	0	1061
21352	1050	0	1	1	0	1052
21353	2	7	3710	1	0	3720
21354	2	7	3657	3	0	3669
21355	3613	0	4	0	0	3617
21356	3905	1	0	1	0	3907
21357	2	3	0	3877	0	3882
21358	3996	0	0	2	0	3998
21359	2	3700	3	1	0	3706
21360	3902	1	2	1	0	3906
21361	3826	2	0	1	0	3829
21362	3759	0	0	1	0	3760
21363	1	2	0	3876	0	3879
21364	0	3667	1	4	0	3672
21365	0	3739	1	2	0	3742
21366	3966	2	0	0	0	3968
21367	5909	0	0	0	0	5909
21368	1	0	0	5717	0	5718
21369	0	1	0	5789	0	5790
21370	0	5554	1	1	0	5556
21371	5904	1	1	0	0	5906
21372	3	2	5803	1	0	5809
21373	1	3	3	5368	0	5375
21374	0	1	1	5609	0	5611
21375	1	1	5809	2	0	5813
21376	1	2	6	5354	0	5363
21377	1	4774	25	8	0	4808
21378	0	1	0	5871	0	5872
21379	1	0	0	5674	0	5675
21380	0	5410	10	1	0	5421
21381	1	5517	7	3	0	5528
21382	0	1	0	5886	0	5887
21383	5859	0	0	4	0	5863
21384	1	1	0	5742	0	5744
21385	0	0	0	5717	0	5717
21386	0	5476	2	1	0	5479
21387	1	1	0	5882	0	5884
21388	0	0	0	5676	0	5676
21389	0	0	0	5747	0	5747
21390	5894	0	0	1	0	5895
21391	2	0	0	5696	0	5698
21392	0	0	0	5640	0	5640
21393	0	1	0	5749	0	5750
21394	3	3	5666	1	0	5673
21395	4936	1	5	3	0	4945
21396	1	5376	6	4	0	5387
21397	5821	1	5	1	0	5828
21398	0	1	0	5737	0	5738
21399	1	2	5645	1	0	5649
21400	4920	1	1	2	0	4924
21401	3	1	5516	1	0	5521
21402	2	1	0	5255	0	5258
21403	5779	0	0	1	0	5780
21404	5622	0	0	0	0	5622
21405	5690	1	0	0	0	5691
21406	0	1	0	4540	0	4541
21407	0	0	0	4595	0	4595
21408	0	0	0	4705	0	4705
21409	0	4445	3	2	0	4450
21410	0	4515	0	2	0	4517
21411	0	4490	0	1	0	4491
21412	0	4414	1	1	0	4416
21413	0	1	1	4572	0	4574
21414	0	1	0	4523	0	4524
21415	4606	0	0	2	0	4608
21416	4245	2	1	1	0	4249
21417	5408	2	1	1	0	5412
21418	0	2	0	5330	0	5332
21419	2	3	0	5478	0	5483
21420	5556	0	0	1	0	5557
21421	5140	1	5	1	0	5147
21422	3	3	5130	2	0	5138
21423	4	4	4526	4	0	4538
21424	4	10	4670	0	0	4684
21425	2	3	5091	0	0	5096
21426	0	2	0	4818	0	4820
21427	5254	0	0	0	0	5254
21428	0	4837	15	4	0	4856
21429	1	0	0	5177	0	5178
21430	3	4	5059	0	0	5066
21431	2	4697	4	4	0	4707
21432	0	0	0	5180	0	5180
21433	2	1	5100	0	0	5103
21434	0	4	0	4768	0	4772
21435	0	1	1	4899	0	4901
21436	5205	0	0	0	0	5205
21437	0	1	0	5094	0	5095
21438	4	0	5182	1	0	5187
21439	0	0	0	4996	0	4996
21440	1	4974	1	0	0	4976
21441	0	0	0	5245	0	5245
21442	0	0	0	5143	0	5143
21443	0	1	0	5054	0	5055
21444	5251	0	0	2	0	5253
21445	4979	2	4	2	0	4987
21446	5795	0	2	3	0	5800
21447	5661	0	1	1	0	5663
21448	3	1	5744	2	0	5750
21449	5268	1	1	0	0	5270
21450	5704	1	2	2	0	5709
21451	0	5	5646	4	0	5655
21452	4	5	5556	0	0	5565
21453	0	1	1	3490	0	3492
21454	0	3453	4	1	0	3458
21455	3721	0	0	1	0	3722
21456	3676	0	1	0	0	3677
21457	3687	0	2	0	0	3689
21458	1	2	1	3522	0	3526
21459	0	4004	7	3	0	4014
21460	4386	0	0	0	0	4386
21461	4254	1	1	0	0	4256
21462	0	1	0	4164	0	4165
21463	2	5	4119	1	0	4127
21464	4006	2	1	4	0	4013
21465	0	4	1	4251	0	4256
21466	4351	0	0	1	0	4352
21467	0	0	0	2768	0	2768
21468	3	0	2683	1	0	2687
21469	4131	1	0	2	0	4134
21470	0	0	0	4231	0	4231
21471	1	0	0	4159	0	4160
21472	0	0	0	4245	0	4245
21473	0	0	0	4228	0	4228
21474	4325	0	2	0	0	4327
21475	0	0	0	4250	0	4250
21476	1	4007	3	2	0	4013
21477	0	0	0	4295	0	4295
21478	0	4080	1	1	0	4082
21479	0	0	0	4312	0	4312
21480	0	1	0	4250	0	4251
21481	0	4090	2	2	0	4094
21482	0	0	0	4319	0	4319
21483	1	1	0	4237	0	4239
21484	4288	0	0	0	0	4288
21485	1	0	4179	0	0	4180
21486	0	1	0	4229	0	4230
21487	4343	0	0	0	0	4343
21488	4097	0	1	3	0	4101
21489	4142	1	0	5	0	4148
21490	2	3	4106	3	0	4114
21491	4	4	3930	0	0	3938
21492	2	0	1	3958	0	3961
21493	4256	0	3	1	0	4260
21494	2	2	4129	3	0	4136
21495	3944	1	5	1	0	3951
21496	4	4004	7	3	0	4018
21497	1	2	0	5514	0	5517
21498	1	2	0	5452	0	5455
21499	5602	0	2	4	0	5608
21500	2	2	0	5486	0	5490
21501	5593	1	0	1	0	5595
21502	5543	0	2	3	0	5548
21503	3	1	0	5515	0	5519
21504	3	1	0	5451	0	5455
21505	5571	0	0	8	0	5579
21506	7	3	5512	2	0	5524
21507	5259	0	7	1	0	5267
21508	4	3	5605	3	0	5615
21509	5358	1	2	2	0	5363
21510	5761	0	2	0	0	5763
21511	5710	0	1	1	0	5712
21512	5676	1	0	2	0	5679
21513	3	5507	8	6	0	5524
21514	5800	1	0	1	0	5802
21515	5783	2	1	0	0	5786
21516	7	5680	6	0	0	5693
21517	5112	2	1	2	0	5117
21518	5	4	4950	0	0	4959
21519	4782	1	3	1	0	4787
21520	10	3	4938	0	0	4951
21521	3	3	3	4910	0	4919
21522	2	1	2	5009	0	5014
21523	3	1	4991	9	0	5004
21524	1	2	5	4806	0	4814
21525	3	14	10	4327	0	4354
21526	5130	0	0	7	0	5137
21527	3	0	0	5084	0	5087
21528	4	0	2	5037	0	5043
21529	0	0	1	5133	0	5134
21530	0	5612	9	10	0	5631
21531	1	94	1	5903	0	5999
21532	5845	56	1	106	0	6008
21533	108	25	5759	64	0	5956
21534	62	20	97	5802	0	5981
21535	23	6	5827	128	0	5984
21536	5464	1	124	69	0	5658
21537	112	3	78	5891	0	6084
21538	75	9	10939	137	0	11160
21539	26	7	603	11163	0	11799
21540	26	4	393	11426	0	11849
21541	11	10955	333	974	0	12273
21542	7	572	210	11964	0	12753
21543	14	379	58	13261	0	13712
21544	10	326	11787	1310	0	13433
21545	13	195	617	12648	0	13473
21546	5	51	409	12631	0	13096
21547	11336	23	334	1347	0	13040
21548	11445	15	253	850	0	12563
21549	1017	11278	109	635	0	13039
21550	12513	635	93	390	0	13631
21551	12693	456	91	234	0	13474
21552	1308	12198	59	248	0	13813
21553	825	925	30	12207	0	13987
21554	12526	546	51	875	0	13998
21555	12664	369	69	642	0	13744
21556	12476	233	86	563	0	13358
21557	1492	11540	105	414	0	13551
21558	1084	691	11524	261	0	13560
21559	11802	470	682	212	0	13166
21560	12172	397	454	182	0	13205
21561	1335	11674	363	185	0	13557
21562	12278	860	273	484	0	13895
21563	12675	546	435	284	0	13940
21564	1567	432	144	12134	0	14277
21565	1094	320	11326	1274	0	14014
21566	1210	162	696	12235	0	14303
21567	1029	173	453	12600	0	14255
21568	524	466	375	13088	0	14453
21569	726	245	12211	1604	0	14786
21570	707	180	790	13439	0	15116
21571	372	477	501	13860	0	15210
21572	379	181	385	14396	0	15341
21573	713	145	253	14295	0	15406
21574	747	130	119	14306	0	15302
21575	716	12519	126	1913	0	15274
21576	348	1075	163	13902	0	15488
21577	237	574	490	14294	0	15595
21578	530	430	12349	1768	0	15077
21579	590	299	771	15906	0	17566
21580	309	457	504	16453	0	17723
21581	548	163	446	16696	0	17853
21582	557	96	374	17260	0	18287
21583	14996	82	256	2942	0	18276
21584	936	81	472	16789	0	18278
21585	648	146	169	17587	0	18550
21586	545	203	14143	2746	0	17637
21587	402	13992	888	2090	0	17372
21588	205	15572	987	1418	0	18182
21589	14677	1355	683	1315	0	18030
21590	913	15629	441	1264	0	18247
21591	728	1456	193	16161	0	18538
21592	15563	985	113	1925	0	18586
21593	1325	740	14259	1632	0	17956
21594	881	817	854	15410	0	17962
21595	749	14799	680	2001	0	18229
21596	549	987	622	15643	0	17801
21597	292	14387	723	1923	0	17325
21598	321	1357	295	15525	0	17498
21599	14239	964	159	2131	0	17493
21600	1272	765	13478	1622	0	17137
21601	975	626	882	13976	0	16459
21602	1196	13968	696	1499	0	17359
21603	14599	1079	591	1321	0	17590
21604	1286	822	13908	1279	0	17295
21605	963	673	1360	14508	0	17504
21606	870	922	14044	1334	0	17170
21607	758	726	1325	14665	0	17474
21608	790	430	14024	1759	0	17003
21609	383	660	1456	14518	0	17017
21610	330	297	1059	15688	0	17374
21611	14141	223	687	2276	0	17327
21612	14641	244	813	1611	0	17309
21613	1692	291	386	14584	0	16953
21614	1318	13771	284	1715	0	17088
21615	1043	1108	220	14741	0	17112
21616	607	1067	274	15381	0	17329
21617	13371	622	283	2663	0	16939
21618	1338	13608	291	1894	0	17131
21619	13885	1072	574	1461	0	16992
21620	14080	752	350	1385	0	16567
21621	1775	13433	275	927	0	16410
21622	1551	14249	280	837	0	16917
21623	14304	1454	531	957	0	17246
21624	1457	1056	12913	1340	0	16766
21625	13832	770	1237	1136	0	16975
21626	14296	539	762	1314	0	16911
21627	1993	13216	883	977	0	17069
21628	1452	1047	447	12803	0	15749
21629	1080	13649	302	1839	0	16870
21630	13196	1310	351	1113	0	15970
21631	13543	1042	277	896	0	15758
21632	1642	960	172	13158	0	15932
21633	1350	1044	131	13763	0	16288
21634	12924	579	127	2105	0	15735
21635	1431	12220	133	1879	0	15663
21636	1371	12282	228	1442	0	15323
21637	1093	13537	380	862	0	15872
21638	523	6950	130	252	0	7855
21639	445	7203	61	272	0	7981
21640	198	1049	68	6842	0	8157
21641	154	887	6146	530	0	7717
21642	512	6808	290	423	0	8033
21643	5907	347	180	274	0	6708
21644	355	211	229	5898	0	6693
21645	5903	208	175	383	0	6669
21646	418	5836	91	299	0	6644
21647	6000	356	105	208	0	6669
21648	449	5840	148	223	0	6660
21649	272	816	183	5500	0	6771
21650	5394	214	150	373	0	6131
21651	5409	163	188	324	0	6084
21652	344	102	147	5503	0	6096
21653	260	83	144	5549	0	6036
21654	268	5122	56	555	0	6001
21655	287	235	45	5542	0	6109
21656	293	175	21	5580	0	6069
21657	178	199	37	5606	0	6020
21658	77	5269	26	598	0	5970
21659	4957	302	46	480	0	5785
21660	235	5164	52	456	0	5907
21661	5191	324	35	291	0	5841
21662	429	5172	41	110	0	5752
21663	412	407	4602	82	0	5503
21664	368	289	171	4797	0	5625
21665	255	292	4726	221	0	5494
21666	165	271	4807	184	0	5427
21667	177	166	372	4836	0	5551
21668	205	96	4900	280	0	5481
21669	230	68	382	3001	0	3681
21670	287	99	208	3095	0	3689
21671	208	144	125	3242	0	3719
21672	2896	194	73	510	0	3673
21673	291	167	35	3196	0	3689
21674	336	167	20	3214	0	3737
21675	3082	65	31	473	0	3651
21676	381	2749	19	460	0	3609
21677	285	2765	28	429	0	3507
21678	285	3141	26	263	0	3715
21679	13	68	4	557	0	642
21680	12	12	573	31	0	628
21681	449	19	20	7	0	495
21682	21	436	2	7	0	466
21683	374	23	4	4	0	405
21684	392	5	0	5	0	402
21685	400	2	5	1	0	408
21686	20	8	380	2	0	410
21687	8	3	13	386	0	410
21688	4	5	2	400	0	411
21689	5	2	1	400	0	408
21690	5	4	0	384	0	393
21691	6	377	2	16	0	401
21692	373	16	2	6	0	397
21693	14	3	358	5	0	380
21694	343	3	10	3	0	359
21695	13	12	0	315	0	340
21696	2	313	0	13	0	328
21697	3	325	0	3	0	331
21698	7	17	2	288	0	314
21699	4	279	0	12	0	295
21700	215	5	1	1	0	222
21701	7	1	205	3	0	216
21702	1	0	6	198	0	205
21703	0	1	0	209	0	210
21704	2	1	0	207	0	210
21705	0	1	0	206	0	207
21706	208	0	0	5	0	213
21707	5	202	0	0	0	207
21708	234	5	1	2	0	242
21709	6	0	0	228	0	234
21710	1	0	0	247	0	248
21711	1	248	0	7	0	256
21712	260	6	0	2	0	268
21713	268	3	0	1	0	272
21714	6	263	0	3	0	272
21715	3	4	1	252	0	260
21716	1	260	0	3	0	264
21717	255	3	0	5	0	263
21718	3	4	254	1	0	262
21719	3	2	251	0	0	256
21720	250	0	5	1	0	256
21721	2	260	3	0	0	265
21722	4	2	0	259	0	265
21723	0	2	1	267	0	270
21724	0	0	259	6	0	265
21725	0	0	2	267	0	269
21726	0	0	4	267	0	271
21727	0	261	0	6	0	267
21728	1	2	0	260	0	263
21729	0	3	0	262	0	265
21730	261	0	0	5	0	266
21731	2	255	1	5	0	263
21732	3	257	0	0	0	260
21733	0	4	0	262	0	266
21734	1	2	0	264	0	267
21735	1	0	0	268	0	269
21736	0	264	0	5	0	269
21737	1	2	0	272	0	275
21738	1	4	0	263	0	268
21739	0	1	0	264	0	265
21740	0	0	2	260	0	262
21741	0	251	0	5	0	256
21742	1	259	0	3	0	263
21743	251	7	1	0	0	259
21744	252	3	1	0	0	256
21745	5	0	0	249	0	254
21746	4	1	240	3	0	248
21747	0	0	2	247	0	249
21748	0	0	3	247	0	250
21749	244	1	1	6	0	252
21750	4	248	0	4	0	256
21751	3	3	0	252	0	258
21752	0	5	0	257	0	262
21753	1	0	248	8	0	257
21754	1	1	248	4	0	254
21755	2	1	6	252	0	261
21756	0	1	4	255	0	260
21757	2	253	1	6	0	262
21758	1	253	0	4	0	258
21759	252	7	1	1	0	261
21760	3	2	1	252	0	258
21761	4	0	246	4	0	254
21762	1	239	3	4	0	247
21763	0	3	3	245	0	251
21764	239	3	0	6	0	248
21765	3	2	1	245	0	251
21766	241	2	0	5	0	248
21767	4	238	0	5	0	247
21768	240	6	2	0	0	248
21769	4	4	0	238	0	246
21770	4	2	254	4	0	264
21771	2	5	3	250	0	260
21772	1	256	4	6	0	267
21773	0	6	2	261	0	269
21774	3	266	1	5	0	275
21775	0	6	1	271	0	278
21776	1	5	253	6	0	265
21777	1	1	246	7	0	255
21778	0	1	252	4	0	257
21779	246	1	9	2	0	258
21780	5	241	3	4	0	253
21781	5	246	1	2	0	254
21782	245	7	0	2	0	254
21783	245	5	0	4	0	254
21784	10	1	0	240	0	251
21785	6	1	229	7	0	243
21786	0	2	223	8	0	233
21787	1	2	8	221	0	232
21788	219	2	3	8	0	232
21789	5	220	0	6	0	231
21790	4	5	0	225	0	234
21791	219	4	1	6	0	230
21792	217	1	1	6	0	225
21793	8	0	218	5	0	231
21794	213	0	5	6	0	224
21795	4	3	227	1	0	235
21796	3	1	221	4	0	229
21797	2	2	6	217	0	227
21798	3	2	3	222	0	230
21799	1	2	0	224	0	227
21800	2	2	218	9	0	231
21801	226	0	4	7	0	237
21802	4	0	5	232	0	241
21803	231	1	2	7	0	241
21804	236	1	0	5	0	242
21805	10	237	0	3	0	250
21806	3	244	0	3	0	250
21807	3	249	1	4	0	257
21808	1	9	2	217	0	229
21809	1	5	211	7	0	224
21810	0	4	7	193	0	204
21811	2	189	5	5	0	201
21812	0	191	1	2	0	194
21813	0	6	4	179	0	189
21814	175	1	0	6	0	182
21815	6	175	1	0	0	182
21816	0	171	2	1	0	174
21817	176	4	1	1	0	182
21818	5	1	1	180	0	187
21819	0	2	0	184	0	186
21820	2	1	0	179	0	182
21821	174	1	0	6	0	181
21822	176	0	0	3	0	179
21823	6	0	1	170	0	177
21824	2	1	166	5	0	174
21825	166	0	6	1	0	173
21826	7	0	0	172	0	179
21827	0	0	169	6	0	175
21828	2	0	171	0	0	173
21829	0	1	5	172	0	178
21830	1	0	177	6	0	184
21831	0	0	6	194	0	200
21832	0	0	1	208	0	209
21833	1	1	1	216	0	219
21834	201	1	0	9	0	211
21835	8	1	0	204	0	213
21836	0	1	0	210	0	211
21837	2	1	1	212	0	216
21838	0	1	2	212	0	215
21839	0	0	199	8	0	207
21840	1	202	6	3	0	212
21841	1	6	1	195	0	203
21842	0	2	1	200	0	203
21843	1	195	0	6	0	202
21844	2	198	0	1	0	201
21845	196	6	0	3	0	205
21846	7	191	1	1	0	200
21847	0	10	2	190	0	202
21848	1	1	194	7	0	203
21849	184	1	5	0	0	190
21850	6	1	185	2	0	194
21851	182	0	7	1	0	190
21852	185	0	0	1	0	186
21853	8	0	178	0	0	186
21854	1	0	7	172	0	180
21855	2	178	0	7	0	187
21856	0	6	2	184	0	192
21857	195	0	1	7	0	203
21858	205	1	0	4	0	210
21859	6	200	1	3	0	210
21860	208	6	1	2	0	217
21861	8	0	1	204	0	213
21862	204	1	1	7	0	213
21863	209	0	0	3	0	212
21864	7	0	0	206	0	213
21865	202	0	0	9	0	211
21866	205	1	1	1	0	208
21867	6	2	197	2	0	207
21868	200	1	5	2	0	208
21869	7	0	197	2	0	206
21870	0	1	185	2	0	188
21871	1	184	8	1	0	194
21872	1	5	1	177	0	184
21873	0	1	176	5	0	182
21874	0	1	177	2	0	180
21875	177	0	6	2	0	185
21876	6	1	1	177	0	185
21877	0	1	2	179	0	182
21878	3	0	0	183	0	186
21879	1	0	0	185	0	186
21880	0	0	1	187	0	188
21881	0	0	176	7	0	183
21882	1	1	177	1	0	180
21883	0	0	5	180	0	185
21884	172	0	1	5	0	178
21885	7	171	1	0	0	179
21886	0	6	0	173	0	179
21887	176	0	0	6	0	182
21888	5	172	0	1	0	178
21889	1	5	0	178	0	184
21890	2	0	0	181	0	183
21891	2	1	0	181	0	184
21892	176	1	0	6	0	183
21893	6	0	168	1	0	175
21894	174	0	6	1	0	181
21895	8	0	0	169	0	177
21896	1	0	1	172	0	174
21897	1	168	1	5	0	175
21898	1	6	168	1	0	176
21899	167	0	5	2	0	174
21900	173	1	1	0	0	175
21901	6	0	164	0	0	170
21902	165	0	6	0	0	171
21903	6	163	1	0	0	170
21904	0	157	0	1	0	158
21905	0	156	0	2	0	158
21906	155	3	1	1	0	160
21907	3	0	156	1	0	160
21908	1	3	4	145	0	153
21909	0	139	1	2	0	142
21910	1	145	0	1	0	147
21911	1	146	0	1	0	148
21912	0	7	0	128	0	135
21913	133	0	0	4	0	137
21914	2	132	1	0	0	135
21915	0	3	1	133	0	137
21916	0	0	0	139	0	139
21917	132	0	0	3	0	135
21918	2	1	0	134	0	137
21919	1	0	0	139	0	140
21920	1	0	135	3	0	139
21921	1	0	3	135	0	139
21922	0	0	0	144	0	144
21923	139	0	0	5	0	144
21924	141	1	0	1	0	143
21925	4	0	1	137	0	142
21926	135	0	1	3	0	139
21927	140	0	0	0	0	140
21928	3	135	1	1	0	140
21929	1	3	136	1	0	141
21930	0	128	3	0	0	131
21931	7	3	0	100	0	110
21932	90	1	2	1	0	94
21933	1	95	0	0	0	96
21934	0	1	0	98	0	99
21935	93	0	3	1	0	97
21936	96	0	0	0	0	96
21937	1	0	0	93	0	94
21938	0	0	101	1	0	102
21939	0	0	1	109	0	110
21940	0	0	0	112	0	112
21941	0	0	110	1	0	111
21942	0	0	0	107	0	107
21943	0	0	0	110	0	110
21944	118	0	0	1	0	119
21945	1	0	0	120	0	121
21946	0	0	0	121	0	121
21947	121	0	0	2	0	123
21948	125	0	0	1	0	126
21949	122	0	0	0	0	122
21950	2	0	121	0	0	123
21951	1	0	1	119	0	121
21952	0	120	0	1	0	121
21953	0	1	0	125	0	126
21954	0	0	130	1	0	131
21955	0	0	1	129	0	130
21956	0	0	124	2	0	126
21957	120	0	0	1	0	121
21958	117	0	1	0	0	118
21959	2	0	0	123	0	125
21960	0	0	0	122	0	122
21961	0	0	0	129	0	129
21962	0	140	0	2	0	142
21963	141	1	0	1	0	143
21964	144	2	0	0	0	146
21965	2	1	0	144	0	147
21966	1	0	0	146	0	147
21967	1	0	0	151	0	152
21968	0	1	0	142	0	143
21969	0	0	153	3	0	156
21970	0	0	1	150	0	151
21971	151	0	0	1	0	152
21972	152	0	0	2	0	154
21973	2	0	0	153	0	155
21974	1	0	149	1	0	151
21975	145	0	0	2	0	147
21976	1	0	0	153	0	154
21977	2	153	0	1	0	156
21978	1	160	1	0	0	162
21979	168	2	0	1	0	171
21980	1	1	0	167	0	169
21981	2	1	0	167	0	170
21982	0	1	0	171	0	172
21983	0	0	1	171	0	172
21984	0	1	0	190	0	191
21985	0	0	191	4	0	195
21986	1	0	192	2	0	195
21987	0	0	191	0	0	191
21988	0	0	4	189	0	193
21989	1	0	198	4	0	203
21990	1	0	1	201	0	203
21991	0	0	2	206	0	208
21992	0	0	1	207	0	208
21993	209	0	0	5	0	214
21994	1	0	0	211	0	212
21995	2	0	1	221	0	224
21996	214	0	0	4	0	218
21997	2	220	0	3	0	225
21998	3	228	0	0	0	231
21999	234	4	0	1	0	239
22000	2	238	0	1	0	241
22001	237	3	0	0	0	240
22002	243	2	0	0	0	245
22003	245	0	0	0	0	245
22004	239	0	1	1	0	241
22005	244	0	0	1	0	245
22006	4	238	0	0	0	242
22007	244	1	0	1	0	246
22008	244	1	1	0	0	246
22009	4	242	0	1	0	247
22010	256	1	0	0	0	257
22011	261	1	0	0	0	262
22012	269	0	0	0	0	269
22013	277	0	1	0	0	278
22014	5	1	322	0	0	328
22015	2	0	4	345	0	351
22016	0	0	3	367	0	370
22017	0	0	358	10	0	368
22018	0	0	358	5	0	363
22019	350	0	10	1	0	361
22020	6	0	4	372	0	382
22021	3	0	377	6	0	386
22022	1	0	367	4	0	372
22023	366	0	13	1	0	380
22024	376	0	4	0	0	380
22025	385	0	1	0	0	386
22026	11	0	368	0	0	379
22027	5	0	5	368	0	378
22028	1	1	365	5	0	372
22029	366	0	7	4	0	377
22030	5	0	383	1	0	389
22031	4	0	6	375	0	385
22032	1	0	5	387	0	393
22033	1	374	1	8	0	384
22034	381	6	0	6	0	393
22035	7	4	382	1	0	394
22036	384	1	8	1	0	394
22037	9	0	390	1	0	400
22038	4	0	9	381	0	394
22039	1	0	5	380	0	386
22040	1	0	2	387	0	390
22041	380	0	0	13	0	393
22042	9	0	1	381	0	391
22043	4	0	1	382	0	387
22044	2	371	1	11	0	385
22045	2	7	0	375	0	384
22046	368	3	1	8	0	380
22047	9	1	370	3	0	383
22048	4	0	8	368	0	380
22049	1	0	366	10	0	377
22050	1	346	9	6	0	362
22051	0	7	368	2	0	377
22052	363	2	10	1	0	376
22053	372	1	5	2	0	380
22054	11	1	2	351	0	365
22055	362	0	3	7	0	372
22056	366	0	2	5	0	373
22057	12	0	1	358	0	371
22058	7	0	2	363	0	372
22059	4	0	356	11	0	371
22060	2	355	8	6	0	371
22061	352	7	5	4	0	368
22062	9	331	4	3	0	347
22063	5	8	3	337	0	353
22064	5	4	1	341	0	351
22065	3	2	1	343	0	349
22066	1	2	1	345	0	349
22067	3	1	324	13	0	341
22068	325	1	8	5	0	339
22069	330	0	7	2	0	339
22070	13	0	4	322	0	339
22071	334	1	2	7	0	344
22072	8	1	3	333	0	345
22073	5	0	327	12	0	344
22074	6	1	8	323	0	338
22075	2	318	2	12	0	334
22076	4	6	3	314	0	327
22077	3	311	2	8	0	324
22078	2	7	2	309	0	320
22079	4	305	1	11	0	321
22080	302	9	4	5	0	320
22081	9	4	297	5	0	315
22082	4	294	9	3	0	310
22083	1	300	5	4	0	310
22084	2	11	5	279	0	297
22085	2	6	3	279	0	290
22086	4	1	3	287	0	295
22087	4	0	3	289	0	296
22088	4	275	2	11	0	292
22089	7	6	1	270	0	284
22090	5	2	2	275	0	284
22091	269	2	2	12	0	285
22092	7	0	4	277	0	288
22093	4	3	262	10	0	279
22094	4	1	263	4	0	272
22095	243	4	7	4	0	258
22096	7	254	4	3	0	268
22097	3	258	1	6	0	268
22098	3	9	0	244	0	256
22099	1	4	1	251	0	257
22100	1	3	226	12	0	242
22101	232	2	7	4	0	245
22102	236	1	6	1	0	244
22103	10	2	232	4	0	248
22104	6	1	236	4	0	247
22105	235	1	7	6	0	249
22106	241	1	5	4	0	251
22107	239	0	2	6	0	247
22108	239	1	1	3	0	244
22109	11	229	0	3	0	243
22110	220	6	0	5	0	231
22111	9	3	208	2	0	222
22112	5	2	188	2	0	197
22113	3	1	192	4	0	200
22114	3	21	13	93	0	130
22115	95	1	0	1	0	97
22116	94	0	0	0	0	94
22117	1	0	0	92	0	93
22118	1	0	0	93	0	94
22119	0	0	0	95	0	95
22120	0	96	0	1	0	97
22121	94	1	0	0	0	95
22122	101	0	0	0	0	101
22123	101	0	0	0	0	101
22124	99	0	0	0	0	99
22125	99	0	0	0	0	99
22126	1	0	0	100	0	101
22127	0	96	0	1	0	97
22128	0	1	0	106	0	107
22129	0	0	0	103	0	103
22130	99	0	0	2	0	101
22131	2	0	93	0	0	95
22132	0	0	98	0	0	98
22133	0	0	101	0	0	101
22134	97	0	1	0	0	98
22135	100	0	0	0	0	100
22136	1	0	0	98	0	99
22137	0	0	0	97	0	97
22138	0	0	0	98	0	98
22139	0	0	103	1	0	104
22140	0	0	1	101	0	102
22141	0	0	105	1	0	106
22142	0	0	1	105	0	106
22143	0	0	0	108	0	108
22144	0	0	0	109	0	109
22145	108	0	0	1	0	109
22146	109	0	0	0	0	109
22147	1	0	114	0	0	115
22148	116	0	1	0	0	117
22149	117	0	0	0	0	117
22150	1	0	0	117	0	118
22151	119	0	0	1	0	120
22152	1	0	0	120	0	121
22153	0	0	0	120	0	120
22154	0	0	118	2	0	120
22155	121	0	1	1	0	123
22156	1	0	0	119	0	120
22157	2	6	1419	2	0	1429
22158	0	4	1471	0	0	1475
22159	3	0	2	1511	0	1516
22160	0	0	0	1555	0	1555
22161	1606	0	0	1	0	1607
22162	1	1	0	1585	0	1587
22163	0	0	1	1536	0	1537
22164	0	1	1	1582	0	1584
22165	1	0	0	1569	0	1570
22166	1619	0	0	2	0	1621
22167	1571	1	0	0	0	1572
22168	1579	0	0	3	0	1582
22169	1589	0	0	1	0	1590
22170	1	0	1	1617	0	1619
22171	1654	0	0	2	0	1656
22172	3	0	0	1636	0	1639
22173	1656	0	1	2	0	1659
22174	2	0	2	1628	0	1632
22175	1	0	0	1631	0	1632
22176	1	1595	0	2	0	1598
22177	1	1	0	1663	0	1665
22178	1630	1	0	2	0	1633
22179	1518	0	0	2	0	1520
22180	5	1	1617	2	0	1625
22181	1	1569	3	2	0	1575
22182	1656	2	1	0	0	1659
22183	2	1595	1	1	0	1599
22184	1668	3	2	0	0	1673
22185	2	1608	1	2	0	1613
22186	2	5	1608	0	0	1615
22187	0	1590	2	1	0	1593
22188	1	1587	1	0	0	1589
22189	0	4	0	1682	0	1686
22190	1698	1	0	2	0	1701
22191	2	0	0	1656	0	1658
22192	1	1	0	1656	0	1658
22193	1684	0	0	3	0	1687
22194	1661	0	0	1	0	1662
22195	2	0	0	1645	0	1647
22196	1	0	1	1632	0	1634
22197	0	0	0	1689	0	1689
22198	1665	0	0	4	0	1669
22199	3	0	1625	1	0	1629
22200	1	0	2	1593	0	1596
22201	1	2	1638	4	0	1645
22202	0	1512	5	4	0	1521
22203	2	1	1614	0	0	1617
22204	1	1	2	1575	0	1579
22205	0	0	1643	1	0	1644
22206	1464	1	5	1	0	1471
22207	2	0	1	1652	0	1655
22208	1	1587	0	4	0	1592
22209	1	2	0	1671	0	1674
22210	1	1609	0	4	0	1614
22211	1	1612	0	3	0	1616
22212	2	1596	1	1	0	1600
22213	1	4	0	1641	0	1646
22214	1	1565	1	4	0	1571
22215	1599	2	1	1	0	1603
22216	4	4	1484	0	0	1492
22217	1	9	1318	4	0	1332
22218	0	5	1428	1	0	1434
22219	0	2	2	1478	0	1482
22220	0	0	1	1476	0	1477
22221	3	2	0	1520	0	1525
22222	1	0	0	1535	0	1536
22223	1	0	1	1493	0	1495
22224	1	1463	1	5	0	1470
22225	1	3	1390	2	0	1396
22226	2	6	1312	2	0	1322
22227	1	1396	8	1	0	1406
22228	0	2	1	1521	0	1524
22229	0	2	1	1520	0	1523
22230	0	1	0	1492	0	1493
22231	1527	1	0	3	0	1531
22232	3	1	1476	4	0	1484
22233	1437	0	2	1	0	1440
22234	1440	1	1	2	0	1444
22235	2	1285	3	3	0	1293
22236	2	1443	1	0	0	1446
22237	1507	2	0	1	0	1510
22238	1	2	0	1468	0	1471
22239	1	1	1	1443	0	1446
22240	1	2	1445	3	0	1451
22241	5	4	1335	1	0	1345
22242	0	0	3	1444	0	1447
22243	1474	1	0	3	0	1478
22244	2	0	1468	2	0	1472
22245	1439	2	1	1	0	1443
22246	2	0	3	1466	0	1471
22247	3	2	0	2684	0	2689
22248	0	2	1	2855	0	2858
22249	4	3	2633	114	0	2754
22250	4	2468	90	17	0	2579
22251	1	2700	5	13	0	2719
22252	2705	107	8	8	0	2828
22253	2777	10	5	10	0	2802
22254	105	10	1	2694	0	2810
22255	2737	8	14	115	0	2874
22256	127	9	2622	9	0	2767
22257	8	15	1622	10	0	1655
22258	14	6	99	1560	0	1679
22259	1573	2	11	113	0	1699
22260	113	3	11	1561	0	1688
22261	15	3	9	1700	0	1727
22262	1578	3	15	124	0	1720
22263	1677	7	14	15	0	1713
22264	110	1596	5	24	0	1735
22265	1632	111	5	16	0	1764
22266	135	13	3	1551	0	1702
22267	13	1601	5	119	0	1738
22268	1637	117	3	14	0	1771
22269	127	1593	11	17	0	1748
22270	16	125	11	1603	0	1755
22271	1626	16	4	120	0	1766
22272	132	10	1580	15	0	1737
22273	16	18	1639	22	0	1695
22274	22	5	105	1577	0	1709
22275	23	12	12	1643	0	1690
22276	15	10	9	1596	0	1630
22277	18	1608	11	114	0	1751
22278	1630	113	14	18	0	1775
22279	1722	7	14	30	0	1773
22280	1697	13	4	18	0	1732
22281	127	1626	6	22	0	1781
22282	19	121	8	1705	0	1853
22283	20	12	5	1838	0	1875
22284	31	14	5	1844	0	1894
22285	1637	26	21	141	0	1825
22286	135	1668	12	26	0	1841
22287	25	136	5	1701	0	1867
22288	29	19	1	1838	0	1887
22289	39	18	1577	151	0	1785
22290	18	1655	104	39	0	1816
22291	35	119	17	1672	0	1843
22292	24	12	24	1789	0	1849
22293	26	11	24	1809	0	1870
22294	1659	19	14	160	0	1852
22295	131	1651	11	52	0	1845
22296	1686	123	3	51	0	1863
22297	141	11	5	1727	0	1884
22298	1723	15	4	142	0	1884
22299	150	25	1632	29	0	1836
22300	1714	17	111	34	0	1876
22301	1819	16	4	29	0	1868
22302	147	22	1648	20	0	1837
22303	26	28	111	1703	0	1868
22304	40	14	5	1835	0	1894
22305	1718	18	14	151	0	1901
22306	144	10	16	1745	0	1915
22307	44	12	19	1835	0	1910
22308	22	19	31	1833	0	1905
22309	27	12	1633	160	0	1832
22310	1629	9	112	65	0	1815
22311	142	1677	13	40	0	1872
22312	24	125	14	1651	0	1814
22313	34	1621	8	149	0	1812
22314	51	1777	12	38	0	1878
22315	32	136	25	1724	0	1917
22316	41	13	1679	153	0	1886
22317	29	34	1750	38	0	1851
22318	30	18	117	1756	0	1921
22319	21	12	1686	177	0	1896
22320	1723	24	126	45	0	1918
22321	151	12	14	1751	0	1928
22322	27	25	17	1832	0	1901
22323	30	1698	27	156	0	1911
22324	16	139	18	1740	0	1913
22325	7	18	21	1819	0	1865
22326	26	1685	12	142	0	1865
22327	13	130	12	1718	0	1873
22328	15	13	7	1815	0	1850
22329	16	1671	13	166	0	1866
22330	1726	131	17	38	0	1912
22331	133	22	1661	52	0	1868
22332	34	31	1721	29	0	1815
22333	30	19	105	1721	0	1875
22334	34	13	21	1831	0	1899
22335	22	21	1655	149	0	1847
22336	38	27	1727	31	0	1823
22337	1646	4	124	47	0	1821
22338	137	1664	32	33	0	1866
22339	1679	140	23	45	0	1887
22340	137	9	1640	59	0	1845
22341	32	1675	122	49	0	1878
22342	15	135	20	1724	0	1894
22343	33	7	1659	164	0	1863
22344	19	29	1764	36	0	1848
22345	23	24	133	1744	0	1924
22346	25	14	1739	174	0	1952
22347	1	456	13	4	0	474
22348	1	14	1	464	0	480
22349	2	1	459	14	0	476
22350	0	466	11	3	0	480
22351	479	12	1	1	0	493
22352	15	1	477	2	0	495
22353	3	476	14	2	0	495
22354	2	14	1	472	0	489
22355	1	2	1	490	0	494
22356	483	2	0	15	0	500
22357	14	0	1	484	0	499
22358	1	1	1	495	0	498
22359	470	0	2	17	0	489
22360	14	1	0	470	0	485
22361	0	1	452	17	0	470
22362	2	0	14	462	0	478
22363	1	0	457	17	0	475
22364	1	0	437	1	0	439
22365	1	2	416	1	0	420
22366	3	3	15	390	0	411
22367	3	0	1	416	0	420
22368	406	2	1	12	0	421
22369	12	1	1	393	0	407
22370	1	402	3	12	0	418
22371	2	12	1	419	0	434
22372	1	0	3	426	0	430
22373	0	415	1	14	0	430
22374	416	11	2	1	0	430
22375	416	0	0	0	0	416
22376	10	409	1	3	0	423
22377	0	405	1	3	0	409
22378	0	23	2	390	0	415
22379	397	0	1	12	0	410
22380	12	0	395	2	0	409
22381	1	2	364	0	0	367
22382	305	2	7	0	0	314
22383	5	329	1	0	0	335
22384	1	5	0	335	0	341
22385	0	1	1	343	0	345
22386	0	0	1	356	0	357
22387	0	0	0	350	0	350
22388	0	343	2	6	0	351
22389	0	7	0	350	0	357
22390	352	0	0	7	0	359
22391	5	0	2	350	0	357
22392	2	1	0	354	0	357
22393	362	0	0	7	0	369
22394	363	0	2	1	0	366
22395	369	2	0	0	0	371
22396	374	0	0	2	0	376
22397	6	0	0	376	0	382
22398	377	1	0	5	0	383
22399	6	0	0	371	0	377
22400	368	0	1	7	0	376
22401	366	1	0	1	0	368
22402	6	0	0	360	0	366
22403	1	1	367	6	0	375
22404	365	0	4	4	0	373
22405	389	0	3	1	0	393
22406	387	0	1	1	0	389
22407	394	0	1	1	0	396
22408	6	0	1	400	0	407
22409	1	1	394	6	0	402
22410	1	0	388	2	0	391
22411	378	0	8	1	0	387
22412	395	1	2	0	0	398
22413	5	391	1	0	0	397
22414	1	396	0	1	0	398
22415	404	5	1	1	0	411
22416	4	1	0	408	0	413
22417	1	3	1	410	0	415
22418	398	0	0	5	0	403
22419	4	399	0	2	0	405
22420	417	3	0	1	0	421
22421	4	1	407	1	0	413
22422	404	0	3	1	0	408
22423	4	0	2	406	0	412
22424	2	0	419	3	0	424
22425	1	423	3	1	0	428
22426	1	3	3	434	0	441
22427	1	1	469	4	0	475
22428	0	0	4	464	0	468
22429	484	0	3	5	0	492
22430	5	0	479	2	0	486
22431	468	0	3	1	0	472
22432	3	477	2	2	0	484
22433	2	4	1	493	0	500
22434	2	2	509	4	0	517
22435	1	2	3	505	0	511
22436	1	0	514	5	0	520
22437	2	507	4	2	0	515
22438	503	4	2	1	0	510
22439	3	513	1	0	0	517
22440	1	6	1	492	0	500
22441	2	2	0	499	0	503
22442	0	1	481	5	0	487
22443	402	0	3	4	0	409
22444	2	448	2	1	0	453
22445	2	422	1	1	0	426
22446	1	437	1	0	0	439
22447	5	9	0	410	0	424
22448	1	421	1	1	0	424
22449	0	4	1	406	0	411
22450	1	410	0	2	0	413
22451	0	2	0	404	0	406
22452	0	405	0	1	0	406
22453	407	1	2	1	0	411
22454	0	2	400	1	0	403
22455	396	1	0	1	0	398
22456	394	0	2	0	0	396
22457	400	0	1	0	0	401
22458	3	400	0	0	0	403
22459	411	0	0	0	0	411
22460	407	2	0	1	0	410
22461	405	1	1	1	0	408
22462	7	0	401	0	0	408
22463	4	1	3	406	0	414
22464	2	1	426	3	0	432
22465	0	1	4	424	0	429
22466	425	0	3	5	0	433
22467	3	421	2	3	0	429
22468	4	2	432	2	0	440
22469	1	5	4	427	0	437
22470	0	1	3	468	0	472
22471	0	1	550	8	0	559
22472	577	0	7	5	0	589
22473	587	0	7	1	0	595
22474	607	0	1	0	0	608
22475	18	1	1	593	0	613
22476	9	578	0	10	0	597
22477	2	609	0	6	0	617
22478	1	14	0	604	0	619
22479	2	13	0	590	0	605
22480	1	584	0	15	0	600
22481	589	8	1	7	0	605
22482	9	589	0	3	0	601
22483	5	9	1	565	0	580
22484	2	7	565	10	0	584
22485	2	1	10	567	0	580
22486	559	0	6	12	0	577
22487	10	1	559	7	0	577
22488	562	1	11	2	0	576
22489	569	0	5	3	0	577
22490	577	0	2	2	0	581
22491	584	1	0	0	0	585
22492	597	0	5	0	0	602
22493	19	1	567	0	0	587
22494	8	0	571	2	0	581
22495	599	0	16	0	0	615
22496	613	1	6	2	0	622
22497	18	0	2	600	0	620
22498	7	601	2	12	0	622
22499	3	13	0	624	0	640
22500	641	7	0	13	0	661
22501	12	2	1	623	0	638
22502	8	640	0	12	0	660
22503	636	13	0	7	0	656
22504	629	6	1	2	0	638
22505	625	3	1	0	0	629
22506	20	606	0	1	0	627
22507	10	12	1	599	0	622
22508	3	6	0	597	0	606
22509	2	583	0	18	0	603
22510	0	15	1	592	0	608
22511	583	6	1	16	0	606
22512	581	1	0	8	0	590
22513	21	573	0	2	0	596
22514	12	13	0	562	0	587
22515	4	6	0	569	0	579
22516	3	2	1	581	0	587
22517	554	3	2	20	0	579
22518	15	0	546	12	0	573
22519	544	0	14	6	0	564
22520	17	3	534	1	0	555
22521	9	4	15	511	0	539
22522	5	535	7	12	0	559
22523	4	561	3	7	0	575
22524	534	20	1	3	0	558
22525	534	8	0	3	0	545
22526	20	521	1	3	0	545
22527	5	494	2	5	0	506
22528	505	20	1	0	0	526
22529	525	8	1	1	0	535
22530	20	534	1	2	0	557
22531	546	17	2	3	0	568
22532	17	8	526	4	0	555
22533	544	4	13	2	0	563
22534	534	3	4	4	0	545
22535	23	2	2	519	0	546
22536	10	515	5	13	0	543
22537	7	12	1	536	0	556
22538	530	9	2	16	0	557
22539	18	3	1	531	0	553
22540	12	2	1	538	0	553
22541	3	3	533	26	0	565
22542	8	3	14	535	0	560
22543	5	1	10	553	0	569
22544	541	2	1	22	0	566
22545	18	2	526	11	0	557
22546	539	6	16	6	0	567
22547	18	3	4	540	0	565
22548	10	0	1	552	0	563
22549	4	3	3	557	0	567
22550	4	524	1	22	0	551
22551	7	539	2	8	0	556
22552	6	19	3	537	0	565
22553	537	9	2	17	0	565
22554	548	4	2	8	0	562
22555	24	4	1	538	0	567
22556	542	2	1	18	0	563
22557	23	4	2	546	0	575
22558	12	2	2	553	0	569
22559	541	2	1	22	0	566
22560	18	544	2	11	0	575
22561	553	16	1	2	0	572
22562	560	6	1	6	0	573
22563	537	5	2	4	0	548
22564	22	531	2	5	0	560
22565	11	15	2	538	0	566
22566	4	6	2	555	0	567
22567	9	5	521	19	0	554
22568	3	5	10	526	0	544
22569	6	2	503	16	0	527
22570	3	468	12	7	0	490
22571	2	375	1	3	0	381
22572	2	351	2	3	0	358
22573	3	5	0	353	0	361
22574	2	2	1	348	0	353
22575	1	0	0	346	0	347
22576	1	1	1	348	0	351
22577	2	0	349	8	0	359
22578	1	0	429	3	0	433
22579	2	0	7	449	0	458
22580	0	0	461	10	0	471
22581	453	1	6	3	0	463
22582	462	1	1	3	0	467
22583	7	1	468	2	0	478
22584	5	0	6	457	0	468
22585	3	0	2	463	0	468
22586	3	0	1	463	0	467
22587	4	0	0	462	0	466
22588	1	1	1	467	0	470
22589	435	1	0	9	0	445
22590	449	0	0	6	0	455
22591	6	456	0	3	0	465
22592	5	7	432	1	0	445
22593	2	433	6	3	0	444
22594	4	442	2	0	0	448
22595	414	7	1	1	0	423
22596	5	410	0	2	0	417
22597	1	399	1	1	0	402
22598	386	8	1	2	0	397
22599	5	3	382	3	0	393
22600	365	1	5	0	0	371
22601	5	1	1	366	0	373
22602	2	2	2	355	0	361
22603	1	1	0	358	0	360
22604	0	0	349	8	0	357
22605	1	350	7	2	0	360
22606	355	4	1	5	0	365
22607	4	1	1	360	0	366
22608	3	363	0	7	0	373
22609	1	6	2	370	0	379
22610	1	3	366	5	0	375
22611	2	0	7	368	0	377
22612	0	1	1	379	0	381
22613	0	2	1	376	0	379
22614	378	1	0	8	0	387
22615	5	2	1	375	0	383
22616	1	2	376	7	0	386
22617	6	368	5	4	0	383
22618	1	5	3	374	0	383
22619	3	1	0	382	0	386
22620	2	0	362	9	0	373
22621	0	0	364	4	0	368
22622	349	1	6	8	0	364
22623	354	0	4	2	0	360
22624	8	352	0	2	0	362
22625	351	5	1	1	0	358
22626	5	1	341	2	0	349
22627	3	1	343	0	0	347
22628	331	5	6	3	0	345
22629	315	2	4	3	0	324
22630	7	0	300	4	0	311
22631	292	0	5	3	0	300
22632	5	0	295	2	0	302
22633	293	0	4	0	0	297
22634	288	2	1	1	0	292
22635	7	1	2	278	0	288
22636	2	303	0	3	0	308
22637	292	7	1	2	0	302
22638	11	1	295	1	0	308
22639	2	298	6	0	0	306
22640	297	7	2	1	0	307
22641	294	2	0	0	0	296
22642	5	288	2	1	0	296
22643	3	5	1	291	0	300
22644	1	2	285	7	0	295
22645	1	0	6	291	0	298
22646	2	0	295	7	0	304
22647	1	1	6	289	0	297
22648	1	2	2	297	0	302
22649	3	1	289	6	0	299
22650	1	284	5	7	0	297
22651	0	7	3	296	0	306
22652	1	2	287	8	0	298
22653	287	0	6	1	0	294
22654	5	1	1	297	0	304
22655	2	2	0	300	0	304
22656	295	1	0	9	0	305
22657	8	0	1	283	0	292
22658	2	1	1	282	0	286
22659	1	279	3	5	0	288
22660	2	7	0	276	0	285
22661	2	2	279	7	0	290
22662	0	0	5	280	0	285
22663	1	276	4	4	0	285
22664	0	277	3	2	0	282
22665	3	6	1	275	0	285
22666	276	1	1	6	0	284
22667	5	2	0	275	0	282
22668	274	2	1	5	0	282
22669	5	2	2	270	0	279
22670	272	0	2	7	0	281
22671	286	1	1	1	0	289
22672	8	6	0	263	0	277
22673	4	12	2	258	0	276
22674	2	268	0	6	0	276
22675	2	266	2	2	0	272
22676	3	5	268	1	0	277
22677	1	256	4	2	0	263
22678	161	13	3	1	0	178
22679	6	1	0	156	0	163
22680	0	145	0	5	0	150
22681	153	2	2	0	0	157
22682	3	2	0	153	0	158
22683	0	0	0	152	0	152
22684	0	0	1	152	0	153
22685	1	0	1	151	0	153
22686	0	145	1	4	0	150
22687	2	157	0	1	0	160
22688	170	3	0	0	0	173
22689	3	171	0	1	0	175
22690	1	2	0	171	0	174
22691	1	1	1	167	0	170
22692	0	0	1	171	0	172
22693	1	0	1	169	0	171
22694	169	0	0	3	0	172
22695	170	1	1	0	0	172
22696	3	1	173	0	0	177
22697	1	0	3	178	0	182
22698	2	0	175	2	0	179
22699	1	0	1	174	0	176
22700	1	0	0	181	0	182
22701	181	1	0	4	0	186
22702	5	0	0	183	0	188
22703	1	0	185	3	0	189
22704	1	1	183	1	0	186
22705	185	0	3	1	0	189
22706	4	1	183	0	0	188
22707	0	2	2	175	0	179
22708	0	0	189	2	0	191
22709	0	2	3	182	0	187
22710	1	182	1	3	0	187
22711	0	2	1	182	0	185
22712	0	179	0	3	0	182
22713	1	181	0	1	0	183
22714	0	2	0	174	0	176
22715	176	0	0	2	0	178
22716	2	175	1	0	0	178
22717	0	2	0	178	0	180
22718	179	0	0	2	0	181
22719	179	0	0	0	0	179
22720	181	0	1	0	0	182
22721	2	0	0	176	0	178
22722	0	0	0	182	0	182
22723	180	0	0	2	0	182
22724	177	0	0	0	0	177
22725	181	0	0	0	0	181
22726	2	0	0	174	0	176
22727	0	0	173	2	0	175
22728	167	0	2	0	0	169
22729	2	0	0	169	0	171
22730	0	174	0	1	0	175
22731	0	2	0	172	0	174
22732	0	838	2	2	0	842
22733	0	3	0	924	0	927
22734	0	0	908	2	0	910
22735	0	877	6	1	0	884
22736	0	1	0	903	0	904
22737	0	0	0	888	0	888
22738	0	0	1	865	0	866
22739	926	0	0	1	0	927
22740	2	877	1	0	0	880
22741	0	1	0	926	0	927
22742	931	1	0	2	0	934
22743	900	0	0	1	0	901
22744	3	0	0	900	0	903
22745	2	0	904	2	0	908
22746	0	2	2	888	0	892
22747	0	880	6	2	0	888
22748	0	2	0	919	0	921
22749	907	1	0	2	0	910
22750	2	0	0	893	0	895
22751	4	4	1835	5	0	1848
22752	0	1798	4	2	0	1804
22753	1924	2	1	0	0	1927
22754	4	1	1890	0	0	1895
22755	1844	0	2	0	0	1846
22756	2	0	1	1911	0	1914
22757	1	0	0	1917	0	1918
22758	1	1868	0	4	0	1873
22759	2750	1	1	2	0	2754
22760	64	1	1	2755	0	2821
22761	14	1	1	2784	0	2800
22762	9	0	0	2833	0	2842
22763	12	6	2711	85	0	2814
22764	5	0	61	2716	0	2782
22765	2769	0	12	80	0	2861
22766	2805	0	12	25	0	2842
22767	77	2	4	2750	0	2833
22768	21	2	3	2800	0	2826
22769	2781	1	1	75	0	2858
22770	76	3	2703	23	0	2805
22771	2683	0	64	18	0	2765
22772	80	5	2661	8	0	2754
22773	27	7	2707	10	0	2751
22774	10	0	83	2664	0	2757
22775	12	2	2714	67	0	2795
22776	2678	0	73	17	0	2768
22777	74	1	21	2697	0	2793
22778	19	3	2733	60	0	2815
22779	2636	0	76	21	0	2733
22780	2766	1	16	12	0	2795
22781	87	6	2676	9	0	2778
22782	34	1	62	2544	0	2641
22783	18	2688	24	50	0	2780
22784	2735	60	19	9	0	2823
22785	75	15	2692	11	0	2793
22786	2550	8	73	7	0	2638
22787	79	2674	21	9	0	2783
22788	2743	61	12	7	0	2823
22789	2746	19	12	3	0	2780
22790	2764	7	4	5	0	2780
22791	85	4	7	2675	0	2771
22792	30	2656	9	56	0	2751
22793	25	66	2570	21	0	2682
22794	14	2661	67	13	0	2755
22795	10	70	24	2512	0	2616
22796	6	2615	12	47	0	2680
22797	7	2725	10	12	0	2754
22798	2669	82	14	11	0	2776
22799	72	25	2608	6	0	2711
22800	29	17	2661	18	0	2725
22801	21	14	2644	10	0	2689
22802	11	2555	86	6	0	2658
22803	2721	65	27	3	0	2816
22804	2748	18	17	4	0	2787
22805	2732	13	11	3	0	2759
22806	85	2641	9	6	0	2741
22807	33	60	5	2717	0	2815
22808	22	23	2652	63	0	2760
22809	19	12	2605	21	0	2657
22810	2659	10	81	12	0	2762
22811	2783	6	29	8	0	2826
22812	2795	4	20	7	0	2826
22813	93	7	2710	5	0	2815
22814	2704	3	69	4	0	2780
22815	83	7	21	2682	0	2793
22816	33	2	11	2755	0	2801
22817	21	5	2673	79	0	2778
22818	14	2607	64	33	0	2718
22819	13	63	20	2748	0	2844
22820	13	18	2686	68	0	2785
22821	2527	8	74	37	0	2646
22822	72	8	23	2727	0	2830
22823	25	10	17	2766	0	2818
22824	2755	5	15	93	0	2868
22825	87	3	8	2761	0	2859
22826	2789	0	9	100	0	2898
22827	2813	2	11	56	0	2882
22828	98	1	15	2760	0	2874
22829	39	8	12	2800	0	2859
22830	2770	2	17	98	0	2887
22831	97	2	15	2773	0	2887
22832	2154	3	9	93	0	2259
22833	2175	2	14	47	0	2238
22834	2174	4	15	39	0	2232
22835	113	2	17	2097	0	2229
22836	47	4	23	2165	0	2239
22837	2138	0	18	92	0	2248
22838	92	2024	34	35	0	2185
22839	35	2085	31	30	0	2181
22840	2110	77	24	24	0	2235
22841	91	29	2011	20	0	2151
22842	2092	12	75	23	0	2202
22843	92	11	26	2108	0	2237
22844	48	18	2051	73	0	2190
22845	2104	7	74	19	0	2204
22846	97	3	32	2102	0	2234
22847	45	9	23	2157	0	2234
22848	33	16	17	2181	0	2247
22849	29	15	10	2192	0	2246
22850	2115	11	18	94	0	2238
22851	91	1196	14	38	0	1339
22852	1216	75	14	30	0	1335
22853	104	32	1167	11	0	1314
22854	51	23	1222	11	0	1307
22855	38	1190	83	8	0	1319
22856	36	71	18	1180	0	1305
22857	20	33	1172	75	0	1300
22858	21	1184	82	30	0	1317
22859	0	0	339	0	0	339
22860	0	0	0	334	0	334
22861	0	1	0	335	0	336
22862	355	0	0	0	0	355
22863	0	0	0	354	0	354
22864	358	0	0	0	0	358
22865	0	0	354	0	0	354
22866	0	361	0	0	0	361
22867	0	0	0	382	0	382
22868	0	0	1	408	0	409
22869	0	0	413	0	0	413
22870	0	0	388	0	0	388
22871	393	1	0	0	0	394
22872	413	0	0	0	0	413
22873	0	0	0	416	0	416
22874	0	0	0	411	0	411
22875	0	404	0	0	0	404
22876	0	0	0	423	0	423
22877	411	0	0	0	0	411
22878	414	0	0	0	0	414
22879	1	414	0	0	0	415
22880	423	0	0	0	0	423
22881	416	1	0	0	0	417
22882	1	1	0	1026	0	1028
22883	1	1015	3	14	0	1033
22884	1	11	2	1056	0	1070
22885	0	1	0	1078	0	1079
22886	1	0	1021	15	0	1037
22887	1056	0	12	3	0	1071
22888	12	1	0	1079	0	1092
22889	2	0	3	1064	0	1069
22890	1	1163	1	16	0	1181
22891	1	23	1	1275	0	1300
22892	1279	1	0	29	0	1309
22893	1386	2	0	3	0	1391
22894	33	1	1367	6	0	1407
22895	3	3	1360	5	0	1371
22896	4	2	35	1330	0	1371
22897	5	6	4	1445	0	1460
22898	1	3	1383	48	0	1435
22899	3	5	1397	16	0	1421
22900	1	3	37	1396	0	1437
22901	9	3	1370	45	0	1427
22902	5	3	1385	15	0	1408
22903	6	1	34	1419	0	1460
22904	1421	7	10	42	0	1480
22905	1444	3	3	14	0	1464
22906	45	5	5	1410	0	1465
22907	14	2	5	1452	0	1473
22908	1388	4	10	38	0	1440
22909	42	1	11	1392	0	1446
22910	1372	1	9	48	0	1430
22911	1380	1	9	17	0	1407
22912	37	1	16	1381	0	1435
22913	9	0	10	1412	0	1431
22914	1344	4	9	50	0	1407
22915	37	1303	16	21	0	1377
22916	5	1353	16	25	0	1399
22917	8	40	11	1389	0	1448
22918	17	13	1319	60	0	1409
22919	13	7	46	1392	0	1458
22920	1351	5	16	67	0	1439
22921	52	3	16	1387	0	1458
22922	1386	3	11	63	0	1463
22923	51	9	1328	43	0	1431
22924	1389	9	33	41	0	1472
22925	53	12	8	1397	0	1470
22926	31	6	10	1452	0	1499
22927	39	3	3005	64	0	3111
22928	35	7	49	2998	0	3089
22929	17	8	26	3195	0	3246
22930	12	18	22	3243	0	3295
22931	3185	9	18	92	0	3304
22932	55	6	3131	41	0	3233
22933	15	7	3118	47	0	3187
22934	3067	3	65	35	0	3170
22935	3128	7	34	44	0	3213
22936	55	5	3144	32	0	3236
22937	20	9	59	3086	0	3174
22938	40	3046	24	70	0	3180
22939	41	38	23	3219	0	3321
22940	3216	5	16	80	0	3317
22941	3227	3	25	55	0	3310
22942	56	6	22	3196	0	3280
22943	33	3015	21	92	0	3161
22944	40	33	13	3140	0	3226
22945	50	3075	20	63	0	3208
22946	3199	39	26	40	0	3304
22947	3140	9	26	54	0	3229
22948	3087	8	23	42	0	3160
22949	72	2949	24	33	0	3078
22950	33	3055	26	33	0	3147
22951	30	47	19	3173	0	3269
22952	24	20	16	3161	0	3221
22953	23	9	25	3113	0	3170
22954	33	8	25	3187	0	3253
22955	53	11	3060	80	0	3204
22956	2888	8	38	60	0	2994
22957	80	12	3104	41	0	3237
22958	3004	8	54	57	0	3123
22959	76	20	3132	45	0	3273
22960	3103	12	42	57	0	3214
22961	87	12	3132	44	0	3275
22962	3066	15	55	43	0	3179
22963	57	18	30	3201	0	3306
22964	3183	13	22	93	0	3311
22965	65	9	21	3225	0	3320
22966	35	7	25	3239	0	3306
22967	37	9	41	3179	0	3266
22968	29	3013	40	79	0	3161
22969	3142	41	34	39	0	3256
22970	3086	7	33	44	0	3170
22971	67	3012	40	30	0	3149
22972	43	47	20	3175	0	3285
22973	41	23	3034	76	0	3174
22974	3013	10	44	47	0	3114
22975	3119	7	25	48	0	3199
22976	3099	9	14	53	0	3175
22977	74	10	18	3064	0	3166
22978	43	2969	14	77	0	3103
22979	42	48	19	3135	0	3244
22980	3138	20	8	68	0	3234
22981	94	13	14	3073	0	3194
22982	5	2372	4	19	0	2400
22983	2361	19	6	6	0	2392
22984	25	4	2356	5	0	2390
22985	11	2	2319	5	0	2337
22986	3	2266	22	4	0	2295
22987	4	2321	3	4	0	2332
22988	11	18	2237	4	0	2270
22989	3	12	2220	9	0	2244
22990	6	58	20	1993	0	2077
22991	2169	4	12	8	0	2193
22992	12	1	2130	2	0	2145
22993	3	1870	14	0	0	1887
22994	2098	2	2	2	0	2104
22995	2	2004	6	3	0	2015
22996	2045	1	0	3	0	2049
22997	1	2007	5	2	0	2015
22998	0	2025	1	1	0	2027
22999	0	1	4	2043	0	2048
23000	0	0	2	2026	0	2028
23001	1	1	2010	1	0	2013
23002	0	0	1	1940	0	1941
23003	2034	0	0	1	0	2035
23004	2015	0	0	0	0	2015
23005	1	0	0	1974	0	1975
23006	0	2	1962	5	0	1969
23007	2	5	1862	1	0	1870
23008	1	0	1	1958	0	1960
23009	5	0	1994	1	0	2000
23010	0	0	1	1924	0	1925
23011	1	0	0	1904	0	1905
23012	1	0	1979	1	0	1981
23013	1788	1	2	5	0	1796
23014	1976	0	0	0	0	1976
23015	1	1	1941	0	0	1943
23016	0	6	3311	0	0	3317
23017	1	1	24	3265	0	3291
23018	1	0	11	3397	0	3409
23019	1	5	5	3470	0	3481
23020	1	2	3	3514	0	3520
23021	3474	0	4	38	0	3516
23022	3469	0	3	23	0	3495
23023	34	4	5	3497	0	3540
23024	16	0	4	3612	0	3632
23025	7	3	3476	52	0	3538
23026	6	0	23	3569	0	3598
23027	9	0	9	2171	0	2189
23028	2113	0	8	48	0	2169
23029	35	2212	3	31	0	2281
23030	16	30	5	2245	0	2296
23031	9	13	5	2296	0	2323
23032	0	7	8	2246	0	2261
23033	6	1998	14	68	0	2086
23034	5	2201	2	37	0	2245
23035	7	42	1	2234	0	2284
23036	6	24	4	2274	0	2308
23037	4	10	0	2323	0	2337
23038	2176	6	4	67	0	2253
23039	32	2211	1	44	0	2288
23040	2233	37	1	34	0	2305
23041	2278	21	3	20	0	2322
23042	47	13	3	2200	0	2263
23043	27	2190	2	57	0	2276
23044	2217	34	1	35	0	2287
23045	45	20	3	2276	0	2344
23046	2222	17	0	46	0	2285
23047	49	8	2	2291	0	2350
23048	29	14	2095	56	0	2194
23049	21	10	2121	32	0	2184
23050	11	11	42	2243	0	2307
23051	15	12	21	2231	0	2279
23052	13	6	13	2148	0	2180
23053	13	2070	12	79	0	2174
23054	12	2259	17	47	0	2335
23055	2222	45	10	45	0	2322
23056	2154	28	18	35	0	2235
23057	53	2158	8	49	0	2268
23058	37	2171	3	48	0	2259
23059	24	2260	2	37	0	2323
23060	2087	63	4	29	0	2183
23061	53	2183	4	32	0	2272
23062	34	55	8	2226	0	2323
23063	2166	31	9	60	0	2266
23064	2172	28	6	52	0	2258
23065	57	19	8	2218	0	2302
23066	49	26	2057	58	0	2190
23067	31	20	2093	58	0	2202
23068	25	14	42	2223	0	2304
23069	22	17	2110	77	0	2226
23070	14	17	44	2211	0	2286
23071	23	17	24	2243	0	2307
23072	23	9	2125	89	0	2246
23073	19	14	2120	76	0	2229
23074	14	24	62	2179	0	2279
23075	26	16	46	2255	0	2343
23076	2129	17	26	111	0	2283
23077	46	2093	29	102	0	2270
23078	41	2194	16	81	0	2332
23079	2091	69	15	73	0	2248
23080	2203	35	23	65	0	2326
23081	88	2131	27	65	0	2311
23082	61	2181	18	99	0	2359
23083	2205	62	27	94	0	2388
23084	66	51	20	2256	0	2393
23085	2123	32	20	138	0	2313
23086	90	2118	28	105	0	2341
23087	2218	50	14	110	0	2392
23088	100	50	2065	88	0	2303
23089	2183	42	52	96	0	2373
23090	81	30	2069	111	0	2291
23091	54	27	55	2214	0	2350
23092	2132	42	34	117	0	2325
23093	80	49	2016	87	0	2232
23094	64	51	46	2167	0	2328
23095	2129	46	36	119	0	2330
23096	76	44	1999	107	0	2226
23097	64	36	37	2186	0	2323
23098	2050	60	31	103	0	2244
23099	81	2088	23	85	0	2277
23100	71	78	16	2111	0	2276
23101	66	57	27	2146	0	2296
23102	51	51	17	2113	0	2232
23103	64	2039	19	124	0	2246
23104	53	75	25	2148	0	2301
23105	85	40	16	2153	0	2294
23106	65	56	26	2172	0	2319
23107	60	37	31	2228	0	2356
23108	57	39	2006	126	0	2228
23109	2091	33	63	100	0	2287
23110	2120	32	37	103	0	2292
23111	89	2084	33	87	0	2293
23112	60	64	31	2161	0	2316
23113	56	49	47	2132	0	2284
23114	57	2036	40	117	0	2250
23115	55	70	41	2192	0	2358
23116	537	4	2	22	0	565
23117	13	542	2	6	0	563
23118	509	12	2	11	0	534
23119	23	4	3	514	0	544
23120	4	8	506	16	0	534
23121	7	513	12	7	0	539
23122	477	13	3	11	0	504
23123	17	448	4	1	0	470
23124	6	432	2	1	0	441
23125	392	12	1	5	0	410
23126	11	6	374	2	0	393
23127	1	326	9	3	0	339
23128	226	22	26	6	0	280
23129	182	1	4	3	0	190
23130	5	175	0	2	0	182
23131	3	4	0	181	0	188
23132	2	0	178	4	0	184
23133	0	4	3	179	0	186
23134	1	1	0	181	0	183
23135	0	1	2	184	0	187
23136	1	1	180	5	0	187
23137	1	1	3	177	0	182
23138	1	0	179	6	0	186
23139	0	1	175	1	0	177
23140	167	0	4	3	0	174
23141	3	177	4	0	0	184
23142	1	176	2	1	0	180
23143	2	3	0	186	0	191
23144	210	3	1	5	0	219
23145	209	2	0	1	0	212
23146	213	0	1	3	0	217
23147	214	1	0	1	0	216
23148	210	0	1	0	0	211
23149	6	0	204	1	0	211
23150	2	1	4	199	0	206
23151	1	198	1	4	0	204
23152	1	3	3	206	0	213
23153	205	1	0	5	0	211
23154	2	212	0	1	0	215
23155	0	3	0	217	0	220
23156	220	0	1	3	0	224
23157	229	2	0	3	0	234
23158	4	2	2	226	0	234
23159	3	0	1	223	0	227
23160	5	0	0	226	0	231
23161	0	2	223	5	0	230
23162	0	1	237	4	0	242
23163	0	1	3	238	0	242
23164	1	0	1	244	0	246
23165	242	0	2	4	0	248
23166	248	0	0	2	0	250
23167	249	2	1	3	0	255
23168	272	0	0	0	0	272
23169	261	0	1	1	0	263
23170	5	265	1	2	0	273
23171	275	5	0	1	0	281
23172	277	0	0	2	0	279
23173	271	2	1	0	0	274
23174	5	2	1	272	0	280
23175	3	0	273	5	0	281
23176	2	0	4	280	0	286
23177	2	1	302	7	0	312
23178	1	0	6	292	0	299
23179	2	315	1	7	0	325
23180	314	4	2	2	0	322
23181	331	0	1	2	0	334
23182	5	3	2	335	0	345
23183	3	0	0	351	0	354
23184	3	0	0	352	0	355
23185	4	353	0	10	0	367
23186	363	3	1	3	0	370
23187	367	1	1	2	0	371
23188	7	362	0	1	0	370
23189	5	2	1	363	0	371
23190	3	3	0	365	0	371
23191	3	360	0	4	0	367
23192	369	6	0	3	0	378
23193	376	1	1	3	0	381
23194	7	2	0	375	0	384
23195	4	0	367	8	0	379
23196	4	1	373	3	0	381
23197	1	1	7	387	0	396
23198	2	0	4	382	0	388
23199	1	1	3	389	0	394
23200	399	1	0	10	0	410
23201	408	1	0	6	0	415
23202	6	421	0	6	0	433
23203	447	6	0	1	0	454
23204	9	3	450	1	0	463
23205	3	4	438	1	0	446
23206	5	447	7	1	0	460
23207	412	2	5	7	0	426
23208	3	410	1	2	0	416
23209	425	4	0	0	0	429
23210	4	1	420	0	0	425
23211	2	1	430	0	0	433
23212	1	0	5	421	0	427
23213	1	4	1580	3	0	1588
23214	0	0	5	1532	0	1537
23215	0	0	2	1633	0	1635
23216	0	1627	2	6	0	1635
23217	0	2	0	1704	0	1706
23218	0	3	0	1698	0	1701
23219	1721	1	0	6	0	1728
23220	4	1650	1	4	0	1659
23221	3	4	0	1726	0	1733
23222	2	2	1708	6	0	1718
23223	1370	2	7	2	0	1381
23224	8	0	1700	3	0	1711
23225	2	0	6	1625	0	1633
23226	1	1692	2	4	0	1699
23227	0	6	1	1753	0	1760
23228	1778	2	0	8	0	1788
23229	1754	1	0	3	0	1758
23230	8	1734	0	2	0	1744
23231	1824	8	0	0	0	1832
23232	1818	2	0	0	0	1820
23233	1819	1	0	0	0	1820
23234	1832	0	0	0	0	1832
23235	1795	0	1	1	0	1797
23236	12	0	1801	0	0	1813
23237	4	0	8	1721	0	1733
23238	1	3	4	1755	0	1763
23239	1	0	1	1817	0	1819
23240	1	1797	1	9	0	1808
23241	0	8	0	1846	0	1854
23242	1	1	1839	10	0	1851
23243	0	1758	9	3	0	1770
23244	0	1773	4	1	0	1778
23245	1	8	1	1810	0	1820
23246	1	3	0	1794	0	1798
23247	0	2	0	1782	0	1784
23248	0	1781	0	12	0	1793
23249	0	1778	2	6	0	1786
23250	1793	10	0	1	0	1804
23251	1793	3	0	0	0	1796
23252	11	1772	3	0	0	1786
23253	1856	8	0	1	0	1865
23254	1869	2	1	0	0	1872
23255	9	1	1	1861	0	1872
23256	3	2	0	1842	0	1847
23257	1	0	0	1885	0	1886
23258	1	1	1850	12	0	1864
23259	2	0	1761	3	0	1766
23260	1	1842	11	3	0	1857
23261	1890	9	3	0	0	1902
23262	10	2	1918	0	0	1930
23263	1728	2	11	0	0	1741
23264	10	2	1928	0	0	1940
23265	1856	1	11	0	0	1868
23266	11	1956	6	0	0	1973
23267	2002	9	2	0	0	2013
23268	11	3	1	1946	0	1961
23269	2	3	0	1958	0	1963
23270	2	0	1943	12	0	1957
23271	0	1898	9	6	0	1913
23272	1	11	3	1982	0	1997
23273	2	4	1959	9	0	1974
23274	1662	4	13	4	0	1683
23275	10	1913	4	3	0	1930
23276	1963	7	1	1	0	1972
23277	8	1882	1	3	0	1894
23278	2	13	0	1947	0	1962
23279	1940	3	0	7	0	1950
23280	8	1893	0	3	0	1904
23281	2	8	0	1937	0	1947
23282	4	3	1884	6	0	1897
23283	1667	5	7	3	0	1682
23284	6	0	2	1874	0	1882
23285	4	0	1879	6	0	1889
23286	3	1824	6	6	0	1839
23287	0	8	4	1885	0	1897
23288	3	4	1864	7	0	1878
23289	0	4	6	1812	0	1822
23290	1	1834	2	8	0	1845
23291	2	1875	5	2	0	1884
23292	5	8	1856	3	0	1872
23293	1	5	8	1776	0	1790
23294	4	0	1887	6	0	1897
23295	1690	4	6	2	0	1702
23296	8	3	1	1850	0	1862
23297	8	1820	5	6	0	1839
23298	1	1870	5	2	0	1878
23299	1876	7	2	0	0	1885
23300	7	1869	0	2	0	1878
23301	1830	7	0	3	0	1840
23302	7	1	1794	4	0	1806
23303	1631	1	12	3	0	1647
23304	7	1778	4	0	0	1789
23305	1852	6	5	1	0	1864
23306	6	1807	2	1	0	1816
23307	2	9	1	1798	0	1810
23308	3	1	0	1832	0	1836
23309	3	2	1818	8	0	1831
23310	1641	2	8	5	0	1656
23311	7	1	1759	1	0	1768
23312	1729	2	5	1	0	1737
23313	6	0	3	765	0	774
23314	2	0	1	777	0	780
23315	0	777	2	8	0	787
23316	2	6	0	821	0	829
23317	0	1	1	837	0	839
23318	0	1	814	11	0	826
23319	779	2	6	1	0	788
23320	8	809	1	0	0	818
23321	820	7	1	1	0	829
23322	8	0	1	824	0	833
23323	2	0	2	826	0	830
23324	814	0	0	10	0	824
23325	9	810	2	2	0	823
23326	794	8	2	0	0	804
23327	8	778	0	1	0	787
23328	4	773	2	2	0	781
23329	765	10	12	2	0	789
23330	10	4	4	734	0	752
23331	4	2	727	6	0	739
23332	2	0	8	732	0	742
23333	1	2	2	733	0	738
23334	2	721	3	9	0	735
23335	2	8	0	740	0	750
23336	0	6	0	730	0	736
23337	1	3	1	739	0	744
23338	2	2	1	748	0	753
23339	2	1	716	9	0	728
23340	3	4	742	4	0	753
23341	4	2	8	760	0	774
23342	4	1	748	10	0	763
23343	5	0	750	3	0	758
23344	1	4	9	760	0	774
23345	8	1	782	10	0	801
23346	2	4	8	765	0	779
23347	5	784	2	9	0	800
23348	805	7	0	7	0	819
23349	8	5	822	1	0	836
23350	7	2	7	826	0	842
23351	0	1	828	11	0	840
23352	1	2	12	899	0	914
23353	3	1	2	919	0	925
23354	1765	1	2	18	0	1786
23355	122	2	3	1819	0	1946
23356	1816	1	3	130	0	1950
23357	1912	1	1	58	0	1972
23358	186	1787	3	26	0	2002
23359	1842	123	1	13	0	1979
23360	161	1764	2	7	0	1934
23361	70	1879	4	3	0	1956
23362	1789	179	6	6	0	1980
23363	140	78	1734	4	0	1956
23364	65	33	1796	4	0	1898
23365	1715	15	175	6	0	1911
23366	1766	5	79	10	0	1860
23367	192	1671	40	7	0	1910
23368	1789	125	14	3	0	1931
23369	1861	65	4	7	0	1937
23370	1895	39	1	5	0	1940
23371	229	20	3	1701	0	1953
23372	1742	19	4	133	0	1898
23373	185	1685	8	54	0	1932
23374	75	131	11	1742	0	1959
23375	41	60	18	1820	0	1939
23376	33	1690	12	183	0	1918
23377	24	139	4	1799	0	1966
23378	1714	65	5	170	0	1954
23379	1821	37	6	71	0	1935
23380	206	1587	15	41	0	1849
23381	107	1770	4	15	0	1896
23382	1779	172	2	17	0	1970
23383	167	90	1670	13	0	1940
23384	92	52	1755	11	0	1910
23385	51	28	175	1685	0	1939
23386	36	19	82	1842	0	1979
23387	64	19	1661	193	0	1937
23388	51	1656	136	134	0	1977
23389	77	132	58	1745	0	2012
23390	93	71	1682	160	0	2006
23391	66	75	137	1737	0	2015
23392	64	65	65	1782	0	1976
23393	65	1697	37	192	0	1991
23394	43	191	30	1759	0	2023
23395	62	104	22	1847	0	2035
23396	59	46	48	1907	0	2060
23397	1726	32	69	238	0	2065
23398	197	22	47	1710	0	1976
23399	147	1645	23	185	0	2000
23400	1766	171	17	90	0	2044
23401	211	89	1645	58	0	2003
23402	152	53	1740	44	0	1989
23403	1775	33	181	38	0	2027
23404	194	37	88	1713	0	2032
23405	126	28	1617	186	0	1957
23406	83	42	150	1701	0	1976
23407	44	40	72	1851	0	2007
23408	1671	24	45	284	0	2024
23409	1778	46	22	144	0	1990
23410	205	1672	11	113	0	2001
23411	150	155	16	1696	0	2017
23412	129	71	1616	171	0	1987
23413	74	1738	142	80	0	2034
23414	1691	185	71	65	0	2012
23415	190	1744	48	41	0	2023
23416	1754	182	62	38	0	2036
23417	195	79	1667	50	0	1991
23418	1706	52	172	85	0	2015
23419	1870	28	77	101	0	2076
23420	238	26	1682	72	0	2018
23421	122	59	174	1664	0	2019
23422	79	1656	75	188	0	1998
23423	47	1763	84	120	0	2014
23424	44	1870	55	88	0	2057
23425	48	230	23	1786	0	2087
23426	45	135	1683	196	0	2059
23427	50	72	163	1815	0	2100
23428	43	39	85	1938	0	2105
23429	46	31	1681	296	0	2054
23430	84	1683	142	145	0	2054
23431	68	164	82	1786	0	2100
23432	1747	105	55	199	0	2106
23433	207	72	34	1784	0	2097
23434	118	38	59	1853	0	2068
23435	79	1714	75	226	0	2094
23436	4089	161	52	128	0	4430
23437	189	80	32	4082	0	4383
23438	86	61	3986	227	0	4360
23439	58	3886	155	160	0	4259
23440	4016	156	78	130	0	4380
23441	208	85	3985	95	0	4373
23442	3921	54	152	52	0	4179
23443	232	79	75	3772	0	4158
23444	113	3909	53	165	0	4240
23445	4045	165	77	92	0	4379
23446	4060	122	47	49	0	4278
23447	239	3995	38	47	0	4319
23448	128	195	36	4065	0	4424
23449	105	100	31	4181	0	4417
23450	4045	71	52	224	0	4392
23451	197	3914	43	115	0	4269
23452	141	155	43	3947	0	4286
23453	93	3886	67	184	0	4230
23454	3	2938	2	7	0	2950
23455	1	16	3	2905	0	2925
23456	2943	2	2	11	0	2958
23457	8	2830	1	3	0	2842
23458	1	13	0	2895	0	2909
23459	0	3	0	2903	0	2906
23460	1	0	2836	9	0	2846
23461	0	3	2662	3	0	2668
23462	1	2741	11	2	0	2755
23463	2	11	2825	1	0	2839
23464	1	3	11	2715	0	2730
23465	1	5	3513	9	0	3528
23466	0	1	9	3365	0	3375
23467	0	0	3	3555	0	3558
23468	0	1	0	3609	0	3610
23469	3628	0	2	11	0	3641
23470	9	0	0	3594	0	3603
23471	1	0	1	3584	0	3586
23472	0	3444	2	14	0	3460
23473	1	7	0	3631	0	3639
23474	3679	1	0	11	0	3691
23475	10	3492	3	4	0	3509
23476	3637	9	1	1	0	3648
23477	15	4	3406	5	0	3430
23478	4	9	3229	0	0	3242
23479	0	5	12	3303	0	3320
23480	2	0	1	3648	0	3651
23481	2	3532	2	13	0	3549
23482	0	11	3	3616	0	3630
23483	3624	1	0	11	0	3636
23484	3429	0	1	4	0	3434
23485	11	3	0	3596	0	3610
23486	1	2	3617	14	0	3634
23487	2	3	10	3612	0	3627
23488	3	0	2	3679	0	3684
23489	1	0	1	3696	0	3698
23490	1	2	1	3698	0	3702
23491	0	0	0	3681	0	3681
23492	1	3533	3	15	0	3552
23493	3668	10	2	5	0	3685
23494	3507	2	0	6	0	3515
23495	3579	0	0	7	0	3586
23496	12	3555	2	5	0	3574
23497	3710	12	0	0	0	3722
23498	13	3525	3	2	0	3543
23499	7	12	3543	1	0	3563
23500	3	8	12	3282	0	3305
23501	3	1	3583	15	0	3602
23502	2	3399	12	1	0	3414
23503	3506	13	4	0	0	3523
23504	14	2	3508	3	0	3527
23505	1	4	3443	2	0	3450
23506	0	3484	29	3	0	3516
23507	2	21	4	3765	0	3792
23508	1	3	3672	22	0	3698
23509	2	2	24	3494	0	3522
23510	1	5	6	3793	0	3805
23511	1	1	0	4619	0	4621
23512	4651	0	5	58	0	4714
23513	4619	0	4	9	0	4632
23514	58	0	2	4556	0	4616
23515	4683	0	3	60	0	4746
23516	63	3	4547	8	0	4621
23517	11	8	4432	8	0	4459
23518	4	5	4418	6	0	4433
23519	6	3	4481	6	0	4496
23520	3	4328	61	17	0	4409
23521	12	51	12	4468	0	4543
23522	14	10	4493	61	0	4578
23523	3889	4	58	15	0	3966
23524	4535	5	10	8	0	4558
23525	59	4423	12	17	0	4511
23526	4518	55	18	5	0	4596
23527	60	4	22	4503	0	4589
23528	11	8	4573	57	0	4649
23529	7	8	64	4335	0	4414
23530	6	4425	23	54	0	4508
23531	4583	61	12	17	0	4673
23532	4533	3	10	14	0	4560
23533	64	4499	14	19	0	4596
23534	4628	63	7	3	0	4701
23535	4574	10	3	7	0	4594
23536	65	3350	12	18	0	3445
23537	25	53	7	3398	0	3483
23538	11	3317	14	67	0	3409
23539	3420	59	17	12	0	3508
23540	65	13	8	3409	0	3495
23541	3423	10	10	58	0	3501
23542	69	21	1	3414	0	3505
23543	30	8	3334	65	0	3437
23544	3312	15	59	7	0	3393
23545	83	8	3350	5	0	3446
23546	21	7	55	3347	0	3430
23547	13	22	3355	59	0	3449
23548	18	6	53	3349	0	3426
23549	11	11	3331	72	0	3425
23550	3269	4	57	16	0	3346
23551	62	3311	13	28	0	3414
23552	3403	59	8	16	0	3486
23553	71	5	14	3402	0	3492
23554	3382	1	16	60	0	3459
23555	59	3340	12	12	0	3423
23556	21	3311	16	14	0	3362
23557	10	3412	17	20	0	3459
23558	3446	58	16	10	0	3530
23559	57	9	10	3417	0	3493
23560	16	16	10	3460	0	3502
23561	27	16	3335	59	0	3437
23562	18	11	3324	19	0	3372
23563	23	11	52	3341	0	3427
23564	22	7	3361	72	0	3462
23565	11	2812	56	15	0	2894
23566	2837	68	19	4	0	2928
23567	58	24	2837	7	0	2926
23568	15	10	2874	18	0	2917
23569	12	8	60	2823	0	2903
23570	2897	4	19	72	0	2992
23571	53	6	22	2903	0	2984
23572	2910	1	20	60	0	2991
23573	54	9	24	2897	0	2984
23574	20	10	2875	61	0	2966
23575	11	2807	62	24	0	2904
23576	23	61	2860	6	0	2950
23577	11	2849	61	14	0	2935
23578	9	61	28	2846	0	2944
23579	2836	17	15	60	0	2928
23580	66	4	2791	22	0	2883
23581	24	6	48	2802	0	2880
23582	19	4	10	2898	0	2931
23583	2894	7	15	65	0	2981
23584	61	10	17	2843	0	2931
23585	10	2874	19	63	0	2966
23586	2849	61	20	13	0	2943
23587	55	20	2818	14	0	2907
23588	3343	13	56	13	0	3425
23589	69	4756	19	14	0	4858
23590	23	59	17	4657	0	4756
23591	14	4820	12	60	0	4906
23592	4919	56	6	21	0	5002
23593	65	15	4812	26	0	4918
23594	4722	11	54	12	0	4799
23595	65	4786	13	18	0	4882
23596	18	63	16	4981	0	5078
23597	5003	23	7	58	0	5091
23598	5008	10	17	11	0	5046
23599	72	16	11	4954	0	5053
23600	21	19	3	4979	0	5022
23601	20	4892	7	74	0	4993
23602	11	73	17	4926	0	5027
23603	24	4960	16	68	0	5068
23604	15	5123	17	27	0	5182
23605	22	78	7	4994	0	5101
23606	20	6265	28	60	0	6373
23607	20	157	6547	20	0	6744
23608	31	60	6650	18	0	6759
23609	21	6520	226	30	0	6797
23610	12	165	6829	21	0	7027
23611	8	61	6217	10	0	6296
23612	9	29	6128	6	0	6172
23613	5	6047	206	6	0	6264
23614	6064	135	91	5	0	6295
23615	130	5950	41	4	0	6125
23616	63	144	6031	2	0	6240
23617	12	72	149	5964	0	6197
23618	6092	18	84	140	0	6334
23619	138	14	6068	70	0	6290
23620	77	14	142	6029	0	6262
23621	21	25	6107	133	0	6286
23622	12	26	166	6098	0	6302
23623	6058	15	99	152	0	6324
23624	142	28	5936	80	0	6186
23625	81	5937	149	24	0	6191
23626	27	133	102	5943	0	6205
23627	6075	75	48	139	0	6337
23628	146	28	5859	74	0	6107
23629	87	31	140	5612	0	5870
23630	39	5870	83	123	0	6115
23631	6002	154	50	69	0	6275
23632	5968	83	38	34	0	6123
23633	214	29	21	5926	0	6190
23634	98	5830	44	142	0	6114
23635	34	6135	45	91	0	6305
23636	5457	204	38	39	0	5738
23637	154	115	30	5287	0	5586
23638	111	5360	26	143	0	5640
23639	5454	149	36	70	0	5709
23640	153	98	40	5476	0	5767
23641	85	48	27	5623	0	5783
23642	55	52	4874	224	0	5205
23643	39	5170	145	105	0	5459
23644	22	5492	89	55	0	5658
23645	24	225	41	5491	0	5781
23646	5458	116	25	162	0	5761
23647	176	5411	31	105	0	5723
23648	5502	161	35	59	0	5757
23649	166	5414	41	38	0	5659
23650	95	198	30	5442	0	5765
23651	5482	114	23	165	0	5784
23652	175	63	29	5506	0	5773
23653	96	49	5346	188	0	5679
23654	61	54	166	5225	0	5506
23655	59	5243	100	176	0	5578
23656	5271	180	61	111	0	5623
23657	163	5393	58	66	0	5680
23658	101	196	54	5186	0	5537
23659	48	144	43	5481	0	5716
23660	62	58	5188	240	0	5548
23661	45	69	5217	125	0	5456
23662	41	67	243	5299	0	5650
23663	60	62	5186	195	0	5503
23664	62	5140	184	112	0	5498
23665	5195	176	112	78	0	5561
23666	181	116	5227	71	0	5595
23667	5125	65	193	62	0	5445
23668	5387	50	119	70	0	5626
23669	5412	37	85	77	0	5611
23670	5456	50	62	57	0	5625
23671	255	91	67	5191	0	5604
23672	139	67	69	5196	0	5471
23673	76	9046	90	246	0	9458
23674	9648	177	80	148	0	10053
23675	208	131	9401	75	0	9815
23676	139	65	217	9162	0	9583
23677	89	61	138	9569	0	9857
23678	72	65	9250	271	0	9658
23679	67	9098	176	152	0	9493
23680	83	220	118	9075	0	9496
23681	63	133	81	9672	0	9949
23682	9652	58	56	271	0	10037
23683	224	9141	50	160	0	9575
23684	150	188	53	9467	0	9858
23685	107	9168	60	207	0	9542
23686	56	184	52	9717	0	10009
23687	9489	112	42	270	0	9913
23688	8780	58	37	131	0	9006
23689	249	68	41	9054	0	9412
23690	9074	60	49	196	0	9379
23691	8841	42	37	154	0	9074
23692	252	8555	41	100	0	8948
23693	125	171	36	8797	0	9129
23694	75	8782	39	172	0	9068
23695	54	210	17	9060	0	9341
23696	8983	108	13	225	0	9329
23697	218	58	23	8813	0	9112
23698	147	52	15	8928	0	9142
23699	77	69	8627	256	0	9029
23700	63	8127	151	155	0	8496
23701	65	8715	76	95	0	8951
23702	8879	234	32	81	0	9226
23703	194	134	22	8664	0	9014
23704	8650	50	20	219	0	8939
23705	199	8344	24	192	0	8759
23706	16	6447	7	11	0	6481
23707	8	6610	3	8	0	6629
23708	6531	20	18	10	0	6579
23709	14	6180	6	7	0	6207
23710	6344	7	11	3	0	6365
23711	6155	3	5	1	0	6164
23712	6189	1	1	2	0	6193
23713	5	1	1	6099	0	6106
23714	3	2	0	6139	0	6144
23715	2	1	2	6256	0	6261
23716	1	4	2	6168	0	6175
23717	6399	0	0	13	0	6412
23718	6	5922	7	5	0	5940
23719	3	6	0	6316	0	6325
23720	6389	1	1	8	0	6399
23721	6	1	0	6192	0	6199
23722	6	1	0	6078	0	6085
23723	6268	1	3	7	0	6279
23724	7	9	6002	4	0	6022
23725	3	4	5	5970	0	5982
23726	3	2	6212	6	0	6223
23727	1	0	6	6072	0	6079
23728	4	0	2	6179	0	6185
23729	6219	1	1	10	0	6231
23730	6	5874	8	5	0	5893
23731	2	5849	3	1	0	5855
23732	6236	5	1	0	0	6242
23733	5	5908	6	4	0	5923
23734	6154	4	0	2	0	6160
23735	8	7	5916	0	0	5931
23736	5738	0	4	3	0	5745
23737	6069	1	2	1	0	6073
23738	6099	1	0	1	0	6101
23739	5	0	0	5856	0	5861
23740	2	0	1	5912	0	5915
23741	0	5753	4	7	0	5764
23742	0	6	0	6075	0	6081
23743	6064	1	1	3	0	6069
23744	2	5655	5	4	0	5666
23745	1	5732	6	5	0	5744
23746	5879	5	0	1	0	5885
23747	4	5	5828	0	0	5837
23748	3	2	6	5526	0	5537
23749	1	1	5880	3	0	5885
23750	1	1	3	5718	0	5723
23751	0	5515	7	7	0	5529
23752	1	3	0	5979	0	5983
23753	5844	1	2	4	0	5851
23754	3	3	0	5727	0	5733
23755	4	6	7025	8	0	7043
23756	6112	4	4	12	0	6132
23757	3	6608	16	7	0	6634
23758	2	6776	9	6	0	6793
23759	7127	7	0	0	0	7134
23760	6800	2	0	2	0	6804
23761	14	4	6976	0	0	6994
23762	6270	1	20	2	0	6293
23763	10	6788	10	1	0	6809
23764	7165	10	2	3	0	7180
23765	10	3	1	7003	0	7017
23766	5	7595	6	13	0	7619
23767	8016	68	2	4	0	8090
23768	79	91	7719	0	0	7889
23769	90	41	76	7465	0	7672
23770	8052	7	87	80	0	8226
23771	86	19	7807	91	0	8003
23772	7697	9	91	42	0	7839
23773	121	4	103	4100	0	4328
23774	106	16	51	4256	0	4429
23775	64	4	4151	183	0	4402
23776	21	6	106	4192	0	4325
23777	4180	3	103	145	0	4431
23778	95	4030	51	120	0	4296
23779	4254	87	28	72	0	4441
23780	4281	111	14	28	0	4434
23781	204	58	30	4167	0	4459
23782	170	15	4207	121	0	4513
23783	79	17	113	4240	0	4449
23784	4228	13	108	171	0	4520
23785	141	4031	76	118	0	4366
23786	4272	95	38	80	0	4485
23787	153	98	20	4180	0	4451
23788	121	50	26	4278	0	4475
23789	66	16	35	3263	0	3380
23790	52	18	3023	256	0	3349
23791	46	24	96	3154	0	3320
23792	62	31	3090	164	0	3347
23793	62	44	3026	143	0	3275
23794	76	9	177	3089	0	3351
23795	44	10	3165	161	0	3380
23796	2979	6	170	191	0	3346
23797	111	13	146	3293	0	3563
23798	133	16	95	3178	0	3422
23799	85	4262	37	229	0	4613
23800	4322	148	49	164	0	4683
23801	4339	112	35	104	0	4590
23802	244	4342	35	117	0	4738
23803	172	131	48	4434	0	4785
23804	90	121	4265	205	0	4681
23805	4167	72	172	174	0	4585
23806	4451	28	153	108	0	4740
23807	269	43	99	4374	0	4785
23808	198	38	4147	204	0	4587
23809	122	4209	170	176	0	4677
23810	4342	147	147	120	0	4756
23811	234	131	4101	103	0	4569
23812	169	4212	162	106	0	4649
23813	4277	166	152	87	0	4682
23814	4215	151	108	63	0	4537
23815	329	105	47	4040	0	4521
23816	245	4166	80	147	0	4638
23817	120	193	57	4398	0	4768
23818	106	147	79	4433	0	4765
23819	124	106	69	4366	0	4665
23820	135	67	49	4573	0	4824
23821	129	63	4126	358	0	4676
23822	102	91	158	4357	0	4708
23823	114	70	158	4457	0	4799
23824	120	78	4119	328	0	4645
23825	87	4133	170	316	0	4706
23826	4227	173	201	184	0	4785
23827	4328	151	143	145	0	4767
23828	317	84	52	4427	0	4880
23829	4425	44	83	284	0	4836
23830	228	86	65	4475	0	4854
23831	196	81	4141	319	0	4737
23832	166	72	4029	276	0	4543
23833	121	4123	241	235	0	4720
23834	4242	173	217	177	0	4809
23835	255	158	4212	144	0	4769
23836	224	114	208	4008	0	4554
23837	189	51	205	4350	0	4795
23838	103	65	153	4610	0	4931
23839	132	79	96	4606	0	4913
23840	135	73	90	4665	0	4963
23841	121	71	4172	458	0	4822
23842	129	41	200	4513	0	4883
23843	4221	67	178	402	0	4868
23844	220	4216	124	344	0	4904
23845	4218	167	133	269	0	4787
23846	212	4333	143	217	0	4905
23847	4405	245	118	169	0	4937
23848	4370	192	105	160	0	4827
23849	364	120	97	4314	0	4895
23850	260	80	89	4556	0	4985
23851	4348	76	82	439	0	4945
23852	4042	76	65	364	0	4547
23853	4333	60	53	269	0	4715
23854	379	4089	65	197	0	4730
23855	256	3215	83	201	0	3755
23856	206	293	2935	163	0	3597
23857	178	219	178	3195	0	3770
23858	181	146	2964	266	0	3557
23859	161	3059	223	250	0	3693
23860	144	246	165	2976	0	3531
23861	186	177	109	3053	0	3525
23862	164	127	96	3284	0	3671
23863	3004	89	98	449	0	3640
23864	2885	113	112	328	0	3438
23865	359	3038	74	262	0	3733
23866	60	91	30	2021	0	2202
23867	53	50	1922	129	0	2154
23868	47	36	1953	88	0	2124
23869	1960	50	94	71	0	2175
23870	1988	39	46	79	0	2152
23871	113	41	28	2008	0	2190
23872	1949	34	48	133	0	2164
23873	114	43	1844	77	0	2078
23874	97	1878	92	71	0	2138
23875	97	80	44	1922	0	2143
23876	62	44	1872	138	0	2116
23877	72	43	91	1955	0	2161
23878	58	26	75	2028	0	2187
23879	60	41	1895	112	0	2108
23880	1902	33	84	85	0	2104
23881	1894	48	57	74	0	2073
23882	116	1960	54	68	0	2198
23883	1968	71	53	86	0	2178
23884	2044	45	34	98	0	2221
23885	114	29	1906	110	0	2159
23886	1952	31	75	84	0	2142
23887	108	2014	38	112	0	2272
23888	2015	86	55	84	0	2240
23889	2043	36	56	64	0	2199
23890	2115	39	37	61	0	2252
23891	2001	29	57	35	0	2122
23892	1998	70	33	48	0	2149
23893	162	2046	28	45	0	2281
23894	1958	88	29	39	0	2114
23895	165	1951	35	41	0	2192
23896	123	1788	29	38	0	1978
23897	91	4472	18	54	0	4635
23898	4580	329	30	68	0	5007
23899	3680	187	3	1	0	3871
23900	472	96	3264	2	0	3834
23901	3639	49	259	2	0	3949
23902	3752	38	187	4	0	3981
23903	550	14	4283	2	0	4849
23904	329	16	403	4311	0	5059
23905	169	13	248	4682	0	5112
23906	101	6	140	4885	0	5132
23907	66	22	71	5125	0	5284
23908	51	16	58	5250	0	5375
23909	77	25	4099	846	0	5047
23910	64	4419	395	476	0	5354
23911	4258	395	229	268	0	5150
23912	432	4629	159	146	0	5366
23913	4691	524	100	85	0	5400
23914	5020	298	63	71	0	5452
23915	717	201	4209	78	0	5205
23916	437	86	415	3890	0	4828
23917	248	4409	229	419	0	5305
23918	4563	390	148	294	0	5395
23919	4703	242	104	193	0	5242
23920	4808	179	88	128	0	5203
23921	790	4470	58	106	0	5424
23922	4817	467	59	74	0	5417
23923	5013	281	27	88	0	5409
23924	5107	196	15	91	0	5409
23925	858	116	54	4358	0	5386
23926	527	98	42	4729	0	5396
23927	355	66	57	5056	0	5534
23928	4434	87	55	779	0	5355
23929	557	4531	40	453	0	5581
23930	4778	444	19	266	0	5507
23931	5011	288	48	138	0	5485
23932	4892	180	56	123	0	5251
23933	5125	114	28	96	0	5363
23934	905	4480	42	97	0	5524
23935	4578	417	20	108	0	5123
23936	748	4280	20	109	0	5157
23937	434	4749	27	125	0	5335
23938	4397	652	27	103	0	5179
23939	570	4279	22	91	0	4962
23940	452	4657	22	64	0	5195
23941	4530	717	19	51	0	5317
23942	4820	431	28	63	0	5342
23943	836	245	29	4231	0	5341
23944	547	176	28	4708	0	5459
23945	4490	145	29	667	0	5331
23946	4735	148	29	408	0	5320
23947	5025	145	14	255	0	5439
23948	947	116	3979	155	0	5197
23949	4794	122	379	114	0	5409
23950	828	132	229	4188	0	5377
23951	581	101	163	4567	0	5412
23952	398	115	96	4799	0	5408
23953	276	118	68	5118	0	5580
23954	268	85	4062	929	0	5344
23955	205	112	4455	611	0	5383
23956	210	114	603	4708	0	5635
23957	278	91	4507	643	0	5519
23958	271	134	4729	414	0	5548
23959	328	114	736	4489	0	5667
23960	345	101	469	4784	0	5699
23961	342	94	318	5022	0	5776
23962	345	112	212	5225	0	5894
23963	4588	99	148	1006	0	5841
23964	4907	99	174	682	0	5862
23965	878	96	174	4789	0	5937
23966	622	89	133	4981	0	5825
23967	404	74	195	5193	0	5866
23968	295	95	152	5276	0	5818
23969	240	117	117	5178	0	5652
23970	229	4346	172	1150	0	5897
23971	4284	513	134	768	0	5699
23972	638	4600	101	595	0	5934
23973	4748	619	124	437	0	5928
23974	4972	401	124	354	0	5851
23975	5213	294	92	358	0	5957
23976	1111	188	138	4587	0	6024
23977	4833	206	111	703	0	5853
23978	926	156	70	4752	0	5904
23979	633	212	64	5058	0	5967
23980	4651	178	57	886	0	5772
23981	878	4109	41	616	0	5644
23982	662	4663	69	372	0	5766
23983	4837	705	66	299	0	5907
23984	850	488	4050	298	0	5686
23985	4766	323	412	291	0	5792
23986	884	251	270	4319	0	5724
23987	689	3892	172	624	0	5377
23988	531	4617	87	494	0	5729
23989	4616	710	74	388	0	5788
23990	860	500	42	4141	0	5543
23991	665	4419	35	618	0	5737
23992	4676	565	28	462	0	5731
23993	5001	416	24	370	0	5811
23994	5041	303	49	331	0	5724
23995	4838	256	41	290	0	5425
23996	1214	4404	72	263	0	5953
23997	148	1515	9	43	0	1715
23998	1526	174	3	29	0	1732
23999	1604	96	6	32	0	1738
24000	234	77	1303	35	0	1649
24001	139	464	123	34	0	760
24002	530	52	52	36	0	670
24003	413	0	0	0	0	413
24004	5	1	419	1	0	426
24005	422	1	5	1	0	429
24006	7	0	438	1	0	446
24007	1	0	504	0	0	505
24008	0	1	5	480	0	486
24009	0	510	1	5	0	516
24010	532	5	1	0	0	538
24011	5	0	0	535	0	540
24012	1	1	0	533	0	535
24013	1	0	0	543	0	544
24014	543	0	0	6	0	549
24015	5	0	0	538	0	543
24016	0	0	0	557	0	557
24017	0	0	549	6	0	555
24018	563	0	5	2	0	570
24019	572	0	0	1	0	573
24020	7	0	562	0	0	569
24021	550	0	5	0	0	555
24022	6	0	0	552	0	558
24023	0	551	1	5	0	557
24024	1	4	0	559	0	564
24025	553	0	0	6	0	559
24026	5	563	0	0	0	568
24027	0	5	0	569	0	574
24028	1	0	1	576	0	578
24029	2	1	0	568	0	571
24030	1	0	1	563	0	565
24031	0	569	2	4	0	575
24032	578	5	1	2	0	586
24033	579	2	0	2	0	583
24034	6	586	0	0	0	592
24035	641	6	0	2	0	649
24036	650	1	0	2	0	653
24037	646	1	0	2	0	649
24038	12	0	636	2	0	650
24039	6	1	7	641	0	655
24040	4	0	625	13	0	642
24041	623	0	10	4	0	637
24042	9	627	3	3	0	642
24043	632	7	3	0	0	642
24044	10	634	0	1	0	645
24045	3	7	2	625	0	637
24046	5	2	1	635	0	643
24047	1	5	627	10	0	643
24048	1	641	7	6	0	655
24049	639	9	2	4	0	654
24050	10	2	635	2	0	649
24051	628	4	9	3	0	644
24052	12	0	3	640	0	655
24053	3	1	643	12	0	659
24054	3	630	8	12	0	653
24055	0	9	4	641	0	654
24056	2	3	649	9	0	663
24057	2	4	635	5	0	646
24058	4	630	10	4	0	648
24059	2	12	8	618	0	640
24060	6	3	2	622	0	633
24061	2	621	2	11	0	636
24062	620	8	3	6	0	637
24063	7	5	1	622	0	635
24064	3	609	2	14	0	628
24065	623	9	3	4	0	639
24066	614	4	3	4	0	625
24067	636	6	1	1	0	644
24068	14	622	1	4	0	641
24069	629	10	1	4	0	644
24070	635	5	0	2	0	642
24071	13	3	0	622	0	638
24072	625	3	2	9	0	639
24073	11	5	0	624	0	640
24074	8	0	615	12	0	635
24075	7	3	627	2	0	639
24076	6	2	9	633	0	650
24077	2	2	631	10	0	645
24078	623	2	11	7	0	643
24079	9	2	3	639	0	653
24080	5	1	4	636	0	646
24081	6	2	629	11	0	648
24082	1	597	10	10	0	618
24083	3	626	5	5	0	639
24084	5	8	7	599	0	619
24085	4	6	1	609	0	620
24086	3	4	596	10	0	613
24087	4	2	585	9	0	600
24088	2	5	10	585	0	602
24089	4	2	554	12	0	572
24090	539	1	13	5	0	558
24091	9	4	4	539	0	556
24092	547	5	5	7	0	564
24093	12	5	0	546	0	563
24094	4	1	1	559	0	565
24095	5	3	538	15	0	561
24096	2	526	12	9	0	549
24097	2	14	3	526	0	545
24098	2	4	505	11	0	522
24099	5	492	9	4	0	510
24100	3	16	6	497	0	522
24101	497	5	4	9	0	515
24102	10	4	488	8	0	510
24103	458	2	8	7	0	475
24104	13	2	452	4	0	471
24105	407	2	9	5	0	423
24106	10	415	6	4	0	435
24107	2	361	4	1	0	368
24108	4	7	0	348	0	359
24109	1	350	2	7	0	360
24110	343	11	1	3	0	358
24111	4	5	3	340	0	352
24112	8	4	0	342	0	354
24113	3	0	3	352	0	358
24114	3	1	330	11	0	345
24115	1	2	7	333	0	343
24116	2	2	318	8	0	330
24117	0	309	6	7	0	322
24118	288	6	5	4	0	303
24119	6	300	2	2	0	310
24120	307	6	2	4	0	319
24121	312	3	2	2	0	319
24122	311	3	0	5	0	319
24123	312	0	3	2	0	317
24124	10	1	304	2	0	317
24125	6	2	6	303	0	317
24126	3	3	3	297	0	306
24127	3	0	3	308	0	314
24128	288	3	0	11	0	302
24129	295	0	3	6	0	304
24130	9	300	1	3	0	313
24131	5	3	291	3	0	302
24132	3	2	290	1	0	296
24133	2	290	8	0	0	300
24134	2	282	4	3	0	291
24135	3	6	3	214	0	226
24136	0	2	0	214	0	216
24137	213	0	0	5	0	218
24138	3	209	1	1	0	214
24139	2	5	0	221	0	228
24140	0	3	1021	4	0	1028
24141	0	0	5	1017	0	1022
24142	1	3	1	1092	0	1097
24143	0	2	1	1112	0	1115
24144	1	0	0	1107	0	1108
24145	1	0	1085	5	0	1091
24146	4	947	3	2	0	956
24147	1	1039	2	1	0	1043
24148	1067	3	0	0	0	1070
24149	2	1049	1	0	0	1052
24150	2	1055	0	2	0	1059
24151	2	2	0	1075	0	1079
24152	1	1	2	1061	0	1065
24153	1	0	1	1063	0	1065
24154	0	1	1075	3	0	1079
24155	1	1018	1	3	0	1023
24156	0	3	1	1092	0	1096
24157	2	993	2	3	0	1000
24158	1101	1	1	2	0	1105
24159	2	1055	2	1	0	1060
24160	1106	1	1	0	0	1108
24161	2	5	1036	0	0	1043
24162	1068	0	1	1	0	1070
24163	1	2	1	1093	0	1097
24164	1	0	1095	3	0	1099
24165	1067	1	2	3	0	1073
24166	1126	0	1	0	0	1127
24167	1118	2	1	2	0	1123
24168	3	0	0	1099	0	1102
24169	2	0	1085	3	0	1090
24170	1004	0	2	2	0	1008
24171	2	0	1	1150	0	1153
24172	2	0	1	1137	0	1140
24173	1	3	1137	5	0	1146
24174	3	1065	4	4	0	1076
24175	0	2	1	1132	0	1135
24176	1	1102	1	2	0	1106
24177	1149	1	0	3	0	1153
24178	1131	1	0	0	0	1132
24179	3	0	0	1131	0	1134
24180	1147	1	1	2	0	1151
24181	1	1093	2	2	0	1098
24182	1152	1	1	1	0	1155
24183	1	1128	0	3	0	1132
24184	2	2	0	1155	0	1159
24185	1	1	0	1160	0	1162
24186	0	1131	0	4	0	1135
24187	1	1	1	1172	0	1175
24188	1	3	1128	1	0	1133
24189	0	1041	4	3	0	1048
24190	1131	2	2	1	0	1136
24191	1	1094	2	5	0	1102
24192	1	0	0	1129	0	1130
24193	1	1	1083	1	0	1086
24194	0	1	0	1089	0	1090
24195	0	2	1	1129	0	1132
24196	1106	0	1	2	0	1109
24197	1	3	1069	4	0	1077
24198	1	1002	6	3	0	1012
24199	0	3	1090	1	0	1094
24200	0	2	1135	1	0	1138
24201	0	1	1144	0	0	1145
24202	0	10	6	1027	0	1043
24203	1167	0	0	2	0	1169
24204	2	1048	3	2	0	1055
24205	1168	2	0	1	0	1171
24206	1166	1	0	2	0	1169
24207	3	0	0	1148	0	1151
24208	0	1127	3	5	0	1135
24209	1174	3	0	1	0	1178
24210	3	1725	2	0	0	1730
24211	1	4	0	1789	0	1794
24212	0	0	0	1827	0	1827
24213	0	1774	2	5	0	1781
24214	0	3	0	1837	0	1840
24215	1	4	1717	4	0	1726
24216	1	2	1730	0	0	1733
24217	0	0	3	2570	0	2573
24218	0	0	0	2650	0	2650
24219	2	1	2591	44	0	2638
24220	1	3	2570	4	0	2578
24221	2296	2	42	4	0	2344
24222	39	2420	11	3	0	2473
24223	4	2611	3	2	0	2620
24224	1	48	2	2511	0	2562
24225	1	7	2	2538	0	2548
24226	0	2	0	2629	0	2631
24227	1	1	2565	44	0	2611
24228	4	5	2496	11	0	2516
24229	1	1	41	2529	0	2572
24230	2	3	2568	47	0	2620
24231	2	2389	54	10	0	2455
24232	2584	41	8	2	0	2635
24233	42	8	2550	3	0	2603
24234	4	6	2550	2	0	2562
24235	1	2	43	2462	0	2508
24236	3	1	2573	45	0	2622
24237	2	2427	51	14	0	2494
24238	1	42	11	2602	0	2656
24239	5	11	2566	48	0	2630
24240	2	1913	35	8	0	1958
24241	1943	43	9	3	0	1998
24242	44	8	2	1930	0	1984
24243	5	1	2	1971	0	1979
24244	1938	1	6	49	0	1994
24245	44	1929	6	8	0	1987
24246	1961	42	2	7	0	2012
24247	1975	5	6	1	0	1987
24248	1986	5	0	2	0	1993
24249	45	3	1	1939	0	1988
24250	1906	2	5	45	0	1958
24251	45	1895	0	9	0	1949
24252	8	1923	2	6	0	1939
24253	1925	50	1	7	0	1983
24254	46	5	2	1953	0	2006
24255	9	3	1	1959	0	1972
24256	3	5	1	1998	0	2007
24257	7	2	1884	53	0	1946
24258	7	1892	40	9	0	1948
24259	4	46	6	1953	0	2009
24260	1950	5	6	50	0	2011
24261	50	3	3	1934	0	1990
24262	7	6	1902	48	0	1963
24263	2	1885	40	7	0	1934
24264	1948	46	5	5	0	2004
24265	1959	4	4	11	0	1978
24266	1948	5	2	8	0	1963
24267	49	3	2	1936	0	1990
24268	7	2	1933	44	0	1986
24269	1	5	1935	8	0	1949
24270	6	1900	48	7	0	1961
24271	7	51	7	1936	0	2001
24272	4	9	1	2014	0	2028
24273	1962	2	6	53	0	2023
24274	49	5	3	1958	0	2015
24275	2437	2	2	52	0	2493
24276	94	1	2374	8	0	2477
24277	38	3	2422	2	0	2465
24278	9	5	110	2345	0	2469
24279	14	1	38	2450	0	2503
24280	10	6	23	2521	0	2560
24281	2435	6	19	117	0	2577
24282	2501	1	24	51	0	2577
24283	118	0	27	2477	0	2622
24284	42	1	2406	125	0	2574
24285	20	3	2467	62	0	2552
24286	26	4	112	2464	0	2606
24287	2484	1	40	120	0	2645
24288	113	1	26	2441	0	2581
24289	47	4	23	2539	0	2613
24290	22	4	2454	140	0	2620
24291	21	4	2465	61	0	2551
24292	2383	5	125	39	0	2552
24293	118	2	2448	35	0	2603
24294	41	3	107	2418	0	2569
24295	21	2	57	2508	0	2588
24296	2446	1	44	131	0	2622
24297	99	2378	50	52	0	2579
24298	2446	87	32	36	0	2601
24299	110	2393	33	38	0	2574
24300	2422	97	17	42	0	2578
24301	116	36	2325	38	0	2515
24302	2250	19	108	24	0	2401
24303	2381	24	38	17	0	2460
24304	146	28	22	2313	0	2509
24305	64	17	2286	101	0	2468
24306	49	15	95	2276	0	2435
24307	46	9	43	2326	0	2424
24308	38	2261	27	127	0	2453
24309	40	87	19	2253	0	2399
24310	24	1723	20	123	0	1890
24311	19	93	27	1762	0	1901
24312	1705	39	20	126	0	1890
24313	105	17	12	1769	0	1903
24314	46	25	1666	129	0	1866
24315	1720	20	94	72	0	1906
24316	117	20	1712	44	0	1893
24317	913	17	62	39	0	1031
24318	939	7	49	36	0	1031
24319	102	887	26	37	0	1052
24320	56	957	38	31	0	1082
24321	938	69	35	25	0	1067
24322	981	32	26	28	0	1067
24323	1007	18	18	21	0	1064
24324	979	24	12	26	0	1041
24325	1003	22	18	22	0	1065
24326	114	28	21	905	0	1068
24327	79	16	15	966	0	1076
24328	61	10	872	90	0	1033
24329	937	7	63	51	0	1058
24330	99	8	37	904	0	1048
24331	69	7	17	956	0	1049
24332	44	6	874	112	0	1036
24333	33	832	72	77	0	1014
24334	25	894	60	54	0	1033
24335	886	58	37	40	0	1021
24336	896	27	29	49	0	1001
24337	96	810	24	45	0	975
24338	52	851	23	40	0	966
24339	834	84	17	27	0	962
24340	877	65	10	20	0	972
24341	117	43	15	805	0	980
24342	86	33	16	844	0	979
24343	73	26	15	881	0	995
24344	838	31	18	91	0	978
24345	888	16	19	62	0	985
24346	117	10	18	856	0	1001
24347	882	8	11	108	0	1009
24348	94	5	790	92	0	981
24349	63	13	57	885	0	1018
24350	48	9	818	102	0	977
24351	49	813	53	79	0	994
24352	43	53	42	859	0	997
24353	832	37	26	87	0	982
24354	80	21	26	853	0	980
24355	48	20	33	881	0	982
24356	47	14	773	110	0	944
24357	37	24	807	59	0	927
24358	36	805	84	50	0	975
24359	819	59	46	35	0	959
24360	865	37	23	37	0	962
24361	865	22	37	42	0	966
24362	884	21	25	30	0	960
24363	113	24	25	798	0	960
24364	89	31	12	809	0	941
24365	73	794	11	73	0	951
24366	853	48	10	46	0	957
24367	885	34	6	44	0	969
24368	127	12	746	41	0	926
24369	761	14	56	43	0	874
24370	89	693	30	51	0	863
24371	64	441	23	296	0	824
24372	51	749	23	36	0	859
24373	700	53	32	25	0	810
24374	76	730	24	31	0	861
24375	2	2	0	236	0	240
24376	0	1	0	238	0	239
24377	1	0	0	228	0	229
24378	0	228	0	3	0	231
24379	0	4	0	225	0	229
24380	0	1	1	220	0	222
24381	0	202	0	2	0	204
24382	1	195	0	1	0	197
24383	179	2	0	0	0	181
24384	1	184	0	0	0	185
24385	163	0	0	0	0	163
24386	0	1	157	0	0	158
24387	1	158	0	0	0	159
24388	160	0	0	0	0	160
24389	160	1	0	0	0	161
24390	3	0	159	0	0	162
24391	1	0	0	161	0	162
24392	0	0	163	0	0	163
24393	0	164	0	1	0	165
24394	165	0	1	0	0	166
24395	0	165	0	0	0	165
24396	0	0	0	161	0	161
24397	0	1	0	164	0	165
24398	0	0	169	1	0	170
24399	0	0	162	1	0	163
24400	172	0	1	0	0	173
24401	168	0	1	0	0	169
24402	171	0	0	0	0	171
24403	168	0	0	0	0	168
24404	1	166	0	0	0	167
24405	1	0	0	166	0	167
24406	0	1	0	166	0	167
24407	0	164	0	1	0	165
24408	168	0	0	1	0	169
24409	168	1	0	0	0	169
24410	1	0	168	0	0	169
24411	170	0	0	0	0	170
24412	0	0	0	168	0	168
24413	1	0	167	0	0	168
24414	0	0	0	169	0	169
24415	0	0	170	0	0	170
24416	0	0	162	1	0	163
24417	0	6	1	155	0	162
24418	0	145	2	0	0	147
24419	139	0	0	2	0	141
24420	130	1	1	0	0	132
24421	1	141	1	0	0	143
24422	2	138	0	3	0	143
24423	146	1	0	0	0	147
24424	148	1	0	1	0	150
24425	149	0	0	1	0	150
24426	149	0	1	0	0	150
24427	1	0	1	153	0	155
24428	1	1	152	0	0	154
24429	3	152	0	1	0	156
24430	160	0	2	0	0	162
24431	1	164	0	0	0	165
24432	166	0	0	0	0	166
24433	162	1	0	1	0	164
24434	1	1	168	1	0	171
24435	2	172	0	0	0	174
24436	1	1	1	181	0	184
24437	2	1	1	181	0	185
24438	1	1	1	179	0	182
24439	182	1	2	1	0	186
24440	180	3	0	1	0	184
24441	181	1	0	2	0	184
24442	3	183	0	1	0	187
24443	178	1	1	1	0	181
24444	1	187	0	1	0	189
24445	2	0	184	3	0	189
24446	1	179	0	3	0	183
24447	1	2	0	170	0	173
24448	2	0	0	167	0	169
24449	1	1	166	1	0	169
24450	1	1	0	164	0	166
24451	0	3	0	165	0	168
24452	168	0	0	1	0	169
24453	165	2	0	1	0	168
24454	171	0	2	0	0	173
24455	0	169	1	1	0	171
24456	171	1	0	2	0	174
24457	173	0	0	1	0	174
24458	2	181	1	0	0	184
24459	1	0	1	182	0	184
24460	0	1	0	184	0	185
24461	181	0	1	0	0	182
24462	2	1	175	0	0	178
24463	2	169	0	0	0	171
24464	0	3	0	169	0	172
24465	1	167	0	2	0	170
24466	2	162	0	1	0	165
24467	164	1	1	0	0	166
24468	163	1	0	1	0	165
24469	1	0	0	164	0	165
24470	0	1	0	156	0	157
24471	0	1	1	156	0	158
24472	1	1	0	153	0	155
24473	1	1	149	1	0	152
24474	1	1	147	1	0	150
24475	1	1	0	154	0	156
24476	1	0	160	1	0	162
24477	2	153	0	1	0	156
24478	159	0	1	2	0	162
24479	166	0	2	1	0	169
24480	0	0	0	170	0	170
24481	0	0	2	166	0	168
24482	0	1	2	166	0	169
24483	1	163	1	0	0	165
24484	166	1	0	2	0	169
24485	169	0	1	1	0	171
24486	2	1	163	1	0	167
24487	1	1	1	169	0	172
24488	1	2	167	1	0	171
24489	2	0	1	186	0	189
24490	2	0	0	185	0	187
24491	1	0	1	185	0	187
24492	1	1	0	188	0	190
24493	186	0	1	2	0	189
24494	195	0	1	1	0	197
24495	196	1	1	1	0	199
24496	2	0	0	196	0	198
24497	1	1	194	2	0	198
24498	189	0	1	1	0	191
24499	3	0	0	199	0	202
24500	189	0	0	2	0	191
24501	1	0	0	189	0	190
24502	1	185	1	1	0	188
24503	2	189	0	0	0	191
24504	1	2	0	191	0	194
24505	1	0	0	193	0	194
24506	0	0	1	194	0	195
24507	1	194	0	1	0	196
24508	192	2	0	1	0	195
24509	2	187	1	1	0	191
24510	0	8	2641	2	0	2651
24511	0	6	2	2481	0	2489
24512	0	2684	2	2	0	2688
24513	1	1	0	2844	0	2846
24514	0	2	0	2725	0	2727
24515	0	0	2821	6	0	2827
24516	2494	3	2	3	0	2502
24517	2	2629	2	0	0	2633
24518	5745	2	0	2	0	5749
24519	5605	1	1	1	0	5608
24520	5513	0	1	1	0	5515
24521	4	2	5592	1	0	5599
24522	1	4	1	5207	0	5213
24523	1	0	1	5649	0	5651
24524	3	0	5655	3	0	5661
24525	4098	4	7	4	0	4113
24526	1	2	5651	1	0	5655
24527	4	1	5494	2	0	5501
24528	0	5216	6	4	0	5226
24529	1	1	1	5547	0	5550
24530	1	2	5664	2	0	5669
24531	4966	4	6	1	0	4977
24532	5343	0	1	0	0	5344
24533	4	0	5560	0	0	5564
24534	1	2	1	5197	0	5201
24535	3	0	5701	3	0	5707
24536	0	5269	5	1	0	5275
24537	5746	1	1	1	0	5749
24538	5640	1	0	0	0	5641
24539	5472	0	2	1	0	5475
24540	2	1	0	5468	0	5471
24541	1	0	0	5554	0	5555
24542	1	2	5623	5	0	5631
24543	4927	1	5	2	0	4935
24544	1	1	1	5547	0	5550
24545	5582	0	4	1	0	5587
24546	2	1	5702	4	0	5709
24547	4	1	5510	0	0	5515
24548	3	9	3	4675	0	4690
24549	0	1	1	5470	0	5472
24550	0	1	5515	4	0	5520
24551	4714	1	4	3	0	4722
24552	1	1	1	5484	0	5487
24553	2	5347	2	2	0	5353
24554	5632	2	0	1	0	5635
24555	1	5391	2	5	0	5399
24556	5312	1	0	2	0	5315
24557	5	3	5483	0	0	5491
24558	3	5	5085	1	0	5094
24559	0	5199	3	1	0	5203
24560	5348	2	2	0	0	5352
24561	3	2	5274	2	0	5281
24562	4748	2	3	3	0	4756
24563	2	5100	9	2	0	5113
24564	3	3	0	5369	0	5375
24565	1	2	1	5330	0	5334
24566	1	4980	2	4	0	4987
24567	5456	2	1	2	0	5461
24568	5217	1	1	1	0	5220
24569	5106	1	0	1	0	5108
24570	6	1	5167	2	0	5176
24571	1	2	4	4978	0	4985
24572	1	0	3	4994	0	4998
24573	1	1	0	5270	0	5272
24574	3	4	5265	4	0	5276
24575	1	4933	5	7	0	4946
24576	5028	3	4	0	0	5035
24577	5	2	5157	0	0	5164
24578	4722	1	4	2	0	4729
24579	2	4862	7	3	0	4874
24580	5247	3	0	0	0	5250
24581	3	5	0	5162	0	5170
24582	5278	0	3	3	0	5284
24583	4	0	0	5178	0	5182
24584	5	1	5219	2	0	5227
24585	1	0	1	5112	0	5114
24586	0	1	5158	5	0	5164
24587	4427	3	6	7	0	4443
24588	3	4908	8	2	0	4921
24589	3	2	1	5153	0	5159
24590	1	5059	2	0	0	5062
24591	5072	0	1	1	0	5074
24592	4998	2	0	1	0	5001
24593	5	4930	4	1	0	4940
24594	5149	2	0	1	0	5152
24595	5032	1	2	1	0	5036
24596	4	2	0	4903	0	4909
24597	2	2	1	4837	0	4842
24598	5185	0	1	2	0	5188
24599	4972	0	0	2	0	4974
24600	5	3	0	4982	0	4990
24601	2	1	1	4969	0	4973
24602	5078	0	0	8	0	5086
24603	7	4	4969	2	0	4982
24604	4383	5	7	5	0	4400
24605	7	0	4961	1	0	4969
24606	2	4736	8	2	0	4748
24607	1	5	2	4945	0	4953
24608	6	3	4960	6	0	4975
24609	1	4663	11	6	0	4681
24610	2686	8	1	1	0	2696
24611	8	3	2609	1	0	2621
24612	2339	3	13	2	0	2357
24613	2632	1	0	2	0	2635
24614	2435	3	6	3	0	2447
24615	9	3	2	2559	0	2573
24616	4	2539	4	6	0	2553
24617	2641	6	4	1	0	2652
24618	10	1	265	1	0	277
24619	262	3	7	1	0	273
24620	8	1	265	2	0	276
24621	4	261	7	3	0	275
24622	1	10	1	265	0	277
24623	8	0	0	270	0	278
24624	4	258	6	7	0	275
24625	7	8	4	267	0	286
24626	8	0	268	7	0	283
24627	4	265	12	2	0	283
24628	1	11	2	268	0	282
24629	263	3	3	13	0	282
24630	272	5	6	1	0	284
24631	7	6	3	274	0	290
24632	6	276	4	8	0	294
24633	4	10	7	273	0	294
24634	7	3	2	277	0	289
24635	10	0	256	9	0	275
24636	8	265	8	3	0	284
24637	3	9	0	268	0	280
24638	4	6	256	11	0	277
24639	6	253	8	3	0	270
24640	1	11	4	261	0	277
24641	266	1	3	9	0	279
24642	9	263	7	1	0	280
24643	4	11	2	270	0	287
24644	282	1	3	12	0	298
24645	290	6	0	5	0	301
24646	283	6	0	8	0	297
24647	280	2	0	9	0	291
24648	8	4	5	272	0	289
24649	1	7	281	10	0	299
24650	5	1	7	282	0	295
24651	7	272	3	6	0	288
24652	284	9	0	3	0	296
24653	11	0	260	8	0	279
24654	260	4	6	5	0	275
24655	8	5	259	5	0	277
24656	2	1	5	263	0	271
24657	4	3	258	8	0	273
24658	5	5	7	255	0	272
24659	2	1	257	12	0	272
24660	5	2	10	256	0	273
24661	257	5	4	8	0	274
24662	5	282	4	9	0	300
24663	5	10	3	288	0	306
24664	1	7	1	291	0	300
24665	4	1	299	12	0	316
24666	5	2	300	3	0	310
24667	286	2	5	3	0	296
24668	10	281	3	3	0	297
24669	285	4	1	5	0	295
24670	294	0	3	6	0	303
24671	7	1	6	285	0	299
24672	0	291	5	10	0	306
24673	308	8	1	5	0	322
24674	320	3	1	1	0	325
24675	324	3	5	2	0	334
24676	327	2	1	1	0	331
24677	316	1	5	2	0	324
24678	6	2	312	4	0	324
24679	308	0	11	1	0	320
24680	8	0	309	6	0	323
24681	3	3	9	310	0	325
24682	5	0	3	321	0	329
24683	8	0	311	6	0	325
24684	301	5	6	3	0	315
24685	7	3	0	311	0	321
24686	3	1	0	323	0	327
24687	2	1	6	328	0	337
24688	4	0	5	325	0	334
24689	6	0	5	327	0	338
24690	4	4	318	7	0	333
24691	5	1	8	317	0	331
24692	7	1	321	7	0	336
24693	3	2	325	5	0	335
24694	320	4	5	4	0	333
24695	338	1	0	6	0	345
24696	369	3	5	3	0	380
24697	14	2	373	2	0	391
24698	8	0	384	3	0	395
24699	6	2	398	2	0	408
24700	5	404	15	3	0	427
24701	3	8	5	397	0	413
24702	415	0	0	5	0	420
24703	7	0	0	446	0	453
24704	0	448	0	8	0	456
24705	466	8	0	0	0	474
24706	8	0	0	456	0	464
24707	0	475	0	8	0	483
24708	0	9	0	474	0	483
24709	0	0	0	478	0	478
24710	465	0	0	8	0	473
24711	8	0	0	459	0	467
24712	2	0	456	8	0	466
24713	0	0	9	452	0	461
24714	0	440	1	8	0	449
24715	2	451	0	0	0	453
24716	0	8	0	439	0	447
24717	1	0	0	450	0	451
24718	0	437	0	8	0	445
24719	0	448	0	0	0	448
24720	1	449	0	0	0	450
24721	0	8	0	427	0	435
24722	1	442	0	10	0	453
24723	442	7	0	2	0	451
24724	8	0	453	2	0	463
24725	1	0	8	448	0	457
24726	0	458	0	9	0	467
24727	462	8	1	1	0	472
24728	9	0	458	0	0	467
24729	0	467	10	1	0	478
24730	464	9	4	0	0	477
24731	8	461	1	1	0	471
24732	3	477	0	1	0	481
24733	5	9	0	471	0	485
24734	1	475	0	7	0	483
24735	475	9	1	0	0	485
24736	8	0	1	473	0	482
24737	1	1	469	8	0	479
24738	1	1	474	0	0	476
24739	0	0	9	470	0	479
24740	1	0	479	9	0	489
24741	0	1	8	478	0	487
24742	472	1	0	8	0	481
24743	9	0	472	0	0	481
24744	0	1	7	450	0	458
24745	1	457	0	8	0	466
24746	0	9	0	460	0	469
24747	0	1	0	466	0	467
24748	1	461	0	9	0	471
24749	0	9	0	467	0	476
24750	1	0	0	477	0	478
24751	0	0	466	10	0	476
24752	0	470	9	0	0	479
24753	471	9	1	0	0	481
24754	8	0	0	477	0	485
24755	0	0	484	9	0	493
24756	0	1	8	476	0	485
24757	1	1	479	8	0	489
24758	467	1	9	0	0	477
24759	8	478	0	1	0	487
24760	0	10	0	481	0	491
24761	1	0	0	499	0	500
24762	464	0	1	9	0	474
24763	8	1	0	461	0	470
24764	1	1	458	11	0	471
24765	1	0	8	441	0	450
24766	0	438	2	8	0	448
24767	0	455	1	0	0	456
24768	2	453	0	0	0	455
24769	0	9	0	452	0	461
24770	4	1	427	8	0	440
24771	0	433	8	3	0	444
24772	428	10	1	0	0	439
24773	11	436	0	0	0	447
24774	436	9	0	2	0	447
24775	434	1	1	1	0	437
24776	8	0	422	2	0	432
24777	2389	0	9	2	0	2400
24778	2565	0	1	1	0	2567
24779	2538	3	2	2	0	2545
24780	2747	0	2	1	0	2750
24781	282	3	2404	1	0	2690
24782	2541	2	132	1	0	2676
24783	2520	6	97	1	0	2624
24784	247	2481	38	3	0	2769
24785	151	142	7	2350	0	2650
24786	51	110	9	2421	0	2591
24787	28	2503	2	226	0	2759
24788	2349	149	0	134	0	2632
24789	146	2597	4	41	0	2788
24790	2491	185	2	9	0	2687
24791	2465	113	11	8	0	2597
24792	275	2505	7	1	0	2788
24793	168	146	3	2477	0	2794
24794	79	124	2355	150	0	2708
24795	48	2484	143	117	0	2792
24796	30	158	117	2233	0	2538
24797	33	2396	40	137	0	2606
24798	39	4581	20	115	0	4755
24799	32	484	10	4500	0	5026
24800	38	262	4246	395	0	4941
24801	25	4286	359	244	0	4914
24802	24	4875	207	95	0	5201
24803	3876	603	83	46	0	4608
24804	355	311	35	4331	0	5032
24805	237	123	18	4690	0	5068
24806	156	72	4	5083	0	5315
24807	120	60	4257	683	0	5120
24808	116	22	374	4413	0	4925
24809	86	4474	230	479	0	5269
24810	4517	409	126	245	0	5297
24811	467	241	57	4605	0	5370
24812	294	144	4407	433	0	5278
24813	4559	111	386	290	0	5346
24814	451	79	214	4651	0	5395
24815	283	71	4503	487	0	5344
24816	141	93	4804	302	0	5340
24817	4572	77	614	118	0	5381
24818	4977	93	308	69	0	5447
24819	5118	81	133	76	0	5408
24820	5364	67	67	59	0	5557
24821	734	107	4356	92	0	5289
24822	373	4646	403	113	0	5535
24823	4496	447	269	110	0	5322
24824	448	4904	123	76	0	5551
24825	4714	532	60	104	0	5410
24826	518	4896	55	71	0	5540
24827	339	573	46	4455	0	5413
24828	243	299	59	4814	0	5415
24829	135	180	115	4730	0	5160
24830	154	4569	77	698	0	5498
24831	129	5017	89	346	0	5581
24832	132	686	71	4272	0	5161
24833	113	4786	51	536	0	5486
24834	120	560	4502	360	0	5542
24835	111	343	428	4804	0	5686
24836	107	187	4744	548	0	5586
24837	4631	145	505	384	0	5665
24838	5094	164	310	185	0	5753
24839	772	137	4612	129	0	5650
24840	444	118	4918	167	0	5647
24841	240	120	702	4665	0	5727
24842	207	95	4765	524	0	5591
24843	108	135	545	4198	0	4986
24844	104	4634	383	532	0	5653
24845	103	506	219	4714	0	5542
24846	135	362	115	4999	0	5611
24847	174	217	115	5232	0	5738
24848	176	236	4559	803	0	5774
24849	174	177	507	4730	0	5588
24850	135	195	415	4495	0	5240
24851	157	270	202	4327	0	4956
24852	173	4770	135	695	0	5773
24853	4689	569	130	425	0	5813
24854	4969	366	89	382	0	5806
24855	5168	217	123	357	0	5865
24856	760	161	146	4920	0	5987
24857	430	183	4554	654	0	5821
24858	251	178	4756	519	0	5704
24859	172	4815	677	299	0	5963
24860	4279	585	391	278	0	5533
24861	499	4851	213	331	0	5894
24862	4677	615	245	252	0	5789
24863	594	4832	234	248	0	5908
24864	4638	589	193	333	0	5753
24865	601	4784	292	202	0	5879
24866	473	541	241	4742	0	5997
24867	411	369	4534	563	0	5877
24868	376	195	4917	391	0	5879
24869	340	123	778	4436	0	5677
24870	267	170	476	4898	0	5811
24871	183	203	384	5193	0	5963
24872	226	224	4555	829	0	5834
24873	257	195	515	5081	0	6048
24874	4655	242	326	736	0	5959
24875	4743	156	184	534	0	5617
24876	752	4741	183	401	0	6077
24877	2511	325	92	241	0	3169
24878	369	2704	45	214	0	3332
24879	2653	391	59	156	0	3259
24880	2751	326	64	142	0	3283
24881	2870	223	81	120	0	3294
24882	464	161	2508	158	0	3291
24883	221	168	2707	150	0	3246
24884	2510	80	523	145	0	3258
24885	2787	67	278	179	0	3311
24886	522	66	201	2505	0	3294
24887	379	48	113	2790	0	3330
24888	257	66	115	2850	0	3288
24889	145	63	226	2888	0	3322
24890	74	74	195	3029	0	3372
24891	2525	91	128	591	0	3335
24892	352	97	154	2775	0	3378
24893	229	129	2465	462	0	3285
24894	2588	161	290	261	0	3300
24895	2714	107	169	252	0	3242
24896	434	2403	110	282	0	3229
24897	200	2805	143	283	0	3431
24898	351	3	0	1	0	355
24899	4	358	0	0	0	362
24900	344	4	0	2	0	350
24901	363	2	0	1	0	366
24902	361	1	2	0	0	364
24903	5	0	0	358	0	363
24904	2	356	1	4	0	363
24905	363	4	0	0	0	367
24906	5	0	0	362	0	367
24907	0	1	1	358	0	360
24908	345	0	1	5	0	351
24909	4	328	0	3	0	335
24910	0	4	1	321	0	326
24911	323	0	0	5	0	328
24912	4	316	0	1	0	321
24913	322	4	0	2	0	328
24914	6	0	310	2	0	318
24915	282	1	6	0	0	289
24916	6	286	0	1	0	293
24917	262	3	5	0	0	270
24918	264	0	0	0	0	264
24919	4	266	0	0	0	270
24920	258	4	0	0	0	262
24921	4	248	0	0	0	252
24922	263	5	0	0	0	268
24923	4	1	0	260	0	265
24924	1	1	0	264	0	266
24925	2	0	0	267	0	269
24926	1	0	260	4	0	265
24927	0	0	2	264	0	266
24928	0	0	263	4	0	267
24929	1	0	4	256	0	261
24930	2	738	5	4	0	749
24931	0	3	1	819	0	823
24932	1	1	806	4	0	812
24933	0	4	776	2	0	782
24934	0	0	3	812	0	815
24935	814	0	1	3	0	818
24936	813	1	0	0	0	814
24937	4	782	0	1	0	787
24938	1	4	1	822	0	828
24939	1	0	826	3	0	830
24940	0	1	3	797	0	801
24941	1	0	820	4	0	825
24942	784	0	3	0	0	787
24943	3	1	1	840	0	845
24944	3	0	805	3	0	811
24945	1	2	3	805	0	811
24946	2	0	0	828	0	830
24947	1	0	817	4	0	822
24948	0	1	3	803	0	807
24949	841	0	0	5	0	846
24950	838	1	1	0	0	840
24951	4	0	0	833	0	837
24952	849	0	2	4	0	855
24953	4	0	821	2	0	827
24954	1	3	791	1	0	796
24955	806	0	4	1	0	811
24956	854	0	2	1	0	857
24957	3	0	3	841	0	847
24958	1	0	0	841	0	842
24959	2	1	818	3	0	824
24960	1	0	2	820	0	823
24961	0	815	3	4	0	822
24962	855	3	2	1	0	861
24963	843	0	1	2	0	846
24964	3	826	0	1	0	830
24965	847	3	1	0	0	851
24966	839	1	1	0	0	841
24967	3	822	1	3	0	829
24968	868	3	2	0	0	873
24969	4	840	0	3	0	847
24970	862	3	1	1	0	867
24971	5	2	835	0	0	842
24972	0	1	3	849	0	853
24973	2	0	1	843	0	846
24974	1	0	1	885	0	887
24975	879	0	0	6	0	885
24976	5	0	1	895	0	901
24977	0	1	871	7	0	879
24978	870	0	5	1	0	876
24979	6	0	1	915	0	922
24980	2	868	3	6	0	879
24981	2	895	1	2	0	900
24982	0	6	1	918	0	925
24983	0	2	2	871	0	875
24984	1	1	0	900	0	902
24985	1	2	880	7	0	890
24986	1	856	5	3	0	865
24987	887	4	1	1	0	893
24988	875	1	1	0	0	877
24989	6	863	0	3	0	872
24990	2	867	0	0	0	869
24991	1	7	0	884	0	892
24992	2	2	844	5	0	853
24993	842	2	4	1	0	849
24994	886	0	1	0	0	887
24995	6	0	0	878	0	884
24996	1	1	0	880	0	882
24997	869	0	0	4	0	873
24998	5	3	856	1	0	865
24999	820	0	6	1	0	827
25000	6	824	2	1	0	833
25001	1	5	0	858	0	864
25002	0	821	2	6	0	829
25003	852	4	1	3	0	860
25004	5	1	0	832	0	838
25005	1	0	0	838	0	839
25006	1	801	3	5	0	810
25007	851	4	1	0	0	856
25008	834	1	0	2	0	837
25009	5	1	786	1	0	793
25010	3	3	722	0	0	728
25011	792	0	5	1	0	798
25012	4	2	778	1	0	785
25013	1	3	708	1	0	713
25014	764	1	4	0	0	769
25015	3	3	784	0	0	790
25016	1	0	4	783	0	788
25017	0	0	0	811	0	811
25018	857	0	0	6	0	863
25019	6	1	1327	1	0	1335
25020	1361	0	32	0	0	1393
25021	30	0	10	1363	0	1403
25022	1386	0	2	31	0	1419
25023	1406	0	0	11	0	1417
25024	1419	0	7	4	0	1430
25025	53	0	3	1377	0	1433
25026	1385	0	11	40	0	1436
25027	56	1	2	1376	0	1435
25028	24	0	2	1410	0	1436
25029	27	0	1	1406	0	1434
25030	18	0	0	967	0	985
25031	932	0	1	51	0	984
25032	962	0	0	36	0	998
25033	56	0	905	15	0	976
25034	939	0	33	24	0	996
25035	963	0	12	22	0	997
25036	53	1	3	919	0	976
25037	25	911	0	49	0	985
25038	943	31	7	15	0	996
25039	52	12	2	925	0	991
25040	917	4	13	36	0	970
25041	54	910	1	22	0	987
25042	941	36	3	7	0	987
25043	48	16	2	898	0	964
25044	19	919	1	41	0	980
25045	932	33	1	16	0	982
25046	38	908	1	17	0	964
25047	34	948	2	2	0	986
25048	950	53	0	12	0	1015
25049	50	18	938	4	0	1010
25050	963	9	31	13	0	1016
25051	42	19	12	945	0	1018
25052	30	11	927	38	0	1006
25053	15	15	35	943	0	1008
25054	10	15	19	967	0	1011
25055	22	4	936	49	0	1011
25056	945	3	47	24	0	1019
25057	50	2	19	948	0	1019
25058	27	2	8	987	0	1024
25059	14	2	15	988	0	1019
25060	954	1	12	66	0	1033
25061	46	1	925	36	0	1008
25062	25	2	967	16	0	1010
25063	21	0	43	946	0	1010
25064	4	4	908	66	0	982
25065	925	1	35	35	0	996
25066	39	914	18	31	0	1002
25067	930	36	15	9	0	990
25068	51	12	16	879	0	958
25069	25	895	23	41	0	984
25070	20	37	14	892	0	963
25071	22	909	15	36	0	982
25072	30	41	4	927	0	1002
25073	17	29	885	50	0	981
25074	32	16	891	22	0	961
25075	17	889	44	29	0	979
25076	884	50	15	17	0	966
25077	48	20	8	850	0	926
25078	25	20	10	893	0	948
25079	852	7	11	68	0	938
25080	887	16	16	30	0	949
25081	57	9	13	868	0	947
25082	30	19	824	44	0	917
25083	36	841	34	23	0	934
25084	20	38	19	817	0	894
25085	27	13	15	798	0	853
25086	34	834	6	45	0	919
25087	871	34	11	28	0	944
25088	44	24	840	27	0	935
25089	26	15	44	838	0	923
25090	13	17	12	886	0	928
25091	14	12	829	63	0	918
25092	19	16	37	862	0	934
25093	848	18	19	48	0	933
25094	864	3	11	35	0	913
25095	856	17	16	26	0	915
25096	60	831	12	22	0	925
25097	846	37	14	27	0	924
25098	44	23	22	830	0	919
25099	37	9	5	823	0	874
25100	27	833	19	47	0	926
25101	894	38	7	23	0	962
25102	931	18	4	21	0	974
25103	927	18	12	14	0	971
25104	948	8	6	25	0	987
25105	953	15	3	30	0	1001
25106	57	9	883	23	0	972
25107	930	19	35	12	0	996
25108	956	2	16	23	0	997
25109	962	7	14	14	0	997
25110	74	2	11	920	0	1007
25111	41	6	15	935	0	997
25112	34	4	873	50	0	961
25113	808	5	52	27	0	892
25114	54	872	16	19	0	961
25115	31	838	14	21	0	904
25116	32	38	822	16	0	908
25117	13	827	35	27	0	902
25118	23	847	26	18	0	914
25119	3	20	8	262	0	293
25120	1	263	0	0	0	264
25121	257	0	0	2	0	259
25122	248	2	1	0	0	251
25123	3	0	1	245	0	249
25124	2	1	242	0	0	245
25125	241	0	0	1	0	242
25126	2	0	247	1	0	250
25127	3	0	246	1	0	250
25128	1	0	2	234	0	237
25129	2	0	1	244	0	247
25130	3	0	238	2	0	243
25131	1	230	1	1	0	233
25132	0	235	1	1	0	237
25133	238	1	0	1	0	240
25134	235	1	1	3	0	240
25135	2	1	229	0	0	232
25136	231	1	0	0	0	232
25137	234	1	1	0	0	236
25138	1	1	1	227	0	230
25139	1	1	0	235	0	237
25140	0	1	0	235	0	236
25141	235	0	0	2	0	237
25142	232	1	0	1	0	234
25143	236	0	1	0	0	237
25144	2	0	0	237	0	239
25145	1	0	226	1	0	228
25146	224	0	1	1	0	226
25147	209	0	1	0	0	210
25148	1	0	1	202	0	204
25149	1	209	1	0	0	211
25150	0	0	0	208	0	208
25151	0	209	0	1	0	210
25152	0	2	1	203	0	206
25153	0	213	0	0	0	213
25154	206	1	0	1	0	208
25155	1	1	0	204	0	206
25156	2	197	0	0	0	199
25157	0	0	196	1	0	197
25158	200	1	0	0	0	201
25159	1	0	1	201	0	203
25160	1	202	0	1	0	204
25161	0	0	0	199	0	199
25162	0	196	0	1	0	197
25163	1	198	0	1	0	200
25164	203	0	0	1	0	204
25165	212	1	0	0	0	213
25166	1	0	215	1	0	217
25167	217	0	1	0	0	218
25168	216	0	1	0	0	217
25169	2	209	0	0	0	211
25170	1	0	0	216	0	217
25171	0	1	0	213	0	214
25172	1	0	208	2	0	211
25173	0	1	206	1	0	208
25174	211	0	1	0	0	212
25175	211	0	1	0	0	212
25176	215	0	0	0	0	215
25177	1	0	208	1	0	210
25178	1	1	0	209	0	211
25179	213	0	2	0	0	215
25180	1	0	0	209	0	210
25181	1	0	212	1	0	214
25182	211	1	0	1	0	213
25183	2	0	221	0	0	223
25184	1	221	0	1	0	223
25185	227	1	1	0	0	229
25186	1	1	225	0	0	227
25187	2	0	0	218	0	220
25188	221	0	2	0	0	223
25189	1	0	0	223	0	224
25190	224	0	0	0	0	224
25191	0	1	0	224	0	225
25192	230	0	0	1	0	231
25193	229	0	0	2	0	231
25194	229	0	1	0	0	230
25195	222	0	1	0	0	223
25196	2	3	0	215	0	220
25197	2	0	213	0	0	215
25198	2	1	212	1	0	216
25199	2	211	2	0	0	215
25200	0	181	1	0	0	182
25201	144	0	5	0	0	149
25202	0	0	0	138	0	138
25203	0	0	143	1	0	144
25204	0	0	150	0	0	150
25205	0	0	0	150	0	150
25206	151	0	0	0	0	151
25207	0	149	0	0	0	149
25208	159	0	0	0	0	159
25209	0	0	0	162	0	162
25210	0	0	0	160	0	160
25211	0	0	0	159	0	159
25212	0	0	160	0	0	160
25213	0	0	159	0	0	159
25214	0	158	0	1	0	159
25215	0	0	0	164	0	164
25216	161	0	0	0	0	161
25217	0	0	156	0	0	156
25218	0	0	162	0	0	162
25219	0	0	0	166	0	166
25220	0	0	0	165	0	165
25221	0	0	0	167	0	167
25222	0	0	0	177	0	177
25223	183	0	0	0	0	183
25224	0	0	0	189	0	189
25225	195	0	0	1	0	196
25226	0	0	206	0	0	206
25227	0	198	0	1	0	199
25228	1	0	0	205	0	206
25229	0	0	205	0	0	205
25230	2	1	202	0	0	205
25231	0	207	0	2	0	209
25232	0	0	1	204	0	205
25233	0	0	1	203	0	204
25234	0	1	205	0	0	206
25235	204	0	0	1	0	205
25236	0	0	0	207	0	207
25237	0	0	1	205	0	206
25238	1	0	222	0	0	223
25239	0	218	0	1	0	219
25240	0	234	0	1	0	235
25241	246	0	1	0	0	247
25242	0	1	0	250	0	251
25243	273	1	0	0	0	274
25244	1	0	269	0	0	270
25245	0	0	0	276	0	276
25246	275	0	0	0	0	275
25247	275	0	2	0	0	277
25248	0	0	0	277	0	277
25249	1	0	278	0	0	279
25250	2	1	277	0	0	280
25251	0	0	0	281	0	281
25252	0	0	282	0	0	282
25253	264	3	1	0	0	268
25254	0	269	0	2	0	271
25255	271	0	2	0	0	273
25256	279	0	0	0	0	279
25257	0	2	0	279	0	281
25258	1	0	0	276	0	277
25259	278	0	0	0	0	278
25260	0	0	0	277	0	277
25261	0	0	272	2	0	274
25262	1	274	0	0	0	275
25263	0	0	0	280	0	280
25264	0	0	2	275	0	277
25265	0	2	0	274	0	276
25266	0	0	264	2	0	266
25267	1	262	0	2	0	265
25268	0	0	1	270	0	271
25269	2	0	264	3	0	269
25270	1	2	1	264	0	268
25271	265	1	0	2	0	268
25272	0	1	2	268	0	271
25273	1	0	261	2	0	264
25274	265	0	0	2	0	267
25275	2	262	0	3	0	267
25276	0	273	5	0	0	278
25277	279	1	0	1	0	281
25278	1	3	284	1	0	289
25279	2	2	1	283	0	288
25280	3	0	1	285	0	289
25281	1	1	285	1	0	288
25282	0	281	1	3	0	285
25283	1	0	0	275	0	276
25284	0	0	282	1	0	283
25285	2	2	1	276	0	281
25286	280	2	0	3	0	285
25287	1	0	285	2	0	288
25288	1	0	1	290	0	292
25289	2	0	0	290	0	292
25290	0	1	290	1	0	292
25291	2	1	0	279	0	282
25292	0	283	1	5	0	289
25293	1	0	3	270	0	274
25294	0	288	1	1	0	290
25295	289	2	2	2	0	295
25296	284	0	0	4	0	288
25297	3	3	285	1	0	292
25298	2	1	286	1	0	290
25299	1	1	272	0	0	274
25300	0	282	3	1	0	286
25301	2	0	3	288	0	293
25302	0	0	296	1	0	297
25303	2	2	0	293	0	297
25304	0	1	0	278	0	279
25305	1	0	276	0	0	277
25306	2	1	0	274	0	277
25307	0	1	0	275	0	276
25308	0	265	3	1	0	269
25309	2	0	0	269	0	271
25310	1	0	1	274	0	276
25311	0	2	272	1	0	275
25312	0	1	0	272	0	273
25313	0	0	271	4	0	275
25314	0	1	268	1	0	270
25315	268	0	0	5	0	273
25316	0	1	4	268	0	273
25317	0	274	2	2	0	278
25318	3	277	0	1	0	281
25319	1	0	2	284	0	287
25320	1	1	281	2	0	285
25321	1	283	1	2	0	287
25322	0	1	2	282	0	285
25323	0	0	279	2	0	281
25324	0	283	1	0	0	284
25325	283	1	0	2	0	286
25326	277	1	2	0	0	280
25327	284	1	0	1	0	286
25328	2	0	0	311	0	313
25329	1	0	2	315	0	318
25330	1	0	1	316	0	318
25331	0	0	313	2	0	315
25332	326	1	1	1	0	329
25333	1	0	0	326	0	327
25334	0	0	330	1	0	331
25335	332	0	1	0	0	333
25336	332	0	0	2	0	334
25337	1	0	315	0	0	316
25338	327	0	1	0	0	328
25339	2	327	0	0	0	329
25340	0	0	318	1	0	319
25341	308	0	1	0	0	309
25342	5	307	1	0	0	313
25343	0	1	0	282	0	283
25344	0	284	0	1	0	285
25345	0	1	0	289	0	290
25346	0	0	285	1	0	286
25347	277	0	1	0	0	278
25348	1	0	284	0	0	285
25349	4	275	2	0	0	281
25350	0	282	0	0	0	282
25351	284	1	3	0	0	288
25352	1	1	291	0	0	293
25353	0	0	1	294	0	295
25354	0	0	292	1	0	293
25355	0	289	1	0	0	290
25356	0	1	0	271	0	272
25357	0	296	0	0	0	296
25358	303	1	0	0	0	304
25359	309	0	0	0	0	309
25360	310	0	0	0	0	310
25361	1	0	309	0	0	310
25362	0	0	309	0	0	309
25363	313	0	1	0	0	314
25364	1	0	322	0	0	323
25365	0	0	1	303	0	304
25366	0	308	0	1	0	309
25367	321	1	0	0	0	322
25368	321	0	0	0	0	321
25369	339	0	0	0	0	339
25370	1	0	0	340	0	341
25371	0	0	0	336	0	336
25372	341	0	0	1	0	342
25373	1	337	0	0	0	338
25374	343	1	0	0	0	344
25375	1	0	0	334	0	335
25376	0	0	0	332	0	332
25377	330	0	0	1	0	331
25378	1	316	0	0	0	317
25379	329	1	0	0	0	330
25380	1	346	0	0	0	347
25381	350	1	0	0	0	351
25382	1	0	0	404	0	405
25383	409	0	0	1	0	410
25384	411	0	0	0	0	411
25385	458	0	0	0	0	458
25386	1	480	0	0	0	481
25387	0	1	467	0	0	468
25388	467	0	1	0	0	468
25389	477	0	0	0	0	477
25390	1	477	0	0	0	478
25391	1	2	0	486	0	489
25392	1	1	1	475	0	478
25393	478	0	1	1	0	480
25394	3	0	0	479	0	482
25395	1	1	485	1	0	488
25396	0	0	487	1	0	488
25397	501	0	1	3	0	505
25398	2	0	0	506	0	508
25399	1	0	0	506	0	507
25400	1	0	1	508	0	510
25401	0	0	511	2	0	513
25402	1	0	3	515	0	519
25403	3	1	0	533	0	537
25404	1	0	0	542	0	543
25405	541	0	0	3	0	544
25406	2	0	1	542	0	545
25407	0	1	546	2	0	549
25408	544	0	2	2	0	548
25409	3	1	557	1	0	562
25410	585	0	2	1	0	588
25411	546	0	1	2	0	549
25412	2	1	1	605	0	609
25413	2	609	1	3	0	615
25414	2	2	2	612	0	618
25415	3	0	1	604	0	608
25416	2	633	1	4	0	640
25417	636	3	0	3	0	642
25418	2	627	0	3	0	632
25419	631	3	1	1	0	636
25420	632	0	1	3	0	636
25421	3	2	0	632	0	637
25422	2	1	0	626	0	629
25423	3	2	613	2	0	620
25424	1	3	591	2	0	597
25425	596	1	2	2	0	601
25426	596	0	2	1	0	599
25427	2	588	2	2	0	594
25428	3	1	2	567	0	573
25429	3	1	585	1	0	590
25430	2	6	3	565	0	576
25431	561	5	1	3	0	570
25432	540	2	1	1	0	544
25433	2	537	0	4	0	543
25434	2	2	1	539	0	544
25435	2	1	2	541	0	546
25436	2	1	0	538	0	541
25437	6	1	511	2	0	520
25438	488	2	1	1	0	492
25439	507	1	0	4	0	512
25440	6	4	3652	5	0	3667
25441	2	3642	2	4	0	3650
25442	3887	1	3	2	0	3893
25443	3754	1	3	0	0	3758
25444	7	1	3764	0	0	3772
25445	6	1	3637	0	0	3644
25446	1	3	4	3439	0	3447
25447	2	3	3797	4	0	3806
25448	3506	1	5	3	0	3515
25449	3710	0	3	3	0	3716
25450	3749	1	4	1	0	3755
25451	4	1	1	3695	0	3701
25452	1	3753	2	4	0	3760
25453	3902	1	1	3	0	3907
25454	3748	1	6	4	0	3759
25455	5	1	3807	7	0	3820
25456	8	4	3428	2	0	3442
25457	3100	7	5	3	0	3115
25458	4	1	3	3704	0	3712
25459	4	2	3865	2	0	3873
25460	4	3682	5	4	0	3695
25461	4	8	2	3828	0	3842
25462	3897	1	4	3	0	3905
25463	5	3780	2	3	0	3790
25464	1	1	2	3817	0	3821
25465	3	3741	6	4	0	3754
25466	1	3806	2	3	0	3812
25467	5	2	1	3802	0	3810
25468	4	2	1	3698	0	3705
25469	2	3668	1	5	0	3676
25470	3706	2	1	5	0	3714
25471	2	2	3836	2	0	3842
25472	3005	6	6	3	0	3020
25473	6	1	2	3643	0	3652
25474	2	1	4	3659	0	3666
25475	5	3	0	3698	0	3706
25476	7	0	1	3621	0	3629
25477	4	2	3769	3	0	3778
25478	2	0	3	3440	0	3445
25479	2	2	2	3649	0	3655
25480	1	3643	2	9	0	3655
25481	2	3	3661	4	0	3670
25482	3	3580	2	5	0	3590
25483	3	4	3582	4	0	3593
25484	2	3613	4	4	0	3623
25485	7	12	0	3685	0	3704
25486	3520	1	4	6	0	3531
25487	6	3619	0	3	0	3628
25488	2	6	1	3626	0	3635
25489	6	7	6931	8	0	6952
25490	1	6808	9	4	0	6822
25491	7022	4	1	2	0	7029
25492	6738	1	3	3	0	6745
25493	4	6739	3	6	0	6752
25494	4	9	6853	4	0	6870
25495	5987	1	7	4	0	5999
25496	4	3	2	6910	0	6919
25497	7096	0	2	4	0	7102
25498	7	6778	4	10	0	6799
25499	0	6675	6	5	0	6686
25500	7	9	6797	4	0	6817
25501	5862	9	6	4	0	5881
25502	4	5	0	6747	0	6756
25503	7039	2	5	5	0	7051
25504	12	6752	4	4	0	6772
25505	6931	5	3	5	0	6944
25506	6660	0	3	0	0	6663
25507	7	5	6846	2	0	6860
25508	4	6579	5	4	0	6592
25509	4	6819	6	2	0	6831
25510	2	6	3	6934	0	6945
25511	2	6701	1	7	0	6711
25512	6864	4	0	1	0	6869
25513	4	6807	0	4	0	6815
25514	3	8	0	6859	0	6870
25515	1	6791	2	6	0	6800
25516	2	6778	2	2	0	6784
25517	3	6856	2	3	0	6864
25518	5	8	0	6798	0	6811
25519	2	3	0	6749	0	6754
25520	2	1	0	6618	0	6621
25521	2	6593	3	9	0	6607
25522	5	14	6421	1	0	6441
25523	3	6	6263	8	0	6280
25524	5998	5	8	4	0	6015
25525	5	3	1	6327	0	6336
25526	4	4	6477	15	0	6500
25527	4	5	6181	1	0	6191
25528	2	6210	11	2	0	6225
25529	2	9	8	6329	0	6348
25530	0	3	1	6480	0	6484
25531	6578	4	0	6	0	6588
25532	6	4	0	6288	0	6298
25533	0	2	0	6503	0	6505
25534	4	3	6486	8	0	6501
25535	0	3	5	6043	0	6051
25536	1	5	1	8254	0	8261
25537	5	5	8446	9	0	8465
25538	4	2	8192	2	0	8200
25539	1	7826	15	9	0	7851
25540	5	8	5595	7	0	5615
25541	2	3	8	5359	0	5372
25542	9	44	40	4248	0	4341
25543	7	2	5646	6	0	5661
25544	1	5216	13	6	0	5236
25545	5678	7	0	5	0	5690
25546	6	5451	5	1	0	5463
25547	1	9	1	5672	0	5683
25548	1	4	1	5633	0	5639
25549	2	5494	3	14	0	5513
25550	1	7	1	5704	0	5713
25551	1	0	1	5618	0	5620
25552	6	4	5591	14	0	5615
25553	1	5223	11	10	0	5245
25554	0	10	5	5657	0	5672
25555	4	3	5585	8	0	5600
25556	1	4	7	5365	0	5377
25557	2	5	2	5302	0	5311
25558	0	0	4	5592	0	5596
25559	0	4	3	5505	0	5512
25560	1	4	3	5447	0	5455
25561	1	5411	4	12	0	5428
25562	5352	7	6	4	0	5369
25563	9	3	5438	4	0	5454
25564	3952	6	34	18	0	4010
25565	12	1	5412	3	0	5428
25566	1	5028	19	9	0	5057
25567	10	7	5218	4	0	5239
25568	1	5010	21	8	0	5040
25569	0	17	6	5057	0	5080
25570	0	13	4	5276	0	5293
25571	1	5178	7	14	0	5200
25572	0	5265	10	8	0	5283
25573	5381	8	0	5	0	5394
25574	5209	6	1	6	0	5222
25575	5177	4	3	4	0	5188
25576	5233	2	2	4	0	5241
25577	12	4	0	5278	0	5294
25578	3	5149	7	9	0	5168
25579	5374	7	2	3	0	5386
25580	7	5	3	5273	0	5288
25581	5241	9	3	7	0	5260
25582	4948	0	5	4	0	4957
25583	10	5076	11	3	0	5100
25584	2	5151	3	2	0	5158
25585	24	5167	4	5	0	5200
25586	1	17	2	5213	0	5233
25587	0	5052	7	6	0	5065
25588	5195	6	1	4	0	5206
25589	2305	2	0	5	0	2312
25590	2304	0	1	3	0	2308
25591	2332	1	0	3	0	2336
25592	2335	3	2	0	0	2340
25593	11	4	2257	0	0	2272
25594	2275	0	9	2	0	2286
25595	9	3	2331	1	0	2344
25596	2237	1	10	0	0	2248
25597	10	1	4	2264	0	2279
25598	5	3	2347	6	0	2361
25599	4	5	2270	2	0	2281
25600	2	2200	16	3	0	2221
25601	2316	10	2	3	0	2331
25602	2263	4	0	0	0	2267
25603	12	4136	10	9	0	4167
25604	7	112	0	4303	0	4422
25605	7093	42	1	105	0	7241
25606	185	45	6660	46	0	6936
25607	60	7019	166	30	0	7275
25608	6889	183	56	27	0	7155
25609	190	7084	46	22	0	7342
25610	109	229	26	6585	0	6949
25611	89	7124	51	151	0	7415
25612	73	254	43	6683	0	7053
25613	58	6872	44	214	0	7188
25614	69	7328	15	82	0	7494
25615	6936	324	27	82	0	7369
25616	7147	207	11	70	0	7435
25617	273	133	6956	82	0	7444
25618	135	142	6946	50	0	7273
25619	103	116	7069	60	0	7348
25620	101	135	297	6950	0	7483
25621	133	84	7021	220	0	7458
25622	103	86	297	6864	0	7350
25623	69	95	176	6974	0	7314
25624	61	6881	171	287	0	7400
25625	6939	252	119	177	0	7487
25626	205	6942	129	160	0	7436
25627	102	287	99	7193	0	7681
25628	95	150	91	7300	0	7636
25629	94	145	47	7428	0	7714
25630	101	131	6901	348	0	7481
25631	102	123	234	7097	0	7556
25632	80	91	135	7222	0	7528
25633	50	130	119	7408	0	7707
25634	70	71	6665	474	0	7280
25635	28	6912	264	286	0	7490
25636	5410	237	132	283	0	6062
25637	5069	142	110	223	0	5544
25638	265	5440	83	242	0	6030
25639	148	276	118	5468	0	6010
25640	117	187	98	5749	0	6151
25641	142	157	5240	379	0	5918
25642	132	5416	239	246	0	6033
25643	123	283	158	5597	0	6161
25644	92	183	5408	404	0	6087
25645	75	129	279	5660	0	6143
25646	57	121	177	5842	0	6197
25647	56	149	5410	442	0	6057
25648	60	137	283	5654	0	6134
25649	72	119	171	5815	0	6177
25650	80	130	5437	454	0	6101
25651	101	108	285	5680	0	6174
25652	74	112	177	5779	0	6142
25653	66	83	173	5927	0	6249
25654	48	97	5304	553	0	6002
25655	31	75	315	5877	0	6298
25656	5429	85	219	494	0	6227
25657	5452	77	161	384	0	6074
25658	298	5428	142	344	0	6212
25659	5653	249	144	296	0	6342
25660	302	129	5456	295	0	6182
25661	181	106	294	5742	0	6323
25662	171	93	180	5513	0	5957
25663	147	117	165	5959	0	6388
25664	5491	102	113	505	0	6211
25665	296	5528	143	355	0	6322
25666	141	253	134	5390	0	5918
25667	85	5641	127	498	0	6351
25668	5520	279	107	372	0	6278
25669	276	5634	128	324	0	6362
25670	5505	332	99	266	0	6202
25671	330	5447	81	258	0	6116
25672	189	5726	89	249	0	6253
25673	202	373	104	5647	0	6326
25674	135	260	86	5862	0	6343
25675	152	181	85	5911	0	6329
25676	116	191	98	5987	0	6392
25677	135	170	5250	530	0	6085
25678	106	5588	251	358	0	6303
25679	111	319	111	5334	0	5875
25680	101	5547	115	460	0	6223
25681	89	352	5315	362	0	6118
25682	85	180	297	5690	0	6252
25683	100	176	165	5905	0	6346
25684	106	167	5319	463	0	6055
25685	112	5601	269	346	0	6328
25686	71	337	202	5526	0	6136
25687	55	209	5396	475	0	6135
25688	50	5527	303	402	0	6282
25689	51	316	186	5772	0	6325
25690	74	181	5387	462	0	6104
25691	73	219	5386	328	0	6006
25692	99	5299	322	303	0	6023
25693	57	5717	232	228	0	6234
25694	68	398	163	5420	0	6049
25695	46	234	157	5949	0	6386
25696	69	163	5438	467	0	6137
25697	5541	174	331	326	0	6372
25698	5669	172	175	309	0	6325
25699	283	182	5264	255	0	5984
25700	140	5382	294	268	0	6084
25701	120	5667	185	267	0	6239
25702	125	5803	172	241	0	6341
25703	111	3688	115	178	0	4092
25704	126	218	110	3747	0	4201
25705	1	2	2	938	0	943
25706	1	3	1	965	0	970
25707	0	2	2	987	0	991
25708	1	3416	0	23	0	3440
25709	1	43	2	3390	0	3436
25710	1	3346	5	44	0	3396
25711	2	44	2	3611	0	3659
25712	3514	13	2	51	0	3580
25713	46	12	2	3452	0	3512
25714	11	3401	2	51	0	3465
25715	4	97	0	3570	0	3671
25716	6	61	5	3680	0	3752
25717	4	74	0	3730	0	3808
25718	3513	45	0	135	0	3693
25719	94	32	1	3681	0	3808
25720	41	55	3264	137	0	3497
25721	27	3533	42	91	0	3693
25722	15	130	11	3701	0	3857
25723	12	118	5	3754	0	3889
25724	38	87	3	3886	0	4014
25725	3661	80	7	240	0	3988
25726	124	68	3416	224	0	3832
25727	102	94	88	3425	0	3709
25728	42	3654	38	241	0	3975
25729	22	223	26	3830	0	4101
25730	3307	136	17	417	0	3877
25731	127	3636	9	384	0	4156
25732	163	103	31	3809	0	4106
25733	158	78	79	3770	0	4085
25734	82	3522	72	348	0	4024
25735	41	210	81	3783	0	4115
25736	48	150	38	3971	0	4207
25737	102	115	3265	435	0	3917
25738	104	3555	59	392	0	4110
25739	3667	131	70	355	0	4223
25740	171	162	3520	300	0	4153
25741	3567	184	170	320	0	4241
25742	99	181	3471	388	0	4139
25743	88	179	93	3931	0	4291
25744	3556	119	87	425	0	4187
25745	214	153	76	3823	0	4266
25746	3640	181	107	328	0	4256
25747	3621	152	133	341	0	4247
25748	3533	151	97	365	0	4146
25749	174	3633	98	357	0	4262
25750	160	180	84	3820	0	4244
25751	176	174	95	3857	0	4302
25752	148	178	115	3906	0	4347
25753	228	194	3389	340	0	4151
25754	242	141	128	3861	0	4372
25755	3651	159	130	360	0	4300
25756	3721	143	137	354	0	4355
25757	214	101	3557	410	0	4282
25758	3643	117	188	381	0	4329
25759	3703	125	142	331	0	4301
25760	321	93	132	3735	0	4281
25761	3653	96	165	299	0	4213
25762	3743	117	128	238	0	4226
25763	372	120	119	3658	0	4269
25764	3571	134	111	397	0	4213
25765	3632	71	78	426	0	4207
25766	361	74	79	3755	0	4269
25767	311	78	3125	396	0	3910
25768	3642	82	158	334	0	4216
25769	381	134	3364	289	0	4168
25770	329	134	3263	303	0	4029
25771	392	3335	152	290	0	4169
25772	330	132	185	3456	0	4103
25773	305	54	162	3654	0	4175
25774	346	50	160	3691	0	4247
25775	336	72	3404	380	0	4192
25776	391	52	3354	297	0	4094
25777	404	3353	212	257	0	4226
25778	360	131	184	3068	0	3743
25779	406	108	110	3389	0	4013
25780	409	70	92	3626	0	4197
25781	298	72	3351	417	0	4138
25782	307	3271	259	313	0	4150
25783	304	99	254	3415	0	4072
25784	234	113	3492	363	0	4202
25785	267	90	3481	310	0	4148
25786	3513	102	194	388	0	4197
25787	3347	61	153	411	0	3972
25788	3556	62	227	307	0	4152
25789	292	111	281	2739	0	3423
25790	186	150	3406	243	0	3985
25791	160	3209	319	287	0	3975
25792	163	3465	200	348	0	4176
25793	193	141	3254	436	0	4024
25794	245	79	227	3339	0	3890
25795	208	73	220	3062	0	3563
25796	204	2856	245	318	0	3623
25797	198	3213	266	229	0	3906
25798	3134	224	235	297	0	3890
25799	3163	143	267	264	0	3837
25800	3312	105	288	220	0	3925
25801	3212	109	200	283	0	3804
25802	3048	131	207	252	0	3638
25803	256	3008	181	233	0	3678
25804	152	2922	185	311	0	3570
25805	233	2986	225	220	0	3664
25806	3031	207	228	154	0	3620
25807	372	178	214	3005	0	3769
25808	5	0	0	165	0	170
25809	165	0	0	6	0	171
25810	2	700	0	6	0	708
25811	1	2	2	732	0	737
25812	0	4	0	733	0	737
25813	0	0	1	740	0	741
25814	728	0	2	5	0	735
25815	2	1	1	732	0	736
25816	4	0	719	3	0	726
25817	692	0	3	4	0	699
25818	3	0	5	719	0	727
25819	4	0	724	3	0	731
25820	0	700	6	3	0	709
25821	0	686	3	0	0	689
25822	693	3	3	1	0	700
25823	672	1	1	0	0	674
25824	3	651	0	2	0	656
25825	1	2	0	688	0	691
25826	694	2	0	2	0	698
25827	2	1	0	708	0	711
25828	2	0	0	707	0	709
25829	1	0	0	699	0	700
25830	1	0	0	708	0	709
25831	1	693	0	4	0	698
25832	1	3	0	711	0	715
25833	0	2	0	709	0	711
25834	0	1	0	711	0	712
25835	0	1	698	4	0	703
25836	1	685	1	2	0	689
25837	0	2	1	714	0	717
25838	0	3	702	4	0	709
25839	1	2	669	2	0	674
25840	0	690	3	3	0	696
25841	701	2	0	2	0	705
25842	2	1	0	707	0	710
25843	712	0	0	4	0	716
25844	3	701	0	2	0	706
25845	0	2	0	719	0	721
25846	710	0	1	2	0	713
25847	710	1	0	0	0	711
25848	2	0	0	711	0	713
25849	0	1	2	711	0	714
25850	1	0	709	2	0	712
25851	0	2	2	696	0	700
25852	2	0	0	716	0	718
25853	716	0	0	3	0	719
25854	3	699	0	0	0	702
25855	0	3	708	1	0	712
25856	691	0	2	1	0	694
25857	3	687	0	2	0	692
25858	1	2	0	709	0	712
25859	712	0	0	3	0	715
25860	2	0	0	703	0	705
25861	0	0	0	708	0	708
25862	0	0	697	3	0	700
25863	0	0	2	700	0	702
25864	702	0	0	3	0	705
25865	2	1	0	701	0	704
25866	702	0	1	2	0	705
25867	3	686	0	0	0	689
25868	0	692	0	0	0	692
25869	0	2	0	709	0	711
25870	1	0	0	709	0	710
25871	708	0	0	3	0	711
25872	2	679	0	1	0	682
25873	708	2	1	0	0	711
25874	708	0	0	1	0	709
25875	2	0	0	701	0	703
25876	700	0	0	3	0	703
25877	3	0	678	0	0	681
25878	0	0	2	694	0	696
25879	0	1	685	2	0	688
25880	0	0	2	693	0	695
25881	687	0	1	4	0	692
25882	695	0	0	1	0	696
25883	3	686	0	0	0	689
25884	1	3	0	690	0	694
25885	1	0	0	698	0	699
25886	0	659	0	4	0	663
25887	1	3	0	696	0	700
25888	0	0	1	702	0	703
25889	0	672	0	3	0	675
25890	684	3	1	0	0	688
25891	682	0	0	1	0	683
25892	4	0	0	677	0	681
25893	1	0	0	678	0	679
25894	0	1	666	3	0	670
25895	0	0	2	672	0	674
25896	0	645	0	4	0	649
25897	660	4	0	0	0	664
25898	3	0	0	681	0	684
25899	0	0	0	675	0	675
25900	667	1	0	3	0	671
25901	4	664	0	1	0	669
25902	1	3	0	679	0	683
25903	0	0	0	682	0	682
25904	0	664	0	3	0	667
25905	672	3	1	1	0	677
25906	3	2	668	1	0	674
25907	0	1	657	1	0	659
25908	0	0	3	667	0	670
25909	0	0	657	4	0	661
25910	113	0	2	1	0	116
25911	4	0	0	115	0	119
25912	0	1	118	3	0	122
25913	2	0	115	1	0	118
25914	0	123	2	1	0	126
25915	120	4	0	0	0	124
25916	3	121	0	0	0	124
25917	120	3	1	0	0	124
25918	123	0	1	0	0	124
25919	3	115	0	1	0	119
25920	114	3	1	0	0	118
25921	118	0	0	0	0	118
25922	1	0	111	1	0	113
25923	0	2	3	111	0	116
25924	0	110	1	2	0	113
25925	0	105	0	0	0	105
25926	1	6	0	95	0	102
25927	78	0	5	1	0	84
25928	1	0	0	77	0	78
25929	0	0	0	84	0	84
25930	0	0	0	80	0	80
25931	0	83	0	1	0	84
25932	0	2	0	256	0	258
25933	0	0	263	146	0	409
25934	268	1	143	25	0	437
25935	403	0	25	2	0	430
25936	148	288	4	6	0	446
25937	295	148	3	4	0	450
25938	149	24	4	291	0	468
25939	31	4	279	150	0	464
25940	266	5	144	26	0	441
25941	126	283	20	4	0	433
25942	25	145	3	284	0	457
25943	262	28	3	151	0	444
25944	131	274	3	24	0	432
25945	25	419	1	8	0	453
25946	289	169	4	4	0	466
25947	159	28	281	6	0	474
25948	282	10	146	1	0	439
25949	134	11	26	277	0	448
25950	32	1	7	433	0	473
25951	11	6	284	179	0	480
25952	11	2	447	31	0	491
25953	20	2	170	295	0	487
25954	8	9	313	163	0	493
25955	11	6	428	37	0	482
25956	8	3	181	285	0	477
25957	5	3	37	428	0	473
25958	289	5	15	170	0	479
25959	150	11	11	307	0	479
25960	305	8	7	168	0	488
25961	150	273	4	41	0	468
25962	34	158	10	289	0	491
25963	19	33	272	159	0	483
25964	290	11	146	36	0	483
25965	445	9	33	11	0	498
25966	460	5	11	11	0	487
25967	458	6	9	14	0	487
25968	436	5	14	16	0	471
25969	178	0	13	289	0	480
25970	37	3	291	162	0	493
25971	22	4	432	39	0	497
25972	14	2	454	18	0	488
25973	282	1	188	13	0	484
25974	427	2	44	14	0	487
25975	184	3	18	227	0	432
25976	36	274	14	116	0	440
25977	23	150	14	302	0	489
25978	19	30	292	162	0	503
25979	21	10	431	45	0	507
25980	295	16	175	19	0	505
25981	168	10	325	12	0	515
25982	41	4	160	300	0	505
25983	309	6	41	159	0	515
25984	443	7	18	35	0	503
25985	467	3	16	11	0	497
25986	476	5	15	22	0	518
25987	208	2	299	18	0	527
25988	332	4	160	15	0	511
25989	166	298	42	12	0	518
25990	47	157	23	308	0	535
25991	36	30	316	154	0	536
25992	25	9	164	338	0	536
25993	34	12	332	169	0	547
25994	26	15	159	340	0	540
25995	23	12	40	468	0	543
25996	21	9	321	195	0	546
25997	25	3	172	344	0	544
25998	301	12	52	181	0	546
25999	162	14	26	347	0	549
26000	43	5	25	480	0	553
26001	309	7	24	204	0	544
26002	169	305	14	49	0	537
26003	332	161	8	29	0	530
26004	162	323	12	29	0	526
26005	340	161	22	18	0	541
26006	178	40	309	16	0	543
26007	49	19	158	319	0	545
26008	28	11	45	465	0	549
26009	294	10	29	193	0	526
26010	157	284	30	60	0	531
26011	44	157	28	314	0	543
26012	28	33	21	450	0	532
26013	23	287	19	200	0	529
26014	280	158	25	52	0	515
26015	136	312	21	38	0	507
26016	45	153	22	311	0	531
26017	20	37	21	423	0	501
26018	33	284	9	166	0	492
26019	305	166	9	47	0	527
26020	174	43	289	30	0	536
26021	310	20	155	29	0	514
26022	178	284	36	26	0	524
26023	52	157	23	297	0	529
26024	307	30	24	170	0	531
26025	176	11	26	320	0	533
26026	56	10	13	457	0	536
26027	294	9	10	204	0	517
26028	178	269	10	50	0	507
26029	42	411	19	38	0	510
26030	301	186	18	32	0	537
26031	188	53	278	26	0	545
26032	0	91	0	1	0	92
26033	2	0	0	78	0	80
26034	1	0	84	0	0	85
26035	0	0	0	72	0	72
26036	77	0	0	0	0	77
26037	0	72	1	0	0	73
26038	0	0	0	74	0	74
26039	1	78	0	0	0	79
26040	78	1	0	0	0	79
26041	78	0	0	1	0	79
26042	0	81	0	0	0	81
26043	1	0	0	79	0	80
26044	1	84	0	0	0	85
26045	85	1	0	0	0	86
26046	86	0	0	1	0	87
26047	0	1	0	86	0	87
26048	1	0	0	90	0	91
26049	1	0	90	0	0	91
26050	86	0	0	1	0	87
26051	0	0	89	1	0	90
26052	0	0	1	89	0	90
26053	91	0	0	0	0	91
26054	0	91	1	0	0	92
26055	94	0	0	1	0	95
26056	1	0	93	0	0	94
26057	91	1	0	0	0	92
26058	1	93	0	0	0	94
26059	93	0	1	0	0	94
26060	1	95	0	0	0	96
26061	0	1	0	95	0	96
26062	1	0	94	0	0	95
26063	0	1	94	0	0	95
26064	0	0	0	94	0	94
26065	0	0	95	1	0	96
26066	0	1	1	94	0	96
26067	1	0	0	97	0	98
26068	1	0	99	0	0	100
26069	95	0	0	2	0	97
26070	98	0	0	2	0	100
26071	0	96	2	0	0	98
26072	103	0	0	0	0	103
26073	1	0	1	101	0	103
26074	0	1	107	1	0	109
26075	2	0	0	105	0	107
26076	0	2	0	105	0	107
26077	102	0	1	0	0	103
26078	0	97	1	1	0	99
26079	1	93	0	1	0	95
26080	1	1	0	94	0	96
26081	1	3	0	90	0	94
26082	0	93	0	0	0	93
26083	0	0	0	90	0	90
26084	0	0	1	87	0	88
26085	0	87	1	0	0	88
26086	82	0	0	2	0	84
26087	0	0	1	83	0	84
26088	0	82	0	1	0	83
26089	1	0	0	83	0	84
26090	84	0	1	1	0	86
26091	1	84	0	0	0	85
26092	84	0	0	1	0	85
26093	90	1	0	0	0	91
26094	1	1	0	91	0	93
26095	95	0	0	1	0	96
26096	95	0	1	0	0	96
26097	93	0	0	2	0	95
26098	94	0	0	1	0	95
26099	2	0	0	94	0	96
26100	1	1	0	94	0	96
26101	1	1	93	0	0	95
26102	0	0	0	92	0	92
26103	0	0	0	92	0	92
26104	0	1	92	1	0	94
26105	90	0	0	3	0	93
26106	0	0	1	97	0	98
26107	1	1	97	0	0	99
26108	90	0	0	1	0	91
26109	0	0	105	2	0	107
26110	1	108	2	0	0	111
26111	1	116	1	1	0	119
26112	1	3	1	120	0	125
26113	0	2	136	1	0	139
26114	142	1	1	1	0	145
26115	151	0	1	1	0	153
26116	2	0	151	1	0	154
26117	147	0	1	0	0	148
26118	153	0	1	0	0	154
26119	3	148	1	0	0	152
26120	152	1	0	0	0	153
26121	2	1	0	150	0	153
26122	1	1	155	2	0	159
26123	1	0	2	156	0	159
26124	0	156	1	3	0	160
26125	0	159	1	2	0	162
26126	158	2	1	1	0	162
26127	158	2	0	0	0	160
26128	154	1	0	1	0	156
26129	3	1	1	156	0	161
26130	3	1	0	155	0	159
26131	1	154	1	2	0	158
26132	153	2	0	2	0	157
26133	1	171	0	1	0	173
26134	160	1	0	1	0	162
26135	1	160	1	0	0	162
26136	158	1	0	0	0	159
26137	154	1	0	0	0	155
26138	2	0	1	147	0	150
26139	2	148	0	0	0	150
26140	1	1	144	1	0	147
26141	139	2	1	0	0	142
26142	2	143	1	0	0	146
26143	1	1	140	0	0	142
26144	0	1	144	0	0	145
26145	0	0	2	138	0	140
26146	1	0	1	135	0	137
26147	0	135	0	2	0	137
26148	134	1	0	1	0	136
26149	1	1	0	130	0	132
26150	2	146	0	1	0	149
26151	0	163	0	1	0	164
26152	0	2	161	0	0	163
26153	0	2	165	0	0	167
26154	163	0	2	0	0	165
26155	1	0	162	0	0	163
26156	1	0	1	160	0	162
26157	0	0	1	164	0	165
26158	0	0	165	2	0	167
26159	0	0	1	165	0	166
26160	0	0	1	162	0	163
26161	165	0	0	2	0	167
26162	166	0	0	1	0	167
26163	2	0	0	164	0	166
26164	1	163	0	1	0	165
26165	0	170	0	1	0	171
26166	171	2	0	0	0	173
26167	1	1	167	0	0	169
26168	1	0	1	168	0	170
26169	179	0	1	1	0	181
26170	181	0	0	1	0	182
26171	2	0	0	178	0	180
26172	1	0	180	1	0	182
26173	0	0	177	1	0	178
26174	170	0	2	0	0	172
26175	180	0	1	0	0	181
26176	3	195	0	0	0	198
26177	1	199	0	0	0	200
26178	222	2	0	0	0	224
26179	230	1	0	0	0	231
26180	2	0	1	231	0	234
26181	2	0	0	237	0	239
26182	1	0	0	242	0	243
26183	240	0	1	2	0	243
26184	2	0	0	244	0	246
26185	1	0	250	1	0	252
26186	253	1	1	1	0	256
26187	2	0	1	260	0	263
26188	1	0	273	2	0	276
26189	259	0	2	1	0	262
26190	259	0	1	1	0	261
26191	2	269	0	1	0	272
26192	1	292	0	0	0	293
26193	1	2	282	0	0	285
26194	283	1	1	0	0	285
26195	4	290	1	0	0	295
26196	1	1	291	1	0	294
26197	282	1	2	1	0	286
26198	2	320	1	0	0	323
26199	2	1	316	0	0	319
26200	313	2	2	0	0	317
26201	3	325	1	0	0	329
26202	0	3	0	332	0	335
26203	334	0	0	2	0	336
26204	4	334	0	0	0	338
26205	0	3	0	333	0	336
26206	335	1	0	1	0	337
26207	1	0	335	0	0	336
26208	1	324	1	0	0	326
26209	0	2	317	0	0	319
26210	0	0	2	320	0	322
26211	0	0	319	1	0	320
26212	0	307	1	1	0	309
26213	2	299	0	0	0	301
26214	0	1	0	302	0	303
26215	0	0	0	282	0	282
26216	0	0	0	299	0	299
26217	0	0	315	1	0	316
26218	0	0	1	317	0	318
26219	316	0	0	1	0	317
26220	310	0	0	0	0	310
26221	1	0	335	0	0	336
26222	0	336	1	0	0	337
26223	343	0	0	0	0	343
26224	1	339	0	0	0	340
26225	352	2	0	0	0	354
26226	353	0	0	0	0	353
26227	1	0	353	0	0	354
26228	0	352	1	0	0	353
26229	0	0	0	363	0	363
26230	0	0	359	1	0	360
26231	353	0	2	0	0	355
26232	1	0	0	365	0	366
26233	0	0	346	1	0	347
26234	338	0	1	0	0	339
26235	1	0	362	0	0	363
26236	0	0	1	377	0	378
26237	407	0	0	3	0	410
26238	3	422	0	0	0	425
26239	1	3	435	0	0	439
26240	431	0	3	0	0	434
26241	489	0	0	0	0	489
26242	6	497	0	1	0	504
26243	0	5	0	496	0	501
26244	1	1	0	504	0	506
26245	499	1	0	6	0	506
26246	6	0	0	505	0	511
26247	0	0	508	8	0	516
26248	0	0	7	505	0	512
26249	515	0	0	8	0	523
26250	6	498	2	1	0	507
26251	0	7	0	496	0	503
26252	1	502	2	6	0	511
26253	518	8	0	0	0	526
26254	8	0	0	577	0	585
26255	0	1	0	610	0	611
26256	1	591	0	13	0	605
26257	0	13	583	2	0	598
26258	0	1	13	584	0	598
26259	0	1	0	601	0	602
26260	1	0	1	600	0	602
26261	1	584	0	15	0	600
26262	3	14	606	2	0	625
26263	2	2	628	3	0	635
26264	635	2	15	2	0	654
26265	664	2	2	1	0	669
26266	16	0	667	3	0	686
26267	671	1	13	1	0	686
26268	17	0	686	4	0	707
26269	662	1	15	3	0	681
26270	16	675	3	6	0	700
26271	688	16	1	6	0	711
26272	16	3	689	0	0	708
26273	2	2	692	5	0	701
26274	3	1	15	700	0	719
26275	714	2	2	20	0	738
26276	19	726	1	6	0	752
26277	2	22	803	7	0	834
26278	3	3	24	815	0	845
26279	1	3	2	859	0	865
26280	835	0	2	27	0	864
26281	848	2	1	7	0	858
26282	25	0	2	816	0	843
26283	827	2	2	26	0	857
26284	27	1	807	4	0	839
26285	3	1	22	796	0	822
26286	4	1	4	824	0	833
26287	813	0	4	25	0	842
26288	815	1	5	5	0	826
26289	29	1	2	798	0	830
26290	798	1	3	24	0	826
26291	29	1	771	4	0	805
26292	6	771	26	3	0	806
26293	4	23	772	1	0	800
26294	4	3	24	791	0	822
26295	781	4	6	23	0	814
26296	25	772	4	3	0	804
26297	4	23	3	759	0	789
26298	6	3	3	747	0	759
26299	0	729	5	23	0	757
26300	5	20	3	744	0	772
26301	2	4	1	755	0	762
26302	4	2	2	762	0	770
26303	6	2	0	759	0	767
26304	3	0	3	742	0	748
26305	5	718	1	31	0	755
26306	4	22	3	728	0	757
26307	4	2	2	742	0	750
26308	6	4	692	27	0	729
26309	1	700	25	11	0	737
26310	6	21	2	720	0	749
26311	3	3	8	727	0	741
26312	3	4	1	728	0	736
26313	6	698	2	29	0	735
26314	5	22	701	8	0	736
26315	5	4	22	718	0	749
26316	5	3	702	28	0	738
26317	8	0	705	6	0	719
26318	5	1	28	696	0	730
26319	701	4	7	28	0	740
26320	27	0	4	700	0	731
26321	4	3	3	695	0	705
26322	6	693	0	31	0	730
26323	3	22	2	714	0	741
26324	4	4	1	731	0	740
26325	2	4	689	33	0	728
26326	2	689	25	12	0	728
26327	3	23	3	706	0	735
26328	692	6	6	28	0	732
26329	23	6	683	10	0	722
26330	3	1	24	686	0	714
26331	3	2	3	716	0	724
26332	681	5	3	29	0	718
26333	24	685	1	12	0	722
26334	686	25	1	9	0	721
26335	24	674	2	9	0	709
26336	4	27	2	666	0	699
26337	669	3	5	29	0	706
26338	20	5	649	13	0	687
26339	4	639	23	9	0	675
26340	5	661	5	8	0	679
26341	589	20	3	5	0	617
26342	19	6	0	578	0	603
26343	4	569	3	23	0	599
26344	1	590	4	10	0	605
26345	0	22	3	587	0	612
26346	6	7	1	593	0	607
26347	569	0	1	25	0	595
26348	17	570	1	10	0	598
26349	4	19	5	574	0	602
26350	3	4	567	20	0	594
26351	0	572	19	7	0	598
26352	4	18	547	4	0	573
26353	2	543	19	6	0	570
26354	1	18	9	493	0	521
26355	2	2	1	483	0	488
26356	2	469	3	15	0	489
26357	1	10	476	7	0	494
26358	473	3	10	5	0	491
26359	11	4	1	490	0	506
26360	2	1	3	503	0	509
26361	4	1	493	13	0	511
26362	0	3	13	477	0	493
26363	1	3	454	14	0	472
26364	1	1	11	446	0	459
26365	3	0	434	14	0	451
26366	0	423	11	4	0	438
26367	1	11	423	5	0	440
26368	1	2	10	436	0	449
26369	442	1	2	14	0	459
26370	12	429	1	3	0	445
26371	4	17	0	433	0	454
26372	2	5	422	16	0	445
26373	0	434	12	7	0	453
26374	3	13	1	413	0	430
26375	0	3	419	10	0	432
26376	1	371	11	4	0	387
26377	273	4	8	0	0	285
26378	254	1	0	1	0	256
26379	3	0	1	257	0	261
26380	256	0	5	4	0	265
26381	3	0	1	252	0	256
26382	1	0	0	260	0	261
26383	2	0	272	4	0	278
26384	0	0	2	272	0	274
26385	2	0	1	274	0	277
26386	272	1	0	4	0	277
26387	269	0	0	3	0	272
26388	4	276	1	0	0	281
26389	1	4	282	0	0	287
26390	0	2	3	280	0	285
26391	0	0	283	3	0	286
26392	263	1	3	1	0	268
26393	4	0	272	0	0	276
26394	2	0	2	267	0	271
26395	0	269	1	4	0	274
26396	1	5	0	265	0	271
26397	0	1	0	272	0	273
26398	0	0	287	4	0	291
26399	0	1	3	288	0	292
26400	290	0	1	5	0	296
26401	286	0	1	3	0	290
26402	291	1	0	0	0	292
26403	296	1	0	0	0	297
26404	4	284	0	2	0	290
26405	1	284	2	1	0	288
26406	1	5	0	289	0	295
26407	0	1	1	292	0	294
26408	1	288	1	5	0	295
26409	0	4	2	294	0	300
26410	1	1	0	293	0	295
26411	1	1	0	295	0	297
26412	1	0	0	297	0	298
26413	2	0	1	296	0	299
26414	284	1	1	5	0	291
26415	5	280	1	4	0	290
26416	2	5	279	2	0	288
26417	1	1	4	279	0	285
26418	1	1	2	286	0	290
26419	2	1	1	279	0	283
26420	279	1	1	4	0	285
26421	3	292	1	1	0	297
26422	1	4	1	280	0	286
26423	1	289	1	6	0	297
26424	1	6	2	282	0	291
26425	2	292	0	6	0	300
26426	3	4	318	2	0	327
26427	1	2	6	337	0	346
26428	2	1	396	8	0	407
26429	1	0	7	397	0	405
26430	0	0	3	436	0	439
26431	428	2	2	13	0	445
26432	434	0	1	7	0	442
26433	439	0	1	4	0	444
26434	437	2	0	2	0	441
26435	433	0	1	2	0	436
26436	15	0	0	417	0	432
26437	5	416	2	9	0	432
26438	3	9	0	416	0	428
26439	1	4	402	10	0	417
26440	401	1	7	7	0	416
26441	410	4	3	3	0	420
26442	10	1	2	408	0	421
26443	4	1	0	409	0	414
26444	1	393	2	14	0	410
26445	1	8	0	409	0	418
26446	3	3	1	403	0	410
26447	3	393	0	13	0	409
26448	3	9	0	410	0	422
26449	392	5	1	10	0	408
26450	10	2	381	6	0	399
26451	387	2	7	3	0	399
26452	8	1	386	5	0	400
26453	4	2	8	384	0	398
26454	2	2	4	378	0	386
26455	0	377	2	15	0	394
26456	3	386	0	6	0	395
26457	3	11	1	383	0	398
26458	2	5	374	12	0	393
26459	367	1	8	6	0	382
26460	11	0	5	369	0	385
26461	4	359	1	18	0	382
26462	2	9	0	375	0	386
26463	2	9	0	371	0	382
26464	3	361	1	13	0	378
26465	4	8	1	361	0	374
26466	6	3	340	10	0	359
26467	4	1	323	5	0	333
26468	0	1	6	314	0	321
26469	0	320	2	6	0	328
26470	1	5	1	326	0	333
26471	323	2	3	8	0	336
26472	328	2	0	3	0	333
26473	325	0	0	3	0	328
26474	11	312	0	2	0	325
26475	3	5	307	3	0	318
26476	309	4	7	0	0	320
26477	323	0	3	2	0	328
26478	10	309	1	3	0	323
26479	3	9	0	308	0	320
26480	309	3	1	8	0	321
26481	317	2	0	2	0	321
26482	314	0	3	2	0	319
26483	10	1	1	293	0	305
26484	299	0	2	7	0	308
26485	7	0	0	299	0	306
26486	3	1	0	299	0	303
26487	295	1	0	10	0	306
26488	7	2	0	286	0	295
26489	286	1	0	11	0	298
26490	8	0	2	287	0	297
26491	5	0	3	289	0	297
26492	282	0	1	13	0	296
26493	6	3	269	6	0	284
26494	4	0	4	278	0	286
26495	3	0	3	279	0	285
26496	4	2	2	278	0	286
26497	4	0	0	284	0	288
26498	3	0	2	265	0	270
26499	2	258	1	11	0	272
26500	1	7	0	258	0	266
26501	3	4	246	9	0	262
26502	3	1	7	255	0	266
26503	4	2	2	258	0	266
26504	3	1	1	264	0	269
26505	5	1	247	12	0	265
26506	1	3	254	4	0	262
26507	251	1	10	4	0	266
26508	256	0	4	5	0	265
26509	12	1229	4	5	0	1250
26510	3	9	1	1377	0	1390
26511	2	3	0	1364	0	1369
26512	5	4	1	1392	0	1402
26513	1409	0	1	12	0	1422
26514	1362	1	2	4	0	1369
26515	9	1	2	1377	0	1389
26516	6	0	0	1388	0	1394
26517	3	2	1	1388	0	1394
26518	1	2	2	1386	0	1391
26519	1347	1	0	13	0	1361
26520	6	1	1357	8	0	1372
26521	5	1214	7	5	0	1231
26522	2	1284	2	7	0	1295
26523	1338	6	2	5	0	1351
26524	7	9	0	1299	0	1315
26525	2	3	1279	8	0	1292
26526	1	8	1096	5	0	1110
26527	0	1156	5	7	0	1168
26528	1216	1	0	2	0	1219
26529	1	3	1175	1	0	1180
26530	985	0	2	0	0	987
26531	0	0	1	1170	0	1171
26532	0	1	0	1192	0	1193
26533	0	1132	0	0	0	1132
26534	0	1140	1	1	0	1142
26535	1198	0	0	0	0	1198
26536	1174	0	0	1	0	1175
26537	0	1137	1	0	0	1138
26538	1	4	1131	0	0	1136
26539	1	2	1119	0	0	1122
26540	0	0	0	1100	0	1100
26541	1223	0	0	0	0	1223
26542	0	1108	2	3	0	1113
26543	1	0	0	1206	0	1207
26544	1216	0	0	2	0	1218
26545	0	0	0	1196	0	1196
26546	0	1	0	1200	0	1201
26547	1199	0	0	1	0	1200
26548	1	1121	2	0	0	1124
26549	0	1136	0	1	0	1137
26550	0	2	1098	1	0	1101
26551	0	0	0	1133	0	1133
26552	1	3	0	1080	0	1084
26553	0	1	1105	1	0	1107
26554	827	2	3	1	0	833
26555	924	0	2	0	0	926
26556	0	1	1058	0	0	1059
26557	771	1	4	2	0	778
26558	1	1	1042	1	0	1045
26559	0	972	2	1	0	975
26560	0	0	0	1073	0	1073
26561	0	0	0	1072	0	1072
26562	1083	0	0	0	0	1083
26563	1036	0	0	0	0	1036
26564	1040	0	0	0	0	1040
26565	1037	0	0	0	0	1037
26566	1041	0	1	0	0	1042
26567	0	2	998	0	0	1000
26568	0	925	3	1	0	929
26569	0	0	0	1040	0	1040
26570	0	974	1	0	0	975
26571	0	984	2	0	0	986
26572	2	0	0	1047	0	1049
26573	0	0	0	1043	0	1043
26574	5	0	1008	0	0	1013
26575	929	0	0	0	0	929
26576	1037	0	0	0	0	1037
26577	0	965	2	0	0	967
26578	1066	0	0	0	0	1066
26579	1079	0	0	0	0	1079
26580	0	0	0	1068	0	1068
26581	0	2	1068	0	0	1070
26582	0	1	1012	0	0	1013
26583	1052	0	0	0	0	1052
26584	1087	0	0	0	0	1087
26585	0	976	2	0	0	978
26586	0	1047	0	1	0	1048
26587	0	0	0	1110	0	1110
26588	1118	0	1	0	0	1119
26589	0	0	1046	0	0	1046
26590	0	1	0	1076	0	1077
26591	1136	0	2	0	0	1138
26592	1114	0	0	1	0	1115
26593	2	0	0	1108	0	1110
26594	1147	0	0	1	0	1148
26595	2	3	1057	1	0	1063
26596	1	0	1103	0	0	1104
26597	0	1	3	1079	0	1083
26598	0	0	1	1168	0	1169
26599	1	0	0	1175	0	1176
26600	1	1106	0	2	0	1109
26601	0	1145	1	3	0	1149
26602	1	2	0	1196	0	1199
26603	1200	1	2	1	0	1204
26604	1	1	2	1180	0	1184
26605	1	1	0	1194	0	1196
26606	0	1113	3	4	0	1120
26607	0	1159	1	4	0	1164
26608	0	2	0	1198	0	1200
26609	0	2	0	326	0	328
26610	325	0	0	3	0	328
26611	2	324	0	1	0	327
26612	331	1	0	1	0	333
26613	1	1	0	330	0	332
26614	1	0	329	1	0	331
26615	0	2	338	3	0	343
26616	350	0	2	1	0	353
26617	4	0	1	356	0	361
26618	1	0	0	353	0	354
26619	0	1	0	357	0	358
26620	1	0	359	2	0	362
26621	0	0	1	369	0	370
26622	0	370	2	3	0	375
26623	0	2	1	374	0	377
26624	1	1	0	369	0	371
26625	0	384	0	5	0	389
26626	0	2	0	397	0	399
26627	396	1	0	3	0	400
26628	3	392	1	1	0	397
26629	423	2	0	1	0	426
26630	434	2	0	0	0	436
26631	4	0	0	435	0	439
26632	1	0	0	430	0	431
26633	0	1	0	432	0	433
26634	0	0	415	6	0	421
26635	0	416	3	1	0	420
26636	0	428	1	0	0	429
26637	1	6	0	419	0	426
26638	423	1	0	3	0	427
26639	4	0	0	430	0	434
26640	3	0	424	5	0	432
26641	2	412	4	2	0	420
26642	1	421	2	1	0	425
26643	437	6	0	0	0	443
26644	436	2	0	0	0	438
26645	5	449	0	1	0	455
26646	450	4	1	0	0	455
26647	4	2	442	1	0	449
26648	1	1	434	0	0	436
26649	446	0	5	0	0	451
26650	463	1	1	0	0	465
26651	7	0	0	458	0	465
26652	462	0	0	4	0	466
26653	3	1	459	3	0	466
26654	5	0	478	0	0	483
26655	0	0	9	524	0	533
26656	0	0	3	591	0	594
26657	1	0	0	617	0	618
26658	1	0	0	655	0	656
26659	0	0	0	709	0	709
26660	1	1	686	17	0	705
26661	1	0	12	698	0	711
26662	709	1	4	14	0	728
26663	14	0	0	715	0	729
26664	707	0	0	16	0	723
26665	13	0	1	713	0	727
26666	713	0	0	18	0	731
26667	733	0	0	7	0	740
26668	14	0	2	715	0	731
26669	3	2	1	737	0	743
26670	726	1	0	23	0	750
26671	739	0	1	10	0	750
26672	20	0	724	7	0	751
26673	4	0	13	731	0	748
26674	2	0	6	745	0	753
26675	729	1	3	21	0	754
26676	742	2	0	7	0	751
26677	21	1	0	727	0	749
26678	8	0	0	734	0	742
26679	7	1	0	718	0	726
26680	5	0	1	714	0	720
26681	5	664	3	24	0	696
26682	4	682	0	11	0	697
26683	3	21	2	683	0	709
26684	6	669	1	22	0	698
26685	7	16	0	688	0	711
26686	4	4	662	22	0	692
26687	5	1	648	9	0	663
26688	3	654	19	9	0	685
26689	3	14	4	652	0	673
26690	7	3	649	20	0	679
26691	5	2	14	640	0	661
26692	4	0	2	668	0	674
26693	652	3	1	22	0	678
26694	16	2	0	665	0	683
26695	4	2	665	21	0	692
26696	3	5	650	6	0	664
26697	4	636	17	5	0	662
26698	4	670	4	6	0	684
26699	661	18	2	6	0	687
26700	15	4	1570	11	0	1600
26701	6	1	67	1595	0	1669
26702	1559	3	39	73	0	1674
26703	1581	3	26	43	0	1653
26704	96	1579	3	35	0	1713
26705	61	65	9	1591	0	1726
26706	23	35	2	1658	0	1718
26707	11	27	4	1701	0	1743
26708	1580	4	6	130	0	1720
26709	68	12	1546	69	0	1695
26710	40	1578	73	37	0	1728
26711	35	70	39	1571	0	1715
26712	6	38	26	1675	0	1745
26713	17	31	1561	108	0	1717
26714	4	5	82	1630	0	1721
26715	8	11	37	1634	0	1690
26716	18	6	28	1654	0	1706
26717	12	7	7	1712	0	1738
26718	9	12	1542	135	0	1698
26719	6	8	71	1658	0	1743
26720	6	6	1533	129	0	1674
26721	10	1541	100	68	0	1719
26722	13	72	45	1534	0	1664
26723	18	40	45	1624	0	1727
26724	11	37	1515	132	0	1695
26725	9	1532	76	91	0	1708
26726	4	77	43	1539	0	1663
26727	6	34	1513	109	0	1662
26728	12	1535	75	77	0	1699
26729	14	68	47	1540	0	1669
26730	6	46	1526	102	0	1680
26731	11	36	74	1541	0	1662
26732	3	8	57	1561	0	1629
26733	4	19	42	1624	0	1689
26734	1475	6	23	156	0	1660
26735	67	1508	27	98	0	1700
26736	1560	77	12	71	0	1720
26737	106	40	1503	49	0	1698
26738	1597	38	84	42	0	1761
26739	1628	18	51	42	0	1739
26740	100	15	45	1576	0	1736
26741	1642	14	29	100	0	1785
26742	1632	17	14	73	0	1736
26743	1659	12	18	58	0	1747
26744	138	18	27	1581	0	1764
26745	61	16	19	1683	0	1779
26746	38	10	1559	147	0	1754
26747	26	12	1586	88	0	1712
26748	1544	17	115	53	0	1729
26749	83	26	66	1446	0	1621
26750	52	1568	55	96	0	1771
26751	1528	74	41	69	0	1712
26752	93	1563	28	84	0	1768
26753	90	1655	20	46	0	1811
26754	72	124	1533	56	0	1785
26755	32	93	3179	46	0	3350
26756	41	72	103	3143	0	3359
26757	34	14	3248	131	0	3427
26758	32	24	3149	88	0	3293
26759	3068	11	118	66	0	3263
26760	3178	24	101	41	0	3344
26761	109	28	57	3117	0	3311
26762	91	17	26	3224	0	3358
26763	50	19	3123	144	0	3336
26764	37	3112	85	111	0	3345
26765	22	67	59	3255	0	3403
26766	3202	52	39	140	0	3433
26767	62	32	29	3266	0	3389
26768	49	3171	45	142	0	3407
26769	51	71	3157	78	0	3357
26770	23	3185	91	77	0	3376
26771	3265	104	75	42	0	3486
26772	3292	61	57	48	0	3458
26773	109	68	23	3279	0	3479
26774	85	23	4450	106	0	4664
26775	41	38	4442	89	0	4610
26776	29	4417	275	85	0	4806
26777	32	185	160	4407	0	4784
26778	13	107	101	4667	0	4888
26779	29	89	4393	293	0	4804
26780	21	20	209	4439	0	4689
26781	21	4412	133	253	0	4819
26782	28	178	80	4552	0	4838
26783	25	94	24	4788	0	4931
26784	26	76	4499	305	0	4906
26785	43	34	190	4659	0	4926
26786	4554	41	101	262	0	4958
26787	220	35	4539	126	0	4920
26788	121	27	4558	95	0	4801
26789	87	4391	314	34	0	4826
26790	48	195	151	4413	0	4807
26791	42	109	67	4825	0	5043
26792	59	58	4543	302	0	4962
26793	4516	18	213	169	0	4916
26794	232	24	110	4737	0	5103
26795	121	28	4601	243	0	4993
26796	65	31	214	4714	0	5024
26797	28	28	4630	284	0	4970
26798	786	27	3829	143	0	4785
26799	93	4465	256	124	0	4938
26800	10	125	74	3498	0	3707
26801	5	3640	38	115	0	3798
26802	3638	144	23	54	0	3859
26803	132	67	3580	35	0	3814
26804	57	3566	137	25	0	3785
26805	25	127	63	3679	0	3894
26806	3587	58	71	142	0	3858
26807	130	3616	54	70	0	3870
26808	61	157	19	3685	0	3922
26809	26	65	30	3716	0	3837
26810	7	3634	38	203	0	3882
26811	3617	135	48	85	0	3885
26812	126	65	32	3775	0	3998
26813	53	64	23	3947	0	4087
26814	27	29	3707	246	0	4009
26815	9	3685	156	135	0	3985
26816	16	146	96	3811	0	4069
26817	17	71	61	4006	0	4155
26818	33	3901	30	215	0	4179
26819	10	157	53	4023	0	4243
26820	15	65	57	4131	0	4268
26821	12	65	33	4155	0	4265
26822	8	3918	32	257	0	4215
26823	3954	153	27	136	0	4270
26824	163	86	3921	56	0	4226
26825	3872	46	160	40	0	4118
26826	182	3884	83	68	0	4217
26827	73	133	68	4043	0	4317
26828	42	71	3938	190	0	4241
26829	20	46	189	3982	0	4237
26830	7	22	109	4097	0	4235
26831	10	50	47	4195	0	4302
26832	14	49	3850	279	0	4192
26833	18	3835	174	133	0	4160
26834	41	165	3894	65	0	4165
26835	18	3885	217	61	0	4181
26836	24	214	3910	62	0	4210
26837	24	96	188	3998	0	4306
26838	3905	40	91	207	0	4243
26839	156	3866	61	115	0	4198
26840	64	185	3856	102	0	4207
26841	44	3859	159	97	0	4159
26842	24	212	3943	64	0	4243
26843	42	84	195	3840	0	4161
26844	38	60	89	3914	0	4101
26845	26	3787	70	228	0	4111
26846	22	4030	81	110	0	4243
26847	4002	246	46	63	0	4357
26848	162	115	32	4051	0	4360
26849	70	72	3923	222	0	4287
26850	33	53	184	4049	0	4319
26851	20	30	3977	275	0	4302
26852	23	24	4015	160	0	4222
26853	26	35	231	3864	0	4156
26854	27	3819	123	185	0	4154
26855	2397	165	78	99	0	2739
26856	166	91	90	2414	0	2761
26857	89	89	45	2443	0	2666
26858	44	2416	36	236	0	2732
26859	2369	187	28	139	0	2723
26860	2503	96	58	75	0	2732
26861	239	54	39	2348	0	2680
26862	112	2246	39	215	0	2612
26863	39	2436	51	130	0	2656
26864	2368	205	57	84	0	2714
26865	165	139	2312	52	0	2668
26866	2395	61	207	44	0	2707
26867	2460	70	95	60	0	2685
26868	2494	54	57	70	0	2675
26869	250	2336	36	61	0	2683
26870	135	171	32	2376	0	2714
26871	2379	100	38	197	0	2714
26872	2385	68	64	111	0	2628
26873	225	2405	55	84	0	2769
26874	1116	23	4	7	0	1150
26875	25	10	4	1116	0	1155
26876	10	7	5	1127	0	1149
26877	4	1116	4	28	0	1152
26878	7	22	2	1135	0	1166
26879	4	8	7	1146	0	1165
26880	4	1126	4	35	0	1169
26881	4	25	3	1108	0	1140
26882	4	2066	7	25	0	2102
26883	2140	25	5	9	0	2179
26884	2113	12	1	7	0	2133
26885	30	2087	1	12	0	2130
26886	15	24	2065	9	0	2113
26887	6	14	19	2059	0	2098
26888	10	5	2079	25	0	2119
26889	4	2024	23	18	0	2069
26890	6	2056	12	6	0	2080
26891	2002	36	1	8	0	2047
26892	20	2036	4	6	0	2066
26893	9	23	4	2031	0	2067
26894	7	2014	1	21	0	2043
26895	4	2035	4	16	0	2059
26896	2042	28	3	2	0	2075
26897	24	10	3	2022	0	2059
26898	14	4	2008	21	0	2047
26899	5	9	1976	10	0	2000
26900	4	1975	25	8	0	2012
26901	2035	21	7	5	0	2068
26902	24	2018	4	3	0	2049
26903	5	24	4	2060	0	2093
26904	2098	15	3	19	0	2135
26905	21	4	3	2107	0	2135
26906	7	4	3	2122	0	2136
26907	4	2096	3	24	0	2127
26908	4	23	1	2141	0	2169
26909	3	10	2123	23	0	2159
26910	2727	9	22	8	0	2766
26911	74	2910	9	9	0	3002
26912	24	2967	3	9	0	3003
26913	2899	80	3	4	0	2986
26914	76	29	2867	4	0	2976
26915	2761	10	59	4	0	2834
26916	64	2950	21	6	0	3041
26917	20	3036	3	3	0	3062
26918	15	90	2997	3	0	3105
26919	5	3064	68	4	0	3141
26920	8	85	23	2960	0	3076
26921	8	24	4	3045	0	3081
26922	2	3012	7	84	0	3105
26923	6	68	5	3083	0	3162
26924	3090	26	2	77	0	3195
26925	73	13	3019	26	0	3131
26926	3029	4	72	6	0	3111
26927	3123	9	23	6	0	3161
26928	3134	9	2	9	0	3154
26929	99	12	3032	7	0	3150
26930	33	8	71	3016	0	3128
26931	15	7	3032	78	0	3132
26932	2960	4	71	22	0	3057
26933	3034	10	24	3	0	3071
26934	92	2989	10	3	0	3094
26935	30	77	10	2981	0	3098
26936	13	2989	13	74	0	3089
26937	10	72	2972	26	0	3080
26938	7	27	71	2991	0	3096
26939	3012	14	27	80	0	3133
26940	3069	12	4	29	0	3114
26941	105	10	6	2894	0	3015
26942	32	2872	13	70	0	2987
26943	18	74	2895	28	0	3015
26944	25	29	2967	7	0	3028
26945	2777	12	99	8	0	2896
26946	89	11	2916	20	0	3036
26947	33	2842	73	12	0	2960
26948	17	74	34	2908	0	3033
26949	17	30	2911	75	0	3033
26950	16	8	77	2828	0	2929
26951	11	14	2883	82	0	2990
26952	2711	11	83	33	0	2838
26953	86	9	25	2813	0	2933
26954	30	2772	21	80	0	2903
26955	12	2888	13	37	0	2950
26956	17	95	10	2820	0	2942
26957	24	26	13	2837	0	2900
26958	15	2741	13	102	0	2871
26959	15	81	2777	28	0	2901
26960	17	34	77	2780	0	2908
26961	12	13	2813	86	0	2924
26962	16	17	2815	30	0	2878
26963	2630	19	102	14	0	2765
26964	78	2722	32	14	0	2846
26965	2804	79	11	21	0	2915
26966	87	48	15	2694	0	2844
26967	34	2734	26	79	0	2873
26968	19	87	16	2776	0	2898
26969	24	34	24	2791	0	2873
26970	27	2686	15	109	0	2837
26971	21	90	2634	38	0	2783
26972	22	52	71	2702	0	2847
26973	2701	25	38	94	0	2858
26974	83	20	20	2700	0	2823
26975	39	26	24	2741	0	2830
26976	23	19	2622	112	0	2776
26977	24	2567	82	59	0	2732
26978	16	93	36	2648	0	2793
26979	23	34	2604	96	0	2757
26980	19	20	2629	54	0	2722
26981	2426	22	117	23	0	2588
26982	91	1724	38	30	0	1883
26983	1748	86	15	28	0	1877
26984	99	1714	23	18	0	1854
26985	36	1786	20	27	0	1869
26986	1716	108	23	34	0	1881
26987	92	41	26	1675	0	1834
26988	45	1691	31	91	0	1858
26989	39	80	10	1771	0	1900
26990	1743	37	20	103	0	1903
26991	96	27	1703	43	0	1869
26992	37	24	1723	36	0	1820
26993	1678	27	112	18	0	1835
26994	98	1662	47	24	0	1831
26995	57	76	1644	26	0	1803
26996	31	1678	88	21	0	1818
26997	25	93	40	1687	0	1845
26998	21	43	1673	90	0	1827
26999	19	24	89	1714	0	1846
27000	19	18	1685	95	0	1817
27001	1666	21	91	40	0	1818
27002	88	1663	40	26	0	1817
27003	1664	88	31	21	0	1804
27004	83	44	21	1541	0	1689
27005	33	1613	24	94	0	1764
27006	837	85	809	39	0	1770
27007	1639	36	57	36	0	1768
27008	87	19	1626	22	0	1754
27009	41	25	1670	22	0	1758
27010	740	5	25	6	0	776
27011	22	734	14	6	0	776
27012	8	713	4	4	0	729
27013	18	43	15	640	0	716
27014	6	10	626	21	0	663
27015	7	614	19	8	0	648
27016	2	513	8	3	0	526
27017	21	20	1	301	0	343
27018	295	3	0	6	0	304
27019	293	0	1	3	0	297
27020	295	1	0	2	0	298
27021	8	1	284	1	0	294
27022	289	0	6	2	0	297
27023	298	0	2	2	0	302
27024	294	2	2	0	0	298
27025	9	1	2	285	0	297
27026	2	288	0	8	0	298
27027	293	6	2	1	0	302
27028	7	295	1	1	0	304
27029	3	6	0	293	0	302
27030	0	3	316	6	0	325
27031	2	1	7	318	0	328
27032	0	2	1	327	0	330
27033	2	1	319	9	0	331
27034	2	311	8	2	0	323
27035	3	7	1	298	0	309
27036	291	4	0	6	0	301
27037	7	288	0	3	0	298
27038	288	7	0	0	0	295
27039	6	3	0	283	0	292
27040	3	278	0	5	0	286
27041	284	6	0	3	0	293
27042	6	279	0	1	0	286
27043	2	6	284	1	0	293
27044	284	2	9	0	0	295
27045	289	0	2	1	0	292
27046	8	287	0	0	0	295
27047	2	5	277	0	0	284
27048	0	280	6	0	0	286
27049	0	5	2	259	0	266
27050	0	2	0	302	0	304
27051	0	0	0	303	0	303
27052	0	294	0	8	0	302
27053	1	5	1	294	0	301
27054	0	2	0	302	0	304
27055	299	1	0	8	0	308
27056	6	0	0	297	0	303
27057	2	0	0	302	0	304
27058	291	0	0	8	0	299
27059	6	299	0	3	0	308
27060	301	6	0	1	0	308
27061	306	3	0	0	0	309
27062	306	1	0	0	0	307
27063	10	0	0	295	0	305
27064	3	1	1	306	0	311
27065	1	0	293	9	0	303
27066	2	0	294	3	0	299
27067	0	1	292	2	0	295
27068	280	1	9	1	0	291
27069	7	1	286	1	0	295
27070	2	289	7	3	0	301
27071	1	8	2	298	0	309
27072	1	3	1	295	0	300
27073	0	303	1	8	0	312
27074	3	7	305	2	0	317
27075	1	311	6	1	0	319
27076	310	9	2	3	0	324
27077	9	3	318	0	0	330
27078	4	322	7	0	0	333
27079	3	7	325	0	0	335
27080	2	2	9	323	0	336
27081	2	1	325	8	0	336
27082	1	2	7	318	0	328
27083	329	0	3	8	0	340
27084	7	1	327	3	0	338
27085	2	329	6	1	0	338
27086	338	7	3	1	0	349
27087	7	3	347	2	0	359
27088	2	2	339	2	0	345
27089	1	0	10	327	0	338
27090	0	1	330	9	0	340
27091	315	0	8	4	0	327
27092	9	318	3	2	0	332
27093	2	9	1	332	0	344
27094	3	332	0	7	0	342
27095	339	9	0	3	0	351
27096	8	4	339	1	0	352
27097	6	1	347	5	0	359
27098	2	1	8	343	0	354
27099	0	2	4	354	0	360
27100	2	0	2	365	0	369
27101	1	2	1	362	0	366
27102	0	1	353	10	0	364
27103	1	352	9	4	0	366
27104	2	2	1	315	0	320
27105	1	3	304	2	0	310
27106	0	298	3	1	0	302
27107	297	2	1	3	0	303
27108	3	4	1	288	0	296
27109	281	2	0	3	0	286
27110	2	279	1	2	0	284
27111	286	3	0	1	0	290
27112	4	1	289	0	0	294
27113	2	6	3	283	0	294
27114	2	288	1	2	0	293
27115	1	2	285	0	0	288
27116	0	286	2	4	0	292
27117	3	3	2	268	0	276
27118	269	1	2	3	0	275
27119	2	274	1	1	0	278
27120	272	2	2	1	0	277
27121	4	1	279	0	0	284
27122	1	3	275	0	0	279
27123	287	1	3	0	0	291
27124	2	0	2	287	0	291
27125	0	0	1	291	0	292
27126	1	1	306	2	0	310
27127	0	1	303	1	0	305
27128	0	308	1	3	0	312
27129	309	1	6	0	0	316
27130	302	0	2	0	0	304
27131	1	293	1	0	0	295
27132	1	1	1	314	0	317
27133	327	0	0	2	0	329
27134	1	1	0	323	0	325
27135	323	0	0	3	0	326
27136	327	0	0	0	0	327
27137	333	0	1	1	0	335
27138	2	1	0	328	0	331
27139	2	0	0	347	0	349
27140	346	0	1	2	0	349
27141	344	0	1	1	0	346
27142	343	0	0	2	0	345
27143	3	339	1	0	0	343
27144	337	2	0	0	0	339
27145	3	335	0	0	0	338
27146	332	3	0	0	0	335
27147	3	0	324	0	0	327
27148	311	1	3	0	0	315
27149	2	316	0	1	0	319
27150	0	305	0	0	0	305
27151	318	2	0	0	0	320
27152	2	0	0	310	0	312
27153	0	0	0	318	0	318
27154	0	311	0	2	0	313
27155	0	322	0	0	0	322
27156	336	2	0	0	0	338
27157	1	0	341	0	0	342
27158	0	0	2	356	0	358
27159	359	0	0	2	0	361
27160	3	1	359	0	0	363
27161	0	396	2	1	0	399
27162	437	3	0	0	0	440
27163	5	1	461	0	0	467
27164	1	0	6	490	0	497
27165	0	0	497	8	0	505
27166	496	0	7	2	0	505
27167	9	505	2	0	0	516
27168	514	9	0	0	0	523
27169	514	3	0	0	0	517
27170	12	0	0	515	0	527
27171	515	0	0	9	0	524
27172	8	0	0	520	0	528
27173	2	0	0	526	0	528
27174	0	1	491	14	0	506
27175	0	488	6	2	0	496
27176	0	11	2	499	0	512
27177	0	4	0	501	0	505
27178	0	0	0	506	0	506
27179	0	0	488	10	0	498
27180	1	481	8	3	0	493
27181	0	8	3	494	0	505
27182	1	3	0	500	0	504
27183	0	0	483	10	0	493
27184	0	0	8	489	0	497
27185	478	0	3	8	0	489
27186	8	478	0	3	0	489
27187	474	8	0	0	0	482
27188	8	3	469	0	0	480
27189	3	0	8	466	0	477
27190	471	0	3	8	0	482
27191	474	0	0	3	0	477
27192	11	2	1975	0	0	1988
27193	4	0	9	1953	0	1966
27194	2	1	2046	9	0	2058
27195	1958	0	7	6	0	1971
27196	7	2005	6	4	0	2022
27197	2040	8	1	0	0	2049
27198	2117	3	1	1	0	2122
27199	11	2027	3	3	0	2044
27200	2135	8	0	0	0	2143
27201	9	6	2082	2	0	2099
27202	2071	0	7	1	0	2079
27203	9	0	4	2105	0	2118
27204	5	1	2090	8	0	2104
27205	1	1	8	2058	0	2068
27206	1	1	4	2079	0	2085
27207	1	0	0	2139	0	2140
27208	0	2061	3	12	0	2076
27209	2131	8	0	4	0	2143
27210	8	4	0	2144	0	2156
27211	3	2061	1	10	0	2075
27212	2	8	1	2130	0	2141
27213	0	2065	0	7	0	2072
27214	4	12	2040	3	0	2059
27215	3	3	8	1994	0	2008
27216	0	0	5	2059	0	2064
27217	0	2	2078	12	0	2092
27218	1894	2	12	4	0	1912
27219	8	2032	6	3	0	2049
27220	4	8	1	2138	0	2151
27221	2	3	2	2106	0	2113
27222	1	1	1	2094	0	2097
27223	1	2024	1	12	0	2038
27224	2084	10	3	3	0	2100
27225	10	4	2058	4	0	2076
27226	5	1	1961	1	0	1968
27227	1	0	11	1993	0	2005
27228	2	1	3	2061	0	2067
27229	2086	0	1	12	0	2099
27230	10	1957	3	8	0	1978
27231	3	10	1	2076	0	2090
27232	2070	3	2	10	0	2085
27233	11	2	0	2020	0	2033
27234	2058	1	1	12	0	2072
27235	13	1	1986	5	0	2005
27236	4	1933	13	5	0	1955
27237	2047	9	4	3	0	2063
27238	13	5	1986	0	0	2004
27239	1939	2	9	4	0	1954
27240	12	4	1929	1	0	1946
27241	1960	2	11	2	0	1975
27242	9	1	5	2008	0	2023
27243	2034	1	1	9	0	2045
27244	10	1	1	2016	0	2028
27245	6	1	1	2004	0	2012
27246	2019	0	2	13	0	2034
27247	9	1917	5	6	0	1937
27248	5	8	0	2026	0	2039
27249	2039	5	1	9	0	2054
27250	2056	0	1	6	0	2063
27251	12	2	1	2011	0	2026
27252	7	1	2	3372	0	3382
27253	3324	0	0	35	0	3359
27254	31	3	1	3329	0	3364
27255	8	0	2	3410	0	3420
27256	3318	1	2	41	0	3362
27257	31	1	3	3332	0	3367
27258	10	2	3159	34	0	3205
27259	3124	3	28	7	0	3162
27260	36	7	3184	4	0	3231
27261	9	8	2972	8	0	2997
27262	2971	6	39	3	0	3019
27263	28	2999	9	4	0	3040
27264	4	26	2	3101	0	3133
27265	9	6	0	3069	0	3084
27266	2	1	2	3046	0	3051
27267	1	1	1	3132	0	3135
27268	3045	1	3	28	0	3077
27269	3083	1	1	3	0	3088
27270	3098	0	2	9	0	3109
27271	32	2	3081	6	0	3121
27272	8	1	27	3148	0	3184
27273	3	2	2	3131	0	3138
27274	6	1	4	3002	0	3013
27275	6	2970	4	32	0	3012
27276	3	3089	5	21	0	3118
27277	3145	29	7	15	0	3196
27278	40	6	4	3167	0	3217
27279	19	2	5	3224	0	3250
27280	24	0	5	3268	0	3297
27281	17	5	3063	60	0	3145
27282	10	14	2892	35	0	2951
27283	2982	1	37	22	0	3042
27284	3126	1	21	22	0	3170
27285	39	3	21	3067	0	3130
27286	29	3068	21	31	0	3149
27287	19	35	19	3137	0	3210
27288	16	16	8	3187	0	3227
27289	16	10	3007	51	0	3084
27290	2984	11	30	40	0	3065
27291	28	2	7	3208	0	3245
27292	19	1	3	1822	0	1845
27293	1737	2	3	59	0	1801
27294	57	1746	1	26	0	1830
27295	1797	33	10	9	0	1849
27296	48	6	13	1737	0	1804
27297	18	1727	10	58	0	1813
27298	1748	27	12	42	0	1829
27299	33	12	12	1773	0	1830
27300	1731	19	8	50	0	1808
27301	1729	18	8	24	0	1779
27302	1733	21	2	29	0	1785
27303	55	1692	3	42	0	1792
27304	27	1707	4	53	0	1791
27305	16	37	11	1704	0	1768
27306	12	1686	19	73	0	1790
27307	1728	28	29	36	0	1821
27308	66	6	24	1737	0	1833
27309	1742	4	20	46	0	1812
27310	1762	11	18	28	0	1819
27311	59	11	15	1726	0	1811
27312	20	20	10	1799	0	1849
27313	1724	26	12	63	0	1825
27314	1740	12	11	51	0	1814
27315	1779	11	9	56	0	1855
27316	1767	9	12	49	0	1837
27317	1794	3	3	46	0	1846
27318	65	12	5	1775	0	1857
27319	56	13	7	1779	0	1855
27320	53	11	8	1795	0	1867
27321	1759	24	14	60	0	1857
27322	66	20	10	1678	0	1774
27323	28	1728	8	79	0	1843
27324	31	49	3	1787	0	1870
27325	1758	24	8	59	0	1849
27326	1799	21	5	32	0	1857
27327	81	20	1638	26	0	1765
27328	46	22	32	1629	0	1729
27329	29	1695	15	60	0	1799
27330	1701	55	12	51	0	1819
27331	53	1716	14	38	0	1821
27332	39	42	13	1778	0	1872
27333	1756	21	10	53	0	1840
27334	1775	9	6	34	0	1824
27335	77	1701	4	46	0	1828
27336	49	39	0	1786	0	1874
27337	36	15	1664	76	0	1791
27338	1766	11	33	62	0	1872
27339	79	4	1697	39	0	1819
27340	1790	2	37	30	0	1859
27341	1805	8	10	33	0	1856
27342	82	14	4	1792	0	1892
27343	1783	12	4	70	0	1869
27344	1798	22	2	53	0	1875
27345	1800	16	4	49	0	1869
27346	59	14	2	1817	0	1892
27347	1792	24	9	72	0	1897
27348	61	18	7	1811	0	1897
27349	45	16	7	1794	0	1862
27350	50	1738	6	65	0	1859
27351	56	34	14	1788	0	1892
27352	1	387	1	5	0	394
27353	382	4	0	4	0	390
27354	385	3	0	1	0	389
27355	8	1	1	382	0	392
27356	4	0	0	377	0	381
27357	370	1	2	7	0	380
27358	6	0	366	5	0	377
27359	365	1	5	2	0	373
27360	7	1	2	361	0	371
27361	5	0	351	5	0	361
27362	352	1	5	4	0	362
27363	363	2	2	0	0	367
27364	8	0	369	3	0	380
27365	374	1	3	2	0	380
27366	7	0	371	0	0	378
27367	5	379	4	1	0	389
27368	387	3	4	2	0	396
27369	383	4	1	0	0	388
27370	8	369	0	0	0	377
27371	2	338	0	2	0	342
27372	321	4	2	2	0	329
27373	322	2	0	1	0	325
27374	6	0	0	333	0	339
27375	2	0	329	4	0	335
27376	0	1	323	2	0	326
27377	334	0	3	1	0	338
27378	5	0	335	0	0	340
27379	314	0	9	2	0	325
27380	3	0	1	314	0	318
27381	2	0	0	316	0	318
27382	0	0	321	5	0	326
27383	325	0	3	2	0	330
27384	3	0	2	331	0	336
27385	2	0	0	350	0	352
27386	343	0	0	5	0	348
27387	351	0	0	2	0	353
27388	341	0	0	0	0	341
27389	5	340	0	0	0	345
27390	2	3	318	0	0	323
27391	316	1	3	0	0	320
27392	328	0	1	0	0	329
27393	4	316	0	0	0	320
27394	304	2	0	3	0	309
27395	2	1	0	298	0	301
27396	1	0	309	3	0	313
27397	305	0	2	1	0	308
27398	316	0	1	0	0	317
27399	316	0	0	0	0	316
27400	312	0	0	0	0	312
27401	3	0	0	314	0	317
27402	1	1	0	313	0	315
27403	314	0	0	3	0	317
27404	2	0	0	316	0	318
27405	1	0	0	311	0	312
27406	0	313	0	3	0	316
27407	0	2	0	318	0	320
27408	0	1	0	318	0	319
27409	0	0	0	322	0	322
27410	0	0	0	327	0	327
27411	0	315	0	3	0	318
27412	0	1	0	314	0	315
27413	0	1	0	310	0	311
27414	0	0	312	2	0	314
27415	0	0	303	1	0	304
27416	0	306	1	0	0	307
27417	356	1	2	0	0	359
27418	3	361	0	0	0	364
27419	1	3	0	382	0	386
27420	0	1	434	4	0	439
27421	461	0	3	1	0	465
27422	2	0	2	480	0	484
27423	477	0	0	3	0	480
27424	480	0	0	2	0	482
27425	4	476	0	0	0	480
27426	480	3	0	0	0	483
27427	3	478	0	0	0	481
27428	2	3	0	496	0	501
27429	0	498	0	4	0	502
27430	1	4	492	2	0	499
27431	0	498	4	1	0	503
27432	1	4	3	495	0	503
27433	498	3	0	4	0	505
27434	3	493	0	3	0	499
27435	4	4	0	494	0	502
27436	0	4	0	506	0	510
27437	2	0	498	8	0	508
27438	0	1	4	499	0	504
27439	0	0	505	4	0	509
27440	500	1	4	3	0	508
27441	4	1	516	2	0	523
27442	5	520	3	0	0	528
27443	1	6	3	517	0	527
27444	1	3	0	525	0	529
27445	0	0	1	531	0	532
27446	520	0	1	7	0	528
27447	3	0	0	525	0	528
27448	4	526	1	4	0	535
27449	513	4	0	1	0	518
27450	5	512	1	1	0	519
27451	4	6	0	512	0	522
27452	512	4	0	6	0	522
27453	4	508	1	4	0	517
27454	4	518	1	1	0	524
27455	512	5	1	1	0	519
27456	515	3	0	1	0	519
27457	8	1	513	0	0	522
27458	525	1	4	0	0	530
27459	5	2	526	0	0	533
27460	3	1	4	539	0	547
27461	1	0	532	6	0	539
27462	0	2	5	534	0	541
27463	0	0	527	5	0	532
27464	1	1	5	507	0	514
27465	2	1	1	518	0	522
27466	509	0	2	7	0	518
27467	4	3	489	9	0	505
27468	485	0	4	2	0	491
27469	4	0	487	2	0	493
27470	3	0	488	1	0	492
27471	1	3	3	482	0	489
27472	479	2	4	3	0	488
27473	4	477	0	3	0	484
27474	465	3	1	1	0	470
27475	460	4	0	0	0	464
27476	5	457	1	2	0	465
27477	458	3	0	0	0	461
27478	3	4	466	1	0	474
27479	3	0	4	466	0	473
27480	465	0	2	5	0	472
27481	5	462	1	4	0	472
27482	3	4	1	452	0	460
27483	2	3	0	457	0	462
27484	1	0	1	459	0	461
27485	1	1	0	464	0	466
27486	451	1	1	5	0	458
27487	445	1	1	3	0	450
27488	454	0	1	2	0	457
27489	458	0	0	1	0	459
27490	5	1	453	1	0	460
27491	452	0	3	1	0	456
27492	445	0	4	1	0	450
27493	5	447	0	3	0	455
27494	2	452	2	1	0	457
27495	2	6	1	449	0	458
27496	1	3	1	448	0	453
27497	2	1	438	7	0	448
27498	1	453	3	3	0	460
27499	2	3	3	443	0	451
27500	2	453	1	3	0	459
27501	2	3	0	458	0	463
27502	2	2	1	450	0	455
27503	0	479	3	5	0	487
27504	0	4	0	484	0	488
27505	2	2	482	5	0	491
27506	0	2	483	3	0	488
27507	485	1	7	1	0	494
27508	489	0	3	2	0	494
27509	6	487	2	2	0	497
27510	489	5	0	2	0	496
27511	7	2	1	494	0	504
27512	496	3	0	5	0	504
27513	7	494	1	5	0	507
27514	5	5	493	1	0	504
27515	492	3	8	1	0	504
27516	9	2	511	1	0	523
27517	3	0	459	1	0	463
27518	5	3	454	0	0	462
27519	1	439	7	0	0	447
27520	374	12	11	1	0	398
27521	359	1	2	3	0	365
27522	3	2	0	367	0	372
27523	3	0	1	366	0	370
27524	1	367	1	4	0	373
27525	370	2	1	3	0	376
27526	3	373	0	1	0	377
27527	0	367	0	1	0	368
27528	363	3	1	1	0	368
27529	1	1	1	360	0	363
27530	1	1	0	361	0	363
27531	1	0	1	363	0	365
27532	1	364	1	2	0	368
27533	359	1	0	2	0	362
27534	3	2	0	354	0	359
27535	2	341	0	1	0	344
27536	4	345	1	1	0	351
27537	2	1	0	343	0	346
27538	1	346	0	1	0	348
27539	1	3	0	342	0	346
27540	334	1	2	2	0	339
27541	1	1	331	2	0	335
27542	0	330	1	1	0	332
27543	8	1	1	322	0	332
27544	0	1	329	1	0	331
27545	335	1	1	1	0	338
27546	1	1	0	342	0	344
27547	335	0	1	1	0	337
27548	337	0	0	0	0	337
27549	1	365	0	1	0	367
27550	366	1	0	0	0	367
27551	368	0	0	0	0	368
27552	369	1	0	0	0	370
27553	2	0	0	366	0	368
27554	1	0	0	369	0	370
27555	1	0	0	369	0	370
27556	0	0	370	2	0	372
27557	0	369	1	2	0	372
27558	354	1	1	1	0	357
27559	1	348	2	0	0	351
27560	1	2	0	345	0	348
27561	2	0	343	1	0	346
27562	328	2	1	0	0	331
27563	2	344	0	1	0	347
27564	0	1	1	341	0	343
27565	1	0	0	345	0	346
27566	0	2	340	1	0	343
27567	0	341	2	1	0	344
27568	1	1	0	348	0	350
27569	0	0	2	351	0	353
27570	0	1	1	350	0	352
27571	347	0	1	2	0	350
27572	1	1	342	1	0	345
27573	1	343	1	2	0	347
27574	350	1	0	0	0	351
27575	1	347	1	1	0	350
27576	0	2	0	351	0	353
27577	1	352	0	1	0	354
27578	343	2	0	0	0	345
27579	341	1	0	1	0	343
27580	1	1	0	344	0	346
27581	2	0	0	344	0	346
27582	1	0	0	350	0	351
27583	0	0	359	4	0	363
27584	0	365	1	2	0	368
27585	0	3	0	429	0	432
27586	1	0	1	443	0	445
27587	0	1	1	454	0	456
27588	0	0	0	461	0	461
27589	1	1	463	7	0	472
27590	0	508	2	5	0	515
27591	0	6	3	540	0	549
27592	0	4	0	593	0	597
27593	3	2	583	9	0	597
27594	0	0	6	591	0	597
27595	0	582	4	6	0	592
27596	0	597	1	4	0	602
27597	0	7	1	592	0	600
27598	1	5	572	7	0	585
27599	548	1	5	5	0	559
27600	5	578	4	3	0	590
27601	5	7	577	0	0	589
27602	1	6	576	1	0	584
27603	3	569	11	4	0	587
27604	0	6	577	1	0	584
27605	0	7	5	564	0	576
27606	573	1	5	5	0	584
27607	569	0	2	4	0	575
27608	570	2	1	0	0	573
27609	579	1	0	1	0	581
27610	6	586	1	2	0	595
27611	596	4	1	1	0	602
27612	7	590	0	3	0	600
27613	6	6	590	0	0	602
27614	1	5	5	585	0	596
27615	0	597	3	5	0	605
27616	1	6	2	571	0	580
27617	557	5	0	5	0	567
27618	5	4	1	546	0	556
27619	3	551	1	6	0	561
27620	557	5	1	4	0	567
27621	5	6	546	2	0	559
27622	5	0	6	543	0	554
27623	1	0	5	546	0	552
27624	535	2	1	9	0	547
27625	7	535	0	6	0	548
27626	6	5	522	2	0	535
27627	2	3	7	527	0	539
27628	2	2	507	8	0	519
27629	2	508	6	5	0	521
27630	1	515	4	1	0	521
27631	510	10	4	1	0	525
27632	5	5	510	2	0	522
27633	519	2	6	1	0	528
27634	6	1	5	510	0	522
27635	5	511	2	6	0	524
27636	511	6	1	4	0	522
27637	6	6	516	1	0	529
27638	6	0	7	512	0	525
27639	2	1	5	513	0	521
27640	1	1	1	519	0	522
27641	2	506	0	9	0	517
27642	498	6	1	5	0	510
27643	5	500	1	4	0	510
27644	4	495	1	3	0	503
27645	4	8	1	481	0	494
27646	484	5	0	7	0	496
27647	478	3	1	4	0	486
27648	483	3	0	2	0	488
27649	12	452	0	1	0	465
27650	5	5	1	452	0	463
27651	5	4	444	6	0	459
27652	2	2	5	446	0	455
27653	1	2	5	445	0	453
27654	3	446	0	9	0	458
27655	450	7	2	6	0	465
27656	6	4	2	442	0	454
27657	4	438	1	20	0	463
27658	454	7	0	7	0	468
27659	9	7	444	2	0	462
27660	444	1	7	1	0	453
27661	8	448	4	1	0	461
27662	450	9	2	1	0	462
27663	451	5	0	1	0	457
27664	12	2	444	0	0	458
27665	450	0	8	0	0	458
27666	9	1	460	0	0	470
27667	5	3	453	0	0	461
27668	448	0	10	2	0	460
27669	450	1	6	0	0	457
27670	13	0	462	1	0	476
27671	6	1	7	455	0	469
27672	2	1	4	458	0	465
27673	2	464	3	16	0	485
27674	473	6	0	7	0	486
27675	481	6	1	2	0	490
27676	13	1	483	1	0	498
27677	483	1	6	2	0	492
27678	491	2	3	1	0	497
27679	10	479	1	2	0	492
27680	8	6	1	480	0	495
27681	4	6	1	482	0	493
27682	3	2	2	483	0	490
27683	464	1	1	10	0	476
27684	7	453	2	6	0	468
27685	2	15	1	383	0	401
27686	2	373	0	9	0	384
27687	1	24	2	338	0	365
27688	5	346	1	5	0	357
27689	2	352	1	1	0	356
27690	289	11	5	7	0	312
27691	287	4	2	5	0	298
27692	3	3	0	232	0	238
27693	5	0	0	231	0	236
27694	1	0	0	227	0	228
27695	0	0	0	234	0	234
27696	0	0	0	231	0	231
27697	0	225	0	5	0	230
27698	1	2	0	225	0	228
27699	2	2	0	223	0	227
27700	222	1	1	4	0	228
27701	3	0	0	228	0	231
27702	2	0	0	232	0	234
27703	2	0	236	4	0	242
27704	1	1	2	228	0	232
27705	0	0	2	242	0	244
27706	0	0	248	5	0	253
27707	1	250	1	3	0	255
27708	1	3	261	1	0	266
27709	0	2	262	1	0	265
27710	0	248	2	0	0	250
27711	255	3	3	2	0	263
27712	262	2	0	0	0	264
27713	2	2	0	258	0	262
27714	273	0	0	1	0	274
27715	3	0	294	2	0	299
27716	2	0	2	298	0	302
27717	0	0	325	3	0	328
27718	0	0	2	322	0	324
27719	0	0	2	325	0	327
27720	0	0	0	333	0	333
27721	330	1	0	4	0	335
27722	2	0	0	333	0	335
27723	343	0	0	3	0	346
27724	347	0	0	2	0	349
27725	3	348	0	1	0	352
27726	348	2	0	1	0	351
27727	2	365	1	0	0	368
27728	1	2	0	366	0	369
27729	0	2	0	366	0	368
27730	0	1	1	371	0	373
27731	1	1	367	4	0	373
27732	0	362	3	2	0	367
27733	0	3	2	352	0	357
27734	2	4	0	351	0	357
27735	1	366	1	4	0	372
27736	370	2	0	1	0	373
27737	2	359	1	1	0	363
27738	363	2	0	1	0	366
27739	2	377	1	2	0	382
27740	2	3	0	366	0	371
27741	0	382	1	2	0	385
27742	386	3	0	4	0	393
27743	395	3	0	1	0	399
27744	402	0	0	1	0	403
27745	406	1	0	0	0	407
27746	5	0	412	2	0	419
27747	410	1	2	1	0	414
27748	419	0	2	2	0	423
27749	420	1	0	2	0	423
27750	6	3	1534	3	0	1546
27751	1543	3	2	0	0	1548
27752	2	1547	3	3	0	1555
27753	1640	2	0	3	0	1645
27754	4	8	2335	5	0	2352
27755	2358	1	1	1	0	2361
27756	2449	0	2	1	0	2452
27757	4	1	2	2418	0	2425
27758	5	0	2402	2	0	2409
27759	2358	0	1	3	0	2362
27760	2	0	2	2445	0	2449
27761	2	1	0	2405	0	2408
27762	3	0	2436	6	0	2445
27763	2136	1	3	5	0	2145
27764	2425	1	1	0	0	2427
27765	5	2288	4	2	0	2299
27766	2	1	1	2462	0	2466
27767	1	3	0	2445	0	2449
27768	3	0	0	2430	0	2433
27769	1	2340	2	3	0	2346
27770	2461	1	1	1	0	2464
27771	3	2	0	2455	0	2460
27772	2	2	0	2443	0	2447
27773	2464	0	0	4	0	2468
27774	2385	0	0	3	0	2388
27775	6	0	0	2411	0	2417
27776	3	0	0	2408	0	2411
27777	2	1	2348	5	0	2356
27778	2132	0	3	2	0	2137
27779	3	2249	4	1	0	2257
27780	4	2	0	2449	0	2455
27781	0	3	0	2459	0	2462
27782	0	2369	2	6	0	2377
27783	2	6	0	2493	0	2501
27784	2536	3	1	7	0	2547
27785	7	1	0	2671	0	2679
27786	4	2	0	2681	0	2687
27787	0	0	0	2739	0	2739
27788	1	1	2687	24	0	2713
27789	1	1	11	2584	0	2597
27790	4	4	2614	20	0	2642
27791	0	2517	21	12	0	2550
27792	0	10	5	2690	0	2705
27793	2	4	4	2659	0	2669
27794	2	4	2	2684	0	2692
27795	0	0	1	2633	0	2634
27796	0	1	1	2672	0	2674
27797	2621	2	3	21	0	2647
27798	14	2	2620	12	0	2648
27799	5	2514	13	12	0	2544
27800	6	2595	7	9	0	2617
27801	0	15	3	2706	0	2724
27802	0	10	1	2678	0	2689
27803	2	6	1	2681	0	2690
27804	4	2612	6	22	0	2644
27805	1	15	0	2706	0	2722
27806	2	8	2606	19	0	2635
27807	1	3595	19	12	0	3627
27808	0	14	5	3868	0	3887
27809	3837	6	4	18	0	3865
27810	12	4	1	3812	0	3829
27811	4	3	0	3815	0	3822
27812	4	3659	3	21	0	3687
27813	5	3701	3	13	0	3722
27814	6	14	5	3842	0	3867
27815	2	9	1	3803	0	3815
27816	1	6	3733	22	0	3762
27817	1	2	12	3648	0	3663
27818	0	3	8	3780	0	3791
27819	1	5	4	3779	0	3789
27820	0	3	2	3785	0	3790
27821	3793	1	2	27	0	3823
27822	3689	1	6	17	0	3713
27823	16	3	0	3767	0	3786
27824	10	3	0	4520	0	4533
27825	4495	2	2	172	0	4671
27826	157	1	2	4566	0	4726
27827	60	8	4371	181	0	4620
27828	14	4293	143	61	0	4511
27829	5	149	50	4505	0	4709
27830	7	50	8	4642	0	4707
27831	4476	10	6	229	0	4721
27832	159	6	10	4553	0	4728
27833	63	10	2	4712	0	4787
27834	4519	4	7	241	0	4771
27835	163	8	11	4565	0	4747
27836	59	4350	14	181	0	4604
27837	17	147	1	4628	0	4793
27838	16	56	2	4736	0	4810
27839	20	12	3	4668	0	4703
27840	13	4	1	4770	0	4788
27841	16	10	4361	266	0	4653
27842	23	11	5084	100	0	5218
27843	11	15	203	5124	0	5353
27844	3	20	64	5304	0	5391
27845	3	5038	19	245	0	5305
27846	17	163	13	5279	0	5472
27847	13	5074	14	207	0	5308
27848	5157	165	10	98	0	5430
27849	164	5139	25	47	0	5375
27850	64	171	16	5469	0	5720
27851	19	67	6	5537	0	5629
27852	19	29	5282	251	0	5581
27853	4836	23	149	106	0	5114
27854	4721	21	51	58	0	4851
27855	215	4533	12	57	0	4817
27856	79	165	10	4614	0	4868
27857	30	73	4587	161	0	4851
27858	11	4526	161	84	0	4782
27859	4697	160	67	54	0	4978
27860	4813	68	26	37	0	4944
27861	239	28	4530	42	0	4839
27862	4586	19	164	42	0	4811
27863	197	36	67	5763	0	6063
27864	77	5617	35	253	0	5982
27865	5893	259	25	85	0	6262
27866	270	90	18	5883	0	6261
27867	5965	35	15	300	0	6315
27868	6146	12	18	131	0	6307
27869	357	13	23	5886	0	6279
27870	119	34	5724	298	0	6175
27871	5654	42	241	125	0	6062
27872	6052	39	57	81	0	6229
27873	6009	26	27	92	0	6154
27874	322	6694	20	80	0	7116
27875	127	266	14	6836	0	7243
27876	66	71	19	7857	0	8013
27877	65	44	7238	421	0	7768
27878	68	22	263	7174	0	7527
27879	39	7328	104	367	0	7838
27880	7238	314	36	155	0	7743
27881	293	7304	27	165	0	7789
27882	122	341	7014	105	0	7582
27883	69	7133	273	124	0	7599
27884	38	7511	118	99	0	7766
27885	54	377	78	7227	0	7736
27886	7189	157	42	355	0	7743
27887	7334	68	50	152	0	7604
27888	7218	78	33	87	0	7416
27889	393	6930	37	77	0	7437
27890	146	309	6828	86	0	7369
27891	7081	144	268	54	0	7547
27892	7410	73	92	67	0	7642
27893	422	7068	49	91	0	7630
27894	7373	323	30	86	0	7812
27895	389	110	64	7219	0	7782
27896	195	83	7028	329	0	7635
27897	7199	61	292	127	0	7679
27898	7397	84	117	73	0	7671
27899	7614	61	64	71	0	7810
27900	435	60	43	7233	0	7771
27901	173	73	59	7421	0	7726
27902	146	64	25	7539	0	7774
27903	146	7024	40	410	0	7620
27904	140	309	44	7320	0	7813
27905	102	127	44	7733	0	8006
27906	128	78	7156	449	0	7811
27907	84	55	267	6418	0	6824
27908	98	84	96	6641	0	6919
27909	123	48	32	6631	0	6834
27910	101	62	33	6581	0	6777
27911	125	6155	69	445	0	6794
27912	106	315	52	6495	0	6968
27913	91	121	52	6721	0	6985
27914	6397	70	71	470	0	7008
27915	407	79	6140	227	0	6853
27916	203	77	6292	146	0	6718
27917	5960	84	367	151	0	6562
27918	6497	92	136	138	0	6863
27919	482	95	59	5317	0	5953
27920	183	6158	79	330	0	6750
27921	6365	329	95	144	0	6933
27922	412	152	46	6153	0	6763
27923	213	6184	89	379	0	6865
27924	5507	152	32	104	0	5795
27925	186	5503	28	75	0	5792
27926	5537	182	29	68	0	5816
27927	5603	92	9	81	0	5785
27928	237	5417	34	60	0	5748
27929	132	182	30	5513	0	5857
27930	96	102	5332	209	0	5739
27931	85	81	150	5448	0	5764
27932	5519	38	58	214	0	5829
27933	221	70	5248	130	0	5669
27934	118	5276	178	109	0	5681
27935	96	174	77	5403	0	5750
27936	74	94	5239	236	0	5643
27937	88	5224	188	124	0	5624
27938	5432	182	87	93	0	5794
27939	210	110	60	5389	0	5769
27940	117	71	50	5475	0	5713
27941	88	77	50	5388	0	5603
27942	56	4659	48	282	0	5045
27943	4677	183	27	155	0	5042
27944	196	4574	56	126	0	4952
27945	114	4761	36	129	0	5040
27946	4790	216	28	128	0	5162
27947	4858	125	43	88	0	5114
27948	253	94	4507	100	0	4954
27949	4687	86	155	86	0	5014
27950	3651	88	81	75	0	3895
27951	273	73	52	3531	0	3929
27952	163	66	3392	220	0	3841
27953	109	53	183	3567	0	3912
27954	3576	37	74	237	0	3924
27955	273	39	3397	128	0	3837
27956	142	52	157	3532	0	3883
27957	110	50	103	4114	0	4377
27958	100	55	58	4384	0	4597
27959	4091	54	43	377	0	4565
27960	292	4106	59	170	0	4627
27961	4235	283	39	138	0	4695
27962	329	99	4038	151	0	4617
27963	92	55	164	2878	0	3189
27964	82	2960	61	226	0	3329
27965	3013	186	36	116	0	3351
27966	238	71	35	3028	0	3372
27967	102	43	2838	233	0	3216
27968	67	44	165	3066	0	3342
27969	2859	52	72	244	0	3227
27970	191	2887	41	127	0	3246
27971	72	1004	42	1881	0	2999
27972	61	2893	63	194	0	3211
27973	2910	177	49	138	0	3274
27974	1973	49	23	44	0	2089
27975	172	1938	22	49	0	2181
27976	1269	107	3	7	0	1386
27977	110	14	6	1213	0	1343
27978	20	1244	7	99	0	1370
27979	1250	105	3	16	0	1374
27980	1361	17	1	9	0	1388
27981	114	1199	0	15	0	1328
27982	18	1300	6	9	0	1333
27983	1244	101	4	6	0	1355
27984	108	17	4	1244	0	1373
27985	1251	16	1	101	0	1369
27986	103	19	1	1245	0	1368
27987	29	11	1173	106	0	1319
27988	12	10	83	1246	0	1351
27989	1227	5	13	104	0	1349
27990	108	10	1165	25	0	1308
27991	23	7	96	1193	0	1319
27992	13	8	10	1327	0	1358
27993	16	7	1184	119	0	1326
27994	1191	8	99	25	0	1323
27995	110	3	9	1209	0	1331
27996	24	9	1123	110	0	1266
27997	1081	15	100	16	0	1212
27998	100	1124	11	17	0	1252
27999	18	1151	11	17	0	1197
28000	14	1182	11	10	0	1217
28001	24	104	1068	14	0	1210
28002	10	37	87	1100	0	1234
28003	7	15	1030	109	0	1161
28004	16	30	84	995	0	1125
28005	13	896	18	106	0	1033
28006	17	1014	12	25	0	1068
28007	11	106	10	966	0	1093
28008	941	21	4	113	0	1079
28009	101	16	13	962	0	1092
28010	20	10	6	1040	0	1076
28011	15	923	7	113	0	1058
28012	953	90	12	28	0	1083
28013	108	941	5	32	0	1086
28014	20	106	11	957	0	1094
28015	19	32	6	1014	0	1071
28016	27	926	12	114	0	1079
28017	18	102	11	991	0	1122
28018	943	20	9	168	0	1140
28019	135	28	10	967	0	1140
28020	41	52	7	1027	0	1127
28021	56	912	13	127	0	1108
28022	30	107	42	971	0	1150
28023	927	31	14	156	0	1128
28024	1021	45	8	53	0	1127
28025	1053	34	5	42	0	1134
28026	129	24	10	971	0	1134
28027	46	30	891	122	0	1089
28028	44	20	957	58	0	1079
28029	54	26	93	960	0	1133
28030	946	48	9	131	0	1134
28031	123	29	10	979	0	1141
28032	958	48	10	129	0	1145
28033	152	27	4	963	0	1146
28034	82	24	14	1041	0	1161
28035	974	45	9	131	0	1159
28036	156	33	892	42	0	1123
28037	951	32	95	52	0	1130
28038	128	43	908	43	0	1122
28039	81	23	87	950	0	1141
28040	990	10	23	123	0	1146
28041	141	40	910	38	0	1129
28042	41	44	997	27	0	1109
28043	980	20	104	42	0	1146
28044	136	14	921	55	0	1126
28045	61	909	109	38	0	1117
28046	37	92	27	1020	0	1176
28047	1032	15	44	142	0	1233
28048	115	11	1007	65	0	1198
28049	1072	17	99	44	0	1232
28050	1131	10	50	42	0	1233
28051	1117	9	27	66	0	1219
28052	1135	16	21	59	0	1231
28053	129	21	45	997	0	1192
28054	55	986	21	120	0	1182
28055	1034	102	21	65	0	1222
28056	134	21	1006	38	0	1199
28057	2	372	5	0	0	379
28058	320	4	3	0	0	327
28059	3	287	0	0	0	290
28060	1	282	1	1	0	285
28061	7	5	1	280	0	293
28062	0	1	0	288	0	289
28063	0	0	0	287	0	287
28064	293	0	0	3	0	296
28065	305	0	0	1	0	306
28066	3	0	0	324	0	327
28067	1	0	0	349	0	350
28068	0	0	380	3	0	383
28069	390	0	3	1	0	394
28070	400	0	1	0	0	401
28071	5	0	0	395	0	400
28072	1	0	0	395	0	396
28073	0	0	395	5	0	400
28074	0	0	4	394	0	398
28075	0	0	395	4	0	399
28076	0	391	5	1	0	397
28077	0	3	403	0	0	406
28078	0	0	4	391	0	395
28079	0	0	402	4	0	406
28080	0	0	392	1	0	393
28081	395	0	5	0	0	400
28082	3	0	1	417	0	421
28083	1	0	413	4	0	418
28084	404	0	4	2	0	410
28085	3	0	424	0	0	427
28086	2	3	464	0	0	469
28087	0	470	6	1	0	477
28088	0	4	2	473	0	479
28089	0	1	463	4	0	468
28090	0	0	477	2	0	479
28091	0	0	6	472	0	478
28092	1	0	2	473	0	476
28093	1	483	0	6	0	490
28094	0	3	0	497	0	500
28095	499	2	0	5	0	506
28096	497	0	1	2	0	500
28097	505	0	0	0	0	505
28098	7	0	0	488	0	495
28099	2	3502	8	6	0	3518
28100	3762	4	1	3	0	3770
28101	3	3545	5	0	0	3553
28102	2	3547	4	1	0	3554
28103	1	3642	1	1	0	3645
28104	3763	7	0	0	0	3770
28105	3	2	2	3670	0	3677
28106	2	0	1	3720	0	3723
28107	1	3638	1	7	0	3647
28108	3718	3	3	2	0	3726
28109	9	3	3656	0	0	3668
28110	2	0	3	3671	0	3676
28111	3797	0	3	4	0	3804
28112	5	3676	1	3	0	3685
28113	3823	3	1	0	0	3827
28114	6	3	0	6475	0	6484
28115	4	6268	7	6	0	6285
28116	3	9	6132	5	0	6149
28117	6064	2	5	1	0	6072
28118	4	1	3	6576	0	6584
28119	6644	0	1	5	0	6650
28120	5	1	0	6555	0	6561
28121	2	6310	2	11	0	6325
28122	2	6	6390	2	0	6400
28123	2	11	6200	0	0	6213
28124	2	2	6	6285	0	6295
28125	6683	0	2	4	0	6689
28126	6553	1	0	4	0	6558
28127	5	2	0	6499	0	6506
28128	3	2	0	6509	0	6514
28129	6703	0	0	5	0	6708
28130	4	1	0	6626	0	6631
28131	6739	1	0	4	0	6744
28132	6	6445	2	11	0	6464
28133	6555	2	1	3	0	6561
28134	5	3	6580	1	0	6589
28135	6	1	5	6504	0	6516
28136	3	0	2	6534	0	6539
28137	0	0	1	6650	0	6651
28138	0	6428	2	14	0	6444
28139	1	6157	4	12	0	6174
28140	0	7	1	6690	0	6698
28141	4	4	6534	6	0	6548
28142	0	3	5	6314	0	6322
28143	0	3	6	6495	0	6504
28144	1	638	2	5962	0	6603
28145	6611	2	3	3	0	6619
28146	5	6345	6	2	0	6358
28147	6	6315	4	4	0	6329
28148	1	12	1	6491	0	6505
28149	1	3	2	6472	0	6478
28150	3	3	1	6321	0	6328
28151	0	0	4	6459	0	6463
28152	6575	0	2	5	0	6582
28153	4	6260	8	7	0	6279
28154	6541	2	1	4	0	6548
28155	6500	2	3	3	0	6508
28156	4	0	2	6433	0	6439
28157	3	1	0	6402	0	6406
28158	6559	2	1	8	0	6570
28159	6321	3	2	5	0	6331
28160	4	1	1	6356	0	6362
28161	6	1	0	6330	0	6337
28162	6	1	6431	7	0	6445
28163	2	5955	10	7	0	5974
28164	1	6273	3	5	0	6282
28165	6351	7	0	2	0	6360
28166	5	7	6253	0	0	6265
28167	5	11	5810	1	0	5827
28168	5552	3	5	2	0	5562
28169	6087	1	2	1	0	6091
28170	2	5957	4	2	0	5965
28171	4	6067	4	1	0	6076
28172	4	5	0	6302	0	6311
28173	6384	2	0	2	0	6388
28174	6281	0	1	4	0	6286
28175	6237	0	2	4	0	6243
28176	2	1	0	6122	0	6125
28177	3	2	0	6205	0	6210
28178	3	4	5992	3	0	6002
28179	5	14	5428	6	0	5453
28180	3	1	5890	1	0	5895
28181	0	10	4	5810	0	5824
28182	6023	2	1	2	0	6028
28183	4	2	6069	2	0	6077
28184	3	1	1	5943	0	5948
28185	1	5879	11	7	0	5898
28186	2	2	1	6177	0	6182
28187	2	1	0	6034	0	6037
28188	3	3	6126	1	0	6133
28189	0	3	1	5876	0	5880
28190	5921	3	5	4	0	5933
28191	3	4	6066	2	0	6075
28192	6	1	2	6033	0	6042
28193	4	2	6160	4	0	6170
28194	2	5551	15	7	0	5575
28195	5	13	5980	2	0	6000
28196	4	4	14	5646	0	5668
28197	0	2	3	6042	0	6047
28198	3	2	6117	12	0	6134
28199	0	0	8	3053	0	3061
28200	0	0	3	3088	0	3091
28201	2	3032	5	10	0	3049
28202	2	9	3083	4	0	3098
28203	0	4	5	3016	0	3025
28204	0	4	2	3194	0	3200
28205	0	3108	6	9	0	3123
28206	2	6	0	3279	0	3287
28207	3276	1	2	7	0	3286
28208	6	2	2	3244	0	3254
28209	5	0	3226	8	0	3239
28210	2966	0	10	5	0	2981
28211	3064	2	6	5	0	3077
28212	10	1	3227	1	0	3239
28213	2894	2	10	3	0	2909
28214	9	3033	7	5	0	3054
28215	4	101	5	2979	0	3089
28216	3	81	2	3309	0	3395
28217	3	43	2	3288	0	3336
28218	1	32	2	3366	0	3401
28219	1	33	2	3543	0	3579
28220	3283	29	2	296	0	3610
28221	116	18	3208	210	0	3552
28222	3311	5	111	154	0	3581
28223	161	6	3231	111	0	3509
28224	127	7	151	3346	0	3631
28225	3318	5	117	174	0	3614
28226	177	13	79	3151	0	3420
28227	143	3258	66	165	0	3632
28228	3332	121	60	141	0	3654
28229	167	91	32	3499	0	3789
28230	135	57	3199	215	0	3606
28231	3246	46	116	181	0	3589
28232	171	3335	99	130	0	3735
28233	134	135	3402	109	0	3780
28234	102	105	153	3370	0	3730
28235	69	55	142	3375	0	3641
28236	69	3336	92	264	0	3761
28237	67	152	3392	181	0	3792
28238	47	123	178	3591	0	3939
28239	45	88	3514	262	0	3909
28240	46	106	196	3678	0	4026
28241	36	82	148	3795	0	4061
28242	55	76	3444	428	0	4003
28243	57	41	200	3746	0	4044
28244	46	29	178	3680	0	3933
28245	75	24	111	3867	0	4077
28246	126	28	115	3947	0	4216
28247	3587	32	161	419	0	4199
28248	271	34	3485	287	0	4077
28249	3706	33	250	236	0	4225
28250	240	38	170	3768	0	4216
28251	239	42	122	3847	0	4250
28252	148	68	75	3830	0	4121
28253	132	3644	92	389	0	4257
28254	3787	167	87	320	0	4361
28255	200	137	79	3869	0	4285
28256	170	3771	126	359	0	4426
28257	149	194	79	4103	0	4525
28258	5283	195	109	335	0	5922
28259	5293	109	141	279	0	5822
28260	5228	94	96	301	0	5719
28261	296	5092	95	287	0	5770
28262	205	226	5211	263	0	5905
28263	5178	132	232	233	0	5775
28264	5422	107	177	246	0	5952
28265	331	5240	195	200	0	5966
28266	5500	176	109	261	0	6046
28267	5289	141	137	271	0	5838
28268	5526	92	157	222	0	5997
28269	406	5359	79	280	0	6124
28270	291	223	71	5658	0	6243
28271	5542	164	76	395	0	6177
28272	5714	91	37	383	0	6225
28273	5669	101	61	266	0	6097
28274	5765	99	113	212	0	6189
28275	510	91	80	5617	0	6298
28276	345	102	5336	347	0	6130
28277	291	86	180	5472	0	6029
28278	243	5411	150	421	0	6225
28279	214	264	88	5821	0	6387
28280	237	192	7570	427	0	8426
28281	7617	149	353	416	0	8535
28282	463	172	228	7956	0	8819
28283	7886	123	165	611	0	8785
28284	8076	105	91	426	0	8698
28285	753	74	181	8021	0	9029
28286	598	85	7761	467	0	8911
28287	414	119	7594	341	0	8468
28288	7472	74	571	291	0	8408
28289	609	7522	331	273	0	8735
28290	486	7832	202	237	0	8757
28291	348	7723	167	227	0	8465
28292	338	8212	178	182	0	8910
28293	7937	615	140	187	0	8879
28294	8164	404	137	194	0	8899
28295	8236	289	109	201	0	8835
28296	8325	235	104	246	0	8910
28297	829	221	98	7498	0	8646
28298	593	7696	99	452	0	8840
28299	8111	386	109	362	0	8968
28300	693	243	7438	308	0	8682
28301	502	7589	410	263	0	8764
28302	349	376	7819	254	0	8798
28303	7759	314	470	264	0	8807
28304	8158	244	325	216	0	8943
28305	8173	176	229	289	0	8867
28306	718	207	208	7943	0	9076
28307	509	151	7638	487	0	8785
28308	408	7774	386	408	0	8976
28309	7857	378	236	237	0	8708
28310	684	7817	155	229	0	8885
28311	536	7800	126	264	0	8726
28312	360	7970	226	184	0	8740
28313	347	8307	212	190	0	9056
28314	77	281	5305	17	0	5680
28315	53	5653	190	22	0	5918
28316	5443	252	97	17	0	5809
28317	211	168	47	5407	0	5833
28318	122	109	20	5655	0	5906
28319	5519	77	29	255	0	5880
28320	206	5428	38	124	0	5796
28321	161	206	5424	50	0	5841
28322	72	141	196	5430	0	5839
28323	95	63	100	5544	0	5802
28324	88	37	42	5823	0	5990
28325	49	60	5505	337	0	5951
28326	67	47	5663	136	0	5913
28327	37	64	278	5585	0	5964
28328	61	38	5675	226	0	6000
28329	46	60	5528	142	0	5776
28330	4773	51	326	90	0	5240
28331	237	5282	153	83	0	5755
28332	142	5484	86	75	0	5787
28333	117	5696	79	62	0	5954
28334	85	311	69	5052	0	5517
28335	94	5542	100	169	0	5905
28336	5621	252	82	105	0	6060
28337	254	153	5398	76	0	5881
28338	5544	153	222	35	0	5954
28339	267	109	104	5551	0	6031
28340	127	130	86	5545	0	5888
28341	105	6863	47	267	0	7282
28342	6896	276	78	123	0	7373
28343	6992	150	42	69	0	7253
28344	383	7064	63	65	0	7575
28345	241	246	36	7123	0	7646
28346	138	170	6998	272	0	7578
28347	134	108	7008	154	0	7404
28348	115	7054	321	93	0	7583
28349	7224	291	184	57	0	7756
28350	315	198	7154	53	0	7720
28351	213	140	291	7071	0	7715
28352	7289	102	161	287	0	7839
28353	7416	118	93	132	0	7759
28354	438	7770	107	103	0	8418
28355	213	8294	103	96	0	8706
28356	8282	388	112	71	0	8853
28357	384	211	8084	64	0	8743
28358	7185	166	280	80	0	7711
28359	7337	175	145	47	0	7704
28360	442	185	86	7090	0	7803
28361	244	161	7027	286	0	7718
28362	160	153	7192	142	0	7647
28363	7154	105	393	84	0	7736
28364	423	87	7144	74	0	7728
28365	7116	84	371	85	0	7656
28366	7238	76	195	98	0	7607
28367	436	7002	130	124	0	7692
28368	272	322	6863	65	0	7522
28369	168	7012	371	67	0	7618
28370	7065	356	195	66	0	7682
28371	376	199	6897	60	0	7532
28372	226	142	348	6840	0	7556
28373	190	86	6955	307	0	7538
28374	141	116	7142	172	0	7571
28375	130	97	7142	124	0	7493
28376	115	96	7107	96	0	7414
28377	121	6683	521	91	0	7416
28378	130	338	6800	69	0	7337
28379	141	6838	430	100	0	7509
28380	36	121	4597	11	0	4765
28381	4607	40	134	11	0	4792
28382	124	38	65	4095	0	4322
28383	54	4596	53	74	0	4777
28384	4610	102	55	27	0	4794
28385	4608	40	51	26	0	4725
28386	4497	49	52	12	0	4610
28387	4545	32	44	11	0	4632
28388	162	4502	43	14	0	4721
28389	4479	119	40	16	0	4654
28390	4481	59	38	24	0	4602
28391	135	4385	65	14	0	4599
28392	88	117	4174	9	0	4388
28393	66	59	126	4142	0	4393
28394	70	4287	68	84	0	4509
28395	69	106	4323	39	0	4537
28396	56	50	4322	50	0	4478
28397	74	4219	152	24	0	4469
28398	73	4289	89	18	0	4469
28399	64	4389	58	13	0	4524
28400	55	6426	59	10	0	6550
28401	6432	155	48	16	0	6651
28402	6395	92	53	14	0	6554
28403	184	69	6382	20	0	6655
28404	121	51	6271	25	0	6468
28405	76	58	156	6247	0	6537
28406	70	42	106	6311	0	6529
28407	70	39	104	6451	0	6664
28408	6367	58	70	131	0	6626
28409	142	6176	85	61	0	6464
28410	103	6270	66	51	0	6490
28411	98	6404	67	33	0	6602
28412	6360	185	78	22	0	6645
28413	6464	94	76	34	0	6668
28414	176	83	89	6363	0	6711
28415	6485	58	74	113	0	6730
28416	6402	60	89	59	0	6610
28417	194	66	65	6411	0	6736
28418	6472	51	77	137	0	6737
28419	187	6258	76	59	0	6580
28420	127	151	72	6368	0	6718
28421	119	89	6109	113	0	6430
28422	83	6121	154	67	0	6425
28423	95	169	6139	38	0	6441
28424	97	92	176	5822	0	6187
28425	90	6135	115	118	0	6458
28426	106	127	101	6158	0	6492
28427	93	83	75	6236	0	6487
28428	80	89	6108	163	0	6440
28429	99	65	6080	71	0	6315
28430	87	63	189	6103	0	6442
28431	101	73	106	5967	0	6247
28432	91	6086	108	129	0	6414
28433	5975	179	73	73	0	6300
28434	174	6047	80	62	0	6363
28435	128	6169	70	41	0	6408
28436	89	212	5790	39	0	6130
28437	63	5933	171	66	0	6233
28438	72	171	97	5664	0	6004
28439	71	5940	104	125	0	6240
28440	59	163	126	5873	0	6221
28441	19	4528	36	96	0	4679
28442	4589	104	1608	36	0	6337
28443	88	6251	27	29	0	6395
28444	30	88	28	6057	0	6203
28445	28	5939	22	66	0	6055
28446	6073	89	17	23	0	6202
28447	6115	46	14	25	0	6200
28448	89	5806	21	19	0	5935
28449	5984	78	22	8	0	6092
28450	97	69	18	5622	0	5806
28451	44	32	5613	66	0	5755
28452	28	37	5407	32	0	5504
28453	20	5444	88	32	0	5584
28454	4906	38	27	13	0	4984
28455	4727	17	7	5	0	4756
28456	26	16	4557	3	0	4602
28457	15	23	4070	8	0	4116
28458	4211	7	22	6	0	4246
28459	4516	4	5	8	0	4533
28460	29	11	4431	0	0	4471
28461	3887	8	25	7	0	3927
28462	22	4243	10	7	0	4282
28463	11	4408	6	7	0	4432
28464	7	30	7	4521	0	4565
28465	5	7	9	4493	0	4514
28466	4534	15	2	21	0	4572
28467	4341	5	5	10	0	4361
28468	4386	7	2	3	0	4398
28469	21	4	6	4446	0	4477
28470	12	5	6	4479	0	4502
28471	10	4186	2	25	0	4223
28472	8	4326	4	3	0	4341
28473	7	4398	6	5	0	4416
28474	9	22	2	4399	0	4432
28475	7	4242	6	17	0	4272
28476	9	41	3821	6	0	3877
28477	3422	11	19	12	0	3464
28478	22	7	3945	6	0	3980
28479	14	18	3752	4	0	3788
28480	3725	6	21	1	0	3753
28481	21	3808	8	4	0	3841
28482	4088	18	7	5	0	4118
28483	3987	8	6	7	0	4008
28484	21	13	3842	4	0	3880
28485	11	13	3673	6	0	3703
28486	13	3625	23	8	0	3669
28487	9	19	3695	2	0	3725
28488	8	8	16	3654	0	3686
28489	6	8	15	3401	0	3430
28490	5	3636	16	23	0	3680
28491	3	3774	11	11	0	3799
28492	3899	23	4	6	0	3932
28493	3833	16	3	4	0	3856
28494	20	15	2	3836	0	3873
28495	15	6	2	3937	0	3960
28496	3872	5	3	21	0	3901
28497	3811	3	11	8	0	3833
28498	18	3780	10	10	0	3818
28499	3891	16	6	5	0	3918
28500	16	2334	7	2	0	2359
28501	12	2343	3	1	0	2359
28502	2462	24	2	0	0	2488
28503	2387	10	3	4	0	2404
28504	16	6	1	2306	0	2329
28505	2393	4	3	9	0	2409
28506	16	1	2302	6	0	2325
28507	10	2273	11	3	0	2297
28508	2376	12	6	5	0	2399
28509	12	8	2348	8	0	2376
28510	5	17	8	2243	0	2273
28511	2	2154	6	7	0	2169
28512	5	2241	2	8	0	2256
28513	2343	10	13	1	0	2367
28514	10	4	2251	3	0	2268
28515	2178	3	7	0	0	2188
28516	7	2	4	2234	0	2247
28517	7	1	2215	5	0	2228
28518	2948	1	8	5	0	2962
28519	6	2937	9	4	0	2956
28520	3	3039	11	1	0	3054
28521	3229	9	2	1	0	3241
28522	3185	6	0	2	0	3193
28523	3224	4	1	3	0	3232
28524	10	1	2	3126	0	3139
28525	9	0	1	3138	0	3148
28526	7	2	3124	7	0	3140
28527	5	0	2990	6	0	3001
28528	3	2933	19	6	0	2961
28529	3	9	3	3125	0	3140
28530	3130	6	1	3	0	3140
28531	4	2984	2	4	0	2994
28532	3	5	0	3125	0	3133
28533	3115	3	0	5	0	3123
28534	5	2980	2	4	0	2991
28535	13	2947	1	3	0	2964
28536	3	25	2792	4	0	2824
28537	2868	3	7	3	0	2881
28538	3056	2	3	1	0	3062
28539	10	4	2975	0	0	2989
28540	2735	4	5	0	0	2744
28541	6	2	2991	0	0	2999
28542	3	1516	3	1	0	1523
28543	8	4	2	1552	0	1566
28544	1554	4	1	3	0	1562
28545	6	1510	0	2	0	1518
28546	2	1514	3	3	0	1522
28547	1517	4	0	0	0	1521
28548	4	3	1545	1	0	1553
28549	1515	2	4	0	0	1521
28550	5	1545	1	2	0	1553
28551	2	6	1524	0	0	1532
28552	1509	3	3	0	0	1515
28553	1583	2	1	0	0	1586
28554	5	1	2	1550	0	1558
28555	5	1	0	1569	0	1575
28556	1	1522	1	7	0	1531
28557	2	2	1553	4	0	1561
28558	0	1	4	1515	0	1520
28559	0	4	1628	2	0	1634
28560	1	3	1621	1	0	1626
28561	1	3	3	1653	0	1660
28562	2	1	1693	3	0	1699
28563	4	2	1671	2	0	1679
28564	1	4	6	1649	0	1660
28565	6	0	1707	4	0	1717
28566	1583	2	8	5	0	1598
28567	4	1558	4	7	0	1573
28568	3	3	1725	0	0	1731
28569	5	4	1758	3	0	1770
28570	3	4	6	1695	0	1708
28571	1810	1	7	4	0	1822
28572	1800	0	3	4	0	1807
28573	1802	1	3	4	0	1810
28574	1820	2	0	1	0	1823
28575	11	2	0	1785	0	1798
28576	10	1	1800	3	0	1814
28577	1799	3	4	3	0	1809
28578	1824	2	2	6	0	1834
28579	1841	1	5	0	0	1847
28580	12	0	1815	3	0	1830
28581	1735	0	4	0	0	1739
28582	9	4	2	1875	0	1890
28583	2	1873	6	11	0	1892
28584	6	11	3	1902	0	1922
28585	1	1846	2	14	0	1863
28586	1888	11	0	4	0	1903
28587	14	4	1915	3	0	1936
28588	3	4	12	1903	0	1922
28589	6	1878	8	13	0	1905
28590	0	1923	6	4	0	1933
28591	1967	11	1	4	0	1983
28592	1946	4	2	1	0	1953
28593	16	4	1861	1	0	1882
28594	1855	0	12	0	0	1867
28595	14	1	3	1875	0	1893
28596	4	1	1946	14	0	1965
28597	6	2	1925	1	0	1934
28598	1	3	14	1936	0	1954
28599	2648	2	4	13	0	2667
28600	72	6	6	3991	0	4075
28601	37	2	2	4261	0	4302
28602	18	4	1	4163	0	4186
28603	4	4172	7	200	0	4383
28604	2	149	3	4317	0	4471
28605	4029	45	3	183	0	4260
28606	136	4178	4	65	0	4383
28607	47	148	5	4290	0	4490
28608	4028	44	9	162	0	4243
28609	141	4093	3	58	0	4295
28610	41	4277	6	37	0	4361
28611	32	174	1	4217	0	4424
28612	4251	67	1	155	0	4474
28613	159	28	4203	63	0	4453
28614	61	19	4223	29	0	4332
28615	5517	19	180	29	0	5745
28616	5782	20	65	33	0	5900
28617	259	5728	37	45	0	6069
28618	105	213	17	4846	0	5181
28619	54	75	5064	225	0	5418
28620	27	58	5136	86	0	5307
28621	31	26	5134	79	0	5270
28622	32	4881	285	43	0	5241
28623	14	5192	98	38	0	5342
28624	5157	265	47	38	0	5507
28625	236	102	5112	32	0	5482
28626	5234	70	226	27	0	5557
28627	5363	47	82	40	0	5532
28628	303	42	4978	48	0	5371
28629	133	5127	225	29	0	5514
28630	77	235	101	5170	0	5583
28631	43	91	5267	234	0	5635
28632	55	68	5191	91	0	5405
28633	4985	49	278	55	0	5367
28634	225	5303	145	38	0	5711
28635	113	246	80	4846	0	5285
28636	76	108	57	4887	0	5128
28637	60	5057	57	263	0	5437
28638	42	5246	60	106	0	5454
28639	36	5432	62	62	0	5592
28640	36	326	61	5338	0	5761
28641	5253	133	55	254	0	5695
28642	250	87	56	5484	0	5877
28643	115	68	5309	283	0	5775
28644	87	72	5452	115	0	5726
28645	65	53	307	5420	0	5845
28646	50	42	5317	281	0	5690
28647	56	5320	276	127	0	5779
28648	54	264	115	5511	0	5944
28649	5497	133	105	277	0	6012
28650	5494	123	66	144	0	5827
28651	328	5586	50	142	0	6106
28652	5592	277	67	71	0	6007
28653	5759	148	56	66	0	6029
28654	5937	114	55	81	0	6187
28655	380	96	5118	77	0	5671
28656	5416	84	241	78	0	5819
28657	320	5424	119	103	0	5966
28658	143	285	5546	64	0	6038
28659	120	156	5569	78	0	5923
28660	96	5563	332	80	0	6071
28661	5521	272	182	81	0	6056
28662	315	131	115	5157	0	5718
28663	148	5502	94	280	0	6024
28664	5469	309	113	137	0	6028
28665	305	141	88	5582	0	6116
28666	5468	128	65	379	0	6040
28667	346	123	78	5713	0	6260
28668	172	133	5406	405	0	6116
28669	147	118	5576	224	0	6065
28670	160	128	5620	151	0	6059
28671	159	140	381	5322	0	6002
28672	155	131	163	5738	0	6187
28673	145	147	5374	377	0	6043
28674	150	5487	304	209	0	6150
28675	5431	339	162	144	0	6076
28676	5449	204	166	119	0	5938
28677	429	5483	121	136	0	6169
28678	229	322	158	5464	0	6173
28679	181	158	5574	284	0	6197
28680	5601	162	378	136	0	6277
28681	403	129	5599	141	0	6272
28682	241	132	5554	114	0	6041
28683	168	117	5734	142	0	6161
28684	5452	137	491	119	0	6199
28685	340	100	5523	108	0	6071
28686	194	5280	451	100	0	6025
28687	127	5659	262	87	0	6135
28688	115	406	221	5231	0	5973
28689	155	207	168	5559	0	6089
28690	166	155	5334	355	0	6010
28691	5375	90	370	166	0	6001
28692	5615	123	200	144	0	6082
28693	435	127	184	5444	0	6190
28694	5418	113	173	305	0	6009
28695	349	5422	159	217	0	6147
28696	5317	323	168	134	0	5942
28697	362	5145	168	129	0	5804
28698	210	5548	174	126	0	6058
28699	4650	320	129	120	0	5219
28700	2956	68	52	52	0	3128
28701	3076	49	46	43	0	3214
28702	3174	32	38	43	0	3287
28703	158	22	2904	48	0	3132
28704	3024	37	115	49	0	3225
28705	137	45	60	2784	0	3026
28706	62	2960	55	112	0	3189
28707	2886	118	31	72	0	3107
28708	119	2982	42	57	0	3200
28709	2996	127	36	37	0	3196
28710	163	57	34	2900	0	3154
28711	87	44	34	3039	0	3204
28712	88	29	2839	126	0	3082
28713	65	40	2907	63	0	3075
28714	74	2964	145	45	0	3228
28715	1308	21	9	1	0	1339
28716	25	1299	4	2	0	1330
28717	10	1267	4	4	0	1285
28718	6	1308	4	4	0	1322
28719	13	23	1244	3	0	1283
28720	7	1262	19	3	0	1291
28721	1171	20	11	4	0	1206
28722	1161	8	2	1	0	1172
28723	24	3	4	1132	0	1163
28724	11	1140	2	23	0	1176
28725	10	1162	2	6	0	1180
28726	8	25	0	1151	0	1184
28727	11	4	1115	20	0	1150
28728	2	1082	20	4	0	1108
28729	8	22	3	1045	0	1078
28730	1011	4	2	21	0	1038
28731	1015	3	4	3	0	1025
28732	25	1020	2	3	0	1050
28733	1023	23	4	1	0	1051
28734	1036	5	2	0	0	1043
28735	23	2	1	1017	0	1043
28736	3	7	995	24	0	1029
28737	5	1008	21	6	0	1040
28738	4	30	7	994	0	1035
28739	7	3	959	18	0	987
28740	11	913	14	6	0	944
28741	855	20	4	5	0	884
28742	865	5	2	3	0	875
28743	13	6	2	843	0	864
28744	3	848	5	16	0	872
28745	2	30	826	1	0	859
28746	5	8	15	835	0	863
28747	5	5	828	18	0	856
28748	1	747	11	4	0	763
28749	8	18	1	609	0	636
28750	585	3	2	7	0	597
28751	10	581	2	0	0	593
28752	569	8	0	0	0	577
28753	552	0	1	4	0	557
28754	9	576	0	1	0	586
28755	0	9	1	577	0	587
28756	3	5	1	565	0	574
28757	1	547	1	7	0	556
28758	0	566	0	2	0	568
28759	2	8	0	515	0	525
28760	2	530	0	7	0	539
28761	524	7	1	2	0	534
28762	527	3	2	0	0	532
28763	9	1	527	0	0	537
28764	4	3	517	0	0	524
28765	510	1	7	3	0	521
28766	509	3	2	1	0	515
28767	6	537	2	1	0	546
28768	535	8	1	1	0	545
28769	531	4	2	1	0	538
28770	8	534	2	2	0	546
28771	534	5	2	2	0	543
28772	6	4	1	627	0	638
28773	3	2	1	641	0	647
28774	1	3	665	9	0	678
28775	0	667	11	2	0	680
28776	6	674	2	3	0	685
28777	617	16	4	15	0	652
28778	619	7	1	2	0	629
28779	618	1	1	3	0	623
28780	628	3	1	0	0	632
28781	14	2	612	3	0	631
28782	5	4	618	0	0	627
28783	3	619	10	1	0	633
28784	3	9	4	611	0	627
28785	3	4	1	616	0	624
28786	2	623	1	13	0	639
28787	0	12	3	618	0	633
28788	614	5	2	9	0	630
28789	12	618	2	4	0	636
28790	4	11	626	6	0	647
28791	3	651	10	1	0	665
28792	652	12	3	1	0	668
28793	13	2	650	5	0	670
28794	638	3	13	1	0	655
28795	649	4	6	1	0	660
28796	15	4	639	3	0	661
28797	6	2	647	2	0	657
28798	8	3	626	2	0	639
28799	599	3	15	0	0	617
28800	15	1	613	1	0	630
28801	7	591	10	3	0	611
28802	586	10	3	0	0	599
28803	10	6	584	0	0	600
28804	571	1	11	2	0	585
28805	11	0	584	1	0	596
28806	2	5	608	0	0	615
28807	3	594	11	3	0	611
28808	4	7	599	2	0	612
28809	2	8	601	2	0	613
28810	2	546	10	3	0	561
28811	588	8	4	0	0	600
28812	10	5	589	0	0	604
28813	3	1	10	548	0	562
28814	2	581	4	7	0	594
28815	594	10	1	3	0	608
28816	596	4	3	2	0	605
28817	18	1	1880	0	0	1899
28818	3	1806	13	1	0	1823
28819	4	1840	5	1	0	1850
28820	1	14	3	1967	0	1985
28821	2	1913	3	13	0	1931
28822	4	11	4	1957	0	1976
28823	1	8	3	1945	0	1957
28824	3	1924	1	14	0	1942
28825	4	11	3	1971	0	1989
28826	3	1957	3	10	0	1973
28827	6	15	1935	5	0	1961
28828	6	4	11	1862	0	1883
28829	2	3	10	1930	0	1945
28830	2	1917	4	12	0	1935
28831	6	1928	3	4	0	1941
28832	2	15	3	1973	0	1993
28833	2	1920	3	16	0	1941
28834	1967	15	2	6	0	1990
28835	13	5	2	1951	0	1971
28836	7	1908	4	11	0	1930
28837	1992	15	0	5	0	2012
28838	12	1912	3	3	0	1930
28839	5	16	1939	0	0	1960
28840	5	4	12	1850	0	1871
28841	1938	3	7	10	0	1958
28842	13	2	1942	7	0	1964
28843	9	3	11	1862	0	1885
28844	1	1845	11	8	0	1865
28845	5	8	1880	4	0	1897
28846	0	3488	19	4	0	3511
28847	3696	10	5	0	0	3711
28848	3687	5	8	3	0	3703
28849	14	3509	7	3	0	3533
28850	3710	14	2	0	0	3726
28851	12	6	3591	1	0	3610
28852	9	3	12	3436	0	3460
28853	2	3	11	3510	0	3526
28854	7	3480	5	11	0	3503
28855	3696	12	4	6	0	3718
28856	4481	9	5	2	0	4497
28857	14	4	4419	0	0	4437
28858	4318	5	12	1	0	4336
28859	4455	3	5	1	0	4464
28860	4481	3	6	1	0	4491
28861	15	3	3	4447	0	4468
28862	4	6	3	4452	0	4465
28863	4	4314	3	11	0	4332
28864	4539	11	3	4	0	4557
28865	4404	3	4	2	0	4413
28866	15	4403	3	4	0	4425
28867	3	16	1	4474	0	4494
28868	3	4370	2	13	0	4388
28869	2	4467	0	5	0	4474
28870	4452	15	7	1	0	4475
28871	19	7	4373	4	0	4403
28872	5	5	4099	2	0	4111
28873	1	4151	13	0	0	4165
28874	4142	5	7	1	0	4155
28875	4	6	4196	0	0	4206
28876	3	3590	18	4	0	3615
28877	4175	2	2	1	0	4180
28878	4	7	3974	1	0	3986
28879	3	1	2	3856	0	3862
28880	4240	0	3	2	0	4245
28881	4	2	3894	4	0	3904
28882	3	3	3856	0	0	3862
28883	1	1	3917	0	0	3919
28884	1	2	3899	0	0	3902
28885	3506	1	12	2	0	3521
28886	4011	0	2	0	0	4013
28887	4	3840	5	1	0	3850
28888	3	1	1	3967	0	3972
28889	0	2	0	4080	0	4082
28890	0	3879	5	5	0	3889
28891	1	1	0	4078	0	4080
28892	0	3923	1	1	0	3925
28893	1	4018	1	8	0	4028
28894	0	4	0	4075	0	4079
28895	0	7	3935	1	0	3943
28896	0	3723	8	5	0	3736
28897	1	1	2	4054	0	4058
28898	4074	3	1	1	0	4079
28899	2	3	3895	3	0	3903
28900	3791	0	3	0	0	3794
28901	3980	0	4	1	0	3985
28902	5	1	0	3835	0	3841
28903	6	1	3944	2	0	3953
28904	1	4	3849	6	0	3860
28905	0	3686	23	2	0	3711
28906	1	4	9	3874	0	3888
28907	0	5	4014	4	0	4023
28908	4	3	3849	5	0	3861
28909	1	3517	29	8	0	3555
28910	4030	5	4	2	0	4041
28911	3973	7	0	1	0	3981
28912	9	1	0	3852	0	3862
28913	6	1	3965	5	0	3977
28914	3	7	3757	9	0	3776
28915	0	3401	40	5	0	3446
28916	1	10	3732	0	0	3743
28917	2	8	2810	2	0	2822
28918	2	6	17	2377	0	2402
28919	1	3	2848	7	0	2859
28920	2592	2	13	5	0	2612
28921	6	1	5	2854	0	2866
28922	6	3	2902	9	0	2920
28923	4	2612	12	5	0	2633
28924	3	8	4	4263	0	4278
28925	3	5	4168	16	0	4192
28926	0	3922	30	13	0	3965
28927	2	16	10	4145	0	4173
28928	0	4168	12	14	0	4194
28929	1	25	3	4256	0	4285
28930	0	10	4	4274	0	4288
28931	3	16	4077	24	0	4120
28932	1	4020	23	20	0	4064
28933	2	14	7	4266	0	4289
28934	1	9	12	4238	0	4260
28935	0	15	3	4312	0	4330
28936	0	7	4087	39	0	4133
28937	1	3912	31	25	0	3969
28938	0	18	9	4257	0	4284
28939	1	13	4122	26	0	4162
28940	1	3949	33	19	0	4002
28941	2	21	10	4208	0	4241
28942	1	20	4087	28	0	4136
28943	1	3974	33	22	0	4030
28944	3	22	12	4117	0	4154
28945	0	15	18	4241	0	4274
28946	2	21	2829	37	0	2889
28947	2631	10	26	35	0	2702
28948	15	2798	21	34	0	2868
28949	2896	32	18	28	0	2974
28950	25	29	2816	24	0	2894
28951	2843	28	27	25	0	2923
28952	28	18	16	2719	0	2781
28953	10	15	22	2915	0	2962
28954	17	17	2757	42	0	2833
28955	2588	17	34	41	0	2680
28956	2162	11	21	36	0	2230
28957	24	2167	23	32	0	2246
28958	21	2258	14	35	0	2328
28959	2289	31	17	33	0	2370
28960	22	31	2233	30	0	2316
28961	16	2307	39	19	0	2381
28962	18	40	22	2283	0	2363
28963	10	30	32	2363	0	2435
28964	13	33	2291	45	0	2382
28965	2323	25	35	44	0	2427
28966	26	26	2337	47	0	2436
28967	2365	22	39	38	0	2464
28968	36	18	2354	40	0	2448
28969	22	2400	49	37	0	2508
28970	2439	33	26	27	0	2525
28971	2454	24	32	21	0	2531
28972	2422	36	24	20	0	2502
28973	2466	28	21	26	0	2541
28974	52	14	23	2448	0	2537
28975	31	27	2403	41	0	2502
28976	31	21	30	2428	0	2510
28977	23	2394	31	69	0	2517
28978	23	34	32	2502	0	2591
28979	29	31	2438	43	0	2541
28980	33	37	2433	29	0	2532
28981	28	28	45	2484	0	2585
28982	2458	28	42	33	0	2561
28983	2432	25	34	37	0	2528
28984	2482	18	32	43	0	2575
28985	57	17	2447	32	0	2553
28986	47	19	2423	28	0	2517
28987	49	2417	45	27	0	2538
28988	42	2485	48	30	0	2605
28989	2463	31	46	18	0	2558
28990	2459	28	32	25	0	2544
28991	45	5309	41	29	0	5424
28992	5666	42	19	33	0	5760
28993	5578	29	27	33	0	5667
28994	68	5460	28	17	0	5573
28995	5774	36	19	26	0	5855
28996	5698	28	17	31	0	5774
28997	62	5543	29	25	0	5659
28998	5779	41	25	34	0	5879
28999	5369	24	33	40	0	5466
29000	42	31	5582	41	0	5696
29001	45	33	5379	38	0	5495
29002	33	5265	52	32	0	5382
29003	30	5522	44	30	0	5626
29004	5688	22	56	26	0	5792
29005	5603	31	34	13	0	5681
29006	5603	35	18	12	0	5668
29007	70	5475	28	18	0	5591
29008	55	34	29	5724	0	5842
29009	45	39	5568	26	0	5678
29010	46	32	34	5320	0	5432
29011	43	5544	26	37	0	5650
29012	5710	43	24	23	0	5800
29013	61	5464	22	28	0	5575
29014	52	33	20	5654	0	5759
29015	6991	26	32	24	0	7073
29016	6933	39	23	21	0	7016
29017	129	28	6628	24	0	6809
29018	6843	25	65	13	0	6946
29019	6998	24	62	15	0	7099
29020	7076	19	32	12	0	7139
29021	159	19	20	6847	0	7045
29022	110	6820	26	57	0	7013
29023	70	63	37	7174	0	7344
29024	18	43	5458	43	0	5562
29025	12	5601	46	46	0	5705
29026	13	47	34	5728	0	5822
29027	16	47	5581	51	0	5695
29028	16	5557	51	42	0	5666
29029	17	60	41	5533	0	5651
29030	21	39	5578	51	0	5689
29031	4399	15	62	52	0	4528
29032	56	13	5662	14	0	5745
29033	41	11	5355	22	0	5429
29034	12	5471	96	12	0	5591
29035	8	49	51	5555	0	5663
29036	12	49	22	5385	0	5468
29037	7	5431	20	72	0	5530
29038	11	64	10	5728	0	5813
29039	5705	50	12	60	0	5827
29040	5560	15	13	55	0	5643
29041	97	13	5473	18	0	5601
29042	5289	11	56	14	0	5370
29043	5535	8	49	11	0	5603
29044	104	19	5455	11	0	5589
29045	57	5384	65	25	0	5531
29046	19	5585	45	16	0	5665
29047	26	105	14	5024	0	5169
29048	16	5507	18	44	0	5585
29049	20	69	5139	33	0	5261
29050	26	53	4959	26	0	5064
29051	23	5222	102	9	0	5356
29052	5462	62	50	12	0	5586
29053	5511	53	30	12	0	5606
29054	5562	18	24	9	0	5613
29055	5514	25	19	10	0	5568
29056	5400	24	18	10	0	5452
29057	103	5273	20	10	0	5406
29058	50	73	5211	12	0	5346
29059	23	54	60	5287	0	5424
29060	5243	29	58	59	0	5389
29061	56	5276	20	53	0	5405
29062	55	64	23	5379	0	5521
29063	41	48	5218	58	0	5365
29064	45	4969	63	51	0	5128
29065	37	5293	52	17	0	5399
29066	5324	110	24	14	0	5472
29067	81	5252	23	13	0	5369
29068	65	80	20	5256	0	5421
29069	5265	70	18	64	0	5417
29070	5167	29	16	49	0	5261
29071	5250	25	11	24	0	5310
29072	121	29	4915	22	0	5087
29073	81	4963	67	24	0	5135
29074	5280	71	57	17	0	5425
29075	86	71	29	5148	0	5334
29076	5255	38	15	61	0	5369
29077	92	5077	14	57	0	5240
29078	5330	73	16	27	0	5446
29079	5410	65	23	18	0	5516
29080	142	33	14	5241	0	5430
29081	99	26	5266	75	0	5466
29082	61	25	92	5290	0	5468
29083	5366	31	59	84	0	5540
29084	5349	25	32	69	0	5475
29085	151	5226	38	31	0	5446
29086	5334	78	23	34	0	5469
29087	118	5249	41	28	0	5436
29088	5353	102	22	25	0	5502
29089	5131	74	23	60	0	5288
29090	152	67	5083	30	0	5332
29091	82	2737	71	73	0	2963
29092	42	94	78	2728	0	2942
29093	54	79	29	2815	0	2977
29094	55	39	31	2706	0	2831
29095	44	2700	51	114	0	2909
29096	37	122	2659	71	0	2889
29097	45	88	2700	50	0	2883
29098	54	3029	128	37	0	3248
29099	3073	105	65	34	0	3277
29100	115	78	3037	19	0	3249
29101	2998	32	116	27	0	3173
29102	104	3028	91	22	0	3245
29103	81	109	4713	53	0	4956
29104	46	79	94	4657	0	4876
29105	47	59	4921	103	0	5130
29106	40	43	4864	98	0	5045
29107	76	47	136	4579	0	4838
29108	90	4740	76	84	0	4990
29109	65	4845	59	50	0	5019
29110	4982	138	39	18	0	5177
29111	139	84	4804	28	0	5055
29112	4795	40	118	18	0	4971
29113	4857	70	74	24	0	5025
29114	141	4839	59	36	0	5075
29115	3600	37	5	4	0	3646
29116	3572	18	4	2	0	3596
29117	3479	4	4	4	0	3491
29118	42	3418	5	3	0	3468
29119	20	3283	13	1	0	3317
29120	10	3325	6	4	0	3345
29121	3450	39	5	1	0	3495
29122	3428	13	7	1	0	3449
29123	47	9	4512	5	0	4573
29124	16	19	4047	1	0	4083
29125	4574	6	30	1	0	4611
29126	4711	4	10	3	0	4728
29127	4721	5	5	1	0	4732
29128	36	2	2	4589	0	4629
29129	14	2	1	4563	0	4580
29130	2	5	6	4624	0	4637
29131	5	5	5	4619	0	4634
29132	12	0	4602	31	0	4645
29133	10	13	4295	9	0	4327
29134	8	7	4368	4	0	4387
29135	5	8	4151	6	0	4170
29136	4222	5	29	6	0	4262
29137	26	4220	13	7	0	4266
29138	14	4339	9	4	0	4366
29139	4529	29	7	2	0	4567
29140	23	19	5493	3	0	5538
29141	11	22	5031	3	0	5067
29142	5159	4	30	8	0	5201
29143	5404	4	10	0	0	5418
29144	29	5394	10	3	0	5436
29145	16	24	6	5661	0	5707
29146	5673	10	5	23	0	5711
29147	5604	5	10	11	0	5630
29148	38	2	4	5594	0	5638
29149	17	5492	3	27	0	5539
29150	5623	24	6	12	0	5665
29151	27	16	5524	7	0	5574
29152	5284	4	25	8	0	5321
29153	29	5352	13	6	0	5400
29154	5656	26	5	3	0	5690
29155	5571	12	8	3	0	5594
29156	34	7	5522	3	0	5566
29157	24	15	5075	3	0	5117
29158	5169	8	34	3	0	5214
29159	5592	8	15	3	0	5618
29160	30	5401	8	7	0	5446
29161	20	25	7	5644	0	5696
29162	12	14	5459	24	0	5509
29163	5282	7	28	8	0	5325
29164	29	5	12	5579	0	5625
29165	18	8	5	5603	0	5634
29166	5658	7	4	31	0	5700
29167	25	5433	11	19	0	5488
29168	5664	22	9	5	0	5700
29169	5538	10	8	7	0	5563
29170	5557	7	6	4	0	5574
29171	34	5475	9	8	0	5526
29172	5670	22	5	6	0	5703
29173	31	14	3	5567	0	5615
29174	20	16	0	5432	0	5468
29175	14	6	5526	29	0	5575
29176	16	7	5216	11	0	5250
29177	12	5268	32	11	0	5323
29178	7	5258	17	14	0	5296
29179	22	25	5162	2	0	5211
29180	8	5007	28	6	0	5049
29181	5364	25	13	7	0	5409
29182	5300	10	11	3	0	5324
29183	5328	5	5	4	0	5342
29184	26	5	4	5107	0	5142
29185	10	8	2	5290	0	5310
29186	12	1	5270	27	0	5310
29187	5	4880	28	16	0	4929
29188	5345	17	9	2	0	5373
29189	23	5026	12	5	0	5066
29190	5341	16	3	5	0	5365
29191	5325	10	3	6	0	5344
29192	25	7	5	5157	0	5194
29193	14	8	4	5081	0	5107
29194	10	7	0	5293	0	5310
29195	13	7	5121	30	0	5171
29196	6	4744	26	15	0	4791
29197	8	4941	17	7	0	4973
29198	3	4633	4	6	0	4646
29199	2	4649	3	8	0	4662
29200	2	4724	4	5	0	4735
29201	4429	11	8	4	0	4452
29202	10	12	4388	0	0	4410
29203	3	3003	8	3	0	3017
29204	3	18	2846	1	0	2868
29205	1	2942	5	3	0	2951
29206	5	15	8	2730	0	2758
29207	6	7	3	3042	0	3058
29208	1	3033	4	8	0	3046
29209	3014	5	2	4	0	3025
29210	5	7	2883	2	0	2897
29211	2	2934	6	5	0	2947
29212	5	10	2895	3	0	2913
29213	2	5	5	2982	0	2994
29214	3	7	2	2932	0	2944
29215	4	2951	5	4	0	2964
29216	1	5	4	3079	0	3089
29217	0	3	0	3056	0	3059
29218	0	2951	2	12	0	2965
29219	0	14	2823	5	0	2842
29220	1	14	2820	2	0	2837
29221	2763	5	10	2	0	2780
29222	3021	4	2	2	0	3029
29223	4	3	2	1808	0	1817
29224	2	5	1823	4	0	1834
29225	2	1	6	1779	0	1788
29226	2	1824	7	4	0	1837
29227	3	6	1847	4	0	1860
29228	1	1758	9	4	0	1772
29229	0	15	1801	1	0	1817
29230	1	1800	9	4	0	1814
29231	1877	5	1	4	0	1887
29232	4	5	3	1804	0	1816
29233	5	3	2	1817	0	1827
29234	2	2	1863	9	0	1876
29235	1	5	1770	6	0	1782
29236	1	1758	12	2	0	1773
29237	1911	4	3	4	0	1922
29238	3	1	4	1858	0	1866
29239	1	5	1931	5	0	1942
29240	1	2	907	2	0	912
29241	876	2	5	4	0	887
29242	903	3	2	1	0	909
29243	7	1	931	2	0	941
29244	2	5	9	918	0	934
29245	3	935	6	3	0	947
29246	955	3	2	1	0	961
29247	6	947	0	4	0	957
29248	927	2	4	1	0	934
29249	4	925	2	2	0	933
29250	2	2980	2	4	0	2988
29251	1	72	7	2919	0	2999
29252	4	35	3	2778	0	2820
29253	1	2891	12	99	0	3003
29254	5	81	3037	34	0	3157
29255	3	46	3102	14	0	3165
29256	3	16	3126	25	0	3170
29257	2879	11	124	18	0	3032
29258	2874	17	55	12	0	2958
29259	111	2984	37	4	0	3136
29260	36	84	3049	3	0	3172
29261	17	29	113	3062	0	3221
29262	24	11	3112	93	0	3240
29263	21	18	3189	37	0	3265
29264	10	19	135	3078	0	3242
29265	6	14	58	3308	0	3386
29266	3	15	3271	143	0	3432
29267	4509	10	122	54	0	4695
29268	161	4964	74	29	0	5228
29269	78	5307	34	31	0	5450
29270	29	273	20	4796	0	5118
29271	4934	125	17	170	0	5246
29272	216	5205	14	96	0	5531
29273	5203	246	14	37	0	5500
29274	252	5663	11	38	0	5964
29275	5775	323	25	38	0	6161
29276	339	160	5529	32	0	6060
29277	154	91	5793	37	0	6075
29278	91	71	373	6580	0	7115
29279	80	90	6474	336	0	6980
29280	79	6239	369	158	0	6845
29281	50	6918	235	63	0	7266
29282	6539	453	149	80	0	7221
29283	344	211	126	5997	0	6678
29284	171	6684	132	333	0	7320
29285	6731	429	94	168	0	7422
29286	6774	260	67	79	0	7180
29287	8143	157	89	67	0	8456
29288	611	110	100	7831	0	8652
29289	309	108	108	8265	0	8790
29290	208	94	7754	578	0	8634
29291	180	75	8038	318	0	8611
29292	7916	78	593	182	0	8769
29293	488	116	295	7815	0	8714
29294	277	120	7718	524	0	8639
29295	7618	99	537	297	0	8551
29296	480	7979	344	193	0	8996
29297	7996	482	222	143	0	8843
29298	8252	276	181	162	0	8871
29299	8603	179	162	160	0	9104
29300	818	206	7631	154	0	8809
29301	8218	186	457	196	0	9057
29302	677	190	305	7024	0	8196
29303	463	7006	278	407	0	8154
29304	360	8100	282	251	0	8993
29305	8091	571	262	153	0	9077
29306	8259	291	214	165	0	8929
29307	8494	207	199	176	0	9076
29308	842	210	154	7929	0	9135
29309	466	258	179	8197	0	9100
29310	382	171	195	7594	0	8342
29311	368	7977	172	719	0	9236
29312	7961	487	220	407	0	9075
29313	8313	268	227	320	0	9128
29314	8677	186	145	321	0	9329
29315	858	205	7729	299	0	9091
29316	8349	222	495	209	0	9275
29317	809	283	273	6967	0	8332
29318	637	7925	208	457	0	9227
29319	8189	542	187	296	0	9214
29320	8443	338	183	235	0	9199
29321	921	234	7650	279	0	9084
29322	605	244	516	7377	0	8742
29323	479	7921	329	520	0	9249
29324	8066	594	297	279	0	9236
29325	863	322	247	7832	0	9264
29326	581	216	282	7896	0	8975
29327	469	208	262	8216	0	9155
29328	401	229	199	8632	0	9461
29329	423	278	7635	822	0	9158
29330	362	7999	483	565	0	9409
29331	374	623	269	8034	0	9300
29332	437	369	7855	713	0	9374
29333	8120	245	576	495	0	9436
29334	8481	230	369	340	0	9420
29335	950	212	214	8250	0	9626
29336	8260	241	221	730	0	9452
29337	8675	209	204	486	0	9574
29338	986	229	7643	414	0	9272
29339	669	7979	538	349	0	9535
29340	8221	516	377	351	0	9465
29341	886	325	268	8203	0	9682
29342	8413	220	292	637	0	9562
29343	844	202	300	8193	0	9539
29344	597	287	224	8560	0	9668
29345	550	227	7697	833	0	9307
29346	7519	231	551	514	0	8815
29347	846	7919	347	405	0	9517
29348	640	527	7858	400	0	9425
29349	563	8204	609	390	0	9766
29350	5930	446	269	256	0	6901
29351	581	293	200	5854	0	6928
29352	5773	214	150	512	0	6649
29353	625	6559	156	340	0	7680
29354	6861	437	141	296	0	7735
29355	7065	261	114	273	0	7713
29356	7137	162	164	269	0	7732
29357	7055	140	166	232	0	7593
29358	810	6583	145	201	0	7739
29359	6995	398	132	226	0	7751
29360	693	307	138	6613	0	7751
29361	574	185	106	6719	0	7584
29362	436	6133	115	576	0	7260
29363	424	6440	90	305	0	7259
29364	413	6753	101	251	0	7518
29365	6079	568	93	247	0	6987
29366	547	6391	125	214	0	7277
29367	341	4661	56	148	0	5206
29368	4584	439	72	152	0	5247
29369	4528	261	60	126	0	4975
29370	497	4532	43	133	0	5205
29371	4716	379	67	120	0	5282
29372	481	285	4291	130	0	5187
29373	4115	144	138	75	0	4472
29374	305	126	3883	82	0	4396
29375	238	3782	156	70	0	4246
29376	197	3900	94	95	0	4286
29377	181	1205	75	2955	0	4416
29378	2934	88	37	107	0	3166
29379	3025	76	22	59	0	3182
29380	2994	77	28	38	0	3137
29381	3019	66	30	35	0	3150
29382	3075	74	27	39	0	3215
29383	212	61	2760	50	0	3083
29384	156	52	2640	45	0	2893
29385	2827	57	109	63	0	3056
29386	161	2868	68	60	0	3157
29387	1662	8	5	3	0	1678
29388	1683	3	1	2	0	1689
29389	1720	1	1	0	0	1722
29390	1716	0	2	6	0	1724
29391	1695	3	1	4	0	1703
29392	11	2	1617	4	0	1634
29393	1668	1	8	7	0	1684
29394	1672	2	3	4	0	1681
29395	12	3	1686	5	0	1706
29396	1620	4	6	8	0	1638
29397	1649	2	7	4	0	1662
29398	16	2	1690	3	0	1711
29399	6	9	1633	11	0	1659
29400	4	1633	19	3	0	1659
29401	11	9	2	1707	0	1729
29402	12	7	1683	8	0	1710
29403	1677	2	12	3	0	1694
29404	16	5	1	1754	0	1776
29405	9	4	1756	8	0	1777
29406	1729	3	10	4	0	1746
29407	1759	2	1	3	0	1765
29408	1788	3	4	3	0	1798
29409	16	1795	0	6	0	1817
29410	9	12	2	1821	0	1844
29411	6	1774	5	9	0	1794
29412	1834	10	3	3	0	1850
29413	1810	5	3	3	0	1821
29414	14	8	1781	2	0	1805
29415	6	1716	10	4	0	1736
29416	6	1752	3	3	0	1764
29417	2	11	1	1775	0	1789
29418	4	3	4	1772	0	1783
29419	1765	3	0	11	0	1779
29420	16	1737	1	2	0	1756
29421	8	1740	2	1	0	1751
29422	15	14	1723	0	0	1752
29423	6	1703	12	2	0	1723
29424	1770	12	4	2	0	1788
29425	22	3	1708	1	0	1734
29426	1486	3	10	4	0	1503
29427	10	1	1676	0	0	1687
29428	1413	2	7	1	0	1423
29429	4	1585	2	2	0	1593
29430	1681	7	2	0	0	1690
29431	7	1	1671	4	0	1683
29432	1712	0	7	2	0	1721
29433	1730	1	1	1	0	1733
29434	9	2	1709	0	0	1720
29435	1701	1	3	0	0	1705
29436	1767	0	1	0	0	1768
29437	1727	2	0	0	0	1729
29438	8	1695	0	5	0	1708
29439	1758	7	3	0	0	1768
29440	11	1	1732	0	0	1744
29441	3	1745	9	0	0	1757
29442	1815	7	5	1	0	1828
29443	1778	2	0	0	0	1780
29444	1799	0	0	0	0	1799
29445	9	1759	2	2	0	1772
29446	3	8	0	1968	0	1979
29447	4	2	1948	14	0	1968
29448	1	1	17	1935	0	1954
29449	2	5	2671	16	0	2694
29450	2540	2	42	2	0	2586
29451	39	2694	24	3	0	2760
29452	24	44	9	2636	0	2713
29453	11	1991	4	43	0	2049
29454	6	55	3	1967	0	2031
29455	6	29	2	1971	0	2008
29456	4	2017	0	76	0	2097
29457	1	51	0	1999	0	2051
29458	4	33	2	2072	0	2111
29459	1	2057	4	71	0	2133
29460	2	2115	2	33	0	2152
29461	4	71	3	2086	0	2164
29462	5	46	2016	57	0	2124
29463	3	2104	53	31	0	2191
29464	2	58	26	2100	0	2186
29465	6	35	2088	58	0	2187
29466	3	2157	55	30	0	2245
29467	2152	59	26	14	0	2251
29468	56	34	2114	10	0	2214
29469	2128	16	55	5	0	2204
29470	63	10	29	2071	0	2173
29471	32	7	12	2146	0	2197
29472	16	9	8	2184	0	2217
29473	7	9	2076	90	0	2182
29474	8	6	2102	45	0	2161
29475	2055	7	82	21	0	2165
29476	53	8	37	2117	0	2215
29477	29	9	2070	62	0	2170
29478	2062	8	55	36	0	2161
29479	58	9	35	2073	0	2175
29480	36	5	11	2109	0	2161
29481	15	9	11	2082	0	2117
29482	11	2069	8	96	0	2184
29483	11	63	6	1980	0	2060
29484	5	2034	8	69	0	2116
29485	9	2114	7	33	0	2163
29486	2038	89	8	24	0	2159
29487	1989	44	6	20	0	2059
29488	2066	22	6	17	0	2111
29489	88	1991	8	16	0	2103
29490	1994	61	10	13	0	2078
29491	2023	37	6	17	0	2083
29492	87	23	8	1976	0	2094
29493	39	14	9	2045	0	2107
29494	20	17	1892	98	0	2027
29495	10	1979	62	46	0	2097
29496	1929	61	32	29	0	2051
29497	1922	37	22	19	0	2000
29498	85	1947	19	16	0	2067
29499	1953	68	13	19	0	2053
29500	1938	46	12	23	0	2019
29501	87	34	14	1851	0	1986
29502	54	1846	4	80	0	1984
29503	26	1934	11	57	0	2028
29504	1862	78	11	43	0	1994
29505	68	62	6	1857	0	1993
29506	38	36	1768	88	0	1930
29507	1823	25	58	59	0	1965
29508	77	30	1816	33	0	1956
29509	40	1829	73	34	0	1976
29510	1846	70	35	36	0	1987
29511	69	55	1797	31	0	1952
29512	44	40	65	1828	0	1977
29513	28	29	1760	87	0	1904
29514	17	1836	66	57	0	1976
29515	20	77	42	1823	0	1962
29516	23	55	1779	79	0	1936
29517	1748	29	77	52	0	1906
29518	78	1830	45	39	0	1992
29519	59	78	22	1689	0	1848
29520	29	1857	22	79	0	1987
29521	1817	87	17	53	0	1974
29522	1787	49	25	48	0	1909
29523	92	1830	27	35	0	1984
29524	58	68	23	1771	0	1920
29525	28	1858	21	78	0	1985
29526	1833	75	23	61	0	1992
29527	808	53	1087	35	0	1983
29528	81	43	1719	34	0	1877
29529	61	1728	63	38	0	1890
29530	36	1785	46	30	0	1897
29531	27	97	24	1734	0	1882
29532	1708	63	18	81	0	1870
29533	1740	30	26	59	0	1855
29534	1688	39	16	32	0	1775
29535	116	1709	14	27	0	1866
29536	72	71	22	1623	0	1788
29537	54	1720	14	56	0	1844
29538	1722	66	13	55	0	1856
29539	81	54	15	1700	0	1850
29540	59	24	1617	82	0	1782
29541	32	1654	63	53	0	1802
29542	1646	70	40	40	0	1796
29543	83	47	1622	27	0	1779
29544	1651	47	59	28	0	1785
29545	91	1611	40	27	0	1769
29546	60	1499	22	14	0	1595
29547	1384	84	11	27	0	1506
29548	73	1517	12	26	0	1628
29549	638	7	4	2	0	651
29550	10	646	3	1	0	660
29551	645	9	1	1	0	656
29552	642	2	1	1	0	646
29553	11	4	672	1	0	688
29554	7	0	638	2	0	647
29555	2	639	7	0	0	648
29556	604	5	2	1	0	612
29557	5	1	583	2	0	591
29558	515	1	6	1	0	523
29559	4	6	1	511	0	522
29560	3	1	534	4	0	542
29561	2	1	534	1	0	538
29562	4	2	555	0	0	561
29563	2	539	2	0	0	543
29564	5	11	6	502	0	524
29565	494	0	0	0	0	494
29566	0	0	0	494	0	494
29567	494	0	0	0	0	494
29568	0	0	0	500	0	500
29569	516	0	0	0	0	516
29570	534	0	0	0	0	534
29571	587	0	0	0	0	587
29572	3	590	0	0	0	593
29573	0	2	603	0	0	605
29574	0	0	3	615	0	618
29575	1	1	2	521	0	525
29576	1	0	1	635	0	637
29577	0	1	0	622	0	623
29578	0	616	1	7	0	624
29579	0	6	618	1	0	625
29580	0	618	9	1	0	628
29581	2	7	0	629	0	638
29582	0	0	0	641	0	641
29583	0	1	0	644	0	645
29584	0	0	1	643	0	644
29585	0	640	0	7	0	647
29586	0	642	0	1	0	643
29587	0	6	642	0	0	648
29588	0	0	7	643	0	650
29589	0	0	0	661	0	661
29590	0	0	0	679	0	679
29591	672	1	0	7	0	680
29592	6	663	1	0	0	670
29593	0	8	673	1	0	682
29594	681	0	7	1	0	689
29595	7	0	0	693	0	700
29596	724	0	0	7	0	731
29597	7	1	0	726	0	734
29598	751	0	1	8	0	760
29599	8	0	0	745	0	753
29600	748	0	0	8	0	756
29601	8	1	773	0	0	782
29602	0	0	6	782	0	788
29603	1	800	0	6	0	807
29604	0	7	0	831	0	838
29605	829	0	0	9	0	838
29606	8	835	1	1	0	845
29607	0	9	0	880	0	889
29608	0	847	0	11	0	858
29609	0	12	0	866	0	878
29610	1	1	0	874	0	876
29611	0	1	857	12	0	870
29612	0	0	14	828	0	842
29613	1	1	847	16	0	865
29614	0	840	10	2	0	852
29615	853	12	0	1	0	866
29616	13	0	848	0	0	861
29617	850	0	10	1	0	861
29618	930	0	1	0	0	931
29619	12	2	0	942	0	956
29620	1	1	1003	12	0	1017
29621	989	0	13	3	0	1005
29622	1075	1	3	1	0	1080
29623	20	0	1	1036	0	1057
29624	2	1	0	1060	0	1063
29625	1	1065	1	23	0	1090
29626	3	19	1	1079	0	1102
29627	2	1078	1	15	0	1096
29628	0	17	1068	5	0	1090
29629	0	5	17	1078	0	1100
29630	1069	3	3	19	0	1094
29631	1083	0	0	7	0	1090
29632	18	1066	1	6	0	1091
29633	4	16	1	1081	0	1102
29634	1082	3	2	21	0	1108
29635	16	1045	0	9	0	1070
29636	1066	19	1	1	0	1087
29637	17	5	2	1082	0	1106
29638	1153	1	0	19	0	1173
29639	19	2	1273	5	0	1299
29640	6	1280	25	8	0	1319
29641	1303	26	6	2	0	1337
29642	25	1336	1	6	0	1368
29643	1349	30	1	1	0	1381
29644	1384	6	2	3	0	1395
29645	36	2	1359	6	0	1403
29646	14	5	27	1360	0	1406
29647	1387	2	8	29	0	1426
29648	31	3	1364	9	0	1407
29649	1395	0	29	5	0	1429
29650	33	2	7	1395	0	1437
29651	9	6	1387	31	0	1433
29652	6	1	29	1383	0	1419
29653	1340	4	10	31	0	1385
29654	33	3	1384	9	0	1429
29655	14	1	30	1411	0	1456
29656	2	4	7	1442	0	1455
29657	1432	0	1	39	0	1472
29658	1442	3	3	9	0	1457
29659	39	1448	7	5	0	1499
29660	11	30	3	1441	0	1485
29661	3	11	5	1467	0	1486
29662	10	3	2	1450	0	1465
29663	1417	1	3	39	0	1460
29664	1434	4	3	11	0	1452
29665	41	1	4	1404	0	1450
29666	11	1388	4	36	0	1439
29667	4	31	5	1392	0	1432
29668	10	1422	1	33	0	1466
29669	1414	28	3	12	0	1457
29670	32	1381	5	7	0	1425
29671	1346	26	1	7	0	1380
29672	34	9	1	1346	0	1390
29673	1335	3	7	29	0	1374
29674	30	3	1314	13	0	1360
29675	14	1347	24	5	0	1390
29676	2201	28	10	8	0	2247
29677	2219	14	2	4	0	2239
29678	40	7	1	2183	0	2231
29679	18	2169	2	26	0	2215
29680	8	25	3	2244	0	2280
29681	9	10	1	2248	0	2268
29682	8	3	7	2237	0	2255
29683	2231	3	3	39	0	2276
29684	2242	3	2	14	0	2261
29685	37	7	8	2235	0	2287
29686	15	2207	6	27	0	2255
29687	2266	28	1	16	0	2311
29688	31	8	2228	6	0	2273
29689	10	5	28	2252	0	2295
29690	11	2	2253	31	0	2297
29691	8	1	26	2260	0	2295
29692	12	3	2298	32	0	2345
29693	5	4	25	2293	0	2327
29694	2322	8	7	30	0	2367
29695	2339	2	3	15	0	2359
29696	34	2272	4	11	0	2321
29697	2409	27	2	15	0	2453
29698	35	10	1	2416	0	2462
29699	16	0	4	2445	0	2465
29700	2432	7	7	41	0	2487
29701	36	5	2417	18	0	2476
29702	17	3	2414	12	0	2446
29703	12	13	4942	8	0	4975
29704	4793	5	34	11	0	4843
29705	31	13	5214	9	0	5267
29706	21	7	5012	12	0	5052
29707	4994	5	25	9	0	5033
29708	27	5087	14	10	0	5138
29709	12	24	5	5403	0	5444
29710	12	15	3	5429	0	5459
29711	11	6	5374	30	0	5421
29712	5265	8	22	15	0	5310
29713	5444	4	13	9	0	5470
29714	5413	6	4	4	0	5427
29715	33	7	5396	14	0	5450
29716	5160	9	22	9	0	5200
29717	26	4	5392	20	0	5442
29718	15	5192	22	18	0	5247
29719	12	5275	7	12	0	5306
29720	5365	23	6	8	0	5402
29721	26	5238	3	9	0	5276
29722	12	5251	9	7	0	5279
29723	5339	21	1	5	0	5366
29724	20	5219	5	10	0	5254
29725	5311	17	7	5	0	5340
29726	18	4	5	5315	0	5342
29727	8	2	8	5326	0	5344
29728	7	1	4	5352	0	5364
29729	5	3	7	5313	0	5328
29730	5	5200	5	24	0	5234
29731	5323	15	4	7	0	5349
29732	26	5407	4	8	0	5445
29733	5	5460	13	12	0	5490
29734	19	32	5333	4	0	5388
29735	4882	6	31	11	0	4930
29736	35	9	7563	11	0	7618
29737	23	50	7823	7	0	7903
29738	6	8098	196	17	0	8317
29739	2	8344	77	15	0	8438
29740	8214	215	32	5	0	8466
29741	166	8288	47	11	0	8512
29742	77	186	8235	3	0	8501
29743	29	7857	219	12	0	8117
29744	25	156	8551	3	0	8735
29745	6	76	8443	4	0	8529
29746	8303	28	254	3	0	8588
29747	177	22	8592	2	0	8793
29748	77	7	207	8492	0	8783
29749	8444	10	86	165	0	8705
29750	165	8021	61	85	0	8332
29751	72	141	8366	32	0	8611
29752	8448	67	165	12	0	8692
29753	179	27	89	7987	0	8282
29754	79	7817	65	149	0	8110
29755	40	125	8318	69	0	8552
29756	8127	57	166	34	0	8384
29757	173	28	8559	11	0	8771
29758	82	12	199	8405	0	8698
29759	40	11	8435	174	0	8660
29760	19	8	187	8539	0	8753
29761	8378	6	89	197	0	8670
29762	175	8267	48	96	0	8586
29763	8596	153	17	33	0	8799
29764	204	73	8464	19	0	8760
29765	93	30	166	8388	0	8677
29766	45	17	8411	166	0	8639
29767	8284	6	206	78	0	8574
29768	8621	7	81	38	0	8747
29769	235	8331	41	19	0	8626
29770	8706	168	24	8	0	8906
29771	8745	72	19	12	0	8848
29772	256	35	17	8438	0	8746
29773	126	26	8295	168	0	8615
29774	58	7993	191	84	0	8326
29775	25	159	82	8538	0	8804
29776	7760	81	36	174	0	8051
29777	181	47	7674	78	0	7980
29778	93	24	7665	42	0	7824
29779	46	15	7653	13	0	7727
29780	7487	21	280	9	0	7797
29781	180	16	7654	10	0	7860
29782	7447	8	228	11	0	7694
29783	224	16	7142	11	0	7393
29784	90	7320	202	16	0	7628
29785	42	169	87	7582	0	7880
29786	33	73	7518	176	0	7800
29787	21	7320	188	79	0	7608
29788	14	7576	97	37	0	7724
29789	21	244	54	7618	0	7937
29790	7612	111	36	176	0	7935
29791	176	61	22	7624	0	7883
29792	7599	31	38	207	0	7875
29793	225	23	27	7590	0	7865
29794	108	33	7426	206	0	7773
29795	45	48	7352	101	0	7546
29796	7033	26	266	48	0	7373
29797	7475	37	130	33	0	7675
29798	279	23	7267	15	0	7584
29799	7040	33	224	22	0	7319
29800	240	23	7200	16	0	7479
29801	112	6813	271	21	0	7217
29802	76	7044	123	31	0	7274
29803	48	5002	79	15	0	5144
29804	52	288	53	4766	0	5159
29805	4764	125	45	177	0	5111
29806	4911	82	37	93	0	5123
29807	277	46	50	4773	0	5146
29808	161	42	4495	195	0	4893
29809	81	36	200	4629	0	4946
29810	47	37	4509	221	0	4814
29811	34	23	253	4564	0	4874
29812	4490	24	128	238	0	4880
29813	4638	18	87	124	0	4867
29814	4693	16	62	66	0	4837
29815	4725	16	52	40	0	4833
29816	320	17	55	4431	0	4823
29817	167	18	37	4608	0	4830
29818	4459	27	52	274	0	4812
29819	4618	20	38	135	0	4811
29820	288	19	58	4453	0	4818
29821	168	20	36	4579	0	4803
29822	91	22	41	4587	0	4741
29823	64	23	29	4668	0	4784
29824	4414	21	41	309	0	4785
29825	222	37	4295	157	0	4711
29826	132	17	193	4391	0	4733
29827	4395	23	101	220	0	4739
29828	219	26	4248	133	0	4626
29829	118	17	205	4382	0	4722
29830	91	18	4266	223	0	4598
29831	57	4206	235	109	0	4607
29832	49	177	125	4116	0	4467
29833	3977	83	75	188	0	4323
29834	209	2149	50	1762	0	4170
29835	129	3855	63	116	0	4163
29836	57	1681	23	56	0	1817
29837	4	858	2	9	0	873
29838	5	793	3	7	0	808
29839	369	54	45	25	0	493
29840	23	21	8	227	0	279
29841	1	0	173	4	0	178
29842	3	0	2	164	0	169
29843	2	0	161	2	0	165
29844	158	0	3	2	0	163
29845	4	0	1	157	0	162
29846	2	0	1	159	0	162
29847	1	0	0	161	0	162
29848	3	0	1	159	0	163
29849	158	1	0	2	0	161
29850	157	0	0	5	0	162
29851	3	0	0	154	0	157
29852	145	0	0	3	0	148
29853	2	0	142	3	0	147
29854	3	142	1	1	0	147
29855	0	1	2	144	0	147
29856	0	1	0	144	0	145
29857	2	142	0	3	0	147
29858	1	1	2	141	0	145
29859	0	1	1	144	0	146
29860	139	0	4	3	0	146
29861	2	2	137	1	0	142
29862	1	0	133	1	0	135
29863	131	0	2	1	0	134
29864	1	0	121	1	0	123
29865	68	0	5	0	0	73
29866	55	0	4	0	0	59
29867	6	2	0	40	0	48
29868	0	0	21	0	0	21
29869	16	3	0	0	0	19
29870	0	16	0	0	0	16
29871	5	0	4	0	0	9
29872	3	0	0	0	0	3
29873	1	0	0	0	0	1
