Pos	A	C	G	T	Other	Total
1	0	0	0	0	0	0
2	0	0	0	0	0	0
3	0	0	0	0	0	0
4	0	0	0	0	0	0
5	12	0	0	0	0	12
6	13	0	0	0	0	13
7	0	0	13	0	0	13
8	0	0	12	0	0	12
9	0	0	0	13	0	13
10	0	0	0	13	0	13
11	0	0	0	13	0	13
12	13	0	0	0	0	13
13	0	0	0	14	0	14
14	65	0	0	4	0	69
15	0	133	0	0	0	133
16	0	138	0	0	0	138
17	0	0	0	317	0	317
18	2	0	0	406	0	408
19	1	689	2	2	0	694
20	0	722	0	1	0	723
21	1	868	2	3	0	874
22	1001	1	1	10	0	1013
23	1	3	1011	3	0	1018
24	0	3	1068	4	0	1075
25	0	0	1	1092	0	1093
26	1153	1	1	7	0	1162
27	1176	0	0	2	0	1178
28	1	1178	1	2	0	1182
29	1399	1	2	15	0	1417
30	1623	0	1	12	0	1636
31	1640	0	0	7	0	1647
32	1	1699	2	1	0	1703
33	1	1745	2	1	0	1749
34	1797	1	0	5	0	1803
35	1842	0	0	11	0	1853
36	0	1863	3	18	0	1884
37	1	1963	3	4	0	1971
38	1979	1	1	5	0	1986
39	1991	0	0	9	0	2000
40	1	2016	5	2	0	2024
41	2	3	0	2069	0	2074
42	2	0	0	2074	0	2076
43	1	0	2	2081	0	2084
44	0	2086	5	3	0	2094
45	1	10	2005	6	0	2022
46	1853	5	2	3	0	1863
47	4	0	0	2095	0	2099
48	0	2118	5	3	0	2126
49	5	1	1	2135	0	2142
50	3	2171	5	2	0	2181
51	4	1	2	2176	0	2183
52	2	2	0	2205	0	2209
53	4	4	2205	6	0	2219
54	5	0	2	2170	0	2177
55	2166	3	0	10	0	2179
56	4	10	2172	3	0	2189
57	2086	2	2	4	0	2094
58	6	1	0	2225	0	2232
59	1	2238	3	1	0	2243
60	0	4	0	2247	0	2251
61	2	6	2255	3	0	2266
62	4	1	1	2216	0	2222
63	0	3	2	2329	0	2334
64	2	2404	5	7	0	2418
65	3	6	2	2440	0	2451
66	3	2456	5	3	0	2467
67	1	8	1	2474	0	2484
68	2433	6	0	16	0	2455
69	2390	1	1	12	0	2404
70	2441	2	0	6	0	2449
71	12	2575	5	4	0	2596
72	7	8	2565	5	0	2585
73	2472	5	13	5	0	2495
74	2707	0	6	8	0	2721
75	23	2807	8	3	0	2841
76	9	16	1	2844	0	2870
77	8	13	1	2913	0	2935
78	2	2	1	2936	0	2941
79	2921	2	0	58	0	2981
80	2962	0	3	29	0	2994
81	2977	3	2	6	0	2988
82	3007	1	0	11	0	3019
83	55	2	2	2931	0	2990
84	26	2972	4	29	0	3031
85	7	31	0	3081	0	3119
86	6	32	3076	32	0	3146
87	6	0	35	3181	0	3222
88	5	10	3355	39	0	3409
89	8	3	36	3342	0	3389
90	3	7	3397	41	0	3448
91	6	6	3459	37	0	3508
92	3	3551	74	25	0	3653
93	3	41	37	3776	0	3857
94	9	43	3868	44	0	3964
95	8	9	48	3740	0	3805
96	4	3881	45	41	0	3971
97	3825	47	1	42	0	3915
98	38	4221	10	11	0	4280
99	43	44	8	4055	0	4150
100	42	4184	10	43	0	4279
101	8	61	4067	43	0	4179
102	8	56	4166	12	0	4242
103	4	4273	88	16	0	4381
104	8	43	42	4274	0	4367
105	14	51	4283	48	0	4396
106	6	4267	55	55	0	4383
107	4274	48	45	10	0	4377
108	51	47	4	4280	0	4382
109	44	8	4438	57	0	4547
110	8	4448	53	47	0	4556
111	8	50	43	4437	0	4538
112	8	41	3	4490	0	4542
113	4214	4	8	94	0	4320
114	48	15	4393	46	0	4502
115	41	8	48	4351	0	4448
116	10	9	4444	49	0	4512
117	4	4311	57	48	0	4420
118	4137	44	50	14	0	4245
119	41	4152	23	9	0	4225
120	46	53	12	3933	0	4044
121	7	4051	10	43	0	4111
122	3878	52	9	49	0	3988
123	47	3977	12	17	0	4053
124	47	59	3855	19	0	3980
125	5	4002	53	8	0	4068
126	3873	53	41	12	0	3979
127	57	57	3958	13	0	4085
128	48	12	54	3974	0	4088
129	3856	9	53	55	0	3973
130	63	14	9	3709	0	3795
131	3737	7	9	61	0	3814
132	3748	11	10	59	0	3828
133	94	9	14	3707	0	3824
134	57	9	11	3705	0	3782
135	3667	9	9	112	0	3797
136	3681	5	8	58	0	3752
137	109	9	8	3636	0	3762
138	3656	10	12	61	0	3739
139	3680	8	9	63	0	3760
140	97	3740	15	20	0	3872
141	62	60	6	3706	0	3834
142	3776	52	9	66	0	3903
143	3820	7	21	55	0	3903
144	104	19	10	3773	0	3906
145	51	17	12	3830	0	3910
146	3746	12	12	109	0	3879
147	61	3790	19	56	0	3926
148	63	61	10	3770	0	3904
149	15	60	3800	69	0	3944
150	18	13	60	3722	0	3813
151	14	3783	60	61	0	3918
152	14	69	3749	66	0	3898
153	12	57	61	3725	0	3855
154	26	13	53	3789	0	3881
155	21	21	3901	101	0	4044
156	3543	6	65	73	0	3687
157	58	3946	62	21	0	4087
158	3921	59	27	18	0	4025
159	67	60	3937	19	0	4083
160	64	28	3960	19	0	4071
161	3595	16	95	36	0	3742
162	64	4052	62	21	0	4199
163	3942	59	9	28	0	4038
164	67	4093	19	15	0	4194
165	56	71	4076	19	0	4222
166	3940	51	53	17	0	4061
167	69	25	4190	17	0	4301
168	55	15	54	4130	0	4254
169	4153	12	51	67	0	4283
170	4133	13	10	55	0	4211
171	103	4074	16	16	0	4209
172	52	107	11	3872	0	4042
173	18	4034	30	50	0	4132
174	23	61	3959	53	0	4096
175	48	60	39	3662	0	3809
176	13	3680	44	43	0	3780
177	20	31	6	3581	0	3638
178	3232	25	10	44	0	3311
179	33	6	7	3499	0	3545
180	30	3511	14	31	0	3586
181	19	33	2	3539	0	3593
182	9	23	5	3525	0	3562
183	11	3506	9	53	0	3579
184	26	55	4	3481	0	3566
185	54	24	3299	31	0	3408
186	8	3342	21	31	0	3402
187	3057	14	15	16	0	3102
188	30	19	3235	7	0	3291
189	25	13	3213	6	0	3257
190	4	3193	28	9	0	3234
191	11	13	38	3018	0	3080
192	8	12	3049	12	0	3081
193	5	2620	19	10	0	2654
194	7	6	7	2730	0	2750
195	3	7	5	2803	0	2818
196	2717	2	2	20	0	2741
197	12	2748	2	18	0	2780
198	7	17	2478	5	0	2507
199	5	12	2616	7	0	2640
200	10	3	16	2613	0	2642
201	9	2	11	3359	0	3381
202	10	3	1	3252	0	3266
203	2	3651	5	81	0	3739
204	9	46	3676	45	0	3776
205	12	62	44	3666	0	3784
206	3	3891	60	47	0	4001
207	7	4081	14	60	0	4162
208	10	110	4149	11	0	4280
209	6	70	63	4034	0	4173
210	1	10	4460	72	0	4543
211	9	7	79	4363	0	4458
212	6	7	90	4575	0	4678
213	6	14	4504	165	0	4689
214	6	4514	84	108	0	4712
215	4355	76	100	24	0	4555
216	77	94	4530	13	0	4714
217	93	4481	87	15	0	4676
218	11	4628	96	15	0	4750
219	12	170	4507	8	0	4697
220	4309	111	91	7	0	4518
221	94	25	100	4067	0	4286
222	98	4492	22	72	0	4684
223	4480	89	11	97	0	4677
224	88	115	10	4262	0	4475
225	101	4479	19	91	0	4690
226	4459	91	15	103	0	4668
227	84	108	4395	28	0	4615
228	100	4424	87	20	0	4631
229	4351	90	103	22	0	4566
230	78	4455	22	16	0	4571
231	4399	88	31	18	0	4536
232	89	107	20	4162	0	4378
233	104	4247	24	87	0	4462
234	16	93	18	4354	0	4481
235	4165	112	18	104	0	4399
236	87	29	4141	115	0	4372
237	107	26	4215	18	0	4366
238	30	21	177	4049	0	4277
239	18	20	118	4118	0	4274
240	15	27	33	3975	0	4050
241	17	3999	26	179	0	4221
242	18	193	3811	114	0	4136
243	23	113	93	3723	0	3952
244	21	3805	114	86	0	4026
245	19	3943	25	113	0	4100
246	23	185	3857	30	0	4095
247	29	125	3977	25	0	4156
248	22	49	4105	19	0	4195
249	30	33	189	3886	0	4138
250	30	35	4029	86	0	4180
251	25	40	96	3989	0	4150
252	23	47	4074	86	0	4230
253	3548	34	109	130	0	3821
254	98	3981	140	29	0	4248
255	115	4058	37	41	0	4251
256	32	209	4157	30	0	4428
257	4076	131	111	37	0	4355
258	4259	35	127	28	0	4449
259	4339	27	41	28	0	4435
260	223	30	4136	43	0	4432
261	127	31	4218	52	0	4428
262	31	35	217	3979	0	4262
263	4092	34	149	126	0	4401
264	4050	31	54	133	0	4268
265	221	47	3901	42	0	4211
266	3971	44	129	39	0	4183
267	117	43	149	3852	0	4161
268	126	45	3891	122	0	4184
269	35	31	3950	135	0	4151
270	3629	24	252	55	0	3960
271	113	41	3953	44	0	4151
272	3758	31	154	58	0	4001
273	115	37	3950	52	0	4154
274	138	3655	162	52	0	4007
275	44	3846	174	38	0	4102
276	46	233	68	3645	0	3992
277	39	159	65	3880	0	4143
278	41	59	3815	223	0	4138
279	60	52	155	3642	0	3909
280	62	3598	171	123	0	3954
281	63	3730	73	126	0	3992
282	65	3903	54	38	0	4060
283	74	236	63	3678	0	4051
284	58	153	3723	123	0	4057
285	68	48	3712	141	0	3969
286	75	37	249	3595	0	3956
287	77	42	164	3649	0	3932
288	88	39	63	3320	0	3510
289	51	3505	64	223	0	3843
290	3528	128	65	144	0	3865
291	3531	135	63	59	0	3788
292	248	3493	67	43	0	3851
293	180	143	3514	41	0	3878
294	3513	135	141	43	0	3832
295	151	58	3684	39	0	3932
296	3686	46	167	36	0	3935
297	3695	46	167	49	0	3957
298	3749	57	58	55	0	3919
299	3597	31	58	73	0	3759
300	235	3505	63	61	0	3864
301	2765	89	55	42	0	2951
302	114	2785	49	48	0	2996
303	2376	84	38	33	0	2531
304	82	2342	47	34	0	2505
305	72	77	2121	24	0	2294
306	32	180	75	1783	0	2070
307	29	1924	72	59	0	2084
308	17	1914	30	46	0	2007
309	1802	105	34	21	0	1962
310	1594	52	14	23	0	1683
311	64	1791	16	19	0	1890
312	48	38	17	1646	0	1749
313	24	1945	17	29	0	2015
314	1954	37	15	31	0	2037
315	45	44	1927	9	0	2025
316	53	10	41	1836	0	1940
317	18	6	46	1852	0	1922
318	22	12	19	1857	0	1910
319	23	12	1816	69	0	1920
320	26	1811	43	37	0	1917
321	23	1885	43	13	0	1964
322	21	66	16	1945	0	2048
323	17	42	1933	45	0	2037
324	20	19	41	1906	0	1986
325	22	15	43	1932	0	2012
326	27	16	11	1902	0	1956
327	14	15	18	1908	0	1955
328	1802	13	15	89	0	1919
329	46	1899	15	48	0	2008
330	1920	56	11	10	0	1997
331	52	48	1887	16	0	2003
332	49	21	1915	13	0	1998
333	21	20	75	1827	0	1943
334	11	14	49	1789	0	1863
335	15	1892	20	81	0	2008
336	11	55	1893	52	0	2011
337	15	1976	52	20	0	2063
338	17	56	2005	20	0	2098
339	1815	38	49	24	0	1926
340	46	2013	43	16	0	2118
341	40	54	2030	15	0	2139
342	17	44	50	1983	0	2094
343	15	22	2034	54	0	2125
344	15	2025	57	48	0	2145
345	16	46	51	1939	0	2052
346	17	2076	11	56	0	2160
347	18	53	2029	50	0	2150
348	19	44	44	1998	0	2105
349	1996	17	38	53	0	2104
350	58	1993	13	43	0	2107
351	48	53	1991	9	0	2101
352	16	48	38	1932	0	2034
353	16	15	2036	47	0	2114
354	9	8	1795	32	0	1844
355	10	1768	90	14	0	1882
356	8	54	26	1641	0	1729
357	4	26	2	1680	0	1712
358	4	6	4	1666	0	1680
359	3	6	1689	44	0	1742
360	8	8	1677	27	0	1720
361	1443	3	45	10	0	1501
362	21	14	1691	9	0	1735
363	1493	17	23	9	0	1542
364	22	1617	25	8	0	1672
365	23	23	8	1509	0	1563
366	4	1633	6	17	0	1660
367	0	1666	10	27	0	1703
368	4	40	1709	8	0	1761
369	2	28	22	1701	0	1753
370	5	10	1741	28	0	1784
371	3	10	1684	30	0	1727
372	1563	7	41	17	0	1628
373	20	6	1676	16	0	1718
374	24	5	1670	10	0	1709
375	1551	9	40	9	0	1609
376	18	9	1677	8	0	1712
377	22	10	1791	12	0	1835
378	9	3	42	1671	0	1725
379	7	1786	31	20	0	1844
380	2	25	10	1795	0	1832
381	4	24	11	1826	0	1865
382	1825	10	11	47	0	1893
383	25	6	14	1791	0	1836
384	26	1850	15	25	0	1916
385	1837	27	8	31	0	1903
386	22	32	1849	13	0	1916
387	1741	7	30	14	0	1792
388	24	11	2002	16	0	2053
389	23	15	2055	10	0	2103
390	5	2079	55	14	0	2153
391	2048	36	28	18	0	2130
392	23	2080	22	21	0	2146
393	25	33	2010	19	0	2087
394	15	28	33	1801	0	1877
395	5	2065	36	28	0	2134
396	2101	30	16	41	0	2188
397	2074	28	12	9	0	2123
398	50	2111	18	7	0	2186
399	2182	32	14	8	0	2236
400	35	33	12	1977	0	2057
401	26	2085	19	31	0	2161
402	6	35	15	2149	0	2205
403	6	28	11	2233	0	2278
404	2224	15	14	54	0	2307
405	2207	6	17	38	0	2268
406	2181	13	11	13	0	2218
407	58	6	2168	9	0	2241
408	1989	4	36	10	0	2039
409	35	8	34	2056	0	2133
410	24	10	2068	29	0	2131
411	10	4	1947	28	0	1989
412	5	1904	51	9	0	1969
413	1672	23	19	0	0	1714
414	21	1730	7	4	0	1762
415	19	22	3	1702	0	1746
416	7	16	4	1749	0	1776
417	4	9	1732	29	0	1774
418	4	4	23	1646	0	1677
419	5	3	1766	25	0	1799
420	4	6	1666	14	0	1690
421	3	1680	28	5	0	1716
422	2	10	8	1572	0	1592
423	4	8	2	1565	0	1579
424	1577	3	1	16	0	1597
425	14	2	1591	12	0	1619
426	9	0	12	1588	0	1609
427	1581	1	10	12	0	1604
428	13	4	1607	8	0	1632
429	1508	0	11	10	0	1529
430	1581	3	11	2	0	1597
431	20	2	1661	3	0	1686
432	15	3	15	1629	0	1662
433	7	2	9	1686	0	1704
434	2	5	1700	17	0	1724
435	1573	0	13	19	0	1605
436	1700	6	10	5	0	1721
437	1622	0	8	3	0	1633
438	1631	5	8	4	0	1648
439	1627	5	12	2	0	1646
440	21	9	1412	9	0	1451
441	12	15	1675	5	0	1707
442	9	1680	18	7	0	1714
443	12	14	1712	5	0	1743
444	6	15	16	1620	0	1657
445	12	13	20	1193	0	1238
446	9	7	4	1653	0	1673
447	13	6	5	1674	0	1698
448	14	7	1682	22	0	1725
449	13	1645	14	15	0	1687
450	10	1698	10	11	0	1729
451	12	19	9	1547	0	1587
452	5	1660	6	20	0	1691
453	1646	16	3	19	0	1684
454	1625	7	5	15	0	1652
455	28	1805	7	9	0	1849
456	27	15	3	1777	0	1822
457	17	10	9	1812	0	1848
458	12	8	1803	27	0	1850
459	1546	4	18	20	0	1588
460	1737	5	17	11	0	1770
461	30	1774	17	12	0	1833
462	1790	18	9	6	0	1823
463	25	13	1804	9	0	1851
464	18	1817	18	13	0	1866
465	12	1871	20	10	0	1913
466	5	1854	12	13	0	1884
467	5	28	8	1784	0	1825
468	1831	15	6	29	0	1881
469	27	7	45	1845	0	1924
470	31	5	1900	35	0	1971
471	14	5	32	1891	0	1942
472	12	7	2013	32	0	2064
473	15	7	29	1919	0	1970
474	12	7	24	1812	0	1855
475	9	1976	21	38	0	2044
476	2010	24	10	31	0	2075
477	31	18	18	1838	0	1905
478	24	1897	12	33	0	1966
479	1888	24	11	24	0	1947
480	1689	20	13	18	0	1740
481	1866	7	13	12	0	1898
482	41	1849	14	16	0	1920
483	21	19	1816	15	0	1871
484	11	18	31	1829	0	1889
485	16	7	26	1781	0	1830
486	18	1827	17	37	0	1899
487	18	28	1783	26	0	1855
488	17	22	1726	13	0	1778
489	1484	5	28	12	0	1529
490	21	3	18	1556	0	1598
491	20	4	1573	20	0	1617
492	13	1627	20	15	0	1675
493	13	19	14	1522	0	1568
494	11	1691	12	16	0	1730
495	9	17	1650	14	0	1690
496	1512	12	21	8	0	1553
497	1639	6	16	12	0	1673
498	28	1655	8	15	0	1706
499	18	18	6	1621	0	1663
500	18	12	1603	17	0	1650
501	11	1580	16	18	0	1625
502	1515	19	18	5	0	1557
503	18	1461	5	2	0	1486
504	12	1491	6	4	0	1513
505	8	24	3	1433	0	1468
506	4	1487	2	14	0	1507
507	1486	13	3	14	0	1516
508	19	13	2	1454	0	1488
509	8	9	1416	16	0	1449
510	5	7	1370	11	0	1393
511	3	3	24	1355	0	1385
512	5	1399	12	14	0	1430
513	1413	13	1	11	0	1438
514	13	11	6	1383	0	1413
515	9	8	1435	17	0	1469
516	3	2	15	1444	0	1464
517	1	10	9	1467	0	1487
518	1458	3	8	18	0	1487
519	15	3	2	1404	0	1424
520	12	4	1426	15	0	1457
521	5	7	1445	11	0	1468
522	4	3	20	1447	0	1474
523	6	4	14	1493	0	1517
524	4	3	1498	26	0	1531
525	1272	3	15	17	0	1307
526	15	6	1489	7	0	1517
527	15	1475	14	4	0	1508
528	4	17	9	1471	0	1501
529	5	14	1487	11	0	1517
530	4	5	1458	11	0	1478
531	3	2	22	1355	0	1382
532	1340	3	12	14	0	1369
533	16	4	1443	12	0	1475
534	11	1406	15	6	0	1438
535	1418	13	13	5	0	1449
536	14	11	1447	8	0	1480
537	1361	3	17	7	0	1388
538	1438	2	15	5	0	1460
539	20	1507	5	8	0	1540
540	17	11	6	1338	0	1372
541	5	1473	9	13	0	1500
542	8	17	1459	12	0	1496
543	1390	12	17	8	0	1427
544	1462	5	16	4	0	1487
545	25	8	1480	6	0	1519
546	14	3	1498	5	0	1520
547	4	1527	29	4	0	1564
548	1530	17	13	3	0	1563
549	26	11	6	1470	0	1513
550	11	6	7	1390	0	1414
551	5	1488	4	29	0	1526
552	1451	21	3	13	0	1488
553	20	13	1498	3	0	1534
554	16	6	17	1575	0	1614
555	1561	2	10	16	0	1589
556	25	1575	9	21	0	1630
557	26	24	1914	6	0	1970
558	6	29	1936	3	0	1974
559	8	4	65	1799	0	1876
560	5	2012	37	39	0	2093
561	5	43	2034	27	0	2109
562	5	35	36	1971	0	2047
563	2041	3	41	41	0	2126
564	41	5	2159	35	0	2240
565	36	5	45	2173	0	2259
566	12	4	2233	45	0	2294
567	5	11	2337	40	0	2393
568	7	20	92	2144	0	2263
569	3	5	2300	45	0	2353
570	1960	4	41	46	0	2051
571	42	4	2316	4	0	2366
572	2096	2	42	8	0	2148
573	43	2190	42	3	0	2278
574	2221	39	8	11	0	2279
575	45	2335	4	1	0	2385
576	40	47	3	2273	0	2363
577	11	37	6	2324	0	2378
578	3	10	2344	76	0	2433
579	5	4	2450	45	0	2504
580	3	6	83	2428	0	2520
581	4	6	2482	46	0	2538
582	13	4	52	2260	0	2329
583	5	2395	45	44	0	2489
584	4	2477	19	44	0	2544
585	3	84	12	2417	0	2516
586	7	45	10	2466	0	2528
587	4	13	2436	86	0	2539
588	7	5	50	2312	0	2374
589	5	2342	49	52	0	2448
590	11	2381	16	44	0	2452
591	7	2456	20	14	0	2497
592	11	110	15	2044	0	2180
593	2	2299	18	44	0	2363
594	2239	53	13	44	0	2349
595	48	42	19	2248	0	2357
596	44	15	2259	55	0	2373
597	16	7	56	2264	0	2343
598	12	9	2332	54	0	2407
599	9	13	2327	43	0	2392
600	7	10	2425	24	0	2466
601	9	2293	96	12	0	2410
602	10	49	2372	14	0	2445
603	2300	47	60	11	0	2418
604	2343	14	48	19	0	2424
605	2386	5	27	18	0	2436
606	92	5	23	2323	0	2443
607	2350	10	22	61	0	2443
608	55	2263	19	48	0	2385
609	37	2370	20	22	0	2449
610	2349	82	20	23	0	2474
611	47	60	2441	15	0	2563
612	45	16	58	2427	0	2546
613	15	22	2546	58	0	2641
614	7	20	2537	57	0	2621
615	8	2531	90	28	0	2657
616	13	58	61	2352	0	2484
617	7	49	22	2530	0	2608
618	2498	28	16	86	0	2628
619	51	2507	19	57	0	2634
620	39	2578	25	25	0	2667
621	19	85	2533	23	0	2660
622	13	2618	64	21	0	2716
623	2518	62	52	22	0	2654
624	2534	50	35	22	0	2641
625	89	26	2583	23	0	2721
626	45	24	2617	23	0	2709
627	23	14	112	2435	0	2584
628	13	26	70	2457	0	2566
629	17	2537	34	95	0	2683
630	20	60	27	2539	0	2646
631	23	49	27	2502	0	2601
632	22	2546	30	99	0	2697
633	25	52	24	2499	0	2600
634	23	50	35	2463	0	2571
635	15	2434	30	105	0	2584
636	14	64	2447	64	0	2589
637	19	57	67	2450	0	2593
638	2457	20	59	65	0	2601
639	2437	21	36	50	0	2544
640	99	19	2451	28	0	2597
641	2344	19	63	24	0	2450
642	2400	22	57	15	0	2494
643	86	2406	30	23	0	2545
644	59	68	2388	21	0	2536
645	17	60	2411	33	0	2521
646	16	22	92	2434	0	2564
647	2514	20	61	68	0	2663
648	2667	20	29	58	0	2774
649	96	16	27	2688	0	2827
650	2861	20	23	70	0	2974
651	2879	23	18	71	0	2991
652	2826	22	22	32	0	2902
653	121	17	2838	20	0	2996
654	51	28	3016	26	0	3121
655	2685	6	124	22	0	2837
656	52	14	2816	28	0	2910
657	30	2483	50	7	0	2570
658	63	64	41	2378	0	2546
659	9	29	2572	32	0	2642
660	7	9	2534	25	0	2575
661	5	11	77	2411	0	2504
662	2	10	2530	37	0	2579
663	2	6	2478	33	0	2519
664	5	2288	50	4	0	2347
665	2	2402	24	4	0	2432
666	2422	41	49	9	0	2521
667	22	20	3	2382	0	2427
668	2372	5	4	24	0	2405
669	26	1	2410	21	0	2458
670	20	6	25	2346	0	2397
671	10	1	20	2480	0	2511
672	2344	3	6	46	0	2399
673	27	2546	5	26	0	2604
674	18	25	2472	3	0	2518
675	4	21	2524	5	0	2554
676	2	2578	44	10	0	2634
677	6	31	2603	2	0	2642
678	3	2611	25	3	0	2642
679	5	2399	21	3	0	2428
680	3	45	2371	4	0	2423
681	2215	20	22	4	0	2261
682	22	2	23	2471	0	2518
683	22	2546	3	21	0	2592
684	5	21	2	2539	0	2567
685	2558	22	2	20	0	2602
686	2607	1	3	21	0	2632
687	2605	1	5	5	0	2616
688	44	4	2538	4	0	2590
689	22	3	21	2439	0	2485
690	1	2553	29	47	0	2630
691	2737	22	5	26	0	2790
692	23	23	3	2735	0	2784
693	24	2	4	2716	0	2746
694	5	3	3	2812	0	2823
695	3	7	2704	46	0	2760
696	2210	4	23	30	0	2267
697	25	2724	24	6	0	2779
698	29	21	6	2689	0	2745
699	14	21	6	2746	0	2787
700	2517	4	10	44	0	2575
701	28	4	2584	26	0	2642
702	25	4	2690	6	0	2725
703	8	2656	51	3	0	2718
704	8	27	2714	5	0	2754
705	2243	23	40	9	0	2315
706	31	2670	33	8	0	2742
707	27	34	2608	5	0	2674
708	2072	28	38	9	0	2147
709	30	8	2725	11	0	2774
710	28	2748	38	7	0	2821
711	10	31	32	2683	0	2756
712	17	25	11	2779	0	2832
713	11	12	2691	53	0	2767
714	10	17	2683	33	0	2743
715	9	2652	66	12	0	2739
716	2581	31	30	10	0	2652
717	32	2754	16	5	0	2807
718	32	32	15	2703	0	2782
719	9	33	2745	36	0	2823
720	2280	8	41	36	0	2365
721	36	9	33	2713	0	2791
722	28	2715	11	33	0	2787
723	6	2823	19	32	0	2880
724	7	53	12	2791	0	2863
725	7	31	13	2844	0	2895
726	2713	10	13	59	0	2795
727	35	12	6	2834	0	2887
728	31	12	2825	36	0	2904
729	2553	9	35	34	0	2631
730	2808	8	34	9	0	2859
731	59	6	2852	10	0	2927
732	2597	8	37	14	0	2656
733	45	6	32	2933	0	3016
734	38	10	8	2967	0	3023
735	15	6	6	2991	0	3018
736	16	7	10	2925	0	2958
737	8	2958	12	58	0	3036
738	2988	36	12	38	0	3074
739	3215	34	11	17	0	3277
740	69	15	3422	13	0	3519
741	3425	11	45	15	0	3496
742	3689	4	42	17	0	3752
743	3798	8	9	12	0	3827
744	3823	11	12	11	0	3857
745	91	3721	12	10	0	3834
746	46	49	3	3588	0	3686
747	11	42	3624	51	0	3728
748	10	9	3451	35	0	3505
749	2949	9	85	10	0	3053
750	3285	1	23	5	0	3314
751	59	3246	6	4	0	3315
752	3192	38	2	4	0	3236
753	43	3322	5	2	0	3372
754	28	39	0	3156	0	3223
755	3294	27	1	47	0	3369
756	3301	1	1	28	0	3331
757	3299	1	3	9	0	3312
758	65	3199	6	1	0	3271
759	3227	38	1	6	0	3272
760	45	26	1	3264	0	3336
761	3319	2	8	43	0	3372
762	45	5	3289	29	0	3368
763	28	3276	42	1	0	3347
764	3314	37	25	7	0	3383
765	42	32	3382	4	0	3460
766	28	4	39	3167	0	3238
767	11	5	3313	41	0	3370
768	7	30	3221	27	0	3285
769	10	2	66	3100	0	3178
770	11	8	3216	39	0	3274
771	13	5	35	3051	0	3104
772	9	3	26	3150	0	3188
773	3032	7	5	61	0	3105
774	42	3054	8	29	0	3133
775	31	3248	8	11	0	3298
776	9	3448	10	6	0	3473
777	18	63	3474	3	0	3558
778	12	30	47	3462	0	3551
779	16	18	3588	49	0	3671
780	3212	6	47	34	0	3299
781	3499	9	27	15	0	3550
782	69	3545	13	11	0	3638
783	40	44	11	3381	0	3476
784	14	3614	10	40	0	3678
785	3598	42	8	30	0	3678
786	60	37	4	3566	0	3667
787	47	12	3614	47	0	3720
788	10	3557	53	38	0	3658
789	20	53	3767	13	0	3853
790	20	34	55	3651	0	3760
791	15	14	3682	49	0	3760
792	3330	8	58	45	0	3441
793	57	17	3841	9	0	3924
794	45	3794	55	13	0	3907
795	16	50	43	3757	0	3866
796	15	41	11	3854	0	3921
797	3796	9	12	85	0	3902
798	3776	9	14	40	0	3839
799	84	3747	14	22	0	3867
800	48	50	3758	11	0	3867
801	23	39	3744	12	0	3818
802	3625	11	78	17	0	3731
803	55	20	3805	14	0	3894
804	45	16	3722	16	0	3799
805	20	12	3713	11	0	3756
806	22	16	3726	12	0	3776
807	24	3732	81	15	0	3852
808	3782	49	38	19	0	3888
809	64	43	17	3686	0	3810
810	3762	12	22	42	0	3838
811	53	3715	18	42	0	3828
812	3756	51	19	24	0	3850
813	60	3961	25	10	0	4056
814	52	53	15	3872	0	3992
815	18	4107	33	63	0	4221
816	18	71	4007	54	0	4150
817	24	4114	70	17	0	4225
818	24	62	49	4426	0	4561
819	4462	54	20	73	0	4609
820	70	26	15	4529	0	4640
821	60	23	4453	74	0	4610
822	29	19	73	4174	0	4295
823	19	4402	62	69	0	4552
824	20	74	4348	59	0	4501
825	4204	58	77	17	0	4356
826	82	15	65	4495	0	4657
827	4462	16	22	79	0	4579
828	4426	15	18	63	0	4522
829	112	4533	27	21	0	4693
830	4601	64	18	24	0	4707
831	4606	51	26	25	0	4708
832	107	4708	25	17	0	4857
833	60	70	22	4660	0	4812
834	25	50	20	4594	0	4689
835	13	4614	29	111	0	4767
836	21	62	20	4684	0	4787
837	20	59	4596	58	0	4733
838	23	55	68	4499	0	4645
839	11	16	4403	66	0	4496
840	20	14	3968	50	0	4052
841	11	3928	90	13	0	4042
842	19	3942	42	13	0	4016
843	6	3957	22	12	0	3997
844	24	77	9	3828	0	3938
845	7	47	3940	45	0	4039
846	3697	5	44	42	0	3788
847	50	13	38	4001	0	4102
848	39	12	4085	50	0	4186
849	10	16	4066	37	0	4129
850	6	4127	86	13	0	4232
851	12	54	34	4080	0	4180
852	3953	38	48	51	0	4090
853	44	3962	13	42	0	4061
854	30	3975	17	17	0	4039
855	6	3918	15	10	0	3949
856	12	69	9	3883	0	3973
857	6	4089	16	52	0	4163
858	6	61	12	4409	0	4488
859	8	49	10	4444	0	4511
860	41	16	4196	114	0	4367
861	3438	18	71	78	0	3605
862	74	13	4327	14	0	4428
863	84	17	71	4292	0	4464
864	16	14	4447	79	0	4556
865	10	4424	87	56	0	4577
866	4481	78	59	14	0	4632
867	76	61	17	4430	0	4584
868	66	11	6	4531	0	4614
869	4477	9	14	122	0	4622
870	4555	10	13	72	0	4650
871	4667	11	14	12	0	4704
872	125	17	4575	15	0	4732
873	4238	14	77	21	0	4350
874	79	4550	74	13	0	4716
875	57	4463	16	11	0	4547
876	18	127	33	4101	0	4279
877	9	65	8	3906	0	3988
878	12	4003	6	126	0	4147
879	15	74	9	3996	0	4094
880	3798	60	13	85	0	3956
881	78	14	3958	65	0	4115
882	53	3953	83	26	0	4115
883	3725	83	65	16	0	3889
884	75	3901	22	17	0	4015
885	59	94	3934	15	0	4102
886	14	110	77	3842	0	4043
887	20	29	3964	83	0	4096
888	19	3900	83	67	0	4069
889	16	81	58	3651	0	3806
890	15	61	3727	73	0	3876
891	20	18	3762	66	0	3866
892	15	21	125	3571	0	3732
893	3599	15	59	84	0	3757
894	3651	12	20	62	0	3745
895	3681	12	14	25	0	3732
896	132	21	3635	22	0	3810
897	66	3657	74	17	0	3814
898	19	77	61	3622	0	3779
899	12	72	20	3418	0	3522
900	9	3687	15	133	0	3844
901	3635	85	12	68	0	3800
902	75	64	11	3664	0	3814
903	67	22	3642	84	0	3815
904	21	3638	87	80	0	3826
905	3488	75	70	27	0	3660
906	75	3698	33	15	0	3821
907	60	83	21	3639	0	3803
908	19	64	31	3708	0	3822
909	12	26	23	3672	0	3733
910	27	27	3614	132	0	3800
911	20	20	78	3436	0	3554
912	26	3452	70	93	0	3641
913	23	3407	30	75	0	3535
914	27	117	3228	29	0	3401
915	3002	57	78	25	0	3162
916	3198	26	60	33	0	3317
917	121	3172	34	20	0	3347
918	2790	64	21	28	0	2903
919	2731	53	17	28	0	2829
920	101	2779	24	24	0	2928
921	57	66	17	2812	0	2952
922	30	53	3061	78	0	3222
923	21	27	3029	63	0	3140
924	2970	38	104	27	0	3139
925	74	3010	60	34	0	3178
926	62	73	24	3004	0	3163
927	32	60	18	3065	0	3175
928	29	22	19	3080	0	3150
929	2916	23	20	110	0	3069
930	75	32	18	2902	0	3027
931	59	21	19	2837	0	2936
932	25	16	2704	110	0	2855
933	2479	23	66	72	0	2640
934	66	2696	59	25	0	2846
935	2774	59	23	31	0	2887
936	67	2756	27	21	0	2871
937	60	72	34	2658	0	2824
938	2761	59	19	70	0	2909
939	2812	33	22	51	0	2918
940	103	25	2756	31	0	2915
941	2770	22	67	33	0	2892
942	72	32	2860	27	0	2991
943	64	29	2701	29	0	2823
944	30	27	2673	22	0	2752
945	22	26	2824	28	0	2900
946	21	20	110	2864	0	3015
947	21	26	2925	65	0	3037
948	23	28	65	2865	0	2981
949	2846	26	61	81	0	3014
950	70	18	26	2827	0	2941
951	2730	20	24	90	0	2864
952	71	2788	30	65	0	2954
953	63	66	12	2781	0	2922
954	45	63	2675	70	0	2853
955	19	3045	71	67	0	3202
956	17	103	58	2924	0	3102
957	23	59	2951	64	0	3097
958	15	2671	47	49	0	2782
959	15	2688	44	23	0	2770
960	20	81	2681	22	0	2804
961	10	82	47	2510	0	2649
962	11	16	2600	47	0	2674
963	2294	3	40	35	0	2372
964	2447	4	33	13	0	2497
965	66	2373	10	6	0	2455
966	2379	38	12	6	0	2435
967	42	34	8	2361	0	2445
968	34	15	2302	42	0	2393
969	2180	8	42	44	0	2274
970	41	4	2339	11	0	2395
971	29	2339	48	10	0	2426
972	2320	34	65	10	0	2429
973	40	27	7	2294	0	2368
974	32	10	2333	37	0	2412
975	2301	0	37	32	0	2370
976	2283	3	32	10	0	2328
977	2319	5	5	6	0	2335
978	67	3	3	2274	0	2347
979	32	3	9	2311	0	2355
980	7	13	2290	64	0	2374
981	3	2288	44	35	0	2370
982	9	40	29	2254	0	2332
983	8	31	6	2332	0	2377
984	5	10	2314	65	0	2394
985	6	7	2288	39	0	2340
986	8	6	64	2252	0	2330
987	2193	2	33	45	0	2273
988	37	2252	13	31	0	2333
989	2247	38	7	9	0	2301
990	41	2225	9	9	0	2284
991	33	41	2254	5	0	2333
992	6	35	2246	30	0	2317
993	2171	10	70	3	0	2254
994	2348	3	33	9	0	2393
995	74	2327	16	9	0	2426
996	39	45	2298	9	0	2391
997	17	32	48	2262	0	2359
998	18	7	35	2200	0	2260
999	12	2295	17	68	0	2392
1000	14	41	7	2284	0	2346
1001	8	37	2302	48	0	2395
1002	2193	14	43	41	0	2291
1003	2315	2	38	12	0	2367
1004	2346	5	9	15	0	2375
1005	2422	9	10	10	0	2451
1006	86	11	2321	9	0	2427
1007	2261	5	48	12	0	2326
1008	49	14	2314	6	0	2383
1009	34	2294	56	17	0	2401
1010	14	43	44	2299	0	2400
1011	2352	39	14	48	0	2453
1012	49	13	8	2511	0	2581
1013	51	7	2500	60	0	2618
1014	2498	8	56	58	0	2620
1015	2559	7	55	18	0	2639
1016	109	6	16	2523	0	2654
1017	63	8	11	2553	0	2635
1018	21	14	2517	99	0	2651
1019	17	2530	61	57	0	2665
1020	2427	59	55	20	0	2561
1021	59	62	2368	9	0	2498
1022	2156	10	55	14	0	2235
1023	65	2161	60	13	0	2299
1024	2172	59	15	11	0	2257
1025	70	2168	15	8	0	2261
1026	55	2190	7	17	0	2269
1027	18	95	18	2144	0	2275
1028	22	49	13	2201	0	2285
1029	24	8	15	2237	0	2284
1030	19	11	11	2274	0	2315
1031	14	12	2163	104	0	2293
1032	2095	7	57	64	0	2223
1033	2225	4	53	21	0	2303
1034	2262	11	16	9	0	2298
1035	107	4	15	2141	0	2267
1036	67	4	17	2182	0	2270
1037	2128	8	15	92	0	2243
1038	2159	10	10	53	0	2232
1039	2168	7	17	27	0	2219
1040	112	18	13	2092	0	2235
1041	54	9	13	2076	0	2152
1042	24	11	1986	96	0	2117
1043	20	7	1963	52	0	2042
1044	11	1940	100	19	0	2070
1045	1627	95	109	38	0	1869
1046	1578	33	43	9	0	1663
1047	1575	7	5	17	0	1604
1048	70	12	1570	12	0	1664
1049	1597	7	39	11	0	1654
1050	1623	8	34	14	0	1679
1051	1648	4	11	16	0	1679
1052	78	3	13	1560	0	1654
1053	48	4	11	1540	0	1603
1054	22	11	9	1544	0	1586
1055	20	9	1273	63	0	1365
1056	1119	8	32	37	0	1196
1057	36	1200	34	6	0	1276
1058	1139	30	6	8	0	1183
1059	32	1130	6	11	0	1179
1060	33	1109	2	8	0	1152
1061	13	49	4	1083	0	1149
1062	31	27	6	1041	0	1105
1063	10	1056	10	52	0	1128
1064	996	21	4	27	0	1048
1065	996	25	5	9	0	1035
1066	49	4	3	974	0	1030
1067	29	4	993	32	0	1058
1068	14	1	993	31	0	1039
1069	9	7	1032	13	0	1061
1070	16	3	1013	9	0	1041
1071	887	3	56	3	0	949
1072	894	4	22	4	0	924
1073	47	2	3	873	0	925
1074	34	6	863	20	0	923
1075	11	2	20	845	0	878
1076	6	878	24	25	0	933
1077	11	941	6	25	0	983
1078	947	33	4	7	0	991
1079	941	25	1	9	0	976
1080	958	7	5	15	0	985
1081	49	3	6	939	0	997
1082	30	6	4	977	0	1017
1083	14	3	5	989	0	1011
1084	9	4	6	994	0	1013
1085	14	2	959	45	0	1020
1086	10	5	21	977	0	1013
1087	1018	2	20	27	0	1067
1088	31	3	8	1064	0	1106
1089	30	2	4	1063	0	1099
1090	12	2	7	1061	0	1082
1091	10	997	8	47	0	1062
1092	8	1007	6	28	0	1049
1093	7	985	5	11	0	1008
1094	11	33	3	941	0	988
1095	11	19	4	960	0	994
1096	956	4	5	44	0	1009
1097	973	5	5	22	0	1005
1098	998	4	3	9	0	1014
1099	43	6	3	969	0	1021
1100	28	5	1	963	0	997
1101	10	958	5	38	0	1011
1102	11	1014	5	24	0	1054
1103	1003	38	3	10	0	1054
1104	32	18	0	968	0	1018
1105	953	4	2	22	0	981
1106	945	2	2	24	0	973
1107	34	2	7	911	0	954
1108	18	1037	10	20	0	1085
1109	1034	18	5	19	0	1076
1110	1160	15	5	10	0	1190
1111	34	4	1242	8	0	1288
1112	1069	3	10	5	0	1087
1113	12	1102	9	2	0	1125
1114	9	6	0	1072	0	1087
1115	1244	7	2	13	0	1266
1116	9	0	1	1282	0	1292
1117	12	1	1	1271	0	1285
1118	2	1306	4	19	0	1331
1119	1318	8	0	14	0	1340
1120	1335	12	0	5	0	1352
1121	20	1343	2	2	0	1367
1122	15	1383	4	1	0	1403
1123	1390	19	1	0	0	1410
1124	1390	14	0	2	0	1406
1125	22	4	1360	3	0	1389
1126	14	1	1314	2	0	1331
1127	3	1	1379	0	0	1383
1128	2	0	21	1372	0	1395
1129	0	1	14	1401	0	1416
1130	1	4	1435	22	0	1462
1131	1391	0	8	19	0	1418
1132	1500	1	12	7	0	1520
1133	1506	0	3	2	0	1511
1134	1499	1	2	3	0	1505
1135	23	3	1674	1	0	1701
1136	1653	2	7	5	0	1667
1137	1684	1	12	3	0	1700
1138	1710	1	4	4	0	1719
1139	1717	0	0	4	0	1721
1140	1680	1	0	3	0	1684
1141	23	0	1691	3	0	1717
1142	18	1669	9	2	0	1698
1143	4	10	14	1660	0	1688
1144	6	15	2	1730	0	1753
1145	3	6	1710	25	0	1744
1146	1598	1	9	18	0	1626
1147	13	4	13	1746	0	1776
1148	16	6	1712	9	0	1743
1149	6	8	1711	12	0	1737
1150	5	1857	28	4	0	1894
1151	5	10	16	1937	0	1968
1152	4	12	5	1971	0	1992
1153	9	4	4	2013	0	2030
1154	2007	3	6	23	0	2039
1155	10	1	3	2031	0	2045
1156	15	3	2026	15	0	2059
1157	8	5	1924	17	0	1954
1158	10	5	2213	7	0	2235
1159	8	3	26	2223	0	2260
1160	2300	3	16	13	0	2332
1161	16	5	2347	16	0	2384
1162	2316	2	11	5	0	2334
1163	2739	1	16	19	0	2775
1164	30	0	9	2792	0	2831
1165	25	4	3	2820	0	2852
1166	9	2808	8	29	0	2854
1167	8	14	2773	18	0	2813
1168	2664	13	12	6	0	2695
1169	17	4	15	2868	0	2904
1170	18	2848	11	34	0	2911
1171	14	13	5	2929	0	2961
1172	11	20	2899	15	0	2945
1173	9	5	15	2832	0	2861
1174	3	2905	23	15	0	2946
1175	9	10	10	2924	0	2953
1176	2910	13	6	21	0	2950
1177	19	3	6	2899	0	2927
1178	22	2858	5	19	0	2904
1179	11	2886	9	19	0	2925
1180	2693	22	7	10	0	2732
1181	20	28	2927	8	0	2983
1182	21	4	15	2900	0	2940
1183	17	1	17	3007	0	3042
1184	10	5	3016	29	0	3060
1185	10	3015	13	26	0	3064
1186	10	18	3025	8	0	3061
1187	11	16	14	2930	0	2971
1188	6	3078	21	16	0	3121
1189	3153	9	6	23	0	3191
1190	10	3161	10	11	0	3192
1191	19	3199	4	13	0	3235
1192	3203	36	6	11	0	3256
1193	3444	19	3	14	0	3480
1194	3486	6	10	17	0	3519
1195	29	3	6	3513	0	3551
1196	19	5	3529	17	0	3570
1197	3472	7	16	21	0	3516
1198	3804	5	20	16	0	3845
1199	42	6	7	3864	0	3919
1200	26	11	3831	43	0	3911
1201	12	3865	29	31	0	3937
1202	3851	24	21	21	0	3917
1203	3890	27	11	13	0	3941
1204	42	3973	16	11	0	4042
1205	31	4199	11	6	0	4247
1206	4197	42	7	23	0	4269
1207	4185	24	5	11	0	4225
1208	4074	5	7	15	0	4101
1209	52	5	3	4067	0	4127
1210	30	13	4070	29	0	4142
1211	14	4	23	3934	0	3975
1212	12	17	3939	30	0	3998
1213	4	3879	31	28	0	3942
1214	8	3957	20	13	0	3998
1215	10	32	1	3841	0	3884
1216	7	16	3	3957	0	3983
1217	6	7	2	3857	0	3872
1218	3	3946	4	33	0	3986
1219	3885	18	6	22	0	3931
1220	3826	17	2	7	0	3852
1221	38	3921	7	6	0	3972
1222	16	24	3	3820	0	3863
1223	7	3864	13	22	0	3906
1224	13	21	1	3844	0	3879
1225	10	3930	7	23	0	3970
1226	3891	22	1	21	0	3935
1227	25	22	6	3915	0	3968
1228	26	11	3904	26	0	3967
1229	3773	5	19	26	0	3823
1230	3878	3	18	11	0	3910
1231	33	20	3866	6	0	3925
1232	22	6	21	3835	0	3884
1233	9	9	3936	26	0	3980
1234	11	5	21	3958	0	3995
1235	10	14	3829	23	0	3876
1236	3639	11	24	26	0	3700
1237	27	13	20	3850	0	3910
1238	20	3875	13	21	0	3929
1239	3935	25	6	27	0	3993
1240	30	24	2	4006	0	4062
1241	32	9	4	4062	0	4107
1242	18	17	4041	44	0	4120
1243	17	7	26	4257	0	4307
1244	12	9	4425	37	0	4483
1245	11	11	4515	38	0	4575
1246	18	11	67	4539	0	4635
1247	15	17	4763	41	0	4836
1248	4578	13	49	47	0	4687
1249	5436	8	40	17	0	5501
1250	5618	9	8	22	0	5657
1251	121	5928	15	16	0	6080
1252	80	78	7	5928	0	6093
1253	30	76	7	5395	0	5508
1254	17	6016	19	129	0	6181
1255	5988	80	11	80	0	6159
1256	85	72	11	5913	0	6081
1257	82	24	6137	94	0	6337
1258	23	23	5861	95	0	6002
1259	10	5890	150	35	0	6085
1260	5912	83	84	23	0	6102
1261	92	87	5898	18	0	6095
1262	5358	15	89	23	0	5485
1263	87	5317	90	20	0	5514
1264	82	83	5572	14	0	5751
1265	22	74	5458	14	0	5568
1266	21	20	5709	14	0	5764
1267	18	5490	164	22	0	5694
1268	16	90	5513	15	0	5634
1269	5316	75	97	26	0	5514
1270	92	19	77	5234	0	5422
1271	84	8	18	5653	0	5763
1272	31	14	6	5762	0	5813
1273	23	14	6	5784	0	5827
1274	18	16	5643	170	0	5847
1275	23	11	80	5606	0	5720
1276	13	11	78	5648	0	5750
1277	5580	10	19	179	0	5788
1278	5726	7	20	102	0	5855
1279	5498	7	24	31	0	5560
1280	167	23	5658	19	0	5867
1281	85	5687	109	21	0	5902
1282	20	5819	98	15	0	5952
1283	5391	167	29	19	0	5606
1284	90	5711	17	10	0	5828
1285	93	100	10	5459	0	5662
1286	28	90	17	5656	0	5791
1287	21	30	5560	174	0	5785
1288	10	5426	102	109	0	5647
1289	11	99	5497	28	0	5635
1290	5274	89	103	26	0	5492
1291	5479	16	103	30	0	5628
1292	177	12	34	5469	0	5692
1293	114	8	28	5387	0	5537
1294	36	9	21	5440	0	5506
1295	32	10	22	5473	0	5537
1296	26	25	5382	193	0	5626
1297	22	75	98	5232	0	5427
1298	19	17	5355	112	0	5503
1299	17	22	5194	118	0	5351
1300	10	5179	189	51	0	5429
1301	5170	98	109	26	0	5403
1302	102	5410	42	22	0	5576
1303	112	106	25	5042	0	5285
1304	26	105	5427	99	0	5657
1305	5026	25	106	117	0	5274
1306	111	20	5414	35	0	5580
1307	5460	13	116	28	0	5617
1308	5469	12	113	20	0	5614
1309	211	16	28	5566	0	5821
1310	123	21	25	5555	0	5724
1311	34	16	25	5667	0	5742
1312	30	19	5451	226	0	5726
1313	5147	21	115	137	0	5420
1314	133	5368	127	28	0	5656
1315	143	103	34	5089	0	5369
1316	5350	113	29	134	0	5626
1317	5424	33	37	130	0	5624
1318	5544	21	24	44	0	5633
1319	245	33	5261	37	0	5576
1320	5400	35	125	40	0	5600
1321	5462	26	121	59	0	5668
1322	237	28	4984	56	0	5305
1323	139	38	5470	39	0	5686
1324	51	28	244	5303	0	5626
1325	48	28	5561	136	0	5773
1326	43	5326	164	138	0	5671
1327	31	5540	167	31	0	5769
1328	5359	230	49	36	0	5674
1329	147	5559	51	39	0	5796
1330	151	134	43	5470	0	5798
1331	5263	118	54	151	0	5586
1332	139	5608	52	149	0	5948
1333	124	140	60	5573	0	5897
1334	49	116	57	5652	0	5874
1335	33	42	5495	267	0	5837
1336	47	20	149	5482	0	5698
1337	49	41	5566	164	0	5820
1338	47	20	5535	154	0	5756
1339	58	19	226	5328	0	5631
1340	36	19	137	5455	0	5647
1341	5340	18	33	268	0	5659
1342	151	5633	44	161	0	5989
1343	152	127	37	5365	0	5681
1344	60	135	33	5415	0	5643
1345	5102	26	25	262	0	5415
1346	160	5018	35	154	0	5367
1347	144	4844	32	51	0	5071
1348	43	4587	32	41	0	4703
1349	25	4142	36	29	0	4232
1350	3299	164	85	23	0	3571
1351	3284	84	18	23	0	3409
1352	3265	27	11	13	0	3316
1353	3252	31	7	16	0	3306
1354	167	13	8	3120	0	3308
1355	90	24	3082	86	0	3282
1356	29	3067	81	86	0	3263
1357	27	89	71	2924	0	3111
1358	26	71	2939	82	0	3118
1359	20	22	89	2941	0	3072
1360	22	10	73	2961	0	3066
1361	17	14	2949	150	0	3130
1362	10	10	93	2951	0	3064
1363	19	17	81	2804	0	2921
1364	2849	10	27	152	0	3038
1365	2846	20	18	95	0	2979
1366	2902	15	14	35	0	2966
1367	2939	21	6	28	0	2994
1368	161	23	10	2793	0	2987
1369	96	16	9	2866	0	2987
1370	39	16	10	2913	0	2978
1371	2747	16	12	151	0	2926
1372	101	16	15	2847	0	2979
1373	83	21	14	2852	0	2970
1374	32	20	2777	155	0	2984
1375	37	11	84	2697	0	2829
1376	31	2696	87	99	0	2913
1377	33	2819	21	83	0	2956
1378	2644	124	21	32	0	2821
1379	88	73	2648	26	0	2835
1380	67	2530	64	35	0	2696
1381	2529	68	59	27	0	2683
1382	78	62	27	2571	0	2738
1383	65	21	2544	95	0	2725
1384	36	23	75	2416	0	2550
1385	19	2564	72	92	0	2747
1386	2474	67	19	72	0	2632
1387	73	2536	22	33	0	2664
1388	2548	80	12	22	0	2662
1389	2564	57	13	26	0	2660
1390	133	20	8	2529	0	2690
1391	87	11	14	2487	0	2599
1392	34	2547	10	126	0	2717
1393	2560	75	7	85	0	2727
1394	84	62	2521	32	0	2699
1395	2446	34	75	32	0	2587
1396	2386	13	52	32	0	2483
1397	116	17	2321	26	0	2480
1398	64	10	59	2183	0	2316
1399	2215	11	50	79	0	2355
1400	65	15	2213	59	0	2352
1401	45	15	2092	23	0	2175
1402	1851	13	87	12	0	1963
1403	65	1920	46	16	0	2047
1404	44	1849	45	12	0	1950
1405	76	104	12	1739	0	1931
1406	20	46	1713	56	0	1835
1407	1598	15	52	35	0	1700
1408	50	12	1725	30	0	1817
1409	33	1557	50	18	0	1658
1410	1574	40	32	11	0	1657
1411	52	37	13	1555	0	1657
1412	1587	16	7	51	0	1661
1413	55	15	1543	37	0	1650
1414	47	4	44	1497	0	1592
1415	19	1545	31	51	0	1646
1416	21	43	13	1528	0	1605
1417	21	33	8	1540	0	1602
1418	14	18	1512	71	0	1615
1419	14	1477	48	46	0	1585
1420	14	1452	39	20	0	1525
1421	15	61	1397	12	0	1485
1422	1317	34	41	14	0	1406
1423	1415	11	35	11	0	1472
1424	64	27	16	1353	0	1460
1425	1312	6	10	39	0	1367
1426	52	1258	11	29	0	1350
1427	33	1360	11	11	0	1415
1428	1350	55	2	12	0	1419
1429	48	42	6	1377	0	1473
1430	1414	14	9	43	0	1480
1431	1476	6	3	45	0	1530
1432	71	6	10	1305	0	1392
1433	45	6	1336	46	0	1433
1434	1302	8	42	38	0	1390
1435	1370	9	34	18	0	1431
1436	72	10	15	1301	0	1398
1437	47	1289	11	44	0	1391
1438	19	53	10	1289	0	1371
1439	16	37	1273	43	0	1369
1440	15	8	1245	35	0	1303
1441	7	1246	68	15	0	1336
1442	40	24	21	860	0	945
1443	5	18	6	894	0	923
1444	8	10	870	30	0	918
1445	827	2	26	19	0	874
1446	923	5	20	14	0	962
1447	922	6	13	5	0	946
1448	940	9	6	2	0	957
1449	42	873	0	13	0	928
1450	21	912	7	9	0	949
1451	920	38	5	4	0	967
1452	33	18	7	923	0	981
1453	23	9	10	918	0	960
1454	16	948	6	40	0	1010
1455	11	23	3	983	0	1020
1456	9	16	6	965	0	996
1457	8	953	10	39	0	1010
1458	15	24	952	22	0	1013
1459	10	23	28	959	0	1020
1460	973	6	20	28	0	1027
1461	972	5	11	22	0	1010
1462	43	6	948	12	0	1009
1463	27	10	966	8	0	1011
1464	10	8	993	8	0	1019
1465	9	5	53	952	0	1019
1466	13	5	990	27	0	1035
1467	16	13	953	21	0	1003
1468	12	5	41	871	0	929
1469	14	891	22	31	0	958
1470	12	30	925	29	0	996
1471	10	961	26	11	0	1008
1472	884	27	24	7	0	942
1473	23	904	10	11	0	948
1474	26	30	4	834	0	894
1475	860	16	2	30	0	908
1476	21	10	5	866	0	902
1477	27	1	13	868	0	909
1478	13	4	848	44	0	909
1479	10	832	27	24	0	893
1480	10	878	23	8	0	919
1481	10	31	6	810	0	857
1482	6	18	2	799	0	825
1483	9	5	7	801	0	822
1484	11	4	800	34	0	849
1485	6	6	785	21	0	818
1486	713	7	28	6	0	754
1487	16	5	774	8	0	803
1488	16	2	756	9	0	783
1489	9	739	30	7	0	785
1490	5	17	17	696	0	735
1491	4	15	705	17	0	741
1492	6	3	12	628	0	649
1493	3	3	649	14	0	669
1494	4	1	18	647	0	670
1495	4	2	648	16	0	670
1496	4	2	14	641	0	661
1497	3	3	11	590	0	607
1498	2	617	8	21	0	648
1499	3	16	6	609	0	634
1500	6	619	5	15	0	645
1501	5	13	5	623	0	646
1502	6	7	4	633	0	650
1503	625	7	3	22	0	657
1504	11	4	6	629	0	650
1505	9	2	616	21	0	648
1506	6	5	11	619	0	641
1507	2	3	10	635	0	650
1508	2	5	637	22	0	666
1509	3	2	623	15	0	643
1510	6	4	18	591	0	619
1511	5	3	13	616	0	637
1512	1	4	615	19	0	639
1513	1	591	15	13	0	620
1514	3	619	11	6	0	639
1515	612	15	7	9	0	643
1516	12	6	7	630	0	655
1517	656	4	5	16	0	681
1518	638	3	8	16	0	665
1519	16	673	9	7	0	705
1520	698	13	8	7	0	726
1521	703	10	5	4	0	722
1522	17	8	725	6	0	756
1523	10	2	15	688	0	715
1524	5	1	721	19	0	746
1525	3	3	19	717	0	742
1526	1	3	695	20	0	719
1527	2	624	15	13	0	654
1528	3	603	10	3	0	619
1529	0	10	4	541	0	555
1530	554	8	3	9	0	574
1531	9	5	0	515	0	529
1532	5	1	3	528	0	537
1533	5	3	495	11	0	514
1534	4	0	496	11	0	511
1535	2	5	498	5	0	510
1536	5	2	12	489	0	508
1537	2	3	10	468	0	483
1538	1	488	5	15	0	509
1539	0	519	3	12	0	534
1540	502	11	5	5	0	523
1541	5	518	7	7	0	537
1542	6	9	507	9	0	531
1543	4	5	9	511	0	529
1544	4	5	567	10	0	586
1545	1	571	11	8	0	591
1546	4	6	9	534	0	553
1547	514	8	6	8	0	536
1548	6	3	529	13	0	551
1549	8	529	9	11	0	557
1550	3	9	535	4	0	551
1551	1	541	12	4	0	558
1552	2	7	6	499	0	514
1553	514	5	3	11	0	533
1554	482	4	4	9	0	499
1555	8	478	4	6	0	496
1556	485	4	4	6	0	499
1557	6	6	6	475	0	493
1558	480	2	4	8	0	494
1559	6	4	474	12	0	496
1560	6	2	474	8	0	490
1561	3	5	13	457	0	478
1562	2	5	9	479	0	495
1563	3	4	458	8	0	473
1564	2	1	5	451	0	459
1565	458	3	5	8	0	474
1566	448	0	7	5	0	460
1567	8	450	2	6	0	466
1568	7	456	3	5	0	471
1569	446	7	1	5	0	459
1570	4	5	3	395	0	407
1571	395	5	3	3	0	406
1572	7	396	4	5	0	412
1573	396	5	2	6	0	409
1574	7	9	386	5	0	407
1575	6	7	368	2	0	383
1576	6	3	7	364	0	380
1577	4	4	377	5	0	390
1578	4	5	4	374	0	387
1579	3	2	6	372	0	383
1580	6	1	397	11	0	415
1581	5	0	9	393	0	407
1582	2	4	7	399	0	412
1583	1	2	428	10	0	441
1584	2	2	425	10	0	439
1585	375	1	11	5	0	392
1586	4	0	402	3	0	409
1587	441	0	4	3	0	448
1588	601	2	7	3	0	613
1589	20	4	607	0	0	631
1590	11	2	635	2	0	650
1591	4	1	21	614	0	640
1592	0	2	13	579	0	594
1593	1	612	7	16	0	636
1594	2	626	5	16	0	649
1595	2	22	619	3	0	646
1596	593	14	13	3	0	623
1597	619	1	11	7	0	638
1598	23	5	604	3	0	635
1599	16	4	609	0	0	629
1600	1	3	24	562	0	590
1601	2	593	17	10	0	622
1602	5	10	3	596	0	614
1603	5	11	4	611	0	631
1604	607	2	4	22	0	635
1605	602	2	3	17	0	624
1606	23	2	2	605	0	632
1607	14	2	613	12	0	641
1608	574	1	12	19	0	606
1609	12	626	16	3	0	657
1610	639	8	5	1	0	653
1611	608	12	4	3	0	627
1612	23	641	5	5	0	674
1613	12	648	7	2	0	669
1614	2	20	3	642	0	667
1615	6	14	0	645	0	665
1616	5	663	2	21	0	691
1617	3	12	5	650	0	670
1618	5	17	1	663	0	686
1619	4	4	635	22	0	665
1620	595	0	11	18	0	624
1621	616	4	14	2	0	636
1622	606	2	5	4	0	617
1623	23	2	3	584	0	612
1624	586	0	4	12	0	602
1625	12	569	4	14	0	599
1626	14	9	3	516	0	542
1627	4	576	5	7	0	592
1628	2	620	2	14	0	638
1629	618	19	1	4	0	642
1630	622	12	2	4	0	640
1631	640	2	1	4	0	647
1632	617	1	1	4	0	623
1633	610	2	4	1	0	617
1634	23	3	582	2	0	610
1635	579	2	10	3	0	594
1636	12	2	600	3	0	617
1637	561	2	9	5	0	577
1638	576	1	10	3	0	590
1639	584	4	4	2	0	594
1640	22	8	579	3	0	612
1641	11	2	12	507	0	532
1642	5	562	9	9	0	585
1643	567	9	2	8	0	586
1644	562	9	2	4	0	577
1645	19	562	1	4	0	586
1646	597	10	3	4	0	614
1647	13	11	2	548	0	574
1648	12	579	5	6	0	602
1649	604	9	0	10	0	623
1650	611	12	1	6	0	630
1651	22	4	1	611	0	638
1652	635	2	0	16	0	653
1653	15	2	4	635	0	656
1654	13	3	6	634	0	656
1655	8	4	621	21	0	654
1656	10	3	10	628	0	651
1657	12	2	7	646	0	667
1658	8	6	657	17	0	688
1659	8	4	675	9	0	696
1660	10	1	19	696	0	726
1661	8	0	719	13	0	740
1662	659	6	15	11	0	691
1663	14	758	14	5	0	791
1664	12	10	4	753	0	779
1665	9	11	3	777	0	800
1666	9	2	0	779	0	790
1667	774	1	3	21	0	799
1668	772	2	4	12	0	790
1669	772	3	3	4	0	782
1670	22	769	4	6	0	801
1671	14	9	4	774	0	801
1672	7	10	2	791	0	810
1673	789	6	1	17	0	813
1674	787	3	0	11	0	801
1675	23	3	2	785	0	813
1676	13	7	802	12	0	834
1677	775	5	9	12	0	801
1678	808	1	7	12	0	828
1679	19	5	810	7	0	841
1680	739	4	9	8	0	760
1681	12	5	817	9	0	843
1682	825	2	13	8	0	848
1683	16	29	10	809	0	864
1684	14	902	3	9	0	928
1685	8	11	979	9	0	1007
1686	9	990	15	3	0	1017
1687	4	959	10	10	0	983
1688	851	6	6	2	0	865
1689	6	2	1	848	0	857
1690	2	1	0	829	0	832
1691	851	0	1	10	0	862
1692	6	1	0	895	0	902
1693	2	1	0	899	0	902
1694	3	0	0	912	0	915
1695	2	0	1	916	0	919
1696	2	1	917	9	0	929
1697	2	2	915	2	0	921
1698	1	917	8	3	0	929
1699	934	6	1	3	0	944
1700	7	2	0	941	0	950
1701	3	933	2	8	0	946
1702	3	7	1	1028	0	1039
1703	1	1	2	1034	0	1038
1704	3	1	0	1029	0	1033
1705	2	0	0	1039	0	1041
1706	1	0	1	1026	0	1028
1707	2	1009	0	7	0	1018
1708	1	6	1	1012	0	1020
1709	1	2	984	8	0	995
1710	1	989	6	4	0	1000
1711	0	5	1	996	0	1002
1712	1	1	0	989	0	991
1713	0	966	2	6	0	974
1714	0	985	1	3	0	989
1715	953	8	1	2	0	964
1716	4	940	2	1	0	947
1717	940	5	1	4	0	950
1718	912	2	0	6	0	920
1719	7	3	1069	1	0	1080
1720	5	1	5	1030	0	1041
1721	1	2	1110	7	0	1120
1722	1	1114	3	4	0	1122
1723	3	6	1	1036	0	1046
1724	1	2	0	1124	0	1127
1725	2	0	2	1143	0	1147
1726	1	0	1	1156	0	1158
1727	3	2	1161	8	0	1174
1728	0	2	7	1128	0	1137
1729	1	3	1207	10	0	1221
1730	2	4	1197	3	0	1206
1731	1073	0	10	5	0	1088
1732	1204	2	5	3	0	1214
1733	1219	1	2	5	0	1227
1734	10	1208	4	3	0	1225
1735	7	7	2	1224	0	1240
1736	5	7	1304	11	0	1327
1737	5	0	9	1289	0	1303
1738	3	3	1349	9	0	1364
1739	1264	2	9	8	0	1283
1740	1327	1	3	3	0	1334
1741	1310	2	1	6	0	1319
1742	10	7	1303	0	0	1320
1743	3	11	1282	4	0	1300
1744	4	3	11	1319	0	1337
1745	5	3	3	1317	0	1328
1746	5	2	1	1363	0	1371
1747	4	5	1336	11	0	1356
1748	3	2	1268	6	0	1279
1749	1250	0	11	4	0	1265
1750	9	1	4	1319	0	1333
1751	7	3	2	1389	0	1401
1752	1385	1	1	14	0	1401
1753	7	4	3	1390	0	1404
1754	1547	0	2	21	0	1570
1755	1563	0	2	7	0	1572
1756	1564	4	1	10	0	1579
1757	13	4	1586	4	0	1607
1758	6	1564	10	3	0	1583
1759	1574	10	4	3	0	1591
1760	12	5	2	1582	0	1601
1761	10	1	2	1576	0	1589
1762	5	1581	2	12	0	1600
1763	1581	9	0	10	0	1600
1764	1576	5	1	4	0	1586
1765	1582	2	2	4	0	1590
1766	12	1609	1	4	0	1626
1767	1781	10	4	7	0	1802
1768	1827	4	2	6	0	1839
1769	1864	1	2	10	0	1877
1770	16	1	2	1838	0	1857
1771	8	0	2	1869	0	1879
1772	4	4	1950	15	0	1973
1773	5	0	11	1908	0	1924
1774	2	0	5	1956	0	1963
1775	3	4	1943	14	0	1964
1776	1804	1	11	8	0	1824
1777	1937	2	3	7	0	1949
1778	14	0	3	1925	0	1942
1779	5	1937	6	11	0	1959
1780	2	1961	6	6	0	1975
1781	3	13	2	1939	0	1957
1782	2	9	1893	9	0	1913
1783	6	16	9	1847	0	1878
1784	4	0	1927	12	0	1943
1785	0	5	2024	4	0	2033
1786	1	1	7	2051	0	2060
1787	2065	0	3	7	0	2075
1788	2092	0	2	7	0	2101
1789	11	2	1	2198	0	2212
1790	9	3	1	2305	0	2318
1791	6	1	1	2311	0	2319
1792	0	1	1	2285	0	2287
1793	2295	0	1	15	0	2311
1794	2248	3	2	7	0	2260
1795	2270	2	1	4	0	2277
1796	11	1	2279	1	0	2292
1797	10	1	5	2260	0	2276
1798	4	2	2	2290	0	2298
1799	2289	3	0	6	0	2298
1800	4	2332	5	7	0	2348
1801	2321	5	3	2	0	2331
1802	2283	4	0	5	0	2292
1803	2285	1	2	3	0	2291
1804	2269	1	2	3	0	2275
1805	14	7	2621	1	0	2643
1806	6	2	2533	4	0	2545
1807	2715	0	8	4	0	2727
1808	2824	0	4	1	0	2829
1809	2812	0	2	6	0	2820
1810	2824	2	0	9	0	2835
1811	13	5	3044	7	0	3069
1812	11	3057	20	7	0	3095
1813	7	16	13	3297	0	3333
1814	3706	12	6	32	0	3756
1815	3777	5	3	18	0	3803
1816	3931	2	1	10	0	3944
1817	3971	1	0	6	0	3978
1818	3963	0	0	10	0	3973
1819	3752	2	5	3	0	3762
1820	56	15	3490	6	0	3567
1821	29	4	3668	3	0	3704
1822	12	3	41	3657	0	3713
1823	8	8	3808	32	0	3856
1824	5	3737	37	21	0	3800
1825	3	3876	21	12	0	3912
1826	11	47	3	3989	0	4050
1827	5	28	4268	28	0	4329
1828	10	10	4099	22	0	4141
1829	3956	3	46	14	0	4019
1830	4585	2	34	5	0	4626
1831	66	2	6	4577	0	4651
1832	4666	2	6	39	0	4713
1833	46	1	5	4634	0	4686
1834	35	2	2	4711	0	4750
1835	13	12	4887	67	0	4979
1836	11	5	4794	35	0	4845
1837	9	4	67	4895	0	4975
1838	10	6	4939	43	0	4998
1839	4476	9	47	39	0	4571
1840	4964	0	28	19	0	5011
1841	80	5125	24	4	0	5233
1842	5130	37	12	18	0	5197
1843	67	40	5120	8	0	5235
1844	5018	8	43	11	0	5080
1845	5228	3	32	13	0	5276
1846	5332	1	14	12	0	5359
1847	82	7	22	5187	0	5298
1848	46	5370	26	39	0	5481
1849	5444	41	16	43	0	5544
1850	5466	32	11	19	0	5528
1851	99	16	7	5400	0	5522
1852	5446	9	5	76	0	5536
1853	78	5562	12	51	0	5703
1854	48	54	20	5487	0	5609
1855	32	44	5450	67	0	5593
1856	4370	10	73	59	0	4512
1857	67	12	5484	25	0	5588
1858	58	2	59	5441	0	5560
1859	27	5534	63	57	0	5681
1860	30	5992	19	65	0	6106
1861	30	123	18	6054	0	6225
1862	22	6111	29	88	0	6250
1863	36	109	26	8292	0	8463
1864	27	78	31	8707	0	8843
1865	51	28	18	8864	0	8961
1866	8338	18	10	287	0	8653
1867	189	12	8	8661	0	8870
1868	147	34	8381	220	0	8782
1869	66	8474	158	161	0	8859
1870	8420	157	122	66	0	8765
1871	212	121	38	8515	0	8886
1872	149	34	28	8674	0	8885
1873	70	17	22	8804	0	8913
1874	61	43	8473	312	0	8889
1875	43	8517	175	176	0	8911
1876	8551	168	134	80	0	8933
1877	196	140	35	7989	0	8360
1878	136	8635	51	180	0	9002
1879	8622	186	39	150	0	8997
1880	198	158	8607	49	0	9012
1881	8404	59	180	57	0	8700
1882	221	39	8725	47	0	9032
1883	165	47	8653	39	0	8904
1884	69	8514	305	69	0	8957
1885	64	179	167	8125	0	8535
1886	55	141	8316	212	0	8724
1887	53	7999	221	165	0	8438
1888	57	187	152	7735	0	8131
1889	29	8114	68	206	0	8417
1890	28	223	7909	170	0	8330
1891	45	143	202	7827	0	8217
1892	36	79	8141	222	0	8478
1893	57	46	210	7973	0	8286
1894	45	43	151	8198	0	8437
1895	37	53	8060	339	0	8489
1896	48	56	205	8033	0	8342
1897	7769	40	161	254	0	8224
1898	195	7904	77	233	0	8409
1899	158	205	7871	135	0	8369
1900	7589	141	208	105	0	8043
1901	228	63	174	7544	0	8009
1902	189	7998	82	219	0	8488
1903	8074	216	63	192	0	8545
1904	8218	177	70	96	0	8561
1905	344	95	52	7661	0	8152
1906	211	74	40	7860	0	8185
1907	92	53	47	7980	0	8172
1908	71	65	58	7814	0	8008
1909	66	7536	67	431	0	8100
1910	88	273	66	7284	0	7711
1911	66	7239	63	294	0	7662
1912	57	7203	71	273	0	7604
1913	50	7191	87	170	0	7498
1914	103	337	6518	138	0	7096
1915	69	6884	211	165	0	7329
1916	6525	228	173	171	0	7097
1917	202	6661	106	208	0	7177
1918	202	229	99	6117	0	6647
1919	117	6716	101	295	0	7229
1920	97	251	112	6689	0	7149
1921	126	217	93	6781	0	7217
1922	98	148	6568	398	0	7212
1923	6030	129	220	299	0	6678
1924	6548	126	167	216	0	7057
1925	6469	89	119	246	0	6923
1926	337	6242	143	215	0	6937
1927	208	213	134	6101	0	6656
1928	131	196	5978	307	0	6612
1929	117	5892	242	256	0	6507
1930	123	252	188	4875	0	5438
1931	109	5716	130	230	0	6185
1932	5619	241	120	179	0	6159
1933	5737	200	121	113	0	6171
1934	5801	125	146	92	0	6164
1935	5607	104	160	102	0	5973
1936	323	120	132	5284	0	5859
1937	194	101	137	5202	0	5634
1938	106	5309	127	343	0	5885
1939	100	232	103	5453	0	5888
1940	74	197	5298	309	0	5878
1941	61	123	218	5276	0	5678
1942	60	130	5207	329	0	5726
1943	47	4992	265	291	0	5595
1944	54	234	5140	187	0	5615
1945	55	171	268	5060	0	5554
1946	57	105	5087	310	0	5559
1947	69	103	263	5048	0	5483
1948	83	100	194	5034	0	5411
1949	105	95	119	5020	0	5339
1950	118	103	109	5010	0	5340
1951	4818	96	82	370	0	5366
1952	232	4794	81	260	0	5367
1953	4698	211	52	180	0	5141
1954	226	186	4518	164	0	5094
1955	4541	118	149	146	0	4954
1956	4651	92	118	147	0	5008
1957	332	110	4432	155	0	5029
1958	219	77	4360	149	0	4805
1959	123	4116	252	174	0	4665
1960	92	3778	115	147	0	4132
1961	147	207	3435	129	0	3918
1962	113	3025	131	195	0	3464
1963	61	76	151	972	0	1260
1964	878	16	39	17	0	950
1965	15	4	2	893	0	914
1966	899	4	5	12	0	920
1967	919	4	1	15	0	939
1968	20	997	4	7	0	1028
1969	986	12	3	4	0	1005
1970	989	7	1	4	0	1001
1971	18	3	3	977	0	1001
1972	919	3	2	12	0	936
1973	12	965	0	9	0	986
1974	7	34	3	951	0	995
1975	944	5	0	12	0	961
1976	13	5	972	5	0	995
1977	1029	3	10	11	0	1053
1978	18	1	6	1082	0	1107
1979	6	4	1125	14	0	1149
1980	2	2	1071	9	0	1084
1981	1023	1	14	7	0	1045
1982	1121	2	5	7	0	1135
1983	15	1	1	1130	0	1147
1984	7	2	1	1155	0	1165
1985	3	2	0	1151	0	1156
1986	2	1177	1	13	0	1193
1987	1178	15	1	6	0	1200
1988	12	1187	0	6	0	1205
1989	1181	11	2	1	0	1195
1990	11	8	1163	0	0	1182
1991	10	2	11	1155	0	1178
1992	1205	0	15	18	0	1238
1993	12	1	8	1218	0	1239
1994	8	0	5	1201	0	1214
1995	5	1176	2	18	0	1201
1996	1173	13	3	9	0	1198
1997	14	1246	1	5	0	1266
1998	9	10	4	1252	0	1275
1999	5	7	1231	13	0	1256
2000	1017	3	10	12	0	1042
2001	18	4	1235	6	0	1263
2002	1069	4	12	4	0	1089
2003	17	1200	8	1	0	1226
2004	7	11	4	1148	0	1170
2005	2	1173	3	17	0	1195
2006	1172	14	3	12	0	1201
2007	14	8	1	1212	0	1235
2008	9	4	1	1233	0	1247
2009	6	9	1187	21	0	1223
2010	1078	3	15	11	0	1107
2011	20	5	7	1211	0	1243
2012	11	4	1199	20	0	1234
2013	4	1206	16	12	0	1238
2014	10	14	9	1188	0	1221
2015	1274	9	4	22	0	1309
2016	19	0	2	1328	0	1349
2017	12	9	1339	18	0	1378
2018	1395	1	16	20	0	1432
2019	21	6	10	1527	0	1564
2020	17	7	1667	23	0	1714
2021	4	1	26	1670	0	1701
2022	9	4	14	1643	0	1670
2023	3	1679	10	40	0	1732
2024	1663	26	1	22	0	1712
2025	23	1692	6	9	0	1730
2026	1697	23	7	3	0	1730
2027	25	21	1	1612	0	1659
2028	19	1674	12	30	0	1735
2029	7	22	4	1695	0	1728
2030	6	28	1660	30	0	1724
2031	1604	4	28	22	0	1658
2032	33	1	16	1671	0	1721
2033	18	5	3	1704	0	1730
2034	7	3	7	1729	0	1746
2035	4	5	1676	50	0	1735
2036	6	8	1648	22	0	1684
2037	8	1664	41	6	0	1719
2038	7	24	15	1589	0	1635
2039	1582	17	7	26	0	1632
2040	25	1647	7	19	0	1698
2041	18	22	3	1690	0	1733
2042	1717	20	3	29	0	1769
2043	1719	7	1	30	0	1757
2044	43	1729	5	14	0	1791
2045	1858	33	7	7	0	1905
2046	2083	24	1	16	0	2124
2047	62	7	5	2180	0	2254
2048	26	2195	9	58	0	2288
2049	12	44	11	2257	0	2324
2050	2216	35	8	60	0	2319
2051	59	13	2238	38	0	2348
2052	44	4	47	2247	0	2342
2053	18	10	32	2290	0	2350
2054	4	20	2254	100	0	2378
2055	19	14	50	2279	0	2362
2056	2268	9	40	62	0	2379
2057	2131	4	17	59	0	2211
2058	78	6	16	2242	0	2342
2059	48	10	2218	70	0	2346
2060	15	11	2156	60	0	2242
2061	15	2175	84	25	0	2299
2062	17	2280	41	19	0	2357
2063	20	77	12	2212	0	2321
2064	2201	41	11	66	0	2319
2065	61	2224	19	45	0	2349
2066	2249	58	14	24	0	2345
2067	72	42	14	2225	0	2353
2068	42	25	8	2203	0	2278
2069	2118	15	5	98	0	2236
2070	65	2157	13	54	0	2289
2071	2193	53	11	19	0	2276
2072	64	52	2078	32	0	2226
2073	48	15	2054	23	0	2140
2074	23	3	72	2008	0	2106
2075	16	12	2059	73	0	2160
2076	22	18	2039	47	0	2126
2077	18	9	77	1825	0	1929
2078	22	6	1917	52	0	1997
2079	11	3	66	1810	0	1890
2080	9	7	51	1835	0	1902
2081	14	14	1868	89	0	1985
2082	18	5	60	1824	0	1907
2083	10	10	53	1788	0	1861
2084	16	1768	21	82	0	1887
2085	1749	50	15	55	0	1869
2086	54	43	1746	26	0	1869
2087	43	18	53	1753	0	1867
2088	15	10	41	1820	0	1886
2089	16	20	1748	97	0	1881
2090	1641	17	45	63	0	1766
2091	56	1755	47	28	0	1886
2092	52	46	16	1721	0	1835
2093	19	36	17	1740	0	1812
2094	16	1723	18	98	0	1855
2095	18	51	1708	60	0	1837
2096	23	1752	64	17	0	1856
2097	1668	52	49	17	0	1786
2098	49	42	1668	32	0	1791
2099	43	29	48	1633	0	1753
2100	18	16	1704	66	0	1804
2101	11	26	1657	46	0	1740
2102	21	1598	85	24	0	1728
2103	22	52	58	1516	0	1648
2104	1546	38	14	66	0	1664
2105	1588	11	21	51	0	1671
2106	72	1565	27	24	0	1688
2107	39	47	20	1535	0	1641
2108	1522	39	13	62	0	1636
2109	1551	18	16	48	0	1633
2110	89	1521	11	30	0	1651
2111	1571	46	18	20	0	1655
2112	58	38	16	1487	0	1599
2113	45	1598	17	59	0	1719
2114	63	45	18	1551	0	1677
2115	30	35	11	1525	0	1601
2116	29	22	4	1558	0	1613
2117	22	16	1485	75	0	1598
2118	17	16	1362	39	0	1434
2119	10	1260	64	28	0	1362
2120	1110	38	23	20	0	1191
2121	31	1113	9	24	0	1177
2122	33	33	11	1097	0	1174
2123	6	46	1116	45	0	1213
2124	5	14	49	1106	0	1174
2125	11	7	34	1142	0	1194
2126	7	16	12	1185	0	1220
2127	1139	7	8	61	0	1215
2128	34	9	16	1137	0	1196
2129	24	6	1197	47	0	1274
2130	1101	7	39	33	0	1180
2131	1146	5	24	28	0	1203
2132	1206	4	7	20	0	1237
2133	1195	4	5	25	0	1229
2134	1183	5	10	19	0	1217
2135	55	1139	14	20	0	1228
2136	35	30	7	1089	0	1161
2137	23	1162	7	34	0	1226
2138	1159	33	3	27	0	1222
2139	1177	18	5	20	0	1220
2140	1096	11	8	11	0	1126
2141	51	1051	13	15	0	1130
2142	21	1027	8	8	0	1064
2143	16	1040	4	9	0	1069
2144	30	51	964	7	0	1052
2145	27	114	19	755	0	915
2146	4	642	9	9	0	664
2147	1	550	4	2	0	557
2148	1	3	0	591	0	595
2149	1	2	1	588	0	592
2150	0	0	582	9	0	591
2151	582	1	4	4	0	591
2152	6	0	2	650	0	658
2153	4	1	1	657	0	663
2154	3	0	633	11	0	647
2155	1	4	621	5	0	631
2156	1	642	12	1	0	656
2157	3	6	4	643	0	656
2158	1	4	0	645	0	650
2159	0	2	637	12	0	651
2160	561	1	6	9	0	577
2161	636	1	4	1	0	642
2162	11	3	633	3	0	650
2163	602	0	6	3	0	611
2164	6	1	640	3	0	650
2165	619	1	6	1	0	627
2166	616	1	5	1	0	623
2167	10	1	595	0	0	606
2168	5	1	7	578	0	591
2169	1	0	4	576	0	581
2170	0	2	0	645	0	647
2171	635	1	0	12	0	648
2172	642	1	1	7	0	651
2173	11	0	652	4	0	667
2174	5	1	637	2	0	645
2175	675	1	12	2	0	690
2176	685	1	7	3	0	696
2177	13	2	679	6	0	700
2178	6	0	697	6	0	709
2179	2	0	15	702	0	719
2180	4	3	777	5	0	789
2181	5	3	7	732	0	747
2182	757	1	7	13	0	778
2183	12	0	769	10	0	791
2184	721	2	13	1	0	737
2185	11	1	899	2	0	913
2186	9	4	10	887	0	910
2187	6	0	11	952	0	969
2188	4	0	1	950	0	955
2189	5	946	7	24	0	982
2190	5	11	0	906	0	922
2191	6	13	1	941	0	961
2192	923	1	5	22	0	951
2193	13	1	932	13	0	959
2194	880	0	14	1	0	895
2195	14	4	929	2	0	949
2196	807	1	13	2	0	823
2197	13	898	15	2	0	928
2198	13	11	914	5	0	943
2199	0	12	919	4	0	935
2200	4	0	24	828	0	856
2201	6	0	13	932	0	951
2202	5	4	956	23	0	988
2203	3	2	955	12	0	972
2204	2	1	1049	2	0	1054
2205	1088	2	26	5	0	1121
2206	1118	0	15	4	0	1137
2207	1125	1	5	6	0	1137
2208	27	0	5	1107	0	1139
2209	14	1	3	1124	0	1142
2210	2	2	1148	24	0	1176
2211	3	1	13	1137	0	1154
2212	4	2	13	1145	0	1164
2213	1092	1	6	26	0	1125
2214	1096	1	1	17	0	1115
2215	1120	1	3	6	0	1130
2216	26	0	3	1100	0	1129
2217	14	1	1	1087	0	1103
2218	3	1	3	1106	0	1113
2219	1095	2	3	26	0	1126
2220	15	1	1	1062	0	1079
2221	17	1098	2	13	0	1130
2222	8	11	6	1047	0	1072
2223	3	1092	9	8	0	1112
2224	1076	10	7	15	0	1108
2225	1046	13	4	4	0	1067
2226	27	1070	7	3	0	1107
2227	15	1091	8	2	0	1116
2228	0	22	7	1085	0	1114
2229	2	13	1019	15	0	1049
2230	2	0	18	1005	0	1025
2231	9	2	1037	18	0	1066
2232	6	1002	17	17	0	1042
2233	6	11	18	1003	0	1038
2234	7	13	6	1020	0	1046
2235	6	1	1067	26	0	1100
2236	7	1	13	1062	0	1083
2237	7	0	1078	18	0	1103
2238	1028	1	12	19	0	1060
2239	1073	3	16	7	0	1099
2240	1091	4	4	9	0	1108
2241	24	1	8	1057	0	1090
2242	18	1	2	1071	0	1092
2243	8	3	1090	32	0	1133
2244	9	1	12	1056	0	1078
2245	7	1076	19	16	0	1118
2246	6	12	1070	23	0	1111
2247	5	15	1009	7	0	1036
2248	10	2	24	925	0	961
2249	6	2	1011	11	0	1030
2250	7	6	1029	19	0	1061
2251	882	3	19	14	0	918
2252	10	1160	15	8	0	1193
2253	1239	8	5	15	0	1267
2254	1235	13	6	10	0	1264
2255	1290	2	6	7	0	1305
2256	24	2	3	1265	0	1294
2257	19	2	4	1324	0	1349
2258	5	5	1302	23	0	1335
2259	9	1	13	1270	0	1293
2260	3	1311	21	10	0	1345
2261	1312	7	9	17	0	1345
2262	15	1305	6	7	0	1333
2263	17	1319	7	7	0	1350
2264	7	18	6	1313	0	1344
2265	4	11	1315	16	0	1346
2266	4	2	12	1317	0	1335
2267	6	0	1341	16	0	1363
2268	5	1307	11	19	0	1342
2269	1335	9	14	5	0	1363
2270	1229	11	2	4	0	1246
2271	1270	1	6	12	0	1289
2272	17	3	1418	16	0	1454
2273	10	1	1379	9	0	1399
2274	1445	1	15	11	0	1472
2275	1477	1	14	7	0	1499
2276	1508	3	1	8	0	1520
2277	20	0	3	1484	0	1507
2278	14	2	2	1498	0	1516
2279	1497	2	2	19	0	1520
2280	1478	2	2	13	0	1495
2281	20	5	1567	5	0	1597
2282	16	5	1501	3	0	1525
2283	1493	1	13	10	0	1517
2284	7	7	1624	5	0	1643
2285	1440	0	4	3	0	1447
2286	2	3	1519	2	0	1526
2287	17	1	1	1427	0	1446
2288	1	4	1612	1	0	1618
2289	1	1	3	1617	0	1622
2290	1	1	3	1660	0	1665
2291	2	1738	3	4	0	1747
2292	1744	2	1	7	0	1754
2293	3	8	1831	0	0	1842
2294	1702	1	3	5	0	1711
2295	2	1933	7	1	0	1943
2296	2030	2	1	4	0	2037
2297	5	3	3	2020	0	2031
2298	6	2	0	2030	0	2038
2299	3	2129	6	9	0	2147
2300	5	3	2	2188	0	2198
2301	4	5	1	2169	0	2179
2302	3	2	2	2176	0	2183
2303	2135	1	1	12	0	2149
2304	2026	3	2	10	0	2041
2305	11	7	2007	4	0	2029
2306	7	2053	7	4	0	2071
2307	0	6	7	2104	0	2117
2308	1	7	1	2228	0	2237
2309	1	1	2229	17	0	2248
2310	3	0	11	2165	0	2179
2311	2215	0	10	15	0	2240
2312	2200	1	2	15	0	2218
2313	2256	1	2	5	0	2264
2314	19	1	1	2293	0	2314
2315	2481	0	0	26	0	2507
2316	2535	0	3	13	0	2551
2317	2568	0	2	5	0	2575
2318	18	0	1	2555	0	2574
2319	12	0	0	2575	0	2587
2320	2	0	1	2592	0	2595
2321	5	1	0	2555	0	2561
2322	4	0	2	2553	0	2559
2323	6	8	2508	19	0	2541
2324	9	15	2474	12	0	2510
2325	3	2455	22	21	0	2501
2326	3	10	10	2517	0	2540
2327	3	11	1	2582	0	2597
2328	1	0	0	2602	0	2603
2329	3	4	2575	25	0	2607
2330	1	1	11	2561	0	2574
2331	2	8	2566	16	0	2592
2332	3	2	11	2552	0	2568
2333	7	4	2871	18	0	2900
2334	3	2914	13	16	0	2946
2335	4	10	13	2880	0	2907
2336	2	24	2855	16	0	2897
2337	2324	5	12	24	0	2365
2338	12	2902	17	9	0	2940
2339	13	11	2	2954	0	2980
2340	2	2974	9	14	0	2999
2341	5	15	0	2968	0	2988
2342	3014	12	2	18	0	3046
2343	20	0	3	2998	0	3021
2344	15	3079	11	20	0	3125
2345	3033	17	14	16	0	3080
2346	27	10	4	3170	0	3211
2347	17	17	2	3246	0	3282
2348	3314	2	0	49	0	3365
2349	28	0	0	3616	0	3644
2350	23	1	1	4337	0	4362
2351	8	8	4350	94	0	4460
2352	3	9	4211	52	0	4275
2353	5	1	116	4083	0	4205
2354	4	7	4188	58	0	4257
2355	4	9	4089	55	0	4157
2356	3746	0	113	20	0	3879
2357	68	4	4210	10	0	4292
2358	49	4271	76	9	0	4405
2359	5	65	52	4264	0	4386
2360	4384	52	8	68	0	4512
2361	4398	6	10	54	0	4468
2362	4434	3	10	13	0	4460
2363	117	4381	10	9	0	4517
2364	57	67	8	4324	0	4456
2365	12	50	3	4455	0	4520
2366	4314	7	6	127	0	4454
2367	4422	4	6	67	0	4499
2368	4430	6	4	19	0	4459
2369	124	10	4415	17	0	4566
2370	58	4472	76	15	0	4621
2371	9	5090	63	14	0	5176
2372	19	141	14	4835	0	5009
2373	10	92	7	5068	0	5177
2374	13	22	5029	177	0	5241
2375	4798	13	104	103	0	5018
2376	5064	9	90	30	0	5193
2377	183	10	20	5008	0	5221
2378	111	9	6	5072	0	5198
2379	31	4	6	5148	0	5189
2380	5022	4	10	199	0	5235
2381	108	19	4928	101	0	5156
2382	104	14	4960	28	0	5106
2383	29	9	173	4833	0	5044
2384	18	13	4925	115	0	5071
2385	4725	3	115	108	0	4951
2386	4870	8	100	33	0	5011
2387	4948	1	24	18	0	4991
2388	200	4662	22	20	0	4904
2389	4721	95	14	32	0	4862
2390	123	94	20	4610	0	4847
2391	98	23	19	4647	0	4787
2392	37	12	14	4741	0	4804
2393	24	15	4481	201	0	4721
2394	34	8	114	4321	0	4477
2395	31	4367	100	132	0	4630
2396	4212	98	35	106	0	4451
2397	111	4359	24	64	0	4558
2398	117	111	4242	45	0	4515
2399	44	4303	116	36	0	4499
2400	4173	114	102	35	0	4424
2401	114	4264	52	34	0	4464
2402	120	105	36	3542	0	3803
2403	33	4244	43	111	0	4431
2404	4199	106	31	96	0	4432
2405	4249	94	36	36	0	4415
2406	3981	25	46	35	0	4087
2407	212	34	4133	33	0	4412
2408	130	20	4081	29	0	4260
2409	59	31	4094	34	0	4218
2410	4010	17	190	35	0	4252
2411	127	25	126	3957	0	4235
2412	115	16	31	4034	0	4196
2413	36	27	3955	206	0	4224
2414	43	19	107	4002	0	4171
2415	3702	25	103	130	0	3960
2416	131	3675	46	118	0	3970
2417	3784	108	24	48	0	3964
2418	138	123	3662	38	0	3961
2419	3725	43	109	36	0	3913
2420	3754	28	114	27	0	3923
2421	3828	30	38	34	0	3930
2422	213	40	3630	43	0	3926
2423	139	24	115	3622	0	3900
2424	62	25	3697	125	0	3909
2425	58	17	124	3716	0	3915
2426	57	28	3724	124	0	3933
2427	53	23	119	3644	0	3839
2428	47	22	104	3693	0	3866
2429	3637	18	44	189	0	3888
2430	3691	11	41	121	0	3864
2431	3775	12	32	57	0	3876
2432	210	13	43	3478	0	3744
2433	131	3098	32	121	0	3382
2434	50	3284	39	120	0	3493
2435	3277	165	33	50	0	3525
2436	125	109	3227	36	0	3497
2437	3300	36	117	40	0	3493
2438	133	32	3276	36	0	3477
2439	3307	21	115	40	0	3483
2440	3213	18	110	38	0	3379
2441	208	23	3287	36	0	3554
2442	3317	13	109	38	0	3477
2443	3278	19	103	39	0	3439
2444	3267	19	37	54	0	3377
2445	208	3166	44	46	0	3464
2446	117	185	37	2985	0	3324
2447	57	89	3003	107	0	3256
2448	54	28	2962	103	0	3147
2449	54	2619	164	40	0	2877
2450	36	1841	75	23	0	1975
2451	37	67	43	1708	0	1855
2452	1715	46	15	48	0	1824
2453	52	1710	25	53	0	1840
2454	74	40	12	1627	0	1753
2455	29	1740	14	44	0	1827
2456	1664	48	10	49	0	1771
2457	55	48	15	1642	0	1760
2458	56	21	1617	55	0	1749
2459	38	1518	48	45	0	1649
2460	27	1551	58	13	0	1649
2461	33	71	22	1390	0	1516
2462	25	1563	19	33	0	1640
2463	25	46	16	1550	0	1637
2464	1566	47	9	46	0	1668
2465	1533	19	13	43	0	1608
2466	1593	14	14	19	0	1640
2467	1608	14	12	15	0	1649
2468	92	16	1532	14	0	1654
2469	66	1440	36	14	0	1556
2470	23	1427	55	10	0	1515
2471	9	894	4	6	0	913
2472	5	832	7	2	0	846
2473	731	12	24	4	0	771
2474	667	4	1	1	0	673
2475	665	1	1	2	0	669
2476	661	1	5	1	0	668
2477	10	2	670	2	0	684
2478	821	3	5	8	0	837
2479	864	1	3	3	0	871
2480	879	1	1	3	0	884
2481	7	1	1	873	0	882
2482	4	0	4	868	0	876
2483	893	1	0	10	0	904
2484	9	1	0	893	0	903
2485	2	904	2	4	0	912
2486	3	5	1	915	0	924
2487	2	4	3	907	0	916
2488	4	914	4	6	0	928
2489	3	4	1	931	0	939
2490	4	4	0	914	0	922
2491	902	1	4	7	0	914
2492	5	1	877	6	0	889
2493	868	1	5	0	0	874
2494	7	5	892	5	0	909
2495	4	1	853	3	0	861
2496	2	3	880	4	0	889
2497	860	1	6	4	0	871
2498	5	1	934	3	0	943
2499	914	2	6	0	0	922
2500	922	0	6	1	0	929
2501	926	0	2	2	0	930
2502	7	930	1	4	0	942
2503	899	3	0	1	0	903
2504	5	930	2	1	0	938
2505	5	4	0	935	0	944
2506	2	4	1	926	0	933
2507	1	914	1	9	0	925
2508	1	917	0	4	0	922
2509	2	956	0	2	0	960
2510	967	9	0	3	0	979
2511	4	1040	3	0	0	1047
2512	1050	6	0	5	0	1061
2513	5	7	1052	1	0	1065
2514	1044	1	3	3	0	1051
2515	1078	2	4	2	0	1086
2516	7	0	1055	2	0	1064
2517	6	2	4	1026	0	1038
2518	2	3	1055	5	0	1065
2519	0	2	5	1053	0	1060
2520	1	1	4	1053	0	1059
2521	1075	0	3	10	0	1088
2522	1079	2	0	7	0	1088
2523	9	1078	1	2	0	1090
2524	1102	3	1	2	0	1108
2525	6	10	1067	1	0	1084
2526	1078	1	4	1	0	1084
2527	4	2	1158	1	0	1165
2528	5	8	1207	1	0	1221
2529	1202	0	14	1	0	1217
2530	1254	1	7	2	0	1264
2531	15	5	1354	0	0	1374
2532	11	1	10	1274	0	1296
2533	6	0	7	1379	0	1392
2534	2	2	1392	13	0	1409
2535	4	1	9	1351	0	1365
2536	1	1373	10	9	0	1393
2537	2	8	3	1452	0	1465
2538	2	5	1	1449	0	1457
2539	2	9	1389	15	0	1415
2540	1225	1	9	12	0	1247
2541	1342	1	6	5	0	1354
2542	1354	2	2	5	0	1363
2543	1354	1	0	1	0	1356
2544	14	1327	3	1	0	1345
2545	9	9	1	1284	0	1303
2546	6	11	1268	11	0	1296
2547	2	5	1293	9	0	1309
2548	5	1	14	1308	0	1328
2549	2	2	1328	10	0	1342
2550	1277	2	7	14	0	1300
2551	10	1	8	1307	0	1326
2552	13	2	3	1312	0	1330
2553	4	2	0	1323	0	1329
2554	1302	0	2	20	0	1324
2555	6	1311	5	13	0	1335
2556	1397	6	3	12	0	1418
2557	1408	8	1	7	0	1424
2558	15	1392	10	2	0	1419
2559	14	1416	2	2	0	1434
2560	1426	14	3	2	0	1445
2561	11	11	2	1420	0	1444
2562	11	5	3	1433	0	1452
2563	1471	1	5	17	0	1494
2564	11	10	1431	11	0	1463
2565	1441	1	10	5	0	1457
2566	1468	4	10	4	0	1486
2567	18	1538	5	1	0	1562
2568	1679	10	1	7	0	1697
2569	1670	15	1	2	0	1688
2570	25	1836	9	3	0	1873
2571	16	1887	3	1	0	1907
2572	5	44	0	1867	0	1916
2573	1915	27	2	23	0	1967
2574	24	1999	4	26	0	2053
2575	25	24	1	2032	0	2082
2576	2090	25	2	33	0	2150
2577	29	11	2045	32	0	2117
2578	26	2	24	1958	0	2010
2579	6	4	1980	30	0	2020
2580	1830	2	31	33	0	1896
2581	1931	0	31	5	0	1967
2582	55	6	1934	5	0	2000
2583	33	1918	30	1	0	1982
2584	12	25	27	1914	0	1978
2585	6	33	1959	26	0	2024
2586	3	5	27	1988	0	2023
2587	1	3	31	2022	0	2057
2588	6	2	1996	54	0	2058
2589	1812	1	31	39	0	1883
2590	1994	1	30	10	0	2035
2591	57	4	2012	5	0	2078
2592	34	2024	33	6	0	2097
2593	10	26	31	1893	0	1960
2594	4	2003	14	23	0	2044
2595	2	2030	6	31	0	2069
2596	2022	55	2	7	0	2086
2597	31	29	1	2036	0	2097
2598	32	9	4	2047	0	2092
2599	6	4	2030	64	0	2104
2600	8	9	2013	37	0	2067
2601	4	6	56	2012	0	2078
2602	7	1	33	2062	0	2103
2603	3	7	2049	59	0	2118
2604	5	8	2044	39	0	2096
2605	2	3	62	2032	0	2099
2606	2089	4	39	35	0	2167
2607	42	2099	12	40	0	2193
2608	2136	35	7	12	0	2190
2609	39	2180	10	7	0	2236
2610	43	2176	8	12	0	2239
2611	2091	75	4	10	0	2180
2612	38	54	2185	7	0	2284
2613	46	13	37	2163	0	2259
2614	15	5	44	2284	0	2348
2615	14	4	12	2435	0	2465
2616	9	8	2423	96	0	2536
2617	11	7	46	2490	0	2554
2618	2476	8	55	54	0	2593
2619	51	10	14	2533	0	2608
2620	56	5	7	2585	0	2653
2621	2497	6	7	127	0	2637
2622	2488	6	6	63	0	2563
2623	95	2506	15	25	0	2641
2624	54	51	2548	12	0	2665
2625	20	59	2559	9	0	2647
2626	8	12	2645	19	0	2684
2627	13	2489	113	19	0	2634
2628	7	46	65	2394	0	2512
2629	12	49	20	2450	0	2531
2630	2450	12	15	94	0	2571
2631	50	8	7	2400	0	2465
2632	56	6	2327	64	0	2453
2633	18	5	56	2355	0	2434
2634	10	9	54	2363	0	2436
2635	10	10	2311	102	0	2433
2636	8	2264	60	59	0	2391
2637	22	48	58	1995	0	2123
2638	11	2304	16	54	0	2385
2639	11	60	2242	68	0	2381
2640	2218	54	50	17	0	2339
2641	2312	15	58	12	0	2397
2642	2348	8	20	20	0	2396
2643	102	7	15	2229	0	2353
2644	62	2289	16	77	0	2444
2645	2299	48	17	69	0	2433
2646	2338	51	13	32	0	2434
2647	2342	12	8	26	0	2388
2648	105	9	2252	15	0	2381
2649	2207	11	56	17	0	2291
2650	61	2231	62	21	0	2375
2651	2273	49	20	17	0	2359
2652	57	2306	18	20	0	2401
2653	2325	57	17	17	0	2416
2654	56	65	2281	17	0	2419
2655	2300	15	54	22	0	2391
2656	2232	14	63	18	0	2327
2657	2095	5	32	17	0	2149
2658	2307	8	16	21	0	2352
2659	108	12	2226	13	0	2359
2660	69	6	54	2188	0	2317
2661	2170	13	59	67	0	2309
2662	59	2165	20	68	0	2312
2663	64	50	11	2082	0	2207
2664	25	54	2066	62	0	2207
2665	21	19	61	2092	0	2193
2666	15	13	2082	71	0	2181
2667	21	1985	61	62	0	2129
2668	14	1850	60	18	0	1942
2669	18	1887	17	19	0	1941
2670	59	88	5	1593	0	1745
2671	25	46	8	1657	0	1736
2672	22	15	1608	68	0	1713
2673	18	1553	39	42	0	1652
2674	1457	34	31	16	0	1538
2675	39	1421	19	12	0	1491
2676	40	1413	11	13	0	1477
2677	16	75	35	1330	0	1456
2678	1344	35	7	36	0	1422
2679	1386	13	9	36	0	1444
2680	63	6	7	1376	0	1452
2681	1408	4	14	37	0	1463
2682	40	12	4	1407	0	1463
2683	40	11	1391	33	0	1475
2684	1382	14	35	37	0	1468
2685	38	10	32	1383	0	1463
2686	40	9	1335	31	0	1415
2687	21	8	1334	36	0	1399
2688	15	6	60	1313	0	1394
2689	1383	4	35	39	0	1461
2690	1391	4	9	39	0	1443
2691	58	1325	12	43	0	1438
2692	1432	32	5	18	0	1487
2693	1442	28	5	16	0	1491
2694	1467	11	10	11	0	1499
2695	62	1504	10	11	0	1587
2696	1489	25	5	11	0	1530
2697	1489	32	10	7	0	1538
2698	58	11	9	1474	0	1552
2699	1409	9	1	27	0	1446
2700	36	1410	3	28	0	1477
2701	31	1433	7	6	0	1477
2702	18	41	4	1412	0	1475
2703	12	50	5	1406	0	1473
2704	10	1486	9	43	0	1548
2705	1484	23	5	25	0	1537
2706	26	1382	6	3	0	1417
2707	1349	16	3	11	0	1379
2708	26	1386	11	3	0	1426
2709	20	19	2	1240	0	1281
2710	8	1387	7	17	0	1419
2711	1398	20	3	17	0	1438
2712	1361	14	2	8	0	1385
2713	1337	7	7	8	0	1359
2714	31	2	1224	7	0	1264
2715	13	5	1130	1	0	1149
2716	3	1082	15	3	0	1103
2717	4	14	1035	2	0	1055
2718	5	7	1029	2	0	1043
2719	1	10	9	895	0	915
2720	2	6	986	10	0	1004
2721	0	1013	5	6	0	1024
2722	1006	6	3	2	0	1017
2723	7	965	1	0	0	973
2724	4	968	0	2	0	974
2725	995	7	1	4	0	1007
2726	990	3	1	2	0	996
2727	7	1020	3	17	0	1047
2728	1045	4	1	4	0	1054
2729	1038	3	1	3	0	1045
2730	1042	0	1	1	0	1044
2731	8	1	1024	2	0	1035
2732	5	2	1047	2	0	1056
2733	5	0	9	1040	0	1054
2734	0	1	4	1086	0	1091
2735	1096	2	0	8	0	1106
2736	7	1126	1	4	0	1138
2737	5	5	0	1128	0	1138
2738	3	4	1	1138	0	1146
2739	2	2	0	1155	0	1159
2740	4	0	0	1146	0	1150
2741	3	1	1136	8	0	1148
2742	2	5	1146	7	0	1160
2743	4	0	9	1149	0	1162
2744	2	1	1139	7	0	1149
2745	1063	1	6	6	0	1076
2746	6	2	4	1172	0	1184
2747	6	2	1218	6	0	1232
2748	1095	1	4	9	0	1109
2749	5	1204	7	5	0	1221
2750	1213	5	1	2	0	1221
2751	6	1251	3	1	0	1261
2752	9	6	1	1229	0	1245
2753	1	11	1233	8	0	1253
2754	2	0	4	1201	0	1207
2755	1	7	1184	6	0	1198
2756	1153	0	6	42	0	1201
2757	6	3	3	1206	0	1218
2758	1247	1	1	7	0	1256
2759	5	6	1230	5	0	1246
2760	1324	0	5	3	0	1332
2761	1498	3	7	1	0	1509
2762	22	7	1471	1	0	1501
2763	13	1	13	1431	0	1458
2764	1	5	1493	11	0	1510
2765	1	1485	18	10	0	1514
2766	1490	16	11	3	0	1520
2767	1496	11	1	1	0	1509
2768	25	4	1510	0	0	1539
2769	14	3	1497	0	0	1514
2770	7	2	25	1476	0	1510
2771	5	2	13	1515	0	1535
2772	1518	3	1	24	0	1546
2773	17	1521	6	11	0	1555
2774	1549	15	0	6	0	1570
2775	1575	11	3	3	0	1592
2776	28	3	1555	1	0	1587
2777	1484	2	14	4	0	1504
2778	18	3	1591	4	0	1616
2779	13	2	16	1574	0	1605
2780	7	4	1786	15	0	1812
2781	12	3	13	1822	0	1850
2782	5	6	1855	17	0	1883
2783	1784	1	15	17	0	1817
2784	1846	2	15	3	0	1866
2785	27	2	3	1828	0	1860
2786	1886	0	3	20	0	1909
2787	16	2	5	1894	0	1917
2788	16	1929	11	15	0	1971
2789	1901	13	10	15	0	1939
2790	14	1909	5	8	0	1936
2791	15	14	6	1908	0	1943
2792	8	15	2	1847	0	1872
2793	8	2	2	1850	0	1862
2794	8	2	4	1842	0	1856
2795	6	4	1739	24	0	1773
2796	1547	4	17	21	0	1589
2797	1736	1	9	9	0	1755
2798	22	1766	9	7	0	1804
2799	16	13	0	1772	0	1801
2800	3	12	5	1766	0	1786
2801	7	5	1721	30	0	1763
2802	1654	1	19	12	0	1686
2803	19	2	12	1697	0	1730
2804	16	1	1667	17	0	1701
2805	1626	2	17	15	0	1660
2806	1700	1	11	8	0	1720
2807	1728	0	7	7	0	1742
2808	30	9	1682	3	0	1724
2809	17	0	1694	5	0	1716
2810	1662	3	20	7	0	1692
2811	18	2	13	1748	0	1781
2812	15	2	3	1827	0	1847
2813	9	6	1853	27	0	1895
2814	1798	2	12	18	0	1830
2815	19	4	17	1917	0	1957
2816	2001	4	4	24	0	2033
2817	2040	2	2	23	0	2067
2818	2093	2	2	14	0	2111
2819	29	7	2096	9	0	2141
2820	15	2	18	2066	0	2101
2821	2082	1	14	22	0	2119
2822	21	2144	13	16	0	2194
2823	22	17	4	2179	0	2222
2824	14	14	4	2179	0	2211
2825	2126	2	3	38	0	2169
2826	2130	1	6	24	0	2161
2827	34	2	5	2114	0	2155
2828	20	6	2143	22	0	2191
2829	2070	1	24	20	0	2115
2830	26	7	2234	8	0	2275
2831	2199	3	39	12	0	2253
2832	2237	1	16	6	0	2260
2833	43	4	2241	9	0	2297
2834	25	2	28	2277	0	2332
2835	7	7	2369	38	0	2421
2836	14	2456	33	25	0	2528
2837	16	40	21	2343	0	2420
2838	9	2536	8	41	0	2594
2839	14	39	5	2576	0	2634
2840	9	29	2616	47	0	2701
2841	8	2625	45	44	0	2722
2842	9	2674	30	31	0	2744
2843	12	68	0	2691	0	2771
2844	2738	26	8	51	0	2823
2845	56	3	2	2877	0	2938
2846	2865	3	9	56	0	2933
2847	55	2920	7	35	0	3017
2848	3310	50	6	11	0	3377
2849	66	43	3521	11	0	3641
2850	53	3	65	3474	0	3595
2851	17	2	49	3524	0	3592
2852	10	7	3492	116	0	3625
2853	3286	4	69	56	0	3415
2854	3461	5	51	13	0	3530
2855	108	3454	15	12	0	3589
2856	65	68	6	3038	0	3177
2857	12	3386	12	62	0	3472
2858	14	64	3336	43	0	3457
2859	16	63	3396	13	0	3488
2860	15	82	103	3081	0	3281
2861	3078	7	42	59	0	3186
2862	55	3066	11	37	0	3169
2863	3142	56	5	14	0	3217
2864	62	44	3109	11	0	3226
2865	3144	8	57	9	0	3218
2866	3225	6	43	10	0	3284
2867	102	5	3238	6	0	3351
2868	53	5	55	3139	0	3252
2869	3268	3	41	65	0	3377
2870	3267	4	14	46	0	3331
2871	3287	6	9	12	0	3314
2872	112	2	7	3195	0	3316
2873	55	7	3178	61	0	3301
2874	3105	3	58	52	0	3218
2875	63	13	3259	16	0	3351
2876	49	7	64	3177	0	3297
2877	18	7	49	3119	0	3193
2878	13	3191	12	103	0	3319
2879	7	65	3179	55	0	3306
2880	8	2979	63	21	0	3071
2881	10	3026	51	14	0	3101
2882	20	103	17	2941	0	3081
2883	20	56	2934	67	0	3077
2884	15	13	61	2968	0	3057
2885	19	13	2988	68	0	3088
2886	14	7	67	2933	0	3021
2887	17	15	55	2963	0	3050
2888	17	18	2839	105	0	2979
2889	16	8	71	2835	0	2930
2890	17	13	2905	73	0	3008
2891	17	6	2889	60	0	2972
2892	16	2873	114	12	0	3015
2893	2848	62	57	23	0	2990
2894	71	56	2868	10	0	3005
2895	2705	12	67	18	0	2802
2896	78	9	54	2896	0	3037
2897	61	9	2890	75	0	3035
2898	24	2892	74	54	0	3044
2899	18	70	49	2878	0	3015
2900	19	54	2935	64	0	3072
2901	16	18	73	2744	0	2851
2902	21	2901	63	62	0	3047
2903	2926	67	20	61	0	3074
2904	78	50	19	2923	0	3070
2905	2953	16	15	85	0	3069
2906	3016	15	15	61	0	3107
2907	3052	12	19	24	0	3107
2908	3055	13	13	18	0	3099
2909	2945	13	14	24	0	2996
2910	114	2831	32	18	0	2995
2911	70	68	20	2782	0	2940
2912	35	44	19	2827	0	2925
2913	25	18	20	2800	0	2863
2914	24	17	2666	128	0	2835
2915	29	2634	73	74	0	2810
2916	2578	63	66	22	0	2729
2917	2546	54	24	23	0	2647
2918	108	2460	31	28	0	2627
2919	63	2532	26	32	0	2653
2920	2485	100	27	30	0	2642
2921	78	62	2444	21	0	2605
2922	77	31	73	2347	0	2528
2923	2378	21	59	64	0	2522
2924	75	19	17	2318	0	2429
2925	62	2365	38	67	0	2532
2926	24	58	23	2410	0	2515
2927	20	58	2390	69	0	2537
2928	2299	10	75	67	0	2451
2929	2397	15	58	31	0	2501
2930	116	14	19	2271	0	2420
2931	72	13	22	2299	0	2406
2932	2245	11	16	100	0	2372
2933	65	2195	21	67	0	2348
2934	67	38	22	2185	0	2312
2935	31	52	15	2218	0	2316
2936	2033	14	15	88	0	2150
2937	50	2120	19	61	0	2250
2938	2179	38	7	29	0	2253
2939	56	2164	19	18	0	2257
2940	57	2217	17	20	0	2311
2941	2085	84	14	21	0	2204
2942	42	2145	21	29	0	2237
2943	73	105	24	1976	0	2178
2944	21	51	2057	49	0	2178
2945	12	19	1868	51	0	1950
2946	13	11	1864	13	0	1901
2947	7	1767	91	13	0	1878
2948	1427	20	54	3	0	1504
2949	22	30	4	1244	0	1300
2950	32	8	3	1266	0	1309
2951	6	3	1256	49	0	1314
2952	1223	4	20	33	0	1280
2953	21	3	28	1305	0	1357
2954	38	3	4	1307	0	1352
2955	5	8	0	1342	0	1355
2956	1299	4	3	53	0	1359
2957	20	3	1293	34	0	1350
2958	1300	1	19	8	0	1328
2959	27	2	27	1290	0	1346
2960	33	2	1296	17	0	1348
2961	1232	5	20	34	0	1291
2962	22	8	1318	7	0	1355
2963	30	4	18	1240	0	1292
2964	8	9	1277	21	0	1315
2965	8	4	1265	28	0	1305
2966	1157	5	42	12	0	1216
2967	20	5	1227	5	0	1257
2968	28	4	24	1185	0	1241
2969	1187	4	32	19	0	1242
2970	19	4	7	1219	0	1249
2971	27	6	1211	22	0	1266
2972	8	5	1213	29	0	1255
2973	8	1208	43	7	0	1266
2974	4	14	32	1163	0	1213
2975	1140	24	7	22	0	1193
2976	21	1139	8	32	0	1200
2977	1175	17	4	9	0	1205
2978	23	27	2	1141	0	1193
2979	1152	7	3	25	0	1187
2980	20	1135	5	34	0	1194
2981	37	13	5	1128	0	1183
2982	1137	28	8	15	0	1188
2983	21	1145	3	30	0	1199
2984	29	17	7	1146	0	1199
2985	13	29	4	1139	0	1185
2986	1161	8	9	36	0	1214
2987	20	3	5	1186	0	1214
2988	32	4	6	1177	0	1219
2989	13	4	11	1197	0	1225
2990	12	5	1148	45	0	1210
2991	1093	3	23	35	0	1154
2992	23	6	29	1275	0	1333
2993	34	5	1303	24	0	1366
2994	1238	8	26	38	0	1310
2995	32	11	1329	14	0	1386
2996	34	4	29	1214	0	1281
2997	10	1259	41	24	0	1334
2998	11	30	5	1285	0	1331
2999	12	34	1287	30	0	1363
3000	9	16	1320	40	0	1385
3001	13	5	57	1321	0	1396
3002	8	8	1343	32	0	1391
3003	1260	6	33	42	0	1341
3004	33	9	1334	15	0	1391
3005	33	9	32	1241	0	1315
3006	15	7	33	1261	0	1316
3007	15	7	6	1286	0	1314
3008	1246	5	10	61	0	1322
3009	1251	6	7	47	0	1311
3010	1272	4	9	18	0	1303
3011	64	2	10	1233	0	1309
3012	39	4	10	1232	0	1285
3013	10	5	1204	69	0	1288
3014	10	6	1285	46	0	1347
3015	15	1275	66	14	0	1370
3016	41	26	30	1100	0	1197
3017	4	24	20	1093	0	1141
3018	9	1150	10	46	0	1215
3019	1140	23	11	25	0	1199
3020	23	1160	14	11	0	1208
3021	1174	25	9	9	0	1217
3022	30	24	12	1150	0	1216
3023	1173	4	8	32	0	1217
3024	35	2	12	1170	0	1219
3025	28	1	1129	37	0	1195
3026	10	2	34	1144	0	1190
3027	1085	3	29	31	0	1148
3028	30	2	12	1122	0	1166
3029	30	2	9	1130	0	1171
3030	10	7	1106	54	0	1177
3031	7	4	29	1122	0	1162
3032	14	1	23	1091	0	1129
3033	11	1100	6	53	0	1170
3034	16	29	1	1081	0	1127
3035	13	20	2	1083	0	1118
3036	10	5	6	1052	0	1073
3037	4	918	9	42	0	973
3038	3	17	3	870	0	893
3039	810	11	3	20	0	844
3040	17	766	4	12	0	799
3041	10	734	1	7	0	752
3042	2	756	0	6	0	764
3043	2	29	3	658	0	692
3044	3	676	7	19	0	705
3045	5	717	8	8	0	738
3046	697	21	2	6	0	726
3047	16	8	643	6	0	673
3048	626	3	15	7	0	651
3049	20	3	9	652	0	684
3050	4	1	660	21	0	686
3051	629	1	23	8	0	661
3052	18	2	634	6	0	660
3053	7	2	629	4	0	642
3054	628	1	28	2	0	659
3055	18	1	8	639	0	666
3056	6	1	639	24	0	670
3057	621	1	18	13	0	653
3058	642	0	8	9	0	659
3059	23	1	626	6	0	656
3060	629	0	17	2	0	648
3061	650	1	6	5	0	662
3062	22	2	613	9	0	646
3063	614	0	19	8	0	641
3064	626	1	11	8	0	646
3065	21	4	600	3	0	628
3066	11	2	626	3	0	642
3067	5	3	20	643	0	671
3068	3	3	643	27	0	676
3069	635	4	18	13	0	670
3070	22	7	6	630	0	665
3071	13	3	4	650	0	670
3072	8	6	614	26	0	654
3073	6	4	17	623	0	650
3074	3	2	614	30	0	649
3075	614	2	21	13	0	650
3076	632	2	11	11	0	656
3077	28	3	623	3	0	657
3078	621	3	17	7	0	648
3079	631	1	5	10	0	647
3080	25	1	605	9	0	640
3081	638	0	20	10	0	668
3082	637	1	9	11	0	658
3083	21	3	653	6	0	683
3084	626	3	16	9	0	654
3085	23	4	639	8	0	674
3086	6	0	20	624	0	650
3087	4	2	6	641	0	653
3088	2	3	3	655	0	663
3089	4	5	625	27	0	661
3090	548	3	17	12	0	580
3091	19	6	592	5	0	622
3092	4	444	16	1	0	465
3093	1	427	5	2	0	435
3094	412	12	1	2	0	427
3095	8	5	1	413	0	427
3096	7	417	0	8	0	432
3097	394	7	0	4	0	405
3098	389	3	0	0	0	392
3099	10	410	2	1	0	423
3100	3	8	0	337	0	348
3101	0	371	3	5	0	379
3102	383	7	0	5	0	395
3103	395	3	0	1	0	399
3104	12	0	1	386	0	399
3105	378	1	1	8	0	388
3106	10	0	0	374	0	384
3107	4	1	372	10	0	387
3108	356	1	8	6	0	371
3109	10	2	384	0	0	396
3110	4	1	9	324	0	338
3111	329	0	4	9	0	342
3112	14	0	1	329	0	344
3113	3	0	319	11	0	333
3114	1	0	313	6	0	320
3115	4	0	13	307	0	324
3116	313	0	6	10	0	329
3117	10	313	1	3	0	327
3118	3	9	1	296	0	309
3119	0	5	295	9	0	309
3120	282	1	10	4	0	297
3121	311	0	3	0	0	314
3122	14	0	290	1	0	305
3123	294	0	10	0	0	304
3124	11	0	2	295	0	308
3125	6	0	300	8	0	314
3126	286	1	10	2	0	299
3127	8	0	4	286	0	298
3128	4	1	0	292	0	297
3129	288	0	1	10	0	299
3130	7	264	1	3	0	275
3131	3	275	0	2	0	280
3132	270	8	1	0	0	279
3133	274	2	0	1	0	277
3134	8	0	276	1	0	285
3135	4	1	299	0	0	304
3136	2	0	9	300	0	311
3137	326	0	4	8	0	338
3138	350	0	0	5	0	355
3139	352	0	0	3	0	355
3140	11	347	1	0	0	359
3141	4	370	2	0	0	376
3142	0	10	0	365	0	375
3143	2	4	0	369	0	375
3144	1	1	1	381	0	384
3145	0	1	398	12	0	411
3146	1	0	364	4	0	369
3147	385	0	11	1	0	397
3148	385	0	4	0	0	389
3149	12	0	1	360	0	373
3150	7	0	0	365	0	372
3151	0	0	0	373	0	373
3152	2	1	357	9	0	369
3153	1	0	367	6	0	374
3154	0	1	11	384	0	396
3155	2	1	387	10	0	400
3156	1	385	7	7	0	400
3157	0	395	5	1	0	401
3158	385	11	1	0	0	397
3159	8	396	1	4	0	409
3160	5	7	2	405	0	419
3161	1	5	1	404	0	411
3162	1	406	1	13	0	421
3163	1	6	2	405	0	414
3164	3	4	397	10	0	414
3165	2	405	7	6	0	420
3166	2	8	6	361	0	377
3167	4	3	351	6	0	364
3168	1	343	5	8	0	357
3169	0	5	4	333	0	342
3170	3	353	1	5	0	362
3171	1	7	0	351	0	359
3172	1	4	1	346	0	352
3173	3	351	0	9	0	363
3174	339	7	0	2	0	348
3175	355	4	1	2	0	362
3176	11	354	3	0	0	368
3177	4	366	2	1	0	373
3178	1	10	1	361	0	373
3179	2	4	351	6	0	363
3180	346	0	4	4	0	354
3181	325	1	4	0	0	330
3182	12	1	322	0	0	335
3183	312	0	6	2	0	320
3184	323	1	3	1	0	328
3185	10	1	312	1	0	324
3186	308	0	7	1	0	316
3187	7	0	319	1	0	327
3188	4	323	6	1	0	334
3189	325	6	4	1	0	336
3190	331	3	1	3	0	338
3191	10	0	326	2	0	338
3192	326	0	7	1	0	334
3193	349	0	5	2	0	356
3194	10	0	349	1	0	360
3195	349	0	6	2	0	357
3196	359	0	5	1	0	365
3197	9	1	351	1	0	362
3198	372	1	6	2	0	381
3199	8	0	5	339	0	352
3200	4	2	1	346	0	353
3201	0	0	340	11	0	351
3202	2	1	319	3	0	325
3203	0	2	7	323	0	332
3204	0	0	1	335	0	336
3205	368	0	1	8	0	377
3206	6	3	369	2	0	380
3207	365	0	6	2	0	373
3208	7	0	3	376	0	386
3209	3	3	376	4	0	386
3210	388	0	3	1	0	392
3211	6	0	2	412	0	420
3212	2	1	414	6	0	423
3213	404	0	5	3	0	412
3214	6	0	3	429	0	438
3215	433	0	1	6	0	440
3216	7	1	451	2	0	461
3217	3	0	7	413	0	423
3218	1	449	3	7	0	460
3219	451	7	1	4	0	463
3220	462	2	2	2	0	468
3221	9	472	1	1	0	483
3222	470	7	2	1	0	480
3223	499	3	0	1	0	503
3224	498	0	1	1	0	500
3225	11	528	1	0	0	540
3226	3	10	0	556	0	569
3227	1	3	554	10	0	568
3228	1	1	8	538	0	548
3229	1	0	4	563	0	568
3230	1	1	558	11	0	571
3231	0	2	563	3	0	568
3232	3	0	11	513	0	527
3233	1	569	4	6	0	580
3234	532	9	0	5	0	546
3235	507	2	0	3	0	512
3236	9	540	0	0	0	549
3237	541	8	0	5	0	554
3238	514	3	0	1	0	518
3239	9	0	528	1	0	538
3240	511	0	7	4	0	522
3241	6	564	2	3	0	575
3242	2	6	559	1	0	568
3243	0	4	559	1	0	564
3244	0	558	11	2	0	571
3245	534	7	2	0	0	543
3246	7	6	529	1	0	543
3247	4	0	6	517	0	527
3248	0	1	534	6	0	541
3249	483	1	6	2	0	492
3250	8	5	717	1	0	731
3251	6	1	710	0	0	717
3252	700	1	8	4	0	713
3253	6	759	3	1	0	769
3254	756	7	1	3	0	767
3255	782	2	1	4	0	789
3256	8	1	2	767	0	778
3257	2	847	4	5	0	858
3258	850	6	0	4	0	860
3259	7	5	851	0	0	863
3260	794	1	6	2	0	803
3261	5	861	3	1	0	870
3262	861	6	0	2	0	869
3263	863	3	1	1	0	868
3264	9	863	4	0	0	876
3265	5	6	0	872	0	883
3266	880	3	1	8	0	892
3267	8	878	3	4	0	893
3268	3	7	0	886	0	896
3269	916	2	2	11	0	931
3270	6	1	0	933	0	940
3271	4	2	0	919	0	925
3272	1	929	1	7	0	938
3273	921	7	1	5	0	934
3274	950	3	0	1	0	954
3275	940	0	1	6	0	947
3276	12	975	0	0	0	987
3277	975	7	0	3	0	985
3278	979	2	1	5	0	987
3279	12	0	0	970	0	982
3280	3	2	0	987	0	992
3281	2	4	959	10	0	975
3282	4	0	6	961	0	971
3283	0	1	2	955	0	958
3284	1	2	977	8	0	988
3285	825	2	8	7	0	842
3286	9	0	980	3	0	992
3287	4	3	1038	0	0	1045
3288	4	1	9	1024	0	1038
3289	2	1	2	1033	0	1038
3290	2	1050	4	5	0	1061
3291	1052	7	1	4	0	1064
3292	1033	2	0	3	0	1038
3293	12	1052	2	2	0	1068
3294	4	1136	1	2	0	1143
3295	4	14	1	1116	0	1135
3296	2	1174	2	15	0	1193
3297	1178	16	1	7	0	1202
3298	1188	5	1	3	0	1197
3299	26	4	2	1151	0	1183
3300	9	1	2	1207	0	1219
3301	1205	0	0	22	0	1227
3302	19	3	1173	7	0	1202
3303	1145	2	17	4	0	1168
3304	22	1	1169	3	0	1195
3305	1125	2	18	0	0	1145
3306	20	0	6	1154	0	1180
3307	7	4	1216	18	0	1245
3308	5	1	1206	5	0	1217
3309	1173	0	22	7	0	1202
3310	1209	0	7	4	0	1220
3311	20	1224	7	1	0	1252
3312	8	15	1	1292	0	1316
3313	3	8	1	1316	0	1328
3314	1280	1	1	27	0	1309
3315	16	1288	1	12	0	1317
3316	1269	17	1	5	0	1292
3317	16	1273	1	2	0	1292
3318	10	1282	4	2	0	1298
3319	1268	25	0	0	0	1293
3320	18	13	1237	0	0	1268
3321	13	3	15	1223	0	1254
3322	4	1	8	1254	0	1267
3323	2	5	1229	24	0	1260
3324	3	0	16	1218	0	1237
3325	2	1	9	1106	0	1118
3326	2	1173	4	20	0	1199
3327	1168	16	2	9	0	1195
3328	19	13	1151	22	0	1205
3329	1115	2	16	6	0	1139
3330	19	1184	13	1	0	1217
3331	10	16	6	1198	0	1230
3332	1249	6	1	21	0	1277
3333	18	2	2	1241	0	1263
3334	9	2	0	1261	0	1272
3335	3	2	1240	25	0	1270
3336	1122	0	17	14	0	1153
3337	1208	0	9	5	0	1222
3338	25	6	1213	6	0	1250
3339	11	0	17	1213	0	1241
3340	6	5	1202	17	0	1230
3341	1143	2	19	11	0	1175
3342	1225	0	10	8	0	1243
3343	26	0	3	1208	0	1237
3344	1198	2	2	19	0	1221
3345	21	4	1309	14	0	1348
3346	13	1	15	1317	0	1346
3347	7	2	8	1392	0	1409
3348	3	3	1	1422	0	1429
3349	2	4	3	1414	0	1423
3350	1201	2	0	26	0	1229
3351	15	8	1186	12	0	1221
3352	14	0	16	1201	0	1231
3353	5	8	1183	18	0	1214
3354	1	4	1162	15	0	1182
3355	3	2	25	1136	0	1166
3356	4	2	11	1175	0	1192
3357	1120	0	5	30	0	1155
3358	19	2	4	1149	0	1174
3359	11	4	1	1192	0	1208
3360	11	1	0	1220	0	1232
3361	1208	0	4	31	0	1243
3362	1208	1	1	19	0	1229
3363	1268	1	3	6	0	1278
3364	1258	0	1	8	0	1267
3365	34	1373	3	2	0	1412
3366	17	18	0	1377	0	1412
3367	6	13	1	1440	0	1460
3368	1472	3	7	38	0	1520
3369	25	1546	5	21	0	1597
3370	22	24	1	1604	0	1651
3371	4	28	1698	27	0	1757
3372	1768	6	25	35	0	1834
3373	37	1937	24	3	0	2001
3374	2050	36	7	3	0	2096
3375	2133	30	3	4	0	2170
3376	78	5	4	2081	0	2168
3377	45	10	2081	48	0	2184
3378	17	0	45	2184	0	2246
3379	2210	2	37	57	0	2306
3380	55	1	7	2233	0	2296
3381	2239	3	3	60	0	2305
3382	55	2198	6	46	0	2305
3383	2288	50	2	13	0	2353
3384	56	44	1	2264	0	2365
3385	47	8	1	2481	0	2537
3386	2593	3	2	95	0	2693
3387	2577	4	3	54	0	2638
3388	2617	5	0	26	0	2648
3389	2639	2	6	13	0	2660
3390	2633	1	2	8	0	2644
3391	119	3	3	2504	0	2629
3392	58	12	2454	62	0	2586
3393	18	2498	52	49	0	2617
3394	2427	49	43	14	0	2533
3395	51	45	2389	10	0	2495
3396	2374	6	47	12	0	2439
3397	57	2369	51	7	0	2484
3398	2419	48	5	10	0	2482
3399	61	43	2	2371	0	2477
3400	53	4	2	2384	0	2443
3401	18	12	2339	88	0	2457
3402	11	4	47	2348	0	2410
3403	8	6	2425	61	0	2500
3404	21	3	2414	59	0	2497
3405	2394	6	86	14	0	2500
3406	2485	8	46	11	0	2550
3407	103	11	2361	5	0	2480
3408	2345	2	46	13	0	2406
3409	2368	2	44	14	0	2428
3410	106	6	2318	15	0	2445
3411	62	2281	51	20	0	2414
3412	23	50	42	2371	0	2486
3413	2434	42	11	48	0	2535
3414	2500	10	7	49	0	2566
3415	2517	4	8	19	0	2548
3416	2530	7	10	14	0	2561
3417	2527	8	9	13	0	2557
3418	105	14	2449	9	0	2577
3419	63	13	2479	11	0	2566
3420	37	2	86	2488	0	2613
3421	2542	9	52	63	0	2666
3422	2570	7	17	49	0	2643
3423	2618	7	11	25	0	2661
3424	2552	5	9	21	0	2587
3425	106	2503	20	20	0	2649
3426	68	2584	13	25	0	2690
3427	2592	81	14	24	0	2711
3428	2624	49	16	14	0	2703
3429	113	2565	13	17	0	2708
3430	2667	52	10	22	0	2751
3431	79	49	2618	16	0	2762
3432	74	12	50	2571	0	2707
3433	39	19	2623	62	0	2743
3434	44	10	2641	51	0	2746
3435	47	12	89	2582	0	2730
3436	43	11	52	2683	0	2789
3437	38	11	2681	106	0	2836
3438	44	12	58	2633	0	2747
3439	40	10	48	2711	0	2809
3440	2715	6	19	103	0	2843
3441	2730	11	17	55	0	2813
3442	124	7	15	2664	0	2810
3443	82	19	2669	56	0	2826
3444	38	2715	62	62	0	2877
3445	2650	56	54	24	0	2784
3446	83	54	2720	17	0	2874
3447	79	2632	69	22	0	2802
3448	31	2815	66	21	0	2933
3449	2840	91	29	17	0	2977
3450	2878	52	23	28	0	2981
3451	126	12	21	2827	0	2986
3452	80	21	2907	60	0	3068
3453	45	6	67	2913	0	3031
3454	46	10	59	2931	0	3046
3455	38	5	24	3030	0	3097
3456	2940	9	21	111	0	3081
3457	81	2857	31	67	0	3036
3458	78	2997	28	21	0	3124
3459	43	102	14	2899	0	3058
3460	45	50	12	3072	0	3179
3461	3028	10	19	118	0	3175
3462	2948	13	16	66	0	3043
3463	3014	8	21	25	0	3068
3464	126	2940	24	12	0	3102
3465	2885	48	10	17	0	2960
3466	79	55	17	2805	0	2956
3467	65	20	2781	54	0	2920
3468	29	19	2649	48	0	2745
3469	2455	4	78	23	0	2560
3470	58	8	2436	11	0	2513
3471	48	10	2277	9	0	2344
3472	2076	2	52	9	0	2139
3473	35	5	2138	7	0	2185
3474	22	15	2037	8	0	2082
3475	28	19	69	1848	0	1964
3476	12	7	1968	18	0	2005
3477	8	1	13	1880	0	1902
3478	8	1	13	1869	0	1891
3479	7	5	1943	28	0	1983
3480	5	1972	15	18	0	2010
3481	1943	12	13	6	0	1974
3482	18	15	2034	5	0	2072
3483	18	6	1997	3	0	2024
3484	1636	3	22	9	0	1670
3485	16	22	1929	4	0	1971
3486	9	1881	11	2	0	1903
3487	2	1860	11	5	0	1878
3488	7	18	2	1920	0	1947
3489	7	12	1	1925	0	1945
3490	1996	0	1	21	0	2018
3491	1992	1	2	12	0	2007
3492	2014	1	0	9	0	2024
3493	18	0	0	2016	0	2034
3494	2029	1	3	15	0	2048
3495	1997	6	3	12	0	2018
3496	23	4	2048	1	0	2076
3497	13	5	2005	3	0	2026
3498	1	2070	18	5	0	2094
3499	5	9	10	2081	0	2105
3500	2078	7	3	12	0	2100
3501	12	2075	5	12	0	2104
3502	10	14	4	2074	0	2102
3503	2054	9	3	19	0	2085
3504	2022	1	3	15	0	2041
3505	18	2048	7	8	0	2081
3506	2073	11	8	7	0	2099
3507	2105	10	4	7	0	2126
3508	25	3	2	2114	0	2144
3509	14	7	2155	12	0	2188
3510	6	2139	15	13	0	2173
3511	3	2170	14	7	0	2194
3512	2053	17	8	7	0	2085
3513	7	23	4	2063	0	2097
3514	8	4	2108	9	0	2129
3515	3	2153	8	12	0	2176
3516	2150	7	12	7	0	2176
3517	2161	8	4	6	0	2179
3518	21	7	2247	2	0	2277
3519	14	3	11	2224	0	2252
3520	7	1	12	2328	0	2348
3521	5	3	2616	28	0	2652
3522	2569	3	27	16	0	2615
3523	3157	1	27	8	0	3193
3524	81	1	5	3458	0	3545
3525	52	3517	10	57	0	3636
3526	14	67	3	3750	0	3834
3527	8	76	3659	70	0	3813
3528	3529	4	71	75	0	3679
3529	74	1	73	3681	0	3829
3530	72	6	3717	71	0	3866
3531	3476	4	70	74	0	3624
3532	76	4	71	3682	0	3833
3533	73	4	8	3722	0	3807
3534	3647	2	5	147	0	3801
3535	74	3680	10	74	0	3838
3536	3748	68	6	12	0	3834
3537	82	71	5	3662	0	3820
3538	3718	5	6	79	0	3808
3539	87	9	3639	77	0	3812
3540	76	3640	81	13	0	3810
3541	15	77	77	3639	0	3808
3542	3699	77	11	87	0	3874
3543	84	3719	13	85	0	3901
3544	83	76	13	3665	0	3837
3545	3742	75	11	88	0	3916
3546	3705	8	10	90	0	3813
3547	170	8	12	3570	0	3760
3548	95	14	3505	103	0	3717
3549	22	16	3514	84	0	3636
3550	3364	7	151	28	0	3550
3551	90	3437	82	22	0	3631
3552	82	3485	19	16	0	3602
3553	3390	145	17	16	0	3568
3554	94	3535	14	20	0	3663
3555	96	87	8	3455	0	3646
3556	33	77	10	3580	0	3700
3557	3501	22	10	165	0	3698
3558	3459	20	12	93	0	3584
3559	3511	18	8	33	0	3570
3560	179	11	3259	18	0	3467
3561	102	14	88	3249	0	3453
3562	31	22	3319	100	0	3472
3563	31	13	3272	91	0	3407
3564	40	12	3383	26	0	3461
3565	32	14	163	3175	0	3384
3566	29	16	3363	103	0	3511
3567	36	20	3337	88	0	3481
3568	30	17	165	3234	0	3446
3569	3314	21	89	97	0	3521
3570	97	27	3359	89	0	3572
3571	106	26	89	3269	0	3490
3572	41	22	85	3385	0	3533
3573	29	31	3344	177	0	3581
3574	39	17	92	3378	0	3526
3575	36	22	3481	116	0	3655
3576	45	16	93	3427	0	3581
3577	48	6	93	3465	0	3612
3578	38	9	27	3521	0	3595
3579	31	6	37	3524	0	3598
3580	3324	6	39	186	0	3555
3581	3390	12	48	98	0	3548
3582	165	19	3359	38	0	3581
3583	97	3282	112	51	0	3542
3584	29	89	3431	32	0	3581
3585	30	85	3356	27	0	3498
3586	3197	16	180	39	0	3432
3587	96	3308	115	47	0	3566
3588	3362	80	44	36	0	3522
3589	108	3403	44	39	0	3594
3590	3385	92	30	51	0	3558
3591	3418	85	29	40	0	3572
3592	193	13	35	3297	0	3538
3593	106	3334	31	124	0	3595
3594	30	89	33	3448	0	3600
3595	19	85	30	3472	0	3606
3596	28	11	3404	213	0	3656
3597	27	3416	112	123	0	3678
3598	42	93	97	3409	0	3641
3599	3391	90	36	119	0	3636
3600	3516	14	31	111	0	3672
3601	3597	23	35	36	0	3691
3602	196	3458	44	30	0	3728
3603	3623	99	45	22	0	3789
3604	126	3744	39	22	0	3931
3605	120	113	23	3715	0	3971
3606	40	107	3682	121	0	3950
3607	41	29	118	3614	0	3802
3608	35	3620	112	116	0	3883
3609	41	105	28	3686	0	3860
3610	36	104	23	3637	0	3800
3611	21	3691	24	216	0	3952
3612	3673	113	18	136	0	3940
3613	120	99	25	3626	0	3870
3614	111	33	3549	137	0	3830
3615	42	25	114	3605	0	3786
3616	35	21	103	3656	0	3815
3617	29	21	3576	219	0	3845
3618	40	19	114	3344	0	3517
3619	39	3468	101	137	0	3745
3620	45	117	3466	111	0	3739
3621	38	90	3201	25	0	3354
3622	26	2874	148	28	0	3076
3623	12	2549	70	20	0	2651
3624	9	2210	22	21	0	2262
3625	2081	77	41	36	0	2235
3626	1972	38	6	12	0	2028
3627	2009	10	3	10	0	2032
3628	72	10	3	1965	0	2050
3629	41	13	1945	49	0	2048
3630	13	7	43	1922	0	1985
3631	12	5	34	1945	0	1996
3632	1937	8	9	72	0	2026
3633	1941	6	9	45	0	2001
3634	66	1874	8	101	0	2049
3635	1977	40	7	15	0	2039
3636	1975	33	8	14	0	2030
3637	2021	8	8	17	0	2054
3638	77	16	1936	13	0	2042
3639	38	10	1938	9	0	1995
3640	16	4	67	1872	0	1959
3641	11	6	1912	46	0	1975
3642	1698	14	42	36	0	1790
3643	1739	5	29	9	0	1782
3644	63	7	1694	12	0	1776
3645	1650	3	36	10	0	1699
3646	40	1673	27	11	0	1751
3647	1706	33	4	11	0	1754
3648	40	28	6	1650	0	1724
3649	39	9	7	1591	0	1646
3650	11	1637	6	52	0	1706
3651	1620	36	6	28	0	1690
3652	1635	29	3	13	0	1680
3653	63	1634	8	7	0	1712
3654	45	37	5	1618	0	1705
3655	18	30	5	1608	0	1661
3656	12	1612	6	56	0	1686
3657	15	35	4	1623	0	1677
3658	10	29	6	1655	0	1700
3659	1615	8	5	67	0	1695
3660	1641	9	4	47	0	1701
3661	65	5	1628	19	0	1717
3662	1613	4	38	15	0	1670
3663	43	9	1655	10	0	1717
3664	34	29	40	1590	0	1693
3665	11	10	1633	43	0	1697
3666	15	1578	40	30	0	1663
3667	16	35	42	1538	0	1631
3668	10	27	11	1571	0	1619
3669	1532	7	10	57	0	1606
3670	36	12	3	1550	0	1601
3671	34	8	1504	41	0	1587
3672	1479	5	35	40	0	1559
3673	1512	5	29	15	0	1561
3674	1556	13	6	12	0	1587
3675	1515	4	10	11	0	1540
3676	67	8	8	1498	0	1581
3677	37	10	7	1530	0	1584
3678	14	10	2	1602	0	1628
3679	14	4	6	1592	0	1616
3680	1496	6	5	80	0	1587
3681	1520	3	8	41	0	1572
3682	71	2	7	1348	0	1428
3683	38	1421	10	47	0	1516
3684	1424	40	10	35	0	1509
3685	51	32	1396	12	0	1491
3686	34	1412	44	10	0	1500
3687	1334	41	28	4	0	1407
3688	36	1349	14	9	0	1408
3689	30	40	1294	4	0	1368
3690	1276	24	30	6	0	1336
3691	1311	6	22	7	0	1346
3692	61	4	1210	10	0	1285
3693	36	2	37	1177	0	1252
3694	14	4	24	1195	0	1237
3695	10	1188	15	57	0	1270
3696	11	32	7	1157	0	1207
3697	1092	21	2	44	0	1159
3698	41	1123	5	25	0	1194
3699	27	34	5	1074	0	1140
3700	15	19	3	1106	0	1143
3701	15	9	1047	49	0	1120
3702	12	1046	32	27	0	1117
3703	907	28	16	18	0	969
3704	25	785	5	7	0	822
3705	15	707	6	1	0	729
3706	687	31	2	2	0	722
3707	25	13	1	610	0	649
3708	15	2	4	629	0	650
3709	609	3	3	33	0	648
3710	24	3	0	606	0	633
3711	13	2	1	595	0	611
3712	594	3	1	34	0	632
3713	22	2	2	595	0	621
3714	12	582	0	21	0	615
3715	569	20	0	9	0	598
3716	22	12	560	4	0	598
3717	8	537	20	6	0	571
3718	3	14	7	501	0	525
3719	1	8	466	12	0	487
3720	2	1	483	8	0	494
3721	4	1	18	442	0	465
3722	436	4	5	13	0	458
3723	17	0	1	417	0	435
3724	4	0	1	431	0	436
3725	2	2	2	436	0	442
3726	3	2	0	432	0	437
3727	2	1	1	441	0	445
3728	1	3	417	20	0	441
3729	3	3	424	6	0	436
3730	3	1	17	416	0	437
3731	3	3	418	15	0	439
3732	9	417	11	7	0	444
3733	3	13	5	421	0	442
3734	0	8	419	15	0	442
3735	392	2	12	14	0	420
3736	15	433	6	4	0	458
3737	4	412	4	11	0	431
3738	2	428	1	4	0	435
3739	4	10	0	424	0	438
3740	419	5	3	12	0	439
3741	11	4	0	428	0	443
3742	401	0	22	15	0	438
3743	10	432	5	3	0	450
3744	443	12	2	3	0	460
3745	12	3	2	464	0	481
3746	4	4	1	462	0	471
3747	2	455	1	17	0	475
3748	6	9	0	455	0	470
3749	3	5	1	463	0	472
3750	1	1	1	469	0	472
3751	446	0	1	16	0	463
3752	433	0	4	8	0	445
3753	11	5	445	3	0	464
3754	432	1	8	5	0	446
3755	8	3	468	0	0	479
3756	4	5	9	446	0	464
3757	10	0	3	462	0	475
3758	1	1	4	476	0	482
3759	2	3	459	14	0	478
3760	1	3	6	433	0	443
3761	2	1	449	10	0	462
3762	0	2	10	432	0	444
3763	439	1	3	12	0	455
3764	11	3	435	6	0	455
3765	427	3	7	7	0	444
3766	11	0	3	439	0	453
3767	441	1	3	10	0	455
3768	10	436	1	6	0	453
3769	5	6	0	443	0	454
3770	2	3	396	10	0	411
3771	2	3	9	385	0	399
3772	1	1	4	380	0	386
3773	2	379	4	13	0	398
3774	2	9	360	7	0	378
3775	2	358	8	4	0	372
3776	271	1	3	0	0	275
3777	2	285	4	1	0	292
3778	246	0	1	0	0	247
3779	289	0	0	2	0	291
3780	291	0	0	0	0	291
3781	1	0	1	291	0	293
3782	2	0	289	0	0	291
3783	1	0	0	266	0	267
3784	1	277	3	0	0	281
3785	0	1	0	281	0	282
3786	259	1	1	0	0	261
3787	0	248	0	1	0	249
3788	1	0	0	252	0	253
3789	0	0	0	252	0	252
3790	251	0	0	1	0	252
3791	0	2	244	1	0	247
3792	1	250	0	0	0	251
3793	0	0	1	250	0	251
3794	0	2	250	0	0	252
3795	0	0	0	232	0	232
3796	0	253	2	0	0	255
3797	0	0	0	243	0	243
3798	0	1	0	245	0	246
3799	0	0	0	243	0	243
3800	0	1	239	1	0	241
3801	216	0	0	1	0	217
3802	0	0	1	243	0	244
3803	279	0	0	1	0	280
3804	300	0	1	2	0	303
3805	293	0	0	1	0	294
3806	300	0	0	1	0	301
3807	310	0	0	0	0	310
3808	6	0	0	303	0	309
3809	4	294	0	18	0	316
3810	1	3	0	313	0	317
3811	0	315	0	4	0	319
3812	0	2	2	285	0	289
3813	278	5	0	3	0	286
3814	5	0	0	288	0	293
3815	5	1	282	5	0	293
3816	255	0	3	5	0	263
3817	3	283	4	0	0	290
3818	272	3	0	2	0	277
3819	271	4	1	0	0	276
3820	256	0	0	1	0	257
3821	7	277	0	1	0	285
3822	4	4	0	282	0	290
3823	1	3	0	288	0	292
3824	0	0	297	7	0	304
3825	1	0	4	288	0	293
3826	2	0	4	287	0	293
3827	3	1	0	282	0	286
3828	2	290	0	6	0	298
3829	288	3	0	5	0	296
3830	277	4	0	5	0	286
3831	7	3	286	1	0	297
3832	3	301	3	4	0	311
3833	0	4	4	311	0	319
3834	0	4	1	318	0	323
3835	2	0	0	299	0	301
3836	0	0	0	308	0	308
3837	0	1	1	307	0	309
3838	1	1	280	7	0	289
3839	2	2	263	3	0	270
3840	288	0	9	0	0	297
3841	320	0	5	1	0	326
3842	323	1	0	0	0	324
3843	8	1	0	311	0	320
3844	4	1	292	10	0	307
3845	279	0	7	7	0	293
3846	295	1	6	1	0	303
3847	12	0	298	2	0	312
3848	314	0	8	2	0	324
3849	9	0	353	2	0	364
3850	7	1	10	346	0	364
3851	2	0	358	9	0	369
3852	346	0	9	7	0	362
3853	357	1	7	2	0	367
3854	364	1	1	2	0	368
3855	360	0	2	1	0	363
3856	16	0	372	1	0	389
3857	6	380	12	1	0	399
3858	391	10	6	2	0	409
3859	397	6	1	3	0	407
3860	15	1	383	3	0	402
3861	8	0	13	374	0	395
3862	4	0	6	391	0	401
3863	4	0	382	17	0	403
3864	364	0	11	7	0	382
3865	397	0	6	3	0	406
3866	16	387	6	0	0	409
3867	400	11	0	3	0	414
3868	405	6	2	1	0	414
3869	413	0	1	1	0	415
3870	415	0	1	0	0	416
3871	15	0	395	2	0	412
3872	382	0	11	3	0	396
3873	10	0	9	384	0	403
3874	8	408	0	6	0	422
3875	4	12	408	6	0	430
3876	3	425	10	0	0	438
3877	3	8	7	405	0	423
3878	3	9	414	10	0	436
3879	345	1	10	9	0	365
3880	14	1	366	1	0	382
3881	371	0	12	1	0	384
3882	12	1	6	378	0	397
3883	5	1	0	388	0	394
3884	1	376	0	16	0	393
3885	0	382	1	11	0	394
3886	2	15	0	392	0	409
3887	384	5	0	11	0	400
3888	394	1	3	4	0	402
3889	392	1	0	1	0	394
3890	17	0	394	2	0	413
3891	380	1	11	2	0	394
3892	12	0	419	3	0	434
3893	5	1	408	2	0	416
3894	399	1	16	2	0	418
3895	438	1	7	2	0	448
3896	25	1	425	3	0	454
3897	12	1	9	422	0	444
3898	3	1	5	441	0	450
3899	431	0	1	18	0	450
3900	438	0	2	7	0	447
3901	20	1	479	0	0	500
3902	6	488	14	1	0	509
3903	3	465	3	4	0	475
3904	438	9	1	1	0	449
3905	9	2	0	440	0	451
3906	4	0	2	444	0	450
3907	2	0	2	461	0	465
3908	389	0	0	13	0	402
3909	11	1	2	449	0	463
3910	450	0	0	9	0	459
3911	454	0	1	4	0	459
3912	11	483	2	1	0	497
3913	6	8	1	515	0	530
3914	2	3	520	9	0	534
3915	501	0	9	3	0	513
3916	525	0	2	2	0	529
3917	526	0	2	1	0	529
3918	13	1	547	1	0	562
3919	4	1	9	547	0	561
3920	558	2	2	10	0	572
3921	535	1	2	4	0	542
3922	550	1	0	6	0	557
3923	11	538	3	2	0	554
3924	4	552	3	1	0	560
3925	4	9	1	548	0	562
3926	2	2	2	546	0	552
3927	5	541	6	8	0	560
3928	541	7	1	2	0	551
3929	9	8	552	1	0	570
3930	2	2	9	559	0	572
3931	0	3	4	569	0	576
3932	3	4	535	14	0	556
3933	494	0	9	4	0	507
3934	551	1	2	2	0	556
3935	13	584	4	0	0	601
3936	579	8	2	2	0	591
3937	10	2	617	1	0	630
3938	681	0	9	5	0	695
3939	7	1	729	0	0	737
3940	689	0	24	1	0	714
3941	726	0	2	2	0	730
3942	730	1	1	0	0	732
3943	723	0	0	2	0	725
3944	8	711	3	2	0	724
3945	722	5	0	1	0	728
3946	749	3	2	2	0	756
3947	8	0	736	2	0	746
3948	712	0	3	0	0	715
3949	6	0	3	708	0	717
3950	5	2	720	3	0	730
3951	705	1	2	3	0	711
3952	4	0	3	725	0	732
3953	746	0	0	5	0	751
3954	815	0	1	11	0	827
3955	8	4	800	0	0	812
3956	776	2	3	2	0	783
3957	786	0	5	1	0	792
3958	793	0	1	2	0	796
3959	791	0	0	2	0	793
3960	7	0	0	773	0	780
3961	4	776	0	4	0	784
3962	765	3	2	3	0	773
3963	774	3	0	1	0	778
3964	810	0	0	1	0	811
3965	11	2	785	1	0	799
3966	4	846	3	2	0	855
3967	2	3	5	847	0	857
3968	2	3	1	840	0	846
3969	2	2	921	6	0	931
3970	5	0	9	938	0	952
3971	2	3	975	7	0	987
3972	2	0	8	948	0	958
3973	4	0	8	991	0	1003
3974	2	6	972	15	0	995
3975	916	4	7	6	0	933
3976	985	1	9	1	0	996
3977	18	2	1018	2	0	1040
3978	986	0	11	1	0	998
3979	1039	0	7	3	0	1049
3980	15	1	1102	4	0	1122
3981	10	1	9	1077	0	1097
3982	4	0	9	1100	0	1113
3983	1103	1	1	15	0	1120
3984	9	1136	4	9	0	1158
3985	1074	7	4	4	0	1089
3986	1133	7	2	3	0	1145
3987	11	1142	5	3	0	1161
3988	1157	7	1	3	0	1168
3989	1152	7	1	1	0	1161
3990	17	1155	1	5	0	1178
3991	8	7	0	1156	0	1171
3992	3	1171	5	5	0	1184
3993	5	8	0	1172	0	1185
3994	4	13	1159	6	0	1182
3995	4	6	1124	9	0	1143
3996	1089	0	14	6	0	1109
3997	1140	4	7	2	0	1153
3998	15	5	1148	2	0	1170
3999	1128	2	8	4	0	1142
4000	1154	1	9	7	0	1171
4001	1111	1	2	4	0	1118
4002	15	1189	6	1	0	1211
4003	10	6	2	1199	0	1217
4004	1236	7	0	6	0	1249
4005	1227	0	4	10	0	1241
4006	17	0	1243	3	0	1263
4007	15	0	7	1220	0	1242
4008	4	0	10	1222	0	1236
4009	5	1260	3	14	0	1282
4010	3	1335	3	11	0	1352
4011	6	28	2	1263	0	1299
4012	5	1330	3	9	0	1347
4013	1285	13	1	10	0	1309
4014	15	1306	2	2	0	1325
4015	1384	16	2	4	0	1406
4016	22	12	1433	2	0	1469
4017	1477	3	18	8	0	1506
4018	1561	1	13	3	0	1578
4019	1570	1	1	1	0	1573
4020	1520	2	3	3	0	1528
4021	34	1530	3	3	0	1570
4022	15	22	1	1538	0	1576
4023	5	12	1	1550	0	1568
4024	4	3	1550	34	0	1591
4025	6	0	20	1532	0	1558
4026	4	2	17	1558	0	1581
4027	1560	3	1	40	0	1604
4028	23	1573	4	24	0	1624
4029	19	24	0	1672	0	1715
4030	7	16	5	1721	0	1749
4031	3	1	2	1754	0	1760
4032	1717	1	4	41	0	1763
4033	25	0	1	1740	0	1766
4034	1726	1	3	28	0	1758
4035	29	3	6	1709	0	1747
4036	24	4	1	1773	0	1802
4037	4	4	1692	48	0	1748
4038	1455	0	26	32	0	1513
4039	26	1616	23	6	0	1671
4040	1662	20	2	15	0	1699
4041	25	17	6	1625	0	1673
4042	26	3	1	1705	0	1735
4043	1744	3	1	45	0	1793
4044	1813	1	2	24	0	1840
4045	69	4	2	1877	0	1952
4046	44	5	1866	32	0	1947
4047	11	1	1907	38	0	1957
4048	4	2002	64	13	0	2083
4049	1993	31	38	9	0	2071
4050	1969	40	5	9	0	2023
4051	69	9	2	1914	0	1994
4052	43	1985	5	32	0	2065
4053	11	32	1	2002	0	2046
4054	6	38	3	1933	0	1980
4055	3	1905	10	72	0	1990
4056	1909	35	2	37	0	1983
4057	39	40	2	1916	0	1997
4058	46	2084	8	34	0	2172
4059	10	2168	4	30	0	2212
4060	2133	71	1	9	0	2214
4061	37	49	2114	8	0	2208
4062	2132	9	33	6	0	2180
4063	43	27	39	2104	0	2213
4064	45	1	8	2081	0	2135
4065	12	2085	6	70	0	2173
4066	13	35	2	2072	0	2122
4067	11	48	2091	39	0	2189
4068	7	2082	32	61	0	2182
4069	6	2093	40	14	0	2153
4070	2035	66	5	9	0	2115
4071	37	2138	3	9	0	2187
4072	37	35	1	2093	0	2166
4073	10	2103	9	37	0	2159
4074	11	35	2	2116	0	2164
4075	11	34	3	2131	0	2179
4076	6	17	2057	72	0	2152
4077	13	4	32	2091	0	2140
4078	12	8	38	2096	0	2154
4079	2019	3	9	79	0	2110
4080	40	8	2008	54	0	2110
4081	35	3	33	2040	0	2111
4082	21	10	2060	44	0	2135
4083	1978	11	36	51	0	2076
4084	41	2053	43	27	0	2164
4085	2176	41	12	18	0	2247
4086	44	43	8	2190	0	2285
4087	43	14	3	2227	0	2287
4088	19	9	2208	87	0	2323
4089	1968	7	42	59	0	2076
4090	49	2222	43	25	0	2339
4091	2084	43	16	15	0	2158
4092	52	41	9	2141	0	2243
4093	49	2168	4	47	0	2268
4094	2154	50	7	42	0	2253
4095	49	2272	11	18	0	2350
4096	44	50	7	2292	0	2393
4097	16	43	7	2340	0	2406
4098	19	17	3	2339	0	2378
4099	14	2265	9	93	0	2381
4100	18	45	9	2321	0	2393
4101	12	49	5	2337	0	2403
4102	2186	14	6	91	0	2297
4103	2215	17	5	57	0	2294
4104	2223	16	8	24	0	2271
4105	94	18	2203	21	0	2336
4106	2244	13	45	20	0	2322
4107	2255	14	40	26	0	2335
4108	2241	17	10	22	0	2290
4109	94	13	2107	20	0	2234
4110	2141	16	31	22	0	2210
4111	57	9	33	2143	0	2242
4112	45	15	2057	52	0	2169
4113	16	2070	43	50	0	2179
4114	10	110	45	1978	0	2143
4115	14	2037	12	37	0	2100
4116	10	1988	10	33	0	2041
4117	1867	66	5	14	0	1952
4118	37	37	8	1872	0	1954
4119	1926	13	7	40	0	1986
4120	38	18	5	1933	0	1994
4121	1923	7	5	40	0	1975
4122	40	6	5	1931	0	1982
4123	1915	12	6	34	0	1967
4124	43	7	1835	38	0	1923
4125	30	20	30	1854	0	1934
4126	13	8	1942	40	0	2003
4127	12	11	1845	36	0	1904
4128	10	10	1962	18	0	2000
4129	7	10	62	1854	0	1933
4130	9	7	1917	38	0	1971
4131	1846	5	31	50	0	1932
4132	36	5	33	1914	0	1988
4133	36	14	2128	39	0	2217
4134	18	7	28	2127	0	2180
4135	13	8	33	2203	0	2257
4136	13	12	2399	67	0	2491
4137	14	5	30	2397	0	2446
4138	13	6	34	2406	0	2459
4139	11	2508	11	62	0	2592
4140	2519	32	5	33	0	2589
4141	2557	29	3	16	0	2605
4142	60	13	2439	14	0	2526
4143	2341	6	27	14	0	2388
4144	31	9	2331	9	0	2380
4145	22	11	2200	6	0	2239
4146	7	11	2243	7	0	2268
4147	8	3	24	2120	0	2155
4148	7	7	2159	25	0	2198
4149	5	3	20	2135	0	2163
4150	7	3	9	2177	0	2196
4151	7	2	3	2226	0	2238
4152	4	4	2	2238	0	2248
4153	2203	2	4	29	0	2238
4154	2178	2	4	17	0	2201
4155	27	2269	13	9	0	2318
4156	11	18	6	2281	0	2316
4157	5	15	2366	20	0	2406
4158	5	2315	22	15	0	2357
4159	6	20	10	2423	0	2459
4160	8	19	2459	21	0	2507
4161	13	4	26	2412	0	2455
4162	3	5	2464	37	0	2509
4163	6	9	2446	18	0	2479
4164	7	1	37	2437	0	2482
4165	7	3	20	2487	0	2517
4166	2480	3	6	45	0	2534
4167	31	2	2	2437	0	2472
4168	2473	1	3	30	0	2507
4169	24	2447	6	17	0	2494
4170	14	2512	3	15	0	2544
4171	8	42	3	2518	0	2571
4172	2547	18	4	33	0	2602
4173	30	2642	14	19	0	2705
4174	40	22	5	2861	0	2928
4175	3112	15	5	32	0	3164
4176	3180	6	6	31	0	3223
4177	3183	3	5	16	0	3207
4178	3196	2	7	12	0	3217
4179	3283	1	2	15	0	3301
4180	45	13	3216	5	0	3279
4181	27	14	3174	16	0	3231
4182	9	3211	39	5	0	3264
4183	5	20	22	3169	0	3216
4184	7	22	3393	23	0	3445
4185	6	13	3334	17	0	3370
4186	10	11	41	3246	0	3308
4187	2	10	3505	31	0	3548
4188	2	11	3559	30	0	3602
4189	2	4236	59	10	0	4307
4190	4217	47	36	13	0	4313
4191	47	4628	16	11	0	4702
4192	54	64	8	4533	0	4659
4193	4829	51	2	63	0	4945
4194	58	5059	19	47	0	5183
4195	63	68	7	4947	0	5085
4196	11	65	4967	67	0	5110
4197	4910	14	67	58	0	5049
4198	5138	7	55	21	0	5221
4199	5217	1	8	14	0	5240
4200	131	5	6	5102	0	5244
4201	69	19	5129	71	0	5288
4202	17	5180	75	58	0	5330
4203	14	73	55	5106	0	5248
4204	5087	59	13	72	0	5231
4205	75	24	5112	57	0	5268
4206	63	4994	76	20	0	5153
4207	21	77	5102	9	0	5209
4208	4947	56	84	15	0	5102
4209	5124	13	63	8	0	5208
4210	5161	10	10	16	0	5197
4211	143	6	5047	12	0	5208
4212	71	4952	93	11	0	5127
4213	29	66	61	4974	0	5130
4214	17	63	24	5056	0	5160
4215	8	19	15	5081	0	5123
4216	9	20	5010	136	0	5175
4217	4771	9	79	83	0	4942
4218	79	24	5107	27	0	5237
4219	5053	7	89	23	0	5172
4220	5128	9	75	17	0	5229
4221	5219	14	19	19	0	5271
4222	5069	10	19	19	0	5117
4223	143	22	5051	9	0	5225
4224	93	12	84	4975	0	5164
4225	36	24	5081	80	0	5221
4226	33	4923	85	66	0	5107
4227	17	5087	72	29	0	5205
4228	5003	129	24	21	0	5177
4229	4883	88	24	19	0	5014
4230	145	5024	27	35	0	5231
4231	5094	90	18	22	0	5224
4232	116	73	4448	20	0	4657
4233	4739	20	64	21	0	4844
4234	118	4838	92	10	0	5058
4235	4912	88	18	23	0	5041
4236	4673	71	19	30	0	4793
4237	170	21	25	4552	0	4768
4238	90	24	25	4614	0	4753
4239	4490	20	24	149	0	4683
4240	113	17	27	4541	0	4698
4241	4530	25	21	110	0	4686
4242	127	10	23	4537	0	4697
4243	4509	17	27	95	0	4648
4244	4447	18	21	87	0	4573
4245	167	4388	49	17	0	4621
4246	108	4480	40	18	0	4646
4247	4337	147	26	31	0	4541
4248	113	4427	40	19	0	4599
4249	96	100	28	4314	0	4538
4250	48	88	23	4416	0	4575
4251	4201	27	23	160	0	4411
4252	108	4282	49	94	0	4533
4253	104	4305	31	32	0	4472
4254	74	4315	43	41	0	4473
4255	58	148	4085	28	0	4319
4256	55	96	4165	22	0	4338
4257	70	35	4053	39	0	4197
4258	68	90	147	3353	0	3658
4259	42	3767	92	74	0	3975
4260	3797	78	28	67	0	3970
4261	115	71	3749	26	0	3961
4262	91	35	3771	42	0	3939
4263	53	28	3875	38	0	3994
4264	64	22	140	3755	0	3981
4265	56	26	69	3841	0	3992
4266	57	23	30	3901	0	4011
4267	3811	21	31	137	0	4000
4268	3793	27	29	72	0	3921
4269	3843	29	25	28	0	3925
4270	159	24	31	3691	0	3905
4271	95	28	3556	82	0	3761
4272	52	42	3615	58	0	3767
4273	53	15	127	3507	0	3702
4274	53	22	72	3369	0	3516
4275	3172	21	33	135	0	3361
4276	105	3101	31	74	0	3311
4277	3091	81	22	33	0	3227
4278	102	3103	29	34	0	3268
4279	103	76	16	3024	0	3219
4280	55	53	3010	95	0	3213
4281	39	104	83	2972	0	3198
4282	3074	24	54	93	0	3245
4283	105	26	3054	75	0	3260
4284	2903	11	72	29	0	3015
4285	97	23	2795	29	0	2944
4286	101	19	2768	18	0	2906
4287	2562	16	101	21	0	2700
4288	91	16	2670	18	0	2795
4289	36	18	1779	9	0	1842
4290	28	1654	86	13	0	1781
4291	1395	26	55	11	0	1487
4292	1219	12	2	6	0	1239
4293	1187	5	7	8	0	1207
4294	29	6	1116	7	0	1158
4295	994	3	12	5	0	1014
4296	22	1019	10	6	0	1057
4297	960	14	1	3	0	978
4298	12	6	974	4	0	996
4299	11	2	9	933	0	955
4300	4	4	938	10	0	956
4301	2	944	9	9	0	964
4302	2	8	7	937	0	954
4303	5	5	3	940	0	953
4304	961	2	2	14	0	979
4305	950	1	2	7	0	960
4306	969	2	2	5	0	978
4307	963	2	2	3	0	970
4308	961	1	2	3	0	967
4309	16	4	944	1	0	965
4310	8	2	9	932	0	951
4311	3	4	949	10	0	966
4312	6	1	9	937	0	953
4313	952	1	6	11	0	970
4314	991	0	1	9	0	1001
4315	992	2	3	0	0	997
4316	965	2	0	3	0	970
4317	16	4	950	2	0	972
4318	12	1	11	886	0	910
4319	6	2	976	13	0	997
4320	1	1025	14	12	0	1052
4321	2	1025	13	2	0	1042
4322	2	20	1	1012	0	1035
4323	3	10	4	1063	0	1080
4324	5	1	3	1069	0	1078
4325	2	4	1	1124	0	1131
4326	1102	0	3	33	0	1138
4327	19	1084	6	14	0	1123
4328	1004	15	1	6	0	1026
4329	18	11	3	1012	0	1044
4330	13	1	1	995	0	1010
4331	3	1018	1	24	0	1046
4332	3	16	3	1023	0	1045
4333	1001	10	2	19	0	1032
4334	17	978	6	12	0	1013
4335	10	969	3	0	0	982
4336	957	23	1	2	0	983
4337	15	10	3	930	0	958
4338	12	926	4	16	0	958
4339	3	14	1	953	0	971
4340	923	9	1	18	0	951
4341	13	0	2	928	0	943
4342	11	3	1	936	0	951
4343	920	1	0	26	0	947
4344	14	2	0	932	0	948
4345	12	923	0	18	0	953
4346	5	14	2	927	0	948
4347	1	941	1	18	0	961
4348	3	12	0	949	0	964
4349	929	11	1	14	0	955
4350	932	4	1	11	0	948
4351	24	0	1	946	0	971
4352	10	3	943	13	0	969
4353	907	2	12	14	0	935
4354	15	3	955	2	0	975
4355	906	1	10	2	0	919
4356	914	0	10	4	0	928
4357	21	4	911	2	0	938
4358	11	929	14	0	0	954
4359	909	10	10	4	0	933
4360	920	11	2	5	0	938
4361	22	5	933	2	0	962
4362	922	2	12	5	0	941
4363	912	1	10	3	0	926
4364	904	1	0	3	0	908
4365	22	1	0	892	0	915
4366	13	2	0	897	0	912
4367	2	921	4	21	0	948
4368	3	12	0	954	0	969
4369	3	12	1	958	0	974
4370	3	3	923	23	0	952
4371	5	1	897	16	0	919
4372	815	9	20	9	0	853
4373	892	3	13	5	0	913
4374	25	904	3	2	0	934
4375	17	10	2	894	0	923
4376	8	15	904	18	0	945
4377	5	3	14	913	0	935
4378	4	3	10	933	0	950
4379	4	2	4	957	0	967
4380	3	951	4	25	0	983
4381	5	14	2	976	0	997
4382	6	14	0	952	0	972
4383	6	6	893	27	0	932
4384	6	0	928	21	0	955
4385	863	1	25	6	0	895
4386	930	3	16	2	0	951
4387	27	1	3	977	0	1008
4388	19	1	2	879	0	901
4389	3	3	2	929	0	937
4390	4	8	880	36	0	928
4391	3	852	15	25	0	895
4392	3	19	874	9	0	905
4393	850	17	21	5	0	893
4394	18	4	881	7	0	910
4395	886	3	22	4	0	915
4396	840	2	15	5	0	862
4397	890	3	5	5	0	903
4398	37	2	0	900	0	939
4399	21	2	882	22	0	927
4400	5	917	20	21	0	963
4401	4	17	19	913	0	953
4402	7	16	6	935	0	964
4403	5	6	957	38	0	1006
4404	4	978	29	26	0	1037
4405	1059	25	21	9	0	1114
4406	31	1090	8	5	0	1134
4407	1150	33	6	4	0	1193
4408	40	21	4	1109	0	1174
4409	31	7	1163	36	0	1237
4410	12	1168	34	26	0	1240
4411	1193	33	23	14	0	1263
4412	38	23	1299	8	0	1368
4413	1287	9	56	11	0	1363
4414	1302	3	27	7	0	1339
4415	63	4	1304	5	0	1376
4416	1247	1	38	4	0	1290
4417	1276	4	28	7	0	1315
4418	1289	1	13	5	0	1308
4419	70	1223	3	5	0	1301
4420	1182	31	3	6	0	1222
4421	36	1201	6	4	0	1247
4422	24	36	1240	4	0	1304
4423	8	1282	31	3	0	1324
4424	1247	34	19	3	0	1303
4425	1246	19	11	3	0	1279
4426	1268	8	1	3	0	1280
4427	59	0	4	1204	0	1267
4428	28	4	4	1244	0	1280
4429	1182	1	2	50	0	1235
4430	1212	1	1	26	0	1240
4431	48	2	4	1198	0	1252
4432	26	7	1201	29	0	1263
4433	13	1173	33	19	0	1238
4434	3	1231	23	7	0	1264
4435	4	41	9	1204	0	1258
4436	4	25	1207	33	0	1269
4437	4	11	31	1154	0	1200
4438	6	1196	20	30	0	1252
4439	4	30	9	1205	0	1248
4440	6	19	1211	38	0	1274
4441	10	11	28	1222	0	1271
4442	11	6	1264	36	0	1317
4443	7	5	39	1252	0	1303
4444	7	5	1269	37	0	1318
4445	7	8	1257	22	0	1294
4446	1186	3	52	12	0	1253
4447	1262	7	29	3	0	1301
4448	1276	4	12	7	0	1299
4449	61	1234	8	3	0	1306
4450	34	30	7	1262	0	1333
4451	1240	25	3	33	0	1301
4452	1260	11	9	25	0	1305
4453	1264	5	6	13	0	1288
4454	58	7	1227	7	0	1299
4455	33	1180	33	12	0	1258
4456	13	1270	25	7	0	1315
4457	1213	54	34	6	0	1307
4458	38	32	7	1206	0	1283
4459	1232	11	4	36	0	1283
4460	50	9	1201	24	0	1284
4461	32	5	32	1184	0	1253
4462	20	10	26	1200	0	1256
4463	18	4	11	1142	0	1175
4464	16	1177	8	55	0	1256
4465	1172	34	3	31	0	1240
4466	1206	24	5	16	0	1251
4467	61	1169	11	5	0	1246
4468	36	33	9	1144	0	1222
4469	1153	30	6	29	0	1218
4470	43	8	4	1156	0	1211
4471	1162	7	4	39	0	1212
4472	46	1133	7	29	0	1215
4473	1138	36	7	8	0	1189
4474	39	28	1113	14	0	1194
4475	28	1112	39	9	0	1188
4476	14	33	1155	5	0	1207
4477	35	35	49	1080	0	1199
4478	1103	10	26	31	0	1170
4479	1119	5	8	27	0	1159
4480	1137	8	8	9	0	1162
4481	59	3	5	1064	0	1131
4482	1111	4	7	32	0	1154
4483	45	4	5	1106	0	1160
4484	1089	4	8	37	0	1138
4485	1098	6	7	29	0	1140
4486	55	7	1076	14	0	1152
4487	26	3	1000	5	0	1034
4488	13	7	1011	6	0	1037
4489	9	4	45	954	0	1012
4490	979	2	24	31	0	1036
4491	27	6	10	1025	0	1068
4492	25	4	4	1036	0	1069
4493	1115	4	2	40	0	1161
4494	1137	4	2	30	0	1173
4495	1159	2	5	8	0	1174
4496	1188	3	4	7	0	1202
4497	48	2	2	1144	0	1196
4498	1099	2	3	27	0	1131
4499	26	1089	7	17	0	1139
4500	1073	22	5	10	0	1110
4501	1083	15	3	12	0	1113
4502	34	8	1035	5	0	1082
4503	948	2	19	4	0	973
4504	19	3	921	7	0	950
4505	11	3	824	4	0	842
4506	11	0	836	1	0	848
4507	3	0	25	689	0	717
4508	3	2	770	3	0	778
4509	3	2	4	700	0	709
4510	0	1	730	7	0	738
4511	1	0	900	6	0	907
4512	3	0	7	826	0	836
4513	1	0	4	942	0	947
4514	3	4	985	13	0	1005
4515	947	2	8	6	0	963
4516	10	1	6	984	0	1001
4517	10	0	1	1003	0	1014
4518	994	0	3	16	0	1013
4519	11	0	0	1063	0	1074
4520	9	6	1052	9	0	1076
4521	0	1	978	10	0	989
4522	1	1	18	914	0	934
4523	2	3	934	8	0	947
4524	0	921	9	11	0	941
4525	1	8	9	909	0	927
4526	913	9	1	10	0	933
4527	9	2	921	10	0	942
4528	869	0	7	2	0	878
4529	8	0	9	937	0	954
4530	9	0	0	942	0	951
4531	0	0	0	960	0	960
4532	0	1	0	949	0	950
4533	914	0	0	16	0	930
4534	7	960	2	9	0	978
4535	10	8	0	975	0	993
4536	1	10	0	996	0	1007
4537	1	0	0	1007	0	1008
4538	2	0	0	1008	0	1010
4539	993	0	0	20	0	1013
4540	9	988	4	12	0	1013
4541	976	8	1	1	0	986
4542	8	949	1	0	0	958
4543	8	948	2	4	0	962
4544	950	16	1	7	0	974
4545	11	10	956	0	0	977
4546	8	1	8	963	0	980
4547	978	0	10	13	0	1001
4548	976	2	0	14	0	992
4549	894	2	3	8	0	907
4550	1003	0	1	2	0	1006
4551	18	1121	4	1	0	1144
4552	1130	13	0	7	0	1150
4553	1133	15	1	7	0	1156
4554	28	1240	8	6	0	1282
4555	16	19	1	1248	0	1284
4556	7	18	1245	19	0	1289
4557	5	1	19	1277	0	1302
4558	1224	3	21	20	0	1268
4559	16	3	1271	22	0	1312
4560	17	1247	27	6	0	1297
4561	7	18	1304	9	0	1338
4562	5	18	19	1212	0	1254
4563	5	1303	25	20	0	1353
4564	1345	18	3	20	0	1386
4565	19	1376	6	8	0	1409
4566	22	16	2	1329	0	1369
4567	5	19	4	1355	0	1383
4568	1324	1	2	40	0	1367
4569	20	5	5	1313	0	1343
4570	19	1329	5	27	0	1380
4571	1330	17	4	23	0	1374
4572	1336	18	7	7	0	1368
4573	34	1338	4	8	0	1384
4574	1360	20	6	4	0	1390
4575	20	1355	4	7	0	1386
4576	1309	16	3	8	0	1336
4577	23	1337	8	10	0	1378
4578	25	19	5	1257	0	1306
4579	16	19	4	1328	0	1367
4580	1318	5	5	39	0	1367
4581	1333	6	2	27	0	1368
4582	39	1330	4	14	0	1387
4583	20	28	1297	9	0	1354
4584	1325	22	16	9	0	1372
4585	26	5	20	1310	0	1361
4586	20	1372	4	23	0	1419
4587	11	18	4	1401	0	1434
4588	1369	19	3	25	0	1416
4589	1380	7	3	31	0	1421
4590	1329	6	66	9	0	1410
4591	38	5	6	1383	0	1432
4592	27	7	1417	23	0	1474
4593	1305	10	15	23	0	1353
4594	1329	6	22	5	0	1362
4595	1363	12	0	9	0	1384
4596	38	1312	10	6	0	1366
4597	31	19	3	1289	0	1342
4598	11	1363	8	22	0	1404
4599	16	18	1	1369	0	1404
4600	15	27	2	1411	0	1455
4601	17	6	1500	44	0	1567
4602	13	10	22	1698	0	1743
4603	11	10	27	1723	0	1771
4604	1709	7	1	63	0	1780
4605	35	1743	10	34	0	1822
4606	1772	32	2	16	0	1822
4607	1751	41	4	13	0	1809
4608	65	6	2	1696	0	1769
4609	39	9	1736	36	0	1820
4610	14	1740	31	38	0	1823
4611	11	1649	36	12	0	1708
4612	1592	62	9	9	0	1672
4613	35	1605	5	6	0	1651
4614	37	28	3	1525	0	1593
4615	10	38	0	1545	0	1593
4616	16	9	1536	55	0	1616
4617	8	23	1515	33	0	1579
4618	12	1528	58	7	0	1605
4619	10	28	30	1459	0	1527
4620	1466	30	3	33	0	1532
4621	28	6	7	1519	0	1560
4622	36	11	1481	30	0	1558
4623	13	7	25	1517	0	1562
4624	1480	6	30	29	0	1545
4625	1482	7	8	40	0	1537
4626	58	1494	5	14	0	1571
4627	1506	29	7	16	0	1558
4628	32	1563	7	11	0	1613
4629	1586	29	4	13	0	1632
4630	37	41	6	1538	0	1622
4631	44	9	1540	40	0	1633
4632	15	7	1532	43	0	1597
4633	13	1570	53	13	0	1649
4634	10	47	38	1528	0	1623
4635	12	35	4	1595	0	1646
4636	1560	5	7	60	0	1632
4637	1588	8	3	41	0	1640
4638	1615	13	3	13	0	1644
4639	66	11	5	1567	0	1649
4640	49	15	5	1577	0	1646
4641	23	9	6	1626	0	1664
4642	15	17	1552	57	0	1641
4643	16	14	1544	42	0	1616
4644	1481	15	56	16	0	1568
4645	1551	10	38	15	0	1614
4646	63	14	1541	11	0	1629
4647	1507	17	23	23	0	1570
4648	1500	8	32	17	0	1557
4649	59	11	1535	13	0	1618
4650	36	1527	34	15	0	1612
4651	13	43	29	1385	0	1470
4652	12	30	1456	34	0	1532
4653	14	1563	32	36	0	1645
4654	8	33	31	1350	0	1422
4655	7	1514	16	23	0	1560
4656	12	23	1435	33	0	1503
4657	18	36	1461	13	0	1528
4658	17	8	49	1438	0	1512
4659	1474	10	30	32	0	1546
4660	34	8	8	1498	0	1548
4661	1487	11	9	23	0	1530
4662	31	15	4	1491	0	1541
4663	40	9	1440	34	0	1523
4664	1374	11	30	37	0	1452
4665	27	15	1504	14	0	1560
4666	1460	6	26	15	0	1507
4667	24	12	37	1437	0	1510
4668	34	1465	23	29	0	1551
4669	22	26	9	1522	0	1579
4670	20	1590	13	31	0	1654
4671	28	21	11	1489	0	1549
4672	15	1599	6	35	0	1655
4673	1579	24	9	42	0	1654
4674	1594	28	7	28	0	1657
4675	1589	10	18	15	0	1632
4676	59	9	1566	17	0	1651
4677	44	12	29	1530	0	1615
4678	23	9	1585	34	0	1651
4679	11	1511	44	40	0	1606
4680	17	1539	44	13	0	1613
4681	1521	45	16	16	0	1598
4682	39	35	1519	9	0	1602
4683	43	1512	29	17	0	1601
4684	20	30	31	1517	0	1598
4685	1516	31	20	38	0	1605
4686	29	1528	17	43	0	1617
4687	1543	31	8	25	0	1607
4688	34	38	1542	19	0	1633
4689	40	9	37	1523	0	1609
4690	14	10	39	1584	0	1647
4691	18	8	12	1600	0	1638
4692	15	1512	15	56	0	1598
4693	21	20	16	1465	0	1522
4694	11	38	1545	43	0	1637
4695	22	10	28	1521	0	1581
4696	18	6	40	1525	0	1589
4697	25	10	11	1522	0	1568
4698	21	1489	10	55	0	1575
4699	23	24	12	1474	0	1533
4700	26	30	16	1431	0	1503
4701	9	1305	16	52	0	1382
4702	1100	14	8	26	0	1148
4703	17	1131	3	15	0	1166
4704	18	1101	8	13	0	1140
4705	4	31	8	1086	0	1129
4706	7	20	1071	18	0	1116
4707	938	4	13	23	0	978
4708	11	6	15	1062	0	1094
4709	15	5	1045	16	0	1081
4710	5	1017	14	21	0	1057
4711	3	12	16	1033	0	1064
4712	6	21	1016	16	0	1059
4713	3	2	9	998	0	1012
4714	6	6	15	981	0	1008
4715	980	7	2	25	0	1014
4716	8	984	8	17	0	1017
4717	999	12	3	4	0	1018
4718	11	14	1005	6	0	1036
4719	16	991	15	6	0	1028
4720	6	10	1014	9	0	1039
4721	0	15	10	1017	0	1042
4722	1055	2	15	14	0	1086
4723	9	7	4	1058	0	1078
4724	1064	3	1	15	0	1083
4725	1063	2	7	13	0	1085
4726	20	2	1	1076	0	1099
4727	16	4	1078	13	0	1111
4728	9	3	1098	19	0	1129
4729	3	4	21	1138	0	1166
4730	5	5	19	1146	0	1175
4731	1148	2	8	32	0	1190
4732	9	6	4	1163	0	1182
4733	22	1137	7	15	0	1181
4734	10	8	2	1143	0	1163
4735	5	23	4	1125	0	1157
4736	1092	7	2	35	0	1136
4737	12	1099	3	30	0	1144
4738	28	8	3	1111	0	1150
4739	6	26	2	1104	0	1138
4740	7	1093	8	34	0	1142
4741	4	10	8	1131	0	1153
4742	3	26	2	1106	0	1137
4743	2	1087	6	41	0	1136
4744	6	10	4	1136	0	1156
4745	5	27	1	1100	0	1133
4746	2	1101	2	41	0	1146
4747	4	9	6	1122	0	1141
4748	1068	25	1	21	0	1115
4749	1100	5	3	31	0	1139
4750	1112	4	4	12	0	1132
4751	1108	4	1	12	0	1125
4752	31	1041	2	12	0	1086
4753	951	9	1	8	0	969
4754	5	950	4	8	0	967
4755	21	899	2	3	0	925
4756	1	23	3	913	0	940
4757	2	21	954	10	0	987
4758	911	3	3	20	0	937
4759	960	6	18	7	0	991
4760	26	3	1004	6	0	1039
4761	976	1	5	8	0	990
4762	1004	3	16	3	0	1026
4763	30	966	3	5	0	1004
4764	1182	8	2	13	0	1205
4765	8	24	4	1152	0	1188
4766	25	0	4	1161	0	1190
4767	1	6	1	1181	0	1189
4768	5	6	2	1184	0	1197
4769	1158	0	1	35	0	1194
4770	10	5	3	1131	0	1149
4771	29	2	0	1112	0	1143
4772	6	4	1091	30	0	1131
4773	936	3	10	34	0	983
4774	1084	3	20	6	0	1113
4775	1101	4	1	3	0	1109
4776	27	1079	2	5	0	1113
4777	24	1091	3	6	0	1124
4778	1084	26	0	11	0	1121
4779	7	20	4	1119	0	1150
4780	24	1132	2	14	0	1172
4781	5	11	1	1145	0	1162
4782	6	1206	5	15	0	1232
4783	1173	11	0	23	0	1207
4784	11	1235	4	7	0	1257
4785	29	12	3	1180	0	1224
4786	14	22	0	1177	0	1213
4787	8	6	1244	35	0	1293
4788	11	1378	15	26	0	1430
4789	5	19	24	1434	0	1482
4790	9	34	1456	24	0	1523
4791	6	7	1489	36	0	1538
4792	6	3	47	1508	0	1564
4793	6	6	32	1469	0	1513
4794	4	1436	14	50	0	1504
4795	6	1497	3	34	0	1540
4796	9	46	0	1483	0	1538
4797	1506	33	3	22	0	1564
4798	20	8	1	1635	0	1664
4799	1653	6	1	28	0	1688
4800	1667	6	0	38	0	1711
4801	1693	8	0	9	0	1710
4802	59	7	1644	16	0	1726
4803	1675	2	24	6	0	1707
4804	35	3	32	1682	0	1752
4805	45	2	2	1678	0	1727
4806	10	10	1653	58	0	1731
4807	9	8	1650	41	0	1708
4808	9	3	55	1587	0	1654
4809	12	1593	38	24	0	1667
4810	9	1629	8	41	0	1687
4811	10	55	4	1618	0	1687
4812	1607	34	6	28	0	1675
4813	33	9	5	1638	0	1685
4814	32	8	5	1592	0	1637
4815	14	1634	7	60	0	1715
4816	12	32	1	1662	0	1707
4817	3	41	1629	40	0	1713
4818	11	8	1584	38	0	1641
4819	1523	9	57	15	0	1604
4820	30	1606	37	19	0	1692
4821	1637	29	6	10	0	1682
4822	1642	37	5	10	0	1694
4823	60	8	5	1543	0	1616
4824	37	1623	14	27	0	1701
4825	15	28	4	1627	0	1674
4826	1620	36	7	31	0	1694
4827	26	1650	6	43	0	1725
4828	1599	25	1	9	0	1634
4829	26	1543	8	9	0	1586
4830	1593	29	6	9	0	1637
4831	1593	31	1	8	0	1633
4832	49	1585	4	11	0	1649
4833	31	26	3	1587	0	1647
4834	1597	26	7	23	0	1653
4835	29	9	1558	32	0	1628
4836	29	14	1572	13	0	1628
4837	12	6	47	1552	0	1617
4838	1599	8	26	27	0	1660
4839	26	6	4	1623	0	1659
4840	1634	5	5	32	0	1676
4841	25	11	1610	30	0	1676
4842	1624	2	26	14	0	1666
4843	1711	2	24	12	0	1749
4844	51	6	5	1690	0	1752
4845	28	5	9	1713	0	1755
4846	18	5	3	1702	0	1728
4847	12	1703	8	51	0	1774
4848	9	25	8	1703	0	1745
4849	9	25	7	1699	0	1740
4850	1679	5	5	52	0	1741
4851	1686	7	3	42	0	1738
4852	51	5	1664	11	0	1731
4853	1654	10	30	7	0	1701
4854	38	7	1728	16	0	1789
4855	1569	4	30	13	0	1616
4856	33	10	1691	16	0	1750
4857	32	8	1622	12	0	1674
4858	11	5	48	1565	0	1629
4859	12	9	1608	37	0	1666
4860	1616	6	31	33	0	1686
4861	28	7	25	1734	0	1794
4862	1774	5	8	31	0	1818
4863	1752	5	12	27	0	1796
4864	1622	3	5	12	0	1642
4865	1641	3	4	16	0	1664
4866	54	5	1632	6	0	1697
4867	33	5	23	1626	0	1687
4868	19	9	1655	26	0	1709
4869	17	0	24	1608	0	1649
4870	1608	7	20	33	0	1668
4871	32	3	14	1621	0	1670
4872	1640	2	12	33	0	1687
4873	29	3	8	1654	0	1694
4874	31	5	8	1680	0	1724
4875	1657	10	4	43	0	1714
4876	30	1652	4	31	0	1717
4877	1671	21	2	13	0	1707
4878	29	1663	8	12	0	1712
4879	22	21	4	1657	0	1704
4880	1688	26	4	41	0	1759
4881	34	8	1731	29	0	1802
4882	25	12	24	1683	0	1744
4883	1676	3	22	29	0	1730
4884	1684	4	10	19	0	1717
4885	42	9	3	1669	0	1723
4886	38	1697	0	22	0	1757
4887	15	1645	8	22	0	1690
4888	18	55	0	1486	0	1559
4889	1470	14	1	18	0	1503
4890	13	1424	4	13	0	1454
4891	9	1357	2	10	0	1378
4892	1337	19	1	3	0	1360
4893	10	1346	5	0	0	1361
4894	1345	9	0	2	0	1356
4895	9	10	1	1341	0	1361
4896	13	1	0	1362	0	1376
4897	2	1337	5	16	0	1360
4898	4	1325	3	10	0	1342
4899	1271	13	1	6	0	1291
4900	7	1307	1	0	0	1315
4901	8	1376	0	1	0	1385
4902	1	16	13	1333	0	1363
4903	1364	16	0	13	0	1393
4904	8	4	1476	18	0	1506
4905	1465	0	16	5	0	1486
4906	17	0	20	1655	0	1692
4907	26	2	1680	25	0	1733
4908	3	2	1771	26	0	1802
4909	5	1	49	1798	0	1853
4910	1	2	1903	25	0	1931
4911	1814	1	28	35	0	1878
4912	1907	0	28	7	0	1942
4913	53	4	1916	3	0	1976
4914	31	0	24	1909	0	1964
4915	4	0	29	1893	0	1926
4916	1910	0	4	54	0	1968
4917	24	1	2	1865	0	1892
4918	31	1895	1	27	0	1954
4919	1904	22	2	33	0	1961
4920	25	1950	5	5	0	1985
4921	28	2012	6	3	0	2049
4922	4	53	1	1936	0	1994
4923	4	31	1	1961	0	1997
4924	5	6	1	1989	0	2001
4925	4	3	1941	55	0	2003
4926	1751	1	26	35	0	1813
4927	26	1924	32	4	0	1986
4928	1961	29	3	3	0	1996
4929	1987	31	2	8	0	2028
4930	59	5	0	1918	0	1982
4931	34	1957	4	27	0	2022
4932	8	29	1	2001	0	2039
4933	5	30	1	2013	0	2049
4934	2036	7	1	65	0	2109
4935	2023	5	1	39	0	2068
4936	64	6	1956	7	0	2033
4937	1985	2	25	8	0	2020
4938	32	1999	33	4	0	2068
4939	2030	35	2	3	0	2070
4940	37	2175	7	4	0	2223
4941	40	32	0	2203	0	2275
4942	6	42	2	2175	0	2225
4943	7	2147	4	71	0	2229
4944	9	33	1	2240	0	2283
4945	8	42	4	2229	0	2283
4946	4	7	3	2233	0	2247
4947	10	2162	7	74	0	2253
4948	9	32	7	2217	0	2265
4949	7	38	4	2210	0	2259
4950	11	7	4	2251	0	2273
4951	5	11	2133	79	0	2228
4952	1978	6	39	51	0	2074
4953	45	7	2160	17	0	2229
4954	2089	10	43	9	0	2151
4955	49	6	2151	8	0	2214
4956	2090	6	40	8	0	2144
4957	2128	4	47	12	0	2191
4958	78	7	2106	10	0	2201
4959	51	8	39	2079	0	2177
4960	21	14	1948	39	0	2022
4961	1856	7	36	55	0	1954
4962	39	19	2032	14	0	2104
4963	53	10	2015	14	0	2092
4964	1959	10	68	15	0	2052
4965	43	1991	48	16	0	2098
4966	49	41	13	1985	0	2088
4967	2026	49	10	51	0	2136
4968	53	14	5	2056	0	2128
4969	46	13	16	2084	0	2159
4970	2060	6	9	94	0	2169
4971	2079	12	8	57	0	2156
4972	80	10	2035	21	0	2146
4973	58	9	2032	24	0	2123
4974	19	7	78	2019	0	2123
4975	17	7	2046	54	0	2124
4976	15	13	44	2026	0	2098
4977	18	8	50	2025	0	2101
4978	27	9	12	2087	0	2135
4979	1984	9	9	106	0	2108
4980	45	1933	14	65	0	2057
4981	1933	38	5	31	0	2007
4982	1925	41	8	28	0	2002
4983	84	1899	10	22	0	2015
4984	1854	38	9	26	0	1927
4985	49	43	1827	14	0	1933
4986	46	41	32	1784	0	1903
4987	1809	13	37	47	0	1906
4988	54	9	1763	48	0	1874
4989	1771	5	38	26	0	1840
4990	43	1848	39	22	0	1952
4991	2216	36	11	16	0	2279
4992	2190	34	14	18	0	2256
4993	99	2187	15	16	0	2317
4994	2377	47	11	17	0	2452
4995	74	46	11	2351	0	2482
4996	63	20	11	2392	0	2486
4997	2364	13	8	100	0	2485
4998	2238	11	9	72	0	2330
4999	95	2329	9	36	0	2469
5000	70	2348	12	25	0	2455
5001	35	84	7	2171	0	2297
5002	17	2290	14	48	0	2369
5003	18	2347	7	44	0	2416
5004	2143	65	10	23	0	2241
5005	38	2176	12	15	0	2241
5006	2051	41	9	14	0	2115
5007	40	2070	6	21	0	2137
5008	40	43	1996	18	0	2097
5009	19	2030	32	12	0	2093
5010	1978	44	25	20	0	2067
5011	1957	32	13	13	0	2015
5012	60	23	1941	12	0	2036
5013	49	11	27	1879	0	1966
5014	26	9	33	1969	0	2037
5015	22	11	1969	54	0	2056
5016	19	6	30	1924	0	1979
5017	10	8	1958	49	0	2025
5018	20	4	1903	35	0	1962
5019	1814	11	53	21	0	1899
5020	39	1864	38	16	0	1957
5021	1909	28	18	10	0	1965
5022	43	33	8	1890	0	1974
5023	47	19	1908	31	0	2005
5024	22	14	28	1782	0	1846
5025	19	1919	37	36	0	2011
5026	1949	35	15	34	0	2033
5027	1962	32	10	18	0	2022
5028	66	13	8	1976	0	2063
5029	47	18	1901	26	0	1992
5030	1813	8	29	33	0	1883
5031	38	1899	24	16	0	1977
5032	1894	27	14	13	0	1948
5033	50	30	6	1904	0	1990
5034	1888	15	7	26	0	1936
5035	42	21	6	1897	0	1966
5036	43	15	1940	35	0	2033
5037	34	17	1911	38	0	2000
5038	1826	4	39	34	0	1903
5039	29	1971	40	18	0	2058
5040	1950	27	15	14	0	2006
5041	1905	28	5	15	0	1953
5042	45	1939	8	7	0	1999
5043	1912	29	7	11	0	1959
5044	39	37	2051	11	0	2138
5045	31	25	23	2074	0	2153
5046	28	16	23	2133	0	2200
5047	19	13	16	2150	0	2198
5048	18	17	2104	53	0	2192
5049	18	23	2101	36	0	2178
5050	16	10	49	2010	0	2085
5051	16	2090	38	29	0	2173
5052	15	2182	22	27	0	2246
5053	2181	46	6	22	0	2255
5054	2146	32	17	16	0	2211
5055	43	2275	17	13	0	2348
5056	39	29	3	2289	0	2360
5057	19	33	11	2337	0	2400
5058	2436	22	18	55	0	2531
5059	41	8	12	2530	0	2591
5060	36	15	16	2532	0	2599
5061	27	14	15	2536	0	2592
5062	25	20	2368	64	0	2477
5063	19	24	2257	46	0	2346
5064	2366	3	50	29	0	2448
5065	41	14	41	2487	0	2583
5066	43	10	2567	42	0	2662
5067	25	20	2490	39	0	2574
5068	2482	15	61	27	0	2585
5069	48	13	2809	20	0	2890
5070	40	2848	53	23	0	2964
5071	19	47	43	3084	0	3193
5072	25	37	3102	48	0	3212
5073	3041	23	54	45	0	3163
5074	61	21	41	3287	0	3410
5075	54	11	3275	61	0	3401
5076	29	13	58	3290	0	3390
5077	25	8	46	3320	0	3399
5078	3317	10	23	98	0	3448
5079	55	3382	30	53	0	3520
5080	62	48	13	3318	0	3441
5081	3394	48	12	65	0	3519
5082	3427	22	14	53	0	3516
5083	3472	8	8	34	0	3522
5084	3546	12	10	29	0	3597
5085	109	11	17	3474	0	3611
5086	3565	3	17	61	0	3646
5087	3537	10	10	66	0	3623
5088	3475	4	12	37	0	3528
5089	3511	11	9	32	0	3563
5090	104	3381	21	19	0	3525
5091	33	3058	8	10	0	3109
5092	15	59	5	2970	0	3049
5093	8	3038	8	32	0	3086
5094	2948	34	6	25	0	3013
5095	39	22	6	2938	0	3005
5096	2924	6	3	38	0	2971
5097	2964	1	3	32	0	3000
5098	61	2	6	2993	0	3062
5099	35	3	3	2958	0	2999
5100	6	3023	9	59	0	3097
5101	3020	30	3	30	0	3083
5102	37	3056	10	8	0	3111
5103	3141	35	3	11	0	3190
5104	39	26	5	3157	0	3227
5105	38	14	3143	38	0	3233
5106	3091	6	30	41	0	3168
5107	3057	5	26	13	0	3101
5108	64	4	3081	7	0	3156
5109	40	10	3071	5	0	3126
5110	14	3	55	2959	0	3031
5111	3112	3	34	42	0	3191
5112	3199	7	4	38	0	3248
5113	3348	2	3	19	0	3372
5114	3336	2	4	11	0	3353
5115	74	3251	8	17	0	3350
5116	3338	40	3	39	0	3420
5117	52	36	4	3321	0	3413
5118	45	12	3	3363	0	3423
5119	19	10	3	3446	0	3478
5120	14	8	3	3527	0	3552
5121	3412	8	1	90	0	3511
5122	54	3	2	3556	0	3615
5123	46	12	3444	55	0	3557
5124	21	5	46	3605	0	3677
5125	14	4	40	3657	0	3715
5126	22	4	11	3667	0	3704
5127	14	5	4	3602	0	3625
5128	3461	7	6	106	0	3580
5129	68	3488	7	55	0	3618
5130	52	3551	6	20	0	3629
5131	17	96	5	3464	0	3582
5132	3460	53	9	58	0	3580
5133	3521	10	6	56	0	3593
5134	112	5	4	3535	0	3656
5135	64	12	3430	59	0	3565
5136	3402	3	57	73	0	3535
5137	69	4	47	3573	0	3693
5138	66	7	3552	65	0	3690
5139	3323	9	57	57	0	3446
5140	68	3481	53	26	0	3628
5141	3850	58	13	14	0	3935
5142	93	4014	10	16	0	4133
5143	70	88	4	3958	0	4120
5144	21	3919	12	93	0	4045
5145	25	95	2	3992	0	4114
5146	3820	74	3	110	0	4007
5147	88	3923	8	93	0	4112
5148	87	88	3917	25	0	4117
5149	26	71	82	3938	0	4117
5150	18	29	4054	102	0	4203
5151	26	8	92	3976	0	4102
5152	26	5	77	4068	0	4176
5153	22	15	3919	171	0	4127
5154	3447	7	91	115	0	3660
5155	95	9	3907	37	0	4048
5156	91	14	3853	24	0	3982
5157	24	3786	153	24	0	3987
5158	20	83	79	3684	0	3866
5159	18	82	16	3764	0	3880
5160	24	18	6	3724	0	3772
5161	21	11	5	3865	0	3902
5162	17	25	3676	168	0	3886
5163	3331	9	81	106	0	3527
5164	94	17	3678	41	0	3830
5165	92	11	98	3531	0	3732
5166	3477	10	74	95	0	3656
5167	85	3489	27	103	0	3704
5168	88	92	19	3322	0	3521
5169	3174	70	8	91	0	3343
5170	77	3088	17	88	0	3270
5171	67	3004	14	24	0	3109
5172	2914	125	10	23	0	3072
5173	69	3040	16	15	0	3140
5174	2904	77	8	14	0	3003
5175	77	2942	12	21	0	3052
5176	2940	75	7	14	0	3036
5177	2937	70	13	15	0	3035
5178	131	2948	16	13	0	3108
5179	75	73	12	2903	0	3063
5180	16	79	2870	74	0	3039
5181	2797	14	68	77	0	2956
5182	74	8	75	2835	0	2992
5183	74	2785	22	82	0	2963
5184	12	2844	22	81	0	2959
5185	12	121	14	2811	0	2958
5186	2809	72	14	75	0	2970
5187	70	25	2795	76	0	2966
5188	75	9	67	2833	0	2984
5189	17	13	69	2934	0	3033
5190	19	13	18	2995	0	3045
5191	14	14	11	2924	0	2963
5192	13	2820	17	147	0	2997
5193	22	72	9	2923	0	3026
5194	12	79	2836	88	0	3015
5195	20	24	2745	79	0	2868
5196	20	16	2869	22	0	2927
5197	24	17	135	2707	0	2883
5198	2664	11	83	80	0	2838
5199	78	20	2702	74	0	2874
5200	80	14	2719	24	0	2837
5201	33	14	129	2651	0	2827
5202	2662	24	76	78	0	2840
5203	78	2644	26	76	0	2824
5204	2665	75	16	28	0	2784
5205	88	76	12	2589	0	2765
5206	88	29	2625	79	0	2821
5207	28	43	65	2498	0	2634
5208	21	2634	81	71	0	2807
5209	2730	77	16	88	0	2911
5210	94	77	2730	31	0	2932
5211	73	2659	89	22	0	2843
5212	2671	82	64	31	0	2848
5213	100	68	23	2661	0	2852
5214	81	14	18	2721	0	2834
5215	2698	16	18	149	0	2881
5216	2775	14	14	94	0	2897
5217	2909	19	17	24	0	2969
5218	165	9	13	2743	0	2930
5219	90	2753	26	91	0	2960
5220	2737	80	17	89	0	2923
5221	89	2805	15	37	0	2946
5222	2706	84	16	19	0	2825
5223	96	2662	15	21	0	2794
5224	80	75	13	2535	0	2703
5225	2569	83	5	88	0	2745
5226	2593	23	10	84	0	2710
5227	2675	27	15	27	0	2744
5228	2664	20	10	27	0	2721
5229	2688	16	13	25	0	2742
5230	158	20	2552	20	0	2750
5231	96	19	73	2504	0	2692
5232	42	17	2592	71	0	2722
5233	26	17	2589	81	0	2713
5234	2520	9	131	34	0	2694
5235	2581	15	82	20	0	2698
5236	2587	15	21	16	0	2639
5237	149	11	7	2443	0	2610
5238	2468	10	17	79	0	2574
5239	89	2406	22	77	0	2594
5240	86	2356	23	21	0	2486
5241	32	2146	3	12	0	2193
5242	1855	80	7	9	0	1951
5243	50	1903	12	33	0	1998
5244	1897	45	5	14	0	1961
5245	1861	50	4	11	0	1926
5246	98	10	1777	14	0	1899
5247	68	12	40	1750	0	1870
5248	29	2	49	1875	0	1955
5249	1876	8	12	89	0	1985
5250	1877	8	9	61	0	1955
5251	102	5	8	1841	0	1956
5252	63	10	1819	47	0	1939
5253	20	9	1840	51	0	1920
5254	21	4	88	1829	0	1942
5255	27	12	52	1827	0	1918
5256	33	5	7	1872	0	1917
5257	1768	7	3	101	0	1879
5258	1782	8	5	69	0	1864
5259	100	1757	17	10	0	1884
5260	63	49	5	1801	0	1918
5261	25	59	6	1785	0	1875
5262	19	1804	8	90	0	1921
5263	27	45	7	1840	0	1919
5264	1814	55	8	48	0	1925
5265	64	14	7	1836	0	1921
5266	70	12	11	1835	0	1928
5267	1779	10	9	102	0	1900
5268	1786	14	3	66	0	1869
5269	1844	8	8	26	0	1886
5270	123	14	8	1742	0	1887
5271	80	13	1638	50	0	1781
5272	21	8	1659	69	0	1757
5273	20	12	1661	20	0	1713
5274	24	1551	85	19	0	1679
5275	1549	39	46	17	0	1651
5276	58	46	1528	22	0	1654
5277	1514	8	38	19	0	1579
5278	53	4	46	1481	0	1584
5279	1469	8	16	38	0	1531
5280	1506	13	7	53	0	1579
5281	88	1467	9	24	0	1588
5282	1514	35	15	22	0	1586
5283	1497	48	12	18	0	1575
5284	90	1455	12	25	0	1582
5285	67	43	7	1515	0	1632
5286	30	47	1540	54	0	1671
5287	30	16	33	1544	0	1623
5288	30	10	44	1525	0	1609
5289	1525	12	9	81	0	1627
5290	56	11	7	1522	0	1596
5291	65	1526	7	55	0	1653
5292	22	49	11	1510	0	1592
5293	27	48	12	1542	0	1629
5294	26	18	1467	92	0	1603
5295	30	1462	44	63	0	1599
5296	24	1487	65	28	0	1604
5297	1420	84	19	26	0	1549
5298	55	1505	18	24	0	1602
5299	69	44	11	1455	0	1579
5300	39	50	1456	51	0	1596
5301	27	1452	50	60	0	1589
5302	1463	47	51	22	0	1583
5303	57	50	21	1433	0	1561
5304	67	19	12	1470	0	1568
5305	22	21	1426	101	0	1570
5306	31	6	48	1415	0	1500
5307	21	16	51	1429	0	1517
5308	1362	11	13	99	0	1485
5309	1262	11	11	57	0	1341
5310	83	1230	8	28	0	1349
5311	1181	34	10	30	0	1255
5312	38	1077	12	24	0	1151
5313	40	30	6	947	0	1023
5314	23	965	6	41	0	1035
5315	24	1012	10	37	0	1083
5316	941	53	19	31	0	1044
5317	906	41	6	20	0	973
5318	43	853	8	15	0	919
5319	868	27	7	12	0	914
5320	883	22	4	23	0	932
5321	912	9	9	16	0	946
5322	46	12	5	887	0	950
5323	897	7	4	35	0	943
5324	35	9	834	28	0	906
5325	841	11	23	15	0	890
5326	31	11	926	14	0	982
5327	31	8	26	962	0	1027
5328	15	9	25	1000	0	1049
5329	15	13	1008	44	0	1080
5330	946	10	22	33	0	1011
5331	1007	10	24	13	0	1054
5332	45	8	1133	11	0	1197
5333	29	5	21	1110	0	1165
5334	14	8	22	1136	0	1180
5335	16	5	7	1170	0	1198
5336	1143	5	9	46	0	1203
5337	1134	9	6	29	0	1178
5338	39	6	4	1119	0	1168
5339	24	1091	5	22	0	1142
5340	5	1060	7	18	0	1090
5341	991	28	2	11	0	1032
5342	16	1014	5	3	0	1038
5343	10	941	1	4	0	956
5344	2	18	1	875	0	896
5345	5	7	861	12	0	885
5346	0	877	9	11	0	897
5347	2	9	5	858	0	874
5348	2	827	3	8	0	840
5349	2	12	0	820	0	834
5350	834	6	0	12	0	852
5351	9	891	1	7	0	908
5352	900	8	1	11	0	920
5353	876	5	3	6	0	890
5354	15	4	872	2	0	893
5355	847	1	8	6	0	862
5356	13	2	5	877	0	897
5357	10	5	908	8	0	931
5358	2	911	10	7	0	930
5359	6	7	24	896	0	933
5360	2	7	0	907	0	916
5361	906	0	0	15	0	921
5362	9	4	0	909	0	922
5363	5	2	2	935	0	944
5364	934	1	2	13	0	950
5365	9	921	3	6	0	939
5366	913	8	1	3	0	925
5367	11	8	922	2	0	943
5368	825	0	8	7	0	840
5369	9	6	1054	2	0	1071
5370	6	1087	8	1	0	1102
5371	1092	8	6	3	0	1109
5372	1065	6	1	4	0	1076
5373	15	4	1050	2	0	1071
5374	6	2	1040	2	0	1050
5375	3	3	1078	2	0	1086
5376	1	1135	13	2	0	1151
5377	4	8	7	1148	0	1167
5378	4	12	1293	9	0	1318
5379	4	4	1274	9	0	1291
5380	4	1	28	1296	0	1329
5381	5	5	1369	13	0	1392
5382	1294	2	14	18	0	1328
5383	1519	1	18	7	0	1545
5384	39	4	1502	2	0	1547
5385	25	1502	25	1	0	1553
5386	1	19	24	1451	0	1495
5387	5	25	1448	20	0	1498
5388	3	1484	23	26	0	1536
5389	7	16	19	1428	0	1470
5390	1453	18	6	14	0	1491
5391	1428	5	0	20	0	1453
5392	31	1442	4	6	0	1483
5393	21	14	5	1458	0	1498
5394	7	17	0	1476	0	1500
5395	3	1	1	1481	0	1486
5396	5	1	2	1491	0	1499
5397	5	2	1446	36	0	1489
5398	4	3	13	1454	0	1474
5399	4	3	1456	19	0	1482
5400	1	1431	17	24	0	1473
5401	1411	15	19	8	0	1453
5402	10	1514	5	6	0	1535
5403	18	16	4	1514	0	1552
5404	6	19	2	1513	0	1540
5405	1501	1	4	32	0	1538
5406	15	3	0	1525	0	1543
5407	23	1504	2	18	0	1547
5408	5	17	1	1559	0	1582
5409	6	18	0	1559	0	1583
5410	1528	4	0	39	0	1571
5411	21	3	1515	22	0	1561
5412	19	1520	14	8	0	1561
5413	4	1576	21	6	0	1607
5414	4	31	5	1559	0	1599
5415	1531	22	1	20	0	1574
5416	20	1542	6	21	0	1589
5417	22	14	8	1547	0	1591
5418	5	28	1533	21	0	1587
5419	3	5	16	1569	0	1593
5420	1555	1	21	22	0	1599
5421	1545	7	5	21	0	1578
5422	32	5	4	1563	0	1604
5423	1605	4	1	20	0	1630
5424	1561	3	5	27	0	1596
5425	38	7	1543	9	0	1597
5426	1474	3	18	5	0	1500
5427	17	1468	22	7	0	1514
5428	1486	16	4	12	0	1518
5429	26	28	1453	5	0	1512
5430	25	5	21	1505	0	1556
5431	1519	6	25	24	0	1574
5432	21	9	1341	27	0	1398
5433	22	8	1399	12	0	1441
5434	13	3	42	1362	0	1420
5435	5	11	1419	25	0	1460
5436	1358	3	21	35	0	1417
5437	26	4	1441	7	0	1478
5438	26	4	27	1466	0	1523
5439	12	2	25	1487	0	1526
5440	1522	5	7	53	0	1587
5441	27	4	1539	40	0	1610
5442	33	4	1613	15	0	1665
5443	12	3	64	1643	0	1722
5444	9	3	1708	38	0	1758
5445	1661	7	42	39	0	1749
5446	33	6	38	1684	0	1761
5447	37	3	1727	41	0	1808
5448	19	3	36	1711	0	1769
5449	14	7	37	1738	0	1796
5450	1698	2	10	70	0	1780
5451	36	10	1651	41	0	1738
5452	1572	2	30	15	0	1619
5453	40	7	1741	6	0	1794
5454	1729	8	35	16	0	1788
5455	1770	2	34	21	0	1827
5456	1811	3	6	12	0	1832
5457	72	1706	8	8	0	1794
5458	1761	32	9	5	0	1807
5459	1726	39	11	5	0	1781
5460	72	7	1	1711	0	1791
5461	43	12	1675	35	0	1765
5462	1623	3	38	41	0	1705
5463	37	8	1733	18	0	1796
5464	51	2	38	1649	0	1740
5465	12	5	46	1752	0	1815
5466	1722	3	11	67	0	1803
5467	37	1751	10	44	0	1842
5468	40	32	11	1739	0	1822
5469	21	35	5	1680	0	1741
5470	12	4	1626	71	0	1713
5471	14	3	39	1634	0	1690
5472	13	3	35	1663	0	1714
5473	13	7	7	1583	0	1610
5474	15	1651	9	61	0	1736
5475	1642	32	14	42	0	1730
5476	1615	29	7	18	0	1669
5477	66	1636	17	18	0	1737
5478	1513	28	5	6	0	1552
5479	41	26	6	1513	0	1586
5480	31	3	1538	31	0	1603
5481	9	1539	36	36	0	1620
5482	10	1585	32	11	0	1638
5483	1533	44	4	9	0	1590
5484	1646	23	7	7	0	1683
5485	60	1	9	1626	0	1696
5486	34	3	9	1668	0	1714
5487	11	0	8	1689	0	1708
5488	1585	0	9	65	0	1659
5489	35	4	1584	34	0	1657
5490	1598	0	35	13	0	1646
5491	35	5	30	1609	0	1679
5492	39	1	5	1590	0	1635
5493	10	1615	10	62	0	1697
5494	11	33	8	1672	0	1724
5495	10	26	9	1675	0	1720
5496	10	7	1690	66	0	1773
5497	15	1744	39	33	0	1831
5498	1752	36	34	10	0	1832
5499	1748	29	8	8	0	1793
5500	1823	5	6	9	0	1843
5501	1771	8	6	8	0	1793
5502	71	5	1688	7	0	1771
5503	1692	5	37	14	0	1748
5504	42	5	1756	11	0	1814
5505	45	6	37	1653	0	1741
5506	7	1715	39	46	0	1807
5507	17	31	6	1757	0	1811
5508	12	31	6	1736	0	1785
5509	8	8	1702	67	0	1785
5510	1625	8	34	38	0	1705
5511	1675	6	29	17	0	1727
5512	64	1639	8	22	0	1733
5513	34	34	1686	16	0	1770
5514	10	33	38	1692	0	1773
5515	11	9	1723	46	0	1789
5516	8	15	1691	43	0	1757
5517	21	8	59	1660	0	1748
5518	18	10	1684	43	0	1755
5519	17	6	36	1668	0	1727
5520	13	9	1659	50	0	1731
5521	14	10	32	1659	0	1715
5522	1664	5	34	40	0	1743
5523	1655	6	5	39	0	1705
5524	1670	6	9	18	0	1703
5525	1627	8	4	18	0	1657
5526	68	1648	13	16	0	1745
5527	41	33	6	1601	0	1681
5528	18	27	11	1620	0	1676
5529	19	7	1567	71	0	1664
5530	14	6	37	1528	0	1585
5531	10	8	1540	51	0	1609
5532	10	14	1506	43	0	1573
5533	1352	8	53	18	0	1431
5534	33	1486	29	15	0	1563
5535	1502	31	6	17	0	1556
5536	1507	26	11	19	0	1563
5537	55	1530	15	10	0	1610
5538	1481	24	9	15	0	1529
5539	34	24	1477	14	0	1549
5540	25	1480	25	13	0	1543
5541	1416	21	20	9	0	1466
5542	26	20	1349	9	0	1404
5543	1300	4	18	13	0	1335
5544	19	1369	21	6	0	1415
5545	1354	16	3	12	0	1385
5546	1326	20	2	4	0	1352
5547	31	1308	13	8	0	1360
5548	21	1306	8	8	0	1343
5549	5	1376	11	12	0	1404
5550	6	23	9	1416	0	1454
5551	7	12	6	1497	0	1522
5552	1516	4	8	37	0	1565
5553	1495	3	12	23	0	1533
5554	36	4	1583	10	0	1633
5555	18	5	1660	14	0	1697
5556	8	5	1684	15	0	1712
5557	14	4	41	1661	0	1720
5558	12	6	1780	28	0	1826
5559	9	1	24	1780	0	1814
5560	1786	6	30	26	0	1848
5561	27	7	1825	30	0	1889
5562	1831	3	23	7	0	1864
5563	1863	5	25	13	0	1906
5564	46	8	1868	15	0	1937
5565	29	1951	29	10	0	2019
5566	10	24	31	1953	0	2018
5567	12	33	1980	32	0	2057
5568	14	6	28	1965	0	2013
5569	14	4	27	2105	0	2150
5570	2083	10	6	51	0	2150
5571	34	3	11	2111	0	2159
5572	40	12	2069	35	0	2156
5573	16	6	33	2085	0	2140
5574	2070	7	34	35	0	2146
5575	32	2105	5	30	0	2172
5576	2087	27	5	4	0	2123
5577	29	33	7	2058	0	2127
5578	42	11	2077	24	0	2154
5579	6	8	2089	30	0	2133
5580	12	12	2108	6	0	2138
5581	7	2018	56	3	0	2084
5582	1934	30	66	22	0	2052
5583	27	1903	10	5	0	1945
5584	1802	17	4	2	0	1825
5585	18	1818	4	1	0	1841
5586	24	19	0	1821	0	1864
5587	4	19	3	1842	0	1868
5588	4	2	3	1851	0	1860
5589	1	1850	4	37	0	1892
5590	3	20	4	1991	0	2018
5591	5	18	4	2318	0	2345
5592	2412	0	2	62	0	2476
5593	45	1	3	2552	0	2601
5594	40	7	2609	52	0	2708
5595	2542	3	43	45	0	2633
5596	2589	1	50	12	0	2652
5597	86	2597	11	7	0	2701
5598	2663	43	9	12	0	2727
5599	2659	48	5	8	0	2720
5600	97	2	3	2616	0	2718
5601	54	3	7	2664	0	2728
5602	15	2	5	2722	0	2744
5603	2643	2	5	96	0	2746
5604	2640	6	3	58	0	2707
5605	97	11	2613	13	0	2734
5606	2640	2	42	15	0	2699
5607	2660	2	51	13	0	2726
5608	2687	7	3	12	0	2709
5609	94	9	2582	11	0	2696
5610	60	4	2628	6	0	2698
5611	20	4	88	2603	0	2715
5612	12	8	2680	51	0	2751
5613	12	2	52	2630	0	2696
5614	22	4	61	2346	0	2433
5615	9	2639	14	96	0	2758
5616	2644	45	9	56	0	2754
5617	55	57	2620	17	0	2749
5618	2667	9	51	8	0	2735
5619	55	9	50	2686	0	2800
5620	2707	7	6	58	0	2778
5621	55	2670	11	61	0	2797
5622	67	2757	10	14	0	2848
5623	22	95	7	2732	0	2856
5624	19	56	7	2784	0	2866
5625	16	18	2715	113	0	2862
5626	23	10	48	2737	0	2818
5627	2651	5	56	66	0	2778
5628	60	2657	20	67	0	2804
5629	60	53	2701	20	0	2834
5630	27	51	51	2685	0	2814
5631	21	9	2766	61	0	2857
5632	21	5	60	2726	0	2812
5633	16	7	2777	65	0	2865
5634	13	11	2705	73	0	2802
5635	19	9	105	2662	0	2795
5636	2674	5	59	69	0	2807
5637	2674	4	21	63	0	2762
5638	2647	6	14	28	0	2695
5639	111	2578	21	16	0	2726
5640	2590	53	12	17	0	2672
5641	2563	56	11	24	0	2654
5642	121	12	2491	17	0	2641
5643	68	2453	56	29	0	2606
5644	27	68	55	2352	0	2502
5645	2392	59	10	64	0	2525
5646	62	2339	15	109	0	2525
5647	2460	47	12	27	0	2546
5648	2448	55	19	25	0	2547
5649	2465	11	17	25	0	2518
5650	2402	11	10	21	0	2444
5651	119	9	10	2289	0	2427
5652	2321	14	12	59	0	2406
5653	65	8	22	2258	0	2353
5654	72	2134	16	66	0	2288
5655	24	42	15	2100	0	2181
5656	2071	45	10	58	0	2184
5657	55	13	2069	62	0	2199
5658	57	12	47	2023	0	2139
5659	1997	9	49	62	0	2117
5660	69	1983	18	55	0	2125
5661	1980	42	17	21	0	2060
5662	1960	50	15	14	0	2039
5663	97	1949	19	14	0	2079
5664	1984	42	14	22	0	2062
5665	65	45	1824	7	0	1941
5666	66	17	1807	18	0	1908
5667	1736	11	79	10	0	1836
5668	64	31	1823	10	0	1928
5669	62	10	49	1628	0	1749
5670	25	1696	48	42	0	1811
5671	1726	32	14	47	0	1819
5672	56	1724	17	19	0	1816
5673	52	1708	15	15	0	1790
5674	27	75	6	1736	0	1844
5675	26	47	5	1734	0	1812
5676	31	18	9	1746	0	1804
5677	19	15	11	1785	0	1830
5678	20	9	1662	78	0	1769
5679	24	9	37	1635	0	1705
5680	23	10	39	1602	0	1674
5681	1582	6	12	75	0	1675
5682	43	9	11	1610	0	1673
5683	51	19	1549	47	0	1666
5684	1513	11	34	46	0	1604
5685	58	9	40	1554	0	1661
5686	55	11	1588	38	0	1692
5687	24	31	41	1533	0	1629
5688	21	1619	44	42	0	1726
5689	1607	33	16	51	0	1707
5690	41	39	1501	11	0	1592
5691	22	1146	19	8	0	1195
5692	1026	11	15	8	0	1060
5693	12	900	10	7	0	929
5694	11	829	6	5	0	851
5695	835	12	4	5	0	856
5696	11	803	3	4	0	821
5697	11	810	4	5	0	830
5698	7	8	10	800	0	825
5699	6	11	813	9	0	839
5700	6	828	5	13	0	852
5701	6	19	9	807	0	841
5702	6	833	6	7	0	852
5703	816	8	1	11	0	836
5704	10	5	825	7	0	847
5705	9	3	5	802	0	819
5706	833	2	8	8	0	851
5707	12	4	2	854	0	872
5708	8	5	837	10	0	860
5709	778	2	6	8	0	794
5710	844	2	6	10	0	862
5711	11	887	5	7	0	910
5712	12	7	2	889	0	910
5713	4	9	4	882	0	899
5714	889	3	5	13	0	910
5715	858	3	0	10	0	871
5716	9	6	862	4	0	881
5717	7	853	5	5	0	870
5718	855	4	4	4	0	867
5719	5	4	3	865	0	877
5720	6	1	895	5	0	907
5721	1	1	833	6	0	841
5722	17	0	4	819	0	840
5723	837	0	3	2	0	842
5724	2	836	0	7	0	845
5725	879	1	1	2	0	883
5726	1	3	1	883	0	888
5727	5	0	0	889	0	894
5728	0	0	1	916	0	917
5729	889	0	3	4	0	896
5730	1	924	1	6	0	932
5731	3	1	0	940	0	944
5732	2	3	0	939	0	944
5733	1	0	951	6	0	958
5734	1	0	2	922	0	925
5735	2	4	944	1	0	951
5736	0	925	2	4	0	931
5737	1	1	4	942	0	948
5738	920	3	0	2	0	925
5739	2	0	965	3	0	970
5740	3	1	2	977	0	983
5741	0	3	980	3	0	986
5742	894	0	2	5	0	901
5743	1	4	1029	0	0	1034
5744	4	0	1	994	0	999
5745	1029	1	4	3	0	1037
5746	4	896	1	9	0	910
5747	1050	1	2	1	0	1054
5748	4	1044	0	1	0	1049
5749	5	3	0	1114	0	1122
5750	1	5	1102	5	0	1113
5751	1	3	1120	5	0	1129
5752	4	0	5	1131	0	1140
5753	1167	0	3	7	0	1177
5754	1199	0	0	5	0	1204
5755	5	1	2	1219	0	1227
5756	3	0	2	1236	0	1241
5757	1166	0	0	6	0	1172
5758	4	1128	5	3	0	1140
5759	4	1195	3	2	0	1204
5760	1204	6	1	2	0	1213
5761	2	7	1193	6	0	1208
5762	4	0	3	1184	0	1191
5763	0	1	1177	6	0	1184
5764	6	0	2	1171	0	1179
5765	1	5	1228	4	0	1238
5766	5	1	1207	6	0	1219
5767	2	3	6	1197	0	1208
5768	1	1170	7	3	0	1181
5769	1207	4	2	8	0	1221
5770	3	1207	5	1	0	1216
5771	6	4	1	1216	0	1227
5772	1230	4	1	8	0	1243
5773	6	0	2	1273	0	1281
5774	1251	1	2	7	0	1261
5775	1258	0	1	8	0	1267
5776	1278	1	4	1	0	1284
5777	7	1246	2	4	0	1259
5778	1262	4	3	0	0	1269
5779	4	5	2	1303	0	1314
5780	1351	2	3	10	0	1366
5781	7	2	2	1407	0	1418
5782	1397	1	3	13	0	1414
5783	1421	2	3	14	0	1440
5784	19	1389	7	9	0	1424
5785	17	13	3	1534	0	1567
5786	4	13	4	1502	0	1523
5787	2	1526	2	31	0	1561
5788	5	21	2	1521	0	1549
5789	1502	22	1	24	0	1549
5790	1593	4	2	28	0	1627
5791	1573	2	2	11	0	1588
5792	48	2	1719	5	0	1774
5793	1742	1	22	12	0	1777
5794	1847	5	28	2	0	1882
5795	1893	2	1	6	0	1902
5796	53	1910	4	8	0	1975
5797	30	27	2	1924	0	1983
5798	7	29	2	1967	0	2005
5799	2	2	3	1970	0	1977
5800	5	9	1900	52	0	1966
5801	3	1	28	1937	0	1969
5802	1915	4	27	31	0	1977
5803	31	1	4	1976	0	2012
5804	33	1	1	2001	0	2036
5805	5	7	1964	62	0	2038
5806	5	1932	31	33	0	2001
5807	2031	30	32	14	0	2107
5808	33	28	2	2062	0	2125
5809	2064	1	1	35	0	2101
5810	38	8	2036	34	0	2116
5811	1938	2	28	10	0	1978
5812	35	2161	30	4	0	2230
5813	31	35	2147	12	0	2225
5814	7	36	2151	4	0	2198
5815	9	6	60	2036	0	2111
5816	5	10	2190	36	0	2241
5817	7	2182	33	36	0	2258
5818	7	29	28	2101	0	2165
5819	5	32	4	2179	0	2220
5820	6	2	2	2208	0	2218
5821	2129	2	1	65	0	2197
5822	31	2147	9	33	0	2220
5823	34	26	5	2155	0	2220
5824	5	29	4	2184	0	2222
5825	2120	2	3	66	0	2191
5826	31	2140	9	38	0	2218
5827	2197	31	3	9	0	2240
5828	2144	32	4	12	0	2192
5829	2136	4	3	10	0	2153
5830	67	4	2063	11	0	2145
5831	43	5	33	2002	0	2083
5832	13	2058	39	31	0	2141
5833	9	2121	7	37	0	2174
5834	15	63	3	2016	0	2097
5835	7	2082	11	32	0	2132
5836	2122	40	5	37	0	2204
5837	41	37	2114	13	0	2205
5838	2056	6	33	13	0	2108
5839	2147	5	37	15	0	2204
5840	64	4	9	2194	0	2271
5841	2238	4	6	43	0	2291
5842	41	2410	7	40	0	2498
5843	2469	36	6	22	0	2533
5844	2453	40	3	12	0	2508
5845	2755	7	8	19	0	2789
5846	82	9	2743	16	0	2850
5847	57	12	2839	17	0	2925
5848	22	6	86	2736	0	2850
5849	21	2753	51	45	0	2870
5850	15	2845	21	58	0	2939
5851	19	82	16	2788	0	2905
5852	2851	50	10	59	0	2970
5853	56	17	7	2893	0	2973
5854	56	8	8	2851	0	2923
5855	2805	16	6	98	0	2925
5856	52	2839	10	71	0	2972
5857	54	47	2816	34	0	2951
5858	23	58	2829	28	0	2938
5859	2898	10	88	22	0	3018
5860	56	13	49	2885	0	3003
5861	106	16	2926	52	0	3100
5862	21	5	52	2942	0	3020
5863	23	7	49	2999	0	3078
5864	20	6	16	3048	0	3090
5865	19	15	12	2992	0	3038
5866	21	2929	8	100	0	3058
5867	19	41	11	2991	0	3062
5868	2957	48	13	57	0	3075
5869	48	2958	21	62	0	3089
5870	3090	51	13	22	0	3176
5871	3110	58	8	23	0	3199
5872	3140	15	11	29	0	3195
5873	95	18	3022	17	0	3152
5874	3049	14	50	26	0	3139
5875	3120	9	60	13	0	3202
5876	3131	13	13	19	0	3176
5877	3141	5	9	29	0	3184
5878	115	3079	10	24	0	3228
5879	3042	47	8	16	0	3113
5880	56	65	2988	18	0	3127
5881	62	20	39	2905	0	3026
5882	18	13	48	2995	0	3074
5883	3018	7	12	87	0	3124
5884	44	2952	23	72	0	3091
5885	2854	35	10	21	0	2920
5886	45	2927	12	14	0	2998
5887	3008	35	5	20	0	3068
5888	2968	40	0	16	0	3024
5889	61	3280	15	13	0	3369
5890	3333	37	3	13	0	3386
5891	3454	38	17	15	0	3524
5892	83	3246	5	7	0	3341
5893	52	3373	8	4	0	3437
5894	3595	70	16	13	0	3694
5895	75	40	5	3592	0	3712
5896	3638	30	7	53	0	3728
5897	3717	6	4	47	0	3774
5898	3773	1	3	16	0	3793
5899	3739	3	6	11	0	3759
5900	99	3610	11	13	0	3733
5901	60	3750	9	7	0	3826
5902	3772	86	2	7	0	3867
5903	61	62	3741	5	0	3869
5904	50	15	48	3668	0	3781
5905	16	8	46	3796	0	3866
5906	3773	7	11	98	0	3889
5907	53	3726	14	59	0	3852
5908	59	43	3	3707	0	3812
5909	19	55	1	3864	0	3939
5910	3861	14	4	108	0	3987
5911	55	9	7	3883	0	3954
5912	3779	5	2	67	0	3853
5913	3779	7	4	68	0	3858
5914	3808	4	0	21	0	3833
5915	118	5	2	3707	0	3832
5916	81	7	4	3772	0	3864
5917	25	20	4079	118	0	4242
5918	22	10	4050	67	0	4149
5919	4143	5	136	17	0	4301
5920	77	12	88	4306	0	4483
5921	92	13	4609	85	0	4799
5922	35	13	4656	89	0	4793
5923	28	9	168	4647	0	4852
5924	17	22	4704	93	0	4836
5925	24	7	102	4636	0	4769
5926	20	8	104	4678	0	4810
5927	15	14	4712	188	0	4929
5928	19	6	95	4755	0	4875
5929	26	9	97	4686	0	4818
5930	18	6	20	4911	0	4955
5931	21	22	4694	199	0	4936
5932	13	11	82	4842	0	4948
5933	4739	5	96	124	0	4964
5934	95	4765	36	119	0	5015
5935	4947	89	20	43	0	5099
5936	119	105	4781	30	0	5035
5937	4893	14	88	27	0	5022
5938	4909	15	103	23	0	5050
5939	4956	18	25	20	0	5019
5940	218	11	19	4732	0	4980
5941	144	16	15	4792	0	4967
5942	51	14	4449	200	0	4714
5943	4182	5	99	127	0	4413
5944	116	4310	110	43	0	4579
5945	111	3988	24	31	0	4154
5946	40	4177	17	29	0	4263
5947	35	179	14	3887	0	4115
5948	3871	101	17	93	0	4082
5949	3893	28	16	108	0	4045
5950	186	23	3813	28	0	4050
5951	116	17	84	3768	0	3985
5952	39	13	96	3798	0	3946
5953	31	20	3723	186	0	3960
5954	27	16	3689	124	0	3856
5955	3621	9	171	54	0	3855
5956	95	3722	112	37	0	3966
5957	3813	85	27	48	0	3973
5958	3798	89	21	35	0	3943
5959	197	22	22	3696	0	3937
5960	130	11	13	3800	0	3954
5961	3715	10	20	183	0	3928
5962	127	9	19	3774	0	3929
5963	122	10	19	3754	0	3905
5964	3673	6	20	194	0	3893
5965	116	9	19	3758	0	3902
5966	3778	5	25	134	0	3942
5967	3779	7	38	124	0	3948
5968	192	12	3712	53	0	3969
5969	3708	15	98	54	0	3875
5970	3695	6	114	41	0	3856
5971	3722	11	40	44	0	3817
5972	200	17	3218	44	0	3479
5973	3543	8	94	39	0	3684
5974	120	3454	100	45	0	3719
5975	3593	74	35	46	0	3748
5976	3590	80	36	49	0	3755
5977	189	16	23	3511	0	3739
5978	132	10	21	3538	0	3701
5979	42	3510	27	188	0	3767
5980	52	83	21	3601	0	3757
5981	41	93	22	3629	0	3785
5982	3539	20	24	187	0	3770
5983	129	20	13	3576	0	3738
5984	131	10	15	3536	0	3692
5985	48	16	30	3517	0	3611
5986	56	3357	22	194	0	3629
5987	3273	78	24	125	0	3500
5988	119	3309	38	57	0	3523
5989	2959	80	28	46	0	3113
5990	105	83	2802	39	0	3029
5991	2631	18	76	36	0	2761
5992	97	21	2694	44	0	2856
5993	92	2479	92	30	0	2693
5994	2338	57	89	22	0	2506
5995	2294	72	35	20	0	2421
5996	131	2181	23	22	0	2357
5997	81	2146	22	20	0	2269
5998	2136	100	10	26	0	2272
5999	2173	69	18	21	0	2281
6000	134	19	12	2115	0	2280
6001	88	19	9	2167	0	2283
6002	42	16	2105	115	0	2278
6003	2086	11	49	78	0	2224
6004	75	16	60	2061	0	2212
6005	68	2105	25	74	0	2272
6006	44	47	10	2127	0	2228
6007	40	60	9	2098	0	2207
6008	25	18	2022	117	0	2182
6009	28	22	48	2064	0	2162
6010	1915	10	49	77	0	2051
6011	58	1866	17	73	0	2014
6012	69	1958	17	26	0	2070
6013	1941	89	19	18	0	2067
6014	1987	61	7	32	0	2087
6015	2017	18	10	22	0	2067
6016	118	1895	21	17	0	2051
6017	38	1608	17	15	0	1678
6018	1677	55	8	10	0	1750
6019	1675	38	7	7	0	1727
6020	76	1531	6	10	0	1623
6021	17	1233	2	4	0	1256
6022	1193	28	1	7	0	1229
6023	18	16	3	1190	0	1227
6024	1268	1	3	14	0	1286
6025	17	5	0	1258	0	1280
6026	19	1270	1	18	0	1308
6027	7	1267	4	19	0	1297
6028	1357	42	1	7	0	1407
6029	1338	16	4	4	0	1362
6030	1402	2	1	7	0	1412
6031	44	1336	4	3	0	1387
6032	23	23	1305	6	0	1357
6033	4	1369	23	2	0	1398
6034	1286	20	15	3	0	1324
6035	1178	20	0	6	0	1204
6036	35	2	1232	3	0	1272
6037	15	1205	17	0	0	1237
6038	7	19	13	1195	0	1234
6039	7	16	1	1148	0	1172
6040	6	1105	8	28	0	1147
6041	4	20	1169	9	0	1202
6042	1187	12	17	3	0	1219
6043	23	4	12	1202	0	1241
6044	1221	4	3	21	0	1249
6045	1235	6	0	15	0	1256
6046	35	3	2	1268	0	1308
6047	17	4	0	1349	0	1370
6048	4	5	2	1388	0	1399
6049	8	4	2	1393	0	1407
6050	1337	5	1	43	0	1386
6051	1347	2	2	25	0	1376
6052	42	10	1315	5	0	1372
6053	23	1	24	1316	0	1364
6054	7	2	18	1337	0	1364
6055	8	2	1	1361	0	1372
6056	4	7	1308	37	0	1356
6057	5	3	23	1326	0	1357
6058	1308	3	18	28	0	1357
6059	30	1	2	1309	0	1342
6060	26	1	1279	24	0	1330
6061	9	3	23	1250	0	1285
6062	7	6	1263	29	0	1305
6063	1250	6	20	23	0	1299
6064	30	2	20	1266	0	1318
6065	1259	1	4	30	0	1294
6066	1237	5	6	26	0	1274
6067	41	5	2	1238	0	1286
6068	1333	3	3	37	0	1376
6069	30	5	4	1323	0	1362
6070	30	1397	9	28	0	1464
6071	1463	30	4	28	0	1525
6072	1490	26	2	12	0	1530
6073	1486	3	4	8	0	1501
6074	59	3	4	1466	0	1532
6075	38	0	4	1505	0	1547
6076	16	2	0	1527	0	1545
6077	9	5	1457	64	0	1535
6078	9	1404	35	41	0	1489
6079	8	30	24	1413	0	1475
6080	10	27	1373	41	0	1451
6081	1352	3	35	31	0	1421
6082	35	4	27	1376	0	1442
6083	27	3	1360	40	0	1430
6084	1423	3	29	37	0	1492
6085	39	2	28	1445	0	1514
6086	30	3	5	1460	0	1498
6087	12	1	5	1474	0	1492
6088	1431	1	4	64	0	1500
6089	1439	2	15	42	0	1498
6090	1445	2	4	17	0	1468
6091	61	1386	6	8	0	1461
6092	31	1388	4	9	0	1432
6093	1378	48	5	13	0	1444
6094	40	26	1355	15	0	1436
6095	31	5	26	1364	0	1426
6096	17	3	28	1399	0	1447
6097	1375	3	5	57	0	1440
6098	1312	1	5	39	0	1357
6099	58	1334	7	15	0	1414
6100	34	29	1	1330	0	1394
6101	15	27	1305	40	0	1387
6102	10	6	1302	31	0	1349
6103	12	6	52	1280	0	1350
6104	13	4	29	1332	0	1378
6105	1285	1	6	65	0	1357
6106	36	2	7	1371	0	1416
6107	1438	6	4	48	0	1496
6108	1427	1	6	43	0	1477
6109	60	7	1407	15	0	1489
6110	1437	5	30	16	0	1488
6111	1435	6	26	18	0	1485
6112	1439	2	8	16	0	1465
6113	61	1411	11	13	0	1496
6114	39	1431	12	9	0	1491
6115	18	52	4	1417	0	1491
6116	12	29	1407	43	0	1491
6117	11	1310	30	35	0	1386
6118	24	30	20	1219	0	1293
6119	15	18	7	1194	0	1234
6120	11	1220	9	70	0	1310
6121	1248	33	4	30	0	1315
6122	1274	21	1	13	0	1309
6123	56	5	1299	8	0	1368
6124	1227	3	30	9	0	1269
6125	33	6	1200	11	0	1250
6126	1120	4	29	14	0	1167
6127	34	6	1226	10	0	1276
6128	20	1053	25	55	0	1153
6129	11	16	16	1083	0	1126
6130	9	16	7	1097	0	1129
6131	1081	3	22	34	0	1140
6132	1102	2	2	23	0	1129
6133	1088	2	0	16	0	1106
6134	39	6	1079	5	0	1129
6135	29	3	18	1061	0	1111
6136	13	3	17	1107	0	1140
6137	1099	0	5	36	0	1140
6138	23	1123	7	24	0	1177
6139	1155	22	0	11	0	1188
6140	29	15	2	1177	0	1223
6141	24	5	3	1206	0	1238
6142	11	7	3	1226	0	1247
6143	7	5	1	1244	0	1257
6144	9	1	3	1231	0	1244
6145	6	1150	7	39	0	1202
6146	5	1129	3	17	0	1154
6147	5	1093	3	6	0	1107
6148	5	22	2	1060	0	1089
6149	5	14	1042	13	0	1074
6150	910	5	14	17	0	946
6151	16	1092	11	7	0	1126
6152	14	13	8	1085	0	1120
6153	8	12	2	1189	0	1211
6154	1180	4	2	27	0	1213
6155	1175	1	1	19	0	1196
6156	1155	1	4	7	0	1167
6157	35	2	0	1351	0	1388
6158	21	5	1353	17	0	1396
6159	9	2	1471	17	0	1499
6160	3	2	30	1471	0	1506
6161	8	1	1489	18	0	1516
6162	1368	1	18	18	0	1405
6163	19	2	16	1458	0	1495
6164	18	5	1467	21	0	1511
6165	5	2	15	1451	0	1473
6166	6	6	1555	23	0	1590
6167	4	7	1633	16	0	1660
6168	10	4	29	1621	0	1664
6169	5	8	1712	23	0	1748
6170	3	4	1665	24	0	1696
6171	2	1517	45	5	0	1569
6172	6	22	23	1581	0	1632
6173	1705	19	4	23	0	1751
6174	23	2	0	1701	0	1726
6175	24	0	2	1777	0	1803
6176	2	8	1739	41	0	1790
6177	1507	0	25	26	0	1558
6178	21	1	20	1748	0	1790
6179	24	0	4	1788	0	1816
6180	1730	1	2	44	0	1777
6181	24	1	1	1810	0	1836
6182	1776	0	4	34	0	1814
6183	1800	5	3	26	0	1834
6184	1757	4	2	8	0	1771
6185	43	1706	2	6	0	1757
6186	1743	20	3	5	0	1771
6187	25	1732	3	3	0	1763
6188	24	22	1	1729	0	1776
6189	1752	21	5	28	0	1806
6190	24	1785	4	25	0	1838
6191	1787	23	3	10	0	1823
6192	29	1795	4	4	0	1832
6193	1738	21	3	4	0	1766
6194	29	1759	8	3	0	1799
6195	22	1783	6	4	0	1815
6196	4	1875	6	3	0	1888
6197	6	46	1	1764	0	1817
6198	3	1938	4	25	0	1970
6199	4	31	3	1895	0	1933
6200	5	21	1	1952	0	1979
6201	8	3	2	1976	0	1989
6202	6	3	2	1984	0	1995
6203	1898	1	0	49	0	1948
6204	1944	3	4	27	0	1978
6205	50	9	1915	6	0	1980
6206	1958	3	25	13	0	1999
6207	2099	5	29	9	0	2142
6208	2184	4	11	3	0	2202
6209	62	10	2136	3	0	2211
6210	37	6	2168	9	0	2220
6211	2045	4	65	8	0	2122
6212	37	7	2243	12	0	2299
6213	37	2266	39	11	0	2353
6214	8	36	38	2272	0	2354
6215	2368	36	6	43	0	2453
6216	2423	3	4	47	0	2477
6217	2530	1	5	18	0	2554
6218	82	2	4	2497	0	2585
6219	46	2	4	2596	0	2648
6220	16	10	2593	78	0	2697
6221	12	2	42	2626	0	2682
6222	13	4	41	2674	0	2732
6223	2601	9	4	87	0	2701
6224	59	2652	11	62	0	2784
6225	2730	53	4	17	0	2804
6226	59	41	3	2745	0	2848
6227	2704	8	6	54	0	2772
6228	2730	9	4	55	0	2798
6229	2654	4	6	14	0	2678
6230	95	2685	6	10	0	2796
6231	57	2751	5	9	0	2822
6232	15	95	3	2728	0	2841
6233	2724	48	5	60	0	2837
6234	53	10	4	2716	0	2783
6235	53	8	5	2742	0	2808
6236	14	10	2696	104	0	2824
6237	18	6	52	2726	0	2802
6238	12	11	44	2714	0	2781
6239	20	5	9	2770	0	2804
6240	15	8	2649	120	0	2792
6241	28	9	2621	61	0	2719
6242	29	2620	96	11	0	2756
6243	2646	58	53	13	0	2770
6244	68	48	6	2638	0	2760
6245	60	19	2713	59	0	2851
6246	25	7	55	2684	0	2771
6247	25	6	49	2985	0	3065
6248	2933	5	13	112	0	3063
6249	2972	10	7	60	0	3049
6250	101	2946	18	16	0	3081
6251	2997	52	10	26	0	3085
6252	2991	47	7	28	0	3073
6253	102	8	12	2863	0	2985
6254	56	11	2840	60	0	2967
6255	22	2815	73	56	0	2966
6256	2820	49	48	24	0	2941
6257	2773	44	10	25	0	2852
6258	100	2802	16	20	0	2938
6259	58	54	13	2768	0	2893
6260	2849	47	7	76	0	2979
6261	2876	11	6	64	0	2957
6262	123	12	8	2966	0	3109
6263	3034	9	5	71	0	3119
6264	3108	12	5	66	0	3191
6265	3175	7	12	26	0	3220
6266	139	16	3122	21	0	3298
6267	72	3016	70	28	0	3186
6268	31	3035	56	20	0	3142
6269	2885	96	15	20	0	3016
6270	71	2945	19	24	0	3059
6271	54	70	2901	14	0	3039
6272	23	56	58	2883	0	3020
6273	2870	14	44	83	0	3011
6274	74	12	13	2911	0	3010
6275	2966	12	8	75	0	3061
6276	2970	8	10	65	0	3053
6277	3023	6	9	25	0	3063
6278	123	2884	15	17	0	3039
6279	70	3028	15	20	0	3133
6280	3040	99	12	32	0	3183
6281	3026	59	15	16	0	3116
6282	3088	21	7	25	0	3141
6283	127	9	10	3006	0	3152
6284	3041	11	4	72	0	3128
6285	84	2925	20	59	0	3088
6286	64	3052	17	25	0	3158
6287	39	100	9	3008	0	3156
6288	27	54	2982	75	0	3138
6289	26	25	2970	59	0	3080
6290	31	13	104	2960	0	3108
6291	28	30	3011	70	0	3139
6292	31	17	68	2994	0	3110
6293	3005	21	45	76	0	3147
6294	90	9	10	3032	0	3141
6295	2984	7	17	89	0	3097
6296	92	2890	18	61	0	3061
6297	74	73	2899	24	0	3070
6298	40	54	57	2794	0	2945
6299	33	22	56	2910	0	3021
6300	19	35	2895	118	0	3067
6301	31	14	62	2861	0	2968
6302	31	3113	64	73	0	3281
6303	23	71	16	3224	0	3334
6304	27	52	12	3264	0	3355
6305	30	11	13	3434	0	3488
6306	32	25	3284	135	0	3476
6307	21	17	3086	80	0	3204
6308	2690	11	111	29	0	2841
6309	76	13	2994	16	0	3099
6310	60	2953	71	11	0	3095
6311	2975	65	60	13	0	3113
6312	73	3032	18	16	0	3139
6313	2940	66	16	15	0	3037
6314	2952	57	10	10	0	3029
6315	2848	14	4	16	0	2882
6316	2829	17	6	15	0	2867
6317	120	2686	12	13	0	2831
6318	63	2700	16	17	0	2796
6319	2669	103	7	16	0	2795
6320	69	62	2585	14	0	2730
6321	63	15	55	2517	0	2650
6322	18	11	51	2619	0	2699
6323	17	8	2596	103	0	2724
6324	2331	10	56	67	0	2464
6325	2565	4	53	23	0	2645
6326	2575	7	12	21	0	2615
6327	106	2493	17	17	0	2633
6328	2581	50	14	18	0	2663
6329	68	54	6	2446	0	2574
6330	57	2652	20	49	0	2778
6331	2715	59	10	53	0	2837
6332	2796	55	9	19	0	2879
6333	2976	17	6	14	0	3013
6334	123	13	11	2845	0	2992
6335	86	7	7	2867	0	2967
6336	27	2774	8	112	0	2921
6337	23	66	2777	66	0	2932
6338	23	61	56	2794	0	2934
6339	26	14	61	2809	0	2910
6340	23	8	17	2988	0	3036
6341	16	9	2872	124	0	3021
6342	2746	11	64	82	0	2903
6343	76	6	64	2975	0	3121
6344	81	11	3003	65	0	3160
6345	34	16	61	2964	0	3075
6346	3012	11	67	78	0	3168
6347	81	2851	18	74	0	3024
6348	84	71	12	2933	0	3100
6349	27	82	2922	76	0	3107
6350	2769	16	70	91	0	2946
6351	2914	14	76	29	0	3033
6352	153	16	2907	13	0	3089
6353	104	11	69	2578	0	2762
6354	23	2902	78	74	0	3077
6355	2936	73	25	73	0	3107
6356	84	75	2915	24	0	3098
6357	2817	14	72	16	0	2919
6358	83	19	2807	19	0	2928
6359	82	9	2708	14	0	2813
6360	2499	10	126	19	0	2654
6361	74	2661	78	22	0	2835
6362	76	68	2557	36	0	2737
6363	27	2634	69	16	0	2746
6364	32	64	2582	19	0	2697
6365	17	2587	69	16	0	2689
6366	2403	62	57	16	0	2538
6367	57	68	2416	17	0	2558
6368	66	15	2495	15	0	2591
6369	17	10	2507	15	0	2549
6370	2346	7	105	15	0	2473
6371	2459	8	58	12	0	2537
6372	103	2	15	2424	0	2544
6373	67	11	2482	52	0	2612
6374	16	10	2507	55	0	2588
6375	2379	9	103	14	0	2505
6376	68	9	61	2451	0	2589
6377	2490	1	17	54	0	2562
6378	2477	8	13	58	0	2556
6379	105	7	19	2342	0	2473
6380	69	2364	20	46	0	2499
6381	32	49	8	2413	0	2502
6382	15	58	9	2432	0	2514
6383	21	11	2401	105	0	2538
6384	17	2361	58	60	0	2496
6385	13	2426	68	35	0	2542
6386	16	96	27	2314	0	2453
6387	14	59	2373	52	0	2498
6388	15	2360	62	59	0	2496
6389	20	59	2416	16	0	2511
6390	2248	59	72	10	0	2389
6391	2411	18	54	17	0	2500
6392	106	9	2388	14	0	2517
6393	2405	8	68	12	0	2493
6394	78	7	63	2360	0	2508
6395	64	2461	32	48	0	2605
6396	28	50	19	2510	0	2607
6397	2443	55	18	63	0	2579
6398	2528	15	18	61	0	2622
6399	2568	10	15	16	0	2609
6400	2448	14	18	21	0	2501
6401	102	2325	25	14	0	2466
6402	59	2201	23	11	0	2294
6403	2125	81	13	12	0	2231
6404	58	54	2086	10	0	2208
6405	50	52	44	1930	0	2076
6406	17	2028	55	32	0	2132
6407	15	36	24	1934	0	2009
6408	15	2080	19	38	0	2152
6409	17	40	12	2086	0	2155
6410	11	44	2091	44	0	2190
6411	1998	20	45	41	0	2104
6412	2114	10	50	15	0	2189
6413	76	11	2130	16	0	2233
6414	2103	9	41	10	0	2163
6415	2165	8	49	10	0	2232
6416	80	6	2120	12	0	2218
6417	62	8	43	2067	0	2180
6418	2131	10	47	43	0	2231
6419	49	12	2145	44	0	2250
6420	55	8	43	2061	0	2167
6421	28	15	2178	40	0	2261
6422	16	21	2170	46	0	2253
6423	2114	8	75	19	0	2216
6424	2234	10	50	12	0	2306
6425	2311	11	18	17	0	2357
6426	2371	14	20	12	0	2417
6427	86	11	8	2190	0	2295
6428	49	2177	17	36	0	2279
6429	19	2255	21	43	0	2338
6430	23	69	18	2113	0	2223
6431	2135	35	14	31	0	2215
6432	43	2064	15	28	0	2150
6433	36	2048	10	17	0	2111
6434	2048	50	14	3	0	2115
6435	36	33	12	2022	0	2103
6436	2034	13	10	31	0	2088
6437	40	2058	10	37	0	2145
6438	2052	31	8	11	0	2102
6439	43	28	2224	7	0	2302
6440	2437	6	27	9	0	2479
6441	2512	5	40	7	0	2564
6442	2534	4	38	12	0	2588
6443	74	13	2257	9	0	2353
6444	2428	7	29	7	0	2471
6445	42	2442	30	10	0	2524
6446	32	40	2376	8	0	2456
6447	29	36	45	2226	0	2336
6448	9	5	24	2175	0	2213
6449	4	2371	9	48	0	2432
6450	7	34	3	2396	0	2440
6451	9	23	2	2427	0	2461
6452	8	9	2368	52	0	2437
6453	2105	5	31	34	0	2175
6454	34	5	2403	6	0	2448
6455	59	2	33	2296	0	2390
6456	16	2	2395	28	0	2441
6457	7	6	39	2322	0	2374
6458	2427	2	31	32	0	2492
6459	2493	2	8	31	0	2534
6460	61	4	5	2469	0	2539
6461	35	2	2506	36	0	2579
6462	16	0	33	2513	0	2562
6463	16	7	2468	34	0	2525
6464	2365	0	35	32	0	2432
6465	2469	5	30	10	0	2514
6466	2436	6	3	7	0	2452
6467	2372	4	8	8	0	2392
6468	63	2274	6	8	0	2351
6469	36	36	4	2257	0	2333
6470	2199	32	4	31	0	2266
6471	33	2247	7	38	0	2325
6472	29	2259	13	11	0	2312
6473	9	57	2103	8	0	2177
6474	2115	39	32	4	0	2190
6475	2208	6	26	12	0	2252
6476	61	8	2169	4	0	2242
6477	42	19	33	2077	0	2171
6478	20	1	26	2198	0	2245
6479	13	5	2187	58	0	2263
6480	10	4	34	2134	0	2182
6481	2130	3	33	39	0	2205
6482	38	6	2136	28	0	2208
6483	30	10	2165	8	0	2213
6484	2066	3	56	12	0	2137
6485	39	7	2205	11	0	2262
6486	2128	4	35	10	0	2177
6487	41	2156	32	9	0	2238
6488	2212	29	6	5	0	2252
6489	49	26	6	2152	0	2233
6490	35	5	6	2186	0	2232
6491	2161	6	5	55	0	2227
6492	38	8	3	2183	0	2232
6493	2160	2	3	39	0	2204
6494	36	2222	10	33	0	2301
6495	36	32	2	2165	0	2235
6496	11	33	2	2201	0	2247
6497	2125	4	7	59	0	2195
6498	2160	8	4	35	0	2207
6499	2173	6	2	12	0	2193
6500	59	2103	7	7	0	2176
6501	34	2146	11	12	0	2203
6502	2145	53	3	8	0	2209
6503	42	30	2118	4	0	2194
6504	42	2102	34	3	0	2181
6505	2005	30	26	5	0	2066
6506	1996	22	7	11	0	2036
6507	2023	2	7	7	0	2039
6508	51	2	4	1955	0	2012
6509	2012	2	5	25	0	2044
6510	1959	2	1	27	0	1989
6511	53	2	3	1878	0	1936
6512	1934	4	7	27	0	1972
6513	28	5	1823	29	0	1885
6514	29	3	28	1816	0	1876
6515	12	4	22	1853	0	1891
6516	17	0	3	1904	0	1924
6517	1857	5	4	47	0	1913
6518	1900	3	6	25	0	1934
6519	1842	5	5	8	0	1860
6520	1828	1	4	10	0	1843
6521	1788	1	5	18	0	1812
6522	49	4	5	1703	0	1761
6523	34	4	1	1717	0	1756
6524	1690	2	7	44	0	1743
6525	33	1608	8	27	0	1676
6526	1613	21	6	10	0	1650
6527	28	20	1542	8	0	1598
6528	1609	1	26	8	0	1644
6529	1600	3	21	7	0	1631
6530	56	3	1683	4	0	1746
6531	1693	1	25	3	0	1722
6532	33	2	1739	3	0	1777
6533	26	7	1739	4	0	1776
6534	7	3	46	1628	0	1684
6535	10	0	24	1738	0	1772
6536	7	2	1716	48	0	1773
6537	11	2	1751	25	0	1789
6538	4	1722	53	8	0	1787
6539	10	1579	25	6	0	1620
6540	1238	29	3	2	0	1272
6541	14	1187	6	2	0	1209
6542	1167	15	2	3	0	1187
6543	15	1152	4	2	0	1173
6544	1123	14	2	2	0	1141
6545	15	13	1093	3	0	1124
6546	1101	1	14	2	0	1118
6547	17	1	15	1075	0	1108
6548	13	1093	3	12	0	1121
6549	4	14	1	1089	0	1108
6550	1074	11	2	13	0	1100
6551	1068	3	1	11	0	1083
6552	23	1	1	1075	0	1100
6553	13	3	1074	13	0	1103
6554	6	0	1083	11	0	1100
6555	0	1098	23	2	0	1123
6556	4	12	10	1081	0	1107
6557	2	10	1100	13	0	1125
6558	3	988	11	10	0	1012
6559	16	12	8	984	0	1020
6560	5	8	3	1015	0	1031
6561	958	2	0	21	0	981
6562	14	0	1	969	0	984
6563	9	1	965	13	0	988
6564	3	0	11	955	0	969
6565	909	2	8	13	0	932
6566	12	3	964	9	0	988
6567	910	0	13	2	0	925
6568	12	972	9	0	0	993
6569	990	11	1	2	0	1004
6570	991	8	0	5	0	1004
6571	23	2	2	938	0	965
6572	13	1	1	957	0	972
6573	2	947	3	21	0	973
6574	2	10	2	978	0	992
6575	922	8	2	14	0	946
6576	11	4	913	11	0	939
6577	9	0	12	920	0	941
6578	4	935	11	11	0	961
6579	3	11	4	954	0	972
6580	4	9	3	965	0	981
6581	918	1	3	20	0	942
6582	12	940	3	12	0	967
6583	12	12	3	934	0	961
6584	920	10	3	14	0	947
6585	15	2	3	921	0	941
6586	10	2	6	927	0	945
6587	903	2	3	21	0	929
6588	903	4	0	14	0	921
6589	19	3	905	5	0	932
6590	871	3	12	3	0	889
6591	917	3	9	1	0	930
6592	939	4	4	7	0	954
6593	24	899	4	3	0	930
6594	9	833	3	2	0	847
6595	4	18	3	826	0	851
6596	832	10	2	11	0	855
6597	846	3	3	10	0	862
6598	19	4	2	813	0	838
6599	11	2	876	11	0	900
6600	863	2	12	12	0	889
6601	914	4	7	6	0	931
6602	20	2	3	899	0	924
6603	11	2	3	905	0	921
6604	897	4	2	20	0	923
6605	13	2	2	904	0	921
6606	10	934	3	15	0	962
6607	6	9	6	945	0	966
6608	890	10	3	16	0	919
6609	12	3	881	11	0	907
6610	836	0	12	5	0	853
6611	15	4	894	0	0	913
6612	8	2	11	882	0	903
6613	906	0	9	18	0	933
6614	14	1	3	917	0	935
6615	10	2	1	964	0	977
6616	911	1	24	23	0	959
6617	11	1	960	12	0	984
6618	9	4	1027	4	0	1044
6619	6	1	20	1001	0	1028
6620	5	0	10	1063	0	1078
6621	3	3	3	1070	0	1079
6622	3	3	1065	21	0	1092
6623	994	1	10	12	0	1017
6624	1063	1	7	6	0	1077
6625	1066	1	3	6	0	1076
6626	1067	2	3	3	0	1075
6627	20	1044	1	5	0	1070
6628	8	1034	1	7	0	1050
6629	2	949	2	4	0	957
6630	2	8	0	777	0	787
6631	1	2	0	857	0	860
6632	2	1	789	12	0	804
6633	1	755	5	2	0	763
6634	0	3	2	755	0	760
6635	752	3	0	3	0	758
6636	3	754	0	3	0	760
6637	17	5	0	747	0	769
6638	0	749	0	3	0	752
6639	765	3	0	5	0	773
6640	3	2	1	815	0	821
6641	3	3	825	4	0	835
6642	0	0	807	4	0	811
6643	0	0	7	877	0	884
6644	1	0	4	904	0	909
6645	1	0	0	932	0	933
6646	886	0	1	11	0	898
6647	5	1	893	5	0	904
6648	5	885	4	3	0	897
6649	1	5	7	893	0	906
6650	1	6	920	5	0	932
6651	0	909	7	8	0	924
6652	2	5	5	942	0	954
6653	2	6	945	5	0	958
6654	0	0	4	925	0	929
6655	1	0	5	941	0	947
6656	969	1	0	12	0	982
6657	968	0	1	9	0	978
6658	15	0	0	963	0	978
6659	978	0	2	6	0	986
6660	11	1	985	8	0	1005
6661	10	0	10	987	0	1007
6662	2	6	1020	10	0	1038
6663	1	1	10	1021	0	1033
6664	0	1005	13	11	0	1029
6665	1	1056	1	11	0	1069
6666	0	1051	0	5	0	1056
6667	1	23	1	1046	0	1071
6668	0	10	2	1139	0	1151
6669	0	6	1129	27	0	1162
6670	1	4	1134	15	0	1154
6671	2	3	1210	2	0	1217
6672	1168	2	32	2	0	1204
6673	18	1	18	1214	0	1251
6674	1280	2	3	18	0	1303
6675	23	1318	2	20	0	1363
6676	23	28	2	1342	0	1395
6677	1383	25	0	26	0	1434
6678	31	3	0	1385	0	1419
6679	1369	1	3	30	0	1403
6680	31	4	1473	26	0	1534
6681	23	1502	29	7	0	1561
6682	5	27	23	1548	0	1603
6683	1584	24	4	32	0	1644
6684	1609	3	1	31	0	1644
6685	54	2	2	1596	0	1654
6686	29	2	3	1622	0	1656
6687	1575	2	5	56	0	1638
6688	28	1	11	1599	0	1639
6689	26	5	1581	37	0	1649
6690	9	1613	31	28	0	1681
6691	3	27	28	1651	0	1709
6692	1620	25	7	29	0	1681
6693	1630	7	4	34	0	1675
6694	59	7	1652	11	0	1729
6695	35	1622	31	10	0	1698
6696	6	1695	30	10	0	1741
6697	9	55	7	1685	0	1756
6698	4	32	5	1750	0	1791
6699	3	8	4	1738	0	1753
6700	9	5	8	1721	0	1743
6701	7	1677	6	67	0	1757
6702	11	35	5	1705	0	1756
6703	13	32	1	1726	0	1772
6704	1681	6	4	74	0	1765
6705	1691	3	1	43	0	1738
6706	69	1666	12	14	0	1761
6707	1723	36	7	14	0	1780
6708	1719	37	5	15	0	1776
6709	1735	8	7	15	0	1765
6710	76	8	1661	11	0	1756
6711	39	8	37	1659	0	1743
6712	16	5	35	1712	0	1768
6713	14	9	1648	72	0	1743
6714	18	6	35	1650	0	1709
6715	8	7	37	1569	0	1621
6716	1596	8	3	76	0	1683
6717	42	6	1611	49	0	1708
6718	42	5	34	1550	0	1631
6719	1548	8	33	50	0	1639
6720	39	1550	13	50	0	1652
6721	1591	40	4	25	0	1660
6722	1575	36	6	16	0	1633
6723	73	1563	8	22	0	1666
6724	43	44	4	1601	0	1692
6725	1596	39	2	49	0	1686
6726	48	1598	7	40	0	1693
6727	44	41	6	1607	0	1698
6728	1587	35	8	56	0	1686
6729	1587	9	7	49	0	1652
6730	75	1610	9	20	0	1714
6731	1636	35	9	18	0	1698
6732	44	33	7	1619	0	1703
6733	1630	8	7	53	0	1698
6734	55	15	1585	40	0	1695
6735	44	6	38	1580	0	1668
6736	16	8	35	1628	0	1687
6737	1600	4	6	76	0	1686
6738	40	1593	13	41	0	1687
6739	1561	34	6	22	0	1623
6740	44	1508	7	14	0	1573
6741	44	39	1442	16	0	1541
6742	21	30	1476	19	0	1546
6743	26	11	71	1397	0	1505
6744	19	12	1444	46	0	1521
6745	14	5	35	1461	0	1515
6746	26	6	24	1423	0	1479
6747	25	5	7	1480	0	1517
6748	1440	15	5	68	0	1528
6749	1453	8	5	40	0	1506
6750	1485	7	1	19	0	1512
6751	76	1516	5	10	0	1607
6752	42	1654	13	14	0	1723
6753	18	75	1814	23	0	1930
6754	14	39	56	1849	0	1958
6755	15	14	1889	65	0	1983
6756	15	13	53	1862	0	1943
6757	16	5	47	1889	0	1957
6758	16	14	7	1933	0	1970
6759	16	14	1809	101	0	1940
6760	15	7	54	1852	0	1928
6761	1791	5	46	70	0	1912
6762	56	1767	22	59	0	1904
6763	53	50	7	1786	0	1896
6764	1800	45	10	67	0	1922
6765	1798	14	10	58	0	1880
6766	96	7	7	1772	0	1882
6767	66	2	7	1752	0	1827
6768	1652	9	3	89	0	1753
6769	57	5	7	1686	0	1755
6770	1591	4	5	60	0	1660
6771	57	0	3	1610	0	1670
6772	40	11	1509	56	0	1616
6773	17	1460	44	48	0	1569
6774	14	1478	31	15	0	1538
6775	21	57	6	1394	0	1478
6776	13	29	11	1410	0	1463
6777	1362	6	3	64	0	1435
6778	36	7	2	1395	0	1440
6779	34	7	2	1392	0	1435
6780	7	10	3	1253	0	1273
6781	7	1202	11	69	0	1289
6782	7	30	2	1274	0	1313
6783	7	26	5	1248	0	1286
6784	4	4	4	1263	0	1275
6785	1159	3	3	73	0	1238
6786	31	1175	5	45	0	1256
6787	29	31	4	1210	0	1274
6788	10	29	2	1223	0	1264
6789	16	5	1	1242	0	1264
6790	1150	4	1	67	0	1222
6791	36	6	2	1164	0	1208
6792	28	5	1	1159	0	1193
6793	11	2	1077	63	0	1153
6794	6	1031	30	39	0	1106
6795	5	26	24	1068	0	1123
6796	1050	25	4	35	0	1114
6797	32	1069	7	37	0	1145
6798	1048	28	4	16	0	1096
6799	1039	21	7	5	0	1072
6800	47	9	2	1024	0	1082
6801	29	4	0	1054	0	1087
6802	11	5	1049	49	0	1114
6803	8	3	30	1083	0	1124
6804	8	1	1080	37	0	1126
6805	11	0	30	1111	0	1152
6806	1009	4	28	43	0	1084
6807	30	1036	9	40	0	1115
6808	25	27	9	1108	0	1169
6809	9	22	4	1137	0	1172
6810	8	6	4	1144	0	1162
6811	5	8	4	1162	0	1179
6812	1107	5	5	63	0	1180
6813	31	1095	4	40	0	1170
6814	30	28	1	1136	0	1195
6815	1124	21	3	50	0	1198
6816	34	7	1115	38	0	1194
6817	1095	6	32	21	0	1154
6818	1115	6	20	20	0	1161
6819	54	9	1066	17	0	1146
6820	31	5	27	1049	0	1112
6821	1044	2	29	36	0	1111
6822	32	1067	9	36	0	1144
6823	1071	31	7	17	0	1126
6824	1044	25	3	25	0	1097
6825	1057	10	5	17	0	1089
6826	61	7	3	1028	0	1099
6827	41	4	2	1057	0	1104
6828	18	1150	5	54	0	1227
6829	17	30	2	1159	0	1208
6830	1103	26	5	41	0	1175
6831	35	10	1081	42	0	1168
6832	1093	6	28	24	0	1151
6833	1143	4	25	24	0	1196
6834	58	6	8	1081	0	1153
6835	36	5	2	1134	0	1177
6836	1126	5	5	60	0	1196
6837	1134	3	4	39	0	1180
6838	1080	4	4	20	0	1108
6839	61	8	1105	18	0	1192
6840	35	1097	26	26	0	1184
6841	1105	30	25	20	0	1180
6842	37	24	8	1067	0	1136
6843	34	1074	11	34	0	1153
6844	19	33	3	1074	0	1129
6845	1053	28	5	45	0	1131
6846	34	12	2	1078	0	1126
6847	35	12	1025	39	0	1111
6848	10	1026	30	41	0	1107
6849	10	1053	27	21	0	1111
6850	11	48	1015	19	0	1093
6851	805	76	35	12	0	928
6852	15	772	18	9	0	814
6853	7	12	4	538	0	561
6854	536	5	1	6	0	548
6855	5	536	0	4	0	545
6856	5	3	0	534	0	542
6857	536	4	0	6	0	546
6858	6	4	0	532	0	542
6859	544	0	0	9	0	553
6860	6	2	548	5	0	561
6861	5	557	6	3	0	571
6862	591	3	6	3	0	603
6863	574	5	2	1	0	582
6864	580	3	1	1	0	585
6865	10	4	548	1	0	563
6866	556	0	3	4	0	563
6867	590	1	5	4	0	600
6868	9	1	1	592	0	603
6869	595	0	1	6	0	602
6870	6	583	1	6	0	596
6871	5	5	0	596	0	606
6872	4	8	610	4	0	626
6873	2	3	3	604	0	612
6874	4	2	6	624	0	636
6875	634	2	4	11	0	651
6876	628	1	0	10	0	639
6877	12	2	641	2	0	657
6878	620	0	5	4	0	629
6879	10	1	639	1	0	651
6880	7	2	6	651	0	666
6881	6	4	644	7	0	661
6882	6	0	6	629	0	641
6883	3	649	8	8	0	668
6884	5	5	674	7	0	691
6885	4	11	708	3	0	726
6886	1	5	15	594	0	615
6887	716	3	10	7	0	736
6888	735	0	2	9	0	746
6889	744	0	2	5	0	751
6890	17	2	1	723	0	743
6891	15	0	1	735	0	751
6892	6	2	1	746	0	755
6893	1	1	0	750	0	752
6894	2	1	733	15	0	751
6895	2	3	5	711	0	721
6896	1	706	7	9	0	723
6897	1	5	6	707	0	719
6898	694	9	0	9	0	712
6899	7	4	696	11	0	718
6900	641	0	7	9	0	657
6901	10	2	749	1	0	762
6902	8	3	741	2	0	754
6903	4	723	17	4	0	748
6904	3	8	15	645	0	671
6905	2	13	2	676	0	693
6906	4	675	2	18	0	699
6907	787	6	2	13	0	808
6908	10	14	0	763	0	787
6909	16	2	2	871	0	891
6910	7	0	3	903	0	913
6911	948	2	1	30	0	981
6912	986	0	3	24	0	1013
6913	39	2	1	975	0	1017
6914	28	2	1	968	0	999
6915	962	1	1	36	0	1000
6916	14	1	2	978	0	995
6917	21	3	0	977	0	1001
6918	4	1	0	1004	0	1009
6919	3	1	954	39	0	997
6920	909	0	12	30	0	951
6921	966	1	21	11	0	999
6922	38	4	935	4	0	981
6923	30	1	13	877	0	921
6924	7	938	22	16	0	983
6925	919	12	4	26	0	961
6926	16	950	5	11	0	982
6927	21	895	4	3	0	923
6928	5	28	1	815	0	849
6929	819	20	2	14	0	855
6930	816	3	2	24	0	845
6931	34	1	1	819	0	855
6932	26	3	2	810	0	841
6933	8	2	1	821	0	832
6934	2	3	4	826	0	835
6935	7	2	2	799	0	810
6936	3	765	1	38	0	807
6937	10	13	0	791	0	814
6938	788	19	0	22	0	829
6939	824	4	2	24	0	854
6940	840	0	1	11	0	852
6941	36	799	2	11	0	848
6942	24	11	4	817	0	856
6943	8	20	807	32	0	867
6944	788	6	16	31	0	841
6945	19	1	23	819	0	862
6946	844	5	3	20	0	872
6947	815	4	5	24	0	848
6948	835	1	2	11	0	849
6949	40	5	1	798	0	844
6950	822	2	1	20	0	845
6951	25	3	2	821	0	851
6952	26	3	4	816	0	849
6953	810	3	2	41	0	856
6954	20	0	4	832	0	856
6955	827	1	2	25	0	855
6956	824	5	1	31	0	861
6957	37	1	2	830	0	870
6958	32	3	0	842	0	877
6959	8	5	2	856	0	871
6960	11	3	786	43	0	843
6961	10	5	795	31	0	841
6962	7	1	34	767	0	809
6963	11	2	26	764	0	803
6964	10	2	6	796	0	814
6965	11	2	3	776	0	792
6966	11	5	1	786	0	803
6967	729	2	2	44	0	777
6968	16	725	9	31	0	781
6969	25	16	3	739	0	783
6970	747	19	2	19	0	787
6971	20	3	5	751	0	779
6972	27	2	1	735	0	765
6973	714	1	1	40	0	756
6974	709	2	0	33	0	744
6975	43	5	686	10	0	744
6976	29	4	12	697	0	742
6977	8	1	694	29	0	732
6978	13	1	16	703	0	733
6979	10	1	20	702	0	733
6980	11	1	5	705	0	722
6981	10	3	661	40	0	714
6982	6	619	16	34	0	675
6983	6	625	22	16	0	669
6984	5	27	4	627	0	663
6985	593	20	6	18	0	637
6986	13	4	588	30	0	635
6987	21	2	624	15	0	662
6988	12	1	29	595	0	637
6989	4	0	22	569	0	595
6990	3	612	4	33	0	652
6991	4	10	1	620	0	635
6992	6	18	3	625	0	652
6993	9	9	5	639	0	662
6994	618	3	2	38	0	661
6995	635	1	3	27	0	666
6996	30	1	1	647	0	679
6997	24	623	6	15	0	668
6998	6	8	3	661	0	678
6999	631	17	2	23	0	673
7000	11	638	6	28	0	683
7001	20	9	2	544	0	575
7002	9	564	2	12	0	587
7003	565	13	3	23	0	604
7004	536	16	2	15	0	569
7005	28	569	5	6	0	608
7006	22	555	3	6	0	586
7007	7	21	499	6	0	533
7008	2	498	9	7	0	516
7009	2	16	20	372	0	410
7010	2	13	384	3	0	402
7011	2	299	2	8	0	311
7012	0	1	8	284	0	293
7013	0	7	0	286	0	293
7014	1	0	0	290	0	291
7015	279	0	0	10	0	289
7016	2	1	280	7	0	290
7017	6	2	272	3	0	283
7018	0	1	7	269	0	277
7019	2	1	340	3	0	346
7020	2	0	1	363	0	366
7021	1	0	7	346	0	354
7022	2	0	0	370	0	372
7023	1	0	0	373	0	374
7024	360	0	2	8	0	370
7025	358	1	0	7	0	366
7026	7	0	1	365	0	373
7027	7	0	362	4	0	373
7028	1	1	1	358	0	361
7029	1	357	6	3	0	367
7030	1	1	1	363	0	366
7031	361	6	0	2	0	369
7032	379	1	0	7	0	387
7033	7	0	0	382	0	389
7034	8	0	0	380	0	388
7035	0	0	1	390	0	391
7036	377	0	1	8	0	386
7037	1	3	379	7	0	390
7038	5	0	369	1	0	375
7039	0	336	5	5	0	346
7040	347	1	4	0	0	352
7041	1	4	0	345	0	350
7042	5	0	350	1	0	356
7043	0	423	1	4	0	428
7044	0	432	4	1	0	437
7045	0	7	1	454	0	462
7046	1	4	0	500	0	505
7047	1	494	2	6	0	503
7048	0	2	0	511	0	513
7049	0	5	0	501	0	506
7050	516	0	1	6	0	523
7051	3	519	1	5	0	528
7052	5	3	0	517	0	525
7053	0	5	531	5	0	541
7054	2	1	3	529	0	535
7055	548	1	5	5	0	559
7056	3	545	0	7	0	555
7057	5	5	0	553	0	563
7058	3	7	543	3	0	556
7059	2	0	700	5	0	707
7060	2	0	8	722	0	732
7061	0	1	5	770	0	776
7062	774	0	2	12	0	788
7063	6	821	1	7	0	835
7064	825	6	0	4	0	835
7065	6	7	820	2	0	835
7066	819	1	6	1	0	827
7067	10	1	870	1	0	882
7068	858	0	7	3	0	868
7069	881	0	9	6	0	896
7070	18	2	991	2	0	1013
7071	12	2	993	1	0	1008
7072	0	981	23	4	0	1008
7073	2	10	10	1025	0	1047
7074	1067	10	2	11	0	1090
7075	11	3	1	1106	0	1121
7076	13	0	0	1141	0	1154
7077	0	1	0	1158	0	1159
7078	0	2	1136	22	0	1160
7079	1014	1	10	15	0	1040
7080	1117	0	11	4	0	1132
7081	22	1189	3	3	0	1217
7082	10	14	1	1169	0	1194
7083	3	1234	2	11	0	1250
7084	1	14	1	1254	0	1270
7085	1227	12	1	19	0	1259
7086	16	1237	2	12	0	1267
7087	14	14	0	1205	0	1233
7088	1197	11	0	16	0	1224
7089	1210	1	3	16	0	1230
7090	27	1	1	1205	0	1234
7091	14	3	1226	15	0	1258
7092	1	2	14	1215	0	1232
7093	5	1247	12	15	0	1279
7094	1238	17	3	14	0	1272
7095	15	1226	0	3	0	1244
7096	14	16	3	1220	0	1253
7097	1258	11	1	24	0	1294
7098	22	1	1	1318	0	1342
7099	16	1	2	1325	0	1344
7100	2	5	1307	30	0	1344
7101	1	1314	16	20	0	1351
7102	1271	16	12	4	0	1303
7103	1110	15	3	8	0	1136
7104	23	1290	5	5	0	1323
7105	17	1339	0	3	0	1359
7106	4	28	2	1316	0	1350
7107	1291	11	2	19	0	1323
7108	20	1277	5	15	0	1317
7109	19	16	1	1304	0	1340
7110	2	14	1315	19	0	1350
7111	6	1	18	1275	0	1300
7112	1284	3	11	18	0	1316
7113	19	1323	4	13	0	1359
7114	17	16	1	1368	0	1402
7115	1	13	1370	21	0	1405
7116	6	4	1371	17	0	1398
7117	9	3	30	1351	0	1393
7118	7	4	9	1370	0	1390
7119	3	1326	9	34	0	1372
7120	4	19	8	1347	0	1378
7121	1355	14	3	24	0	1396
7122	26	3	2	1373	0	1404
7123	1356	4	3	23	0	1386
7124	23	1343	2	19	0	1387
7125	15	1418	3	5	0	1441
7126	8	32	2	1427	0	1469
7127	4	11	3	1450	0	1468
7128	6	7	1424	37	0	1474
7129	6	5	21	1421	0	1453
7130	1424	9	13	28	0	1474
7131	27	3	1447	20	0	1497
7132	22	5	22	1431	0	1480
7133	8	11	1497	29	0	1545
7134	12	3	25	1500	0	1540
7135	7	2	18	1514	0	1541
7136	8	6	3	1541	0	1558
7137	5	12	1524	34	0	1575
7138	5	8	21	1487	0	1521
7139	8	1514	18	24	0	1564
7140	10	23	1	1544	0	1578
7141	9	17	2	1570	0	1598
7142	1536	7	1	44	0	1588
7143	22	9	1474	23	0	1528
7144	18	6	22	1475	0	1521
7145	7	9	1445	28	0	1489
7146	5	4	1400	30	0	1439
7147	12	5	36	1424	0	1477
7148	9	10	15	1411	0	1445
7149	10	6	2	1506	0	1524
7150	1468	3	4	40	0	1515
7151	21	9	1475	22	0	1527
7152	1431	2	23	14	0	1470
7153	22	9	16	1501	0	1548
7154	17	5	4	1525	0	1551
7155	5	1548	3	40	0	1596
7156	11	23	6	1556	0	1596
7157	7	14	5	1564	0	1590
7158	15	2	5	1580	0	1602
7159	1162	4	5	25	0	1196
7160	12	9	1154	15	0	1190
7161	983	2	13	13	0	1011
7162	12	1166	10	7	0	1195
7163	1122	12	4	6	0	1144
7164	11	1114	4	10	0	1139
7165	9	1122	4	8	0	1143
7166	3	16	6	1065	0	1090
7167	1081	6	1	14	0	1102
7168	12	4	3	1085	0	1104
7169	7	1056	5	16	0	1084
7170	2	1099	2	18	0	1121
7171	7	16	3	1105	0	1131
7172	5	8	4	1108	0	1125
7173	1	1119	4	26	0	1150
7174	2	13	6	1145	0	1166
7175	2	7	5	1132	0	1146
7176	3	2	2	1179	0	1186
7177	1118	1	1	25	0	1145
7178	12	4	1141	14	0	1171
7179	1063	2	12	5	0	1082
7180	1140	2	10	7	0	1159
7181	1102	0	1	3	0	1106
7182	15	1080	6	4	0	1105
7183	5	9	1	1109	0	1124
7184	1097	6	0	11	0	1114
7185	10	0	0	1130	0	1140
7186	1131	2	0	13	0	1146
7187	10	1205	2	8	0	1225
7188	1246	8	1	5	0	1260
7189	1246	4	2	4	0	1256
7190	1256	2	1	5	0	1264
7191	13	2	0	1224	0	1239
7192	8	1	1	1230	0	1240
7193	1228	2	0	16	0	1246
7194	9	1240	3	6	0	1258
7195	4	1250	2	5	0	1261
7196	1258	9	0	9	0	1276
7197	9	2	1	1254	0	1266
7198	6	0	0	1215	0	1221
7199	0	4	2	1238	0	1244
7200	2	1235	2	11	0	1250
7201	1249	9	0	10	0	1268
7202	8	4	0	1279	0	1291
7203	2	1319	3	9	0	1333
7204	2	7	0	1385	0	1394
7205	2	2	2	1352	0	1358
7206	3	3	0	1356	0	1362
7207	3	2	1	1357	0	1363
7208	1338	0	0	11	0	1349
7209	1347	0	1	3	0	1351
7210	1329	1	0	5	0	1335
7211	9	1	0	1340	0	1350
7212	5	2	1352	10	0	1369
7213	5	3	1253	5	0	1266
7214	3	3	1301	3	0	1310
7215	1337	3	9	4	0	1353
7216	5	1	2	1387	0	1395
7217	5	0	1	1381	0	1387
7218	3	0	1	1399	0	1403
7219	1362	2	0	11	0	1375
7220	1356	0	1	6	0	1363
7221	9	1477	1	1	0	1488
7222	3	4	0	1495	0	1502
7223	3	8	1458	6	0	1475
7224	1	1489	5	2	0	1497
7225	5	5	3	1469	0	1482
7226	2	3	1	1486	0	1492
7227	3	2	1	1466	0	1472
7228	5	1	1	1474	0	1481
7229	4	5	1446	7	0	1462
7230	7	5	1405	2	0	1419
7231	1	1448	9	2	0	1460
7232	2	6	3	1442	0	1453
7233	3	1	2	1436	0	1442
7234	1390	3	1	14	0	1408
7235	6	3	1450	6	0	1465
7236	2	1	4	1427	0	1434
7237	6	1	2	1481	0	1490
7238	4	4	1475	8	0	1491
7239	1	1484	7	5	0	1497
7240	1484	6	2	7	0	1499
7241	4	5	1480	4	0	1493
7242	1369	1	4	6	0	1380
7243	6	4	1644	4	0	1658
7244	5	3	7	1634	0	1649
7245	7	3	1672	6	0	1688
7246	4	3	1817	5	0	1829
7247	2	3	8	1792	0	1805
7248	2	5	9	1629	0	1645
7249	5	1	0	1954	0	1960
7250	3	0	1	1935	0	1939
7251	0	0	1	1916	0	1917
7252	3	7	1897	11	0	1918
7253	6	8	1815	8	0	1837
7254	3	1885	12	3	0	1903
7255	1856	4	6	7	0	1873
7256	5	4	3	1924	0	1936
7257	1937	1	3	12	0	1953
7258	9	0	2	1929	0	1940
7259	2082	1	0	20	0	2103
7260	10	0	0	2120	0	2130
7261	7	0	2	2117	0	2126
7262	3	2153	6	14	0	2176
7263	3	8	1	2206	0	2218
7264	6	12	0	2204	0	2222
7265	0	4	1	2200	0	2205
7266	4	0	2	2204	0	2210
7267	0	2150	6	27	0	2183
7268	2146	8	1	11	0	2166
7269	7	2157	3	5	0	2172
7270	9	6	1	2128	0	2144
7271	2103	5	0	12	0	2120
7272	7	6	2071	8	0	2092
7273	6	7	2070	3	0	2086
7274	4	1	19	1989	0	2013
7275	2	1	6	2122	0	2131
7276	4	2	3	2072	0	2081
7277	6	1	1	1998	0	2006
7278	2	0	0	2060	0	2062
7279	1	2043	3	13	0	2060
7280	4	5	0	2080	0	2089
7281	2068	6	1	14	0	2089
7282	6	1	1	2090	0	2098
7283	10	7	2095	7	0	2119
7284	5	0	8	2075	0	2088
7285	2063	0	12	16	0	2091
7286	8	2255	4	15	0	2282
7287	14	7	2	2408	0	2431
7288	8	15	1	2511	0	2535
7289	2	9	2502	47	0	2560
7290	2	2	3385	32	0	3421
7291	3857	0	79	10	0	3946
7292	92	1	51	4050	0	4194
7293	74	0	10	4172	0	4256
7294	20	8	4318	164	0	4510
7295	10	12	4307	86	0	4415
7296	2	4321	177	25	0	4525
7297	10	107	85	4194	0	4396
7298	6	81	4289	107	0	4483
7299	3	4354	123	79	0	4559
7300	4374	111	78	23	0	4586
7301	4432	75	24	9	0	4540
7302	185	20	7	4204	0	4416
7303	94	4313	16	108	0	4531
7304	4274	112	7	88	0	4481
7305	143	90	21	3460	0	3714
7306	84	26	4265	86	0	4461
7307	21	4299	115	55	0	4490
7308	4257	108	79	24	0	4468
7309	4366	79	20	11	0	4476
7310	190	21	8	4339	0	4558
7311	95	7	4	4432	0	4538
7312	31	9	4239	188	0	4467
7313	12	10	113	4319	0	4454
7314	14	10	76	4203	0	4303
7315	18	4	21	4340	0	4383
7316	16	4	13	4370	0	4403
7317	13	5	12	4237	0	4267
7318	11	4156	19	200	0	4386
7319	4082	106	8	112	0	4308
7320	115	86	4136	47	0	4384
7321	78	4030	116	26	0	4250
7322	28	115	80	4081	0	4304
7323	4085	79	25	124	0	4313
7324	117	20	19	4153	0	4309
7325	92	11	9	4162	0	4274
7326	24	5	12	4250	0	4291
7327	19	10	11	4232	0	4272
7328	24	14	4019	221	0	4278
7329	16	4052	124	129	0	4321
7330	4038	118	78	57	0	4291
7331	121	88	4049	44	0	4302
7332	92	27	133	4049	0	4301
7333	4032	20	94	134	0	4280
7334	127	4032	40	102	0	4301
7335	4142	125	19	43	0	4329
7336	150	101	9	3921	0	4181
7337	118	30	10	4237	0	4395
7338	45	14	12	4320	0	4391
7339	21	8	13	4327	0	4369
7340	4068	22	14	231	0	4335
7341	138	12	13	4190	0	4353
7342	101	7	12	4249	0	4369
7343	3903	13	18	225	0	4159
7344	128	28	3839	128	0	4123
7345	109	10	120	3877	0	4116
7346	3674	13	95	146	0	3928
7347	3709	17	30	112	0	3868
7348	213	12	11	3557	0	3793
7349	117	11	16	3592	0	3736
7350	42	3459	22	219	0	3742
7351	25	116	14	3609	0	3764
7352	27	90	8	3670	0	3795
7353	25	28	3470	235	0	3758
7354	20	24	3510	141	0	3695
7355	14	3417	206	66	0	3703
7356	24	119	101	3389	0	3633
7357	28	87	38	3512	0	3665
7358	3418	30	27	209	0	3684
7359	134	16	25	3361	0	3536
7360	101	26	3246	171	0	3544
7361	43	14	123	3370	0	3550
7362	22	24	3266	171	0	3483
7363	21	24	3286	124	0	3455
7364	29	19	198	3160	0	3406
7365	25	13	111	3334	0	3483
7366	3233	20	38	225	0	3516
7367	3335	22	24	125	0	3506
7368	216	21	19	3264	0	3520
7369	3390	12	16	154	0	3572
7370	3486	10	15	133	0	3644
7371	210	22	13	3405	0	3650
7372	138	10	17	3485	0	3650
7373	3361	12	14	239	0	3626
7374	3462	8	14	146	0	3630
7375	215	16	12	3372	0	3615
7376	121	3331	22	164	0	3638
7377	56	115	15	3447	0	3633
7378	28	86	15	3533	0	3662
7379	28	31	3322	255	0	3636
7380	31	13	125	3459	0	3628
7381	3257	9	98	181	0	3545
7382	126	3297	37	142	0	3602
7383	3311	115	15	66	0	3507
7384	3337	79	6	54	0	3476
7385	3353	21	15	53	0	3442
7386	219	17	10	3095	0	3341
7387	119	22	2756	130	0	3027
7388	41	16	2733	87	0	2877
7389	21	2667	155	48	0	2891
7390	15	1707	46	24	0	1792
7391	10	1202	11	11	0	1234
7392	17	1106	5	9	0	1137
7393	7	40	1061	10	0	1118
7394	736	19	25	5	0	785
7395	31	1	12	790	0	834
7396	7	0	5	786	0	798
7397	4	1	2	783	0	790
7398	3	787	4	23	0	817
7399	788	11	1	14	0	814
7400	18	10	783	3	0	814
7401	13	771	12	6	0	802
7402	3	13	10	782	0	808
7403	787	9	1	16	0	813
7404	13	0	3	795	0	811
7405	11	2	785	17	0	815
7406	3	0	772	15	0	790
7407	6	0	21	749	0	776
7408	4	1	11	760	0	776
7409	748	2	0	26	0	776
7410	11	1	759	17	0	788
7411	750	0	12	3	0	765
7412	769	0	10	3	0	782
7413	20	1	1	795	0	817
7414	14	3	849	15	0	881
7415	5	3	11	850	0	869
7416	852	1	10	12	0	875
7417	14	851	1	14	0	880
7418	870	13	1	3	0	887
7419	13	9	1	844	0	867
7420	10	869	6	14	0	899
7421	0	14	5	879	0	898
7422	0	14	1	899	0	914
7423	5	945	2	26	0	978
7424	2	18	2	970	0	992
7425	8	14	4	983	0	1009
7426	6	2	3	1020	0	1031
7427	7	4	978	32	0	1021
7428	6	978	15	24	0	1023
7429	970	12	17	4	0	1003
7430	16	11	5	958	0	990
7431	14	1051	2	21	0	1088
7432	1106	24	5	16	0	1151
7433	29	18	2	1111	0	1160
7434	24	5	0	1124	0	1153
7435	7	1	2	1073	0	1083
7436	12	1	2	991	0	1006
7437	958	1	2	47	0	1008
7438	31	2	3	983	0	1019
7439	18	4	2	989	0	1013
7440	964	3	4	49	0	1020
7441	31	2	1	982	0	1016
7442	19	9	952	34	0	1014
7443	5	6	29	982	0	1022
7444	963	1	17	34	0	1015
7445	31	2	1	989	0	1023
7446	16	3	981	35	0	1035
7447	4	2	1014	24	0	1044
7448	1020	2	42	12	0	1076
7449	1066	3	20	5	0	1094
7450	1125	1	3	11	0	1140
7451	1139	3	1	6	0	1149
7452	48	5	1112	8	0	1173
7453	24	2	30	1081	0	1137
7454	8	3	19	1134	0	1164
7455	1112	0	6	49	0	1167
7456	31	1	2	1147	0	1181
7457	18	3	1128	34	0	1183
7458	2	2	28	1139	0	1171
7459	4	13	1142	35	0	1194
7460	6	1127	29	27	0	1189
7461	1189	28	16	9	0	1242
7462	34	20	1	1194	0	1249
7463	25	14	1164	32	0	1235
7464	4	5	30	1180	0	1219
7465	2	2	25	1209	0	1238
7466	4	2	1196	54	0	1256
7467	5	3	28	1216	0	1252
7468	1194	2	28	36	0	1260
7469	30	4	1101	36	0	1171
7470	1061	0	27	8	0	1096
7471	29	1042	28	13	0	1112
7472	31	24	1037	5	0	1097
7473	6	25	1032	27	0	1090
7474	10	27	54	875	0	966
7475	6	2	25	1013	0	1046
7476	5	3	1049	51	0	1108
7477	7	3	29	1058	0	1097
7478	1069	2	23	34	0	1128
7479	1095	0	6	29	0	1130
7480	48	1	5	1032	0	1086
7481	30	2	5	1045	0	1082
7482	4	1069	6	50	0	1129
7483	1055	29	4	26	0	1114
7484	34	20	4	1064	0	1122
7485	26	1116	7	36	0	1185
7486	1126	28	4	36	0	1194
7487	1175	24	5	12	0	1216
7488	57	1163	3	17	0	1240
7489	29	29	9	1163	0	1230
7490	7	25	4	1208	0	1244
7491	8	5	1154	63	0	1230
7492	11	3	33	1166	0	1213
7493	1140	5	29	45	0	1219
7494	41	3	9	1174	0	1227
7495	33	6	1132	43	0	1214
7496	1121	2	39	35	0	1197
7497	38	5	29	1119	0	1191
7498	35	5	1107	40	0	1187
7499	10	2	36	1139	0	1187
7500	10	4	1132	45	0	1191
7501	13	3	38	1117	0	1171
7502	11	2	32	1143	0	1188
7503	1108	0	9	71	0	1188
7504	35	1100	16	39	0	1190
7505	1137	31	6	15	0	1189
7506	1105	24	12	12	0	1153
7507	1137	4	9	20	0	1170
7508	61	1092	10	12	0	1175
7509	36	33	1069	15	0	1153
7510	10	27	41	1078	0	1156
7511	1104	5	30	45	0	1184
7512	1127	0	4	46	0	1177
7513	63	3	17	1047	0	1130
7514	1044	5	9	46	0	1104
7515	51	10	994	35	0	1090
7516	1008	1	39	11	0	1059
7517	43	4	1010	19	0	1076
7518	34	1006	42	13	0	1095
7519	1011	34	31	17	0	1093
7520	1003	26	9	20	0	1058
7521	56	992	16	17	0	1081
7522	1000	32	6	19	0	1057
7523	988	23	14	4	0	1029
7524	55	6	922	20	0	1003
7525	897	6	31	11	0	945
7526	37	3	901	10	0	951
7527	24	6	27	834	0	891
7528	12	863	29	28	0	932
7529	11	31	855	29	0	926
7530	759	43	56	18	0	876
7531	713	20	41	6	0	780
7532	35	3	4	661	0	703
7533	28	5	683	13	0	729
7534	9	1	16	693	0	719
7535	683	3	22	18	0	726
7536	17	683	4	23	0	727
7537	698	14	5	8	0	725
7538	681	16	6	5	0	708
7539	33	668	8	6	0	715
7540	25	12	3	669	0	709
7541	676	22	0	18	0	716
7542	23	1	4	689	0	717
7543	22	2	3	707	0	734
7544	8	4	696	29	0	737
7545	6	4	18	706	0	734
7546	10	3	21	703	0	737
7547	676	1	5	31	0	713
7548	636	1	1	20	0	658
7549	36	3	3	635	0	677
7550	25	1	628	16	0	670
7551	6	4	632	22	0	664
7552	9	1	29	597	0	636
7553	7	3	633	18	0	661
7554	5	0	17	597	0	619
7555	6	2	16	591	0	615
7556	580	1	4	29	0	614
7557	17	2	560	20	0	599
7558	564	4	12	6	0	586
7559	567	3	17	6	0	593
7560	32	1	535	6	0	574
7561	17	3	492	5	0	517
7562	4	18	24	455	0	501
7563	6	462	13	11	0	492
7564	5	484	5	12	0	506
7565	38	17	11	413	0	479
7566	6	7	2	398	0	413
7567	4	1	2	415	0	422
7568	7	0	4	416	0	427
7569	401	0	2	16	0	419
7570	15	1	3	403	0	422
7571	10	3	396	7	0	416
7572	3	0	10	379	0	392
7573	4	376	11	8	0	399
7574	5	8	5	382	0	400
7575	373	7	2	12	0	394
7576	9	0	2	362	0	373
7577	7	3	353	11	0	374
7578	3	338	11	10	0	362
7579	5	6	9	346	0	366
7580	344	7	4	11	0	366
7581	355	1	0	8	0	364
7582	17	0	4	313	0	334
7583	9	2	310	8	0	329
7584	5	2	302	6	0	315
7585	274	1	9	3	0	287
7586	7	2	281	2	0	292
7587	4	1	220	3	0	228
7588	0	0	3	180	0	183
7589	192	1	4	0	0	197
7590	187	1	3	4	0	195
7591	186	0	0	2	0	188
7592	6	1	205	0	0	212
7593	4	0	202	1	0	207
7594	1	234	3	1	0	239
7595	0	0	6	237	0	243
7596	1	3	2	239	0	245
7597	1	1	1	233	0	236
7598	0	0	2	245	0	247
7599	0	0	238	5	0	243
7600	1	239	0	5	0	245
7601	271	0	2	1	0	274
7602	313	3	1	1	0	318
7603	330	1	0	0	0	331
7604	7	321	3	1	0	332
7605	6	2	1	333	0	342
7606	365	6	0	2	0	373
7607	1	375	0	7	0	383
7608	377	1	0	4	0	382
7609	1	362	1	2	0	366
7610	358	2	2	1	0	363
7611	344	8	1	3	0	356
7612	8	2	1	340	0	351
7613	9	0	0	369	0	378
7614	3	2	351	8	0	364
7615	2	4	378	7	0	391
7616	386	1	9	4	0	400
7617	395	1	7	2	0	405
7618	9	1	1	378	0	389
7619	8	1	1	382	0	392
7620	2	1	381	8	0	392
7621	2	1	2	374	0	379
7622	3	2	367	3	0	375
7623	1	1	2	374	0	378
7624	1	0	6	379	0	386
7625	369	0	2	11	0	382
7626	368	0	2	8	0	378
7627	9	0	1	383	0	393
7628	10	2	0	384	0	396
7629	2	4	400	10	0	416
7630	1	0	4	425	0	430
7631	0	2	428	5	0	435
7632	407	1	5	8	0	421
7633	3	1	8	407	0	419
7634	402	0	4	2	0	408
7635	5	404	0	10	0	419
7636	403	2	1	6	0	412
7637	6	8	0	398	0	412
7638	10	3	2	392	0	407
7639	4	392	2	12	0	410
7640	3	2	1	408	0	414
7641	2	8	398	8	0	416
7642	1	2	3	414	0	420
7643	2	1	387	5	0	395
7644	2	379	8	6	0	395
7645	1	2	5	383	0	391
7646	2	6	385	3	0	396
7647	1	4	373	7	0	385
7648	2	8	7	377	0	394
7649	373	0	7	3	0	383
7650	4	2	376	5	0	387
7651	6	0	2	371	0	379
7652	394	3	5	3	0	405
7653	3	366	5	7	0	381
7654	396	2	0	6	0	404
7655	5	8	1	388	0	402
7656	10	3	0	413	0	426
7657	6	2	0	420	0	428
7658	419	0	0	11	0	430
7659	4	2	0	422	0	428
7660	8	0	0	422	0	430
7661	416	0	0	12	0	428
7662	2	1	413	10	0	426
7663	6	1	4	414	0	425
7664	8	2	414	2	0	426
7665	400	0	6	9	0	415
7666	2	0	6	416	0	424
7667	7	1	419	4	0	431
7668	396	1	3	6	0	406
7669	402	0	6	8	0	416
7670	9	0	439	0	0	448
7671	11	0	3	426	0	440
7672	5	0	6	436	0	447
7673	4	0	453	10	0	467
7674	4	436	3	10	0	453
7675	2	3	445	5	0	455
7676	445	6	6	1	0	458
7677	2	5	494	1	0	502
7678	469	0	5	3	0	477
7679	7	0	501	3	0	511
7680	480	1	5	3	0	489
7681	4	570	8	4	0	586
7682	10	2	4	576	0	592
7683	5	9	0	585	0	599
7684	4	4	567	9	0	584
7685	3	0	3	543	0	549
7686	3	554	9	8	0	574
7687	557	4	1	8	0	570
7688	1	588	2	4	0	595
7689	8	4	2	584	0	598
7690	590	5	1	7	0	603
7691	2	595	3	20	0	620
7692	587	5	0	3	0	595
7693	6	5	583	3	0	597
7694	6	3	5	563	0	577
7695	2	0	7	564	0	573
7696	3	0	2	576	0	581
7697	589	1	1	11	0	602
7698	580	1	2	8	0	591
7699	598	0	2	4	0	604
7700	606	0	0	2	0	608
7701	10	7	594	2	0	613
7702	483	0	0	4	0	487
7703	3	500	6	0	0	509
7704	7	502	4	0	0	513
7705	548	5	13	3	0	569
7706	567	3	0	4	0	574
7707	5	3	1	555	0	564
7708	584	0	0	4	0	588
7709	573	1	0	4	0	578
7710	603	0	0	2	0	605
7711	12	0	0	638	0	650
7712	8	658	2	6	0	674
7713	2	682	0	6	0	690
7714	3	15	0	675	0	693
7715	665	9	0	11	0	685
7716	9	678	1	8	0	696
7717	7	11	1	678	0	697
7718	2	7	683	8	0	700
7719	605	3	10	8	0	626
7720	10	672	9	3	0	694
7721	8	688	2	0	0	698
7722	684	17	0	1	0	702
7723	11	10	692	2	0	715
7724	7	2	10	690	0	709
7725	5	709	7	10	0	731
7726	0	11	2	732	0	745
7727	0	7	1	709	0	717
7728	2	672	0	15	0	689
7729	5	10	1	695	0	711
7730	1	5	1	695	0	702
7731	680	2	0	18	0	700
7732	9	683	0	7	0	699
7733	678	12	0	0	0	690
7734	10	6	0	674	0	690
7735	5	679	0	11	0	695
7736	0	12	687	6	0	705
7737	1	5	8	706	0	720
7738	0	3	7	724	0	734
7739	5	0	749	18	0	772
7740	699	2	12	9	0	722
7741	14	4	5	780	0	803
7742	770	1	2	12	0	785
7743	13	1	763	7	0	784
7744	6	1	14	761	0	782
7745	1	8	790	16	0	815
7746	2	2	12	782	0	798
7747	1	1	6	829	0	837
7748	814	3	0	18	0	835
7749	16	820	3	8	0	847
7750	814	15	2	5	0	836
7751	22	9	847	2	0	880
7752	6	2	16	831	0	855
7753	4	3	863	15	0	885
7754	742	4	14	7	0	767
7755	855	3	5	6	0	869
7756	21	4	846	4	0	875
7757	817	4	14	8	0	843
7758	858	2	8	6	0	874
7759	24	1	2	851	0	878
7760	11	5	836	18	0	870
7761	3	4	885	14	0	906
7762	4	4	23	878	0	909
7763	6	2	8	863	0	879
7764	3	873	3	25	0	904
7765	4	912	5	10	0	931
7766	886	25	1	9	0	921
7767	22	7	1	887	0	917
7768	10	865	3	19	0	897
7769	6	909	2	8	0	925
7770	839	22	3	7	0	871
7771	21	7	4	872	0	904
7772	12	868	6	18	0	904
7773	4	20	3	868	0	895
7774	9	7	5	873	0	894
7775	7	4	3	882	0	896
7776	837	2	4	26	0	869
7777	19	852	8	9	0	888
7778	11	21	1	866	0	899
7779	6	8	2	875	0	891
7780	0	2	8	878	0	888
7781	6	3	764	26	0	799
7782	716	4	20	15	0	755
7783	20	3	7	777	0	807
7784	780	5	3	18	0	806
7785	786	7	3	11	0	807
7786	792	1	3	6	0	802
7787	25	4	766	7	0	802
7788	12	733	21	10	0	776
7789	4	19	13	724	0	760
7790	8	12	733	20	0	773
7791	3	4	721	13	0	741
7792	5	2	23	684	0	714
7793	2	714	10	16	0	742
7794	716	14	3	13	0	746
7795	727	7	4	5	0	743
7796	786	1	3	6	0	796
7797	761	5	4	7	0	777
7798	26	6	767	6	0	805
7799	733	1	17	9	0	760
7800	18	747	12	7	0	784
7801	11	18	7	720	0	756
7802	4	7	4	741	0	756
7803	732	0	2	29	0	763
7804	21	1	4	732	0	758
7805	12	3	692	16	0	723
7806	665	2	18	6	0	691
7807	688	3	9	4	0	704
7808	677	2	5	5	0	689
7809	22	4	662	6	0	694
7810	564	2	12	4	0	582
7811	10	594	13	3	0	620
7812	578	9	30	3	0	620
7813	10	3	1	574	0	588
7814	7	3	1	578	0	589
7815	4	570	0	12	0	586
7816	7	37	2	557	0	603
7817	2	602	3	9	0	616
7818	5	8	1	579	0	593
7819	0	558	4	9	0	571
7820	3	9	1	559	0	572
7821	1	565	3	11	0	580
7822	5	8	0	585	0	598
7823	2	558	2	11	0	573
7824	574	9	2	8	0	593
7825	14	6	0	610	0	630
7826	12	1	1	612	0	626
7827	4	1	3	674	0	682
7828	5	3	2	678	0	688
7829	2	3	702	26	0	733
7830	2	3	12	703	0	720
7831	5	0	9	722	0	736
7832	703	1	4	22	0	730
7833	703	3	2	13	0	721
7834	21	732	3	5	0	761
7835	13	12	0	786	0	811
7836	5	12	1	828	0	846
7837	819	2	1	26	0	848
7838	18	1	800	14	0	833
7839	773	1	9	2	0	785
7840	15	805	18	1	0	839
7841	798	11	2	1	0	812
7842	786	13	1	4	0	804
7843	25	778	1	3	0	807
7844	14	826	2	3	0	845
7845	2	23	2	791	0	818
7846	1	15	790	13	0	819
7847	749	2	14	15	0	780
7848	12	2	795	3	0	812
7849	763	1	13	4	0	781
7850	15	3	815	0	0	833
7851	13	771	13	1	0	798
7852	5	10	11	790	0	816
7853	767	14	1	16	0	798
7854	772	2	2	16	0	792
7855	25	0	0	773	0	798
7856	782	1	1	13	0	797
7857	775	2	1	15	0	793
7858	25	763	2	4	0	794
7859	766	13	0	4	0	783
7860	14	801	3	1	0	819
7861	14	13	0	765	0	792
7862	761	14	1	13	0	789
7863	774	1	1	16	0	792
7864	761	1	2	7	0	771
7865	24	3	747	2	0	776
7866	15	2	801	0	0	818
7867	6	1	27	784	0	818
7868	1	4	14	864	0	883
7869	5	933	1	30	0	969
7870	930	17	0	17	0	964
7871	19	21	0	929	0	969
7872	25	3	1	951	0	980
7873	5	3	959	43	0	1010
7874	5	931	20	23	0	979
7875	7	981	21	3	0	1012
7876	5	37	7	969	0	1018
7877	934	24	2	20	0	980
7878	22	5	2	959	0	988
7879	24	5	0	951	0	980
7880	947	1	0	38	0	986
7881	947	2	2	23	0	974
7882	40	2	2	939	0	983
7883	22	4	932	24	0	982
7884	7	2	20	954	0	983
7885	7	2	21	955	0	985
7886	938	4	4	41	0	987
7887	24	2	3	999	0	1028
7888	995	3	2	25	0	1025
7889	18	6	972	27	0	1023
7890	32	3	17	996	0	1048
7891	10	3	23	1035	0	1071
7892	8	2	3	1053	0	1066
7893	3	1	6	1064	0	1074
7894	6	1	4	1061	0	1072
7895	3	6	1019	48	0	1076
7896	959	2	19	30	0	1010
7897	22	5	21	978	0	1026
7898	33	4	942	21	0	1000
7899	6	1	965	29	0	1001
7900	5	2	42	958	0	1007
7901	956	4	27	23	0	1010
7902	951	4	5	28	0	988
7903	996	3	6	5	0	1010
7904	49	3	5	891	0	948
7905	34	930	8	25	0	997
7906	955	22	3	29	0	1009
7907	972	29	3	7	0	1011
7908	998	8	3	8	0	1017
7909	978	4	2	13	0	997
7910	46	2	5	954	0	1007
7911	30	4	929	30	0	993
7912	9	4	24	942	0	979
7913	11	5	944	25	0	985
7914	921	2	23	32	0	978
7915	952	8	27	12	0	999
7916	40	1	919	13	0	973
7917	923	1	22	13	0	959
7918	943	1	21	17	0	982
7919	48	1	2	904	0	955
7920	30	938	6	27	0	1001
7921	953	16	4	30	0	1003
7922	24	22	8	898	0	952
7923	29	920	9	25	0	983
7924	11	26	3	929	0	969
7925	12	21	868	28	0	929
7926	9	877	20	29	0	935
7927	831	14	20	7	0	872
7928	841	15	5	13	0	874
7929	799	1	8	8	0	816
7930	785	1	3	12	0	801
7931	36	2	2	744	0	784
7932	21	754	4	24	0	803
7933	723	14	4	23	0	764
7934	27	21	731	5	0	784
7935	23	665	14	10	0	712
7936	9	10	657	8	0	684
7937	8	14	16	616	0	654
7938	5	576	17	14	0	612
7939	9	9	6	635	0	659
7940	10	13	632	15	0	670
7941	11	1	12	622	0	646
7942	11	1	17	633	0	662
7943	10	2	3	667	0	682
7944	611	4	4	27	0	646
7945	20	599	5	22	0	646
7946	19	11	6	581	0	617
7947	572	14	1	20	0	607
7948	20	578	2	18	0	618
7949	593	12	3	5	0	613
7950	16	15	574	11	0	616
7951	20	1	16	548	0	585
7952	5	563	23	18	0	609
7953	561	13	2	17	0	593
7954	22	14	568	8	0	612
7955	18	553	14	10	0	595
7956	9	10	15	552	0	586
7957	8	10	4	566	0	588
7958	548	3	7	19	0	577
7959	17	7	2	560	0	586
7960	18	2	519	16	0	555
7961	10	4	10	539	0	563
7962	8	5	548	13	0	574
7963	6	3	11	500	0	520
7964	5	530	16	14	0	565
7965	516	11	1	17	0	545
7966	481	11	5	4	0	501
7967	19	487	4	7	0	517
7968	12	398	5	4	0	419
7969	4	8	1	359	0	372
7970	381	3	1	6	0	391
7971	8	1	2	379	0	390
7972	373	3	0	4	0	380
7973	6	385	3	6	0	400
7974	9	4	2	378	0	393
7975	4	7	415	6	0	432
7976	2	4	9	408	0	423
7977	4	2	9	426	0	441
7978	440	3	3	14	0	460
7979	7	444	3	8	0	462
7980	8	8	1	445	0	462
7981	443	7	2	7	0	459
7982	8	4	441	11	0	464
7983	426	4	7	6	0	443
7984	9	18	6	430	0	463
7985	9	457	3	12	0	481
7986	447	9	4	8	0	468
7987	10	4	428	2	0	444
7988	5	1	423	1	0	430
7989	1	425	12	2	0	440
7990	393	5	22	1	0	421
7991	4	2	0	425	0	431
7992	2	0	0	430	0	432
7993	424	0	0	6	0	430
7994	4	1	426	3	0	434
7995	3	0	4	420	0	427
7996	1	2	443	4	0	450
7997	0	0	5	437	0	442
7998	0	426	3	16	0	445
7999	0	4	1	447	0	452
8000	2	3	444	5	0	454
8001	421	1	5	4	0	431
8002	4	0	3	456	0	463
8003	4	1	484	3	0	492
8004	0	0	4	470	0	474
8005	2	0	4	457	0	463
8006	0	1	434	8	0	443
8007	1	1	427	5	0	434
8008	0	0	9	432	0	441
8009	0	0	440	6	0	446
8010	404	0	6	5	0	415
8011	5	0	3	438	0	446
8012	428	1	1	4	0	434
8013	8	0	438	5	0	451
8014	5	0	4	426	0	435
8015	1	2	506	4	0	513
8016	1	522	4	4	0	531
8017	1	4	523	0	0	528
8018	0	5	518	0	0	523
8019	489	1	8	0	0	498
8020	505	0	5	1	0	511
8021	10	1	511	0	0	522
8022	5	2	5	473	0	485
8023	3	1	4	526	0	534
8024	1	2	556	10	0	569
8025	0	537	7	8	0	552
8026	532	6	8	3	0	549
8027	7	8	543	0	0	558
8028	9	1	6	585	0	601
8029	2	1	8	624	0	635
8030	622	0	1	16	0	639
8031	636	2	0	12	0	650
8032	648	0	1	6	0	655
8033	650	1	2	0	0	653
8034	16	1	2	622	0	641
8035	9	2	650	7	0	668
8036	3	1	7	638	0	649
8037	1	0	7	663	0	671
8038	1	0	4	686	0	691
8039	2	5	662	20	0	689
8040	626	0	11	12	0	649
8041	11	1	9	672	0	693
8042	10	1	709	9	0	729
8043	3	751	11	9	0	774
8044	0	11	9	767	0	787
8045	4	9	2	795	0	810
8046	778	2	2	22	0	804
8047	12	790	2	13	0	817
8048	11	15	795	2	0	823
8049	6	12	12	780	0	810
8050	3	2	12	808	0	825
8051	791	1	4	25	0	821
8052	804	0	1	13	0	818
8053	25	0	1	819	0	845
8054	812	1	1	18	0	832
8055	13	793	2	14	0	822
8056	13	12	888	3	0	916
8057	5	10	14	893	0	922
8058	5	4	10	915	0	934
8059	3	0	5	924	0	932
8060	1	3	1	914	0	919
8061	1	879	4	27	0	911
8062	914	11	2	15	0	942
8063	15	10	0	923	0	948
8064	13	980	3	14	0	1010
8065	1000	12	3	12	0	1027
8066	1003	10	0	7	0	1020
8067	24	1071	0	5	0	1100
8068	18	12	1	1103	0	1134
8069	5	12	1	1118	0	1136
8070	4	3	0	1102	0	1109
8071	3	0	1	1107	0	1111
8072	1086	3	1	29	0	1119
8073	1109	1	4	16	0	1130
8074	32	1138	1	6	0	1177
8075	18	17	1090	4	0	1129
8076	6	14	17	1076	0	1113
8077	1103	5	15	16	0	1139
8078	15	1071	7	16	0	1109
8079	17	1090	3	4	0	1114
8080	1118	30	0	3	0	1151
8081	1125	20	1	2	0	1148
8082	31	4	2	1105	0	1142
8083	20	2	1137	16	0	1175
8084	5	2	1156	19	0	1182
8085	1158	0	30	6	0	1194
8086	1253	1	19	5	0	1278
8087	1251	1	4	5	0	1261
8088	1236	0	0	6	0	1242
8089	1288	3	0	2	0	1293
8090	35	1234	2	3	0	1274
8091	22	20	1	1163	0	1206
8092	3	1256	3	12	0	1274
8093	1242	17	1	20	0	1280
8094	1220	16	0	7	0	1243
8095	1254	4	0	3	0	1261
8096	1252	3	4	3	0	1262
8097	33	1224	5	5	0	1267
8098	1278	15	1	8	0	1302
8099	21	1275	2	4	0	1302
8100	19	24	4	1254	0	1301
8101	1258	13	2	20	0	1293
8102	22	8	1247	16	0	1293
8103	15	3	15	1218	0	1251
8104	7	3	15	1259	0	1284
8105	4	3	1267	30	0	1304
8106	5	1268	16	19	0	1308
8107	1270	16	13	8	0	1307
8108	1270	16	4	4	0	1294
8109	29	1262	9	1	0	1301
8110	19	16	0	1261	0	1296
8111	9	17	1313	16	0	1355
8112	3	1402	16	16	0	1437
8113	1374	20	13	6	0	1413
8114	21	16	1417	1	0	1455
8115	1211	2	16	2	0	1231
8116	1319	4	13	4	0	1340
8117	32	5	1449	6	0	1492
8118	19	1440	19	4	0	1482
8119	10	15	14	1452	0	1491
8120	7	17	1502	19	0	1545
8121	1355	3	16	19	0	1393
8122	1487	3	14	4	0	1508
8123	30	1497	6	2	0	1535
8124	12	18	1	1507	0	1538
8125	7	11	1	1539	0	1558
8126	7	6	1522	23	0	1558
8127	2	1523	17	15	0	1557
8128	1531	15	12	7	0	1565
8129	1515	11	3	2	0	1531
8130	1537	2	1	4	0	1544
8131	25	8	1513	1	0	1547
8132	1458	1	16	4	0	1479
8133	1527	2	11	4	0	1544
8134	27	1	2	1520	0	1550
8135	18	2	1508	16	0	1544
8136	2	1	17	1497	0	1517
8137	6	7	1535	16	0	1564
8138	3	0	12	1476	0	1491
8139	4	1521	10	9	0	1544
8140	4	1595	6	9	0	1614
8141	7	20	1	1594	0	1622
8142	3	12	1	1547	0	1563
8143	1475	3	0	23	0	1501
8144	12	8	1480	16	0	1516
8145	1371	1	12	7	0	1391
8146	15	1498	12	0	0	1525
8147	1499	11	2	1	0	1513
8148	1510	9	1	1	0	1521
8149	24	2	0	1490	0	1516
8150	15	2	1521	15	0	1553
8151	2	3	14	1526	0	1545
8152	3	1623	9	17	0	1652
8153	6	14	1	1607	0	1628
8154	3	14	2	1616	0	1635
8155	1602	2	1	26	0	1631
8156	19	1	2	1510	0	1532
8157	9	1517	5	20	0	1551
8158	5	15	0	1555	0	1575
8159	1546	8	3	18	0	1575
8160	18	1582	4	15	0	1619
8161	12	18	3	1629	0	1662
8162	4	9	3	1596	0	1612
8163	4	6	2	1782	0	1794
8164	3	2	1	1741	0	1747
8165	1682	0	4	42	0	1728
8166	24	2	3	1719	0	1748
8167	17	1	1	1757	0	1776
8168	4	3	2	1739	0	1748
8169	1	1806	3	47	0	1857
8170	1784	29	1	23	0	1837
8171	32	20	1829	3	0	1884
8172	19	1838	32	3	0	1892
8173	1754	24	34	3	0	1815
8174	24	17	1786	21	0	1848
8175	15	1800	25	2	0	1842
8176	7	22	15	1747	0	1791
8177	0	1862	7	20	0	1889
8178	2	27	1878	15	0	1922
8179	1	18	1911	4	0	1934
8180	0	1869	46	1	0	1916
8181	1890	23	15	2	0	1930
8182	1883	14	4	2	0	1903
8183	35	9	1838	1	0	1883
8184	19	7	1727	0	0	1753
8185	3	2	1860	3	0	1868
8186	4	2	40	1790	0	1836
8187	1	2	16	1846	0	1865
8188	3	2	2	1892	0	1899
8189	3	6	1852	44	0	1905
8190	3	0	29	1814	0	1846
8191	0	4	19	1859	0	1882
8192	5	2	1859	47	0	1913
8193	1746	0	30	24	0	1800
8194	32	0	20	1938	0	1990
8195	24	0	7	1901	0	1932
8196	4	1942	4	46	0	1996
8197	1925	29	7	26	0	1987
8198	32	20	1910	4	0	1966
8199	1891	4	31	6	0	1932
8200	33	2	21	1905	0	1961
8201	22	9	1915	34	0	1980
8202	7	2	30	1937	0	1976
8203	1936	2	23	43	0	2004
8204	36	3	1941	24	0	2004
8205	1940	1	30	22	0	1993
8206	1999	2	22	11	0	2034
8207	2024	6	6	14	0	2050
8208	57	1993	9	7	0	2066
8209	28	31	4	2031	0	2094
8210	2102	22	6	38	0	2168
8211	2101	5	8	25	0	2139
8212	2069	6	9	9	0	2093
8213	66	11	1942	12	0	2031
8214	2036	4	41	10	0	2091
8215	49	5	28	2125	0	2207
8216	29	5	2130	48	0	2212
8217	13	4	46	2137	0	2200
8218	10	6	30	2179	0	2225
8219	9	8	2118	83	0	2218
8220	7	4	57	2103	0	2171
8221	11	4	35	2129	0	2179
8222	8	7	2499	88	0	2602
8223	2525	5	60	44	0	2634
8224	2819	3	47	13	0	2882
8225	117	1	15	2957	0	3090
8226	62	7	2930	83	0	3082
8227	15	3	80	2882	0	2980
8228	8	2883	48	95	0	3034
8229	11	71	14	2915	0	3011
8230	17	46	14	2921	0	2998
8231	2877	11	12	125	0	3025
8232	2909	3	5	71	0	2988
8233	2962	5	10	30	0	3007
8234	140	4	8	2862	0	3014
8235	73	5	9	2930	0	3017
8236	30	6	2832	129	0	2997
8237	20	4	83	2767	0	2874
8238	19	2827	56	95	0	2997
8239	2821	77	17	61	0	2976
8240	86	2771	19	27	0	2903
8241	2808	76	13	29	0	2926
8242	98	49	15	2578	0	2740
8243	57	2733	16	87	0	2893
8244	2774	71	11	60	0	2916
8245	2798	50	12	27	0	2887
8246	134	16	7	2715	0	2872
8247	66	2750	12	88	0	2916
8248	28	71	10	2763	0	2872
8249	22	55	2703	81	0	2861
8250	2639	16	73	56	0	2784
8251	85	2684	53	28	0	2850
8252	2665	71	16	24	0	2776
8253	93	44	8	2635	0	2780
8254	2715	19	14	80	0	2828
8255	101	15	2772	59	0	2947
8256	2847	6	77	30	0	2960
8257	2877	3	59	27	0	2966
8258	139	10	2856	33	0	3038
8259	79	9	83	2844	0	3015
8260	36	7	63	2896	0	3002
8261	2794	13	17	142	0	2966
8262	87	2796	22	84	0	2989
8263	67	65	29	2628	0	2789
8264	31	55	2610	87	0	2783
8265	34	26	2628	63	0	2751
8266	27	2551	112	30	0	2720
8267	26	67	2555	29	0	2677
8268	2411	43	99	27	0	2580
8269	73	19	59	2315	0	2466
8270	2390	10	16	71	0	2487
8271	76	18	2342	61	0	2497
8272	67	8	72	2302	0	2449
8273	33	15	48	2361	0	2457
8274	22	19	2322	108	0	2471
8275	31	8	59	2357	0	2455
8276	2309	11	53	86	0	2459
8277	2321	11	19	60	0	2411
8278	117	8	15	2251	0	2391
8279	2298	6	13	77	0	2394
8280	2288	10	7	66	0	2371
8281	107	2227	22	29	0	2385
8282	81	51	16	2230	0	2378
8283	2268	41	7	83	0	2399
8284	88	17	8	2301	0	2414
8285	2214	8	16	84	0	2322
8286	84	10	14	2212	0	2320
8287	63	11	2186	85	0	2345
8288	34	2199	68	61	0	2362
8289	33	62	43	1837	0	1975
8290	30	2191	24	60	0	2305
8291	2143	61	18	52	0	2274
8292	68	2122	23	26	0	2239
8293	59	2106	17	20	0	2202
8294	28	101	12	2049	0	2190
8295	2034	48	18	74	0	2174
8296	75	14	13	2087	0	2189
8297	2084	15	12	74	0	2185
8298	2093	14	12	60	0	2179
8299	102	2106	12	29	0	2249
8300	2182	60	15	26	0	2283
8301	2177	43	20	29	0	2269
8302	2191	13	9	30	0	2243
8303	122	22	2068	15	0	2227
8304	78	12	57	2028	0	2175
8305	35	10	46	2086	0	2177
8306	42	10	2009	99	0	2160
8307	2028	12	62	64	0	2166
8308	2072	10	46	32	0	2160
8309	2084	7	15	24	0	2130
8310	1973	9	13	21	0	2016
8311	105	1888	15	27	0	2035
8312	1893	49	11	25	0	1978
8313	79	38	11	1852	0	1980
8314	57	18	1724	50	0	1849
8315	1677	5	43	46	0	1771
8316	65	1686	39	19	0	1809
8317	1593	40	16	13	0	1662
8318	54	1586	11	22	0	1673
8319	44	1558	13	24	0	1639
8320	27	1623	16	16	0	1682
8321	33	1572	61	22	0	1688
8322	17	50	1242	12	0	1321
8323	22	87	27	1033	0	1169
8324	12	7	933	17	0	969
8325	680	4	10	22	0	716
8326	11	728	14	8	0	761
8327	20	765	4	6	0	795
8328	6	24	3	757	0	790
8329	9	15	1	776	0	801
8330	12	7	767	18	0	804
8331	8	7	763	17	0	795
8332	5	5	22	756	0	788
8333	7	3	805	11	0	826
8334	8	792	12	19	0	831
8335	5	15	15	859	0	894
8336	13	13	2	951	0	979
8337	12	5	946	21	0	984
8338	15	3	9	957	0	984
8339	956	2	18	18	0	994
8340	18	3	5	952	0	978
8341	24	2	5	949	0	980
8342	9	2	935	32	0	978
8343	892	1	10	25	0	928
8344	22	960	20	5	0	1007
8345	30	13	2	985	0	1030
8346	16	20	986	12	0	1034
8347	15	7	10	983	0	1015
8348	963	7	19	17	0	1006
8349	22	6	963	25	0	1016
8350	29	6	13	966	0	1014
8351	12	4	992	15	0	1023
8352	10	953	10	31	0	1004
8353	13	16	994	7	0	1030
8354	15	939	15	6	0	975
8355	11	12	817	6	0	846
8356	5	42	11	666	0	724
8357	6	753	13	11	0	783
8358	697	9	3	15	0	724
8359	7	16	5	665	0	693
8360	711	1	7	11	0	730
8361	13	3	1	742	0	759
8362	17	4	4	734	0	759
8363	735	4	3	23	0	765
8364	738	2	2	18	0	760
8365	23	4	3	757	0	787
8366	18	2	792	12	0	824
8367	6	787	10	16	0	819
8368	8	8	791	6	0	813
8369	5	809	9	7	0	830
8370	783	7	14	8	0	812
8371	14	12	774	6	0	806
8372	14	3	779	2	0	798
8373	6	2	20	774	0	802
8374	814	3	11	14	0	842
8375	13	3	826	13	0	855
8376	19	856	16	3	0	894
8377	899	13	12	10	0	934
8378	924	10	6	4	0	944
8379	928	1	4	9	0	942
8380	931	5	8	4	0	948
8381	934	4	2	1	0	941
8382	25	6	913	4	0	948
8383	16	3	11	812	0	842
8384	3	839	16	8	0	866
8385	864	11	1	16	0	892
8386	14	875	5	2	0	896
8387	863	11	1	6	0	881
8388	864	11	3	4	0	882
8389	20	852	5	5	0	882
8390	877	11	2	2	0	892
8391	13	13	2	872	0	900
8392	18	1	1	878	0	898
8393	11	2	863	19	0	895
8394	6	882	12	11	0	911
8395	6	8	12	875	0	901
8396	2	14	3	898	0	917
8397	8	2	2	907	0	919
8398	2	5	854	24	0	885
8399	781	5	9	15	0	810
8400	16	2	13	826	0	857
8401	837	2	2	16	0	857
8402	16	2	2	839	0	859
8403	16	4	797	13	0	830
8404	7	3	799	17	0	826
8405	755	2	25	5	0	787
8406	820	3	12	5	0	840
8407	22	807	3	6	0	838
8408	16	15	798	3	0	832
8409	5	13	11	773	0	802
8410	5	4	14	684	0	707
8411	827	1	3	23	0	854
8412	828	4	6	13	0	851
8413	840	3	3	6	0	852
8414	24	4	814	9	0	851
8415	815	4	13	7	0	839
8416	13	1	18	839	0	871
8417	21	3	6	838	0	868
8418	11	5	4	842	0	862
8419	7	824	6	21	0	858
8420	778	11	4	13	0	806
8421	13	14	6	768	0	801
8422	19	3	762	14	0	798
8423	9	4	12	751	0	776
8424	7	755	15	13	0	790
8425	769	11	1	19	0	800
8426	19	14	5	741	0	779
8427	23	1	5	726	0	755
8428	6	3	710	26	0	745
8429	11	1	10	691	0	713
8430	5	707	15	15	0	742
8431	5	12	3	721	0	741
8432	5	17	704	16	0	742
8433	636	4	10	19	0	669
8434	713	1	19	8	0	741
8435	18	593	4	6	0	621
8436	535	10	4	4	0	553
8437	550	9	3	5	0	567
8438	17	562	0	3	0	582
8439	11	11	4	581	0	607
8440	582	7	4	16	0	609
8441	11	616	5	11	0	643
8442	10	14	612	2	0	638
8443	571	5	12	7	0	595
8444	650	4	6	3	0	663
8445	630	2	2	3	0	637
8446	614	1	3	4	0	622
8447	21	632	4	2	0	659
8448	653	10	2	3	0	668
8449	660	6	3	1	0	670
8450	671	0	2	3	0	676
8451	19	1	1	670	0	691
8452	675	2	3	11	0	691
8453	15	660	4	7	0	686
8454	7	12	684	1	0	704
8455	2	7	13	698	0	720
8456	696	0	15	18	0	729
8457	16	3	718	10	0	747
8458	12	0	15	728	0	755
8459	4	1	719	18	0	742
8460	4	714	14	10	0	742
8461	6	14	9	686	0	715
8462	5	12	680	17	0	714
8463	3	688	16	10	0	717
8464	3	13	8	676	0	700
8465	671	10	0	18	0	699
8466	713	0	2	13	0	728
8467	732	2	0	4	0	738
8468	734	2	2	3	0	741
8469	734	0	0	5	0	739
8470	28	1	699	5	0	733
8471	701	2	15	3	0	721
8472	728	1	12	3	0	744
8473	30	1	1	697	0	729
8474	685	0	1	13	0	699
8475	667	0	0	11	0	678
8476	22	642	3	2	0	669
8477	12	11	0	639	0	662
8478	3	9	1	637	0	650
8479	629	1	0	20	0	650
8480	13	617	1	9	0	640
8481	12	622	2	1	0	637
8482	2	19	1	629	0	651
8483	1	10	1	648	0	660
8484	1	2	0	657	0	660
8485	2	2	1	650	0	655
8486	631	1	2	25	0	659
8487	654	1	1	15	0	671
8488	24	5	650	4	0	683
8489	15	0	14	640	0	669
8490	4	2	9	656	0	671
8491	4	0	633	23	0	660
8492	597	2	15	11	0	625
8493	17	638	11	4	0	670
8494	632	12	3	5	0	652
8495	13	11	0	624	0	648
8496	17	3	618	15	0	653
8497	5	4	13	648	0	670
8498	7	1	672	15	0	695
8499	3	646	14	12	0	675
8500	643	13	10	7	0	673
8501	650	8	2	7	0	667
8502	24	657	5	2	0	688
8503	13	13	2	641	0	669
8504	629	9	1	15	0	654
8505	13	631	4	12	0	660
8506	13	13	3	632	0	661
8507	654	10	5	16	0	685
8508	16	5	638	13	0	672
8509	628	3	10	6	0	647
8510	15	654	12	7	0	688
8511	652	12	1	4	0	669
8512	641	11	3	3	0	658
8513	26	6	637	4	0	673
8514	17	2	13	625	0	657
8515	7	2	12	654	0	675
8516	8	3	641	23	0	675
8517	6	2	12	649	0	669
8518	5	3	10	632	0	650
8519	653	2	0	24	0	679
8520	656	4	4	12	0	676
8521	24	1	1	648	0	674
8522	12	2	637	21	0	672
8523	6	3	14	665	0	688
8524	13	3	8	667	0	691
8525	3	4	700	27	0	734
8526	5	3	11	717	0	736
8527	701	1	8	18	0	728
8528	712	2	2	14	0	730
8529	21	716	5	4	0	746
8530	740	13	2	10	0	765
8531	803	10	0	7	0	820
8532	21	787	3	4	0	815
8533	790	14	4	6	0	814
8534	769	8	0	5	0	782
8535	829	1	5	7	0	842
8536	26	7	785	5	0	823
8537	796	3	9	9	0	817
8538	22	1	8	792	0	823
8539	782	4	1	19	0	806
8540	15	2	777	11	0	805
8541	13	748	13	5	0	779
8542	750	11	8	6	0	775
8543	15	825	3	6	0	849
8544	8	10	3	797	0	818
8545	5	7	2	831	0	845
8546	829	2	1	16	0	848
8547	799	5	2	7	0	813
8548	18	1	796	9	0	824
8549	9	1	777	7	0	794
8550	4	1	815	6	0	826
8551	5	1	16	784	0	806
8552	2	4	804	11	0	821
8553	4	3	787	8	0	802
8554	12	20	9	659	0	700
8555	708	0	3	12	0	723
8556	724	0	0	4	0	728
8557	731	0	1	6	0	738
8558	727	0	2	1	0	730
8559	10	2	1	722	0	735
8560	2	1	1	749	0	753
8561	4	1	767	8	0	780
8562	2	0	8	764	0	774
8563	3	1	4	745	0	753
8564	778	1	1	11	0	791
8565	788	0	2	4	0	794
8566	15	1	0	786	0	802
8567	791	1	3	10	0	805
8568	798	0	1	5	0	804
8569	12	1	1	801	0	815
8570	6	0	1	806	0	813
8571	3	2	792	13	0	810
8572	4	2	784	4	0	794
8573	4	0	11	793	0	808
8574	4	3	4	814	0	825
8575	5	1	810	12	0	828
8576	776	1	11	9	0	797
8577	786	1	5	4	0	796
8578	15	0	793	6	0	814
8579	6	798	14	2	0	820
8580	822	9	5	6	0	842
8581	17	5	869	3	0	894
8582	6	9	9	843	0	867
8583	4	0	4	869	0	877
8584	938	0	1	18	0	957
8585	971	0	3	7	0	981
8586	16	0	2	974	0	992
8587	4	1	3	1004	0	1012
8588	991	0	3	18	0	1012
8589	1021	0	2	10	0	1033
8590	1009	0	0	7	0	1016
8591	19	0	1012	2	0	1033
8592	11	0	12	1019	0	1042
8593	3	2	7	1043	0	1055
8594	1026	0	2	21	0	1049
8595	14	1030	4	9	0	1057
8596	1178	12	0	7	0	1197
8597	20	1185	11	3	0	1219
8598	20	20	2	1192	0	1234
8599	3	11	4	1248	0	1266
8600	9	1	1221	37	0	1268
8601	3	0	23	1220	0	1246
8602	6	5	1245	27	0	1283
8603	8	2	25	1261	0	1296
8604	5	2	17	1259	0	1283
8605	3	1220	7	37	0	1267
8606	6	1257	3	20	0	1286
8607	8	36	3	1193	0	1240
8608	6	15	3	1274	0	1298
8609	8	2	3	1308	0	1321
8610	4	2	2	1314	0	1322
8611	10	2	5	1321	0	1338
8612	6	4	1341	46	0	1397
8613	9	1	27	1327	0	1364
8614	5	1	18	1364	0	1388
8615	10	2	1315	47	0	1374
8616	8	1317	30	22	0	1377
8617	10	21	22	1312	0	1365
8618	10	19	1307	32	0	1368
8619	5	1299	31	25	0	1360
8620	8	24	21	1310	0	1363
8621	1339	21	3	39	0	1402
8622	28	4	4	1370	0	1406
8623	25	4	3	1378	0	1410
8624	7	4	2	1426	0	1439
8625	8	1	1	1369	0	1379
8626	3	1325	9	47	0	1384
8627	7	25	4	1364	0	1400
8628	1371	19	6	36	0	1432
8629	28	2	7	1386	0	1423
8630	22	3	2	1359	0	1386
8631	8	2	5	1393	0	1408
8632	1349	7	3	56	0	1415
8633	1407	5	6	34	0	1452
8634	45	4	2	1422	0	1473
8635	1353	4	3	38	0	1398
8636	1351	5	3	31	0	1390
8637	42	1331	9	21	0	1403
8638	1359	21	6	20	0	1406
8639	27	1379	10	12	0	1428
8640	20	1372	5	23	0	1420
8641	6	38	4	1361	0	1409
8642	2	29	1357	26	0	1414
8643	5	7	41	1286	0	1339
8644	3	5	16	1308	0	1332
8645	5	1269	8	46	0	1328
8646	1271	33	1	28	0	1333
8647	26	20	5	1286	0	1337
8648	19	6	1462	39	0	1526
8649	7	1	26	1464	0	1498
8650	2	1495	17	39	0	1553
8651	1564	21	6	34	0	1625
8652	24	19	4	1564	0	1611
8653	26	11	1574	31	0	1642
8654	7	6	22	1637	0	1672
8655	6	1602	25	35	0	1668
8656	6	32	4	1633	0	1675
8657	1673	27	2	41	0	1743
8658	1833	3	3	37	0	1876
8659	1860	3	7	19	0	1889
8660	54	1853	6	14	0	1927
8661	1847	36	1	20	0	1904
8662	40	27	2	1837	0	1906
8663	1847	9	6	45	0	1907
8664	40	1882	9	39	0	1970
8665	28	34	4	1936	0	2002
8666	11	35	1899	41	0	1986
8667	1734	9	31	39	0	1813
8668	38	1953	28	13	0	2032
8669	31	32	8	1952	0	2023
8670	10	27	2	2006	0	2045
8671	4	8	1	2030	0	2043
8672	9	6	1	1965	0	1981
8673	13	1938	7	54	0	2012
8674	1950	35	1	43	0	2029
8675	1955	27	3	20	0	2005
8676	59	10	1986	13	0	2068
8677	35	9	31	2021	0	2096
8678	13	6	2039	37	0	2095
8679	1945	3	33	39	0	2020
8680	2033	6	29	15	0	2083
8681	2015	6	3	11	0	2035
8682	64	7	3	1955	0	2029
8683	33	1971	11	35	0	2050
8684	1953	34	3	35	0	2025
8685	39	28	1	1934	0	2002
8686	1918	7	8	37	0	1970
8687	39	7	1846	30	0	1922
8688	26	7	1886	9	0	1928
8689	1885	0	46	10	0	1941
8690	32	5	22	1914	0	1973
8691	1926	6	3	30	0	1965
8692	33	1958	3	30	0	2024
8693	1962	27	4	10	0	2003
8694	1967	21	5	9	0	2002
8695	51	11	2043	5	0	2110
8696	20	7	1927	6	0	1960
8697	7	1982	34	7	0	2030
8698	14	32	15	1993	0	2054
8699	2076	14	4	24	0	2118
8700	21	5	1	2078	0	2105
8701	22	3	0	2102	0	2127
8702	8	7	2013	39	0	2067
8703	1947	1	17	19	0	1984
8704	20	8	14	2081	0	2123
8705	15	3	2054	25	0	2097
8706	7	10	2056	17	0	2090
8707	10	1	27	2079	0	2117
8708	7	10	2086	20	0	2123
8709	3	11	2072	16	0	2102
8710	8	2	27	1915	0	1952
8711	5	6	2216	24	0	2251
8712	8	4	16	2104	0	2132
8713	2	2182	14	18	0	2216
8714	2254	21	2	16	0	2293
8715	26	2281	7	10	0	2324
8716	14	24	5	2244	0	2287
8717	23	2309	3	20	0	2355
8718	10	29	2395	18	0	2452
8719	11	13	34	2721	0	2779
8720	8	5	3185	60	0	3258
8721	2990	2	66	44	0	3102
8722	67	3268	51	11	0	3397
8723	3303	68	4	9	0	3384
8724	79	62	1	3196	0	3338
8725	3267	5	6	76	0	3354
8726	86	13	3304	57	0	3460
8727	52	3309	74	7	0	3442
8728	3273	75	55	12	0	3415
8729	84	53	10	3097	0	3244
8730	58	3248	7	72	0	3385
8731	13	78	3	3301	0	3395
8732	3395	53	7	87	0	3542
8733	86	3689	10	62	0	3847
8734	3762	90	4	19	0	3875
8735	99	84	3703	4	0	3890
8736	3653	7	96	16	0	3772
8737	107	5	77	3713	0	3902
8738	3742	4	8	105	0	3859
8739	93	3673	6	87	0	3859
8740	86	96	8	3692	0	3882
8741	18	81	4	3811	0	3914
8742	12	12	3658	180	0	3862
8743	16	5	97	3651	0	3769
8744	10	7	82	3753	0	3852
8745	14	5	12	3803	0	3834
8746	12	6	10	3822	0	3850
8747	14	9	3664	178	0	3865
8748	8	3453	103	99	0	3663
8749	9	97	85	3444	0	3635
8750	3402	85	10	107	0	3604
8751	3396	12	7	94	0	3509
8752	175	3365	15	20	0	3575
8753	3392	97	13	16	0	3518
8754	3382	84	7	15	0	3488
8755	3413	13	8	11	0	3445
8756	191	3292	13	9	0	3505
8757	3157	93	1	16	0	3267
8758	108	90	6	3058	0	3262
8759	84	11	3065	100	0	3260
8760	18	3079	91	87	0	3275
8761	20	95	74	3053	0	3242
8762	16	81	3048	99	0	3244
8763	2946	11	84	89	0	3130
8764	99	13	83	2986	0	3181
8765	91	16	9	3082	0	3198
8766	21	12	7	3152	0	3192
8767	21	8	9	3165	0	3203
8768	18	20	2947	173	0	3158
8769	2615	10	89	115	0	2829
8770	101	2909	83	32	0	3125
8771	2994	89	14	25	0	3122
8772	109	2990	8	21	0	3128
8773	3013	96	13	21	0	3143
8774	116	78	7	2951	0	3152
8775	92	18	2934	113	0	3157
8776	34	17	2955	97	0	3103
8777	20	23	168	2869	0	3080
8778	20	17	84	2919	0	3040
8779	24	14	11	3034	0	3083
8780	2860	10	18	185	0	3073
8781	103	20	2892	102	0	3117
8782	97	39	94	2681	0	2911
8783	29	2861	84	110	0	3084
8784	2814	94	17	93	0	3018
8785	111	89	2811	28	0	3039
8786	99	2767	103	24	0	2993
8787	32	95	2886	28	0	3041
8788	33	82	95	2790	0	3000
8789	40	18	2863	104	0	3025
8790	24	26	2888	89	0	3027
8791	26	25	160	2809	0	3020
8792	28	18	2838	107	0	2991
8793	23	9	2859	97	0	2988
8794	19	22	165	2677	0	2883
8795	2660	12	87	123	0	2882
8796	103	14	2550	110	0	2777
8797	100	7	103	2468	0	2678
8798	24	14	86	2606	0	2730
8799	2435	16	23	187	0	2661
8800	104	16	16	2525	0	2661
8801	2511	10	20	119	0	2660
8802	115	2427	17	97	0	2656
8803	95	107	15	2425	0	2642
8804	2414	81	11	118	0	2624
8805	2477	8	17	112	0	2614
8806	180	15	23	2405	0	2623
8807	97	20	2355	113	0	2585
8808	2254	16	99	102	0	2471
8809	105	2323	93	32	0	2553
8810	2330	98	24	30	0	2482
8811	2333	79	19	28	0	2459
8812	2378	18	20	33	0	2449
8813	180	13	2163	27	0	2383
8814	92	2110	104	21	0	2327
8815	63	77	81	2060	0	2281
8816	24	88	16	2180	0	2308
8817	27	24	2038	164	0	2253
8818	23	1856	82	90	0	2051
8819	10	1534	64	25	0	1633
8820	10	1245	11	10	0	1276
8821	1052	58	37	15	0	1162
8822	45	25	6	1028	0	1104
8823	25	2	12	1055	0	1094
8824	12	4	1037	54	0	1107
8825	954	3	33	38	0	1028
8826	28	2	29	959	0	1018
8827	31	46	8	937	0	1022
8828	35	3	916	56	0	1010
8829	10	938	29	28	0	1005
8830	12	27	26	938	0	1003
8831	12	24	929	30	0	995
8832	5	760	19	22	0	806
8833	511	5	7	1	0	524
8834	5	5	552	3	0	565
8835	6	0	4	502	0	512
8836	1	520	5	6	0	532
8837	524	4	2	6	0	536
8838	5	5	0	551	0	561
8839	593	1	1	9	0	604
8840	613	2	1	6	0	622
8841	9	616	1	4	0	630
8842	619	5	1	1	0	626
8843	649	7	0	6	0	662
8844	11	1	662	2	0	676
8845	643	0	6	1	0	650
8846	6	0	681	3	0	690
8847	663	1	5	4	0	673
8848	679	0	5	3	0	687
8849	15	5	666	0	0	686
8850	9	0	4	672	0	685
8851	2	3	696	4	0	705
8852	2	6	662	5	0	675
8853	14	4	688	5	0	711
8854	0	1	5	659	0	665
8855	1	21	6	752	0	780
8856	0	1	0	788	0	789
8857	1	0	0	807	0	808
8858	1	1	841	12	0	855
8859	0	0	5	762	0	767
8860	0	730	8	5	0	743
8861	2	8	812	8	0	830
8862	0	8	5	790	0	803
8863	2	2	822	5	0	831
8864	1	800	7	7	0	815
8865	2	823	9	1	0	835
8866	1	13	1	815	0	830
8867	1	9	821	5	0	836
8868	0	1	838	9	0	848
8869	3	1	13	811	0	828
8870	0	1	10	868	0	879
8871	2	1	0	883	0	886
8872	4	4	880	17	0	905
8873	0	876	10	9	0	895
8874	0	906	11	3	0	920
8875	2	18	2	926	0	948
8876	0	11	916	12	0	939
8877	10	5	960	12	0	987
8878	0	1052	18	3	0	1073
8879	1069	10	8	4	0	1091
8880	10	1077	1	3	0	1091
8881	9	13	1076	4	0	1102
8882	1064	9	14	2	0	1089
8883	14	0	11	1120	0	1145
8884	1132	1	1	14	0	1148
8885	13	1	2	1138	0	1154
8886	13	1	0	1136	0	1150
8887	1154	1	1	27	0	1183
8888	15	1230	2	17	0	1264
8889	16	14	1226	3	0	1259
8890	1	1256	17	2	0	1276
8891	1222	16	16	1	0	1255
8892	16	1250	2	3	0	1271
8893	1246	15	0	3	0	1264
8894	1235	15	2	5	0	1257
8895	31	1237	0	2	0	1270
8896	15	14	3	1233	0	1265
8897	1234	15	0	18	0	1267
8898	1241	0	1	21	0	1263
8899	32	0	1	1225	0	1258
8900	16	3	1214	16	0	1249
8901	0	3	1216	15	0	1234
8902	1	1	31	1218	0	1251
8903	0	3	1237	17	0	1257
8904	1150	1	19	19	0	1189
8905	16	1241	18	8	0	1283
8906	17	15	2	1269	0	1303
8907	4	16	0	1269	0	1289
8908	3	2	2	1264	0	1271
8909	4	1	1	1269	0	1275
8910	3	2	1	1283	0	1289
8911	4	6	1270	31	0	1311
8912	3	1288	21	17	0	1329
8913	1309	20	19	5	0	1353
8914	21	22	2	1321	0	1366
8915	22	3	2	1348	0	1375
8916	6	4	5	1348	0	1363
8917	3	1304	4	40	0	1351
8918	3	19	5	1384	0	1411
8919	5	19	4	1356	0	1384
8920	1291	3	3	44	0	1341
8921	24	1260	3	23	0	1310
8922	24	1275	4	4	0	1307
8923	4	41	2	1284	0	1331
8924	1249	22	5	26	0	1302
8925	27	5	1252	21	0	1305
8926	1203	1	22	9	0	1235
8927	24	7	1389	2	0	1422
8928	23	2	23	1375	0	1423
8929	7	2	23	1419	0	1451
8930	5	4	4	1425	0	1438
8931	6	7	2	1428	0	1443
8932	5	4	5	1417	0	1431
8933	1379	3	2	47	0	1431
8934	25	11	1344	27	0	1407
8935	23	4	25	1365	0	1417
8936	9	8	1447	26	0	1490
8937	8	1437	20	33	0	1498
8938	1395	22	22	10	0	1449
8939	24	27	1424	16	0	1491
8940	32	4	24	1395	0	1455
8941	11	6	21	1456	0	1494
8942	6	8	1431	54	0	1499
8943	6	3	1407	34	0	1450
8944	11	6	49	1282	0	1348
8945	1371	6	21	31	0	1429
8946	1381	1	3	31	0	1416
8947	47	1375	7	7	0	1436
8948	1417	27	4	9	0	1457
8949	32	25	2	1359	0	1418
8950	24	1441	6	32	0	1503
8951	7	32	2	1466	0	1507
8952	5	27	1456	38	0	1526
8953	5	3	27	1426	0	1461
8954	8	16	30	1460	0	1514
8955	1370	5	2	46	0	1423
8956	27	1392	7	32	0	1458
8957	1356	23	7	15	0	1401
8958	24	1338	5	14	0	1381
8959	1321	23	4	11	0	1359
8960	23	1312	6	13	0	1354
8961	23	1328	6	9	0	1366
8962	1356	41	4	9	0	1410
8963	27	20	7	1297	0	1351
8964	19	1361	8	32	0	1420
8965	1406	24	4	28	0	1462
8966	1455	22	7	11	0	1495
8967	1483	2	4	12	0	1501
8968	1456	3	12	8	0	1479
8969	44	1495	12	14	0	1565
8970	28	26	3	1485	0	1542
8971	10	21	9	1515	0	1555
8972	1512	5	9	46	0	1572
8973	28	5	3	1494	0	1530
8974	1499	3	6	25	0	1533
8975	26	12	1410	24	0	1472
8976	1396	7	19	12	0	1434
8977	29	6	1397	9	0	1441
8978	23	4	21	1349	0	1397
8979	1308	9	17	29	0	1363
8980	26	1319	5	25	0	1375
8981	1296	19	7	11	0	1333
8982	21	1297	4	10	0	1332
8983	17	20	1	1318	0	1356
8984	8	23	1320	19	0	1370
8985	1142	6	17	20	0	1185
8986	18	1256	17	7	0	1298
8987	19	17	2	1219	0	1257
8988	12	12	6	1223	0	1253
8989	7	6	2	1240	0	1255
8990	5	11	1203	27	0	1246
8991	12	1200	19	14	0	1245
8992	1191	16	15	8	0	1230
8993	1218	15	2	7	0	1242
8994	34	1204	7	3	0	1248
8995	1258	18	2	8	0	1286
8996	25	17	3	1255	0	1300
8997	25	1252	7	19	0	1303
8998	1255	21	5	21	0	1302
8999	27	18	1223	8	0	1276
9000	18	1234	21	12	0	1285
9001	9	18	15	1274	0	1316
9002	7	16	2	1282	0	1307
9003	6	6	1237	35	0	1284
9004	10	4	22	1214	0	1250
9005	8	14	1250	25	0	1297
9006	7	5	16	1213	0	1241
9007	6	7	16	1245	0	1274
9008	13	4	0	1250	0	1267
9009	7	9	5	1285	0	1306
9010	11	9	1250	30	0	1300
9011	7	7	1307	17	0	1338
9012	3	1407	31	13	0	1454
9013	8	24	19	1415	0	1466
9014	17	25	1499	25	0	1566
9015	3	1500	25	22	0	1550
9016	7	26	23	1524	0	1580
9017	5	26	1596	28	0	1655
9018	1465	6	25	29	0	1525
9019	1750	8	22	9	0	1789
9020	51	7	1	1739	0	1798
9021	36	4	1721	31	0	1792
9022	13	2	26	1724	0	1765
9023	1717	8	25	31	0	1781
9024	30	1851	10	29	0	1920
9025	1935	28	3	14	0	1980
9026	1915	31	3	9	0	1958
9027	67	5	1	1784	0	1857
9028	33	7	3	1844	0	1887
9029	12	2	4	1867	0	1885
9030	11	5	4	1857	0	1877
9031	13	4	4	1862	0	1883
9032	1799	5	8	66	0	1878
9033	1828	4	4	40	0	1876
9034	1837	5	7	16	0	1865
9035	61	5	1747	9	0	1822
9036	1696	4	29	10	0	1739
9037	36	4	27	1717	0	1784
9038	32	8	1707	36	0	1783
9039	9	1671	29	26	0	1735
9040	10	26	40	1666	0	1742
9041	7	22	6	1664	0	1699
9042	4	1735	8	52	0	1799
9043	9	24	3	1817	0	1853
9044	6	28	1804	33	0	1871
9045	4	8	1811	32	0	1855
9046	8	4	52	1804	0	1868
9047	1785	3	30	28	0	1846
9048	1780	2	6	35	0	1823
9049	56	6	1773	11	0	1846
9050	33	1675	25	12	0	1745
9051	14	1748	33	10	0	1805
9052	1669	47	6	16	0	1738
9053	40	36	1698	11	0	1785
9054	32	6	24	1662	0	1724
9055	1668	2	30	30	0	1730
9056	28	1642	10	38	0	1718
9057	37	1686	4	17	0	1744
9058	1647	45	10	12	0	1714
9059	39	33	3	1661	0	1736
9060	1802	6	5	45	0	1858
9061	43	4	5	2016	0	2068
9062	45	5	6	2093	0	2149
9063	10	11	2079	91	0	2191
9064	19	5	42	2125	0	2191
9065	19	9	44	2109	0	2181
9066	2033	6	9	96	0	2144
9067	48	4	9	2129	0	2190
9068	51	10	2076	62	0	2199
9069	1954	4	46	69	0	2073
9070	45	5	52	2005	0	2107
9071	2028	9	12	58	0	2107
9072	51	1968	13	65	0	2097
9073	59	2055	8	21	0	2143
9074	2035	83	10	16	0	2144
9075	2115	54	10	20	0	2199
9076	97	7	17	2068	0	2189
9077	65	9	2050	53	0	2177
9078	20	12	40	2123	0	2195
9079	2030	12	54	60	0	2156
9080	56	2025	23	54	0	2158
9081	63	50	11	1980	0	2104
9082	2010	54	7	68	0	2139
9083	60	27	1988	59	0	2134
9084	2021	13	51	25	0	2110
9085	1933	6	61	31	0	2031
9086	98	11	2047	15	0	2171
9087	66	14	2072	28	0	2180
9088	33	6	92	1993	0	2124
9089	26	8	59	1968	0	2061
9090	17	2069	23	96	0	2205
9091	23	44	8	2116	0	2191
9092	23	57	2094	63	0	2237
9093	24	18	48	2149	0	2239
9094	22	10	56	2155	0	2243
9095	24	9	2063	108	0	2204
9096	21	2033	39	78	0	2171
9097	20	39	58	2032	0	2149
9098	19	48	19	2086	0	2172
9099	2054	10	10	108	0	2182
9100	55	11	11	2091	0	2168
9101	73	16	2017	65	0	2171
9102	2010	11	43	69	0	2133
9103	2077	10	54	27	0	2168
9104	2113	13	19	20	0	2165
9105	112	13	1995	23	0	2143
9106	75	3	49	1990	0	2117
9107	25	9	63	2040	0	2137
9108	18	11	19	2092	0	2140
9109	1943	6	17	112	0	2078
9110	60	1929	18	72	0	2079
9111	49	38	1763	26	0	1876
9112	14	1733	46	16	0	1809
9113	12	1718	46	22	0	1798
9114	14	1708	14	18	0	1754
9115	28	75	7	1628	0	1738
9116	13	54	1606	49	0	1722
9117	1390	8	38	46	0	1482
9118	35	1471	46	17	0	1569
9119	1373	26	5	18	0	1422
9120	39	1443	9	9	0	1500
9121	1484	33	9	15	0	1541
9122	34	1526	15	11	0	1586
9123	45	33	1516	11	0	1605
9124	17	36	26	1409	0	1488
9125	14	10	34	1539	0	1597
9126	1519	8	12	69	0	1608
9127	42	5	8	1667	0	1722
9128	47	7	1607	51	0	1712
9129	15	7	44	1636	0	1702
9130	13	10	1637	46	0	1706
9131	8	1606	48	54	0	1716
9132	12	44	50	1475	0	1581
9133	10	1640	13	50	0	1713
9134	1617	47	15	38	0	1717
9135	45	40	8	1648	0	1741
9136	49	9	1673	47	0	1778
9137	16	16	1652	50	0	1734
9138	1611	4	79	20	0	1714
9139	52	15	42	1611	0	1720
9140	51	12	1602	51	0	1716
9141	15	10	1594	55	0	1674
9142	9	1540	83	15	0	1647
9143	6	42	79	1363	0	1490
9144	17	1472	13	43	0	1545
9145	8	43	9	1465	0	1525
9146	1460	35	16	51	0	1562
9147	47	5	16	1489	0	1557
9148	42	14	9	1494	0	1559
9149	1465	7	7	89	0	1568
9150	43	12	10	1567	0	1632
9151	43	7	9	1514	0	1573
9152	24	1511	5	86	0	1626
9153	1518	45	5	54	0	1622
9154	1577	41	9	21	0	1648
9155	84	14	9	1544	0	1651
9156	49	11	8	1550	0	1618
9157	12	7	11	1556	0	1586
9158	13	1461	15	88	0	1577
9159	13	1552	18	52	0	1635
9160	20	79	9	1306	0	1414
9161	998	26	2	37	0	1063
9162	991	7	3	31	0	1032
9163	42	957	6	11	0	1016
9164	903	30	2	7	0	942
9165	23	907	3	6	0	939
9166	18	909	6	11	0	944
9167	39	36	5	835	0	915
9168	827	18	2	21	0	868
9169	19	825	5	19	0	868
9170	20	827	6	5	0	858
9171	7	38	3	827	0	875
9172	10	21	3	814	0	848
9173	1	5	817	44	0	867
9174	789	3	22	20	0	834
9175	806	10	15	11	0	842
9176	35	10	817	8	0	870
9177	19	5	817	10	0	851
9178	8	5	31	814	0	858
9179	5	4	21	847	0	877
9180	8	835	6	42	0	891
9181	9	23	4	856	0	892
9182	7	24	838	27	0	896
9183	5	4	30	807	0	846
9184	8	4	17	795	0	824
9185	768	1	3	51	0	823
9186	23	8	727	25	0	783
9187	700	3	21	18	0	742
9188	22	8	726	13	0	769
9189	21	7	24	717	0	769
9190	6	7	722	32	0	767
9191	13	4	721	23	0	761
9192	7	6	41	678	0	732
9193	675	3	22	31	0	731
9194	677	6	12	28	0	723
9195	39	674	9	15	0	737
9196	695	26	14	7	0	742
9197	689	20	9	9	0	727
9198	42	686	8	11	0	747
9199	32	28	4	680	0	744
9200	14	21	5	710	0	750
9201	6	12	7	728	0	753
9202	10	7	4	738	0	759
9203	11	9	697	50	0	767
9204	652	9	25	29	0	715
9205	28	6	21	685	0	740
9206	25	3	7	694	0	729
9207	8	672	8	47	0	735
9208	9	26	4	702	0	741
9209	7	19	699	32	0	757
9210	618	7	21	30	0	676
9211	27	6	678	16	0	727
9212	19	4	20	677	0	720
9213	685	8	20	29	0	742
9214	26	690	7	27	0	750
9215	21	18	9	696	0	744
9216	9	18	724	33	0	784
9217	9	6	24	753	0	792
9218	730	7	17	31	0	785
9219	29	6	731	23	0	789
9220	18	10	688	9	0	725
9221	5	637	36	11	0	689
9222	583	17	19	5	0	624
9223	23	575	5	13	0	616
9224	21	23	594	7	0	645
9225	3	11	508	6	0	528
9226	4	496	31	2	0	533
9227	376	5	7	3	0	391
9228	6	387	3	2	0	398
9229	5	7	2	381	0	395
9230	2	7	1	390	0	400
9231	1	1	396	11	0	409
9232	3	0	9	389	0	401
9233	2	1	399	10	0	412
9234	378	0	9	10	0	397
9235	377	0	8	3	0	388
9236	357	3	0	2	0	362
9237	16	0	338	4	0	358
9238	344	0	9	0	0	353
9239	8	0	8	324	0	340
9240	9	341	1	7	0	358
9241	349	6	2	7	0	364
9242	9	8	346	1	0	364
9243	353	1	8	0	0	362
9244	351	0	10	1	0	362
9245	15	1	365	2	0	383
9246	8	366	9	1	0	384
9247	2	7	9	371	0	389
9248	0	12	379	8	0	399
9249	4	1	381	7	0	393
9250	3	0	10	314	0	327
9251	2	4	333	6	0	345
9252	0	0	4	339	0	343
9253	1	2	6	318	0	327
9254	0	2	0	329	0	331
9255	0	2	322	11	0	335
9256	1	1	4	327	0	333
9257	4	0	325	6	0	335
9258	1	2	4	327	0	334
9259	320	0	6	8	0	334
9260	6	2	2	322	0	332
9261	7	327	0	7	0	341
9262	1	7	0	342	0	350
9263	354	8	1	8	0	371
9264	9	355	4	7	0	375
9265	9	9	0	359	0	377
9266	360	7	3	9	0	379
9267	12	2	352	9	0	375
9268	8	1	11	349	0	369
9269	1	2	364	11	0	378
9270	4	1	379	9	0	393
9271	3	1	19	367	0	390
9272	376	0	9	15	0	400
9273	12	1	359	8	0	380
9274	354	1	10	6	0	371
9275	11	1	9	380	0	401
9276	8	1	386	11	0	406
9277	2	0	410	10	0	422
9278	2	2	391	2	0	397
9279	2	0	19	371	0	392
9280	384	2	10	10	0	406
9281	11	391	3	7	0	412
9282	10	10	1	392	0	413
9283	2	11	2	411	0	426
9284	400	1	3	15	0	419
9285	402	2	1	10	0	415
9286	17	405	3	1	0	426
9287	412	10	0	6	0	428
9288	417	7	1	2	0	427
9289	17	0	3	396	0	416
9290	9	0	396	10	0	415
9291	397	1	11	9	0	418
9292	14	0	11	400	0	425
9293	11	1	1	410	0	423
9294	406	0	2	17	0	425
9295	13	0	2	405	0	420
9296	11	2	1	410	0	424
9297	399	1	2	18	0	420
9298	9	389	1	9	0	408
9299	397	10	1	2	0	410
9300	9	8	384	2	0	403
9301	375	0	10	0	0	385
9302	9	0	6	373	0	388
9303	8	400	1	7	0	416
9304	1	7	2	430	0	440
9305	1	7	1	432	0	441
9306	2	21	0	417	0	440
9307	423	0	2	13	0	438
9308	7	421	3	7	0	438
9309	6	394	2	1	0	403
9310	387	11	2	2	0	402
9311	6	6	396	2	0	410
9312	5	1	377	1	0	384
9313	343	1	12	1	0	357
9314	6	0	351	3	0	360
9315	4	0	6	352	0	362
9316	1	0	4	340	0	345
9317	1	0	0	338	0	339
9318	1	1	0	344	0	346
9319	1	335	0	10	0	346
9320	1	6	0	336	0	343
9321	1	4	340	7	0	352
9322	0	0	7	354	0	361
9323	1	1	351	6	0	359
9324	1	0	321	5	0	327
9325	0	0	9	341	0	350
9326	1	1	342	6	0	350
9327	2	0	6	339	0	347
9328	333	0	3	8	0	344
9329	6	0	345	4	0	355
9330	325	1	6	1	0	333
9331	7	1	4	346	0	358
9332	6	1	339	7	0	353
9333	1	341	6	5	0	353
9334	0	6	4	343	0	353
9335	1	5	347	8	0	361
9336	0	0	7	345	0	352
9337	357	0	4	8	0	369
9338	358	0	1	5	0	364
9339	377	0	1	0	0	378
9340	10	2	0	369	0	381
9341	6	1	0	364	0	371
9342	2	0	1	372	0	375
9343	383	0	1	12	0	396
9344	6	401	1	7	0	415
9345	7	6	1	378	0	392
9346	0	6	2	380	0	388
9347	380	0	1	13	0	394
9348	6	366	0	10	0	382
9349	8	6	0	420	0	434
9350	424	7	1	9	0	441
9351	414	1	0	7	0	422
9352	13	1	0	404	0	418
9353	410	0	1	8	0	419
9354	8	0	0	413	0	421
9355	6	4	450	9	0	469
9356	2	0	9	457	0	468
9357	1	0	7	462	0	470
9358	2	0	1	468	0	471
9359	433	1	1	15	0	450
9360	9	447	0	8	0	464
9361	443	7	1	1	0	452
9362	7	444	0	1	0	452
9363	5	434	0	1	0	440
9364	435	8	1	1	0	445
9365	4	467	0	0	0	471
9366	5	4	0	456	0	465
9367	460	6	1	3	0	470
9368	464	0	0	10	0	474
9369	12	0	0	471	0	483
9370	6	1	0	437	0	444
9371	1	452	0	10	0	463
9372	458	3	0	7	0	468
9373	435	5	0	2	0	442
9374	8	470	0	3	0	481
9375	3	435	2	1	0	441
9376	3	4	0	443	0	450
9377	424	4	1	3	0	432
9378	2	1	0	431	0	434
9379	6	0	0	424	0	430
9380	1	2	428	6	0	437
9381	1	0	463	6	0	470
9382	6	1	5	456	0	468
9383	2	1	460	5	0	468
9384	0	458	3	4	0	465
9385	1	3	3	456	0	463
9386	1	4	2	457	0	464
9387	1	1	0	470	0	472
9388	3	1	459	7	0	470
9389	2	2	442	7	0	453
9390	421	0	5	1	0	427
9391	3	465	3	2	0	473
9392	468	3	0	1	0	472
9393	5	4	1	461	0	471
9394	464	2	0	6	0	472
9395	5	0	0	480	0	485
9396	4	487	1	3	0	495
9397	483	3	0	5	0	491
9398	2	7	482	3	0	494
9399	5	497	2	2	0	506
9400	495	6	3	2	0	506
9401	4	6	0	489	0	499
9402	7	539	1	6	0	553
9403	2	8	3	524	0	537
9404	506	10	1	9	0	526
9405	8	1	2	509	0	520
9406	512	2	0	7	0	521
9407	9	0	502	11	0	522
9408	6	0	6	505	0	517
9409	518	1	6	7	0	532
9410	7	2	534	8	0	551
9411	8	523	12	2	0	545
9412	4	8	8	521	0	541
9413	1	12	526	7	0	546
9414	3	2	506	11	0	522
9415	7	1	12	504	0	524
9416	2	2	523	12	0	539
9417	1	3	512	11	0	527
9418	2	2	17	505	0	526
9419	523	2	7	7	0	539
9420	9	3	0	520	0	532
9421	12	3	1	499	0	515
9422	2	3	511	13	0	529
9423	5	2	8	555	0	570
9424	552	2	7	11	0	572
9425	10	4	533	11	0	558
9426	9	530	7	3	0	549
9427	3	8	10	543	0	564
9428	553	8	2	7	0	570
9429	10	2	3	543	0	558
9430	11	561	1	12	0	585
9431	3	9	584	8	0	604
9432	1	10	9	601	0	621
9433	649	1	9	13	0	672
9434	10	2	649	13	0	674
9435	14	1	9	672	0	696
9436	725	1	14	11	0	751
9437	725	1	6	16	0	748
9438	25	728	6	3	0	762
9439	731	10	4	2	0	747
9440	13	13	3	721	0	750
9441	11	4	765	12	0	792
9442	3	752	13	17	0	785
9443	3	766	15	4	0	788
9444	3	21	3	750	0	777
9445	4	12	2	768	0	786
9446	0	0	761	22	0	783
9447	0	750	12	13	0	775
9448	4	769	15	3	0	791
9449	5	18	0	656	0	679
9450	657	12	1	15	0	685
9451	11	653	1	12	0	677
9452	14	8	2	662	0	686
9453	699	11	1	12	0	723
9454	11	1	2	711	0	725
9455	13	4	3	702	0	722
9456	2	1	3	721	0	727
9457	7	3	0	720	0	730
9458	701	3	3	20	0	727
9459	11	5	1	712	0	729
9460	14	3	668	11	0	696
9461	647	1	10	17	0	675
9462	11	5	688	5	0	709
9463	18	7	700	1	0	726
9464	3	3	20	696	0	722
9465	4	1	14	688	0	707
9466	3	4	2	707	0	716
9467	677	3	2	25	0	707
9468	12	7	674	12	0	705
9469	626	3	8	8	0	645
9470	633	2	9	8	0	652
9471	18	1	617	7	0	643
9472	597	3	9	3	0	612
9473	8	4	626	7	0	645
9474	14	659	8	4	0	685
9475	3	5	10	675	0	693
9476	1	10	4	701	0	716
9477	2	1	4	696	0	703
9478	4	4	2	703	0	713
9479	5	1	688	19	0	713
9480	1	1	673	17	0	692
9481	3	2	19	638	0	662
9482	6	9	644	10	0	669
9483	624	2	8	13	0	647
9484	671	1	13	8	0	693
9485	18	3	4	666	0	691
9486	667	5	1	12	0	685
9487	8	739	4	15	0	766
9488	756	6	3	6	0	771
9489	9	12	781	4	0	806
9490	11	1	9	775	0	796
9491	3	802	13	10	0	828
9492	817	7	3	12	0	839
9493	8	11	4	851	0	874
9494	11	4	848	11	0	874
9495	5	3	8	833	0	849
9496	841	0	12	14	0	867
9497	10	5	876	14	0	905
9498	13	1	8	885	0	907
9499	5	4	10	888	0	907
9500	3	2	901	17	0	923
9501	4	889	9	12	0	914
9502	6	765	12	5	0	788
9503	6	17	3	913	0	939
9504	7	8	4	953	0	972
9505	6	2	3	964	0	975
9506	936	5	5	19	0	965
9507	958	2	2	17	0	979
9508	21	2	3	955	0	981
9509	950	2	2	10	0	964
9510	6	976	5	15	0	1002
9511	9	8	2	1001	0	1020
9512	2	11	3	1003	0	1019
9513	8	0	3	1018	0	1029
9514	947	2	3	23	0	975
9515	8	999	4	12	0	1023
9516	10	8	1	1019	0	1038
9517	1008	9	3	11	0	1031
9518	9	4	1	1027	0	1041
9519	13	0	3	1012	0	1028
9520	2	980	3	25	0	1010
9521	4	1011	2	13	0	1030
9522	2	18	2	995	0	1017
9523	3	8	2	977	0	990
9524	949	0	3	20	0	972
9525	11	1	2	968	0	982
9526	10	5	972	9	0	996
9527	6	2	8	966	0	982
9528	4	961	9	10	0	984
9529	979	15	7	15	0	1016
9530	9	7	2	984	0	1002
9531	12	1	1	955	0	969
9532	3	971	6	14	0	994
9533	942	6	1	13	0	962
9534	10	998	1	17	0	1026
9535	9	3	4	982	0	998
9536	3	7	878	6	0	894
9537	5	1	1	842	0	849
9538	863	0	4	5	0	872
9539	3	860	4	5	0	872
9540	5	3	0	871	0	879
9541	0	858	3	2	0	863
9542	2	2	0	888	0	892
9543	1	8	881	16	0	906
9544	1	0	3	871	0	875
9545	2	1	5	896	0	904
9546	1	0	0	910	0	911
9547	857	0	1	11	0	869
9548	872	1	0	7	0	880
9549	8	899	1	1	0	909
9550	886	2	1	4	0	893
9551	2	888	2	2	0	894
9552	5	896	2	1	0	904
9553	845	9	1	0	0	855
9554	6	4	842	3	0	855
9555	7	2	2	823	0	834
9556	2	0	5	860	0	867
9557	1	1	1	878	0	881
9558	894	1	0	11	0	906
9559	3	924	4	8	0	939
9560	6	6	0	921	0	933
9561	1	900	2	6	0	909
9562	938	3	1	9	0	951
9563	5	9	0	955	0	969
9564	12	1	1	1138	0	1152
9565	0	1302	2	24	0	1328
9566	3	18	0	1405	0	1426
9567	5	23	0	1405	0	1433
9568	1350	1	3	48	0	1402
9569	14	1358	5	29	0	1406
9570	21	1397	1	7	0	1426
9571	6	39	1	1420	0	1466
9572	5	25	1374	19	0	1423
9573	5	5	1380	24	0	1414
9574	3	5	41	1349	0	1398
9575	4	7	1377	21	0	1409
9576	3	2	19	1371	0	1395
9577	8	3	26	1292	0	1329
9578	2	5	1	1414	0	1422
9579	1362	3	1	47	0	1413
9580	21	3	1	1390	0	1415
9581	28	2	1	1373	0	1404
9582	1	1348	4	46	0	1399
9583	6	21	1	1414	0	1442
9584	3	32	1340	27	0	1402
9585	5	5	19	1375	0	1404
9586	6	2	24	1386	0	1418
9587	1276	3	2	49	0	1330
9588	17	2	2	1336	0	1357
9589	25	4	4	1272	0	1305
9590	4	1	2	1308	0	1315
9591	1187	3	2	52	0	1244
9592	20	1224	9	30	0	1283
9593	23	22	1	1216	0	1262
9594	4	29	1	1238	0	1272
9595	8	8	1187	51	0	1254
9596	4	7	21	1220	0	1252
9597	1126	4	26	31	0	1187
9598	17	1176	4	38	0	1235
9599	29	21	6	1151	0	1207
9600	4	33	4	1171	0	1212
9601	5	7	1131	57	0	1200
9602	1045	6	18	46	0	1115
9603	19	1129	34	12	0	1194
9604	1133	17	4	22	0	1176
9605	19	28	5	1133	0	1185
9606	31	8	4	1143	0	1186
9607	3	8	3	1165	0	1179
9608	8	5	8	1167	0	1188
9609	1112	5	5	61	0	1183
9610	23	4	5	1086	0	1118
9611	29	1038	6	31	0	1104
9612	7	20	6	1101	0	1134
9613	6	27	5	1108	0	1146
9614	1073	3	10	59	0	1145
9615	20	1036	8	41	0	1105
9616	30	22	7	1060	0	1119
9617	1043	29	6	42	0	1120
9618	1064	6	5	47	0	1122
9619	46	5	8	1071	0	1130
9620	29	7	1046	45	0	1127
9621	1054	3	22	47	0	1126
9622	27	8	28	1074	0	1137
9623	29	8	1067	38	0	1142
9624	6	5	19	1126	0	1156
9625	13	8	28	1067	0	1116
9626	16	2	8	1058	0	1084
9627	5	1035	5	70	0	1115
9628	16	22	6	1054	0	1098
9629	10	29	1	1054	0	1094
9630	8	6	6	1072	0	1092
9631	8	8	7	1080	0	1103
9632	8	1	5	1058	0	1072
9633	13	5	5	1028	0	1051
9634	910	6	6	56	0	978
9635	23	13	908	41	0	985
9636	25	907	23	24	0	979
9637	910	17	24	22	0	973
9638	26	926	8	20	0	980
9639	926	22	15	18	0	981
9640	25	22	4	928	0	979
9641	954	3	5	36	0	998
9642	27	8	6	945	0	986
9643	31	3	4	846	0	884
9644	8	873	7	51	0	939
9645	883	21	4	35	0	943
9646	22	24	892	24	0	962
9647	27	3	21	912	0	963
9648	11	6	916	36	0	969
9649	11	5	884	37	0	937
9650	895	4	39	20	0	958
9651	26	6	22	911	0	965
9652	26	5	894	39	0	964
9653	7	8	905	38	0	958
9654	7	3	39	913	0	962
9655	7	5	22	927	0	961
9656	912	3	4	50	0	969
9657	27	6	4	929	0	966
9658	28	4	901	33	0	966
9659	6	0	20	886	0	912
9660	14	5	22	846	0	887
9661	6	847	9	44	0	906
9662	835	17	6	23	0	881
9663	18	817	11	13	0	859
9664	645	5	2	11	0	663
9665	3	461	1	3	0	468
9666	2	389	3	0	0	394
9667	1	19	0	375	0	395
9668	2	0	1	376	0	379
9669	1	0	0	376	0	377
9670	348	1	1	2	0	352
9671	1	0	349	2	0	352
9672	2	1	1	349	0	353
9673	334	0	1	3	0	338
9674	2	352	1	1	0	356
9675	0	332	2	1	0	335
9676	0	2	0	334	0	336
9677	2	1	0	358	0	361
9678	1	1	0	356	0	358
9679	0	362	1	2	0	365
9680	0	1	1	363	0	365
9681	0	2	355	3	0	360
9682	0	5	326	3	0	334
9683	327	2	2	2	0	333
9684	2	0	1	358	0	361
9685	359	1	0	1	0	361
9686	351	0	0	1	0	352
9687	2	355	0	1	0	358
9688	352	2	0	3	0	357
9689	352	1	0	3	0	356
9690	2	0	0	373	0	375
9691	1	0	0	372	0	373
9692	3	1	398	2	0	404
9693	0	410	2	1	0	413
9694	0	1	2	372	0	375
9695	17	1	0	397	0	415
9696	395	0	0	1	0	396
9697	0	0	0	407	0	407
9698	399	0	0	1	0	400
9699	0	0	0	415	0	415
9700	0	421	0	1	0	422
9701	442	1	0	0	0	443
9702	0	0	0	536	0	536
9703	0	0	0	597	0	597
9704	0	0	0	625	0	625
9705	0	2	625	14	0	641
9706	1	0	12	656	0	669
9707	659	0	6	16	0	681
9708	16	0	4	694	0	714
9709	6	0	0	778	0	784
9710	3	0	2	753	0	758
9711	0	747	0	33	0	780
9712	0	767	1	8	0	776
9713	740	27	0	3	0	770
9714	20	758	2	0	0	780
9715	759	23	0	0	0	782
9716	760	8	0	0	0	768
9717	763	3	0	3	0	769
9718	30	2	726	1	0	759
9719	11	750	25	0	0	786
9720	773	20	8	3	0	804
9721	24	8	3	792	0	827
9722	10	3	0	825	0	838
9723	4	0	0	811	0	815
9724	0	786	0	31	0	817
9725	1	20	0	806	0	827
9726	841	8	0	27	0	876
9727	21	3	0	856	0	880
9728	9	0	0	872	0	881
9729	3	0	870	31	0	904
9730	0	1	913	12	0	926
9731	0	0	28	899	0	927
9732	1	0	14	929	0	944
9733	0	924	5	35	0	964
9734	3	21	0	929	0	953
9735	0	8	0	951	0	959
9736	0	3	1	971	0	975
9737	913	0	0	35	0	948
9738	22	3	917	11	0	953
9739	9	1	21	930	0	961
9740	941	0	8	22	0	971
9741	924	2	3	10	0	939
9742	31	1	1	907	0	940
9743	16	1	0	928	0	945
9744	908	0	0	35	0	943
9745	19	908	3	14	0	944
9746	9	936	4	4	0	953
9747	7	29	0	948	0	984
9748	954	11	0	23	0	988
9749	974	2	1	11	0	988
9750	956	2	0	7	0	965
9751	34	2	956	1	0	993
9752	871	1	23	8	0	903
9753	27	3	964	2	0	996
9754	909	1	24	5	0	939
9755	22	953	7	6	0	988
9756	10	21	974	4	0	1009
9757	3	8	22	970	0	1003
9758	3	4	983	28	0	1018
9759	1	0	26	990	0	1017
9760	991	5	8	28	0	1032
9761	22	2	1048	15	0	1087
9762	10	2	22	1036	0	1070
9763	4	1080	9	24	0	1117
9764	6	22	5	1101	0	1134
9765	2	10	3	1108	0	1123
9766	3	2	1	1108	0	1114
9767	1082	2	1	36	0	1121
9768	1098	4	0	16	0	1118
9769	32	1	2	1094	0	1129
9770	12	7	1071	26	0	1116
9771	11	3	1061	10	0	1085
9772	5	0	31	1075	0	1111
9773	2	6	1137	26	0	1171
9774	5	1	28	1124	0	1158
9775	8	3	9	1087	0	1107
9776	9	0	3	1116	0	1128
9777	5	1090	5	38	0	1138
9778	2	1106	4	18	0	1130
9779	5	28	1	1130	0	1164
9780	4	10	3	1141	0	1158
9781	6	6	0	1144	0	1156
9782	1093	4	2	34	0	1133
9783	24	4	1120	19	0	1167
9784	11	2	22	1122	0	1157
9785	1120	1	13	23	0	1157
9786	24	1134	6	13	0	1177
9787	12	23	4	1151	0	1190
9788	5	7	7	1176	0	1195
9789	2	5	5	1182	0	1194
9790	6	3	1	1166	0	1176
9791	6	2	1135	40	0	1183
9792	1008	3	25	20	0	1056
9793	1094	0	10	13	0	1117
9794	32	2	1114	5	0	1153
9795	1065	2	21	11	0	1099
9796	1105	1	8	8	0	1122
9797	32	4	1153	4	0	1193
9798	15	1258	25	9	0	1307
9799	11	21	11	1288	0	1331
9800	5	11	1291	24	0	1331
9801	4	1243	25	18	0	1290
9802	3	18	1161	10	0	1192
9803	2	1098	17	7	0	1124
9804	3	19	19	1052	0	1093
9805	0	5	1091	13	0	1109
9806	2	0	8	1040	0	1050
9807	4	4	1110	10	0	1128
9808	1	1079	10	5	0	1095
9809	995	1	1	2	0	999
9810	1	1020	0	0	0	1021
9811	1	1054	2	0	0	1057
9812	0	24	1	1019	0	1044
9813	0	3	0	1115	0	1118
9814	0	0	0	1125	0	1125
9815	0	0	0	1106	0	1106
9816	0	0	1	1131	0	1132
9817	1	1	1257	7	0	1266
9818	0	1	5	1235	0	1241
9819	1	0	3	1284	0	1288
9820	1282	0	1	11	0	1294
9821	1271	0	1	4	0	1276
9822	1271	0	0	1	0	1272
9823	9	1	0	1280	0	1290
9824	1381	1	1	10	0	1393
9825	1528	0	1	14	0	1543
9826	1514	0	1	7	0	1522
9827	15	2	1527	0	0	1544
9828	1478	1	8	0	0	1487
9829	1506	1	9	2	0	1518
9830	1502	1	1	4	0	1508
9831	20	2	0	1464	0	1486
9832	11	3	1482	11	0	1507
9833	1	1	9	1469	0	1480
9834	1552	0	11	18	0	1581
9835	11	1	1	1573	0	1586
9836	11	1808	2	10	0	1831
9837	4	7	1	1911	0	1923
9838	1906	9	1	11	0	1927
9839	1909	0	1	14	0	1924
9840	1896	1	0	7	0	1904
9841	22	3	1995	1	0	2021
9842	15	0	11	1984	0	2010
9843	2	2	10	2088	0	2102
9844	3	1	2100	29	0	2133
9845	6	2034	12	14	0	2066
9846	6	12	2112	6	0	2136
9847	3	10	13	2095	0	2121
9848	2121	1	18	18	0	2158
9849	18	7	2209	14	0	2248
9850	17	0	12	2199	0	2228
9851	6	4	2235	15	0	2260
9852	2126	1	12	15	0	2154
9853	14	2	14	2238	0	2268
9854	17	3	2350	19	0	2389
9855	9	1	12	2320	0	2342
9856	6	3	2427	16	0	2452
9857	2	2405	14	35	0	2456
9858	4	11	15	2419	0	2449
9859	2435	12	3	21	0	2471
9860	15	2	4	2450	0	2471
9861	15	2	2	2418	0	2437
9862	2389	2	5	31	0	2427
9863	15	2325	5	20	0	2365
9864	17	2402	2	9	0	2430
9865	7	27	5	2396	0	2435
9866	4	2419	6	16	0	2445
9867	2	15	5	2457	0	2479
9868	12	15	2	2466	0	2495
9869	2444	2	3	32	0	2481
9870	17	2452	7	23	0	2499
9871	23	20	2474	11	0	2528
9872	7	2548	23	6	0	2584
9873	2506	15	15	11	0	2547
9874	2561	16	7	12	0	2596
9875	26	3	4	2546	0	2579
9876	2649	4	1	20	0	2674
9877	17	2	2	2629	0	2650
9878	2629	5	2	19	0	2655
9879	2742	3	0	24	0	2769
9880	32	3	4	2872	0	2911
9881	2877	4	0	25	0	2906
9882	20	7	2870	20	0	2917
9883	2833	2	18	10	0	2863
9884	19	1	17	2928	0	2965
9885	2995	2	4	22	0	3023
9886	20	3159	9	19	0	3207
9887	21	21	6	3167	0	3215
9888	4	20	4	3201	0	3229
9889	3155	3	4	38	0	3200
9890	28	8	3188	21	0	3245
9891	21	3170	21	11	0	3223
9892	12	16	20	3173	0	3221
9893	11	3202	11	19	0	3243
9894	15	20	3	3216	0	3254
9895	11	18	3	3188	0	3220
9896	3	5	6	3249	0	3263
9897	3162	2	5	44	0	3213
9898	21	3	7	3079	0	3110
9899	3101	4	4	23	0	3132
9900	3147	4	1	35	0	3187
9901	42	2	4	3214	0	3262
9902	3237	4	8	23	0	3272
9903	3151	5	4	35	0	3195
9904	40	8	3277	12	0	3337
9905	28	3	19	3204	0	3254
9906	3336	5	19	24	0	3384
9907	22	3313	13	23	0	3371
9908	3376	22	2	16	0	3416
9909	3367	19	6	12	0	3404
9910	41	10	3324	10	0	3385
9911	22	3	18	3182	0	3225
9912	3571	3	17	33	0	3624
9913	24	2	6	3580	0	3612
9914	26	7	5	3661	0	3699
9915	11	6	3	3657	0	3677
9916	13	0	3	3997	0	4013
9917	3985	7	3	58	0	4053
9918	38	14	4138	45	0	4235
9919	50	3	36	4346	0	4435
9920	13	8	4726	54	0	4801
9921	14	13	4903	60	0	4990
9922	4686	0	132	29	0	4847
9923	86	17	5237	13	0	5353
9924	74	5132	86	15	0	5307
9925	5205	93	83	20	0	5401
9926	5371	83	9	15	0	5478
9927	177	8	5	5176	0	5366
9928	98	13	5393	88	0	5592
9929	25	12	5399	86	0	5522
9930	5459	6	173	25	0	5663
9931	100	5	103	5619	0	5827
9932	5752	4	10	90	0	5856
9933	95	5841	21	103	0	6060
9934	5920	84	14	18	0	6036
9935	5814	101	3	24	0	5942
9936	190	5627	17	11	0	5845
9937	123	90	6	5591	0	5810
9938	5553	104	9	104	0	5770
9939	109	33	5580	125	0	5847
9940	120	5610	104	24	0	5858
9941	32	100	113	5555	0	5800
9942	5545	113	22	101	0	5781
9943	94	5652	26	117	0	5889
9944	5884	85	16	26	0	6011
9945	119	160	5768	6	0	6053
9946	5671	19	101	29	0	5820
9947	120	18	5827	20	0	5985
9948	5681	13	108	13	0	5815
9949	5664	13	122	16	0	5815
9950	229	18	5633	15	0	5895
9951	141	5657	108	29	0	5935
9952	38	99	132	5513	0	5782
9953	24	127	5737	112	0	6000
9954	42	5649	110	126	0	5927
9955	35	102	130	5516	0	5783
9956	38	130	30	5683	0	5881
9957	45	35	5543	230	0	5853
9958	54	15	120	5460	0	5649
9959	44	23	133	5600	0	5800
9960	39	31	5502	229	0	5801
9961	36	14	129	5270	0	5449
9962	34	5474	159	115	0	5782
9963	5501	99	50	127	0	5777
9964	132	125	53	5346	0	5656
9965	154	5507	46	115	0	5822
9966	74	106	51	5062	0	5293
9967	55	5674	52	106	0	5887
9968	73	134	5556	123	0	5886
9969	57	5687	162	44	0	5950
9970	5601	128	162	29	0	5920
9971	5606	138	54	47	0	5845
9972	5791	32	48	53	0	5924
9973	277	46	5623	47	0	5993
9974	182	36	5594	48	0	5860
9975	65	5802	275	43	0	6185
9976	82	140	160	5302	0	5684
9977	63	6012	73	143	0	6291
9978	106	173	45	5130	0	5454
9979	82	5893	60	132	0	6167
9980	5863	172	52	140	0	6227
9981	6226	165	37	62	0	6490
9982	313	58	49	6357	0	6777
9983	213	48	6284	179	0	6724
9984	6016	54	173	188	0	6431
9985	191	6304	216	60	0	6771
9986	213	180	74	6079	0	6546
9987	113	189	44	5857	0	6203
9988	89	6251	66	294	0	6700
9989	6316	175	49	185	0	6725
9990	214	205	6218	45	0	6682
9991	214	65	185	6211	0	6675
9992	6313	51	193	176	0	6733
9993	6258	56	80	195	0	6589
9994	354	6411	62	57	0	6884
9995	242	177	60	6122	0	6601
9996	92	6589	70	172	0	6923
9997	6497	208	57	193	0	6955
9998	208	187	6556	84	0	7035
9999	195	89	6595	73	0	6952
10000	105	65	303	6366	0	6839
10001	66	69	209	6218	0	6562
10002	82	6452	74	320	0	6928
10003	77	182	81	6542	0	6882
10004	77	192	6385	209	0	6863
10005	6117	73	189	220	0	6599
10006	200	58	184	6361	0	6803
10007	189	73	6329	206	0	6797
10008	81	78	176	6408	0	6743
10009	64	61	202	6127	0	6454
10010	59	6270	79	331	0	6739
10011	75	183	50	6400	0	6708
10012	67	201	55	6142	0	6465
10013	85	62	51	6224	0	6422
10014	5786	53	76	320	0	6235
10015	178	5746	65	211	0	6200
10016	178	5570	47	75	0	5870
10017	5174	236	41	66	0	5517
10018	4868	165	45	59	0	5137
10019	222	4674	44	46	0	4986
10020	121	4335	40	27	0	4523
10021	3919	159	8	40	0	4126
10022	93	3973	25	24	0	4115
10023	93	3933	21	25	0	4072
10024	3759	175	12	31	0	3977
10025	85	3813	21	24	0	3943
10026	3758	98	17	23	0	3896
10027	3704	83	13	39	0	3839
10028	3662	42	19	29	0	3752
10029	159	3630	16	30	0	3835
10030	92	3614	23	29	0	3758
10031	44	134	14	3415	0	3607
10032	40	3646	20	78	0	3784
10033	41	96	14	3596	0	3747
10034	3568	84	11	93	0	3756
10035	87	42	18	3533	0	3680
10036	79	3509	25	101	0	3714
10037	3429	87	20	72	0	3608
10038	90	3462	19	52	0	3623
10039	77	3600	28	30	0	3735
10040	43	133	14	3373	0	3563
10041	28	3530	28	74	0	3660
10042	3453	90	14	76	0	3633
10043	81	86	3362	40	0	3569
10044	74	3295	83	40	0	3492
10045	42	79	58	3303	0	3482
10046	37	74	3287	92	0	3490
10047	26	44	72	3209	0	3351
10048	32	27	65	3242	0	3366
10049	34	34	32	3346	0	3446
10050	36	35	19	3305	0	3395
10051	27	29	3176	161	0	3393
10052	25	3165	83	107	0	3380
10053	3116	80	64	73	0	3333
10054	85	75	3108	51	0	3319
10055	3097	45	71	59	0	3272
10056	84	33	3172	48	0	3337
10057	74	34	84	3152	0	3344
10058	51	30	3138	96	0	3315
10059	45	41	3273	83	0	3442
10060	34	33	125	3237	0	3429
10061	45	39	84	3149	0	3317
10062	41	28	28	3372	0	3469
10063	36	42	29	3372	0	3479
10064	3249	41	20	148	0	3458
10065	89	41	3329	108	0	3567
10066	3277	36	65	59	0	3437
10067	3318	35	49	52	0	3454
10068	3308	36	23	53	0	3420
10069	3332	42	10	36	0	3420
10070	3311	35	11	32	0	3389
10071	175	27	12	3144	0	3358
10072	94	45	2973	70	0	3182
10073	68	33	2919	59	0	3079
10074	45	2976	96	35	0	3152
10075	2796	73	73	23	0	2965
10076	60	95	46	2746	0	2947
10077	57	42	16	2629	0	2744
10078	31	2637	24	96	0	2788
10079	30	2659	15	64	0	2768
10080	30	2600	10	30	0	2670
10081	2218	84	14	31	0	2347
10082	26	28	5	1955	0	2014
10083	24	1976	8	26	0	2034
10084	14	23	6	1989	0	2032
10085	8	26	1957	32	0	2023
10086	18	12	1964	22	0	2016
10087	10	6	39	2161	0	2216
10088	2259	10	23	37	0	2329
10089	2359	9	7	37	0	2412
10090	2389	8	7	18	0	2422
10091	69	13	2362	17	0	2461
10092	42	11	38	2325	0	2416
10093	21	12	30	2427	0	2490
10094	14	14	2291	70	0	2389
10095	2080	12	42	43	0	2177
10096	46	17	2294	23	0	2380
10097	45	15	2253	23	0	2336
10098	21	5	2236	16	0	2278
10099	14	8	75	2094	0	2191
10100	11	9	47	2146	0	2213
10101	14	10	2210	80	0	2314
10102	12	11	54	2216	0	2293
10103	2217	8	52	56	0	2333
10104	45	8	22	2311	0	2386
10105	41	14	2254	75	0	2384
10106	22	9	2457	67	0	2555
10107	13	10	90	2354	0	2467
10108	2517	12	49	56	0	2634
10109	72	2644	24	51	0	2791
10110	2742	51	26	27	0	2846
10111	2774	42	24	28	0	2868
10112	105	20	2825	27	0	2977
10113	63	7	76	2793	0	2939
10114	2863	5	62	88	0	3018
10115	2781	11	42	64	0	2898
10116	113	2811	32	46	0	3002
10117	75	52	34	2830	0	2991
10118	27	42	40	2915	0	3024
10119	25	20	2801	124	0	2970
10120	38	8	72	2797	0	2915
10121	31	9	2829	96	0	2965
10122	36	14	2821	70	0	2941
10123	38	7	120	2834	0	2999
10124	2856	0	69	96	0	3021
10125	85	2794	44	70	0	2993
10126	2843	57	38	45	0	2983
10127	2800	42	31	36	0	2909
10128	109	2746	43	34	0	2932
10129	71	59	37	2562	0	2729
10130	2587	51	35	64	0	2737
10131	90	2581	21	52	0	2744
10132	2425	56	18	37	0	2536
10133	89	2420	21	24	0	2554
10134	57	62	22	2333	0	2474
10135	39	38	17	2395	0	2489
10136	2388	15	21	99	0	2523
10137	2338	20	13	70	0	2441
10138	114	2333	19	47	0	2513
10139	68	57	2293	36	0	2454
10140	29	42	2299	41	0	2411
10141	24	12	107	2146	0	2289
10142	29	2318	63	76	0	2486
10143	36	53	39	2442	0	2570
10144	26	46	33	2459	0	2564
10145	33	23	34	2515	0	2605
10146	34	13	2457	112	0	2616
10147	29	21	2406	75	0	2531
10148	33	2470	97	38	0	2638
10149	33	67	56	2449	0	2605
10150	35	50	22	2624	0	2731
10151	39	29	2540	119	0	2727
10152	2102	26	82	77	0	2287
10153	92	22	62	2598	0	2774
10154	64	30	2630	94	0	2818
10155	2390	21	76	86	0	2573
10156	80	2600	53	66	0	2799
10157	87	79	2681	35	0	2882
10158	64	46	77	2682	0	2869
10159	2599	37	65	74	0	2775
10160	81	25	2637	70	0	2813
10161	70	19	82	2613	0	2784
10162	45	25	62	2790	0	2922
10163	27	26	42	3067	0	3162
10164	3071	23	32	151	0	3277
10165	85	2978	25	107	0	3195
10166	68	70	44	3009	0	3191
10167	32	69	2970	114	0	3185
10168	24	33	99	2878	0	3034
10169	27	2853	86	112	0	3078
10170	28	3040	40	86	0	3194
10171	2967	123	31	50	0	3171
10172	3002	75	23	49	0	3149
10173	139	38	2971	45	0	3193
10174	2932	19	88	49	0	3088
10175	108	2986	80	37	0	3211
10176	3024	92	30	37	0	3183
10177	116	67	21	2989	0	3193
10178	93	47	3017	101	0	3258
10179	52	30	86	3029	0	3197
10180	51	27	3060	108	0	3246
10181	2949	39	95	92	0	3175
10182	85	22	76	3014	0	3197
10183	78	3107	40	125	0	3350
10184	58	93	29	3197	0	3377
10185	31	78	3049	115	0	3273
10186	35	3071	98	87	0	3291
10187	2820	74	58	47	0	2999
10188	72	2750	28	41	0	2891
10189	45	2698	23	26	0	2792
10190	30	123	16	2506	0	2675
10191	15	2720	27	60	0	2822
10192	6	72	16	2671	0	2765
10193	15	45	2641	68	0	2769
10194	2311	25	58	43	0	2437
10195	2518	17	37	24	0	2596
10196	88	16	2498	23	0	2625
10197	2392	8	57	21	0	2478
10198	63	2470	42	19	0	2594
10199	2514	51	21	20	0	2606
10200	70	37	15	2429	0	2551
10201	38	17	2545	62	0	2662
10202	22	2623	49	44	0	2738
10203	21	53	45	2633	0	2752
10204	11	33	17	2653	0	2714
10205	2570	13	12	90	0	2685
10206	2415	7	10	52	0	2484
10207	85	2432	11	16	0	2544
10208	39	2213	9	11	0	2272
10209	10	2166	12	10	0	2198
10210	10	51	3	2086	0	2150
10211	2094	33	3	28	0	2158
10212	2060	9	3	33	0	2105
10213	50	4	6	2049	0	2109
10214	30	5	9	2024	0	2068
10215	1988	5	2	51	0	2046
10216	27	8	4	2051	0	2090
10217	28	11	2055	29	0	2123
10218	1981	2	22	32	0	2037
10219	2053	8	26	8	0	2095
10220	53	10	2067	8	0	2138
10221	2073	9	23	6	0	2111
10222	31	7	78	2055	0	2171
10223	32	4	5	2003	0	2044
10224	8	6	6	2040	0	2060
10225	1970	7	5	51	0	2033
10226	24	2022	7	35	0	2088
10227	29	28	4	2020	0	2081
10228	10	2027	4	27	0	2068
10229	2009	24	7	32	0	2072
10230	33	26	3	2041	0	2103
10231	27	8	5	2023	0	2063
10232	13	2017	8	44	0	2082
10233	13	32	1956	28	0	2029
10234	7	24	27	2019	0	2077
10235	2030	11	23	32	0	2096
10236	2211	6	7	31	0	2255
10237	63	10	2292	12	0	2377
10238	44	7	40	2258	0	2349
10239	12	2364	46	39	0	2461
10240	12	42	8	2394	0	2456
10241	2386	44	9	49	0	2488
10242	2370	10	5	53	0	2438
10243	81	8	7	2297	0	2393
10244	54	2303	8	42	0	2407
10245	2438	42	8	46	0	2534
10246	45	43	4	2478	0	2570
10247	2475	16	4	49	0	2544
10248	2566	11	4	59	0	2640
10249	89	11	4	2598	0	2702
10250	61	7	3	2564	0	2635
10251	20	7	2	2680	0	2709
10252	9	2629	6	100	0	2744
10253	13	42	3	2596	0	2654
10254	15	45	5	2562	0	2627
10255	11	13	2450	90	0	2564
10256	9	12	2390	61	0	2472
10257	17	4	83	2374	0	2478
10258	2347	9	52	49	0	2457
10259	42	2388	14	54	0	2498
10260	2374	42	4	18	0	2438
10261	57	53	2336	14	0	2460
10262	49	10	2213	15	0	2287
10263	14	2064	75	9	0	2162
10264	4	32	58	2054	0	2148
10265	4	36	2079	32	0	2151
10266	6	12	2171	40	0	2229
10267	6	2	62	2161	0	2231
10268	2181	4	37	37	0	2259
10269	2175	2	7	39	0	2223
10270	62	3	3	2192	0	2260
10271	44	8	2440	37	0	2529
10272	16	8	29	2513	0	2566
10273	12	5	31	2450	0	2498
10274	9	2507	14	62	0	2592
10275	2502	30	6	46	0	2584
10276	2471	30	8	23	0	2532
10277	61	2551	9	12	0	2633
10278	42	39	3	2387	0	2471
10279	12	2534	4	38	0	2588
10280	2517	40	2	38	0	2597
10281	42	38	2487	13	0	2580
10282	30	15	2412	17	0	2474
10283	12	13	2332	7	0	2364
10284	12	3	53	2278	0	2346
10285	11	3	35	2315	0	2364
10286	2308	2	10	53	0	2373
10287	30	2	7	2319	0	2358
10288	32	7	5	2416	0	2460
10289	15	12	2649	59	0	2735
10290	7	14	2589	43	0	2653
10291	2499	9	52	16	0	2576
10292	30	2605	42	11	0	2688
10293	2702	29	11	18	0	2760
10294	34	26	10	2694	0	2764
10295	37	8	9	2669	0	2723
10296	16	2678	3	58	0	2755
10297	13	25	7	2701	0	2746
10298	2655	31	7	42	0	2735
10299	34	11	7	2704	0	2756
10300	32	14	2660	47	0	2753
10301	17	2535	35	36	0	2623
10302	2568	31	33	21	0	2653
10303	2597	34	11	24	0	2666
10304	2617	11	10	11	0	2649
10305	2653	6	10	15	0	2684
10306	69	5	5	2601	0	2680
10307	48	10	6	2615	0	2679
10308	20	9	2693	60	0	2782
10309	7	5	34	2723	0	2769
10310	12	14	2717	45	0	2788
10311	9	3	33	2729	0	2774
10312	2691	7	30	42	0	2770
10313	35	2787	12	44	0	2878
10314	45	29	5	2975	0	3054
10315	17	33	12	3048	0	3110
10316	2980	15	9	71	0	3075
10317	2923	6	6	61	0	2996
10318	58	18	3081	25	0	3182
10319	50	3112	44	9	0	3215
10320	17	28	38	3092	0	3175
10321	10	34	17	3111	0	3172
10322	3073	12	12	69	0	3166
10323	3026	10	4	59	0	3099
10324	67	9	3097	27	0	3200
10325	43	11	3155	7	0	3216
10326	20	6	63	3165	0	3254
10327	9	5	41	3226	0	3281
10328	13	11	3183	63	0	3270
10329	2989	6	38	49	0	3082
10330	44	1	35	3187	0	3267
10331	3241	10	14	44	0	3309
10332	47	3220	15	49	0	3331
10333	3307	35	6	37	0	3385
10334	50	44	3642	15	0	3751
10335	43	3587	49	11	0	3690
10336	7	3443	27	8	0	3485
10337	3355	38	7	14	0	3414
10338	3301	14	1	8	0	3324
10339	44	3	1	3267	0	3315
10340	19	3318	11	29	0	3377
10341	3	3419	6	17	0	3445
10342	4	45	1	3462	0	3512
10343	3505	22	1	45	0	3573
10344	3496	2	2	34	0	3534
10345	56	8	3369	4	0	3437
10346	3237	0	28	7	0	3272
10347	37	3806	24	1	0	3868
10348	3827	56	1	6	0	3890
10349	61	4683	10	4	0	4758
10350	33	5132	5	3	0	5173
10351	8	180	2	5399	0	5589
10352	5697	89	10	147	0	5943
10353	5834	14	4	108	0	5960
10354	267	16	5638	22	0	5943
10355	139	2	144	5664	0	5949
10356	5789	2	115	163	0	6069
10357	157	5	20	5959	0	6141
10358	5947	2	7	169	0	6125
10359	5959	2	7	128	0	6096
10360	272	19	5809	23	0	6123
10361	145	5	149	5713	0	6012
10362	39	2	116	5936	0	6093
10363	22	2	20	6081	0	6125
10364	18	6	5731	286	0	6041
10365	10	2	158	5780	0	5950
10366	23	2	119	5522	0	5666
10367	9	5579	27	260	0	5875
10368	24	163	5548	137	0	5872
10369	6	5757	165	31	0	5959
10370	5618	168	121	27	0	5934
10371	169	124	19	5336	0	5648
10372	142	26	12	5152	0	5332
10373	31	5318	20	262	0	5631
10374	5311	151	12	147	0	5621
10375	5410	123	6	42	0	5581
10376	280	5266	19	21	0	5586
10377	149	5453	17	24	0	5643
10378	5363	274	11	21	0	5669
10379	179	155	5298	34	0	5666
10380	152	48	5325	24	0	5549
10381	5121	20	291	31	0	5463
10382	175	5277	152	17	0	5621
10383	5367	169	32	37	0	5605
10384	200	144	5273	26	0	5643
10385	5301	46	158	43	0	5548
10386	199	5344	146	28	0	5717
10387	165	176	28	5364	0	5733
10388	71	134	26	5469	0	5700
10389	56	34	25	5232	0	5347
10390	50	16	30	5332	0	5428
10391	46	20	17	5122	0	5205
10392	47	5048	31	319	0	5445
10393	5031	164	21	191	0	5407
10394	207	149	5005	51	0	5412
10395	168	37	169	5068	0	5442
10396	57	38	5149	204	0	5448
10397	49	26	189	5142	0	5406
10398	36	24	162	5225	0	5447
10399	5007	20	44	347	0	5418
10400	195	33	5047	183	0	5458
10401	153	5001	196	75	0	5425
10402	54	177	164	5026	0	5421
10403	53	155	36	5177	0	5421
10404	45	74	5011	310	0	5440
10405	53	41	172	5086	0	5352
10406	43	39	149	5191	0	5422
10407	4907	46	34	332	0	5319
10408	190	4862	42	208	0	5302
10409	5016	187	23	76	0	5302
10410	5073	159	28	55	0	5315
10411	336	62	20	4895	0	5313
10412	197	45	4865	199	0	5306
10413	78	55	4929	168	0	5230
10414	66	45	306	4616	0	5033
10415	70	39	172	4465	0	4746
10416	46	4605	76	295	0	5022
10417	4548	174	44	175	0	4941
10418	202	4519	57	64	0	4842
10419	184	4575	44	56	0	4859
10420	4450	306	38	65	0	4859
10421	213	166	34	4390	0	4803
10422	166	4599	48	207	0	5020
10423	73	178	25	4719	0	4995
10424	45	157	4520	252	0	4974
10425	38	43	4564	213	0	4858
10426	43	38	294	4484	0	4859
10427	43	43	4581	225	0	4892
10428	46	39	199	4564	0	4848
10429	68	26	155	4563	0	4812
10430	42	40	66	4662	0	4810
10431	4300	23	45	344	0	4712
10432	169	4206	46	220	0	4641
10433	150	4313	49	95	0	4607
10434	4014	272	48	65	0	4399
10435	4154	165	35	67	0	4421
10436	296	58	33	4033	0	4420
10437	184	49	3962	193	0	4388
10438	54	43	174	4084	0	4355
10439	49	41	4065	220	0	4375
10440	56	3919	194	180	0	4349
10441	58	158	138	3948	0	4302
10442	3927	144	46	178	0	4295
10443	178	47	37	3966	0	4228
10444	160	46	3800	196	0	4202
10445	3712	28	165	163	0	4068
10446	168	33	3919	75	0	4195
10447	148	22	3630	68	0	3868
10448	44	3450	234	52	0	3780
10449	33	2482	116	24	0	2655
10450	28	2201	29	15	0	2273
10451	1446	121	54	72	0	1693
10452	1279	6	1	4	0	1290
10453	11	4	1	1320	0	1336
10454	10	2	1	1340	0	1353
10455	4	1	0	1397	0	1402
10456	3	1373	3	13	0	1392
10457	1386	8	0	8	0	1402
10458	9	1380	3	7	0	1399
10459	7	10	0	1387	0	1404
10460	1357	5	3	12	0	1377
10461	7	2	1	1357	0	1367
10462	8	1	4	1383	0	1396
10463	1391	0	3	17	0	1411
10464	1389	1	3	11	0	1404
10465	13	7	1403	8	0	1431
10466	8	10	1393	1	0	1412
10467	6	4	1465	1	0	1476
10468	4	1	15	1469	0	1489
10469	2	3	9	1479	0	1493
10470	1	1505	3	15	0	1524
10471	1512	10	1	15	0	1538
10472	9	8	2	1571	0	1590
10473	12	1	2	1595	0	1610
10474	6	1653	4	22	0	1685
10475	2	1797	2	15	0	1816
10476	2	20	1	1879	0	1902
10477	2	11	1	2160	0	2174
10478	2142	6	1	35	0	2184
10479	2143	1	2	22	0	2168
10480	44	2	0	2140	0	2186
10481	25	5	2169	24	0	2223
10482	11	9	2220	27	0	2267
10483	7	1	37	2281	0	2326
10484	6	1	23	2258	0	2288
10485	4	2280	11	37	0	2332
10486	2241	16	5	27	0	2289
10487	20	20	6	2235	0	2281
10488	16	13	2287	25	0	2341
10489	4	3	19	2303	0	2329
10490	12	8	2309	29	0	2358
10491	7	10	2312	27	0	2356
10492	4	2	51	2317	0	2374
10493	2331	3	24	30	0	2388
10494	18	11	2318	27	0	2374
10495	22	1	22	2267	0	2312
10496	4	13	2526	31	0	2574
10497	4	3	23	2522	0	2552
10498	13	2	22	2541	0	2578
10499	4	6	2536	46	0	2592
10500	3	5	2472	31	0	2511
10501	6	14	47	2290	0	2357
10502	9	0	29	2506	0	2544
10503	5	1	20	2518	0	2544
10504	3	1	4	2530	0	2538
10505	2479	6	5	48	0	2538
10506	2482	2	5	36	0	2525
10507	40	2491	6	15	0	2552
10508	2509	18	5	14	0	2546
10509	27	27	3	2509	0	2566
10510	2529	5	4	25	0	2563
10511	28	11	2553	32	0	2624
10512	2562	4	25	11	0	2602
10513	30	3	27	2601	0	2661
10514	34	1	9	2771	0	2815
10515	2858	3	3	65	0	2929
10516	29	4	7	3143	0	3183
10517	34	12	3262	47	0	3355
10518	3252	1	42	51	0	3346
10519	41	3391	57	16	0	3505
10520	45	40	12	3465	0	3562
10521	18	48	3680	46	0	3792
10522	9	11	44	3596	0	3660
10523	8	11	3657	54	0	3730
10524	9	4	49	3676	0	3738
10525	4	3660	73	52	0	3789
10526	10	46	11	3655	0	3722
10527	6	3981	12	74	0	4073
10528	11	59	7	3759	0	3836
10529	11	69	9	4184	0	4273
10530	19	11	5	4262	0	4297
10531	14	2	15	4252	0	4283
10532	18	1	9	4283	0	4311
10533	11	14	4107	161	0	4293
10534	17	5	71	4191	0	4284
10535	12	6	80	4203	0	4301
10536	4164	8	23	154	0	4349
10537	70	4178	18	105	0	4371
10538	4257	72	7	40	0	4376
10539	85	84	13	4198	0	4380
10540	88	27	4137	90	0	4342
10541	20	4110	77	112	0	4319
10542	4090	69	90	44	0	4293
10543	73	4202	29	23	0	4327
10544	84	4280	30	29	0	4423
10545	4193	141	8	28	0	4370
10546	68	91	9	4448	0	4616
10547	4410	17	10	105	0	4542
10548	92	6	15	4309	0	4422
10549	97	14	4273	111	0	4495
10550	19	13	4250	116	0	4398
10551	4066	9	178	38	0	4291
10552	4315	8	109	30	0	4462
10553	175	4	20	4225	0	4424
10554	110	12	14	4287	0	4423
10555	4041	13	9	196	0	4259
10556	87	4077	23	123	0	4310
10557	98	4192	16	41	0	4347
10558	4188	169	14	28	0	4399
10559	4186	100	11	45	0	4342
10560	175	4159	25	18	0	4377
10561	106	91	10	4155	0	4362
10562	34	112	4130	96	0	4372
10563	28	28	4132	111	0	4299
10564	3905	13	168	47	0	4133
10565	97	13	4180	29	0	4319
10566	117	12	97	4012	0	4238
10567	39	17	90	3965	0	4111
10568	16	4024	39	192	0	4271
10569	4004	85	22	110	0	4221
10570	99	92	19	4033	0	4243
10571	115	29	3994	99	0	4237
10572	26	3942	95	131	0	4194
10573	28	92	99	3938	0	4157
10574	25	103	3873	104	0	4105
10575	32	30	3776	100	0	3938
10576	19	3659	172	49	0	3899
10577	3304	80	91	28	0	3503
10578	82	3443	34	26	0	3585
10579	3447	91	15	31	0	3584
10580	98	85	3361	29	0	3573
10581	3262	27	77	29	0	3395
10582	90	3276	91	35	0	3492
10583	83	79	21	3262	0	3445
10584	26	76	13	3390	0	3505
10585	3294	23	23	166	0	3506
10586	80	24	3297	112	0	3513
10587	3265	17	88	45	0	3415
10588	3291	15	83	34	0	3423
10589	153	26	3189	32	0	3400
10590	113	18	3219	42	0	3392
10591	42	20	140	3153	0	3355
10592	3202	19	91	104	0	3416
10593	3242	31	33	93	0	3399
10594	153	3237	29	30	0	3449
10595	112	78	19	3271	0	3480
10596	39	87	21	3137	0	3284
10597	35	35	20	3212	0	3302
10598	38	22	15	3253	0	3328
10599	3107	17	23	169	0	3316
10600	92	24	24	3181	0	3321
10601	108	26	3072	113	0	3319
10602	45	25	3071	101	0	3242
10603	2864	17	144	42	0	3067
10604	93	3005	109	35	0	3242
10605	97	3088	53	26	0	3264
10606	52	145	25	3060	0	3282
10607	54	91	20	3133	0	3298
10608	42	30	30	3165	0	3267
10609	31	16	23	3210	0	3280
10610	32	22	3072	168	0	3294
10611	34	21	83	3020	0	3158
10612	47	22	84	3017	0	3170
10613	33	26	2889	150	0	3098
10614	2537	18	82	102	0	2739
10615	79	2626	88	39	0	2832
10616	2372	62	22	35	0	2491
10617	73	58	2232	26	0	2389
10618	68	21	2149	30	0	2268
10619	27	2128	111	28	0	2294
10620	2096	52	121	27	0	2296
10621	1956	44	21	21	0	2042
10622	1915	14	11	22	0	1962
10623	100	1878	17	15	0	2010
10624	1811	48	15	15	0	1889
10625	66	46	1789	12	0	1913
10626	41	1794	52	19	0	1906
10627	1736	39	34	21	0	1830
10628	49	1781	20	18	0	1868
10629	1664	41	9	18	0	1732
10630	1601	29	12	12	0	1654
10631	78	11	1679	15	0	1783
10632	38	1682	51	15	0	1786
10633	1628	35	40	15	0	1718
10634	42	33	1627	17	0	1719
10635	33	1664	43	14	0	1754
10636	24	32	29	1597	0	1682
10637	9	34	1595	34	0	1672
10638	10	9	1564	33	0	1616
10639	3	5	57	1543	0	1608
10640	1533	4	31	38	0	1606
10641	37	1549	10	36	0	1632
10642	33	33	1449	14	0	1529
10643	14	27	1435	15	0	1491
10644	1323	7	50	16	0	1396
10645	31	1489	35	4	0	1559
10646	1223	15	5	1	0	1244
10647	19	1271	2	0	0	1292
10648	1311	23	6	3	0	1343
10649	1266	13	0	4	0	1283
10650	28	1258	7	2	0	1295
10651	15	15	7	1274	0	1311
10652	1388	15	2	18	0	1423
10653	17	4	5	1416	0	1442
10654	12	5	5	1453	0	1475
10655	1439	2	3	32	0	1476
10656	15	1436	9	20	0	1480
10657	1476	14	7	9	0	1506
10658	17	14	1459	4	0	1494
10659	16	3	19	1459	0	1497
10660	5	5	17	1519	0	1546
10661	1542	4	5	29	0	1580
10662	1559	3	7	18	0	1587
10663	31	5	3	1558	0	1597
10664	20	7	1625	19	0	1671
10665	7	5	14	1634	0	1660
10666	14	3	15	1638	0	1670
10667	10	6	4	1684	0	1704
10668	6	3	3	1684	0	1696
10669	1624	3	4	34	0	1665
10670	24	7	1682	23	0	1736
10671	22	1714	16	9	0	1761
10672	9	20	15	1674	0	1718
10673	7	13	4	1798	0	1822
10674	12	8	1748	36	0	1804
10675	8	9	1709	23	0	1749
10676	9	2	30	1699	0	1740
10677	8	4	20	1695	0	1727
10678	13	8	1646	33	0	1700
10679	8	4	17	1644	0	1673
10680	1647	3	20	27	0	1697
10681	20	1724	6	19	0	1769
10682	16	24	1704	10	0	1754
10683	10	1749	24	10	0	1793
10684	6	21	22	1765	0	1814
10685	5	25	1755	30	0	1815
10686	5	1803	21	33	0	1862
10687	9	20	22	1839	0	1890
10688	11	17	1871	25	0	1924
10689	15	4	22	1837	0	1878
10690	5	9	21	1860	0	1895
10691	1865	3	8	45	0	1921
10692	23	5	10	1871	0	1909
10693	1851	5	7	37	0	1900
10694	1788	3	42	24	0	1857
10695	1833	9	6	15	0	1863
10696	46	3	4	1807	0	1860
10697	28	6	1804	22	0	1860
10698	8	9	1747	30	0	1794
10699	1692	4	38	16	0	1750
10700	28	11	1822	5	0	1866
10701	1727	7	24	13	0	1771
10702	24	1840	20	13	0	1897
10703	1862	21	10	11	0	1904
10704	27	25	1884	11	0	1947
10705	19	5	1975	16	0	2015
10706	10	3	50	2044	0	2107
10707	6	3	2167	46	0	2222
10708	9	8	2207	42	0	2266
10709	9	0	69	2297	0	2375
10710	13	4	33	2418	0	2468
10711	10	3	6	2460	0	2479
10712	8	2478	10	96	0	2592
10713	15	53	8	2437	0	2513
10714	6	2596	9	57	0	2668
10715	2577	48	10	52	0	2687
10716	2646	45	10	20	0	2721
10717	94	8	14	2533	0	2649
10718	50	2599	11	58	0	2718
10719	14	63	2616	50	0	2743
10720	2552	49	62	20	0	2683
10721	57	8	53	2561	0	2679
10722	55	5	10	2604	0	2674
10723	12	8	11	2644	0	2675
10724	2513	3	18	108	0	2642
10725	60	2489	10	66	0	2625
10726	47	2536	18	26	0	2627
10727	2369	82	11	12	0	2474
10728	43	2429	11	14	0	2497
10729	2463	48	7	16	0	2534
10730	2404	45	10	11	0	2470
10731	87	2432	10	14	0	2543
10732	56	50	7	2366	0	2479
10733	12	2479	14	48	0	2553
10734	15	49	14	2460	0	2538
10735	11	42	9	2580	0	2642
10736	2582	8	11	100	0	2701
10737	2637	8	14	65	0	2724
10738	102	5	15	2653	0	2775
10739	64	7	2621	69	0	2761
10740	2493	7	58	69	0	2627
10741	61	2606	56	26	0	2749
10742	53	58	22	2610	0	2743
10743	21	51	13	2686	0	2771
10744	17	21	14	2725	0	2777
10745	2536	13	8	127	0	2684
10746	2510	19	12	78	0	2619
10747	95	2406	20	40	0	2561
10748	67	2432	15	28	0	2542
10749	32	99	8	2394	0	2533
10750	30	61	9	2435	0	2535
10751	23	22	2380	119	0	2544
10752	22	16	55	2326	0	2419
10753	23	14	2292	76	0	2405
10754	23	17	2205	63	0	2308
10755	20	2215	103	40	0	2378
10756	59	58	60	2195	0	2372
10757	2192	53	17	71	0	2333
10758	75	18	12	2207	0	2312
10759	62	25	2156	74	0	2317
10760	2025	25	51	61	0	2162
10761	2096	17	41	32	0	2186
10762	107	27	2010	27	0	2171
10763	76	14	52	2096	0	2238
10764	2050	16	50	69	0	2185
10765	83	2028	15	63	0	2189
10766	2183	65	10	39	0	2297
10767	2217	59	16	37	0	2329
10768	118	22	12	2198	0	2350
10769	68	17	13	2273	0	2371
10770	2205	19	13	123	0	2360
10771	82	17	6	2241	0	2346
10772	66	18	2165	99	0	2348
10773	2000	12	64	80	0	2156
10774	2112	16	51	36	0	2215
10775	127	2053	25	28	0	2233
10776	74	2141	11	28	0	2254
10777	35	116	14	2035	0	2200
10778	20	2141	20	82	0	2263
10779	27	76	13	2157	0	2273
10780	2116	53	14	97	0	2280
10781	2080	21	22	73	0	2196
10782	112	2027	23	42	0	2204
10783	2009	72	17	25	0	2123
10784	70	2012	17	32	0	2131
10785	2008	69	15	32	0	2124
10786	1963	49	17	34	0	2063
10787	117	19	1875	29	0	2040
10788	1849	10	69	33	0	1961
10789	88	1800	64	14	0	1966
10790	70	1880	28	23	0	2001
10791	1875	101	16	20	0	2012
10792	87	57	13	1884	0	2041
10793	67	27	1891	78	0	2063
10794	41	20	61	1946	0	2068
10795	37	20	47	1948	0	2052
10796	35	12	1886	123	0	2056
10797	1783	12	65	86	0	1946
10798	84	1886	51	41	0	2062
10799	1960	62	16	34	0	2072
10800	95	55	19	1867	0	2036
10801	1901	26	10	75	0	2012
10802	99	1814	17	62	0	1992
10803	77	68	4	1826	0	1975
10804	1804	51	9	79	0	1943
10805	80	24	1713	73	0	1890
10806	56	21	1562	32	0	1671
10807	1416	14	74	27	0	1531
10808	56	1478	44	18	0	1596
10809	40	1292	13	13	0	1358
10810	30	62	6	1201	0	1299
10811	18	1274	4	40	0	1336
10812	34	52	9	1224	0	1319
10813	14	29	2	1251	0	1296
10814	15	12	10	1241	0	1278
10815	16	1180	19	53	0	1268
10816	15	28	5	1150	0	1198
10817	14	29	1078	37	0	1158
10818	17	996	23	18	0	1054
10819	10	32	16	921	0	979
10820	13	1005	14	26	0	1058
10821	992	30	5	23	0	1050
10822	1013	20	6	15	0	1054
10823	1021	8	11	11	0	1051
10824	46	1013	11	17	0	1087
10825	33	25	9	1024	0	1091
10826	20	27	1014	28	0	1089
10827	16	19	1014	21	0	1070
10828	1001	10	35	18	0	1064
10829	1025	4	21	19	0	1069
10830	43	8	14	1080	0	1145
10831	33	10	5	1041	0	1089
10832	17	7	1017	69	0	1110
10833	10	1010	40	34	0	1094
10834	16	1031	32	18	0	1097
10835	8	47	907	8	0	970
10836	11	32	29	835	0	907
10837	6	8	30	796	0	840
10838	6	9	2	898	0	915
10839	8	5	4	897	0	914
10840	863	6	3	45	0	917
10841	34	6	844	19	0	903
10842	851	7	30	5	0	893
10843	33	4	18	862	0	917
10844	867	9	1	24	0	901
10845	36	4	4	876	0	920
10846	22	11	859	27	0	919
10847	8	3	27	876	0	914
10848	9	7	896	28	0	940
10849	4	7	29	899	0	939
10850	6	8	917	33	0	964
10851	7	937	27	23	0	994
10852	4	28	18	925	0	975
10853	7	18	6	925	0	956
10854	5	946	7	45	0	1003
10855	993	32	6	19	0	1050
10856	32	18	3	994	0	1047
10857	26	6	3	1033	0	1068
10858	1034	8	5	43	0	1090
10859	1056	2	6	21	0	1085
10860	1097	7	2	14	0	1120
10861	1118	5	7	7	0	1137
10862	50	4	1068	7	0	1129
10863	1024	0	24	7	0	1055
10864	1057	7	18	6	0	1088
10865	43	3	3	1020	0	1069
10866	21	12	5	947	0	985
10867	892	4	3	32	0	931
10868	18	859	4	14	0	895
10869	13	15	3	818	0	849
10870	5	13	846	19	0	883
10871	2	847	16	12	0	877
10872	840	14	12	8	0	874
10873	846	9	2	8	0	865
10874	858	3	2	5	0	868
10875	890	3	3	4	0	900
10876	30	0	1	833	0	864
10877	17	5	824	18	0	864
10878	6	4	908	18	0	936
10879	5	1	27	905	0	938
10880	945	1	18	22	0	986
10881	20	2	5	958	0	985
10882	17	0	968	19	0	1004
10883	934	0	20	24	0	978
10884	955	1	21	8	0	985
10885	35	2	5	1040	0	1082
10886	18	4	1070	27	0	1119
10887	6	3	1077	21	0	1107
10888	1021	4	37	6	0	1068
10889	21	1065	26	6	0	1118
10890	23	21	1056	5	0	1105
10891	9	16	18	1044	0	1087
10892	1019	1	15	26	0	1061
10893	22	984	8	19	0	1033
10894	22	957	46	5	0	1030
10895	985	30	6	7	0	1028
10896	25	18	6	980	0	1029
10897	1045	4	7	23	0	1079
10898	25	2	4	1056	0	1087
10899	28	2	3	1058	0	1091
10900	6	5	1026	45	0	1082
10901	2	6	1017	25	0	1050
10902	5	3	1053	7	0	1068
10903	9	2	41	1025	0	1077
10904	1025	3	21	29	0	1078
10905	23	4	1046	26	0	1099
10906	27	1	22	1048	0	1098
10907	12	3	1100	27	0	1142
10908	10	1062	25	21	0	1118
10909	6	21	20	1092	0	1139
10910	6	18	8	1105	0	1137
10911	9	2	4	1094	0	1109
10912	1068	0	5	45	0	1118
10913	25	1	4	1088	0	1118
10914	25	1	4	1087	0	1117
10915	1089	3	2	45	0	1139
10916	25	3	1104	25	0	1157
10917	1117	0	24	10	0	1151
10918	1121	2	24	7	0	1154
10919	42	3	1096	8	0	1149
10920	1082	0	24	8	0	1114
10921	39	0	20	1125	0	1184
10922	22	3	1147	27	0	1199
10923	1125	1	22	18	0	1166
10924	1194	1	17	12	0	1224
10925	42	1	6	1172	0	1221
10926	23	1	7	1191	0	1222
10927	9	2	3	1199	0	1213
10928	1147	3	2	47	0	1199
10929	24	1195	5	28	0	1252
10930	1142	13	4	5	0	1164
10931	14	1130	4	5	0	1153
10932	16	1109	4	7	0	1136
10933	7	23	4	1121	0	1155
10934	5	15	3	1138	0	1161
10935	6	4	3	1127	0	1140
10936	5	4	1	1139	0	1149
10937	6	5	1077	28	0	1116
10938	1020	2	13	17	0	1052
10939	13	3	14	1088	0	1118
10940	19	2	1089	16	0	1126
10941	7	3	14	1090	0	1114
10942	5	2	14	1101	0	1122
10943	7	3	1102	26	0	1138
10944	4	0	18	1103	0	1125
10945	9	3	13	1105	0	1130
10946	1084	1	5	34	0	1124
10947	12	1	1134	25	0	1172
10948	1091	1	17	10	0	1119
10949	18	1150	19	8	0	1195
10950	1144	12	8	7	0	1171
10951	1096	15	3	13	0	1127
10952	32	3	2	1102	0	1139
10953	21	4	1094	15	0	1134
10954	7	1172	12	18	0	1209
10955	15	15	16	1044	0	1090
10956	2	1191	9	19	0	1221
10957	1156	14	4	20	0	1194
10958	19	18	1134	5	0	1176
10959	20	4	1118	12	0	1154
10960	9	4	36	1102	0	1151
10961	7	2	1153	19	0	1181
10962	6	0	20	1180	0	1206
10963	5	3	19	1185	0	1212
10964	1179	1	5	39	0	1224
10965	19	1187	5	24	0	1235
10966	24	15	3	1207	0	1249
10967	3	18	4	1225	0	1250
10968	8	6	5	1203	0	1222
10969	2	1187	5	46	0	1240
10970	6	1200	4	28	0	1238
10971	1193	31	2	9	0	1235
10972	1205	24	2	7	0	1238
10973	1207	4	2	11	0	1224
10974	31	6	1169	11	0	1217
10975	22	0	16	1144	0	1182
10976	7	5	1159	19	0	1190
10977	6	1150	12	24	0	1192
10978	1076	11	18	6	0	1111
10979	15	12	1030	14	0	1071
10980	23	3	12	984	0	1022
10981	4	7	1024	14	0	1049
10982	999	3	11	16	0	1029
10983	1034	1	15	9	0	1059
10984	1043	1	5	7	0	1056
10985	1003	2	3	5	0	1013
10986	23	2	1101	4	0	1130
10987	1081	3	9	5	0	1098
10988	1101	1	10	4	0	1116
10989	19	1097	10	4	0	1130
10990	1101	9	3	4	0	1117
10991	1094	11	0	7	0	1112
10992	17	2	3	1062	0	1084
10993	13	1137	6	12	0	1168
10994	1201	9	1	14	0	1225
10995	1292	12	1	6	0	1311
10996	27	6	1447	2	0	1482
10997	20	4	1442	5	0	1471
10998	5	2	1496	1	0	1504
10999	5	2	54	1432	0	1493
11000	1476	1	28	29	0	1534
11001	26	1476	14	26	0	1542
11002	1476	29	2	12	0	1519
11003	35	1496	3	5	0	1539
11004	1487	30	3	4	0	1524
11005	33	1462	2	7	0	1504
11006	21	1463	7	4	0	1495
11007	1372	43	0	3	0	1418
11008	27	1385	21	5	0	1438
11009	23	28	1	1353	0	1405
11010	9	21	1365	25	0	1420
11011	0	9	1367	22	0	1398
11012	4	2	44	1330	0	1380
11013	4	2	26	1381	0	1413
11014	1	3	1367	45	0	1416
11015	4	1	25	1341	0	1371
11016	3	1	20	1346	0	1370
11017	1319	0	7	44	0	1370
11018	25	1321	5	29	0	1380
11019	24	27	2	1221	0	1274
11020	9	1316	4	20	0	1349
11021	1238	31	4	22	0	1295
11022	25	1268	12	7	0	1312
11023	1259	30	5	8	0	1302
11024	1229	19	4	4	0	1256
11025	44	13	3	1208	0	1268
11026	33	1	2	1221	0	1257
11027	9	8	4	1251	0	1272
11028	10	2	2	1261	0	1275
11029	4	6	1162	49	0	1221
11030	1055	5	25	31	0	1116
11031	27	1144	24	12	0	1207
11032	25	28	9	1202	0	1264
11033	15	24	3	1193	0	1235
11034	3	1201	8	44	0	1256
11035	1196	27	7	29	0	1259
11036	27	1234	5	10	0	1276
11037	28	33	2	1226	0	1289
11038	8	25	7	1279	0	1319
11039	5	13	3	1299	0	1320
11040	13	3	3	1310	0	1329
11041	1262	6	2	58	0	1328
11042	30	12	1253	32	0	1327
11043	28	3	34	1261	0	1326
11044	9	9	33	1279	0	1330
11045	8	3	14	1308	0	1333
11046	9	9	6	1313	0	1337
11047	1208	7	7	56	0	1278
11048	38	8	1209	33	0	1288
11049	28	9	24	1150	0	1211
11050	16	1147	25	30	0	1218
11051	6	1214	10	26	0	1256
11052	1181	50	2	18	0	1251
11053	30	35	1185	7	0	1257
11054	1074	15	21	7	0	1117
11055	34	13	1130	8	0	1185
11056	22	5	30	1079	0	1136
11057	1107	2	23	36	0	1168
11058	25	1121	16	28	0	1190
11059	25	25	5	1057	0	1112
11060	13	1099	11	27	0	1150
11061	1098	30	10	33	0	1171
11062	1066	18	10	21	0	1115
11063	39	14	9	1067	0	1129
11064	25	10	1058	37	0	1130
11065	20	9	1081	29	0	1139
11066	8	13	40	1035	0	1096
11067	11	1063	21	31	0	1126
11068	12	44	10	1096	0	1162
11069	10	27	5	1056	0	1098
11070	12	16	3	1071	0	1102
11071	16	10	1081	55	0	1162
11072	7	8	29	1092	0	1136
11073	7	6	15	1095	0	1123
11074	5	1064	12	52	0	1133
11075	4	29	9	1014	0	1056
11076	8	17	9	1110	0	1144
11077	6	10	11	1120	0	1147
11078	12	5	4	1139	0	1160
11079	4	5	10	1119	0	1138
11080	10	5	4	1119	0	1138
11081	13	7	2	1101	0	1123
11082	13	12	2	1062	0	1089
11083	5	14	979	59	0	1057
11084	8	12	22	1018	0	1060
11085	989	7	17	48	0	1061
11086	32	5	8	930	0	975
11087	26	8	931	43	0	1008
11088	907	6	31	28	0	972
11089	975	2	22	24	0	1023
11090	977	3	12	21	0	1013
11091	984	8	3	21	0	1016
11092	47	3	5	1010	0	1065
11093	28	2	973	41	0	1044
11094	13	944	28	28	0	1013
11095	6	898	25	19	0	948
11096	3	13	5	666	0	687
11097	1	6	1	660	0	668
11098	3	1	1	690	0	695
11099	1	0	1	708	0	710
11100	1	0	1	807	0	809
11101	834	2	0	16	0	852
11102	6	855	1	16	0	878
11103	9	864	2	5	0	880
11104	9	16	1	994	0	1020
11105	3	11	0	1030	0	1044
11106	1	4	2	1044	0	1051
11107	2	0	1	1056	0	1059
11108	0	2	1013	25	0	1040
11109	0	981	8	16	0	1005
11110	1	9	10	992	0	1012
11111	990	10	4	13	0	1017
11112	9	5	0	1007	0	1021
11113	9	6	1032	15	0	1062
11114	6	4	1008	16	0	1034
11115	3	6	1039	7	0	1055
11116	2	4	24	993	0	1023
11117	1030	1	17	17	0	1065
11118	11	0	5	1053	0	1069
11119	16	0	0	1055	0	1071
11120	1063	0	2	26	0	1091
11121	10	1	3	1100	0	1114
11122	15	1	2	1103	0	1121
11123	6	4	1203	28	0	1241
11124	2	1233	11	19	0	1265
11125	4	10	14	1278	0	1306
11126	1282	13	4	19	0	1318
11127	15	3	2	1309	0	1329
11128	22	4	1282	22	0	1330
11129	5	1	14	1287	0	1307
11130	2	1286	21	18	0	1327
11131	0	14	6	1336	0	1356
11132	4	20	1268	22	0	1314
11133	3	1421	18	21	0	1463
11134	2	27	21	1475	0	1525
11135	1	26	9	1584	0	1620
11136	3	5	4	1586	0	1598
11137	2	2	0	1596	0	1600
11138	5	3	1498	65	0	1571
11139	3	1512	31	49	0	1595
11140	1513	33	29	12	0	1587
11141	1551	30	8	4	0	1593
11142	59	5	1	1552	0	1617
11143	37	6	1527	36	0	1606
11144	1472	1	35	38	0	1546
11145	31	3	34	1537	0	1605
11146	31	8	1562	39	0	1640
11147	15	1	29	1571	0	1616
11148	5	0	32	1587	0	1624
11149	3	2	11	1627	0	1643
11150	4	6	1688	74	0	1772
11151	5	2	34	1630	0	1671
11152	4	1739	36	40	0	1819
11153	1743	32	13	35	0	1823
11154	1767	31	4	14	0	1816
11155	1782	7	1	12	0	1802
11156	67	1734	6	9	0	1816
11157	1751	30	5	12	0	1798
11158	40	33	2	1738	0	1813
11159	1732	9	5	40	0	1786
11160	1734	6	4	37	0	1781
11161	66	9	1683	17	0	1775
11162	45	1688	34	10	0	1777
11163	1685	34	33	15	0	1767
11164	36	35	11	1671	0	1753
11165	42	11	1641	36	0	1730
11166	11	1638	37	42	0	1728
11167	1615	32	39	18	0	1704
11168	35	32	10	1636	0	1713
11169	37	9	6	1650	0	1702
11170	17	2	3	1669	0	1691
11171	3	1586	11	82	0	1682
11172	7	33	8	1617	0	1665
11173	7	1596	12	40	0	1655
11174	16	38	5	1627	0	1686
11175	11	32	1633	46	0	1722
11176	9	6	35	1665	0	1715
11177	11	5	38	1670	0	1724
11178	11	2	10	1720	0	1743
11179	7	5	1639	86	0	1737
11180	8	3	38	1656	0	1705
11181	17	5	35	1672	0	1729
11182	9	8	15	1708	0	1740
11183	15	8	4	1697	0	1724
11184	13	6	7	1711	0	1737
11185	7	10	1635	82	0	1734
11186	9	8	39	1649	0	1705
11187	14	7	38	1620	0	1679
11188	1548	5	7	80	0	1640
11189	39	1549	14	54	0	1656
11190	37	1578	10	22	0	1647
11191	17	64	6	1558	0	1645
11192	10	42	6	1519	0	1577
11193	8	1467	13	74	0	1562
11194	8	53	5	1428	0	1494
11195	8	1445	10	46	0	1509
11196	14	57	7	1424	0	1502
11197	12	35	6	1453	0	1506
11198	8	12	1374	72	0	1466
11199	8	1349	38	49	0	1444
11200	8	1268	34	18	0	1328
11201	1116	49	21	12	0	1198
11202	31	1162	5	17	0	1215
11203	26	28	7	1148	0	1209
11204	6	32	1029	38	0	1105
11205	5	8	23	1036	0	1072
11206	997	3	27	36	0	1063
11207	27	4	1032	31	0	1094
11208	25	1066	32	16	0	1139
11209	13	30	30	962	0	1035
11210	10	28	2	1128	0	1168
11211	1120	6	4	64	0	1194
11212	26	5	4	1167	0	1202
11213	30	7	6	1161	0	1204
11214	8	8	0	1182	0	1198
11215	4	4	3	1195	0	1206
11216	1135	7	1	65	0	1208
11217	1149	5	6	42	0	1202
11218	51	18	6	1136	0	1211
11219	1156	6	9	33	0	1204
11220	25	6	1	1145	0	1177
11221	26	10	1084	37	0	1157
11222	8	6	1093	34	0	1141
11223	5	27	43	907	0	982
11224	2	943	26	39	0	1010
11225	4	25	4	941	0	974
11226	893	18	6	36	0	953
11227	24	6	6	928	0	964
11228	904	2	6	35	0	947
11229	26	30	1	901	0	958
11230	25	4	923	31	0	983
11231	4	888	19	23	0	934
11232	6	929	22	6	0	963
11233	2	13	2	738	0	755
11234	3	8	709	13	0	733
11235	0	563	4	7	0	574
11236	1	2	5	575	0	583
11237	548	8	5	8	0	569
11238	5	1	580	9	0	595
11239	4	0	1	604	0	609
11240	2	1	5	664	0	672
11241	2	5	663	12	0	682
11242	1	4	655	7	0	667
11243	2	4	719	5	0	730
11244	1	2	8	730	0	741
11245	1	6	766	5	0	778
11246	669	1	7	7	0	684
11247	6	1	4	725	0	736
11248	7	2	869	5	0	883
11249	3	870	8	9	0	890
11250	1	9	803	5	0	818
11251	2	5	7	790	0	804
11252	855	2	5	16	0	878
11253	7	0	0	883	0	890
11254	7	0	3	881	0	891
11255	931	1	2	18	0	952
11256	7	2	1	954	0	964
11257	8	3	944	14	0	969
11258	927	1	9	9	0	946
11259	11	978	13	2	0	1004
11260	973	9	2	5	0	989
11261	11	6	4	969	0	990
11262	6	2	963	11	0	982
11263	5	4	1086	6	0	1101
11264	2	0	17	1082	0	1101
11265	5	0	7	1105	0	1117
11266	3	2	1138	16	0	1159
11267	3	9	1098	12	0	1122
11268	1125	1	18	7	0	1151
11269	12	1	9	1166	0	1188
11270	1175	2	4	13	0	1194
11271	16	3	1	1171	0	1191
11272	10	4	1240	17	0	1271
11273	7	5	1367	13	0	1392
11274	2	2	21	1366	0	1391
11275	2	0	11	1376	0	1389
11276	2	5	1456	24	0	1487
11277	1388	1	19	10	0	1418
11278	18	0	10	1497	0	1525
11279	1522	1	6	22	0	1551
11280	23	1829	4	10	0	1866
11281	13	33	1	1853	0	1900
11282	1876	19	1	39	0	1935
11283	42	7	1973	26	0	2048
11284	23	2	40	1975	0	2040
11285	9	1	25	1998	0	2033
11286	3	1	7	2050	0	2061
11287	1	5	1996	63	0	2065
11288	3	0	39	1978	0	2020
11289	2	2035	27	44	0	2108
11290	8	37	7	2062	0	2114
11291	5	26	2066	39	0	2136
11292	5	16	2064	25	0	2110
11293	5	5	61	2042	0	2113
11294	6	0	27	2088	0	2121
11295	5	2	8	2115	0	2130
11296	3	0	5	2129	0	2137
11297	2051	2	0	68	0	2121
11298	2032	0	8	36	0	2076
11299	57	4	2023	11	0	2095
11300	29	2043	46	6	0	2124
11301	9	37	19	2058	0	2123
11302	2071	23	7	39	0	2140
11303	1982	7	10	31	0	2030
11304	2106	3	9	16	0	2134
11305	2119	2	11	10	0	2142
11306	65	5	2080	10	0	2160
11307	2019	2	42	18	0	2081
11308	46	1992	31	10	0	2079
11309	33	37	11	2020	0	2101
11310	16	27	1997	50	0	2090
11311	16	5	45	1984	0	2050
11312	10	8	2016	48	0	2082
11313	12	5	47	1964	0	2028
11314	12	3	29	2007	0	2051
11315	1968	4	17	67	0	2056
11316	49	1	11	2001	0	2062
11317	33	9	1992	56	0	2090
11318	19	1	45	2081	0	2146
11319	2075	4	32	50	0	2161
11320	46	2	17	2105	0	2170
11321	29	7	2069	55	0	2160
11322	13	2054	48	38	0	2153
11323	2094	39	35	20	0	2188
11324	51	25	14	1995	0	2085
11325	33	2195	18	46	0	2292
11326	2204	39	11	39	0	2293
11327	47	27	2204	23	0	2301
11328	30	2176	48	30	0	2284
11329	13	43	33	2221	0	2310
11330	17	25	2212	51	0	2305
11331	16	8	50	2165	0	2239
11332	2174	7	37	59	0	2277
11333	51	10	2209	42	0	2312
11334	39	9	46	2194	0	2288
11335	13	8	2241	66	0	2328
11336	22	4	53	2209	0	2288
11337	14	9	32	2260	0	2315
11338	2196	2	18	81	0	2297
11339	52	2189	27	61	0	2329
11340	30	43	13	2177	0	2263
11341	2146	23	16	58	0	2243
11342	2149	10	13	44	0	2216
11343	68	6	10	2066	0	2150
11344	31	2015	19	52	0	2117
11345	15	2093	15	37	0	2160
11346	15	54	13	2079	0	2161
11347	22	24	13	2118	0	2177
11348	1925	11	8	71	0	2015
11349	44	10	10	2024	0	2088
11350	27	10	2000	62	0	2099
11351	1831	4	38	32	0	1905
11352	42	1904	28	25	0	1999
11353	1900	32	20	20	0	1972
11354	47	31	2125	22	0	2225
11355	26	2124	41	18	0	2209
11356	2095	39	35	14	0	2183
11357	2145	23	8	14	0	2190
11358	64	10	2102	14	0	2190
11359	2010	5	43	10	0	2068
11360	2086	7	25	18	0	2136
11361	58	2051	19	15	0	2143
11362	29	39	12	2142	0	2222
11363	10	30	2027	52	0	2119
11364	14	9	48	2051	0	2122
11365	14	8	2114	59	0	2195
11366	10	4	47	2085	0	2146
11367	2074	6	33	58	0	2171
11368	52	5	10	2203	0	2270
11369	33	10	2258	59	0	2360
11370	2218	4	50	35	0	2307
11371	53	5	30	2340	0	2428
11372	35	7	2231	56	0	2329
11373	2093	9	47	36	0	2185
11374	60	5	31	2164	0	2260
11375	34	8	2141	57	0	2240
11376	16	10	2032	35	0	2093
11377	9	7	66	1992	0	2074
11378	11	8	2023	49	0	2091
11379	4	1999	60	28	0	2091
11380	1	23	26	1703	0	1753
11381	1700	14	5	23	0	1742
11382	22	7	1740	19	0	1788
11383	16	5	1637	7	0	1665
11384	1519	3	37	3	0	1562
11385	23	4	1649	5	0	1681
11386	1537	0	26	5	0	1568
11387	28	9	1636	5	0	1678
11388	20	0	25	1588	0	1633
11389	8	4	1583	22	0	1617
11390	7	0	24	1544	0	1575
11391	5	3	1608	22	0	1638
11392	1	0	1584	17	0	1602
11393	1410	1	38	8	0	1457
11394	20	1598	24	5	0	1647
11395	1615	23	6	3	0	1647
11396	24	1607	6	3	0	1640
11397	20	26	2	1609	0	1657
11398	5	17	5	1647	0	1674
11399	1623	6	2	36	0	1667
11400	28	1	1	1615	0	1645
11401	17	8	1593	25	0	1643
11402	1551	5	21	20	0	1597
11403	1622	1	18	11	0	1652
11404	40	1	4	1660	0	1705
11405	21	5	1638	28	0	1692
11406	8	0	26	1630	0	1664
11407	7	1625	22	25	0	1679
11408	5	20	8	1662	0	1695
11409	6	16	5	1685	0	1712
11410	3	8	1652	41	0	1704
11411	1395	2	23	30	0	1450
11412	20	1636	24	9	0	1689
11413	1624	22	11	9	0	1666
11414	29	1719	8	8	0	1764
11415	20	25	5	1659	0	1709
11416	7	1751	12	25	0	1795
11417	12	28	1683	17	0	1740
11418	8	14	25	1580	0	1627
11419	3	6	23	1628	0	1660
11420	7	3	8	1667	0	1685
11421	1622	1	7	54	0	1684
11422	28	2	10	1653	0	1693
11423	1608	3	9	32	0	1652
11424	1617	1	4	25	0	1647
11425	1533	2	8	14	0	1557
11426	45	3	1518	6	0	1572
11427	25	2	26	1501	0	1554
11428	14	1	24	1653	0	1692
11429	11	2	11	1686	0	1710
11430	1763	4	10	51	0	1828
11431	40	0	6	1778	0	1824
11432	24	6	9	1796	0	1835
11433	1905	0	11	63	0	1979
11434	52	3	5	1981	0	2041
11435	32	8	2003	54	0	2097
11436	12	6	2101	37	0	2156
11437	11	3	79	2112	0	2205
11438	2065	5	39	59	0	2168
11439	2026	4	13	39	0	2082
11440	89	4	7	2028	0	2128
11441	43	5	2029	58	0	2135
11442	11	2058	54	40	0	2163
11443	16	47	35	2093	0	2191
11444	8	35	8	2142	0	2193
11445	6	5	6	2147	0	2164
11446	2077	4	7	90	0	2178
11447	53	10	2061	50	0	2174
11448	2107	3	50	17	0	2177
11449	58	1	41	1974	0	2074
11450	41	2041	14	51	0	2147
11451	2052	48	9	43	0	2152
11452	2055	42	6	15	0	2118
11453	81	11	2116	9	0	2217
11454	40	1850	55	10	0	1955
11455	10	1839	36	11	0	1896
11456	1816	75	11	8	0	1910
11457	48	38	7	1811	0	1904
11458	38	8	7	1840	0	1893
11459	11	4	5	1839	0	1859
11460	8	1778	8	72	0	1866
11461	5	1846	4	43	0	1898
11462	1739	69	3	8	0	1819
11463	38	35	4	1729	0	1806
11464	30	8	1930	43	0	2011
11465	5	1	51	2005	0	2062
11466	7	4	2220	60	0	2291
11467	8	4	2328	44	0	2384
11468	8	6	2314	14	0	2342
11469	9	2050	114	10	0	2183
11470	16	57	62	1962	0	2097
11471	5	2188	19	52	0	2264
11472	24	65	14	2059	0	2162
11473	8	57	3	2252	0	2320
11474	2199	7	4	119	0	2329
11475	60	9	2	2240	0	2311
11476	2254	2	5	79	0	2340
11477	2257	6	7	66	0	2336
11478	119	1	4	2140	0	2264
11479	67	2131	8	64	0	2270
11480	17	63	4	2112	0	2196
11481	9	2174	9	73	0	2265
11482	13	66	7	2127	0	2213
11483	11	73	2082	77	0	2243
11484	10	7	68	2143	0	2228
11485	13	8	61	2185	0	2267
11486	2058	4	16	134	0	2212
11487	63	2119	15	67	0	2264
11488	67	60	6	2143	0	2276
11489	16	59	6	2156	0	2237
11490	11	2123	16	122	0	2272
11491	7	75	4	2142	0	2228
11492	2037	55	4	82	0	2178
11493	2107	10	4	73	0	2194
11494	113	2063	7	32	0	2215
11495	71	60	8	2082	0	2221
11496	2038	61	9	72	0	2180
11497	77	2042	10	68	0	2197
11498	64	72	9	1902	0	2047
11499	21	2086	15	66	0	2188
11500	2034	69	10	63	0	2176
11501	71	67	2031	18	0	2187
11502	69	18	2058	20	0	2165
11503	20	15	114	1995	0	2144
11504	13	18	2036	76	0	2143
11505	16	22	80	2005	0	2123
11506	1973	14	61	88	0	2136
11507	65	10	2030	82	0	2187
11508	69	16	69	2033	0	2187
11509	17	13	56	2125	0	2211
11510	2060	16	18	130	0	2224
11511	80	2058	20	77	0	2235
11512	2117	72	10	33	0	2232
11513	2103	62	18	26	0	2209
11514	127	1993	13	29	0	2162
11515	74	74	16	2021	0	2185
11516	21	72	1973	82	0	2148
11517	19	17	67	1979	0	2082
11518	16	2001	66	69	0	2152
11519	1994	67	14	83	0	2158
11520	68	74	14	2018	0	2174
11521	71	26	2046	93	0	2236
11522	25	16	65	2118	0	2224
11523	21	12	60	2152	0	2245
11524	13	18	15	2198	0	2244
11525	18	20	8	2217	0	2263
11526	18	9	11	2173	0	2211
11527	15	17	2025	140	0	2197
11528	17	15	1939	86	0	2057
11529	17	1819	108	44	0	1988
11530	14	1823	66	24	0	1927
11531	1794	98	14	19	0	1925
11532	72	63	1776	22	0	1933
11533	1635	12	47	35	0	1729
11534	48	17	1580	16	0	1661
11535	46	6	1512	20	0	1584
11536	13	7	80	1398	0	1498
11537	1447	7	43	46	0	1543
11538	41	3	17	1529	0	1590
11539	46	9	15	1514	0	1584
11540	16	9	1583	90	0	1698
11541	17	9	37	1630	0	1693
11542	11	5	35	1605	0	1656
11543	12	6	8	1630	0	1656
11544	11	4	8	1636	0	1659
11545	13	3	4	1651	0	1671
11546	1553	7	7	89	0	1656
11547	45	8	3	1590	0	1646
11548	37	12	1519	52	0	1620
11549	13	9	33	1555	0	1610
11550	11	9	1541	46	0	1607
11551	3	4	45	1569	0	1621
11552	6	4	1581	49	0	1640
11553	5	4	43	1499	0	1551
11554	8	2	44	1544	0	1598
11555	6	9	1513	83	0	1611
11556	1405	3	50	46	0	1504
11557	37	7	1537	26	0	1607
11558	38	4	46	1547	0	1635
11559	1591	5	40	50	0	1686
11560	48	2	8	1635	0	1693
11561	38	2	10	1647	0	1697
11562	13	7	1596	84	0	1700
11563	6	1590	48	48	0	1692
11564	2	1250	28	12	0	1292
11565	5	1243	6	11	0	1265
11566	15	25	47	901	0	988
11567	911	7	0	15	0	933
11568	9	1	0	898	0	908
11569	3	0	1	897	0	901
11570	2	0	0	928	0	930
11571	0	0	1	932	0	933
11572	0	951	2	15	0	968
11573	0	10	0	962	0	972
11574	0	5	0	966	0	971
11575	1	982	2	16	0	1001
11576	977	10	0	8	0	995
11577	11	6	1	978	0	996
11578	969	3	0	12	0	984
11579	987	0	2	8	0	997
11580	16	1016	1	4	0	1037
11581	6	11	2	1145	0	1164
11582	3	10	1165	13	0	1191
11583	1	2	1178	7	0	1188
11584	2	13	22	1159	0	1196
11585	1170	0	8	22	0	1200
11586	1249	1	4	10	0	1264
11587	23	0	1	1298	0	1322
11588	1313	0	2	19	0	1334
11589	17	1304	2	9	0	1332
11590	1300	17	0	7	0	1324
11591	16	1403	2	12	0	1433
11592	9	19	1	1449	0	1478
11593	2	10	0	1437	0	1449
11594	3	1442	2	24	0	1471
11595	1431	19	0	11	0	1461
11596	21	10	1415	9	0	1455
11597	8	3	14	1439	0	1464
11598	4	9	1445	18	0	1476
11599	3	2	15	1446	0	1466
11600	1451	1	8	23	0	1483
11601	21	1	1	1454	0	1477
11602	1445	3	2	21	0	1471
11603	1454	2	0	15	0	1471
11604	25	1	3	1443	0	1472
11605	10	2	1441	21	0	1474
11606	4	1486	20	9	0	1519
11607	4	16	7	1464	0	1491
11608	1419	7	2	20	0	1448
11609	21	2	1422	12	0	1457
11610	8	2	16	1423	0	1449
11611	4	2	10	1451	0	1467
11612	5	4	1	1468	0	1478
11613	1456	2	1	29	0	1488
11614	21	2	0	1467	0	1490
11615	11	3	2	1488	0	1504
11616	6	3	1479	31	0	1519
11617	3	4	19	1494	0	1520
11618	4	1	12	1504	0	1521
11619	4	5	4	1520	0	1533
11620	1	1471	5	32	0	1509
11621	7	18	3	1414	0	1442
11622	2	9	3	1450	0	1464
11623	1370	1	1	33	0	1405
11624	23	7	1401	16	0	1447
11625	14	2	1391	11	0	1418
11626	6	1415	23	6	0	1450
11627	3	15	10	1445	0	1473
11628	1443	9	5	19	0	1476
11629	19	6	3	1426	0	1454
11630	14	1	2	1432	0	1449
11631	4	0	5	1451	0	1460
11632	5	5	2	1446	0	1458
11633	3	3	1	1451	0	1458
11634	5	5	1429	33	0	1472
11635	6	1	14	1431	0	1452
11636	1424	1	13	23	0	1461
11637	13	1378	8	21	0	1420
11638	13	14	4	1377	0	1408
11639	4	10	2	1392	0	1408
11640	5	2	1371	30	0	1408
11641	5	5	14	1345	0	1369
11642	6	2	10	1477	0	1495
11643	1521	5	2	34	0	1562
11644	20	1611	2	22	0	1655
11645	16	20	3	1618	0	1657
11646	8	14	3	1634	0	1659
11647	4	5	6	1652	0	1667
11648	4	6	1642	40	0	1692
11649	8	4	1613	23	0	1648
11650	1	1603	35	11	0	1650
11651	4	1621	19	11	0	1655
11652	3	29	4	1581	0	1617
11653	2	1524	6	31	0	1563
11654	5	19	3	1767	0	1794
11655	0	21	1	1953	0	1975
11656	5	4	1	2034	0	2044
11657	4	3	5	2343	0	2355
11658	3	6	2337	64	0	2410
11659	6	6	32	2327	0	2371
11660	4	3	32	2361	0	2400
11661	4	3	10	2418	0	2435
11662	2357	2	4	81	0	2444
11663	34	2403	14	58	0	2509
11664	43	36	6	2136	0	2221
11665	11	2390	1	57	0	2459
11666	2287	42	5	41	0	2375
11667	1972	52	5	29	0	2058
11668	60	2301	8	19	0	2388
11669	45	2340	5	13	0	2403
11670	13	83	2245	9	0	2350
11671	7	2346	39	11	0	2403
11672	10	51	49	2224	0	2334
11673	2282	43	8	41	0	2374
11674	35	2373	8	44	0	2460
11675	43	39	7	2420	0	2509
11676	14	49	5	2444	0	2512
11677	4	13	3	2528	0	2548
11678	2406	12	4	92	0	2514
11679	39	17	2416	66	0	2538
11680	2300	7	37	32	0	2376
11681	41	2331	42	23	0	2437
11682	46	36	8	2314	0	2404
11683	19	49	2274	38	0	2380
11684	2054	11	37	56	0	2158
11685	33	2257	44	20	0	2354
11686	48	38	11	2138	0	2235
11687	16	2235	12	35	0	2298
11688	8	41	8	2304	0	2361
11689	9	46	5	2313	0	2373
11690	7	23	2255	78	0	2363
11691	8	14	2171	57	0	2250
11692	5	15	69	2177	0	2266
11693	5	13	2290	50	0	2358
11694	8	10	42	2256	0	2316
11695	5	6	48	2252	0	2311
11696	10	6	17	2322	0	2355
11697	2251	6	11	94	0	2362
11698	37	6	14	2334	0	2391
11699	45	6	2315	65	0	2431
11700	2278	3	39	67	0	2387
11701	45	8	47	2336	0	2436
11702	53	6	13	2376	0	2448
11703	2328	10	6	91	0	2435
11704	38	2373	13	62	0	2486
11705	56	35	8	2421	0	2520
11706	22	46	9	2411	0	2488
11707	2336	13	6	99	0	2454
11708	41	14	2366	68	0	2489
11709	54	14	39	2372	0	2479
11710	21	14	45	2388	0	2468
11711	11	10	18	2330	0	2369
11712	11	2332	20	99	0	2462
11713	12	36	10	2394	0	2452
11714	2285	44	17	71	0	2417
11715	38	2311	19	71	0	2439
11716	2281	40	12	39	0	2372
11717	42	2413	13	35	0	2503
11718	2403	46	14	33	0	2496
11719	48	52	2404	33	0	2537
11720	51	29	2386	27	0	2493
11721	2334	14	76	23	0	2447
11722	50	22	2534	22	0	2628
11723	61	12	49	2494	0	2616
11724	30	11	52	2391	0	2484
11725	20	20	24	2546	0	2610
11726	2497	9	18	100	0	2624
11727	43	13	2472	78	0	2606
11728	2475	9	46	40	0	2570
11729	58	7	52	2578	0	2695
11730	2605	11	21	66	0	2703
11731	58	8	15	2621	0	2702
11732	2737	9	13	79	0	2838
11733	68	11	9	3091	0	3179
11734	61	10	3112	84	0	3267
11735	3121	13	50	77	0	3261
11736	3226	12	59	37	0	3334
11737	119	7	23	3173	0	3322
11738	77	56	11	3023	0	3167
11739	38	3149	17	114	0	3318
11740	3051	52	19	78	0	3200
11741	60	3132	17	32	0	3241
11742	3043	53	11	31	0	3138
11743	68	65	3002	25	0	3160
11744	66	27	2970	20	0	3083
11745	23	18	2929	25	0	2995
11746	2782	10	102	18	0	2912
11747	61	3003	69	16	0	3149
11748	60	46	25	2938	0	3069
11749	2922	50	14	69	0	3055
11750	55	2955	25	66	0	3101
11751	66	86	17	2770	0	2939
11752	19	2952	19	59	0	3049
11753	20	2810	20	60	0	2910
11754	24	2819	10	24	0	2877
11755	2521	91	9	20	0	2641
11756	48	2612	9	19	0	2688
11757	36	2276	10	10	0	2332
11758	13	2214	11	14	0	2252
11759	2198	51	10	9	0	2268
11760	2192	30	10	10	0	2242
11761	65	25	2124	13	0	2227
11762	2030	4	27	15	0	2076
11763	2147	4	26	13	0	2190
11764	60	4	9	2113	0	2186
11765	2209	3	7	29	0	2248
11766	36	9	2211	29	0	2285
11767	31	2379	30	9	0	2449
11768	2455	32	25	10	0	2522
11769	41	30	5	2479	0	2555
11770	2520	6	4	35	0	2565
11771	45	10	2390	34	0	2479
11772	2417	7	32	7	0	2463
11773	40	3	31	2461	0	2535
11774	35	2	2457	37	0	2531
11775	9	2344	34	29	0	2416
11776	5	2396	34	12	0	2447
11777	8	55	16	2308	0	2387
11778	9	35	1	2213	0	2258
11779	8	2370	8	48	0	2434
11780	2398	30	1	29	0	2458
11781	2370	26	6	6	0	2408
11782	2372	9	2	4	0	2387
11783	56	2505	8	3	0	2572
11784	41	33	2	2317	0	2393
11785	10	2521	10	28	0	2569
11786	2508	35	3	28	0	2574
11787	2462	27	3	6	0	2498
11788	56	2398	9	4	0	2467
11789	2418	28	1	4	0	2451
11790	38	26	4	2386	0	2454
11791	37	3	2	2385	0	2427
11792	2402	3	2	57	0	2464
11793	2352	5	5	37	0	2399
11794	2426	2	2	7	0	2437
11795	61	5	2	2387	0	2455
11796	33	4	4	2437	0	2478
11797	7	12	2451	58	0	2528
11798	7	9	28	2416	0	2460
11799	11	7	28	2395	0	2441
11800	11	10	2360	58	0	2439
11801	12	8	2331	32	0	2383
11802	10	7	2432	5	0	2454
11803	8	7	61	2379	0	2455
11804	9	9	2389	35	0	2442
11805	16	7	34	2332	0	2389
11806	15	7	27	2371	0	2420
11807	10	16	2338	64	0	2428
11808	11	15	2379	34	0	2439
11809	13	9	55	2353	0	2430
11810	7	12	2490	37	0	2546
11811	13	11	2453	32	0	2509
11812	9	2407	59	9	0	2484
11813	2467	40	30	8	0	2545
11814	2473	30	1	14	0	2518
11815	2468	12	4	16	0	2500
11816	67	2420	12	9	0	2508
11817	44	2385	10	5	0	2444
11818	25	60	2	2358	0	2445
11819	20	34	4	2340	0	2398
11820	7	19	2311	65	0	2402
11821	14	4	33	2312	0	2363
11822	2230	10	33	41	0	2314
11823	48	5	5	2083	0	2141
11824	45	2193	9	33	0	2280
11825	2236	34	7	36	0	2313
11826	2237	34	7	6	0	2284
11827	2295	6	6	18	0	2325
11828	65	5	2200	16	0	2286
11829	43	5	29	2343	0	2420
11830	2463	2	37	38	0	2540
11831	44	5	2583	40	0	2672
11832	36	2435	37	20	0	2528
11833	10	2147	42	9	0	2208
11834	1964	40	23	8	0	2035
11835	18	2040	8	11	0	2077
11836	24	20	7	1993	0	2044
11837	6	32	2051	26	0	2115
11838	10	6	29	2056	0	2101
11839	2065	5	31	28	0	2129
11840	26	2024	12	33	0	2095
11841	2041	23	8	12	0	2084
11842	24	32	2029	10	0	2095
11843	33	1	23	1913	0	1970
11844	4	2067	37	20	0	2128
11845	8	21	8	2103	0	2140
11846	2120	25	3	30	0	2178
11847	2086	5	9	28	0	2128
11848	2105	4	7	9	0	2125
11849	2124	10	1	6	0	2141
11850	58	1	1	2076	0	2136
11851	38	3	2116	24	0	2181
11852	17	1	26	2004	0	2048
11853	4	2071	27	32	0	2134
11854	2074	25	13	27	0	2139
11855	26	25	2101	21	0	2173
11856	2040	6	28	12	0	2086
11857	27	1	33	2090	0	2151
11858	30	3	2147	29	0	2209
11859	12	5	26	2136	0	2179
11860	2127	5	28	34	0	2194
11861	2142	3	11	29	0	2185
11862	2153	4	6	15	0	2178
11863	49	6	2083	8	0	2146
11864	34	5	24	2059	0	2122
11865	5	12	2097	21	0	2135
11866	6	2039	19	33	0	2097
11867	1855	19	24	1	0	1899
11868	17	1828	8	7	0	1860
11869	1766	16	3	8	0	1793
11870	21	18	5	1682	0	1726
11871	22	1701	6	15	0	1744
11872	1706	19	4	13	0	1742
11873	22	17	1709	5	0	1753
11874	19	13	19	1669	0	1720
11875	1700	1	13	26	0	1740
11876	16	7	1699	18	0	1740
11877	18	4	13	1626	0	1661
11878	14	1648	17	11	0	1690
11879	9	14	5	1672	0	1700
11880	8	16	4	1636	0	1664
11881	1580	5	5	20	0	1610
11882	13	1600	5	23	0	1641
11883	16	17	4	1554	0	1591
11884	4	1598	3	16	0	1621
11885	10	10	8	1584	0	1612
11886	13	1663	0	16	0	1692
11887	1611	18	3	16	0	1648
11888	23	18	1646	2	0	1689
11889	15	1	17	1599	0	1632
11890	8	5	21	1618	0	1652
11891	10	3	3	1642	0	1658
11892	10	6	3	1627	0	1646
11893	12	9	1603	28	0	1652
11894	9	1675	19	17	0	1720
11895	1667	16	18	4	0	1705
11896	1670	15	1	10	0	1696
11897	27	1640	8	6	0	1681
11898	1653	16	1	11	0	1681
11899	1627	12	7	5	0	1651
11900	29	1690	5	10	0	1734
11901	26	20	1	1588	0	1635
11902	11	1670	13	10	0	1704
11903	1626	14	7	19	0	1666
11904	20	16	1645	6	0	1687
11905	1498	6	14	10	0	1528
11906	22	5	1713	6	0	1746
11907	20	4	14	1690	0	1728
11908	1664	5	11	17	0	1697
11909	18	4	1667	21	0	1710
11910	1557	4	15	9	0	1585
11911	1633	3	14	9	0	1659
11912	26	5	6	1651	0	1688
11913	14	1714	7	17	0	1752
11914	1749	20	1	15	0	1785
11915	18	12	7	1730	0	1767
11916	14	1723	8	20	0	1765
11917	1723	15	4	18	0	1760
11918	17	13	3	1741	0	1774
11919	15	1907	8	20	0	1950
11920	14	14	4	1963	0	1995
11921	1973	18	2	20	0	2013
11922	1981	2	2	24	0	2009
11923	1992	6	4	5	0	2007
11924	27	5	4	1960	0	1996
11925	17	5	6	1968	0	1996
11926	10	16	1977	29	0	2032
11927	11	1	17	2005	0	2034
11928	5	9	2153	22	0	2189
11929	7	3	1836	18	0	1864
11930	2	5	1811	1	0	1819
11931	1	1845	21	5	0	1872
11932	5	11	12	1722	0	1750
11933	1	1952	3	6	0	1962
11934	1981	13	1	11	0	2006
11935	1971	12	2	2	0	1987
11936	28	1	2	2069	0	2100
11937	11	4	2089	19	0	2123
11938	2	3	29	2090	0	2124
11939	1	11	2184	34	0	2230
11940	5	4	28	2108	0	2145
11941	3	2156	18	29	0	2206
11942	2	2238	7	16	0	2263
11943	2174	44	3	5	0	2226
11944	29	16	2141	7	0	2193
11945	18	1	31	2099	0	2149
11946	5	1	17	2162	0	2185
11947	2165	2	5	45	0	2217
11948	32	2177	5	19	0	2233
11949	2202	30	5	5	0	2242
11950	30	2253	7	3	0	2293
11951	2225	30	2	6	0	2263
11952	2236	18	2	10	0	2266
11953	48	4	5	2239	0	2296
11954	23	8	2238	31	0	2300
11955	2060	3	32	26	0	2121
11956	31	2246	21	6	0	2304
11957	2304	32	5	8	0	2349
11958	35	17	7	2228	0	2287
11959	22	3	2	2208	0	2235
11960	6	2273	7	48	0	2334
11961	5	31	2	2232	0	2270
11962	7	2366	8	32	0	2413
11963	9	30	9	2363	0	2411
11964	8	17	1	2349	0	2375
11965	2254	4	3	54	0	2315
11966	40	8	2331	21	0	2400
11967	24	2316	35	6	0	2381
11968	9	30	18	2300	0	2357
11969	2306	22	2	34	0	2364
11970	2347	5	4	18	0	2374
11971	2411	3	2	11	0	2427
11972	56	6	2389	7	0	2458
11973	2385	3	41	6	0	2435
11974	45	4	22	2448	0	2519
11975	2429	7	2	49	0	2487
11976	45	2428	7	24	0	2504
11977	27	34	4	2458	0	2523
11978	2426	27	1	42	0	2496
11979	38	2507	6	27	0	2578
11980	30	36	4	2545	0	2615
11981	8	26	2604	43	0	2681
11982	2596	6	42	39	0	2683
11983	2821	6	23	11	0	2861
11984	78	10	2895	6	0	2989
11985	30	2862	45	4	0	2941
11986	11	3048	30	11	0	3100
11987	10	63	10	3021	0	3104
11988	12	29	3	2966	0	3010
11989	17	8	2	3045	0	3072
11990	16	11	3008	69	0	3104
11991	2983	6	53	35	0	3077
11992	3292	2	28	18	0	3340
11993	3419	9	4	18	0	3450
11994	3404	6	3	13	0	3426
11995	3373	15	1	12	0	3401
11996	3405	9	4	20	0	3438
11997	103	4	28	3382	0	3517
11998	49	10	3349	66	0	3474
11999	17	18	3412	41	0	3488
12000	13	10	100	3441	0	3564
12001	26	8	45	3425	0	3504
12002	17	16	5	3450	0	3488
12003	20	3470	17	93	0	3600
12004	3573	73	4	42	0	3692
12005	73	3733	14	21	0	3841
12006	51	70	9	3632	0	3762
12007	3555	40	6	93	0	3694
12008	68	3614	14	57	0	3753
12009	58	73	12	3604	0	3747
12010	18	52	10	3661	0	3741
12011	30	13	4	3694	0	3741
12012	29	3617	13	114	0	3773
12013	25	76	12	3696	0	3809
12014	21	54	3633	88	0	3796
12015	21	11	75	3769	0	3876
12016	23	11	46	3856	0	3936
12017	23	11	11	4104	0	4149
12018	23	11	15	4208	0	4257
12019	27	19	4043	173	0	4262
12020	22	4114	95	103	0	4334
12021	25	90	86	4159	0	4360
12022	23	90	20	4274	0	4407
12023	34	27	16	4169	0	4246
12024	22	4082	17	195	0	4316
12025	20	4309	24	136	0	4489
12026	4229	179	12	50	0	4470
12027	101	107	12	4132	0	4352
12028	93	44	3997	130	0	4264
12029	31	4003	91	123	0	4248
12030	3891	102	88	54	0	4135
12031	105	105	3893	36	0	4139
12032	101	36	3829	34	0	4000
12033	34	31	3880	39	0	3984
12034	21	41	190	3721	0	3973
12035	24	30	3871	110	0	4035
12036	27	3623	126	120	0	3896
12037	64	80	111	3583	0	3838
12038	17	89	3701	104	0	3911
12039	18	34	99	3638	0	3789
12040	3494	22	105	139	0	3760
12041	88	40	3550	126	0	3804
12042	3453	30	94	79	0	3656
12043	105	3634	98	66	0	3903
12044	3728	94	47	62	0	3931
12045	119	102	28	3659	0	3908
12046	3707	40	31	123	0	3901
12047	3712	30	49	116	0	3907
12048	3644	43	34	60	0	3781
12049	192	3629	45	43	0	3909
12050	3677	88	41	55	0	3861
12051	3591	90	40	64	0	3785
12052	186	46	3513	53	0	3798
12053	132	3522	110	50	0	3814
12054	66	102	119	3468	0	3755
12055	48	118	50	3565	0	3781
12056	54	43	32	3661	0	3790
12057	48	41	3491	196	0	3776
12058	34	30	108	3578	0	3750
12059	46	39	3537	143	0	3765
12060	3417	29	119	143	0	3708
12061	3543	27	110	78	0	3758
12062	171	36	3487	58	0	3752
12063	3521	25	117	57	0	3720
12064	3546	35	108	73	0	3762
12065	3636	24	58	53	0	3771
12066	226	28	36	3466	0	3756
12067	164	26	3562	125	0	3877
12068	84	3535	125	120	0	3864
12069	89	92	109	3518	0	3808
12070	78	115	3559	103	0	3855
12071	66	48	3395	117	0	3626
12072	3225	42	166	74	0	3507
12073	97	3532	136	68	0	3833
12074	3571	100	52	86	0	3809
12075	3523	94	49	78	0	3744
12076	179	3535	57	63	0	3834
12077	3600	85	57	64	0	3806
12078	136	105	3609	47	0	3897
12079	139	58	3466	48	0	3711
12080	103	26	3513	37	0	3679
12081	84	3321	187	32	0	3624
12082	3120	74	117	29	0	3340
12083	3115	87	74	37	0	3313
12084	178	2957	59	39	0	3233
12085	139	3019	53	52	0	3263
12086	77	125	59	2845	0	3106
12087	58	122	46	2897	0	3123
12088	2896	42	50	151	0	3139
12089	87	2930	53	107	0	3177
12090	2988	83	48	63	0	3182
12091	2873	91	45	51	0	3060
12092	149	56	2781	43	0	3029
12093	153	2756	65	46	0	3020
12094	99	75	76	2704	0	2954
12095	2778	96	44	60	0	2978
12096	120	34	39	2743	0	2936
12097	2700	31	55	72	0	2858
12098	102	33	2632	77	0	2844
12099	110	2488	89	46	0	2733
12100	72	2511	100	28	0	2711
12101	85	118	57	2153	0	2413
12102	66	2576	40	48	0	2730
12103	2536	87	43	70	0	2736
12104	68	92	2417	42	0	2619
12105	2239	59	42	48	0	2388
12106	75	52	2409	40	0	2576
12107	90	31	65	2362	0	2548
12108	73	35	79	2380	0	2567
12109	72	22	53	2433	0	2580
12110	2413	30	43	99	0	2585
12111	87	30	2390	76	0	2583
12112	96	30	53	2328	0	2507
12113	61	22	67	2263	0	2413
12114	54	2242	42	101	0	2439
12115	38	2148	31	87	0	2304
12116	55	2206	22	46	0	2329
12117	22	50	44	1910	0	2026
12118	32	24	11	1786	0	1853
12119	14	1638	9	18	0	1679
12120	10	1569	7	17	0	1603
12121	1536	5	6	9	0	1556
12122	7	15	8	1527	0	1557
12123	3	1506	2	3	0	1514
12124	1534	3	1	1	0	1539
12125	6	3	1	1537	0	1547
12126	1696	2	0	9	0	1707
12127	15	1	0	1763	0	1779
12128	9	2	1967	15	0	1993
12129	4	1980	14	13	0	2011
12130	1891	16	10	4	0	1921
12131	17	11	1970	1	0	1999
12132	12	2010	18	0	0	2040
12133	3	11	21	2041	0	2076
12134	4	11	18	2045	0	2078
12135	3	2	1	2025	0	2031
12136	5	2	0	2002	0	2009
12137	1	1	1951	26	0	1979
12138	2	1938	14	12	0	1966
12139	4	14	9	1937	0	1964
12140	1862	10	2	14	0	1888
12141	12	1971	1	16	0	2000
12142	11	14	0	2042	0	2067
12143	3	12	2003	20	0	2038
12144	3	2033	23	13	0	2072
12145	11	22	19	1761	0	1813
12146	2	2064	3	9	0	2078
12147	2081	22	3	6	0	2112
12148	2080	13	1	6	0	2100
12149	37	9	2065	2	0	2113
12150	2018	1	23	5	0	2047
12151	2166	0	14	10	0	2190
12152	40	3	2113	2	0	2158
12153	16	2187	28	2	0	2233
12154	3	23	16	2220	0	2262
12155	2	15	1	2283	0	2301
12156	2267	1	2	41	0	2311
12157	27	1	0	2314	0	2342
12158	16	3	2312	28	0	2359
12159	2083	2	23	22	0	2130
12160	29	8	2293	3	0	2333
12161	15	2314	26	3	0	2358
12162	2225	25	17	2	0	2269
12163	31	19	2277	0	0	2327
12164	18	5	2229	2	0	2254
12165	1	2254	42	3	0	2300
12166	8	24	16	2228	0	2276
12167	4	17	2138	22	0	2181
12168	5	4	29	1899	0	1937
12169	3	2	16	2120	0	2141
12170	2	2	2108	44	0	2156
12171	4	2089	30	16	0	2139
12172	4	26	17	2104	0	2151
12173	2017	16	3	28	0	2064
12174	2017	3	3	20	0	2043
12175	43	4	2	2032	0	2081
12176	18	4	2038	29	0	2089
12177	7	7	2207	16	0	2237
12178	5	0	41	2139	0	2185
12179	4	4	2117	32	0	2157
12180	2009	2	28	19	0	2058
12181	32	1	17	2103	0	2153
12182	19	0	3	2140	0	2162
12183	1	2131	9	46	0	2187
12184	4	32	1	2177	0	2214
12185	3	22	2146	38	0	2209
12186	1984	4	31	25	0	2044
12187	2152	3	16	7	0	2178
12188	47	3	2138	5	0	2193
12189	20	3	35	2408	0	2466
12190	8	1	18	2472	0	2499
12191	7	6	2454	77	0	2544
12192	5	2	46	2534	0	2587
12193	10	3	33	2428	0	2474
12194	2	2564	8	86	0	2660
12195	5	48	4	2628	0	2685
12196	5	38	1	2685	0	2729
12197	2739	4	4	98	0	2845
12198	2864	6	2	49	0	2921
12199	2923	3	4	15	0	2945
12200	2936	5	6	9	0	2956
12201	2948	1	4	10	0	2963
12202	111	7	2815	11	0	2944
12203	53	4	63	2777	0	2897
12204	18	3	44	2910	0	2975
12205	7	1	2892	108	0	3008
12206	2757	5	62	55	0	2879
12207	2885	4	47	17	0	2953
12208	107	7	2756	15	0	2885
12209	2891	5	60	8	0	2964
12210	2965	3	49	9	0	3026
12211	120	7	2928	24	0	3079
12212	71	2	66	2795	0	2934
12213	21	2948	57	58	0	3084
12214	16	61	16	3062	0	3155
12215	11	57	9	3079	0	3156
12216	14	5	5	3164	0	3188
12217	6	18	3059	119	0	3202
12218	2945	2	68	70	0	3085
12219	3114	11	54	17	0	3196
12220	118	0	15	3069	0	3202
12221	66	9	3022	77	0	3174
12222	23	6	70	3050	0	3149
12223	9	11	3123	75	0	3218
12224	19	6	3173	67	0	3265
12225	20	3296	121	11	0	3448
12226	11	51	58	3060	0	3180
12227	3053	52	18	65	0	3188
12228	2942	6	8	61	0	3017
12229	3001	5	17	19	0	3042
12230	107	4	17	2894	0	3022
12231	57	3066	16	67	0	3206
12232	13	55	14	3099	0	3181
12233	28	55	3257	64	0	3404
12234	3276	5	63	65	0	3409
12235	3434	7	60	24	0	3525
12236	123	6	17	3395	0	3541
12237	66	18	14	3450	0	3548
12238	22	2	11	3522	0	3557
12239	22	6	3382	124	0	3534
12240	2835	11	71	86	0	3003
12241	82	3311	63	28	0	3484
12242	62	3227	23	31	0	3343
12243	22	106	3223	16	0	3367
12244	21	51	61	3156	0	3289
12245	11	20	3250	66	0	3347
12246	2979	14	63	59	0	3115
12247	75	10	53	3055	0	3193
12248	61	12	3061	64	0	3198
12249	21	3155	70	69	0	3315
12250	3136	54	48	28	0	3266
12251	66	52	3257	15	0	3390
12252	63	3213	72	25	0	3373
12253	16	3272	60	25	0	3373
12254	3188	105	20	12	0	3325
12255	78	59	13	3195	0	3345
12256	71	15	3332	75	0	3493
12257	13	3312	83	66	0	3474
12258	3308	76	64	18	0	3466
12259	3309	62	13	30	0	3414
12260	129	3262	27	18	0	3436
12261	67	78	3313	21	0	3479
12262	27	61	79	3317	0	3484
12263	3339	13	60	76	0	3488
12264	3380	12	13	69	0	3474
12265	136	13	3318	13	0	3480
12266	75	21	72	3243	0	3411
12267	26	8	67	3423	0	3524
12268	22	12	3375	127	0	3536
12269	28	21	3371	69	0	3489
12270	3343	11	124	27	0	3505
12271	3474	7	75	25	0	3581
12272	3493	9	16	27	0	3545
12273	3501	7	24	18	0	3550
12274	136	18	3383	18	0	3555
12275	3407	8	72	22	0	3509
12276	101	7	65	3284	0	3457
12277	77	15	3224	80	0	3396
12278	29	11	3253	69	0	3362
12279	28	3207	124	30	0	3389
12280	16	66	81	3135	0	3298
12281	27	61	3186	71	0	3345
12282	3054	16	76	71	0	3217
12283	85	10	77	2687	0	2859
12284	72	3214	34	65	0	3385
12285	3272	70	18	65	0	3425
12286	3288	55	24	30	0	3397
12287	132	15	3271	21	0	3439
12288	81	3312	77	20	0	3490
12289	30	49	52	3009	0	3140
12290	3002	51	21	51	0	3125
12291	81	14	15	3008	0	3118
12292	55	12	2886	58	0	3011
12293	2605	8	62	49	0	2724
12294	59	2884	44	17	0	3004
12295	51	2782	17	19	0	2869
12296	22	2947	23	16	0	3008
12297	2831	68	42	24	0	2965
12298	2813	40	15	14	0	2882
12299	2841	9	16	11	0	2877
12300	80	12	14	2742	0	2848
12301	42	27	2745	47	0	2861
12302	23	13	49	2732	0	2817
12303	2767	4	34	54	0	2859
12304	59	7	15	2796	0	2877
12305	2774	10	17	49	0	2850
12306	2759	9	14	47	0	2829
12307	2768	6	15	13	0	2802
12308	74	2724	11	29	0	2838
12309	2746	41	19	11	0	2817
12310	57	31	2753	18	0	2859
12311	54	18	2692	10	0	2774
12312	21	2692	67	8	0	2788
12313	24	40	36	2572	0	2672
12314	2584	24	14	35	0	2657
12315	44	15	2583	31	0	2673
12316	2470	9	37	12	0	2528
12317	47	1	38	2403	0	2489
12318	32	2576	24	33	0	2665
12319	15	41	16	2587	0	2659
12320	19	46	2624	39	0	2728
12321	2401	7	33	40	0	2481
12322	48	9	2702	15	0	2774
12323	42	17	2567	5	0	2631
12324	2355	5	57	14	0	2431
12325	39	2377	33	8	0	2457
12326	2554	34	13	17	0	2618
12327	2565	23	14	11	0	2613
12328	68	10	2537	7	0	2622
12329	2411	36	36	13	0	2496
12330	51	15	2485	19	0	2570
12331	36	9	2357	2	0	2404
12332	15	12	2441	12	0	2480
12333	15	2284	49	4	0	2352
12334	2234	25	20	8	0	2287
12335	2255	22	5	7	0	2289
12336	2278	5	2	7	0	2292
12337	2259	1	9	6	0	2275
12338	56	3	2241	5	0	2305
12339	31	3	33	2196	0	2263
12340	13	1	24	2247	0	2285
12341	2246	1	10	46	0	2303
12342	33	2247	5	24	0	2309
12343	23	28	4	2237	0	2292
12344	2208	19	8	33	0	2268
12345	40	9	2279	19	0	2347
12346	24	4	29	2258	0	2315
12347	9	10	2326	25	0	2370
12348	12	2310	33	20	0	2375
12349	13	40	21	2197	0	2271
12350	2193	18	7	28	0	2246
12351	34	7	5	2174	0	2220
12352	25	7	2171	32	0	2235
12353	10	2154	25	26	0	2215
12354	2261	23	22	18	0	2324
12355	30	28	2368	6	0	2432
12356	2152	4	38	9	0	2203
12357	23	2261	31	5	0	2320
12358	2339	22	5	9	0	2375
12359	2342	23	1	3	0	2369
12360	44	3	4	2345	0	2396
12361	31	6	2352	25	0	2414
12362	6	2414	21	28	0	2469
12363	9	21	23	2475	0	2528
12364	4	22	7	2565	0	2598
12365	3	6	2	2823	0	2834
12366	5	2	1	2867	0	2875
12367	6	3170	6	63	0	3245
12368	3173	47	3	39	0	3262
12369	49	3230	11	9	0	3299
12370	48	54	3	3275	0	3380
12371	3300	48	5	53	0	3406
12372	63	5	1	3315	0	3384
12373	57	7	3276	60	0	3400
12374	11	3290	60	56	0	3417
12375	9	59	49	3290	0	3407
12376	6	53	7	3368	0	3434
12377	3282	6	1	107	0	3396
12378	61	11	3246	55	0	3373
12379	3197	6	53	13	0	3269
12380	3219	3	50	11	0	3283
12381	3263	5	8	8	0	3284
12382	107	14	3205	10	0	3336
12383	62	5	60	3166	0	3293
12384	13	3	53	3183	0	3252
12385	12	11	3299	109	0	3431
12386	13	12	3321	55	0	3401
12387	3297	6	110	13	0	3426
12388	70	7	57	3417	0	3551
12389	3451	5	7	72	0	3535
12390	3502	3	5	69	0	3579
12391	122	19	9	3478	0	3628
12392	65	7	3735	68	0	3875
12393	3483	11	71	65	0	3630
12394	79	3	59	3750	0	3891
12395	75	13	3766	83	0	3937
12396	17	3735	77	72	0	3901
12397	3589	75	65	23	0	3752
12398	77	3693	19	19	0	3808
12399	86	79	8	3257	0	3430
12400	20	3707	23	74	0	3824
12401	3588	77	12	67	0	3744
12402	3668	69	5	26	0	3768
12403	147	3632	16	20	0	3815
12404	3651	76	18	20	0	3765
12405	3664	69	11	31	0	3775
12406	144	3635	13	21	0	3813
12407	3629	74	15	37	0	3755
12408	108	61	14	3552	0	3735
12409	86	14	11	3651	0	3762
12410	3577	4	19	144	0	3744
12411	104	10	17	3402	0	3533
12412	87	3540	15	94	0	3736
12413	3540	72	19	82	0	3713
12414	3527	70	22	27	0	3646
12415	144	3546	31	20	0	3741
12416	3633	79	16	21	0	3749
12417	3647	65	17	29	0	3758
12418	156	13	15	3562	0	3746
12419	95	24	3540	88	0	3747
12420	37	3484	87	89	0	3697
12421	3503	88	69	33	0	3693
12422	3550	77	15	26	0	3668
12423	159	14	3437	26	0	3636
12424	3480	14	78	24	0	3596
12425	102	27	3446	30	0	3605
12426	3370	13	74	24	0	3481
12427	93	21	68	3313	0	3495
12428	87	23	3299	85	0	3494
12429	33	29	3331	77	0	3470
12430	39	22	123	3227	0	3411
12431	38	24	67	3208	0	3337
12432	39	24	3108	133	0	3304
12433	47	23	70	3110	0	3250
12434	50	32	3156	77	0	3315
12435	51	27	73	3093	0	3244
12436	59	18	60	3028	0	3165
12437	36	3024	20	134	0	3214
12438	46	3058	24	75	0	3203
12439	47	3198	19	21	0	3285
12440	45	129	11	3088	0	3273
12441	41	72	18	3124	0	3255
12442	50	26	3059	146	0	3281
12443	2901	21	78	87	0	3087
12444	3124	22	71	22	0	3239
12445	164	2999	21	22	0	3206
12446	3068	75	28	31	0	3202
12447	111	74	18	2978	0	3181
12448	3082	18	19	81	0	3200
12449	3067	23	11	92	0	3193
12450	170	17	28	2967	0	3182
12451	2868	23	18	81	0	2990
12452	95	2795	37	79	0	3006
12453	85	2835	32	24	0	2976
12454	50	115	23	2536	0	2724
12455	48	2754	23	75	0	2900
12456	41	74	20	2698	0	2833
12457	50	69	21	2706	0	2846
12458	2616	21	22	120	0	2779
12459	89	2584	26	85	0	2784
12460	2586	67	26	36	0	2715
12461	2498	68	25	27	0	2618
12462	138	2430	25	34	0	2627
12463	2448	70	23	30	0	2571
12464	89	60	2397	36	0	2582
12465	65	2179	64	24	0	2332
12466	2041	49	56	31	0	2177
12467	53	35	1718	20	0	1826
12468	44	1640	38	21	0	1743
12469	17	1698	56	21	0	1792
12470	1607	54	32	11	0	1704
12471	1607	39	7	12	0	1665
12472	1632	21	10	11	0	1674
12473	69	1596	13	11	0	1689
12474	42	27	9	1585	0	1663
12475	1587	29	10	40	0	1666
12476	1603	8	17	39	0	1667
12477	58	11	13	1602	0	1684
12478	46	22	1646	30	0	1744
12479	25	12	1654	37	0	1728
12480	14	10	53	1640	0	1717
12481	20	4	34	1701	0	1759
12482	21	10	1632	56	0	1719
12483	19	6	36	1494	0	1555
12484	17	1531	35	45	0	1628
12485	1417	23	17	27	0	1484
12486	30	35	12	1411	0	1488
12487	1349	8	8	26	0	1391
12488	18	1342	7	36	0	1403
12489	26	1340	12	9	0	1387
12490	1269	28	4	14	0	1315
12491	18	20	1216	12	0	1266
12492	992	31	8	8	0	1039
12493	10	1012	34	4	0	1060
12494	12	6	1	973	0	992
12495	986	9	1	10	0	1006
12496	5	1	4	966	0	976
12497	985	0	2	6	0	993
12498	953	1	3	11	0	968
12499	14	989	3	3	0	1009
12500	1004	4	1	3	0	1012
12501	2	997	2	5	0	1006
12502	1004	2	2	5	0	1013
12503	3	11	0	1017	0	1031
12504	1051	0	1	6	0	1058
12505	4	0	1	1044	0	1049
12506	1051	2	0	4	0	1057
12507	1050	3	0	9	0	1062
12508	1055	3	0	2	0	1060
12509	1072	1	0	2	0	1075
12510	1071	1	1	3	0	1076
12511	13	0	0	1074	0	1087
12512	1022	1	1	3	0	1027
12513	5	1001	3	11	0	1020
12514	9	2	985	0	0	996
12515	3	8	16	956	0	983
12516	1	5	990	4	0	1000
12517	1	0	2	1032	0	1035
12518	0	2	1039	6	0	1047
12519	1021	0	5	12	0	1038
12520	5	1	10	1071	0	1087
12521	10	3	1055	3	0	1071
12522	3	3	1181	15	0	1202
12523	3	1	18	1192	0	1214
12524	1341	0	12	14	0	1367
12525	10	1445	6	14	0	1475
12526	1469	9	1	5	0	1484
12527	1468	13	1	2	0	1484
12528	22	1439	2	2	0	1465
12529	1595	9	1	8	0	1613
12530	12	15	1	1591	0	1619
12531	18	3	2	1595	0	1618
12532	6	1	1	1591	0	1599
12533	1563	3	0	26	0	1592
12534	10	1600	0	19	0	1629
12535	15	15	2	1609	0	1641
12536	7	19	0	1700	0	1726
12537	1675	5	0	37	0	1717
12538	19	0	0	1688	0	1707
12539	24	3	1744	24	0	1795
12540	4	1816	15	22	0	1857
12541	1846	20	22	8	0	1896
12542	20	26	4	1784	0	1834
12543	26	1896	5	20	0	1947
12544	1903	18	2	22	0	1945
12545	23	32	1861	8	0	1924
12546	29	1883	21	0	0	1933
12547	1883	20	25	7	0	1935
12548	19	27	7	1878	0	1931
12549	27	4	2	1895	0	1928
12550	7	5	1875	48	0	1935
12551	9	1	20	1874	0	1904
12552	2	6	2021	27	0	2056
12553	6	4	1956	27	0	1993
12554	3	4	2123	9	0	2139
12555	2088	1	67	8	0	2164
12556	2168	0	31	3	0	2202
12557	2214	2	7	7	0	2230
12558	57	0	2	2115	0	2174
12559	36	2131	7	21	0	2195
12560	9	2160	1	28	0	2198
12561	2142	49	3	11	0	2205
12562	2124	31	1	2	0	2158
12563	45	2160	4	3	0	2212
12564	2095	23	2	10	0	2130
12565	27	27	2052	6	0	2112
12566	30	12	2134	2	0	2178
12567	8	4	46	2011	0	2069
12568	9	3	29	2172	0	2213
12569	5	12	2130	42	0	2189
12570	7	3	19	2098	0	2127
12571	2117	0	25	34	0	2176
12572	22	9	2120	25	0	2176
12573	2061	6	23	10	0	2100
12574	29	2	28	2209	0	2268
12575	24	4	2309	28	0	2365
12576	6	2343	26	25	0	2400
12577	2354	21	27	14	0	2416
12578	26	32	2294	6	0	2358
12579	2260	8	26	5	0	2299
12580	30	1	25	2301	0	2357
12581	2277	3	10	27	0	2317
12582	31	12	2336	23	0	2402
12583	34	2	25	2362	0	2423
12584	2472	3	24	28	0	2527
12585	2476	5	7	36	0	2524
12586	2599	2	3	16	0	2620
12587	2619	7	6	11	0	2643
12588	63	2	8	2537	0	2610
12589	36	5	5	2527	0	2573
12590	13	10	2545	61	0	2629
12591	13	1	36	2518	0	2568
12592	5	4	30	2500	0	2539
12593	8	2612	16	50	0	2686
12594	2632	31	8	37	0	2708
12595	2732	27	7	20	0	2786
12596	61	2885	7	13	0	2966
12597	40	44	5	2862	0	2951
12598	16	36	6	2925	0	2983
12599	2796	8	7	82	0	2893
12600	54	8	2965	46	0	3073
12601	45	3	50	2993	0	3091
12602	12	5	3085	59	0	3161
12603	2914	4	55	45	0	3018
12604	3041	3	43	14	0	3101
12605	3067	4	13	9	0	3093
12606	95	4	4	2967	0	3070
12607	48	2	6	3032	0	3088
12608	2982	3	7	90	0	3082
12609	55	13	2960	45	0	3073
12610	46	3	50	2948	0	3047
12611	2979	2	37	62	0	3080
12612	58	6	11	3014	0	3089
12613	43	27	3155	57	0	3282
12614	18	6	3179	40	0	3243
12615	3045	5	86	22	0	3158
12616	53	3264	49	10	0	3376
12617	3271	46	9	12	0	3338
12618	3307	33	9	16	0	3365
12619	84	6	8	3267	0	3365
12620	55	21	7	3240	0	3323
12621	17	3245	11	88	0	3361
12622	3138	43	8	46	0	3235
12623	50	3279	12	18	0	3359
12624	35	3154	11	10	0	3210
12625	15	65	7	3058	0	3145
12626	3031	31	10	46	0	3118
12627	3149	7	3	37	0	3196
12628	77	5	2	3147	0	3231
12629	42	4	4	3127	0	3177
12630	19	2	6	3166	0	3193
12631	3070	3	11	78	0	3162
12632	53	6	3107	46	0	3212
12633	38	3079	48	14	0	3179
12634	3113	41	25	19	0	3198
12635	55	24	6	3123	0	3208
12636	32	10	3049	47	0	3138
12637	16	9	3047	39	0	3111
12638	10	3079	65	18	0	3172
12639	14	3070	31	10	0	3125
12640	10	57	6	2936	0	3009
12641	13	2928	14	36	0	2991
12642	13	32	4	3089	0	3138
12643	14	23	7	3177	0	3221
12644	3247	4	5	61	0	3317
12645	39	8	4	3295	0	3346
12646	35	8	2	3323	0	3368
12647	10	13	3311	57	0	3391
12648	13	10	33	3375	0	3431
12649	3353	4	25	53	0	3435
12650	3425	5	3	34	0	3467
12651	67	3509	13	10	0	3599
12652	3460	35	7	26	0	3528
12653	44	32	3434	26	0	3536
12654	37	3441	51	18	0	3547
12655	14	41	26	3465	0	3546
12656	20	30	11	3535	0	3596
12657	21	9	9	3610	0	3649
12658	3597	5	8	73	0	3683
12659	3292	7	14	45	0	3358
12660	65	8	3612	27	0	3712
12661	40	12	3644	22	0	3718
12662	22	17	3775	15	0	3829
12663	19	3788	70	15	0	3892
12664	13	3854	35	20	0	3922
12665	3853	69	9	20	0	3951
12666	3807	30	8	24	0	3869
12667	72	7	11	3814	0	3904
12668	41	11	10	3718	0	3780
12669	21	3852	12	77	0	3962
12670	19	44	5	3985	0	4053
12671	17	38	3931	63	0	4049
12672	16	3941	57	58	0	4072
12673	20	50	37	4025	0	4132
12674	22	46	3988	60	0	4116
12675	27	16	49	3608	0	3700
12676	24	3883	39	53	0	3999
12677	4000	54	10	42	0	4106
12678	4006	35	10	25	0	4076
12679	4200	16	11	27	0	4254
12680	96	15	4	4270	0	4385
12681	58	16	5	4306	0	4385
12682	4307	20	7	108	0	4442
12683	72	4255	17	58	0	4402
12684	4330	50	14	21	0	4415
12685	64	56	4527	22	0	4669
12686	4479	25	62	25	0	4591
12687	4635	14	52	32	0	4733
12688	122	12	14	4532	0	4680
12689	4696	9	12	72	0	4789
12690	4698	17	19	70	0	4804
12691	125	10	18	4845	0	4998
12692	97	27	4810	76	0	5010
12693	4413	16	68	79	0	4576
12694	76	21	5137	25	0	5259
12695	69	5052	88	15	0	5224
12696	20	53	59	4974	0	5106
12697	14	60	22	5027	0	5123
12698	5268	11	10	124	0	5413
12699	88	27	5419	75	0	5609
12700	91	20	82	4903	0	5096
12701	22	5360	88	82	0	5552
12702	22	5303	16	75	0	5416
12703	24	152	11	5318	0	5505
12704	20	83	5321	111	0	5535
12705	17	16	98	5399	0	5530
12706	19	13	81	5331	0	5444
12707	14	24	5294	169	0	5501
12708	17	5390	94	87	0	5588
12709	5125	94	91	32	0	5342
12710	97	5566	29	18	0	5710
12711	95	103	18	5333	0	5549
12712	5330	92	14	100	0	5536
12713	101	5251	16	83	0	5451
12714	95	108	5321	25	0	5549
12715	5094	86	87	30	0	5297
12716	102	5400	94	23	0	5619
12717	5500	99	16	38	0	5653
12718	123	150	5265	30	0	5568
12719	5281	27	102	36	0	5446
12720	118	19	96	5276	0	5509
12721	100	16	5365	110	0	5591
12722	34	19	102	5157	0	5312
12723	34	5172	92	107	0	5405
12724	34	92	23	5335	0	5484
12725	37	92	15	5306	0	5450
12726	54	32	5203	179	0	5468
12727	41	10	95	5236	0	5382
12728	40	26	4714	131	0	4911
12729	27	5121	88	117	0	5353
12730	33	111	84	5104	0	5332
12731	34	100	5115	112	0	5361
12732	36	5064	114	123	0	5337
12733	33	5203	108	38	0	5382
12734	39	191	5019	46	0	5295
12735	40	98	4976	44	0	5158
12736	39	24	186	4865	0	5114
12737	4937	17	89	119	0	5162
12738	117	4901	36	121	0	5175
12739	119	107	24	4852	0	5102
12740	4866	96	16	133	0	5111
12741	116	4833	36	112	0	5097
12742	4831	106	23	41	0	5001
12743	136	4962	33	27	0	5158
12744	4858	116	32	34	0	5040
12745	4832	106	24	36	0	4998
12746	4870	23	54	49	0	4996
12747	223	5081	27	47	0	5378
12748	138	112	30	5077	0	5357
12749	57	111	4991	147	0	5306
12750	49	4958	139	128	0	5274
12751	59	125	133	4868	0	5185
12752	64	103	56	4952	0	5175
12753	41	27	4830	217	0	5115
12754	57	4763	137	131	0	5088
12755	4710	121	110	58	0	4999
12756	131	4808	37	58	0	5034
12757	128	121	23	4676	0	4948
12758	41	119	4642	135	0	4937
12759	4310	32	133	124	0	4599
12760	126	31	115	4658	0	4930
12761	107	32	4539	136	0	4814
12762	4167	28	128	126	0	4449
12763	117	4388	126	44	0	4675
12764	4461	119	29	53	0	4662
12765	4452	110	25	49	0	4636
12766	198	35	25	4336	0	4594
12767	108	39	4460	136	0	4743
12768	27	4424	132	118	0	4701
12769	30	134	4416	39	0	4619
12770	30	116	106	4180	0	4432
12771	22	41	100	4368	0	4531
12772	4220	26	35	205	0	4486
12773	113	31	4215	114	0	4473
12774	99	4178	123	40	0	4440
12775	32	117	100	4139	0	4388
12776	30	111	28	4224	0	4393
12777	4051	37	25	182	0	4295
12778	123	4111	26	108	0	4368
12779	102	107	19	3909	0	4137
12780	3697	88	19	109	0	3913
12781	95	3681	20	83	0	3879
12782	3668	98	14	19	0	3799
12783	3633	85	14	16	0	3748
12784	158	3581	30	28	0	3797
12785	3282	80	14	22	0	3398
12786	89	3273	21	12	0	3395
12787	3282	82	10	18	0	3392
12788	3256	66	15	13	0	3350
12789	138	3115	16	13	0	3282
12790	2994	73	9	17	0	3093
12791	3034	56	24	15	0	3129
12792	3034	10	9	12	0	3065
12793	127	14	2891	23	0	3055
12794	55	13	2523	7	0	2598
12795	11	17	2662	11	0	2701
12796	2482	4	111	12	0	2609
12797	69	10	2380	9	0	2468
12798	41	8	1957	9	0	2015
12799	12	6	60	1816	0	1894
12800	1871	5	35	33	0	1944
12801	43	12	1848	33	0	1936
12802	33	10	2066	11	0	2120
12803	15	8	56	2043	0	2122
12804	17	7	30	2122	0	2176
12805	13	11	4	2205	0	2233
12806	10	10	2164	64	0	2248
12807	17	11	36	2132	0	2196
12808	2104	8	31	40	0	2183
12809	43	2145	9	39	0	2236
12810	42	39	6	2052	0	2139
12811	17	35	4	2087	0	2143
12812	16	16	2118	62	0	2212
12813	11	2133	42	31	0	2217
12814	2039	38	37	9	0	2123
12815	55	2113	10	9	0	2187
12816	48	46	6	2074	0	2174
12817	18	37	2106	42	0	2203
12818	19	5	47	2207	0	2278
12819	17	7	41	2238	0	2303
12820	2292	9	13	76	0	2390
12821	61	6	19	2231	0	2317
12822	49	2270	19	56	0	2394
12823	15	2368	23	46	0	2452
12824	17	84	2391	12	0	2504
12825	2337	39	60	18	0	2454
12826	57	6	54	2418	0	2535
12827	49	5	14	2427	0	2495
12828	11	10	14	2494	0	2529
12829	2467	7	20	91	0	2585
12830	54	2487	15	58	0	2614
12831	2543	50	7	28	0	2628
12832	59	39	2398	20	0	2516
12833	43	11	2413	11	0	2478
12834	2371	11	88	18	0	2488
12835	57	9	39	2398	0	2503
12836	51	8	10	2465	0	2534
12837	15	9	14	2463	0	2501
12838	14	9	2375	103	0	2501
12839	2331	9	60	46	0	2446
12840	2414	11	44	15	0	2484
12841	2338	11	13	15	0	2377
12842	96	11	8	2294	0	2409
12843	91	8	2168	69	0	2336
12844	10	11	2208	48	0	2277
12845	20	8	2312	17	0	2357
12846	18	2180	84	19	0	2301
12847	69	34	33	1854	0	1990
12848	1847	25	8	42	0	1922
12849	35	8	1852	39	0	1934
12850	1884	5	36	20	0	1945
12851	40	4	34	1880	0	1958
12852	36	7	6	1863	0	1912
12853	13	1822	9	66	0	1910
12854	15	1895	12	33	0	1955
12855	9	1954	11	14	0	1988
12856	17	51	9	1909	0	1986
12857	1896	25	6	41	0	1968
12858	1920	5	10	45	0	1980
12859	61	10	1881	18	0	1970
12860	1844	3	35	19	0	1901
12861	43	12	1870	11	0	1936
12862	33	13	34	1861	0	1941
12863	14	6	1918	42	0	1980
12864	1841	9	43	31	0	1924
12865	39	8	36	1849	0	1932
12866	33	10	2036	38	0	2117
12867	7	4	1876	39	0	1926
12868	1794	5	50	20	0	1869
12869	1882	6	29	21	0	1938
12870	55	1883	16	15	0	1969
12871	38	34	6	1911	0	1989
12872	18	33	1937	40	0	2028
12873	12	13	1923	31	0	1979
12874	12	7	51	1940	0	2010
12875	1954	7	34	35	0	2030
12876	36	1961	15	32	0	2044
12877	31	33	9	1971	0	2044
12878	1958	25	6	41	0	2030
12879	38	4	9	1940	0	1991
12880	35	1987	21	31	0	2074
12881	13	32	16	2042	0	2103
12882	2038	27	10	43	0	2118
12883	43	3	12	2089	0	2147
12884	2037	5	8	35	0	2085
12885	32	2053	15	36	0	2136
12886	2067	30	13	17	0	2127
12887	32	36	2002	13	0	2083
12888	1958	9	38	12	0	2017
12889	2077	7	30	15	0	2129
12890	62	2137	12	14	0	2225
12891	40	30	9	2084	0	2163
12892	13	36	2083	31	0	2163
12893	11	6	2027	35	0	2079
12894	1945	4	56	15	0	2020
12895	1899	6	20	17	0	1942
12896	52	1919	4	15	0	1990
12897	28	1959	7	10	0	2004
12898	1920	43	9	7	0	1979
12899	36	1926	12	7	0	1981
12900	32	1997	11	8	0	2048
12901	9	41	11	2008	0	2069
12902	13	23	8	1874	0	1918
12903	10	7	1842	50	0	1909
12904	11	3	30	1813	0	1857
12905	1761	2	28	39	0	1830
12906	37	6	1776	29	0	1848
12907	29	13	1802	6	0	1850
12908	19	5	46	1724	0	1794
12909	17	5	24	1812	0	1858
12910	12	4	8	1853	0	1877
12911	9	7	1870	46	0	1932
12912	9	6	29	1790	0	1834
12913	12	4	22	1785	0	1823
12914	1752	4	9	37	0	1802
12915	23	1781	8	18	0	1830
12916	1765	21	6	6	0	1798
12917	28	20	1735	6	0	1789
12918	1569	3	13	8	0	1593
12919	13	1675	19	3	0	1710
12920	1523	4	0	2	0	1529
12921	5	1523	3	2	0	1533
12922	1411	5	2	4	0	1422
12923	5	1392	3	2	0	1402
12924	9	1367	3	3	0	1382
12925	14	13	1	1338	0	1366
12926	1330	7	1	9	0	1347
12927	1334	0	1	8	0	1343
12928	1326	2	3	2	0	1333
12929	12	2	1313	2	0	1329
12930	7	3	1283	2	0	1295
12931	3	0	10	1300	0	1313
12932	1	1369	9	2	0	1381
12933	1	1406	2	8	0	1417
12934	3	11	1	1383	0	1398
12935	1406	9	1	6	0	1422
12936	1398	1	0	9	0	1408
12937	1414	2	2	2	0	1420
12938	13	3	1515	2	0	1533
12939	10	2	4	1513	0	1529
12940	2	4	1542	4	0	1552
12941	1528	1	3	11	0	1543
12942	1607	1	8	3	0	1619
12943	13	5	1602	0	0	1620
12944	11	1	3	1609	0	1624
12945	1617	0	10	4	0	1631
12946	6	2	1	1628	0	1637
12947	11	1	0	1640	0	1652
12948	4	3	0	1738	0	1745
12949	1820	1	1	24	0	1846
12950	16	0	2	2007	0	2025
12951	2073	1	1	18	0	2093
12952	20	2192	1	22	0	2235
12953	21	22	2	2405	0	2450
12954	1	25	3	2368	0	2397
12955	5	3	0	2331	0	2339
12956	2370	1	3	50	0	2424
12957	27	1	0	2367	0	2395
12958	32	4	1	2133	0	2170
12959	2417	1	1	42	0	2461
12960	2426	0	1	31	0	2458
12961	2433	0	1	5	0	2439
12962	53	4	2391	1	0	2449
12963	34	6	2217	1	0	2258
12964	2370	1	50	3	0	2424
12965	24	1	26	2388	0	2439
12966	31	2	1	2126	0	2160
12967	2302	1	0	54	0	2357
12968	2274	3	0	32	0	2309
12969	2169	2	2	2	0	2175
12970	46	2251	5	1	0	2303
12971	2310	22	0	3	0	2335
12972	2154	30	2	3	0	2189
12973	50	2263	4	3	0	2320
12974	26	2212	3	3	0	2244
12975	16	47	2	2035	0	2100
12976	2316	27	1	17	0	2361
12977	2322	1	2	25	0	2350
12978	2308	0	1	7	0	2316
12979	53	1	1	2230	0	2285
12980	2241	1	1	24	0	2267
12981	26	5	2200	28	0	2259
12982	2138	2	22	5	0	2167
12983	22	3	2198	5	0	2228
12984	28	1	2111	6	0	2146
12985	6	0	41	2074	0	2121
12986	2109	0	21	29	0	2159
12987	24	1	2	2086	0	2113
12988	24	3	2177	22	0	2226
12989	6	4	2205	27	0	2242
12990	5	0	44	2168	0	2217
12991	2118	3	23	26	0	2170
12992	24	2361	5	27	0	2417
12993	27	20	2	2444	0	2493
12994	7	25	0	2432	0	2464
12995	8	8	2524	49	0	2589
12996	11	8	2551	29	0	2599
12997	9	0	43	2652	0	2704
12998	2702	0	23	33	0	2758
12999	33	10	2672	28	0	2743
13000	39	5	20	2608	0	2672
13001	16	6	25	2657	0	2704
13002	11	5	5	2640	0	2661
13003	2582	3	1	63	0	2649
13004	36	7	2297	51	0	2391
13005	32	2583	17	31	0	2663
13006	17	24	18	2635	0	2694
13007	25	30	2589	40	0	2684
13008	30	2546	22	46	0	2644
13009	30	2598	32	21	0	2681
13010	2589	45	7	23	0	2664
13011	55	2544	10	8	0	2617
13012	2595	29	13	34	0	2671
13013	45	32	2563	35	0	2675
13014	45	15	26	2632	0	2718
13015	2586	4	31	62	0	2683
13016	46	2584	11	67	0	2708
13017	54	32	2580	40	0	2706
13018	62	33	20	2318	0	2433
13019	38	2634	35	47	0	2754
13020	41	33	7	2763	0	2844
13021	2752	34	14	47	0	2847
13022	62	2788	19	65	0	2934
13023	2832	37	6	32	0	2907
13024	2873	41	16	32	0	2962
13025	93	13	2877	37	0	3020
13026	92	3038	36	24	0	3190
13027	57	36	41	3218	0	3352
13028	50	43	3334	58	0	3485
13029	59	16	3598	57	0	3730
13030	58	8	104	3630	0	3800
13031	3796	5	69	65	0	3935
13032	3702	19	28	70	0	3819
13033	143	14	17	3740	0	3914
13034	100	12	3769	78	0	3959
13035	48	3774	70	69	0	3961
13036	3885	71	61	30	0	4047
13037	3934	58	21	30	0	4043
13038	136	3876	21	18	0	4051
13039	4021	70	23	30	0	4144
13040	106	69	3917	20	0	4112
13041	3853	24	69	35	0	3981
13042	3664	13	78	21	0	3776
13043	127	14	3863	18	0	4022
13044	90	7	77	3773	0	3947
13045	32	9	3837	81	0	3959
13046	27	3721	104	68	0	3920
13047	17	3793	74	45	0	3929
13048	32	103	29	3595	0	3759
13049	37	56	3681	68	0	3842
13050	11	3472	60	60	0	3603
13051	5	3407	60	17	0	3489
13052	3176	117	13	5	0	3311
13053	3130	42	3	5	0	3180
13054	78	6	4	3131	0	3219
13055	51	3	4	3057	0	3115
13056	11	3160	6	67	0	3244
13057	3086	37	2	49	0	3174
13058	3161	35	6	15	0	3217
13059	75	3152	7	13	0	3247
13060	51	39	4	3179	0	3273
13061	17	40	3158	42	0	3257
13062	10	9	45	3168	0	3232
13063	3215	3	39	52	0	3309
13064	44	7	10	3257	0	3318
13065	46	3	4	3294	0	3347
13066	3241	1	6	82	0	3330
13067	53	7	3	3214	0	3277
13068	47	3297	8	54	0	3406
13069	17	47	7	3363	0	3434
13070	11	33	5	3380	0	3429
13071	9	8	8	3310	0	3335
13072	5	3345	9	76	0	3435
13073	10	50	0	3369	0	3429
13074	8	46	3307	59	0	3420
13075	6	15	50	3454	0	3525
13076	10	18	3433	67	0	3528
13077	6	3405	60	48	0	3519
13078	18	48	43	3444	0	3553
13079	20	44	12	3481	0	3557
13080	7	16	7	3512	0	3542
13081	10	10	4	3508	0	3532
13082	9	16	3395	104	0	3524
13083	6	3372	54	68	0	3500
13084	14	47	44	3434	0	3539
13085	16	49	3424	58	0	3547
13086	19	10	52	3475	0	3556
13087	3442	8	42	66	0	3558
13088	60	15	3375	58	0	3508
13089	3273	6	52	19	0	3350
13090	70	6	41	3324	0	3441
13091	56	12	3329	67	0	3464
13092	22	3203	59	55	0	3339
13093	16	57	50	3185	0	3308
13094	14	51	3296	63	0	3424
13095	13	3253	57	51	0	3374
13096	18	59	45	3160	0	3282
13097	3124	50	17	67	0	3258
13098	3151	13	8	61	0	3233
13099	3189	9	7	36	0	3241
13100	110	12	3194	14	0	3330
13101	60	3255	64	18	0	3397
13102	24	62	53	3266	0	3405
13103	20	59	19	3468	0	3566
13104	3560	19	12	113	0	3704
13105	67	3758	17	77	0	3919
13106	3825	83	10	26	0	3944
13107	3812	67	6	21	0	3906
13108	3906	18	13	27	0	3964
13109	147	18	3760	25	0	3950
13110	3814	9	86	25	0	3934
13111	100	13	68	3811	0	3992
13112	74	16	20	3829	0	3939
13113	3774	11	10	148	0	3943
13114	91	12	14	3741	0	3858
13115	67	3705	18	107	0	3897
13116	28	81	12	3731	0	3852
13117	3599	65	6	107	0	3777
13118	88	26	3600	76	0	3790
13119	74	3536	81	35	0	3726
13120	27	80	60	3471	0	3638
13121	3464	60	15	101	0	3640
13122	73	24	3421	66	0	3584
13123	63	166	78	3246	0	3553
13124	29	44	3377	81	0	3531
13125	42	16	3274	64	0	3396
13126	19	19	3156	22	0	3216
13127	21	13	3019	21	0	3074
13128	18	10	2907	9	0	2944
13129	2440	5	89	10	0	2544
13130	44	2447	53	17	0	2561
13131	2326	35	17	10	0	2388
13132	2337	33	5	14	0	2389
13133	68	2298	11	15	0	2392
13134	40	2362	11	5	0	2418
13135	2316	67	25	8	0	2416
13136	2364	31	1	12	0	2408
13137	75	9	5	2240	0	2329
13138	40	2368	7	37	0	2452
13139	2336	34	9	38	0	2417
13140	41	2364	16	11	0	2432
13141	37	42	5	2346	0	2430
13142	2357	30	7	52	0	2446
13143	2370	13	5	37	0	2425
13144	68	5	5	2370	0	2448
13145	41	10	4	2387	0	2442
13146	14	13	2318	72	0	2417
13147	21	6	38	2314	0	2379
13148	11	7	2334	43	0	2395
13149	14	10	41	2200	0	2265
13150	13	3	31	2259	0	2306
13151	2217	1	15	70	0	2303
13152	2176	6	10	42	0	2234
13153	66	11	2175	19	0	2271
13154	2135	3	44	12	0	2194
13155	46	6	38	2158	0	2248
13156	36	6	2149	42	0	2233
13157	19	4	46	2170	0	2239
13158	22	5	33	2270	0	2330
13159	16	9	2223	75	0	2323
13160	17	9	43	2273	0	2342
13161	17	11	2290	50	0	2368
13162	19	5	46	2347	0	2417
13163	2369	6	43	57	0	2475
13164	48	2426	20	47	0	2541
13165	2452	45	10	24	0	2531
13166	52	2510	20	11	0	2593
13167	2453	55	6	17	0	2531
13168	59	2388	20	7	0	2474
13169	2306	49	28	18	0	2401
13170	62	2314	9	13	0	2398
13171	45	60	8	2287	0	2400
13172	25	48	2306	47	0	2426
13173	11	66	2199	50	0	2326
13174	21	4	85	2184	0	2294
13175	2117	15	50	50	0	2232
13176	58	2224	17	51	0	2350
13177	52	55	5	2264	0	2376
13178	18	49	2295	59	0	2421
13179	13	15	2352	55	0	2435
13180	20	6	96	2132	0	2254
13181	13	2323	58	49	0	2443
13182	2322	43	7	50	0	2422
13183	53	62	2359	18	0	2492
13184	58	13	2313	18	0	2402
13185	15	2371	99	11	0	2496
13186	2324	65	62	9	0	2460
13187	2372	44	15	23	0	2454
13188	88	21	8	2327	0	2444
13189	2424	7	10	41	0	2482
13190	2368	8	15	53	0	2444
13191	82	2376	19	23	0	2500
13192	2346	51	11	13	0	2421
13193	57	53	2339	11	0	2460
13194	59	16	48	2298	0	2421
13195	24	9	47	2288	0	2368
13196	2262	13	14	85	0	2374
13197	56	2266	16	57	0	2395
13198	2271	54	10	17	0	2352
13199	58	2318	18	9	0	2403
13200	50	2231	17	11	0	2309
13201	16	77	2135	27	0	2255
13202	11	47	2109	17	0	2184
13203	1825	24	79	8	0	1936
13204	1792	21	54	8	0	1875
13205	57	10	1655	6	0	1728
13206	36	1586	21	3	0	1646
13207	11	1629	32	8	0	1680
13208	1606	40	14	13	0	1673
13209	1620	35	12	3	0	1670
13210	54	15	3	1677	0	1749
13211	1725	2	5	23	0	1755
13212	23	8	17	1704	0	1752
13213	31	15	1674	23	0	1743
13214	11	18	1609	30	0	1668
13215	1662	8	40	13	0	1723
13216	37	8	27	1627	0	1699
13217	32	1841	11	31	0	1915
13218	1902	19	14	27	0	1962
13219	1882	33	10	17	0	1942
13220	51	10	1917	10	0	1988
13221	1904	10	28	8	0	1950
13222	1968	7	26	11	0	2012
13223	48	9	12	1929	0	1998
13224	40	1874	13	16	0	1943
13225	14	1970	12	32	0	2028
13226	25	48	13	2011	0	2097
13227	13	36	21	1996	0	2066
13228	29	6	8	2046	0	2089
13229	23	14	1995	46	0	2078
13230	18	18	1945	38	0	2019
13231	15	22	40	1913	0	1990
13232	19	17	1933	17	0	1986
13233	15	13	1894	38	0	1960
13234	14	6	46	1829	0	1895
13235	17	8	2036	30	0	2091
13236	11	2005	33	41	0	2090
13237	2148	29	39	18	0	2234
13238	37	37	17	2093	0	2184
13239	39	2112	24	28	0	2203
13240	17	34	2192	39	0	2282
13241	14	43	28	2218	0	2303
13242	18	10	2359	25	0	2412
13243	17	13	34	2348	0	2412
13244	23	5	42	2402	0	2472
13245	20	25	2469	67	0	2581
13246	13	20	36	2410	0	2479
13247	15	2456	51	35	0	2557
13248	10	33	17	2550	0	2610
13249	19	48	2590	37	0	2694
13250	12	12	32	2579	0	2635
13251	2511	12	39	49	0	2611
13252	41	2576	14	46	0	2677
13253	42	25	21	2590	0	2678
13254	12	45	2685	42	0	2784
13255	18	2631	44	49	0	2742
13256	10	2650	49	18	0	2727
13257	14	62	2598	19	0	2693
13258	14	34	29	2465	0	2542
13259	15	9	32	2481	0	2537
13260	12	8	2493	51	0	2564
13261	6	2425	30	39	0	2500
13262	8	2421	29	11	0	2469
13263	2288	36	4	6	0	2334
13264	23	2298	8	5	0	2334
13265	2265	20	2	11	0	2298
13266	19	20	3	2217	0	2259
13267	2318	5	3	27	0	2353
13268	25	8	2374	21	0	2428
13269	2385	1	19	8	0	2413
13270	23	4	15	2453	0	2495
13271	17	2476	7	21	0	2521
13272	2526	17	5	22	0	2570
13273	21	51	2	2603	0	2677
13274	17	2728	10	17	0	2772
13275	4	2847	11	18	0	2880
13276	2729	23	33	10	0	2795
13277	2789	13	1	7	0	2810
13278	2783	3	3	7	0	2796
13279	28	0	1	2698	0	2727
13280	12	2687	6	15	0	2720
13281	1	2763	4	11	0	2779
13282	5	28	2	2748	0	2783
13283	2707	13	2	23	0	2745
13284	2637	0	3	19	0	2659
13285	2644	0	2	12	0	2658
13286	29	3	2675	2	0	2709
13287	14	11	2654	6	0	2685
13288	2719	2	27	7	0	2755
13289	19	3	13	2745	0	2780
13290	17	6	1	2791	0	2815
13291	5	1	5	2798	0	2809
13292	3	2	3	2813	0	2821
13293	6	7	2775	31	0	2819
13294	5	4	22	2756	0	2787
13295	4	6	2810	25	0	2845
13296	2571	1	24	22	0	2618
13297	18	2836	17	11	0	2882
13298	21	21	5	2942	0	2989
13299	5	14	6	2907	0	2932
13300	2874	7	5	40	0	2926
13301	2850	4	4	22	0	2880
13302	2902	5	4	16	0	2927
13303	2890	8	11	11	0	2920
13304	31	6	2897	14	0	2948
13305	15	9	2901	11	0	2936
13306	7	6	31	2985	0	3029
13307	3004	5	17	29	0	3055
13308	2987	8	6	20	0	3021
13309	34	11	2984	20	0	3049
13310	20	11	23	2871	0	2925
13311	2919	7	15	34	0	2975
13312	28	5	8	2940	0	2981
13313	16	14	2939	31	0	3000
13314	8	6	22	2884	0	2920
13315	2873	7	17	31	0	2928
13316	20	3199	10	23	0	3252
13317	3171	24	3	20	0	3218
13318	3167	16	6	14	0	3203
13319	3189	7	8	7	0	3211
13320	38	10	3	3192	0	3243
13321	3201	5	6	28	0	3240
13322	28	3484	6	18	0	3536
13323	21	3609	10	13	0	3653
13324	11	55	8	3604	0	3678
13325	3678	34	3	52	0	3767
13326	43	3881	13	32	0	3969
13327	4724	46	4	22	0	4796
13328	4911	43	4	11	0	4969
13329	136	5123	10	15	0	5284
13330	107	95	7	5313	0	5522
13331	22	77	6	5428	0	5533
13332	23	34	5422	168	0	5647
13333	30	7	92	5495	0	5624
13334	24	49	5569	117	0	5759
13335	18	5393	111	96	0	5618
13336	34	91	74	5413	0	5612
13337	5230	75	18	108	0	5431
13338	5270	17	15	94	0	5396
13339	160	9	15	5298	0	5482
13340	89	17	5168	102	0	5376
13341	4654	15	95	92	0	4856
13342	92	5012	73	33	0	5210
13343	85	5073	23	12	0	5193
13344	28	5142	8	43	0	5221
13345	26	195	10	4871	0	5102
13346	22	128	5222	91	0	5463
13347	19	22	89	5251	0	5381
13348	13	31	5373	101	0	5518
13349	19	25	5299	82	0	5425
13350	14	26	5429	26	0	5495
13351	13	16	171	5036	0	5236
13352	15	14	95	5395	0	5519
13353	7	8	30	5520	0	5565
13354	11	7	26	5391	0	5435
13355	5319	7	25	170	0	5521
13356	90	5302	24	104	0	5520
13357	5376	89	20	37	0	5522
13358	97	5535	28	39	0	5699
13359	81	96	10	5556	0	5743
13360	34	77	8	5740	0	5859
13361	5651	26	6	177	0	5860
13362	5713	25	12	106	0	5856
13363	5825	16	9	35	0	5885
13364	5814	16	11	26	0	5867
13365	5785	17	10	41	0	5853
13366	183	5672	16	21	0	5892
13367	5649	103	8	34	0	5794
13368	118	5641	20	22	0	5801
13369	5574	105	14	33	0	5726
13370	128	93	5487	30	0	5738
13371	110	29	93	5305	0	5537
13372	46	5578	84	80	0	5788
13373	41	103	20	5488	0	5652
13374	38	99	5360	118	0	5615
13375	42	30	97	5278	0	5447
13376	5157	25	88	125	0	5395
13377	99	5218	37	123	0	5477
13378	92	5346	27	54	0	5519
13379	36	192	5379	51	0	5658
13380	38	108	105	5144	0	5395
13381	30	5534	100	124	0	5788
13382	35	95	36	5698	0	5864
13383	32	100	5797	116	0	6045
13384	31	5720	109	121	0	5981
13385	41	125	5810	38	0	6014
13386	38	105	5765	38	0	5946
13387	34	35	168	5712	0	5949
13388	5812	33	100	116	0	6061
13389	123	31	42	5868	0	6064
13390	96	48	5920	125	0	6189
13391	34	32	115	5990	0	6171
13392	27	46	6307	126	0	6506
13393	19	31	6405	126	0	6581
13394	6317	24	187	56	0	6584
13395	6648	27	116	59	0	6850
13396	6697	19	60	60	0	6836
13397	192	27	6519	48	0	6786
13398	109	38	6496	50	0	6693
13399	53	18	203	6305	0	6579
13400	40	23	116	6584	0	6763
13401	6547	19	47	207	0	6820
13402	130	16	35	6585	0	6766
13403	119	28	6581	146	0	6874
13404	48	45	6515	135	0	6743
13405	44	6507	203	61	0	6815
13406	47	118	105	6540	0	6810
13407	61	110	6614	135	0	6920
13408	48	27	130	6549	0	6754
13409	6598	19	119	157	0	6893
13410	147	24	6776	117	0	7064
13411	128	30	132	6681	0	6971
13412	66	31	106	6881	0	7084
13413	60	40	6792	210	0	7102
13414	56	18	130	6668	0	6872
13415	49	26	6864	149	0	7088
13416	6104	27	147	129	0	6407
13417	150	19	109	6271	0	6549
13418	116	6343	66	124	0	6649
13419	6328	120	42	131	0	6621
13420	6301	96	42	66	0	6505
13421	202	6236	46	53	0	6537
13422	102	374	23	5426	0	5925
13423	33	5781	30	121	0	5965
13424	44	5839	18	75	0	5976
13425	88	174	5577	37	0	5876
13426	34	5225	124	49	0	5432
13427	13	92	4292	13	0	4410
13428	3248	18	81	17	0	3364
13429	3543	9	27	10	0	3589
13430	43	3882	10	12	0	3947
13431	25	3945	9	12	0	3991
13432	5	4128	13	10	0	4156
13433	4194	50	5	12	0	4261
13434	40	20	10	4241	0	4311
13435	25	12	4495	46	0	4578
13436	7	4569	44	28	0	4648
13437	5	48	27	4646	0	4726
13438	10	31	6	4397	0	4444
13439	8	5412	13	64	0	5497
13440	5609	73	3	39	0	5724
13441	84	69	5708	22	0	5883
13442	75	15	88	6115	0	6293
13443	12	7148	80	111	0	7351
13444	7050	133	12	74	0	7269
13445	143	116	7060	22	0	7341
13446	105	6973	138	16	0	7232
13447	21	131	103	6923	0	7178
13448	13	117	6929	133	0	7192
13449	6542	20	138	107	0	6807
13450	138	7	109	6836	0	7090
13451	114	28	6911	128	0	7181
13452	19	6860	145	128	0	7152
13453	6703	137	107	26	0	6973
13454	136	6952	33	11	0	7132
13455	6940	150	7	30	0	7127
13456	6925	107	14	21	0	7067
13457	244	25	11	6692	0	6972
13458	118	6407	21	149	0	6695
13459	39	136	6486	112	0	6773
13460	18	106	139	6561	0	6824
13461	35	47	123	5837	0	6042
13462	29	16	32	6766	0	6843
13463	30	14	18	6788	0	6850
13464	26	15	20	6788	0	6849
13465	6556	26	17	262	0	6861
13466	6510	13	20	128	0	6671
13467	6254	18	23	39	0	6334
13468	234	6145	37	35	0	6451
13469	119	142	6345	31	0	6637
13470	31	118	6457	27	0	6633
13471	32	43	6544	28	0	6647
13472	39	26	274	6071	0	6410
13473	36	31	125	6373	0	6565
13474	33	28	43	6462	0	6566
13475	35	38	6273	273	0	6619
13476	20	6090	161	172	0	6443
13477	46	151	6289	37	0	6523
13478	43	120	6374	39	0	6576
13479	31	31	252	6098	0	6412
13480	30	38	6396	170	0	6634
13481	28	27	175	6062	0	6292
13482	6048	26	128	181	0	6383
13483	6010	33	43	149	0	6235
13484	284	30	5915	55	0	6284
13485	149	35	164	5724	0	6072
13486	59	38	5952	178	0	6227
13487	35	5853	171	166	0	6225
13488	5785	157	141	53	0	6136
13489	178	152	5878	50	0	6258
13490	150	5623	179	61	0	6013
13491	47	5692	154	64	0	5957
13492	36	5557	74	82	0	5749
13493	55	278	5068	54	0	5455
13494	56	140	172	4612	0	4980
13495	50	4973	142	164	0	5329
13496	46	160	55	5056	0	5317
13497	43	143	59	5127	0	5372
13498	4965	41	56	280	0	5342
13499	167	4961	85	170	0	5383
13500	4908	155	54	75	0	5192
13501	169	4904	62	70	0	5205
13502	142	4999	60	73	0	5274
13503	70	258	4835	68	0	5231
13504	70	174	175	4711	0	5130
13505	60	64	4892	162	0	5178
13506	52	4673	171	196	0	5092
13507	54	158	4816	79	0	5107
13508	52	140	4729	75	0	4996
13509	46	4652	269	69	0	5036
13510	4449	149	165	75	0	4838
13511	150	4651	74	83	0	4958
13512	4652	154	58	89	0	4953
13513	161	144	4602	89	0	4996
13514	152	45	4639	87	0	4923
13515	62	4564	275	69	0	4970
13516	4528	159	148	66	0	4901
13517	170	4672	81	49	0	4972
13518	144	158	78	4584	0	4964
13519	4661	138	73	161	0	5033
13520	147	76	4658	152	0	5033
13521	152	40	190	4702	0	5084
13522	4678	43	152	178	0	5051
13523	156	4677	77	176	0	5086
13524	136	173	58	4653	0	5020
13525	45	145	4645	181	0	5016
13526	4567	51	184	163	0	4965
13527	155	44	159	4674	0	5032
13528	129	61	4663	177	0	5030
13529	53	42	176	4558	0	4829
13530	41	4476	165	194	0	4876
13531	58	155	4512	169	0	4894
13532	73	137	153	4244	0	4607
13533	4048	43	145	146	0	4382
13534	160	39	59	4018	0	4276
13535	3751	42	56	134	0	3983
13536	132	3644	71	118	0	3965
13537	3633	129	61	44	0	3867
13538	127	123	3444	41	0	3735
13539	85	41	2787	25	0	2938
13540	22	33	2506	22	0	2583
13541	21	2297	166	19	0	2503
13542	157	22	90	847	0	1116
13543	2	18	5	837	0	862
13544	2	3	2	832	0	839
13545	1	6	2	851	0	860
13546	2	5	835	24	0	866
13547	756	3	15	17	0	791
13548	12	835	17	4	0	868
13549	817	15	6	1	0	839
13550	14	14	1	819	0	848
13551	15	785	5	12	0	817
13552	5	12	3	798	0	818
13553	791	15	4	10	0	820
13554	12	786	10	15	0	823
13555	799	15	3	5	0	822
13556	807	17	2	1	0	827
13557	28	4	3	815	0	850
13558	14	5	763	17	0	799
13559	731	2	13	16	0	762
13560	17	4	13	791	0	825
13561	805	3	3	15	0	826
13562	797	0	4	15	0	816
13563	802	1	6	3	0	812
13564	27	8	789	1	0	825
13565	15	4	16	798	0	833
13566	802	3	16	14	0	835
13567	15	4	863	17	0	899
13568	16	858	13	7	0	894
13569	4	11	17	799	0	831
13570	3	12	861	13	0	889
13571	7	2	852	15	0	876
13572	2	5	24	793	0	824
13573	6	4	13	834	0	857
13574	6	2	5	840	0	853
13575	5	6	2	833	0	846
13576	4	1	804	29	0	838
13577	4	814	15	16	0	849
13578	3	9	17	778	0	807
13579	754	13	3	14	0	784
13580	698	3	5	13	0	719
13581	708	4	3	7	0	722
13582	24	4	3	669	0	700
13583	14	2	3	599	0	618
13584	4	573	2	23	0	602
13585	5	596	1	13	0	615
13586	7	15	3	592	0	617
13587	548	5	0	9	0	562
13588	553	3	3	8	0	567
13589	542	1	3	2	0	548
13590	539	2	0	6	0	547
13591	561	1	4	5	0	571
13592	11	550	5	5	0	571
13593	7	8	2	555	0	572
13594	553	9	3	9	0	574
13595	561	0	5	9	0	575
13596	14	2	5	550	0	571
13597	9	2	4	553	0	568
13598	2	1	583	16	0	602
13599	4	3	5	575	0	587
13600	5	1	6	584	0	596
13601	3	2	608	10	0	623
13602	2	10	6	592	0	610
13603	5	648	4	9	0	666
13604	5	5	657	5	0	672
13605	7	675	7	0	0	689
13606	3	4	6	650	0	663
13607	4	3	1	626	0	634
13608	1	632	4	10	0	647
13609	0	659	3	4	0	666
13610	668	7	2	3	0	680
13611	668	8	0	3	0	679
13612	11	0	654	4	0	669
13613	763	0	8	11	0	782
13614	818	0	6	2	0	826
13615	825	0	0	2	0	827
13616	820	2	3	2	0	827
13617	14	2	771	6	0	793
13618	4	3	688	4	0	699
13619	723	1	8	3	0	735
13620	6	774	5	1	0	786
13621	5	5	726	1	0	737
13622	696	2	3	5	0	706
13623	747	0	5	4	0	756
13624	6	0	746	3	0	755
13625	691	1	1	5	0	698
13626	2	1	3	809	0	815
13627	5	5	827	5	0	842
13628	722	1	4	7	0	734
13629	4	826	5	1	0	836
13630	865	4	2	3	0	874
13631	923	5	1	6	0	935
13632	9	1	0	922	0	932
13633	6	0	0	943	0	949
13634	3	0	0	947	0	950
13635	963	1	1	12	0	977
13636	1007	1	0	8	0	1016
13637	10	0	0	1012	0	1022
13638	6	1	2	1025	0	1034
13639	2	2	1019	12	0	1035
13640	952	0	7	9	0	968
13641	10	1	5	1041	0	1057
13642	8	1	1	1047	0	1057
13643	2	1031	3	12	0	1048
13644	4	5	1	1047	0	1057
13645	3	6	1	1047	0	1057
13646	1010	2	2	14	0	1028
13647	8	1036	2	5	0	1051
13648	8	6	1	1054	0	1069
13649	3	5	0	1059	0	1067
13650	2	1	2	1092	0	1097
13651	4	1	1062	14	0	1081
13652	2	1	7	1052	0	1062
13653	1018	1	5	12	0	1036
13654	10	1	1073	7	0	1091
13655	11	1	8	1076	0	1096
13656	4	0	6	1118	0	1128
13657	1109	0	3	19	0	1131
13658	1100	3	3	8	0	1114
13659	18	6	1109	5	0	1138
13660	1012	2	10	8	0	1032
13661	14	4	1116	10	0	1144
13662	1105	3	12	3	0	1123
13663	12	1245	6	8	0	1271
13664	1298	12	0	9	0	1319
13665	17	1308	7	4	0	1336
13666	1427	16	1	6	0	1450
13667	16	1471	3	5	0	1495
13668	13	15	1	1511	0	1540
13669	4	9	1	1516	0	1530
13670	1	2	7	1542	0	1552
13671	6	1520	6	28	0	1560
13672	3	12	3	1530	0	1548
13673	3	1529	6	18	0	1556
13674	4	17	1	1540	0	1562
13675	1518	13	2	20	0	1553
13676	1516	5	0	16	0	1537
13677	29	1521	4	9	0	1563
13678	17	16	5	1533	0	1571
13679	1529	13	2	18	0	1562
13680	18	1541	4	20	0	1583
13681	16	1587	3	6	0	1612
13682	1583	24	0	5	0	1612
13683	1599	13	1	8	0	1621
13684	29	1602	8	3	0	1642
13685	1608	16	4	3	0	1631
13686	21	12	0	1630	0	1663
13687	16	10	1685	25	0	1736
13688	1671	4	14	22	0	1711
13689	1727	5	13	6	0	1751
13690	31	7	1758	8	0	1804
13691	1730	4	14	14	0	1762
13692	1816	6	12	7	0	1841
13693	1868	4	2	9	0	1883
13694	31	1844	4	9	0	1888
13695	1890	19	2	9	0	1920
13696	1885	16	1	5	0	1907
13697	34	5	3	1897	0	1939
13698	20	1	3	1912	0	1936
13699	11	4	0	1930	0	1945
13700	1902	4	1	31	0	1938
13701	21	3	3	1865	0	1892
13702	1919	4	0	32	0	1955
13703	1944	7	4	25	0	1980
13704	37	4	3	1940	0	1984
13705	21	6	4	2011	0	2042
13706	18	2	2	2018	0	2040
13707	1974	5	2	38	0	2019
13708	23	1978	3	25	0	2029
13709	16	16	3	2001	0	2036
13710	16	10	3	2035	0	2064
13711	2025	9	4	26	0	2064
13712	2025	5	1	24	0	2055
13713	33	9	1888	11	0	1941
13714	22	7	1905	7	0	1941
13715	2006	4	29	13	0	2052
13716	26	5	18	2085	0	2134
13717	24	5	5	2632	0	2666
13718	12	5	2600	59	0	2676
13719	15	8	36	2451	0	2510
13720	8	2567	32	44	0	2651
13721	11	2645	10	38	0	2704
13722	2588	65	4	17	0	2674
13723	53	39	2598	9	0	2699
13724	32	2716	40	16	0	2804
13725	16	39	25	2719	0	2799
13726	21	37	2671	38	0	2767
13727	10	9	36	2628	0	2683
13728	8	8	25	2659	0	2700
13729	20	9	2725	65	0	2819
13730	15	2729	43	37	0	2824
13731	18	43	29	2674	0	2764
13732	2688	36	8	44	0	2776
13733	2702	9	9	39	0	2759
13734	2707	3	9	19	0	2738
13735	69	2666	12	19	0	2766
13736	2635	36	11	24	0	2706
13737	49	33	15	2632	0	2729
13738	32	16	2590	48	0	2686
13739	2547	10	34	42	0	2633
13740	46	2627	33	16	0	2722
13741	37	38	11	2615	0	2701
13742	14	36	9	2612	0	2671
13743	17	2590	11	67	0	2685
13744	16	45	7	2647	0	2715
13745	17	28	14	2672	0	2731
13746	15	13	9	2709	0	2746
13747	2648	9	14	76	0	2747
13748	2624	10	14	52	0	2700
13749	68	16	2637	32	0	2753
13750	38	11	48	2660	0	2757
13751	25	16	34	2720	0	2795
13752	21	20	18	2754	0	2813
13753	2685	17	13	75	0	2790
13754	48	25	2647	47	0	2767
13755	2612	9	42	31	0	2694
13756	2680	16	36	28	0	2760
13757	69	12	19	2619	0	2719
13758	2642	16	14	61	0	2733
13759	54	13	2562	65	0	2694
13760	2472	20	41	34	0	2567
13761	56	2739	40	38	0	2873
13762	45	53	2729	26	0	2853
13763	22	42	2738	31	0	2833
13764	34	19	67	2681	0	2801
13765	33	13	2774	62	0	2882
13766	2655	13	41	48	0	2757
13767	51	2610	38	24	0	2723
13768	2621	42	17	32	0	2712
13769	50	33	10	2637	0	2730
13770	47	19	2630	56	0	2752
13771	32	14	2619	61	0	2726
13772	24	18	71	2638	0	2751
13773	2688	15	41	70	0	2814
13774	49	2692	19	60	0	2820
13775	45	2850	14	45	0	2954
13776	2859	60	18	45	0	2982
13777	54	2897	30	35	0	3016
13778	2926	45	11	33	0	3015
13779	63	39	16	2886	0	3004
13780	2908	17	14	63	0	3002
13781	60	12	25	2878	0	2975
13782	2924	12	20	67	0	3023
13783	58	11	22	2885	0	2976
13784	47	2847	25	70	0	2989
13785	2855	38	18	60	0	2971
13786	54	2831	21	36	0	2942
13787	62	48	2733	28	0	2871
13788	38	41	48	2550	0	2677
13789	36	2765	49	47	0	2897
13790	2736	39	21	45	0	2841
13791	2660	39	18	32	0	2749
13792	92	2658	24	23	0	2797
13793	43	50	2653	35	0	2781
13794	30	39	50	2553	0	2672
13795	21	2623	52	52	0	2748
13796	30	47	19	2680	0	2776
13797	34	37	26	2668	0	2765
13798	2656	18	14	76	0	2764
13799	62	2650	21	45	0	2778
13800	55	42	11	2710	0	2818
13801	2706	43	18	56	0	2823
13802	2669	17	17	59	0	2762
13803	2625	16	16	31	0	2688
13804	89	16	17	2567	0	2689
13805	2540	21	15	48	0	2624
13806	58	2500	22	44	0	2624
13807	2513	49	13	24	0	2599
13808	57	2556	17	29	0	2659
13809	2510	49	10	22	0	2591
13810	2492	33	7	32	0	2564
13811	84	15	8	2454	0	2561
13812	64	16	2516	49	0	2645
13813	24	34	2442	51	0	2551
13814	35	2442	58	14	0	2549
13815	2354	36	25	33	0	2448
13816	55	39	2326	8	0	2428
13817	1554	4	9	7	0	1574
13818	12	1676	13	13	0	1714
13819	19	1743	6	2	0	1770
13820	3	20	7	1754	0	1784
13821	7	1879	5	11	0	1902
13822	5	21	1967	17	0	2010
13823	10	16	25	1894	0	1945
13824	7	2032	22	21	0	2082
13825	10	24	2	2091	0	2127
13826	2095	19	6	33	0	2153
13827	34	6	4	2153	0	2197
13828	24	8	2161	29	0	2222
13829	5	2142	31	28	0	2206
13830	7	26	31	2093	0	2157
13831	8	31	2	2175	0	2216
13832	9	9	4	2194	0	2216
13833	2128	8	3	53	0	2192
13834	2134	6	3	39	0	2182
13835	55	11	2107	6	0	2179
13836	36	10	2149	5	0	2200
13837	5	2169	55	14	0	2243
13838	2197	32	28	14	0	2271
13839	40	25	3	2164	0	2232
13840	36	6	2	2212	0	2256
13841	12	3	3	2239	0	2257
13842	8	7	4	2241	0	2260
13843	7	12	2162	57	0	2238
13844	2060	7	31	34	0	2132
13845	32	8	31	2436	0	2507
13846	40	11	2414	50	0	2515
13847	2384	7	40	54	0	2485
13848	2656	3	40	19	0	2718
13849	90	5	2963	15	0	3073
13850	58	13	3049	10	0	3130
13851	16	5	110	2954	0	3085
13852	3009	6	66	71	0	3152
13853	3082	4	10	69	0	3165
13854	119	4	7	2983	0	3113
13855	68	4	10	3086	0	3168
13856	15	8	3035	115	0	3173
13857	18	7	58	3016	0	3099
13858	10	9	3078	75	0	3172
13859	2854	5	64	65	0	2988
13860	65	3081	72	14	0	3232
13861	2907	53	4	17	0	2981
13862	56	2885	11	10	0	2962
13863	2863	57	5	12	0	2937
13864	73	57	7	2756	0	2893
13865	68	6	8	2760	0	2842
13866	2729	7	6	117	0	2859
13867	2777	6	4	66	0	2853
13868	2857	8	3	22	0	2890
13869	2870	4	2	13	0	2889
13870	139	10	2709	10	0	2868
13871	2719	3	69	16	0	2807
13872	2767	4	67	13	0	2851
13873	2794	2	9	17	0	2822
13874	146	4	13	2631	0	2794
13875	2514	4	4	78	0	2600
13876	84	2488	9	69	0	2650
13877	78	69	12	2509	0	2668
13878	23	58	12	2611	0	2704
13879	20	13	2515	137	0	2685
13880	27	7	73	2454	0	2561
13881	19	2534	74	81	0	2708
13882	2486	70	17	76	0	2649
13883	79	2564	14	28	0	2685
13884	2577	76	15	18	0	2686
13885	90	68	13	2522	0	2693
13886	2532	10	11	89	0	2642
13887	86	2441	11	82	0	2620
13888	2496	71	15	31	0	2613
13889	2497	68	13	25	0	2603
13890	150	16	10	2439	0	2615
13891	91	12	15	2504	0	2622
13892	34	15	2406	143	0	2598
13893	28	9	72	2462	0	2571
13894	31	9	70	2451	0	2561
13895	27	11	2391	144	0	2573
13896	31	10	75	2468	0	2584
13897	32	11	2447	98	0	2588
13898	2373	9	90	83	0	2555
13899	100	6	73	2368	0	2547
13900	92	16	2316	92	0	2516
13901	2326	10	75	75	0	2486
13902	101	8	64	2330	0	2503
13903	90	9	2315	95	0	2509
13904	2304	7	86	79	0	2476
13905	98	10	65	2335	0	2508
13906	97	6	24	2390	0	2517
13907	2370	7	12	148	0	2537
13908	103	11	15	2371	0	2500
13909	96	8	10	2388	0	2502
13910	40	9	18	2283	0	2350
13911	47	2229	18	141	0	2435
13912	2165	75	16	92	0	2348
13913	2227	61	13	39	0	2340
13914	158	21	12	2152	0	2343
13915	2216	11	14	94	0	2335
13916	2205	13	12	89	0	2319
13917	2278	9	19	32	0	2338
13918	1980	12	17	42	0	2051
13919	2212	16	15	33	0	2276
13920	162	10	1985	27	0	2184
13921	90	12	1922	36	0	2060
13922	1768	6	106	34	0	1914
13923	79	1760	66	30	0	1935
13924	76	59	22	1669	0	1826
13925	31	60	1675	76	0	1842
13926	40	15	1689	72	0	1816
13927	26	20	107	1604	0	1757
13928	1609	6	66	75	0	1756
13929	81	5	18	1713	0	1817
13930	70	9	1679	83	0	1841
13931	1737	6	64	69	0	1876
13932	81	5	57	1747	0	1890
13933	65	5	24	1808	0	1902
13934	36	2	14	1863	0	1915
13935	26	2	15	1853	0	1896
13936	26	8	1721	123	0	1878
13937	27	5	62	1756	0	1850
13938	1683	4	65	77	0	1829
13939	73	13	1671	69	0	1826
13940	1711	3	62	26	0	1802
13941	1736	6	48	33	0	1823
13942	1766	6	14	29	0	1815
13943	1723	8	15	23	0	1769
13944	109	1651	19	25	0	1804
13945	53	1414	17	22	0	1506
13946	22	1541	8	25	0	1596
13947	1447	59	11	41	0	1558
13948	32	32	1297	15	0	1376
13949	896	24	18	7	0	945
13950	20	0	15	840	0	875
13951	847	2	5	20	0	874
13952	22	2	4	845	0	873
13953	854	2	2	20	0	878
13954	19	1	4	860	0	884
13955	22	0	2	859	0	883
13956	693	2	3	25	0	723
13957	19	933	2	16	0	970
13958	22	17	945	5	0	989
13959	9	939	13	11	0	972
13960	4	12	833	3	0	852
13961	4	6	10	787	0	807
13962	807	3	18	9	0	837
13963	20	0	2	795	0	817
13964	775	0	1	10	0	786
13965	8	915	2	11	0	936
13966	11	8	929	4	0	952
13967	3	934	11	4	0	952
13968	4	917	10	2	0	933
13969	878	10	1	6	0	895
13970	853	4	1	4	0	862
13971	12	866	1	4	0	883
13972	7	4	1	877	0	889
13973	5	5	2	875	0	887
13974	861	2	2	17	0	882
13975	20	4	855	8	0	887
13976	20	3	850	5	0	878
13977	6	1	11	845	0	863
13978	3	2	846	9	0	860
13979	777	1	6	8	0	792
13980	842	1	5	2	0	850
13981	11	834	3	4	0	852
13982	8	6	865	2	0	881
13983	3	6	6	878	0	893
13984	5	3	939	5	0	952
13985	2	1	7	924	0	934
13986	919	0	4	4	0	927
13987	5	962	4	11	0	982
13988	7	9	1041	4	0	1061
13989	5	1098	6	4	0	1113
13990	3	1128	5	2	0	1138
13991	1113	7	2	6	0	1128
13992	1108	5	1	6	0	1120
13993	11	2	1141	6	0	1160
13994	8	1152	5	5	0	1170
13995	5	7	5	1165	0	1182
13996	2	7	1	1166	0	1176
13997	4	2	3	1150	0	1159
13998	1	2	1161	13	0	1177
13999	7	0	5	1152	0	1164
14000	4	3	6	1182	0	1195
14001	1192	2	2	13	0	1209
14002	1195	3	2	6	0	1206
14003	1232	2	2	4	0	1240
14004	1221	3	1	3	0	1228
14005	1233	2	3	4	0	1242
14006	12	1240	2	3	0	1257
14007	1224	7	0	6	0	1237
14008	8	7	1244	3	0	1262
14009	11	1	7	1261	0	1280
14010	1274	5	11	6	0	1296
14011	5	1284	4	6	0	1299
14012	1304	5	2	4	0	1315
14013	1341	4	2	7	0	1354
14014	11	1	3	1354	0	1369
14015	5	3	2	1428	0	1438
14016	2	1497	2	15	0	1516
14017	6	7	2	1516	0	1531
14018	7	9	1607	9	0	1632
14019	4	3	16	1603	0	1626
14020	1	3	1636	17	0	1657
14021	1477	1	21	15	0	1514
14022	19	1	11	1679	0	1710
14023	13	7	1670	17	0	1707
14024	1	1666	17	16	0	1700
14025	2	1639	13	2	0	1656
14026	1618	26	0	1	0	1645
14027	17	11	1	1630	0	1659
14028	13	4	1824	12	0	1853
14029	1	1776	17	16	0	1810
14030	2	15	1783	4	0	1804
14031	1711	11	13	4	0	1739
14032	1766	0	10	1	0	1777
14033	1769	0	1	1	0	1771
14034	22	1	0	1769	0	1792
14035	15	2	1763	18	0	1798
14036	1	1791	15	12	0	1819
14037	3	11	10	1821	0	1845
14038	2	17	1800	15	0	1834
14039	3	6	1765	13	0	1787
14040	3	1	24	1802	0	1830
14041	1848	0	12	13	0	1873
14042	12	3	0	1851	0	1866
14043	13	0	1	1888	0	1902
14044	1	4	1916	21	0	1942
14045	4	1	12	1921	0	1938
14046	1	1	11	1871	0	1884
14047	3	4	1893	21	0	1921
14048	0	4	1877	13	0	1894
14049	3	2	23	1859	0	1887
14050	3	5	1900	15	0	1923
14051	5	0	12	1903	0	1920
14052	1895	0	12	19	0	1926
14053	12	1937	7	15	0	1971
14054	11	15	1	2003	0	2030
14055	2	16	1997	15	0	2030
14056	1686	1	12	20	0	1719
14057	13	1918	15	3	0	1949
14058	1921	12	1	2	0	1936
14059	14	12	1	1901	0	1928
14060	11	2	3	1910	0	1926
14061	1941	0	0	33	0	1974
14062	16	5	1957	11	0	1989
14063	1899	2	15	7	0	1923
14064	15	3	10	1952	0	1980
14065	1860	2	2	18	0	1882
14066	1875	1	4	16	0	1896
14067	26	2	3	1877	0	1908
14068	13	1922	7	11	0	1953
14069	1956	13	2	16	0	1987
14070	1935	11	1	6	0	1953
14071	30	7	1975	0	0	2012
14072	1959	1	16	6	0	1982
14073	15	5	16	1979	0	2015
14074	17	2066	8	19	0	2110
14075	3	17	0	2003	0	2023
14076	4	2096	5	15	0	2120
14077	2080	17	2	15	0	2114
14078	2122	15	3	12	0	2152
14079	34	3	4	2278	0	2319
14080	22	5	2293	26	0	2346
14081	8	5	2289	22	0	2324
14082	9	2	42	2330	0	2383
14083	2326	2	20	30	0	2378
14084	2574	4	5	26	0	2609
14085	51	2622	8	2	0	2683
14086	26	28	5	2702	0	2761
14087	7	38	2808	38	0	2891
14088	4	7	2820	39	0	2870
14089	8	4	82	2821	0	2915
14090	3059	2	46	55	0	3162
14091	58	2	4	3114	0	3178
14092	51	6	3104	58	0	3219
14093	3017	2	57	53	0	3129
14094	58	3	50	3055	0	3166
14095	56	1	10	3122	0	3189
14096	21	2	6	3037	0	3066
14097	9	3012	15	105	0	3141
14098	9	63	3037	55	0	3164
14099	24	52	3063	11	0	3150
14100	9	7	100	3059	0	3175
14101	10	9	3125	66	0	3210
14102	3045	2	63	56	0	3166
14103	64	7	48	3080	0	3199
14104	58	6	10	3095	0	3169
14105	13	6	8	3069	0	3096
14106	6	3056	19	108	0	3189
14107	3138	57	12	59	0	3266
14108	68	47	6	3113	0	3234
14109	3113	6	2	72	0	3193
14110	62	3104	15	60	0	3241
14111	3143	61	9	14	0	3227
14112	3106	47	8	17	0	3178
14113	3112	5	7	16	0	3140
14114	108	3022	8	21	0	3159
14115	59	3015	8	18	0	3100
14116	2855	98	4	9	0	2966
14117	59	2949	14	9	0	3031
14118	56	57	2792	16	0	2921
14119	9	2775	61	15	0	2860
14120	13	2810	50	9	0	2882
14121	2737	82	7	10	0	2836
14122	56	48	2709	12	0	2825
14123	47	12	2708	11	0	2778
14124	10	9	84	2646	0	2749
14125	2721	9	45	47	0	2822
14126	62	16	2728	45	0	2851
14127	55	5	53	2726	0	2839
14128	15	14	2628	49	0	2706
14129	9	14	2576	45	0	2644
14130	2504	7	85	19	0	2615
14131	58	13	2592	13	0	2676
14132	54	8	57	2525	0	2644
14133	17	15	45	2502	0	2579
14134	16	2527	15	86	0	2644
14135	18	2589	17	58	0	2682
14136	19	89	15	2514	0	2637
14137	18	51	2535	56	0	2660
14138	21	17	55	2560	0	2653
14139	18	14	49	2588	0	2669
14140	15	15	2630	101	0	2761
14141	18	12	61	2645	0	2736
14142	2635	12	56	64	0	2767
14143	64	12	2617	64	0	2757
14144	2568	14	58	26	0	2666
14145	59	14	54	2556	0	2683
14146	56	13	22	2578	0	2669
14147	23	2549	30	102	0	2704
14148	19	58	23	2572	0	2672
14149	21	48	20	2650	0	2739
14150	2596	16	17	110	0	2739
14151	64	11	17	2640	0	2732
14152	53	7	21	2658	0	2739
14153	2535	9	19	116	0	2679
14154	59	14	27	2551	0	2651
14155	64	10	20	2407	0	2501
14156	17	2481	28	115	0	2641
14157	2525	51	20	76	0	2672
14158	70	47	17	2539	0	2673
14159	55	19	15	2586	0	2675
14160	30	14	2498	124	0	2666
14161	26	9	62	2505	0	2602
14162	27	15	49	2538	0	2629
14163	2449	20	10	113	0	2592
14164	2469	15	14	70	0	2568
14165	108	18	11	2449	0	2586
14166	73	23	2413	68	0	2577
14167	25	2379	63	64	0	2531
14168	20	2476	58	28	0	2582
14169	30	93	13	2451	0	2587
14170	2476	62	24	65	0	2627
14171	66	24	11	2499	0	2600
14172	2478	14	11	75	0	2578
14173	61	15	17	2521	0	2614
14174	60	10	14	2462	0	2546
14175	2386	15	13	101	0	2515
14176	2410	11	16	60	0	2497
14177	100	2434	17	33	0	2584
14178	63	2499	20	22	0	2604
14179	22	76	19	2249	0	2366
14180	15	43	11	2290	0	2359
14181	21	10	2238	90	0	2359
14182	1991	7	52	65	0	2115
14183	52	2186	51	25	0	2314
14184	32	1949	17	15	0	2013
14185	1868	52	24	16	0	1960
14186	33	31	1823	10	0	1897
14187	24	14	1705	13	0	1756
14188	9	9	1651	11	0	1680
14189	6	1593	36	11	0	1646
14190	6	33	6	1429	0	1474
14191	4	9	2	1452	0	1467
14192	5	5	1	1454	0	1465
14193	1442	1	2	16	0	1461
14194	1429	1	3	14	0	1447
14195	14	1443	5	7	0	1469
14196	12	9	4	1465	0	1490
14197	6	16	1486	15	0	1523
14198	3	1504	8	12	0	1527
14199	1466	7	10	9	0	1492
14200	13	13	1450	2	0	1478
14201	1271	3	6	8	0	1288
14202	6	8	1461	2	0	1477
14203	12	1	6	1417	0	1436
14204	0	1512	13	7	0	1532
14205	1530	8	2	8	0	1548
14206	8	1559	3	2	0	1572
14207	1501	6	3	2	0	1512
14208	5	9	2	1494	0	1510
14209	8	3	1570	7	0	1588
14210	5	1	6	1568	0	1580
14211	4	4	8	1676	0	1692
14212	7	7	1660	21	0	1695
14213	1499	5	12	13	0	1529
14214	16	1686	10	4	0	1716
14215	1695	14	2	5	0	1716
14216	14	1782	6	5	0	1807
14217	12	15	1	1892	0	1920
14218	2	17	1894	31	0	1944
14219	2332	3	23	14	0	2372
14220	45	2452	15	3	0	2515
14221	38	45	1	2451	0	2535
14222	16	32	1	2523	0	2572
14223	2680	6	2	71	0	2759
14224	2838	5	3	36	0	2882
14225	90	2946	11	4	0	3051
14226	3103	61	4	3	0	3171
14227	3082	41	4	4	0	3131
14228	3098	10	4	16	0	3128
14229	111	20	3065	8	0	3204
14230	44	3029	76	4	0	3153
14231	13	3158	47	4	0	3222
14232	12	110	8	2965	0	3095
14233	11	52	2	3101	0	3166
14234	3074	10	3	113	0	3200
14235	74	3062	5	55	0	3196
14236	3156	73	7	17	0	3253
14237	89	44	5	3073	0	3211
14238	51	15	4	3164	0	3234
14239	3043	7	5	121	0	3176
14240	2999	6	3	61	0	3069
14241	118	9	2934	16	0	3077
14242	58	14	74	2911	0	3057
14243	24	6	2975	73	0	3078
14244	14	15	2922	50	0	3001
14245	12	10	2999	16	0	3037
14246	2892	6	117	11	0	3026
14247	82	10	48	2950	0	3090
14248	60	5	11	2986	0	3062
14249	27	12	3	3065	0	3107
14250	18	17	2966	123	0	3124
14251	15	3	77	2969	0	3064
14252	12	10	52	3021	0	3095
14253	2960	6	18	117	0	3101
14254	3021	16	8	60	0	3105
14255	3096	7	6	17	0	3126
14256	3106	10	7	18	0	3141
14257	137	14	3	2944	0	3098
14258	2976	11	6	89	0	3082
14259	101	11	6	2982	0	3100
14260	65	15	2847	91	0	3018
14261	2869	14	75	66	0	3024
14262	95	2899	57	25	0	3076
14263	78	75	17	2866	0	3036
14264	35	58	12	2821	0	2926
14265	25	2934	12	129	0	3100
14266	2907	83	8	76	0	3074
14267	89	2858	20	42	0	3009
14268	80	87	2838	23	0	3028
14269	36	58	2879	24	0	2997
14270	2762	20	128	17	0	2927
14271	2857	15	65	25	0	2962
14272	137	22	2790	33	0	2982
14273	2755	7	84	34	0	2880
14274	104	18	2761	30	0	2913
14275	2756	19	86	26	0	2887
14276	109	17	2747	36	0	2909
14277	84	13	2739	30	0	2866
14278	46	15	124	2562	0	2747
14279	33	17	74	2649	0	2773
14280	2693	16	22	136	0	2867
14281	2714	19	12	79	0	2824
14282	2767	10	10	46	0	2833
14283	2770	18	17	35	0	2840
14284	160	2573	36	33	0	2802
14285	100	84	25	2502	0	2711
14286	49	2606	27	97	0	2779
14287	42	86	33	2600	0	2761
14288	44	56	23	2559	0	2682
14289	49	30	17	2551	0	2647
14290	57	19	2388	153	0	2617
14291	2279	16	94	95	0	2484
14292	108	2309	69	45	0	2531
14293	80	2418	26	41	0	2565
14294	54	128	2356	42	0	2580
14295	48	54	98	2360	0	2560
14296	44	19	67	2413	0	2543
14297	2399	11	29	142	0	2581
14298	124	11	21	2399	0	2555
14299	80	13	40	2436	0	2569
14300	57	6	36	2491	0	2590
14301	82	12	40	2456	0	2590
14302	2356	9	30	143	0	2538
14303	2387	15	37	77	0	2516
14304	2431	6	35	37	0	2509
14305	158	11	28	2318	0	2515
14306	2318	9	28	119	0	2474
14307	121	8	18	2325	0	2472
14308	82	9	26	2396	0	2513
14309	62	15	2208	150	0	2435
14310	48	11	2199	100	0	2358
14311	48	18	2191	35	0	2292
14312	2178	8	141	34	0	2361
14313	115	13	78	2020	0	2226
14314	99	2140	32	90	0	2361
14315	2178	75	16	85	0	2354
14316	118	58	2063	43	0	2282
14317	1951	19	76	37	0	2083
14318	94	1814	68	28	0	2004
14319	1278	39	11	21	0	1349
14320	58	40	8	1226	0	1332
14321	1262	6	9	49	0	1326
14322	54	1212	17	37	0	1320
14323	37	1218	6	17	0	1278
14324	963	56	5	10	0	1034
14325	34	966	2	6	0	1008
14326	24	824	4	4	0	856
14327	4	841	4	12	0	861
14328	794	41	17	6	0	858
14329	724	16	1	6	0	747
14330	737	4	2	2	0	745
14331	27	4	1	717	0	749
14332	17	1	4	747	0	769
14333	3	6	750	23	0	782
14334	5	1	13	751	0	770
14335	6	2	787	15	0	810
14336	4	1	16	764	0	785
14337	6	3	14	774	0	797
14338	763	1	4	22	0	790
14339	763	3	3	15	0	784
14340	23	776	4	6	0	809
14341	17	14	2	774	0	807
14342	5	11	780	14	0	810
14343	6	2	12	758	0	778
14344	7	3	14	767	0	791
14345	6	2	2	782	0	792
14346	5	1	746	22	0	774
14347	2	1	690	13	0	706
14348	694	0	18	7	0	719
14349	13	1	10	721	0	745
14350	13	1	747	12	0	773
14351	725	3	11	10	0	749
14352	12	752	11	5	0	780
14353	760	10	3	5	0	778
14354	13	11	775	3	0	802
14355	737	3	12	3	0	755
14356	14	3	9	772	0	798
14357	12	3	779	11	0	805
14358	5	782	11	10	0	808
14359	789	11	9	3	0	812
14360	11	10	2	786	0	809
14361	9	4	6	772	0	791
14362	6	810	5	20	0	841
14363	2	12	2	828	0	844
14364	3	13	809	15	0	840
14365	3	801	11	10	0	825
14366	782	11	10	6	0	809
14367	13	8	2	775	0	798
14368	10	4	2	784	0	800
14369	6	6	762	19	0	793
14370	3	3	9	764	0	779
14371	8	5	784	14	0	811
14372	1	788	12	12	0	813
14373	814	7	11	10	0	842
14374	824	7	2	4	0	837
14375	835	2	2	6	0	845
14376	20	884	4	1	0	909
14377	14	11	2	908	0	935
14378	6	10	1	912	0	929
14379	4	2	1	880	0	887
14380	888	1	5	24	0	918
14381	899	1	2	13	0	915
14382	22	1	2	900	0	925
14383	12	2	985	18	0	1017
14384	9	2	14	992	0	1017
14385	8	2	9	1005	0	1024
14386	4	1	0	1018	0	1023
14387	1	3	3	1023	0	1030
14388	1007	1	3	27	0	1038
14389	17	0	1	1014	0	1032
14390	7	1	0	1022	0	1030
14391	2	1020	2	24	0	1048
14392	3	14	4	1062	0	1083
14393	3	1082	4	19	0	1108
14394	2	16	2	1112	0	1132
14395	1077	10	2	20	0	1109
14396	17	1107	3	12	0	1139
14397	1072	18	2	5	0	1097
14398	22	10	1106	3	0	1141
14399	13	2	19	1083	0	1117
14400	5	3	1117	22	0	1147
14401	2	0	20	1110	0	1132
14402	2	2	13	1092	0	1109
14403	2	1091	2	27	0	1122
14404	4	1094	8	12	0	1118
14405	4	1099	4	5	0	1112
14406	1068	23	1	7	0	1099
14407	10	954	6	3	0	973
14408	3	944	2	6	0	955
14409	14	12	1	946	0	973
14410	940	3	1	13	0	957
14411	11	1077	3	5	0	1096
14412	1123	9	0	3	0	1135
14413	1118	2	1	6	0	1127
14414	15	2	1195	3	0	1215
14415	4	3	10	1155	0	1172
14416	1	1	3	1220	0	1225
14417	2	2	5	1216	0	1225
14418	2	1	2	1198	0	1203
14419	4	4	1177	11	0	1196
14420	2	5	1105	4	0	1116
14421	1058	2	10	4	0	1074
14422	8	1196	6	0	0	1210
14423	3	1218	0	3	0	1224
14424	1213	11	2	1	0	1227
14425	8	1199	0	3	0	1210
14426	4	9	0	1185	0	1198
14427	1196	3	1	10	0	1210
14428	9	5	1188	3	0	1205
14429	3	4	8	1186	0	1201
14430	3	2	1234	11	0	1250
14431	1140	3	9	4	0	1156
14432	9	5	1410	1	0	1425
14433	1430	1	10	7	0	1448
14434	1552	1	2	9	0	1564
14435	1535	2	1	3	0	1541
14436	1545	0	3	5	0	1553
14437	1556	0	2	3	0	1561
14438	11	0	3	1554	0	1568
14439	1662	2	1	18	0	1683
14440	12	1	1	1682	0	1696
14441	4	1	1	1690	0	1696
14442	3	2	1	1784	0	1790
14443	1	3	1813	12	0	1829
14444	3	0	8	1770	0	1781
14445	1	1	4	1834	0	1840
14446	1	7	1813	14	0	1835
14447	1603	5	9	10	0	1627
14448	12	2	2	1871	0	1887
14449	4	8	1891	8	0	1911
14450	3	5	1823	10	0	1841
14451	6	1	10	1818	0	1835
14452	1	4	1884	12	0	1901
14453	7	1	8	1859	0	1875
14454	4	1	5	1948	0	1958
14455	4	1956	3	15	0	1978
14456	2	1955	5	5	0	1967
14457	1990	10	3	6	0	2009
14458	13	2	2	1998	0	2015
14459	6	1	3	1993	0	2003
14460	5	3	1	2044	0	2053
14461	2	4	2073	19	0	2098
14462	5	0	10	2032	0	2047
14463	2019	2	3	17	0	2041
14464	13	3	2103	7	0	2126
14465	3	1	11	2165	0	2180
14466	3	2	5	2202	0	2212
14467	5	1	3	2177	0	2186
14468	1	2309	3	17	0	2330
14469	2307	13	2	8	0	2330
14470	2446	8	7	3	0	2464
14471	28	2495	7	4	0	2534
14472	16	22	2	2643	0	2683
14473	7	16	2702	27	0	2752
14474	6	3	2692	19	0	2720
14475	2664	4	59	7	0	2734
14476	34	2	26	2781	0	2843
14477	2922	1	7	28	0	2958
14478	32	3007	10	26	0	3075
14479	32	3056	10	11	0	3109
14480	2989	63	2	8	0	3062
14481	35	3125	13	5	0	3178
14482	37	38	2	3068	0	3145
14483	10	34	2	2886	0	2932
14484	7	3172	6	58	0	3243
14485	3141	45	1	40	0	3227
14486	44	43	3157	10	0	3254
14487	2974	7	41	19	0	3041
14488	44	15	3175	4	0	3238
14489	2881	4	44	20	0	2949
14490	49	7	3232	7	0	3295
14491	49	3157	50	5	0	3261
14492	13	58	44	3121	0	3236
14493	3120	36	9	46	0	3211
14494	45	8	3124	40	0	3217
14495	43	9	3146	6	0	3204
14496	10	4	78	3034	0	3126
14497	8	4	3148	42	0	3202
14498	12	5	43	3078	0	3138
14499	8	3	49	3051	0	3111
14500	10	4	3088	77	0	3179
14501	4	4	45	3075	0	3128
14502	3099	2	44	53	0	3198
14503	39	3108	12	49	0	3208
14504	3191	39	8	18	0	3256
14505	43	36	5	3136	0	3220
14506	3205	6	6	45	0	3262
14507	3213	6	3	44	0	3266
14508	85	8	7	3121	0	3221
14509	49	3257	5	39	0	3350
14510	3291	34	10	38	0	3373
14511	48	42	3130	10	0	3230
14512	49	15	3107	14	0	3185
14513	3061	7	74	15	0	3157
14514	44	9	49	3007	0	3109
14515	49	7	3063	38	0	3157
14516	14	4	50	3065	0	3133
14517	3062	2	45	43	0	3152
14518	3126	2	12	57	0	3197
14519	3083	6	7	16	0	3112
14520	79	3154	15	16	0	3264
14521	57	40	5	3175	0	3277
14522	23	42	5	3181	0	3251
14523	3150	8	6	83	0	3247
14524	50	3199	11	50	0	3310
14525	3214	48	9	18	0	3289
14526	54	46	6	3153	0	3259
14527	3160	10	8	54	0	3232
14528	50	17	3060	54	0	3181
14529	52	3086	43	23	0	3204
14530	34	41	42	2943	0	3060
14531	12	3252	19	41	0	3324
14532	17	45	10	3044	0	3116
14533	2972	48	6	46	0	3072
14534	50	14	2862	50	0	2976
14535	2802	10	47	16	0	2875
14536	44	3022	49	25	0	3140
14537	57	46	14	3034	0	3151
14538	30	43	11	3082	0	3166
14539	2939	9	16	78	0	3042
14540	49	21	2985	54	0	3109
14541	55	6	46	3006	0	3113
14542	12	11	48	2946	0	3017
14543	33	5	13	2968	0	3019
14544	11	12	14	2996	0	3033
14545	2912	5	12	93	0	3022
14546	2910	8	13	67	0	2998
14547	90	10	2893	25	0	3018
14548	59	9	2857	24	0	2949
14549	2903	12	80	22	0	3017
14550	3006	7	47	26	0	3086
14551	95	6	17	2956	0	3074
14552	57	10	15	2973	0	3055
14553	2935	2	20	85	0	3042
14554	51	2935	19	51	0	3056
14555	68	37	8	2977	0	3090
14556	18	40	13	3024	0	3095
14557	19	11	2938	96	0	3064
14558	24	10	48	2961	0	3043
14559	22	20	2964	55	0	3061
14560	20	5	50	2954	0	3029
14561	2869	8	49	55	0	2981
14562	56	2	14	2919	0	2991
14563	53	8	2836	63	0	2960
14564	17	2767	52	61	0	2897
14565	23	48	47	2939	0	3057
14566	28	48	3045	55	0	3176
14567	16	3084	48	60	0	3208
14568	16	45	49	3013	0	3123
14569	9	52	3006	56	0	3123
14570	2270	13	43	58	0	2384
14571	37	2838	37	21	0	2933
14572	38	2691	10	9	0	2748
14573	12	2694	13	9	0	2728
14574	18	76	4	2520	0	2618
14575	13	38	2654	35	0	2740
14576	6	2656	30	32	0	2724
14577	27	31	27	2549	0	2634
14578	2765	30	5	40	0	2840
14579	32	3	3	3860	0	3898
14580	46	12	4382	82	0	4522
14581	10	4389	83	62	0	4544
14582	4243	86	76	21	0	4426
14583	75	4470	12	18	0	4575
14584	82	96	4264	10	0	4452
14585	9	4401	88	7	0	4505
14586	13	88	90	4233	0	4424
14587	12	93	4287	77	0	4469
14588	7	4281	87	83	0	4458
14589	12	89	75	4151	0	4327
14590	13	84	10	4183	0	4290
14591	3	4250	20	150	0	4423
14592	9	93	6	4337	0	4445
14593	9	79	4279	95	0	4462
14594	7	18	4339	89	0	4453
14595	3	15	146	4279	0	4443
14596	4288	5	81	100	0	4474
14597	4324	12	13	83	0	4432
14598	152	10	16	4173	0	4351
14599	75	4248	17	102	0	4442
14600	24	87	17	4331	0	4459
14601	4260	70	14	100	0	4444
14602	90	17	8	4303	0	4418
14603	88	13	7	4331	0	4439
14604	4193	11	5	172	0	4381
14605	86	4167	19	99	0	4371
14606	85	91	4	4133	0	4313
14607	4183	78	7	101	0	4369
14608	99	17	4107	86	0	4309
14609	4092	14	82	31	0	4219
14610	97	12	75	4100	0	4284
14611	4156	10	8	95	0	4269
14612	4127	15	10	90	0	4242
14613	3963	11	8	28	0	4010
14614	161	4037	19	25	0	4242
14615	97	90	4002	20	0	4209
14616	33	4107	87	19	0	4246
14617	3994	89	75	27	0	4185
14618	106	4076	16	15	0	4213
14619	96	96	11	3979	0	4182
14620	3857	94	13	91	0	4055
14621	98	3864	18	85	0	4065
14622	94	105	3855	24	0	4078
14623	29	86	88	3832	0	4035
14624	23	29	3884	97	0	4033
14625	20	3847	98	93	0	4058
14626	25	99	85	3774	0	3983
14627	24	90	18	3869	0	4001
14628	19	26	19	3953	0	4017
14629	20	24	28	3799	0	3871
14630	15	3745	28	182	0	3970
14631	3671	100	19	108	0	3898
14632	97	99	3690	41	0	3927
14633	95	19	100	3700	0	3914
14634	3697	32	87	113	0	3929
14635	110	32	3692	114	0	3948
14636	96	3550	114	37	0	3797
14637	37	108	94	3488	0	3727
14638	35	97	3570	109	0	3811
14639	22	3578	119	96	0	3815
14640	3390	110	88	48	0	3636
14641	101	3548	36	44	0	3729
14642	89	116	35	3435	0	3675
14643	29	108	19	3544	0	3700
14644	3430	34	16	192	0	3672
14645	93	3442	35	116	0	3686
14646	100	98	31	3459	0	3688
14647	3402	91	23	133	0	3649
14648	3344	28	24	115	0	3511
14649	180	3286	30	55	0	3551
14650	3395	109	14	44	0	3562
14651	3393	106	14	44	0	3557
14652	185	38	18	3298	0	3539
14653	112	40	3257	130	0	3539
14654	64	24	92	3211	0	3391
14655	58	21	87	3234	0	3400
14656	39	36	3147	196	0	3418
14657	38	3118	103	116	0	3375
14658	49	100	86	3112	0	3347
14659	30	96	25	3211	0	3362
14660	39	30	27	3237	0	3333
14661	33	22	27	3163	0	3245
14662	35	3101	33	187	0	3356
14663	3139	99	22	125	0	3385
14664	3164	88	10	61	0	3323
14665	3039	22	13	48	0	3122
14666	184	2744	25	41	0	2994
14667	95	109	17	2732	0	2953
14668	39	100	2737	107	0	2983
14669	45	43	86	2635	0	2809
14670	54	2740	98	86	0	2978
14671	2705	104	14	85	0	2908
14672	2753	83	17	43	0	2896
14673	2754	37	17	37	0	2845
14674	163	2665	30	40	0	2898
14675	93	2537	32	28	0	2690
14676	29	2620	28	38	0	2715
14677	67	145	2375	25	0	2612
14678	29	111	2044	40	0	2224
14679	38	372	88	565	0	1063
14680	376	4	22	12	0	414
14681	363	1	1	13	0	378
14682	9	2	2	362	0	375
14683	6	4	0	353	0	363
14684	3	5	0	361	0	369
14685	6	0	1	354	0	361
14686	368	2	3	10	0	383
14687	371	1	0	8	0	380
14688	12	384	3	2	0	401
14689	392	6	2	5	0	405
14690	390	9	2	6	0	407
14691	395	3	4	6	0	408
14692	13	5	332	2	0	352
14693	378	3	6	4	0	391
14694	7	386	6	1	0	400
14695	7	8	2	397	0	414
14696	2	7	6	396	0	411
14697	4	376	1	15	0	396
14698	1	9	0	399	0	409
14699	387	7	3	8	0	405
14700	10	5	1	411	0	427
14701	7	4	401	11	0	423
14702	380	4	9	8	0	401
14703	8	432	10	8	0	458
14704	12	7	2	447	0	468
14705	7	9	2	449	0	467
14706	5	4	1	439	0	449
14707	5	3	423	17	0	448
14708	9	407	8	8	0	432
14709	6	9	5	423	0	443
14710	3	10	416	13	0	442
14711	5	0	8	407	0	420
14712	8	2	415	9	0	434
14713	4	5	6	409	0	424
14714	6	404	7	9	0	426
14715	9	6	4	413	0	432
14716	411	8	2	13	0	434
14717	414	0	6	6	0	426
14718	15	4	401	4	0	424
14719	6	5	409	9	0	429
14720	3	2	440	5	0	450
14721	4	5	11	434	0	454
14722	2	2	5	466	0	475
14723	4	3	4	472	0	483
14724	6	516	1	17	0	540
14725	6	10	2	511	0	529
14726	9	7	3	543	0	562
14727	8	6	2	567	0	583
14728	539	1	3	16	0	559
14729	538	2	4	8	0	552
14730	17	6	559	6	0	588
14731	5	5	558	7	0	575
14732	549	3	14	6	0	572
14733	574	2	7	11	0	594
14734	14	6	560	5	0	585
14735	10	3	547	8	0	568
14736	533	4	16	4	0	557
14737	535	1	7	10	0	553
14738	12	3	589	7	0	611
14739	7	2	10	578	0	597
14740	3	4	5	603	0	615
14741	5	628	4	14	0	651
14742	3	8	4	648	0	663
14743	2	11	637	14	0	664
14744	6	2	10	650	0	668
14745	9	2	12	639	0	662
14746	3	3	640	22	0	668
14747	614	1	12	21	0	648
14748	647	1	19	9	0	676
14749	17	3	5	653	0	678
14750	11	0	3	661	0	675
14751	644	4	14	16	0	678
14752	650	4	0	21	0	675
14753	618	2	2	10	0	632
14754	650	1	6	16	0	673
14755	20	633	6	20	0	679
14756	618	6	6	11	0	641
14757	18	615	7	6	0	646
14758	17	10	7	624	0	658
14759	17	7	8	614	0	646
14760	7	610	8	21	0	646
14761	16	6	4	630	0	656
14762	8	18	12	612	0	650
14763	10	605	4	29	0	648
14764	11	6	3	628	0	648
14765	5	16	10	619	0	650
14766	7	4	6	635	0	652
14767	14	2	603	31	0	650
14768	8	582	13	14	0	617
14769	8	7	13	554	0	582
14770	10	594	12	19	0	635
14771	581	11	6	20	0	618
14772	12	10	577	12	0	611
14773	12	14	571	10	0	607
14774	519	2	13	17	0	551
14775	12	11	10	557	0	590
14776	19	6	536	11	0	572
14777	6	2	541	16	0	565
14778	5	0	26	532	0	563
14779	542	3	11	12	0	568
14780	527	4	3	24	0	558
14781	19	1	14	528	0	562
14782	13	6	529	11	0	559
14783	6	545	11	24	0	586
14784	15	7	8	549	0	579
14785	19	12	551	8	0	590
14786	8	539	10	19	0	576
14787	6	8	19	529	0	562
14788	539	16	5	14	0	574
14789	11	2	5	537	0	555
14790	10	529	18	9	0	566
14791	521	15	7	15	0	558
14792	7	10	544	19	0	580
14793	23	545	7	6	0	581
14794	9	5	547	16	0	577
14795	513	15	12	8	0	548
14796	19	3	10	519	0	551
14797	12	6	13	541	0	572
14798	540	11	7	14	0	572
14799	9	3	17	543	0	572
14800	19	6	512	12	0	549
14801	467	2	6	21	0	496
14802	9	524	10	15	0	558
14803	21	3	4	500	0	528
14804	486	8	4	18	0	516
14805	10	485	12	12	0	519
14806	18	3	6	515	0	542
14807	538	18	5	9	0	570
14808	10	5	4	540	0	559
14809	20	554	2	8	0	584
14810	6	15	612	18	0	651
14811	7	7	6	642	0	662
14812	19	6	9	654	0	688
14813	658	4	3	24	0	689
14814	5	11	6	664	0	686
14815	672	4	12	7	0	695
14816	764	6	3	21	0	794
14817	15	4	1	771	0	791
14818	23	818	6	9	0	856
14819	8	8	6	808	0	830
14820	801	9	1	12	0	823
14821	21	801	3	11	0	836
14822	9	782	4	15	0	810
14823	762	23	4	4	0	793
14824	737	8	4	12	0	761
14825	20	756	3	6	0	785
14826	732	13	12	8	0	765
14827	718	16	1	5	0	740
14828	17	3	4	693	0	717
14829	16	6	781	9	0	812
14830	6	10	6	796	0	818
14831	12	5	799	9	0	825
14832	13	6	7	799	0	825
14833	1	3	783	24	0	811
14834	755	0	18	13	0	786
14835	8	2	11	779	0	800
14836	805	6	9	9	0	829
14837	16	11	0	784	0	811
14838	13	837	14	7	0	871
14839	885	14	0	13	0	912
14840	14	11	808	12	0	845
14841	816	1	8	3	0	828
14842	11	827	12	3	0	853
14843	830	10	2	1	0	843
14844	853	9	0	4	0	866
14845	18	848	4	2	0	872
14846	11	11	2	872	0	896
14847	863	12	3	13	0	891
14848	16	853	3	9	0	881
14849	9	13	1	879	0	902
14850	910	9	2	16	0	937
14851	14	4	1	914	0	933
14852	12	3	1	917	0	933
14853	8	0	2	951	0	961
14854	2	12	912	24	0	950
14855	3	3	13	915	0	934
14856	922	1	10	15	0	948
14857	12	1	905	12	0	930
14858	16	1	12	915	0	944
14859	6	2	9	932	0	949
14860	5	2	909	27	0	943
14861	868	1	14	16	0	899
14862	925	4	10	6	0	945
14863	24	3	962	4	0	993
14864	16	3	12	943	0	974
14865	6	1	11	991	0	1009
14866	3	4	997	27	0	1031
14867	4	4	16	1031	0	1055
14868	11	1	10	1043	0	1065
14869	3	3	1060	25	0	1091
14870	1006	2	15	15	0	1038
14871	18	1	12	1062	0	1093
14872	1071	3	2	17	0	1093
14873	1060	3	3	18	0	1084
14874	24	2	1072	7	0	1105
14875	16	0	16	1035	0	1067
14876	1046	1	13	20	0	1080
14877	17	1057	4	16	0	1094
14878	17	14	5	1081	0	1117
14879	8	12	3	1096	0	1119
14880	4	2	3	1129	0	1138
14881	6	0	1097	28	0	1131
14882	977	5	14	13	0	1009
14883	17	1	14	1083	0	1115
14884	16	1	4	1095	0	1116
14885	6	3	1073	28	0	1110
14886	5	3	15	1090	0	1113
14887	6	3	12	1108	0	1129
14888	1062	0	6	32	0	1100
14889	17	1076	2	22	0	1117
14890	15	12	1071	8	0	1106
14891	1064	11	20	4	0	1099
14892	15	2	14	1074	0	1105
14893	15	1	1065	25	0	1106
14894	10	5	1089	12	0	1116
14895	5	2	26	1080	0	1113
14896	5	2	1102	21	0	1130
14897	4	1	1128	15	0	1148
14898	6	1043	28	6	0	1083
14899	5	13	15	1121	0	1154
14900	8	10	1136	17	0	1171
14901	5	4	16	1101	0	1126
14902	1159	1	14	25	0	1199
14903	14	1	12	1166	0	1193
14904	15	0	3	1209	0	1227
14905	1164	1	3	31	0	1199
14906	1212	4	6	14	0	1236
14907	31	2	5	1201	0	1239
14908	15	2	1197	22	0	1236
14909	6	1182	14	17	0	1219
14910	7	10	16	1155	0	1188
14911	1116	14	4	15	0	1149
14912	1070	2	3	19	0	1094
14913	27	1070	3	10	0	1110
14914	17	1087	6	9	0	1119
14915	1120	22	9	4	0	1155
14916	1043	14	5	8	0	1070
14917	28	4	1085	10	0	1127
14918	20	4	20	1028	0	1072
14919	8	1118	23	19	0	1168
14920	1185	14	6	21	0	1226
14921	20	13	2	1132	0	1167
14922	23	1206	7	18	0	1254
14923	8	22	1279	17	0	1326
14924	9	32	18	1141	0	1200
14925	9	1314	17	17	0	1357
14926	1326	14	4	19	0	1363
14927	1316	16	7	8	0	1347
14928	30	1325	7	7	0	1369
14929	1231	13	1	7	0	1252
14930	1203	10	3	8	0	1224
14931	22	1263	8	3	0	1296
14932	11	1296	7	5	0	1319
14933	3	21	4	1260	0	1288
14934	1279	10	5	14	0	1308
14935	17	4	1370	13	0	1404
14936	1285	2	12	4	0	1303
14937	13	1367	10	4	0	1394
14938	1279	7	2	9	0	1297
14939	1270	9	3	6	0	1288
14940	1294	1	3	5	0	1303
14941	16	0	2	1266	0	1284
14942	10	1278	4	9	0	1301
14943	1268	8	5	6	0	1287
14944	10	12	1267	4	0	1293
14945	7	1261	10	9	0	1287
14946	6	8	8	1262	0	1284
14947	6	9	1247	9	0	1271
14948	6	4	1275	8	0	1293
14949	6	6	16	1232	0	1260
14950	8	3	9	1266	0	1286
14951	7	4	1	1283	0	1295
14952	4	3	6	1251	0	1264
14953	2	1233	8	21	0	1264
14954	6	1288	6	11	0	1311
14955	1309	20	5	4	0	1338
14956	12	10	3	1310	0	1335
14957	14	4	2	1351	0	1371
14958	5	4	3	1362	0	1374
14959	1316	5	2	24	0	1347
14960	1351	7	1	12	0	1371
14961	29	2	1	1367	0	1399
14962	1381	5	4	11	0	1401
14963	1319	4	4	11	0	1338
14964	1355	3	2	11	0	1371
14965	24	4	3	1328	0	1359
14966	13	7	1332	13	0	1365
14967	10	5	1270	11	0	1296
14968	5	4	1322	2	0	1333
14969	1	7	1325	4	0	1337
14970	5	4	13	1298	0	1320
14971	1311	0	7	32	0	1350
14972	1310	4	1	9	0	1324
14973	14	6	1319	4	0	1343
14974	11	5	1368	3	0	1387
14975	7	1459	22	1	0	1489
14976	3	17	8	1455	0	1483
14977	1439	6	3	17	0	1465
14978	10	13	1476	11	0	1510
14979	1391	2	10	6	0	1409
14980	11	1704	8	4	0	1727
14981	12	9	1	1792	0	1814
14982	7	9	1	1884	0	1901
14983	5	4	1	1929	0	1939
14984	1904	3	1	40	0	1948
14985	25	1	3	1964	0	1993
14986	24	11	2	1947	0	1984
14987	1942	1	1	40	0	1984
14988	21	2	2	1951	0	1976
14989	23	3	1938	20	0	1984
14990	1870	1	15	24	0	1910
14991	18	3	18	1935	0	1974
14992	27	0	4	1947	0	1978
14993	2	1957	7	35	0	2001
14994	1983	19	2	21	0	2025
14995	2054	21	3	9	0	2087
14996	41	1	4	2078	0	2124
14997	26	2	2049	20	0	2097
14998	1886	1	19	29	0	1935
14999	23	3	2065	4	0	2095
15000	27	2	18	1998	0	2045
15001	3	3	25	2081	0	2112
15002	2027	3	2	40	0	2072
15003	25	2	3	2131	0	2161
15004	30	5	2123	23	0	2181
15005	2025	1	23	28	0	2077
15006	24	3	2231	8	0	2266
15007	27	5	2240	5	0	2277
15008	2311	2	41	7	0	2361
15009	26	1	21	2416	0	2464
15010	24	2515	4	26	0	2569
15011	2533	21	3	26	0	2583
15012	2530	21	4	4	0	2559
15013	45	5	2521	2	0	2573
15014	2499	0	24	10	0	2533
15015	22	2	22	2501	0	2547
15016	23	7	2613	27	0	2670
15017	7	2570	23	26	0	2626
15018	2492	19	23	8	0	2542
15019	21	2529	1	11	0	2562
15020	23	18	2	2485	0	2528
15021	10	18	2	2521	0	2551
15022	5	1	3	2510	0	2519
15023	6	1	9	2407	0	2423
15024	6	2381	3	42	0	2432
15025	5	16	2292	22	0	2335
15026	5	2319	21	4	0	2349
15027	2313	17	19	13	0	2362
15028	25	20	1	2335	0	2381
15029	2344	6	1	21	0	2372
15030	23	2	8	2341	0	2374
15031	2478	2	4	27	0	2511
15032	22	2538	8	22	0	2590
15033	2672	17	6	12	0	2707
15034	2681	20	1	8	0	2710
15035	2578	0	5	12	0	2595
15036	2614	7	2	10	0	2633
15037	36	2573	6	7	0	2622
15038	28	24	2599	7	0	2658
15039	5	16	25	2590	0	2636
15040	2614	3	24	25	0	2666
15041	2674	2	3	23	0	2702
15042	41	3	5	2739	0	2788
15043	25	7	2814	25	0	2871
15044	15	1	16	2750	0	2782
15045	10	2819	23	21	0	2873
15046	2843	20	4	23	0	2890
15047	29	36	3	2833	0	2901
15048	29	2887	4	24	0	2944
15049	5	3041	9	27	0	3082
15050	13	3126	3	4	0	3146
15051	8	44	4	3161	0	3217
15052	3164	27	6	30	0	3227
15053	32	3224	1	33	0	3290
15054	36	23	4	3283	0	3346
15055	3279	30	5	28	0	3342
15056	29	6	3	3323	0	3361
15057	3259	2	3	40	0	3304
15058	3281	6	6	40	0	3333
15059	56	3550	5	9	0	3620
15060	46	32	3	3396	0	3477
15061	8	3604	8	26	0	3646
15062	3562	30	7	36	0	3635
15063	3615	27	5	17	0	3664
15064	3667	9	6	13	0	3695
15065	65	7	4	3598	0	3674
15066	40	7	3527	36	0	3610
15067	3419	6	28	42	0	3495
15068	3555	7	30	10	0	3602
15069	72	4	3	3443	0	3522
15070	41	3527	8	34	0	3610
15071	17	34	8	3574	0	3633
15072	15	39	5	3620	0	3679
15073	3581	8	11	67	0	3667
15074	3495	9	8	36	0	3548
15075	61	10	3433	18	0	3522
15076	41	10	24	3410	0	3485
15077	3483	5	31	38	0	3557
15078	41	6	2	3533	0	3582
15079	40	13	3578	37	0	3668
15080	13	3283	39	40	0	3375
15081	13	3401	26	12	0	3452
15082	3727	48	3	13	0	3791
15083	49	28	1	3960	0	4038
15084	36	13	2	4486	0	4537
15085	4389	7	6	106	0	4508
15086	77	7	4465	54	0	4603
15087	58	5	65	4412	0	4540
15088	20	5	4530	71	0	4626
15089	9	4485	77	48	0	4619
15090	4707	66	47	22	0	4842
15091	4812	42	11	10	0	4875
15092	4827	14	6	13	0	4860
15093	128	12	4680	9	0	4829
15094	4716	6	69	9	0	4800
15095	4800	7	42	14	0	4863
15096	121	6	16	4663	0	4806
15097	3870	9	42	79	0	4000
15098	69	7	4594	42	0	4712
15099	4450	5	69	27	0	4551
15100	82	15	4648	11	0	4756
15101	51	4622	81	14	0	4768
15102	28	74	44	4149	0	4295
15103	16	4647	15	57	0	4735
15104	23	78	4567	40	0	4708
15105	14	4681	66	19	0	4780
15106	4327	71	46	19	0	4463
15107	63	4416	13	15	0	4507
15108	52	4254	13	12	0	4331
15109	30	106	4214	9	0	4359
15110	14	53	67	4161	0	4295
15111	4196	22	45	66	0	4329
15112	80	21	4223	56	0	4380
15113	57	4173	73	27	0	4330
15114	31	67	47	4051	0	4196
15115	19	50	4233	72	0	4374
15116	17	27	4101	45	0	4190
15117	23	9	109	4067	0	4208
15118	22	13	4143	73	0	4251
15119	21	18	86	3624	0	3749
15120	20	3998	66	65	0	4149
15121	30	70	24	3879	0	4003
15122	27	4109	23	65	0	4224
15123	28	76	17	4090	0	4211
15124	4052	54	19	76	0	4201
15125	91	16	16	4035	0	4158
15126	68	4038	22	83	0	4211
15127	40	64	20	4127	0	4251
15128	29	50	4113	90	0	4282
15129	23	18	71	4133	0	4245
15130	4102	16	55	83	0	4256
15131	77	22	3989	52	0	4140
15132	68	15	72	3894	0	4049
15133	3763	18	54	79	0	3914
15134	76	3769	30	58	0	3933
15135	70	80	21	3682	0	3853
15136	3745	57	16	85	0	3903
15137	81	33	21	3768	0	3903
15138	67	25	3694	91	0	3877
15139	3540	25	89	59	0	3713
15140	83	3667	73	33	0	3856
15141	64	3677	35	21	0	3797
15142	3647	121	33	17	0	3818
15143	3622	72	18	24	0	3736
15144	125	28	21	3547	0	3721
15145	3639	23	28	82	0	3772
15146	94	24	3561	63	0	3742
15147	3486	20	83	36	0	3625
15148	87	3418	68	38	0	3611
15149	3430	77	44	27	0	3578
15150	86	62	3489	43	0	3680
15151	69	19	81	3409	0	3578
15152	38	27	60	3492	0	3617
15153	33	26	39	3148	0	3246
15154	29	3357	35	107	0	3528
15155	3350	73	20	63	0	3506
15156	89	56	33	2999	0	3177
15157	78	3186	36	78	0	3378
15158	3430	63	55	56	0	3604
15159	3189	46	32	43	0	3310
15160	3267	31	28	31	0	3357
15161	3229	28	30	38	0	3325
15162	3175	23	23	43	0	3264
15163	125	25	26	3094	0	3270
15164	81	27	25	3127	0	3260
15165	3095	18	34	114	0	3261
15166	81	40	24	3136	0	3281
15167	56	38	23	3118	0	3235
15168	31	40	2953	118	0	3142
15169	3042	31	84	63	0	3220
15170	3123	29	67	53	0	3272
15171	3156	40	31	34	0	3261
15172	128	27	39	2796	0	2990
15173	71	3013	29	72	0	3185
15174	3283	82	23	60	0	3448
15175	3177	68	32	48	0	3325
15176	131	30	35	3356	0	3552
15177	3373	19	35	95	0	3522
15178	148	47	2744	95	0	3034
15179	74	3330	84	48	0	3536
15180	58	3362	59	66	0	3545
15181	90	127	3231	47	0	3495
15182	23	2802	77	34	0	2936
15183	35	2558	45	42	0	2680
15184	2039	53	14	39	0	2145
15185	31	2031	21	42	0	2125
15186	47	29	19	2022	0	2117
15187	2102	33	18	50	0	2203
15188	44	17	2055	43	0	2159
15189	2017	18	23	31	0	2089
15190	40	32	2060	24	0	2156
15191	38	4	2046	40	0	2128
15192	1955	17	50	29	0	2051
15193	27	8	2060	41	0	2136
15194	48	1963	29	10	0	2050
15195	15	25	33	1961	0	2034
15196	1973	34	6	30	0	2043
15197	32	1949	8	40	0	2029
15198	40	31	14	1959	0	2044
15199	24	28	2003	33	0	2088
15200	33	9	19	2017	0	2078
15201	2014	13	32	31	0	2090
15202	37	10	2001	30	0	2078
15203	58	37	20	1949	0	2064
15204	2006	26	25	28	0	2085
15205	2046	6	7	46	0	2105
15206	72	7	7	2009	0	2095
15207	45	5	5	2037	0	2092
15208	15	7	2081	53	0	2156
15209	29	13	2066	25	0	2133
15210	2020	8	47	10	0	2085
15211	2170	8	48	7	0	2233
15212	52	2184	12	14	0	2262
15213	2235	18	15	14	0	2282
15214	2305	23	6	10	0	2344
15215	51	9	2420	17	0	2497
15216	38	2504	21	16	0	2579
15217	2532	22	28	8	0	2590
15218	2533	26	5	7	0	2571
15219	2554	5	2	7	0	2568
15220	54	4	3	2499	0	2560
15221	35	6	1	2481	0	2523
15222	9	2495	4	50	0	2558
15223	7	18	3	2535	0	2563
15224	2483	25	2	33	0	2543
15225	31	6	2	2527	0	2566
15226	35	9	2494	25	0	2563
15227	11	9	2455	29	0	2504
15228	6	3	44	2438	0	2491
15229	6	4	2455	28	0	2493
15230	10	5	2442	33	0	2490
15231	4	3	52	2353	0	2412
15232	7	2	31	2505	0	2545
15233	6	5	2495	53	0	2559
15234	5	9	2496	33	0	2543
15235	6	2503	53	5	0	2567
15236	2523	26	33	11	0	2593
15237	30	2622	8	5	0	2665
15238	2592	25	7	7	0	2631
15239	2626	26	9	7	0	2668
15240	48	2662	10	8	0	2728
15241	2770	31	4	11	0	2816
15242	36	35	4	2754	0	2829
15243	41	7	2781	30	0	2859
15244	8	6	30	2770	0	2814
15245	9	6	32	2807	0	2854
15246	2730	4	4	56	0	2794
15247	2776	5	7	38	0	2826
15248	2790	3	4	15	0	2812
15249	2777	6	8	13	0	2804
15250	2586	6	8	10	0	2610
15251	68	2502	8	5	0	2583
15252	44	26	7	2522	0	2599
15253	10	37	2557	36	0	2640
15254	7	2	31	2575	0	2615
15255	13	2	35	2585	0	2635
15256	10	4	9	2728	0	2751
15257	2866	4	6	69	0	2945
15258	49	3	5	2902	0	2959
15259	2914	4	5	51	0	2974
15260	54	10	2959	48	0	3071
15261	46	6	43	3282	0	3377
15262	12	4	3367	73	0	3456
15263	3325	3	75	57	0	3460
15264	66	3	57	3429	0	3555
15265	60	10	3465	68	0	3603
15266	16	4	68	3520	0	3608
15267	3503	2	60	80	0	3645
15268	74	9	3593	62	0	3738
15269	3653	1	60	23	0	3737
15270	3728	8	57	21	0	3814
15271	3785	2	24	11	0	3822
15272	3643	7	11	17	0	3678
15273	128	3568	10	11	0	3717
15274	54	3416	17	12	0	3499
15275	25	3386	12	12	0	3435
15276	31	101	5	3056	0	3193
15277	21	3194	7	52	0	3274
15278	3090	63	8	34	0	3195
15279	60	3062	6	29	0	3157
15280	42	3064	13	17	0	3136
15281	23	87	8	3047	0	3165
15282	21	34	8	3113	0	3176
15283	3019	15	12	91	0	3137
15284	77	5	2	3065	0	3149
15285	51	11	2957	68	0	3087
15286	14	17	2883	52	0	2966
15287	24	10	3018	25	0	3077
15288	19	6	96	2884	0	3005
15289	28	5	43	3166	0	3242
15290	17	7	3067	106	0	3197
15291	15	8	3048	56	0	3127
15292	18	19	3157	19	0	3213
15293	3091	13	116	22	0	3242
15294	66	8	60	3191	0	3325
15295	56	14	12	3242	0	3324
15296	3193	5	18	114	0	3330
15297	76	12	17	3186	0	3291
15298	64	3241	21	75	0	3401
15299	24	3401	12	64	0	3501
15300	22	102	14	3347	0	3485
15301	3409	54	10	86	0	3559
15302	3380	16	8	72	0	3476
15303	3461	14	15	24	0	3514
15304	126	16	14	3365	0	3521
15305	63	22	3324	68	0	3477
15306	30	11	66	3330	0	3437
15307	35	12	3351	84	0	3482
15308	3112	12	71	63	0	3258
15309	82	11	62	3245	0	3400
15310	3173	6	25	85	0	3289
15311	75	14	3187	61	0	3337
15312	2905	11	72	39	0	3027
15313	79	9	3280	27	0	3395
15314	70	3086	66	20	0	3242
15315	23	3081	57	28	0	3189
15316	2984	95	20	20	0	3119
15317	78	57	19	2971	0	3125
15318	57	21	2981	73	0	3132
15319	24	2973	71	59	0	3127
15320	15	3071	60	30	0	3176
15321	33	101	20	3010	0	3164
15322	3048	49	19	79	0	3195
15323	3067	19	18	61	0	3165
15324	98	3039	31	33	0	3201
15325	3080	70	28	21	0	3199
15326	85	54	15	3050	0	3204
15327	61	23	3080	94	0	3258
15328	44	3110	76	55	0	3285
15329	29	62	58	3193	0	3342
15330	30	53	30	3220	0	3333
15331	3150	12	24	117	0	3303
15332	83	25	3086	67	0	3261
15333	3094	16	77	31	0	3218
15334	3156	17	51	31	0	3255
15335	113	18	18	3111	0	3260
15336	71	13	24	3143	0	3251
15337	3088	21	11	111	0	3231
15338	77	17	24	3184	0	3302
15339	58	25	3084	91	0	3258
15340	50	25	2929	49	0	3053
15341	29	2871	98	42	0	3040
15342	18	3025	61	33	0	3137
15343	40	92	33	2734	0	2899
15344	15	2843	22	75	0	2955
15345	2914	68	26	51	0	3059
15346	70	2956	30	34	0	3090
15347	61	62	22	2899	0	3044
15348	32	60	13	2948	0	3053
15349	24	28	2911	112	0	3075
15350	19	12	74	2895	0	3000
15351	39	6	56	2944	0	3045
15352	23	2964	38	92	0	3117
15353	27	103	16	3021	0	3167
15354	19	46	15	3145	0	3225
15355	41	22	3026	113	0	3202
15356	22	2959	64	82	0	3127
15357	14	137	47	2463	0	2661
15358	24	2691	17	47	0	2779
15359	14	55	2611	65	0	2745
15360	9	2562	50	23	0	2644
15361	2208	33	30	10	0	2281
15362	2144	23	8	7	0	2182
15363	2113	8	5	12	0	2138
15364	46	2077	11	7	0	2141
15365	2074	24	8	5	0	2111
15366	34	26	0	2033	0	2093
15367	2030	11	4	28	0	2073
15368	25	2028	6	51	0	2110
15369	2023	27	3	10	0	2063
15370	1972	24	5	9	0	2010
15371	46	2078	6	14	0	2144
15372	33	27	2078	10	0	2148
15373	11	24	29	2210	0	2274
15374	6	23	2465	31	0	2525
15375	10	8	40	2541	0	2599
15376	3	3	39	2727	0	2772
15377	3	14	2722	84	0	2823
15378	10	4	43	2747	0	2804
15379	2681	9	45	55	0	2790
15380	43	8	2742	51	0	2844
15381	42	2744	44	18	0	2848
15382	11	41	47	2700	0	2799
15383	10	47	9	2869	0	2935
15384	10	22	2844	86	0	2962
15385	15	13	40	2712	0	2780
15386	6	2850	50	52	0	2958
15387	2724	41	10	56	0	2831
15388	35	2854	17	13	0	2919
15389	2612	49	4	13	0	2678
15390	40	2633	7	11	0	2691
15391	29	2845	9	12	0	2895
15392	31	73	2686	8	0	2798
15393	10	40	42	2678	0	2770
15394	6	12	39	2685	0	2742
15395	10	7	7	2763	0	2787
15396	6	2982	8	88	0	3084
15397	8	57	11	3003	0	3079
15398	2949	42	10	70	0	3071
15399	60	10	6	2883	0	2959
15400	2872	4	13	68	0	2957
15401	66	18	2862	54	0	3000
15402	2849	14	60	24	0	2947
15403	71	8	47	2839	0	2965
15404	52	26	14	2965	0	3057
15405	2932	10	9	108	0	3059
15406	62	16	2960	59	0	3097
15407	44	2901	70	23	0	3038
15408	19	59	51	2895	0	3024
15409	2942	46	12	77	0	3077
15410	2980	16	10	54	0	3060
15411	106	11	8	2914	0	3039
15412	53	26	2926	66	0	3071
15413	2796	7	63	59	0	2925
15414	65	19	2854	29	0	2967
15415	57	10	65	2818	0	2950
15416	16	21	2877	77	0	2991
15417	19	12	63	2861	0	2955
15418	16	13	2845	77	0	2951
15419	17	2789	57	76	0	2939
15420	29	63	52	2368	0	2512
15421	19	2825	22	64	0	2930
15422	2803	70	21	52	0	2946
15423	2833	49	12	40	0	2934
15424	108	23	2792	25	0	2948
15425	60	17	67	2778	0	2922
15426	2814	12	55	73	0	2954
15427	70	20	20	2779	0	2889
15428	65	12	17	2741	0	2835
15429	29	19	2653	111	0	2812
15430	2503	14	72	75	0	2664
15431	80	23	2675	37	0	2815
15432	62	10	75	2641	0	2788
15433	28	19	2693	88	0	2828
15434	2636	10	75	72	0	2793
15435	2697	10	59	41	0	2807
15436	2757	15	26	29	0	2827
15437	119	17	19	2646	0	2801
15438	58	23	2578	76	0	2735
15439	39	18	2588	64	0	2709
15440	26	25	110	2312	0	2473
15441	23	2548	65	76	0	2712
15442	2518	63	30	64	0	2675
15443	83	56	18	2534	0	2691
15444	70	19	2534	85	0	2708
15445	38	19	69	2548	0	2674
15446	44	19	2573	79	0	2715
15447	41	21	74	2562	0	2698
15448	39	18	2608	87	0	2752
15449	31	12	2558	81	0	2682
15450	38	2484	116	42	0	2680
15451	30	60	2530	54	0	2674
15452	38	52	2520	45	0	2655
15453	30	41	115	1919	0	2105
15454	40	8	70	2092	0	2210
15455	34	2321	47	92	0	2494
15456	2336	55	30	62	0	2483
15457	79	2352	47	33	0	2511
15458	76	58	33	2255	0	2422
15459	2301	43	36	77	0	2457
15460	80	15	29	2360	0	2484
15461	2364	12	40	88	0	2504
15462	83	15	32	2401	0	2531
15463	54	22	2358	87	0	2521
15464	40	15	75	2378	0	2508
15465	32	22	71	2406	0	2531
15466	2361	12	35	121	0	2529
15467	2368	16	33	78	0	2495
15468	2259	9	37	37	0	2342
15469	100	2147	42	47	0	2336
15470	60	2233	41	36	0	2370
15471	2101	78	35	42	0	2256
15472	66	47	2116	37	0	2266
15473	53	16	2067	38	0	2174
15474	33	124	76	1674	0	1907
15475	24	9	1737	42	0	1812
15476	19	10	1606	34	0	1669
15477	1403	4	57	28	0	1492
15478	1498	5	35	13	0	1551
15479	64	1497	12	23	0	1596
15480	24	1545	27	17	0	1613
15481	15	44	21	1206	0	1286
15482	11	1460	23	45	0	1539
15483	1456	29	27	28	0	1540
15484	38	21	12	1312	0	1383
15485	30	1453	20	38	0	1541
15486	1508	32	20	29	0	1589
15487	36	20	1538	20	0	1614
15488	28	11	1498	19	0	1556
15489	1489	11	55	22	0	1577
15490	38	10	1519	21	0	1588
15491	1288	7	38	18	0	1351
15492	35	4	28	1352	0	1419
15493	26	10	1427	33	0	1496
15494	11	1398	39	35	0	1483
15495	14	1400	36	12	0	1462
15496	1114	20	16	13	0	1163
15497	17	1140	12	13	0	1182
15498	1061	8	12	9	0	1090
15499	1069	6	6	12	0	1093
15500	21	1074	13	3	0	1111
15501	16	9	11	1031	0	1067
15502	7	13	1099	11	0	1130
15503	6	1188	15	12	0	1221
15504	5	28	7	1146	0	1186
15505	2	10	3	1240	0	1255
15506	1214	2	2	25	0	1243
15507	17	1	2	1215	0	1235
15508	11	5	1240	17	0	1273
15509	3	1235	18	14	0	1270
15510	4	15	13	1265	0	1297
15511	1307	12	1	19	0	1339
15512	1322	2	3	15	0	1342
15513	27	2	2	1330	0	1361
15514	1458	2	1	18	0	1479
15515	31	10	1497	12	0	1550
15516	18	4	29	1465	0	1516
15517	6	5	1535	29	0	1575
15518	4	3	28	1581	0	1616
15519	5	3	18	1596	0	1622
15520	4	5	3	1627	0	1639
15521	4	1	4	1658	0	1667
15522	7	3	1	1662	0	1673
15523	1610	2	2	58	0	1672
15524	1638	0	2	31	0	1671
15525	57	1635	7	4	0	1703
15526	1682	36	3	7	0	1728
15527	44	24	2	1669	0	1739
15528	27	4	3	1715	0	1749
15529	8	2	0	1736	0	1746
15530	3	2	1705	63	0	1773
15531	12	3	38	1596	0	1649
15532	4	1671	31	33	0	1739
15533	1664	38	3	32	0	1737
15534	1687	25	4	9	0	1725
15535	65	2	1663	12	0	1742
15536	31	1678	39	13	0	1761
15537	10	37	25	1667	0	1739
15538	2	32	1695	49	0	1778
15539	9	1	41	1599	0	1650
15540	3	1690	27	43	0	1763
15541	1650	37	6	33	0	1726
15542	39	1712	5	15	0	1771
15543	32	39	1678	9	0	1758
15544	15	29	1696	17	0	1757
15545	6	1677	65	13	0	1761
15546	7	1699	30	10	0	1746
15547	1653	59	4	14	0	1730
15548	1646	28	6	16	0	1696
15549	64	7	2	1649	0	1722
15550	29	11	1634	49	0	1723
15551	13	2	39	1642	0	1696
15552	5	10	27	1647	0	1689
15553	1619	8	2	74	0	1703
15554	1607	2	5	40	0	1654
15555	65	5	10	1681	0	1761
15556	36	12	1686	48	0	1782
15557	13	1680	43	38	0	1774
15558	1663	48	33	13	0	1757
15559	46	1728	8	12	0	1794
15560	34	44	7	1705	0	1790
15561	12	31	6	1785	0	1834
15562	11	9	2	1801	0	1823
15563	10	8	17	1780	0	1815
15564	1705	5	9	78	0	1797
15565	48	16	3	1710	0	1777
15566	35	1701	7	53	0	1796
15567	17	48	7	1705	0	1777
15568	1641	27	9	61	0	1738
15569	45	1661	9	43	0	1758
15570	35	43	7	1685	0	1770
15571	11	29	1672	52	0	1764
15572	1617	9	46	44	0	1716
15573	52	10	30	1647	0	1739
15574	41	11	1603	52	0	1707
15575	14	12	1623	41	0	1690
15576	10	7	71	1608	0	1696
15577	1583	10	40	55	0	1688
15578	1617	8	9	40	0	1674
15579	72	1630	9	19	0	1730
15580	1584	46	7	24	0	1661
15581	1607	32	7	18	0	1664
15582	1630	8	8	20	0	1666
15583	1561	7	9	25	0	1602
15584	73	6	8	1480	0	1567
15585	39	7	6	1500	0	1552
15586	14	14	1393	84	0	1505
15587	13	1309	46	43	0	1411
15588	15	1360	32	21	0	1428
15589	12	64	1287	12	0	1375
15590	1285	35	40	20	0	1380
15591	50	5	31	1306	0	1392
15592	1344	10	5	48	0	1407
15593	1280	5	2	47	0	1334
15594	72	11	1248	16	0	1347
15595	37	11	43	1249	0	1340
15596	1257	5	30	54	0	1346
15597	52	7	6	1291	0	1356
15598	43	6	1248	54	0	1351
15599	14	30	39	1155	0	1238
15600	14	1243	42	41	0	1340
15601	14	1296	10	34	0	1354
15602	21	68	1175	17	0	1281
15603	13	1124	38	16	0	1191
15604	1033	30	29	11	0	1103
15605	986	23	6	8	0	1023
15606	56	5	3	959	0	1023
15607	27	7	8	986	0	1028
15608	11	4	7	972	0	994
15609	922	6	6	54	0	988
15610	38	904	5	28	0	975
15611	910	28	3	8	0	949
15612	875	24	2	8	0	909
15613	59	843	5	6	0	913
15614	706	18	4	7	0	735
15615	22	685	5	6	0	718
15616	696	18	1	6	0	721
15617	24	13	664	13	0	714
15618	566	2	33	10	0	611
15619	16	587	11	2	0	616
15620	12	11	33	566	0	622
15621	5	10	2	612	0	629
15622	5	1	1	619	0	626
15623	606	0	2	26	0	634
15624	16	4	3	615	0	638
15625	11	2	571	17	0	601
15626	527	4	12	12	0	555
15627	15	4	554	3	0	576
15628	12	0	11	542	0	565
15629	2	3	542	10	0	557
15630	4	2	10	524	0	540
15631	3	535	12	13	0	563
15632	10	9	1	522	0	542
15633	6	547	2	10	0	565
15634	4	10	4	551	0	569
15635	562	10	2	11	0	585
15636	12	2	2	583	0	599
15637	581	1	3	13	0	598
15638	14	2	548	11	0	575
15639	568	4	8	5	0	585
15640	581	5	10	5	0	601
15641	597	2	4	1	0	604
15642	20	7	1	582	0	610
15643	578	4	1	12	0	595
15644	19	2	583	12	0	616
15645	593	2	9	6	0	610
15646	16	0	607	6	0	629
15647	604	2	8	9	0	623
15648	15	2	11	643	0	671
15649	14	1	696	11	0	722
15650	5	4	14	697	0	720
15651	6	3	12	704	0	725
15652	6	2	702	22	0	732
15653	624	3	11	14	0	652
15654	8	709	13	10	0	740
15655	663	8	2	3	0	676
15656	11	676	0	3	0	690
15657	708	8	4	6	0	726
15658	8	11	690	6	0	715
15659	618	1	19	5	0	643
15660	5	645	7	5	0	662
15661	12	3	2	626	0	643
15662	2	7	2	653	0	664
15663	6	1	0	677	0	684
15664	5	2	681	11	0	699
15665	2	1	6	673	0	682
15666	5	2	704	7	0	718
15667	682	2	5	11	0	700
15668	737	0	8	3	0	748
15669	14	0	1	768	0	783
15670	11	0	776	5	0	792
15671	700	3	4	14	0	721
15672	8	1	1028	5	0	1042
15673	9	1	14	1066	0	1090
15674	2	0	17	1096	0	1115
15675	6	1	2	1140	0	1149
15676	2	2	2	1153	0	1159
15677	1100	2	2	39	0	1143
15678	18	1173	2	24	0	1217
15679	18	14	1189	2	0	1223
15680	3	1221	16	1	0	1241
15681	1216	14	21	2	0	1253
15682	17	22	2	1219	0	1260
15683	1248	1	1	17	0	1267
15684	17	2	3	1244	0	1266
15685	22	0	2	1235	0	1259
15686	2	1	0	1260	0	1263
15687	2	2	1213	38	0	1255
15688	2	1210	17	26	0	1255
15689	4	16	1251	4	0	1275
15690	2	19	17	1235	0	1273
15691	1279	1	25	21	0	1326
15692	1270	2	2	25	0	1299
15693	1311	0	3	7	0	1321
15694	38	1287	2	7	0	1334
15695	1365	15	1	8	0	1389
15696	18	21	3	1349	0	1391
15697	23	2	1	1414	0	1440
15698	3	2	5	1436	0	1446
15699	2	1449	4	39	0	1494
15700	8	16	1	1355	0	1380
15701	2	1427	4	19	0	1452
15702	1410	16	1	20	0	1447
15703	1419	23	4	10	0	1456
15704	45	2	0	1415	0	1462
15705	25	8	1414	23	0	1470
15706	1352	3	19	22	0	1396
15707	20	4	22	1413	0	1459
15708	21	2	1415	24	0	1462
15709	1327	2	16	31	0	1376
15710	21	1	23	1415	0	1460
15711	1414	2	3	22	0	1441
15712	18	1418	2	24	0	1462
15713	24	19	2	1394	0	1439
15714	9	1539	2	19	0	1569
15715	8	31	5	1558	0	1602
15716	6	1622	2	23	0	1653
15717	8	21	4	1637	0	1670
15718	5	33	1593	21	0	1652
15719	1213	3	17	36	0	1269
15720	21	1608	21	7	0	1657
15721	23	18	1542	7	0	1590
15722	1513	18	16	8	0	1555
15723	21	2	20	1593	0	1636
15724	21	8	1584	19	0	1632
15725	4	1601	18	24	0	1647
15726	3	16	20	1611	0	1650
15727	10	20	1642	17	0	1689
15728	5	2	17	1649	0	1673
15729	4	3	19	1687	0	1713
15730	9	5	1694	34	0	1742
15731	4	4	16	1724	0	1748
15732	9	6	1779	22	0	1816
15733	4	6	18	1766	0	1794
15734	4	10	1862	28	0	1904
15735	3	6	18	1812	0	1839
15736	1	1	24	1862	0	1888
15737	7	6	4	1834	0	1851
15738	7	1830	8	31	0	1876
15739	1798	20	7	25	0	1850
15740	1817	22	5	7	0	1851
15741	44	3	2	1807	0	1856
15742	1829	2	4	27	0	1862
15743	23	7	1805	29	0	1864
15744	22	1768	24	10	0	1824
15745	1771	17	20	13	0	1821
15746	16	1768	6	16	0	1806
15747	22	18	5	1763	0	1808
15748	5	24	5	1755	0	1789
15749	1693	3	5	44	0	1745
15750	25	5	4	1734	0	1768
15751	28	4	1713	22	0	1767
15752	10	1700	20	28	0	1758
15753	1696	20	25	8	0	1749
15754	25	21	7	1711	0	1764
15755	23	1759	5	25	0	1812
15756	4	26	3	1708	0	1741
15757	5	1731	7	24	0	1767
15758	1709	25	2	26	0	1762
15759	1695	24	1	8	0	1728
15760	46	7	1660	8	0	1721
15761	29	8	1654	6	0	1697
15762	3	5	43	1635	0	1686
15763	9	1698	31	20	0	1758
15764	9	25	3	1716	0	1753
15765	1697	26	4	33	0	1760
15766	24	6	1712	24	0	1766
15767	24	2	23	1673	0	1722
15768	4	6	1708	30	0	1748
15769	6	4	1658	28	0	1696
15770	4	1710	50	6	0	1770
15771	88	107	24	1517	0	1736
15772	1320	8	1	15	0	1344
15773	14	2	1247	12	0	1275
15774	7	1243	11	1	0	1262
15775	1218	10	6	3	0	1237
15776	10	5	0	1219	0	1234
15777	1254	0	2	16	0	1272
15778	1259	1	2	10	0	1272
15779	1321	1	1	5	0	1328
15780	16	3	1349	1	0	1369
15781	1249	0	10	5	0	1264
15782	1349	0	6	5	0	1360
15783	18	1387	0	2	0	1407
15784	7	22	2	1388	0	1419
15785	2	7	2	1406	0	1417
15786	1	0	0	1428	0	1429
15787	1400	2	0	19	0	1421
15788	1359	0	0	13	0	1372
15789	17	2	1401	2	0	1422
15790	8	1	11	1356	0	1376
15791	1	1354	9	12	0	1376
15792	1372	11	1	9	0	1393
15793	12	9	1373	0	0	1394
15794	10	0	9	1330	0	1349
15795	1	1	7	1335	0	1344
15796	2	1330	3	19	0	1354
15797	1	9	1	1315	0	1326
15798	4	8	0	1272	0	1284
15799	1	0	0	1312	0	1313
15800	1263	1	0	22	0	1286
15801	13	1	1	1304	0	1319
15802	8	2	3	1294	0	1307
15803	1366	1	0	25	0	1392
15804	13	2	0	1362	0	1377
15805	10	1622	1	15	0	1648
15806	1674	14	0	12	0	1700
15807	1798	13	1	3	0	1815
15808	1846	2	0	4	0	1852
15809	1970	1	1	3	0	1975
15810	37	2004	6	1	0	2048
15811	2206	25	0	2	0	2233
15812	2228	17	1	2	0	2248
15813	53	2	2	2199	0	2256
15814	23	6	2130	29	0	2188
15815	8	2	28	2094	0	2132
15816	4	1	22	2060	0	2087
15817	4	1	3	2058	0	2066
15818	5	0	1	2084	0	2090
15819	5	1	2	2102	0	2110
15820	2017	0	1	56	0	2074
15821	38	0	2	2043	0	2083
15822	22	3	2061	41	0	2127
15823	7	2	34	2041	0	2084
15824	4	2097	27	38	0	2166
15825	6	33	3	2128	0	2170
15826	2	25	2222	37	0	2286
15827	1915	1	41	33	0	1990
15828	2115	3	26	8	0	2152
15829	61	4	2290	10	0	2365
15830	26	2269	36	5	0	2336
15831	2311	35	25	7	0	2378
15832	2299	26	2	9	0	2336
15833	2323	3	3	4	0	2333
15834	2272	3	2	6	0	2283
15835	68	2	2	2193	0	2265
15836	36	5	2264	37	0	2342
15837	15	7	36	2272	0	2330
15838	13	3	30	2320	0	2366
15839	10	4	2286	70	0	2370
15840	7	6	2269	42	0	2324
15841	2232	2	63	10	0	2307
15842	41	2304	38	11	0	2394
15843	37	36	6	2334	0	2413
15844	15	33	2313	44	0	2405
15845	2160	2	36	47	0	2245
15846	42	6	2440	18	0	2506
15847	2328	4	42	20	0	2394
15848	45	2474	38	20	0	2577
15849	38	38	8	2521	0	2605
15850	11	37	2474	48	0	2570
15851	2336	5	39	50	0	2430
15852	50	2579	41	14	0	2684
15853	40	2753	14	13	0	2820
15854	21	76	11	2782	0	2890
15855	18	45	7	2979	0	3049
15856	3056	14	8	98	0	3176
15857	66	3060	13	57	0	3196
15858	71	52	11	3072	0	3206
15859	3111	48	6	69	0	3234
15860	3201	12	6	64	0	3283
15861	3271	8	11	23	0	3313
15862	120	17	3273	25	0	3435
15863	76	15	3363	17	0	3471
15864	3419	10	123	21	0	3573
15865	84	3549	68	25	0	3726
15866	67	3633	29	14	0	3743
15867	31	133	7	3313	0	3484
15868	14	3586	20	83	0	3703
15869	3557	80	13	66	0	3716
15870	87	56	16	3536	0	3695
15871	73	22	3536	84	0	3715
15872	3499	13	84	71	0	3667
15873	3615	8	65	34	0	3722
15874	143	12	24	3556	0	3735
15875	93	11	12	3626	0	3742
15876	37	11	27	3663	0	3738
15877	37	18	11	3655	0	3721
15878	30	27	3463	151	0	3671
15879	22	3451	79	84	0	3636
15880	37	85	63	3049	0	3234
15881	26	3479	20	88	0	3613
15882	30	95	14	3002	0	3141
15883	25	3416	23	85	0	3549
15884	3326	95	16	78	0	3515
15885	3386	71	9	34	0	3500
15886	146	3369	22	27	0	3564
15887	3449	80	18	30	0	3577
15888	110	65	15	3392	0	3582
15889	3379	25	18	96	0	3518
15890	101	3365	23	78	0	3567
15891	3423	86	21	39	0	3569
15892	3440	69	17	22	0	3548
15893	143	26	21	3348	0	3538
15894	85	30	3335	85	0	3535
15895	38	3334	85	77	0	3534
15896	34	92	64	3346	0	3536
15897	3361	68	24	96	0	3549
15898	115	32	3330	74	0	3551
15899	88	27	76	3297	0	3488
15900	34	28	62	3385	0	3509
15901	3349	13	23	153	0	3538
15902	3405	21	11	93	0	3530
15903	3302	18	15	45	0	3380
15904	155	3230	16	29	0	3430
15905	2995	83	17	31	0	3126
15906	93	65	2891	35	0	3084
15907	66	30	2826	35	0	2957
15908	34	19	2814	24	0	2891
15909	23	22	178	2508	0	2731
15910	29	19	2557	70	0	2675
15911	2342	15	61	56	0	2474
15912	66	15	37	2406	0	2524
15913	57	15	2476	70	0	2618
15914	2481	10	53	51	0	2595
15915	79	16	45	2479	0	2619
15916	64	15	18	2538	0	2635
15917	2494	13	11	105	0	2623
15918	75	10	11	2559	0	2655
15919	52	22	2499	78	0	2651
15920	35	11	64	2537	0	2647
15921	22	17	2546	73	0	2658
15922	28	4	68	2523	0	2623
15923	2410	11	57	74	0	2552
15924	67	2413	23	61	0	2564
15925	55	2463	21	32	0	2571
15926	34	89	11	2369	0	2503
15927	27	52	12	2347	0	2438
15928	24	2329	11	106	0	2470
15929	23	2295	19	64	0	2401
15930	28	89	12	2272	0	2401
15931	24	45	18	2292	0	2379
15932	2171	17	22	107	0	2317
15933	60	2207	19	66	0	2352
15934	61	2171	13	33	0	2278
15935	25	2278	21	28	0	2352
15936	2081	90	41	26	0	2238
15937	61	50	2090	26	0	2227
15938	2094	14	58	26	0	2192
15939	68	9	42	2084	0	2203
15940	54	2031	20	63	0	2168
15941	18	2163	14	65	0	2260
15942	2161	89	11	32	0	2293
15943	69	52	11	2029	0	2161
15944	52	2307	17	62	0	2438
15945	2339	63	15	58	0	2475
15946	2286	49	10	30	0	2375
15947	96	29	2216	25	0	2366
15948	2184	17	56	19	0	2276
15949	2173	15	43	20	0	2251
15950	101	16	15	2027	0	2159
15951	54	1990	18	60	0	2122
15952	21	2040	9	47	0	2117
15953	17	78	3	1877	0	1975
15954	1660	34	2	53	0	1749
15955	43	8	1649	29	0	1729
15956	23	15	1618	10	0	1666
15957	36	9	1592	11	0	1648
15958	11	8	1659	12	0	1690
15959	17	1558	61	14	0	1650
15960	11	1532	29	12	0	1584
15961	21	58	1444	21	0	1544
15962	11	34	1421	14	0	1480
15963	5	1210	39	4	0	1258
15964	5	18	17	1081	0	1121
15965	4	22	1163	22	0	1211
15966	4	3	19	1113	0	1139
15967	7	4	17	1184	0	1212
15968	1	4	3	1235	0	1243
15969	5	2	2	1293	0	1302
15970	7	0	1251	37	0	1295
15971	4	3	25	1236	0	1268
15972	1261	4	20	28	0	1313
15973	26	6	1280	18	0	1330
15974	1288	3	21	5	0	1317
15975	26	2	22	1287	0	1337
15976	21	3	1294	25	0	1343
15977	1282	1	25	22	0	1330
15978	24	3	23	1294	0	1344
15979	1314	6	5	27	0	1352
15980	25	2	2	1264	0	1293
15981	16	1266	7	28	0	1317
15982	10	25	1348	23	0	1406
15983	4	18	26	1337	0	1385
15984	1364	5	22	29	0	1420
15985	1383	2	8	23	0	1416
15986	1404	3	4	6	0	1417
15987	1385	3	4	8	0	1400
15988	1352	1	2	9	0	1364
15989	36	1352	4	9	0	1401
15990	1350	26	6	7	0	1389
15991	27	24	1332	9	0	1392
15992	1346	1	23	10	0	1380
15993	31	2	22	1170	0	1225
15994	22	7	1361	25	0	1415
15995	7	9	1357	20	0	1393
15996	6	2	45	1351	0	1404
15997	1364	5	23	28	0	1420
15998	35	1379	8	25	0	1447
15999	1377	28	7	7	0	1419
16000	34	1387	8	6	0	1435
16001	26	28	7	1387	0	1448
16002	12	24	9	1406	0	1451
16003	1410	9	8	46	0	1473
16004	32	6	4	1425	0	1467
16005	26	9	1380	47	0	1462
16006	1359	7	29	24	0	1419
16007	32	5	28	1419	0	1484
16008	28	5	12	1423	0	1468
16009	8	6	1391	53	0	1458
16010	1291	10	29	26	0	1356
16011	1375	5	28	10	0	1418
16012	52	1346	14	10	0	1422
16013	31	24	1261	8	0	1324
16014	12	27	1301	7	0	1347
16015	8	4	42	1266	0	1320
16016	6	4	25	1256	0	1291
16017	8	1313	12	45	0	1378
16018	7	22	1273	28	0	1330
16019	11	17	26	1267	0	1321
16020	6	6	1336	34	0	1382
16021	7	6	28	1293	0	1334
16022	9	1332	20	31	0	1392
16023	13	24	10	1356	0	1403
16024	11	18	9	1369	0	1407
16025	11	6	4	1360	0	1381
16026	1331	5	3	44	0	1383
16027	25	4	1319	28	0	1376
16028	25	1388	26	11	0	1450
16029	13	24	19	1494	0	1550
16030	1494	16	6	33	0	1549
16031	39	4	6	1533	0	1582
16032	1544	3	5	35	0	1587
16033	34	4	1557	31	0	1626
16034	1567	4	34	9	0	1614
16035	44	3	28	1613	0	1688
16036	38	4	1615	37	0	1694
16037	16	1634	33	28	0	1711
16038	12	32	29	1637	0	1710
16039	16	20	11	1650	0	1697
16040	1598	9	9	53	0	1669
16041	37	1629	9	32	0	1707
16042	24	1567	6	10	0	1607
16043	10	1613	5	7	0	1635
16044	1426	45	8	8	0	1487
16045	28	1424	8	10	0	1470
16046	31	29	4	1410	0	1474
16047	9	21	5	1448	0	1483
16048	1427	5	4	50	0	1486
16049	33	1417	9	29	0	1488
16050	28	27	3	1437	0	1495
16051	1469	22	3	34	0	1528
16052	1474	7	3	26	0	1510
16053	1488	1	10	11	0	1510
16054	51	1471	7	9	0	1538
16055	1336	19	3	6	0	1364
16056	27	14	5	1319	0	1365
16057	18	1315	5	22	0	1360
16058	5	1354	3	20	0	1382
16059	5	34	8	1324	0	1371
16060	1322	14	5	25	0	1366
16061	1365	2	4	23	0	1394
16062	34	4	5	1331	0	1374
16063	13	1354	3	20	0	1390
16064	1344	21	1	19	0	1385
16065	21	17	1268	6	0	1312
16066	13	4	1236	9	0	1262
16067	1179	1	31	4	0	1215
16068	20	5	1209	2	0	1236
16069	12	1	17	1125	0	1155
16070	1151	2	10	19	0	1182
16071	18	1	1	1187	0	1207
16072	14	4	1182	18	0	1218
16073	3	1210	20	16	0	1249
16074	2	14	10	1237	0	1263
16075	4	14	1286	23	0	1327
16076	1208	2	14	14	0	1238
16077	20	0	11	1309	0	1340
16078	15	1	1336	21	0	1373
16079	4	1	18	1309	0	1332
16080	2	1342	14	17	0	1375
16081	5	18	3	1509	0	1535
16082	6	11	2	1460	0	1479
16083	4	1	2	1425	0	1432
16084	0	1429	4	31	0	1464
16085	1450	18	0	17	0	1485
16086	20	12	2	1473	0	1507
16087	18	3	0	1496	0	1517
16088	7	2	0	1510	0	1519
16089	1	8	1470	37	0	1516
16090	5	6	17	1477	0	1505
16091	1476	1	12	23	0	1512
16092	18	1536	3	17	0	1574
16093	19	22	2	1557	0	1600
16094	7	14	0	1571	0	1592
16095	1565	3	3	37	0	1608
16096	20	1540	1	16	0	1577
16097	1587	21	0	11	0	1619
16098	1602	16	1	6	0	1625
16099	36	4	1	1585	0	1626
16100	1608	2	0	27	0	1637
16101	23	1589	6	17	0	1635
16102	1613	22	2	6	0	1643
16103	29	13	0	1591	0	1633
16104	1740	5	1	25	0	1771
16105	1806	6	2	20	0	1834
16106	45	3	1775	8	0	1831
16107	1786	3	22	4	0	1815
16108	1824	4	19	4	0	1851
16109	1836	2	1	13	0	1852
16110	48	8	1952	2	0	2010
16111	20	1952	31	1	0	2004
16112	9	34	20	1967	0	2030
16113	1982	20	3	35	0	2040
16114	38	1916	5	22	0	1981
16115	1955	33	6	8	0	2002
16116	42	22	2	2005	0	2071
16117	31	6	1979	35	0	2051
16118	2008	1	35	26	0	2070
16119	40	3	22	2063	0	2128
16120	29	8	2062	39	0	2138
16121	2002	3	39	34	0	2078
16122	43	6	2193	6	0	2248
16123	36	2	39	2270	0	2347
16124	12	0	32	2383	0	2427
16125	2358	0	3	83	0	2444
16126	2351	2	6	46	0	2405
16127	80	2357	6	5	0	2448
16128	2325	39	3	11	0	2378
16129	41	40	2149	4	0	2234
16130	37	10	2154	4	0	2205
16131	2076	1	71	4	0	2152
16132	41	2161	44	3	0	2249
16133	2152	36	5	4	0	2197
16134	50	2128	5	2	0	2185
16135	2109	34	2	10	0	2155
16136	37	36	7	2048	0	2128
16137	49	8	2044	42	0	2143
16138	11	3	38	2049	0	2101
16139	9	4	38	2100	0	2151
16140	2061	3	4	75	0	2143
16141	45	7	2033	41	0	2126
16142	2011	2	39	10	0	2062
16143	39	2037	43	8	0	2127
16144	2049	35	5	9	0	2098
16145	45	36	9	2025	0	2115
16146	45	12	2028	44	0	2129
16147	18	5	37	2066	0	2126
16148	2042	4	43	43	0	2132
16149	41	8	10	2079	0	2138
16150	52	7	7	2036	0	2102
16151	15	1991	5	74	0	2085
16152	11	37	14	2049	0	2111
16153	19	39	2001	41	0	2100
16154	9	6	36	2013	0	2064
16155	17	4	39	2018	0	2078
16156	1985	7	10	73	0	2075
16157	42	3	11	1997	0	2053
16158	52	7	1930	41	0	2030
16159	12	1945	44	44	0	2045
16160	19	36	39	1947	0	2041
16161	15	39	6	1942	0	2002
16162	1957	14	10	70	0	2051
16163	51	1908	9	42	0	2010
16164	44	41	8	1937	0	2030
16165	1905	37	12	44	0	1998
16166	1949	6	8	46	0	2009
16167	75	8	11	1927	0	2021
16168	56	7	1910	45	0	2018
16169	1872	9	36	47	0	1964
16170	48	6	41	1958	0	2053
16171	1960	8	14	52	0	2034
16172	1933	3	14	51	0	2001
16173	79	1831	21	21	0	1952
16174	1891	37	11	16	0	1955
16175	45	1903	11	18	0	1977
16176	50	37	7	1844	0	1938
16177	22	37	5	1812	0	1876
16178	17	1810	14	75	0	1916
16179	1842	38	5	49	0	1934
16180	1775	41	11	29	0	1856
16181	77	15	1625	16	0	1733
16182	47	9	1626	19	0	1701
16183	15	6	71	1651	0	1743
16184	1680	6	41	52	0	1779
16185	47	9	9	1703	0	1768
16186	50	5	7	1749	0	1811
16187	17	9	1780	77	0	1883
16188	17	11	1779	46	0	1853
16189	14	9	1784	20	0	1827
16190	1672	2	71	19	0	1764
16191	1724	7	60	18	0	1809
16192	73	1683	10	20	0	1786
16193	52	1698	10	11	0	1771
16194	35	65	7	1655	0	1762
16195	15	46	1683	38	0	1782
16196	1644	11	33	47	0	1735
16197	42	8	1762	20	0	1832
16198	45	6	35	1731	0	1817
16199	21	7	36	1803	0	1867
16200	17	8	7	1828	0	1860
16201	18	4	11	1905	0	1938
16202	1841	3	7	79	0	1930
16203	43	8	10	1872	0	1933
16204	40	6	1747	43	0	1836
16205	1582	4	30	49	0	1665
16206	41	4	1689	14	0	1748
16207	39	5	1689	21	0	1754
16208	11	1699	61	9	0	1780
16209	40	20	38	1518	0	1616
16210	1544	33	11	25	0	1613
16211	31	4	5	1549	0	1589
16212	38	11	1513	26	0	1588
16213	10	5	21	1530	0	1566
16214	1486	5	33	30	0	1554
16215	23	1488	12	35	0	1558
16216	1446	16	4	18	0	1484
16217	30	1445	9	6	0	1490
16218	1397	15	4	12	0	1428
16219	17	1431	9	8	0	1465
16220	27	1392	3	8	0	1430
16221	5	33	1338	9	0	1385
16222	5	1285	13	4	0	1307
16223	1118	11	9	7	0	1145
16224	6	11	5	1107	0	1129
16225	1119	5	0	5	0	1129
16226	11	1165	2	9	0	1187
16227	1159	6	5	5	0	1175
16228	11	18	1169	0	0	1198
16229	14	6	7	1136	0	1163
16230	8	1241	14	11	0	1274
16231	3	7	4	1277	0	1291
16232	2	16	2	1300	0	1320
16233	1512	5	2	27	0	1546
16234	17	1573	5	25	0	1620
16235	1646	19	2	12	0	1679
16236	28	37	1622	1	0	1688
16237	39	11	1594	4	0	1648
16238	9	1608	55	9	0	1681
16239	3	22	40	1605	0	1670
16240	9	36	1614	25	0	1684
16241	7	7	23	1554	0	1591
16242	4	5	36	1657	0	1702
16243	6	2	1640	53	0	1701
16244	5	7	1625	43	0	1680
16245	3	4	1699	12	0	1718
16246	2	13	1703	3	0	1721
16247	2	1737	60	14	0	1813
16248	7	23	44	1775	0	1849
16249	5	41	6	1827	0	1879
16250	9	12	1789	63	0	1873
16251	5	1	28	1813	0	1847
16252	6	4	1906	30	0	1946
16253	3	5	31	1890	0	1929
16254	5	3	44	1843	0	1895
16255	5	1862	10	66	0	1943
16256	5	25	6	1904	0	1940
16257	5	41	3	1883	0	1932
16258	6	10	6	1910	0	1932
16259	5	4	1815	75	0	1899
16260	4	1823	30	51	0	1908
16261	1819	28	42	15	0	1904
16262	1828	44	8	10	0	1890
16263	67	8	3	1805	0	1883
16264	45	14	3	1751	0	1813
16265	8	1801	8	70	0	1887
16266	1774	26	7	47	0	1854
16267	26	1856	7	10	0	1899
16268	1846	32	8	8	0	1894
16269	31	44	1832	8	0	1915
16270	1729	12	27	13	0	1781
16271	32	1815	45	10	0	1902
16272	45	22	10	1834	0	1911
16273	9	49	4	1801	0	1863
16274	7	1852	13	63	0	1935
16275	1797	22	10	52	0	1881
16276	29	42	10	1818	0	1899
16277	42	11	4	1841	0	1898
16278	1899	6	5	73	0	1983
16279	1901	7	5	58	0	1971
16280	64	10	1901	15	0	1990
16281	1911	6	29	9	0	1955
16282	32	8	51	1920	0	2011
16283	52	6	1905	33	0	1996
16284	12	8	30	1915	0	1965
16285	6	8	1950	39	0	2003
16286	6	7	1900	51	0	1964
16287	10	6	64	1856	0	1936
16288	5	6	1935	37	0	1983
16289	8	1957	33	50	0	2048
16290	7	28	46	1940	0	2021
16291	11	48	13	2019	0	2091
16292	11	7	1992	80	0	2090
16293	8	1991	38	52	0	2089
16294	1985	35	47	19	0	2086
16295	31	44	6	2013	0	2094
16296	2026	9	10	41	0	2086
16297	34	2085	9	57	0	2185
16298	51	53	2116	14	0	2234
16299	10	50	47	2084	0	2191
16300	2042	6	58	48	0	2154
16301	43	14	2002	60	0	2119
16302	1938	5	42	22	0	2007
16303	39	1964	57	19	0	2079
16304	53	2006	16	10	0	2085
16305	1951	83	17	13	0	2064
16306	38	48	19	1953	0	2058
16307	45	10	14	1923	0	1992
16308	11	1904	13	84	0	2012
16309	12	37	15	1951	0	2015
16310	9	47	12	1954	0	2022
16311	1902	9	7	95	0	2013
16312	39	7	11	1968	0	2025
16313	50	8	1931	52	0	2041
16314	9	3	51	1968	0	2031
16315	12	8	55	2065	0	2140
16316	7	13	2036	90	0	2146
16317	11	10	36	2062	0	2119
16318	1995	4	47	60	0	2106
16319	1973	7	16	57	0	2053
16320	2033	6	9	27	0	2075
16321	82	8	8	1975	0	2073
16322	52	6	1991	52	0	2101
16323	8	1967	46	60	0	2081
16324	19	42	50	1972	0	2083
16325	15	49	2003	65	0	2132
16326	21	10	38	1980	0	2049
16327	12	10	43	2021	0	2086
16328	1970	10	10	82	0	2072
16329	41	2075	13	59	0	2188
16330	47	51	1988	17	0	2103
16331	1897	43	44	8	0	1992
16332	45	2047	41	12	0	2145
16333	26	1846	16	15	0	1903
16334	1830	53	19	12	0	1914
16335	34	23	4	1814	0	1875
16336	31	13	2094	36	0	2174
16337	9	4	34	2098	0	2145
16338	7	2143	31	37	0	2218
16339	2158	36	6	33	0	2233
16340	40	29	4	2158	0	2231
16341	2289	3	2	51	0	2345
16342	43	6	4	2245	0	2298
16343	27	2365	11	43	0	2446
16344	2375	36	2	36	0	2449
16345	2341	26	6	10	0	2383
16346	60	2345	9	7	0	2421
16347	2295	33	3	9	0	2340
16348	35	22	7	2181	0	2245
16349	23	2222	7	31	0	2283
16350	2228	34	3	30	0	2295
16351	35	2249	7	13	0	2304
16352	2254	34	4	11	0	2303
16353	38	24	1	2222	0	2285
16354	2249	2	3	37	0	2291
16355	2291	7	3	29	0	2330
16356	2297	3	9	8	0	2317
16357	55	6	2	2293	0	2356
16358	31	4	4	2316	0	2355
16359	2289	8	2	61	0	2360
16360	41	4	2297	29	0	2371
16361	33	5	31	2324	0	2393
16362	7	2468	33	35	0	2543
16363	13	34	4	2505	0	2556
16364	8	28	5	2529	0	2570
16365	12	14	2519	66	0	2611
16366	12	10	31	2795	0	2848
16367	8	3038	29	46	0	3121
16368	14	51	7	3077	0	3149
16369	13	48	3258	54	0	3373
16370	11	16	61	3350	0	3438
16371	17	8	60	3402	0	3487
16372	3330	11	9	127	0	3477
16373	3398	9	4	78	0	3489
16374	131	7	4	3277	0	3419
16375	78	3282	4	68	0	3432
16376	19	3327	11	71	0	3428
16377	30	117	3301	22	0	3470
16378	19	79	61	3268	0	3427
16379	3277	17	63	64	0	3421
16380	79	8	10	3340	0	3437
16381	77	17	3328	80	0	3502
16382	25	10	61	3388	0	3484
16383	23	9	63	3396	0	3491
16384	14	9	10	3496	0	3529
16385	18	16	3347	134	0	3515
16386	20	3368	69	90	0	3547
16387	3314	68	67	28	0	3477
16388	3291	70	10	18	0	3389
16389	134	16	7	3240	0	3397
16390	81	74	3181	81	0	3417
16391	23	3231	71	92	0	3417
16392	26	70	62	2888	0	3046
16393	16	3263	13	69	0	3361
16394	15	3306	12	59	0	3392
16395	3227	111	7	32	0	3377
16396	65	76	3265	23	0	3429
16397	72	21	3097	5	0	3195
16398	17	8	103	3017	0	3145
16399	12	7	63	3099	0	3181
16400	10	13	3118	107	0	3248
16401	16	8	56	3064	0	3144
16402	7	13	3120	73	0	3213
16403	2889	11	50	76	0	3026
16404	49	6	66	3072	0	3193
16405	67	12	3166	57	0	3302
16406	30	7	52	2923	0	3012
16407	13	3175	70	57	0	3315
16408	3176	50	10	74	0	3310
16409	43	3249	21	23	0	3336
16410	3257	56	11	27	0	3351
16411	62	69	3218	22	0	3371
16412	3253	14	47	26	0	3340
16413	62	10	63	3258	0	3393
16414	75	23	3269	58	0	3425
16415	21	10	52	3242	0	3325
16416	11	11	3210	72	0	3304
16417	2986	13	60	81	0	3140
16418	54	3173	74	30	0	3331
16419	79	47	20	2913	0	3059
16420	21	3274	21	59	0	3375
16421	3204	57	15	73	0	3349
16422	3196	65	17	41	0	3319
16423	115	3201	23	26	0	3365
16424	88	49	19	3208	0	3364
16425	24	58	12	3234	0	3328
16426	18	24	11	3272	0	3325
16427	3149	20	8	131	0	3308
16428	57	3162	20	87	0	3326
16429	68	53	10	3060	0	3191
16430	19	61	16	3102	0	3198
16431	3004	14	13	122	0	3153
16432	44	21	2897	74	0	3036
16433	66	12	2887	40	0	3005
16434	2739	8	87	31	0	2865
16435	56	9	2862	26	0	2953
16436	63	10	2514	21	0	2608
16437	35	13	89	2414	0	2551
16438	2511	7	66	45	0	2629
16439	44	14	14	2504	0	2576
16440	64	10	2483	56	0	2613
16441	2281	12	46	70	0	2409
16442	50	20	2403	19	0	2492
16443	60	2318	56	21	0	2455
16444	16	41	61	2367	0	2485
16445	2442	52	16	57	0	2567
16446	38	12	14	2479	0	2543
16447	55	12	19	2474	0	2560
16448	2538	9	15	101	0	2663
16449	43	9	13	2618	0	2683
16450	56	10	13	2647	0	2726
16451	27	7	2638	89	0	2761
16452	14	13	42	2651	0	2720
16453	2620	7	63	54	0	2744
16454	2625	14	8	69	0	2716
16455	2656	7	15	20	0	2698
16456	99	11	16	2548	0	2674
16457	58	2578	17	45	0	2698
16458	2588	34	13	61	0	2696
16459	41	2608	17	20	0	2686
16460	2556	43	6	19	0	2624
16461	56	51	14	2451	0	2572
16462	2324	10	9	45	0	2388
16463	2309	4	10	54	0	2377
16464	2337	6	14	18	0	2375
16465	80	2261	17	17	0	2375
16466	42	2024	15	12	0	2093
16467	1795	33	6	6	0	1840
16468	24	1839	7	5	0	1875
16469	12	1595	2	2	0	1611
16470	0	1532	0	2	0	1534
16471	1490	14	0	7	0	1511
16472	7	13	0	1472	0	1492
16473	12	2	0	1451	0	1465
16474	1433	0	1	24	0	1458
16475	7	3	1477	11	0	1498
16476	12	0	6	1695	0	1713
16477	3	0	10	1798	0	1811
16478	0	0	1	1998	0	1999
16479	2	2	0	2048	0	2052
16480	0	2040	1	66	0	2107
16481	1	2348	5	36	0	2390
16482	2330	77	0	9	0	2416
16483	48	49	1	2353	0	2451
16484	49	6	1	2416	0	2472
16485	5	5	2323	104	0	2437
16486	4	3	52	2392	0	2451
16487	9	6	2400	63	0	2478
16488	5	1	61	2427	0	2494
16489	4	2	2474	67	0	2547
16490	1	2409	62	52	0	2524
16491	6	48	52	2389	0	2495
16492	2399	51	7	61	0	2518
16493	2418	9	3	53	0	2483
16494	105	3	3	2388	0	2499
16495	59	3	2382	61	0	2505
16496	14	6	2364	61	0	2445
16497	2241	0	100	13	0	2354
16498	56	2341	60	9	0	2466
16499	2418	56	6	9	0	2489
16500	2382	48	4	8	0	2442
16501	110	13	2335	9	0	2467
16502	63	3	63	2327	0	2456
16503	14	6	57	2388	0	2465
16504	8	2	11	2528	0	2549
16505	13	1	5	2432	0	2451
16506	8	2	4	2417	0	2431
16507	3	5	2296	122	0	2426
16508	7	10	2322	71	0	2410
16509	5	2	111	2259	0	2377
16510	7	6	60	2342	0	2415
16511	8	5	14	2379	0	2406
16512	2218	6	6	132	0	2362
16513	66	5	12	2268	0	2351
16514	2255	4	5	81	0	2345
16515	79	2	7	2261	0	2349
16516	2312	5	10	81	0	2408
16517	2350	4	5	79	0	2438
16518	2347	6	16	18	0	2387
16519	2344	1	8	23	0	2376
16520	2337	7	10	15	0	2369
16521	133	7	7	2257	0	2404
16522	2329	1	10	78	0	2418
16523	78	2271	13	71	0	2433
16524	2328	62	12	22	0	2424
16525	81	56	10	2316	0	2463
16526	72	15	2280	75	0	2442
16527	22	9	68	2367	0	2466
16528	24	9	2343	86	0	2462
16529	13	9	76	2344	0	2442
16530	21	4	71	2365	0	2461
16531	13	13	2276	138	0	2440
16532	23	10	2349	79	0	2461
16533	19	8	119	2324	0	2470
16534	2328	2	73	82	0	2485
16535	76	7	2349	82	0	2514
16536	70	2352	79	32	0	2533
16537	25	59	2465	28	0	2577
16538	2372	62	74	28	0	2536
16539	75	6	62	2419	0	2562
16540	2528	5	18	80	0	2631
16541	2521	7	19	77	0	2624
16542	142	2	10	2474	0	2628
16543	82	6	2410	79	0	2577
16544	28	5	62	2417	0	2512
16545	27	4	67	2369	0	2467
16546	2254	3	18	151	0	2426
16547	75	2314	21	92	0	2502
16548	80	68	11	2280	0	2439
16549	32	76	2230	86	0	2424
16550	2132	16	68	93	0	2309
16551	87	2151	78	34	0	2350
16552	90	59	21	2182	0	2352
16553	32	62	19	2225	0	2338
16554	29	12	21	2284	0	2346
16555	2127	5	16	144	0	2292
16556	2204	10	13	95	0	2322
16557	144	3	14	2178	0	2339
16558	88	10	2178	96	0	2372
16559	27	2226	86	82	0	2421
16560	2263	63	70	37	0	2433
16561	2363	56	24	33	0	2476
16562	145	11	11	2283	0	2450
16563	94	5	19	2397	0	2515
16564	31	13	2302	152	0	2498
16565	23	2387	89	92	0	2591
16566	2394	66	83	33	0	2576
16567	2349	73	15	27	0	2464
16568	140	2325	25	28	0	2518
16569	2400	74	13	24	0	2511
16570	90	65	13	2340	0	2508
16571	77	20	2311	93	0	2501
16572	33	3	69	2406	0	2511
16573	25	9	2403	103	0	2540
16574	2308	9	80	90	0	2487
16575	81	2363	77	40	0	2561
16576	67	54	12	2093	0	2226
16577	20	47	2052	68	0	2187
16578	17	10	1971	55	0	2053
16579	1796	16	77	19	0	1908
16580	43	1838	52	18	0	1951
16581	1518	22	4	8	0	1552
16582	1481	26	3	10	0	1520
16583	1482	2	3	12	0	1499
16584	49	1	4	1433	0	1487
16585	21	7	1406	25	0	1459
16586	7	1372	21	22	0	1422
16587	9	14	19	1414	0	1456
16588	9	20	1389	18	0	1436
16589	8	6	1334	22	0	1370
16590	5	5	38	1331	0	1379
16591	9	0	1356	19	0	1384
16592	1287	7	17	27	0	1338
16593	21	1	23	1339	0	1384
16594	23	2	5	1365	0	1395
16595	1360	4	8	36	0	1408
16596	22	1355	6	23	0	1406
16597	1466	18	6	10	0	1500
16598	28	21	1	1463	0	1513
16599	30	2	1	1510	0	1543
16600	7	3	7	1537	0	1554
16601	6	3	10	1506	0	1525
16602	1438	4	8	38	0	1488
16603	23	8	1447	23	0	1501
16604	24	1393	16	5	0	1438
16605	7	17	19	1395	0	1438
16606	1352	21	8	21	0	1402
16607	1375	1	7	28	0	1411
16608	31	1371	12	6	0	1420
16609	1381	13	7	8	0	1409
16610	20	1401	2	9	0	1432
16611	23	1463	7	8	0	1501
16612	16	70	5	1415	0	1506
16613	8	59	1500	26	0	1593
16614	10	4	18	1535	0	1567
16615	1524	5	21	22	0	1572
16616	17	1549	4	24	0	1594
16617	27	18	2	1619	0	1666
16618	7	23	1947	25	0	2002
16619	1968	3	16	22	0	2009
16620	2041	5	18	13	0	2077
16621	2015	5	3	9	0	2032
16622	29	8	1871	9	0	1917
16623	1767	6	14	8	0	1795
16624	22	1846	16	8	0	1892
16625	14	18	4	1768	0	1804
16626	4	1876	11	14	0	1905
16627	1869	11	4	17	0	1901
16628	1822	15	10	9	0	1856
16629	24	4	1854	12	0	1894
16630	12	1852	20	8	0	1892
16631	8	14	24	1834	0	1880
16632	7	10	2	1849	0	1868
16633	8	5	3	1833	0	1849
16634	7	2	4	1825	0	1838
16635	13	1	4	1832	0	1850
16636	7	8	1732	25	0	1772
16637	5	1728	15	21	0	1769
16638	1661	13	11	7	0	1692
16639	20	13	1717	4	0	1754
16640	13	1776	15	4	0	1808
16641	1741	17	36	6	0	1800
16642	19	19	1866	6	0	1910
16643	1787	3	15	12	0	1817
16644	1825	3	12	8	0	1848
16645	1848	5	3	4	0	1860
16646	26	1912	7	8	0	1953
16647	21	17	1836	20	0	1894
16648	3	2009	18	4	0	2034
16649	10	24	11	1667	0	1712
16650	5	2025	4	18	0	2052
16651	2073	19	6	21	0	2119
16652	2147	18	2	12	0	2179
16653	2113	5	5	8	0	2131
16654	38	14	2202	5	0	2259
16655	23	2319	24	7	0	2373
16656	12	28	20	2531	0	2591
16657	2763	19	4	35	0	2821
16658	45	2701	11	31	0	2788
16659	45	37	4	2638	0	2724
16660	11	41	2640	39	0	2731
16661	2474	7	33	37	0	2551
16662	44	7	2788	8	0	2847
16663	35	14	2753	8	0	2810
16664	2506	3	75	8	0	2592
16665	48	5	2651	1	0	2705
16666	2569	3	41	1	0	2614
16667	42	2650	38	3	0	2733
16668	2735	38	8	8	0	2789
16669	49	30	6	2709	0	2794
16670	38	5	5	2711	0	2759
16671	20	4	2	2789	0	2815
16672	2746	9	3	74	0	2832
16673	2748	0	4	46	0	2798
16674	2731	5	6	10	0	2752
16675	72	2630	9	9	0	2720
16676	50	44	2	2659	0	2755
16677	19	35	2667	44	0	2765
16678	14	6	38	2585	0	2643
16679	12	2588	39	40	0	2679
16680	12	58	7	2588	0	2665
16681	13	35	5	2591	0	2644
16682	2586	6	13	75	0	2680
16683	44	11	4	2617	0	2676
16684	44	15	2570	52	0	2681
16685	12	13	2557	49	0	2631
16686	15	5	76	2618	0	2714
16687	2575	8	38	51	0	2672
16688	50	7	20	2593	0	2670
16689	50	3	25	2629	0	2707
16690	17	9	2622	81	0	2729
16691	19	2612	50	50	0	2731
16692	19	42	47	2635	0	2743
16693	2632	39	12	51	0	2734
16694	49	2623	15	43	0	2730
16695	49	41	14	2643	0	2747
16696	17	50	2626	54	0	2747
16697	18	5	48	2587	0	2658
16698	2541	8	43	56	0	2648
16699	54	2478	19	47	0	2598
16700	47	48	2494	20	0	2609
16701	27	38	48	2491	0	2604
16702	21	20	2537	59	0	2637
16703	2431	11	54	51	0	2547
16704	2511	12	51	25	0	2599
16705	83	19	2488	29	0	2619
16706	53	13	58	2464	0	2588
16707	33	14	2567	55	0	2669
16708	36	2541	54	54	0	2685
16709	40	45	58	2562	0	2705
16710	20	53	2564	64	0	2701
16711	28	14	63	2392	0	2497
16712	17	2512	66	53	0	2648
16713	28	47	16	2472	0	2563
16714	28	48	2431	62	0	2569
16715	2298	13	52	70	0	2433
16716	52	2409	51	37	0	2549
16717	2374	41	17	33	0	2465
16718	58	44	2076	30	0	2208
16719	2023	13	51	20	0	2107
16720	66	17	2053	24	0	2160
16721	2014	16	55	25	0	2110
16722	2055	12	46	38	0	2151
16723	87	12	24	2027	0	2150
16724	61	13	18	2064	0	2156
16725	2024	15	19	98	0	2156
16726	59	2045	23	55	0	2182
16727	2115	46	19	38	0	2218
16728	67	44	21	2052	0	2184
16729	61	2085	33	62	0	2241
16730	31	50	22	2186	0	2289
16731	34	44	30	2208	0	2316
16732	24	12	25	2180	0	2241
16733	24	2153	14	112	0	2303
16734	2061	51	21	61	0	2194
16735	69	47	16	2060	0	2192
16736	50	17	2058	85	0	2210
16737	18	17	2048	65	0	2148
16738	19	21	2084	36	0	2160
16739	1979	9	103	37	0	2128
16740	2015	11	51	31	0	2108
16741	88	24	1984	24	0	2120
16742	59	13	59	1826	0	1957
16743	26	12	57	1928	0	2023
16744	22	11	1963	104	0	2100
16745	22	16	1977	59	0	2074
16746	24	18	89	1942	0	2073
16747	1961	11	59	64	0	2095
16748	1968	6	23	58	0	2055
16749	1960	8	28	29	0	2025
16750	94	1905	22	26	0	2047
16751	53	1891	26	19	0	1989
16752	23	72	18	1801	0	1914
16753	1759	38	38	60	0	1895
16754	60	12	1717	44	0	1833
16755	1497	13	36	32	0	1578
16756	36	1390	31	17	0	1474
16757	16	1236	12	7	0	1271
16758	1211	31	10	5	0	1257
16759	20	1220	10	7	0	1257
16760	18	1229	4	9	0	1260
16761	1138	33	53	29	0	1253
16762	22	1168	3	2	0	1195
16763	8	18	4	1103	0	1133
16764	7	8	0	1133	0	1148
16765	1077	3	2	26	0	1108
16766	1088	1	3	9	0	1101
16767	24	1099	2	6	0	1131
16768	11	1073	2	2	0	1088
16769	6	23	1045	1	0	1075
16770	1046	10	17	5	0	1078
16771	1076	39	8	1	0	1124
16772	1115	2	1	3	0	1121
16773	23	1	0	1090	0	1114
16774	13	0	1	1142	0	1156
16775	1210	5	1	24	0	1240
16776	20	2	0	1209	0	1231
16777	9	3	1171	21	0	1204
16778	3	2	15	1162	0	1182
16779	3	1160	8	19	0	1190
16780	2	17	2	1180	0	1201
16781	2	11	0	1208	0	1221
16782	3	4	1	1215	0	1223
16783	1177	2	2	27	0	1208
16784	14	1195	4	12	0	1225
16785	7	15	1	1193	0	1216
16786	6	12	1183	16	0	1217
16787	2	7	1148	11	0	1168
16788	4	1	23	1176	0	1204
16789	4	3	9	1190	0	1206
16790	1143	2	6	26	0	1177
16791	18	1	1	1098	0	1118
16792	9	1097	1	20	0	1127
16793	4	24	1087	12	0	1127
16794	4	28	17	1078	0	1127
16795	4	5	1145	17	0	1171
16796	6	3	19	1146	0	1174
16797	1164	2	8	24	0	1198
16798	1177	1	5	13	0	1196
16799	25	1153	4	4	0	1186
16800	14	18	2	1178	0	1212
16801	1231	9	0	23	0	1263
16802	1276	6	3	17	0	1302
16803	1304	2	1	9	0	1316
16804	1313	3	2	8	0	1326
16805	1320	3	4	4	0	1331
16806	24	1313	6	6	0	1349
16807	1263	13	1	5	0	1282
16808	17	10	1258	2	0	1287
16809	10	0	10	1247	0	1267
16810	1265	1	5	15	0	1286
16811	1253	2	3	8	0	1266
16812	1230	2	4	4	0	1240
16813	19	4	1219	11	0	1253
16814	10	2	15	1227	0	1254
16815	1261	1	10	15	0	1287
16816	18	1272	6	11	0	1307
16817	1376	17	0	9	0	1402
16818	1333	7	1	4	0	1345
16819	1375	4	0	6	0	1385
16820	22	3	3	1389	0	1417
16821	1441	1	6	16	0	1464
16822	18	6	1457	24	0	1505
16823	13	7	1465	8	0	1493
16824	1440	1	21	12	0	1474
16825	17	8	1490	4	0	1519
16826	1345	4	13	9	0	1371
16827	11	3	1445	7	0	1466
16828	8	2	10	1392	0	1412
16829	1365	0	6	15	0	1386
16830	13	1359	7	9	0	1388
16831	1387	10	3	4	0	1404
16832	11	1386	4	6	0	1407
16833	7	1506	4	5	0	1522
16834	5	17	1	1550	0	1573
16835	2	5	2	1559	0	1568
16836	2	4	1	1550	0	1557
16837	3	4	1516	23	0	1546
16838	1462	5	8	15	0	1490
16839	1565	0	29	3	0	1597
16840	1581	0	3	6	0	1590
16841	1567	0	3	4	0	1574
16842	1577	0	5	7	0	1589
16843	22	5	1499	2	0	1528
16844	12	5	1507	6	0	1530
16845	8	0	21	1514	0	1543
16846	5	3	1514	13	0	1535
16847	1394	2	11	15	0	1422
16848	14	1579	10	5	0	1608
16849	18	10	2	1633	0	1663
16850	1631	14	4	11	0	1660
16851	15	2	4	1738	0	1759
16852	20	3	1759	14	0	1796
16853	4	5	1767	19	0	1795
16854	7	2	28	1836	0	1873
16855	4	1	1884	16	0	1905
16856	1766	2	16	18	0	1802
16857	17	14	20	1827	0	1878
16858	21	3	1852	23	0	1899
16859	6	1839	19	20	0	1884
16860	0	17	32	1854	0	1903
16861	7	19	1899	22	0	1947
16862	9	3	15	1863	0	1890
16863	9	3	21	1930	0	1963
16864	6	4	1967	46	0	2023
16865	7	2	20	1982	0	2011
16866	8	1	25	1977	0	2011
16867	3	1	7	2012	0	2023
16868	1971	1	0	47	0	2019
16869	23	1989	8	25	0	2045
16870	28	1985	3	7	0	2023
16871	13	42	1966	5	0	2026
16872	1821	20	25	8	0	1874
16873	26	3	2023	6	0	2058
16874	24	3	1969	7	0	2003
16875	2	3	37	1888	0	1930
16876	1902	1	23	23	0	1949
16877	20	1930	3	25	0	1978
16878	1947	19	5	6	0	1977
16879	1926	20	4	6	0	1956
16880	34	1975	7	8	0	2024
16881	1987	17	1	9	0	2014
16882	1966	21	2	4	0	1993
16883	36	2085	3	7	0	2131
16884	23	20	5	2070	0	2118
16885	3	23	6	2152	0	2184
16886	2221	1	5	47	0	2274
16887	28	2275	10	24	0	2337
16888	2392	24	6	6	0	2428
16889	2368	27	3	13	0	2411
16890	2480	2	2	14	0	2498
16891	56	5	3	2451	0	2515
16892	36	5	0	2478	0	2519
16893	2489	6	4	61	0	2560
16894	2549	3	5	33	0	2590
16895	2539	5	1	13	0	2558
16896	64	1	5	2567	0	2637
16897	34	9	2587	45	0	2675
16898	12	2	35	2613	0	2662
16899	11	2	31	2876	0	2920
16900	12	8	2821	73	0	2914
16901	13	5	2940	42	0	3000
16902	16	2	89	2899	0	3006
16903	11	9	2931	58	0	3009
16904	2987	1	57	59	0	3104
16905	60	2	49	3063	0	3174
16906	50	5	12	3116	0	3183
16907	3138	1	6	113	0	3258
16908	69	2	6	3155	0	3232
16909	51	5	4	3173	0	3233
16910	16	2	5	3227	0	3250
16911	11	5	7	3221	0	3244
16912	9	11	3120	114	0	3254
16913	12	5	59	3125	0	3201
16914	13	9	3090	76	0	3188
16915	11	3160	77	61	0	3309
16916	13	62	48	3153	0	3276
16917	7	50	3040	84	0	3181
16918	2776	8	71	63	0	2918
16919	70	3012	53	20	0	3155
16920	3066	58	14	19	0	3157
16921	75	45	13	2891	0	3024
16922	49	2977	9	75	0	3110
16923	3036	62	8	56	0	3162
16924	72	3094	13	22	0	3201
16925	3105	72	6	17	0	3200
16926	75	47	12	3029	0	3163
16927	3077	13	9	75	0	3174
16928	69	3116	9	64	0	3258
16929	3159	65	12	27	0	3263
16930	78	49	3100	16	0	3243
16931	58	13	62	3132	0	3265
16932	3101	7	49	77	0	3234
16933	3054	9	14	60	0	3137
16934	119	7	5	2987	0	3118
16935	58	18	2981	81	0	3138
16936	24	2871	63	83	0	3041
16937	17	3031	49	18	0	3115
16938	2993	108	15	22	0	3138
16939	77	51	10	2975	0	3113
16940	64	15	8	3029	0	3116
16941	2968	9	14	119	0	3110
16942	2913	10	9	62	0	2994
16943	121	12	2967	28	0	3128
16944	60	13	72	2915	0	3060
16945	32	16	2929	76	0	3053
16946	19	2948	80	66	0	3113
16947	2828	65	47	36	0	2976
16948	72	2942	30	22	0	3066
16949	48	2961	15	16	0	3040
16950	31	107	16	2929	0	3083
16951	2798	51	11	83	0	2943
16952	72	2832	17	58	0	2979
16953	2821	70	12	38	0	2941
16954	83	2792	16	24	0	2915
16955	57	61	11	2779	0	2908
16956	2745	45	18	85	0	2893
16957	71	19	2813	72	0	2975
16958	59	25	66	2780	0	2930
16959	22	20	2809	91	0	2942
16960	16	2672	82	66	0	2836
16961	19	2719	49	63	0	2850
16962	2707	90	14	32	0	2843
16963	64	2761	15	27	0	2867
16964	2765	66	14	36	0	2881
16965	2764	44	16	40	0	2864
16966	103	23	2661	20	0	2807
16967	2604	20	64	19	0	2707
16968	76	24	2854	26	0	2980
16969	56	2795	74	25	0	2950
16970	2884	75	42	24	0	3025
16971	85	2865	20	20	0	2990
16972	58	84	15	2865	0	3022
16973	2843	52	12	73	0	2980
16974	84	31	10	2847	0	2972
16975	54	22	2856	92	0	3024
16976	36	28	62	2854	0	2980
16977	37	16	47	2942	0	3042
16978	2859	24	19	108	0	3010
16979	80	26	2910	73	0	3089
16980	2916	17	71	35	0	3039
16981	3016	21	49	18	0	3104
16982	117	24	24	2910	0	3075
16983	73	14	13	2909	0	3009
16984	2852	16	17	111	0	2996
16985	89	2960	11	68	0	3128
16986	67	65	14	2890	0	3036
16987	44	41	2817	69	0	2971
16988	24	25	2698	51	0	2798
16989	24	2773	89	32	0	2918
16990	51	60	46	2717	0	2874
16991	22	46	15	2789	0	2872
16992	2766	21	11	86	0	2884
16993	68	18	8	2748	0	2842
16994	2706	12	10	74	0	2802
16995	75	2644	12	39	0	2770
16996	45	2653	9	25	0	2732
16997	25	2803	16	16	0	2860
16998	2744	77	32	31	0	2884
16999	2610	28	8	9	0	2655
17000	65	2529	10	10	0	2614
17001	2357	25	8	14	0	2404
17002	33	2338	6	8	0	2385
17003	24	32	2	2283	0	2341
17004	12	2325	4	26	0	2367
17005	2320	35	3	23	0	2381
17006	2353	16	15	14	0	2398
17007	42	13	3	2261	0	2319
17008	2284	7	4	35	0	2330
17009	38	7	4	2277	0	2326
17010	16	2329	11	56	0	2412
17011	14	30	2	2360	0	2406
17012	10	2361	10	31	0	2412
17013	2363	31	4	25	0	2423
17014	35	18	2322	12	0	2387
17015	2100	11	18	3	0	2132
17016	27	8	11	2212	0	2258
17017	15	9	2228	21	0	2273
17018	2110	2	18	20	0	2150
17019	21	15	2253	13	0	2302
17020	16	2	25	2259	0	2302
17021	10	8	12	2320	0	2350
17022	8	7	5	2329	0	2349
17023	11	4	1	2318	0	2334
17024	4	2357	9	38	0	2408
17025	18	24	3	2613	0	2658
17026	2623	19	5	41	0	2688
17027	30	15	2589	25	0	2659
17028	26	3031	33	18	0	3108
17029	3084	39	21	10	0	3154
17030	3252	33	8	14	0	3307
17031	84	16	4	3660	0	3764
17032	53	22	3623	75	0	3773
17033	25	6	68	3630	0	3729
17034	14	7	50	3710	0	3781
17035	19	9	3661	126	0	3815
17036	10	3806	82	72	0	3970
17037	3906	70	52	29	0	4057
17038	3966	51	19	27	0	4063
17039	4086	16	13	18	0	4133
17040	140	9	10	3973	0	4132
17041	69	14	13	4172	0	4268
17042	4266	8	5	140	0	4419
17043	100	9	4	4029	0	4142
17044	73	4255	14	99	0	4441
17045	4458	74	7	75	0	4614
17046	4578	65	10	36	0	4689
17047	4830	26	5	27	0	4888
17048	4822	6	8	30	0	4866
17049	185	18	4557	15	0	4775
17050	112	20	4583	17	0	4732
17051	60	25	152	4508	0	4745
17052	34	3	89	4664	0	4790
17053	34	12	4613	154	0	4813
17054	28	11	4649	101	0	4789
17055	22	11	155	4579	0	4767
17056	4597	6	103	103	0	4809
17057	107	8	34	4520	0	4669
17058	94	17	4536	131	0	4778
17059	43	4627	102	91	0	4863
17060	4632	80	78	57	0	4847
17061	4750	79	33	32	0	4894
17062	4745	29	21	28	0	4823
17063	4799	14	24	21	0	4858
17064	194	15	4537	27	0	4773
17065	126	17	88	4562	0	4793
17066	4603	13	83	108	0	4807
17067	124	7	45	4623	0	4799
17068	115	9	18	4288	0	4430
17069	57	4288	30	225	0	4600
17070	45	80	22	4408	0	4555
17071	4302	73	33	118	0	4526
17072	103	4338	38	105	0	4584
17073	4354	91	18	53	0	4516
17074	126	4357	33	48	0	4564
17075	112	110	23	3984	0	4229
17076	53	4233	28	101	0	4415
17077	55	4342	22	102	0	4521
17078	4217	154	48	53	0	4472
17079	126	102	4198	48	0	4474
17080	117	43	4168	38	0	4366
17081	55	37	4201	43	0	4336
17082	3876	25	170	52	0	4123
17083	121	4094	114	38	0	4367
17084	118	4174	47	39	0	4378
17085	3966	157	31	43	0	4197
17086	123	4012	36	42	0	4213
17087	129	4095	37	50	0	4311
17088	75	165	34	4067	0	4341
17089	56	111	4062	132	0	4361
17090	65	59	4108	104	0	4336
17091	61	45	160	4059	0	4325
17092	4023	39	107	132	0	4301
17093	136	4054	71	104	0	4365
17094	133	111	39	4058	0	4341
17095	91	103	4029	125	0	4348
17096	70	50	3973	117	0	4210
17097	66	28	182	3859	0	4135
17098	3836	34	123	125	0	4118
17099	3897	38	55	118	0	4108
17100	204	46	3797	65	0	4112
17101	3795	37	130	46	0	4008
17102	168	40	3866	47	0	4121
17103	152	24	128	3440	0	3744
17104	87	3757	127	110	0	4081
17105	3808	101	68	115	0	4092
17106	147	92	57	3785	0	4081
17107	129	42	53	3777	0	4001
17108	84	24	48	3904	0	4060
17109	68	32	54	3927	0	4081
17110	75	31	3667	215	0	3988
17111	63	3640	123	139	0	3965
17112	69	98	107	3684	0	3958
17113	3655	93	64	144	0	3956
17114	144	44	51	3741	0	3980
17115	135	33	41	3782	0	3991
17116	81	42	3667	197	0	3987
17117	62	42	3642	142	0	3888
17118	69	3554	189	71	0	3883
17119	71	3673	136	63	0	3943
17120	78	167	57	3571	0	3873
17121	3574	109	44	132	0	3859
17122	138	58	3516	117	0	3829
17123	108	3528	114	74	0	3824
17124	78	106	95	3030	0	3309
17125	41	3068	48	118	0	3275
17126	67	102	35	2739	0	2943
17127	43	2963	49	108	0	3163
17128	37	96	32	2554	0	2719
17129	2401	65	24	103	0	2593
17130	80	2277	18	70	0	2445
17131	46	62	15	1827	0	1950
17132	1764	48	14	57	0	1883
17133	38	1775	19	45	0	1877
17134	33	1719	18	28	0	1798
17135	39	1745	7	28	0	1819
17136	15	68	32	1574	0	1689
17137	7	40	20	1534	0	1601
17138	18	1490	15	60	0	1583
17139	15	40	24	1460	0	1539
17140	31	52	1493	38	0	1614
17141	8	1536	28	30	0	1602
17142	10	64	17	1375	0	1466
17143	14	1479	17	17	0	1527
17144	11	29	1416	23	0	1479
17145	6	1396	20	13	0	1435
17146	1080	6	27	4	0	1117
17147	9	11	2	1062	0	1084
17148	1069	2	2	10	0	1083
17149	7	5	1081	9	0	1102
17150	11	0	8	1077	0	1096
17151	1	3	1058	12	0	1074
17152	5	0	8	1091	0	1104
17153	1109	0	11	11	0	1131
17154	8	0	4	1141	0	1153
17155	1112	3	3	7	0	1125
17156	7	1143	6	12	0	1168
17157	1132	8	2	3	0	1145
17158	8	15	1107	5	0	1135
17159	14	1135	8	3	0	1160
17160	5	8	10	1163	0	1186
17161	2	10	0	1126	0	1138
17162	0	4	1113	19	0	1136
17163	1	1142	9	11	0	1163
17164	0	7	10	1150	0	1167
17165	1	1183	1	6	0	1191
17166	2	8	1	1152	0	1163
17167	3	1184	1	7	0	1195
17168	1170	5	1	12	0	1188
17169	8	8	1	1226	0	1243
17170	8	1	1208	6	0	1223
17171	0	1199	13	11	0	1223
17172	0	1238	10	2	0	1250
17173	1	16	1225	3	0	1245
17174	8	1249	8	5	0	1270
17175	4	7	6	1181	0	1198
17176	1	7	1220	9	0	1237
17177	2	2	5	1193	0	1202
17178	1	1	7	1220	0	1229
17179	1	7	1189	10	0	1207
17180	1080	3	19	12	0	1114
17181	6	3	6	1215	0	1230
17182	6	1	1291	9	0	1307
17183	5	1290	10	8	0	1313
17184	1291	7	8	4	0	1310
17185	5	1268	1	2	0	1276
17186	8	7	2	1249	0	1266
17187	1187	7	1	7	0	1202
17188	8	1	0	1196	0	1205
17189	7	5	1245	10	0	1267
17190	2	0	8	1196	0	1206
17191	2	7	1214	9	0	1232
17192	1149	0	7	15	0	1171
17193	6	4	1222	1	0	1233
17194	1189	1	9	4	0	1203
17195	1224	2	7	4	0	1237
17196	15	2	1245	5	0	1267
17197	5	4	1256	2	0	1267
17198	4	1279	17	4	0	1304
17199	1359	9	7	7	0	1382
17200	11	8	0	1386	0	1405
17201	9	0	4	1421	0	1434
17202	1556	3	1	22	0	1582
17203	1575	0	3	15	0	1593
17204	1593	1	0	9	0	1603
17205	1606	0	3	4	0	1613
17206	15	3	1	1582	0	1601
17207	1584	3	1	9	0	1597
17208	11	3	1	1613	0	1628
17209	9	1	2	1617	0	1629
17210	3	3	2	1627	0	1635
17211	5	7	1594	16	0	1622
17212	2	1584	8	20	0	1614
17213	2	1626	8	4	0	1640
17214	3	12	5	1608	0	1628
17215	1617	9	0	12	0	1638
17216	9	0	4	1612	0	1625
17217	1587	2	2	13	0	1604
17218	10	4	1614	11	0	1639
17219	1550	4	10	4	0	1568
17220	14	4	6	1639	0	1663
17221	1667	2	2	21	0	1692
17222	1674	1	1	11	0	1687
17223	1760	2	2	12	0	1776
17224	21	1	5	1765	0	1792
17225	8	5	1735	16	0	1764
17226	4	3	13	1732	0	1752
17227	1751	0	10	19	0	1780
17228	18	10	1978	13	0	2019
17229	15	1	12	2072	0	2100
17230	2123	2	10	15	0	2150
17231	16	2	2275	14	0	2307
17232	2279	3	16	6	0	2304
17233	2412	1	13	11	0	2437
17234	33	1	2	2455	0	2491
17235	21	1	2	2609	0	2633
17236	2632	0	2	41	0	2675
17237	22	3	2	2766	0	2793
17238	2689	3	2	31	0	2725
17239	22	2814	7	21	0	2864
17240	20	2779	4	6	0	2809
17241	2	42	2	2710	0	2756
17242	6	23	2789	24	0	2842
17243	2	2796	30	18	0	2846
17244	2720	27	36	9	0	2792
17245	25	2755	4	7	0	2791
17246	17	32	2722	2	0	2773
17247	4	15	25	2694	0	2738
17248	8	8	2757	30	0	2803
17249	3	2881	31	18	0	2933
17250	8	27	16	2801	0	2852
17251	3	2879	6	31	0	2919
17252	9	29	2882	16	0	2936
17253	4	17	27	2872	0	2920
17254	5	9	2903	30	0	2947
17255	5	2	29	2873	0	2909
17256	2912	1	18	31	0	2962
17257	32	10	2887	16	0	2945
17258	2717	4	30	9	0	2760
17259	32	11	2813	6	0	2862
17260	18	4	32	2779	0	2833
17261	6	5	3036	28	0	3075
17262	7	2	29	3004	0	3042
17263	8	3	19	3021	0	3051
17264	7	2	2	2991	0	3002
17265	5	3	2	3025	0	3035
17266	3	7	3302	49	0	3361
17267	3122	2	29	26	0	3179
17268	32	2	16	3431	0	3481
17269	3389	1	2	42	0	3434
17270	3468	2	4	20	0	3494
17271	3509	2	3	12	0	3526
17272	53	3	4	3702	0	3762
17273	33	1	4	3757	0	3795
17274	5	4269	5	46	0	4325
17275	4615	51	4	37	0	4707
17276	4851	31	1	11	0	4894
17277	4856	11	9	15	0	4891
17278	128	18	4990	15	0	5151
17279	61	1	82	4962	0	5106
17280	16	11	5037	80	0	5144
17281	4907	4	86	55	0	5052
17282	5080	5	49	23	0	5157
17283	121	6	16	4992	0	5135
17284	65	4	8	4774	0	4851
17285	22	5096	23	106	0	5247
17286	5151	80	6	74	0	5311
17287	5235	50	4	26	0	5315
17288	123	5172	11	11	0	5317
17289	5213	79	13	14	0	5319
17290	95	49	3	5169	0	5316
17291	63	8	10	5306	0	5387
17292	5231	11	9	131	0	5382
17293	91	12	5230	60	0	5393
17294	5156	5	78	30	0	5269
17295	5303	5	53	17	0	5378
17296	124	5258	26	15	0	5423
17297	5314	76	10	24	0	5424
17298	101	62	5226	6	0	5395
17299	66	15	80	5187	0	5348
17300	5239	5	50	94	0	5388
17301	98	8	14	5239	0	5359
17302	57	11	5072	94	0	5234
17303	23	7	81	4914	0	5025
17304	16	5447	56	89	0	5608
17305	26	79	14	5603	0	5722
17306	23	45	16	5649	0	5733
17307	21	12	9	5661	0	5703
17308	22	8	8	5700	0	5738
17309	12	19	5598	151	0	5780
17310	19	6	79	5648	0	5752
17311	5585	7	55	102	0	5749
17312	96	5549	21	71	0	5737
17313	73	83	12	5669	0	5837
17314	31	58	5659	101	0	5849
17315	19	18	85	5665	0	5787
17316	5681	10	51	106	0	5848
17317	5719	10	23	65	0	5817
17318	5734	2	17	27	0	5780
17319	161	6	10	5691	0	5868
17320	77	11	5657	101	0	5846
17321	36	5615	91	88	0	5830
17322	5726	79	56	33	0	5894
17323	104	49	23	5647	0	5823
17324	82	13	11	5711	0	5817
17325	40	17	5726	131	0	5914
17326	38	5642	83	69	0	5832
17327	33	5808	63	38	0	5942
17328	32	137	25	5472	0	5666
17329	34	61	5398	82	0	5575
17330	4787	23	90	82	0	4982
17331	101	22	5191	33	0	5347
17332	4796	16	84	40	0	4936
17333	90	5423	54	40	0	5607
17334	62	77	5399	31	0	5569
17335	5035	51	84	24	0	5194
17336	97	5296	59	24	0	5476
17337	5598	71	15	43	0	5727
17338	90	59	5669	27	0	5845
17339	64	5662	87	26	0	5839
17340	5734	65	42	31	0	5872
17341	91	49	5702	35	0	5877
17342	5592	15	62	31	0	5700
17343	89	11	46	5725	0	5871
17344	5805	10	26	82	0	5923
17345	95	10	16	5781	0	5902
17346	5725	18	21	85	0	5849
17347	95	18	5759	60	0	5932
17348	58	8	66	5826	0	5958
17349	28	15	42	5807	0	5892
17350	28	18	5688	117	0	5851
17351	22	15	72	5720	0	5829
17352	24	4910	65	88	0	5087
17353	29	68	21	6213	0	6331
17354	25	46	17	6590	0	6678
17355	37	16	11	7345	0	7409
17356	24	22	7268	187	0	7501
17357	6454	22	129	124	0	6729
17358	143	11	83	7537	0	7774
17359	102	23	7726	151	0	8002
17360	7185	7	140	124	0	7456
17361	7701	9	98	42	0	7850
17362	7862	17	27	33	0	7939
17363	248	17	22	7700	0	7987
17364	128	14	15	8757	0	8914
17365	59	21	18	8381	0	8479
17366	34	8374	35	300	0	8743
17367	8372	183	23	161	0	8739
17368	8447	119	35	77	0	8678
17369	300	33	20	8468	0	8821
17370	147	27	8426	200	0	8800
17371	75	22	8502	155	0	8754
17372	33	8043	309	55	0	8440
17373	19	8203	149	81	0	8452
17374	7514	304	30	62	0	7910
17375	151	7392	31	37	0	7611
17376	7423	154	6	30	0	7613
17377	7432	93	9	21	0	7555
17378	7460	24	12	14	0	7510
17379	266	9	4	7302	0	7581
17380	126	7	6	7775	0	7914
17381	8010	5	8	278	0	8301
17382	189	6	6	8312	0	8513
17383	134	20	8177	206	0	8537
17384	8166	9	173	153	0	8501
17385	200	12	122	8199	0	8533
17386	139	9	26	8360	0	8534
17387	46	11	11	8487	0	8555
17388	41	21	8092	360	0	8514
17389	7374	9	191	180	0	7754
17390	201	16	8306	46	0	8569
17391	154	14	210	8082	0	8460
17392	38	26	8383	196	0	8643
17393	32	13	214	8196	0	8455
17394	28	22	138	8356	0	8544
17395	34	27	8421	330	0	8812
17396	64	15	210	7421	0	7710
17397	37	8353	150	193	0	8733
17398	8349	202	31	151	0	8733
17399	8539	139	21	52	0	8751
17400	371	28	14	8371	0	8784
17401	192	17	8503	247	0	8959
17402	55	8231	217	180	0	8683
17403	29	8713	161	59	0	8962
17404	8164	330	46	47	0	8587
17405	230	176	8048	44	0	8498
17406	8106	37	212	58	0	8413
17407	262	14	153	8104	0	8533
17408	176	14	54	8303	0	8547
17409	7911	17	38	377	0	8343
17410	242	7951	50	203	0	8446
17411	183	219	8029	82	0	8513
17412	57	146	233	7941	0	8377
17413	51	49	8218	269	0	8587
17414	51	8057	276	185	0	8569
17415	61	210	167	8052	0	8490
17416	8052	149	65	268	0	8534
17417	8217	42	40	209	0	8508
17418	386	37	7983	73	0	8479
17419	200	8006	234	75	0	8515
17420	7920	214	172	69	0	8375
17421	240	8123	81	62	0	8506
17422	182	244	49	7867	0	8342
17423	7965	163	36	260	0	8424
17424	253	43	40	8116	0	8452
17425	193	38	7910	274	0	8415
17426	94	32	234	8012	0	8372
17427	63	53	7991	285	0	8392
17428	91	24	249	7875	0	8239
17429	7779	34	176	289	0	8278
17430	250	7836	86	204	0	8376
17431	7888	220	125	108	0	8341
17432	273	163	50	7747	0	8233
17433	185	60	47	7776	0	8068
17434	74	58	7150	401	0	7683
17435	82	46	7544	219	0	7891
17436	84	7385	368	100	0	7937
17437	81	226	7146	79	0	7532
17438	6517	158	286	72	0	7033
17439	244	6874	198	86	0	7402
17440	189	7100	76	74	0	7439
17441	81	7191	70	85	0	7427
17442	91	388	52	6878	0	7409
17443	75	202	6961	261	0	7499
17444	70	6960	271	226	0	7527
17445	90	234	186	6121	0	6631
17446	60	7165	96	238	0	7559
17447	6945	249	48	221	0	7463
17448	7091	172	53	99	0	7415
17449	407	66	64	6922	0	7459
17450	239	47	56	7078	0	7420
17451	6540	57	66	395	0	7058
17452	246	6310	68	242	0	6866
17453	186	6440	78	92	0	6796
17454	101	340	36	5871	0	6348
17455	51	151	5192	211	0	5605
17456	49	5036	198	148	0	5431
17457	4860	177	154	65	0	5256
17458	200	4787	76	55	0	5118
17459	130	4771	54	49	0	5004
17460	4527	271	67	36	0	4901
17461	205	4691	39	64	0	4999
17462	145	181	4607	60	0	4993
17463	51	4684	173	57	0	4965
17464	3628	118	108	33	0	3887
17465	100	3695	35	39	0	3869
17466	3638	111	22	40	0	3811
17467	126	85	28	3556	0	3795
17468	100	33	27	3662	0	3822
17469	40	31	3554	171	0	3796
17470	30	3572	98	111	0	3811
17471	33	104	72	3641	0	3850
17472	3601	95	34	109	0	3839
17473	3544	38	26	99	0	3707
17474	163	3552	41	40	0	3796
17475	97	97	24	3492	0	3710
17476	3449	81	22	104	0	3656
17477	3480	38	70	87	0	3675
17478	161	41	3356	32	0	3590
17479	99	37	3231	25	0	3392
17480	29	29	3154	27	0	3239
17481	11	2722	99	20	0	2852
17482	2490	49	49	9	0	2597
17483	45	2528	13	15	0	2601
17484	2525	48	6	14	0	2593
17485	50	2563	10	14	0	2637
17486	55	44	7	2611	0	2717
17487	2633	42	9	51	0	2735
17488	44	16	2625	48	0	2733
17489	2592	8	43	23	0	2666
17490	2643	11	41	12	0	2707
17491	81	2660	12	9	0	2762
17492	38	2593	14	10	0	2655
17493	2591	70	7	9	0	2677
17494	40	53	2658	5	0	2756
17495	2461	8	33	3	0	2505
17496	2499	14	61	7	0	2581
17497	53	29	4	2449	0	2535
17498	2539	2	3	24	0	2568
17499	28	8	0	2633	0	2669
17500	41	5	3	2671	0	2720
17501	7	6	4	2590	0	2607
17502	10	2564	5	50	0	2629
17503	2525	25	4	40	0	2594
17504	2592	28	9	17	0	2646
17505	58	7	5	2571	0	2641
17506	42	4	8	2547	0	2601
17507	11	2608	10	43	0	2672
17508	2596	25	4	34	0	2659
17509	27	37	2621	7	0	2692
17510	41	11	21	2643	0	2716
17511	19	12	2617	22	0	2670
17512	13	5	24	2611	0	2653
17513	11	10	2561	26	0	2608
17514	11	8	23	2495	0	2537
17515	2545	4	31	36	0	2616
17516	29	8	2647	34	0	2718
17517	2559	6	24	11	0	2600
17518	34	2709	33	8	0	2784
17519	38	26	4	2732	0	2800
17520	12	39	5	2808	0	2864
17521	2971	10	2	64	0	3047
17522	29	7	8	3185	0	3229
17523	35	11	3256	29	0	3331
17524	3159	4	20	40	0	3223
17525	3274	6	37	13	0	3330
17526	3315	7	10	10	0	3342
17527	3312	4	5	12	0	3333
17528	55	3254	10	9	0	3328
17529	39	24	5	3260	0	3328
17530	3235	30	5	28	0	3298
17531	25	9	6	3255	0	3295
17532	3227	7	7	35	0	3276
17533	37	8	3170	35	0	3250
17534	41	5	3233	11	0	3290
17535	14	29	46	3047	0	3136
17536	14	3215	33	25	0	3287
17537	11	3281	15	38	0	3345
17538	3189	41	8	15	0	3253
17539	29	31	3191	10	0	3261
17540	2874	10	20	15	0	2919
17541	24	3154	32	6	0	3216
17542	3107	13	8	13	0	3141
17543	27	19	6	3059	0	3111
17544	26	13	3203	21	0	3263
17545	17	5	14	3185	0	3221
17546	18	7	20	3144	0	3189
17547	10	3142	8	40	0	3200
17548	7	3268	10	30	0	3315
17549	14	29	5	3268	0	3316
17550	23	3355	8	19	0	3405
17551	8	21	3295	20	0	3344
17552	16	27	3268	9	0	3320
17553	2937	9	34	13	0	2993
17554	3308	8	22	9	0	3347
17555	35	3303	8	5	0	3351
17556	32	15	6	3283	0	3336
17557	12	21	6	3289	0	3328
17558	14	8	3282	35	0	3339
17559	13	7	15	3102	0	3137
17560	8	3261	21	30	0	3320
17561	7	14	3215	24	0	3260
17562	10	27	3126	8	0	3171
17563	10	3005	38	9	0	3062
17564	15	21	3087	9	0	3132
17565	6	28	20	3018	0	3072
17566	17	13	22	2850	0	2902
17567	11	7	3127	35	0	3180
17568	12	3	19	3054	0	3088
17569	10	3045	24	19	0	3098
17570	8	3160	15	29	0	3212
17571	10	25	7	3079	0	3121
17572	12	26	3170	18	0	3226
17573	2	3291	25	27	0	3345
17574	9	17	26	3250	0	3302
17575	7	17	3253	48	0	3325
17576	2940	7	29	17	0	2993
17577	3290	4	14	12	0	3320
17578	3292	4	5	5	0	3306
17579	30	2	7	3270	0	3309
17580	20	3	2	3229	0	3254
17581	9	8	3362	28	0	3407
17582	4	3	24	3345	0	3376
17583	6	2	15	3535	0	3558
17584	3	14	3483	35	0	3535
17585	2801	3	23	37	0	2864
17586	24	3319	20	5	0	3368
17587	3335	21	5	4	0	3365
17588	22	3318	9	11	0	3360
17589	16	28	2	3292	0	3338
17590	10	23	3290	24	0	3347
17591	3	4	21	3137	0	3165
17592	5	7	3232	25	0	3269
17593	2475	5	30	28	0	2538
17594	21	10	3241	8	0	3280
17595	16	3	40	3092	0	3151
17596	12	12	3238	31	0	3293
17597	6	3248	39	24	0	3317
17598	7	27	20	3314	0	3368
17599	16	15	9	3323	0	3363
17600	16	5	5	3491	0	3517
17601	15	12	3447	73	0	3547
17602	8	15	3544	45	0	3612
17603	11	4	80	3548	0	3643
17604	6	5	44	4331	0	4386
17605	8	2	13	4578	0	4601
17606	4646	8	9	156	0	4819
17607	93	1	10	4802	0	4906
17608	70	18	5004	100	0	5192
17609	5022	9	100	75	0	5206
17610	116	5	77	5211	0	5409
17611	5453	7	13	123	0	5596
17612	5592	5	16	91	0	5704
17613	204	3	14	5628	0	5849
17614	5672	0	22	130	0	5824
17615	5638	5	11	105	0	5759
17616	211	10	5541	25	0	5787
17617	107	5570	140	11	0	5828
17618	29	115	92	5428	0	5664
17619	16	89	22	5694	0	5821
17620	5564	21	14	208	0	5807
17621	5454	12	11	123	0	5600
17622	5485	3	9	44	0	5541
17623	223	13	5136	33	0	5405
17624	109	5198	139	33	0	5479
17625	5194	116	108	22	0	5440
17626	129	5267	32	26	0	5454
17627	5291	128	16	29	0	5464
17628	141	123	9	5184	0	5457
17629	5284	13	9	141	0	5447
17630	5300	10	10	114	0	5434
17631	5380	4	19	41	0	5444
17632	239	19	5254	27	0	5539
17633	5298	4	118	35	0	5455
17634	155	5308	107	30	0	5600
17635	5440	116	20	29	0	5605
17636	5426	94	36	37	0	5593
17637	5549	17	11	35	0	5612
17638	259	11	13	5165	0	5448
17639	137	5301	31	121	0	5590
17640	5318	130	15	112	0	5575
17641	159	107	5348	40	0	5654
17642	126	5432	134	45	0	5737
17643	77	126	106	4872	0	5181
17644	56	5355	26	115	0	5552
17645	5288	132	16	101	0	5537
17646	5455	107	24	38	0	5624
17647	253	33	20	5359	0	5665
17648	151	31	5264	158	0	5604
17649	54	5288	152	129	0	5623
17650	89	143	112	4490	0	4834
17651	77	103	36	5294	0	5510
17652	57	23	35	5543	0	5658
17653	5479	16	24	253	0	5772
17654	5596	19	20	153	0	5788
17655	5656	24	27	53	0	5760
17656	5721	22	23	29	0	5795
17657	294	30	22	5483	0	5829
17658	177	39	5591	169	0	5976
17659	102	20	136	5752	0	6010
17660	92	20	111	5758	0	5981
17661	97	12	32	5809	0	5950
17662	93	22	21	5850	0	5986
17663	5655	26	33	286	0	6000
17664	222	18	45	5729	0	6014
17665	5758	28	33	194	0	6013
17666	5800	26	40	156	0	6022
17667	318	44	5523	70	0	5955
17668	208	33	5515	86	0	5842
17669	137	25	5697	69	0	5928
17670	132	68	244	5386	0	5830
17671	111	35	5571	169	0	5886
17672	94	43	161	5384	0	5682
17673	97	42	123	5489	0	5751
17674	5392	28	39	282	0	5741
17675	213	47	31	5286	0	5577
17676	195	5482	38	174	0	5889
17677	5526	144	26	177	0	5873
17678	213	5588	57	76	0	5934
17679	206	176	5606	52	0	6040
17680	114	5776	158	57	0	6105
17681	5625	173	139	51	0	5988
17682	232	148	37	5544	0	5961
17683	200	57	5444	176	0	5877
17684	5477	46	145	153	0	5821
17685	248	33	122	5492	0	5895
17686	220	49	5453	176	0	5898
17687	123	28	161	5578	0	5890
17688	105	33	137	5616	0	5891
17689	119	45	32	5620	0	5816
17690	96	5531	44	273	0	5944
17691	5681	148	37	166	0	6032
17692	249	134	30	5494	0	5907
17693	196	5602	35	189	0	6022
17694	106	169	30	5588	0	5893
17695	121	150	5489	156	0	5916
17696	90	5479	155	158	0	5882
17697	5481	157	146	64	0	5848
17698	5559	142	35	64	0	5800
17699	259	49	35	5346	0	5689
17700	169	44	36	5339	0	5588
17701	5283	35	32	247	0	5597
17702	5138	36	27	162	0	5363
17703	225	5082	58	66	0	5431
17704	4306	90	23	44	0	4463
17705	115	74	4079	39	0	4307
17706	114	32	4016	30	0	4192
17707	38	3945	144	25	0	4152
17708	26	3842	85	17	0	3970
17709	3576	126	44	27	0	3773
17710	46	3626	23	11	0	3706
17711	3450	43	50	16	0	3559
17712	3373	41	8	12	0	3434
17713	3375	8	7	13	0	3403
17714	83	9	4	3325	0	3421
17715	3361	5	10	47	0	3423
17716	49	9	3229	47	0	3334
17717	50	15	3266	14	0	3345
17718	13	3221	81	20	0	3335
17719	6	44	3288	16	0	3354
17720	11	69	43	3084	0	3207
17721	17	13	3251	41	0	3322
17722	14	12	3197	37	0	3260
17723	10	8	74	3122	0	3214
17724	3161	5	41	49	0	3256
17725	3185	8	7	46	0	3246
17726	73	15	3415	11	0	3514
17727	3309	9	42	16	0	3376
17728	50	16	3496	8	0	3570
17729	3428	7	41	6	0	3482
17730	3654	6	37	15	0	3712
17731	75	4	9	3601	0	3689
17732	46	6	5	3540	0	3597
17733	16	3473	12	89	0	3590
17734	15	3580	12	38	0	3645
17735	25	72	9	3491	0	3597
17736	19	35	6	3564	0	3624
17737	3484	12	8	71	0	3575
17738	47	3477	16	42	0	3582
17739	3463	44	9	16	0	3532
17740	46	3459	17	13	0	3535
17741	48	57	3306	9	0	3420
17742	26	41	40	3243	0	3350
17743	3292	9	41	45	0	3387
17744	3506	10	7	43	0	3566
17745	86	3577	16	11	0	3690
17746	54	3722	20	8	0	3804
17747	11	3831	12	15	0	3869
17748	24	101	12	3861	0	3998
17749	12	57	3903	52	0	4024
17750	11	3860	65	60	0	3996
17751	14	50	61	3781	0	3906
17752	14	57	12	3847	0	3930
17753	11	10	3803	109	0	3933
17754	11	7	3821	66	0	3905
17755	3685	7	109	27	0	3828
17756	60	9	4063	11	0	4143
17757	3980	20	50	13	0	4063
17758	3839	7	64	11	0	3921
17759	3909	3	11	12	0	3935
17760	3897	6	14	14	0	3931
17761	113	13	3715	20	0	3861
17762	74	3767	54	12	0	3907
17763	18	52	62	3753	0	3885
17764	20	70	3780	60	0	3930
17765	20	19	48	3701	0	3788
17766	18	3434	73	56	0	3581
17767	13	48	6	3894	0	3961
17768	22	62	7	3886	0	3977
17769	19	15	8	3896	0	3938
17770	3838	13	5	111	0	3967
17771	62	12	10	3929	0	4013
17772	66	13	17	3920	0	4016
17773	20	13	15	3865	0	3913
17774	11	3741	21	100	0	3873
17775	3658	42	11	72	0	3783
17776	43	3533	20	15	0	3611
17777	59	3539	15	9	0	3622
17778	29	89	12	3548	0	3678
17779	16	65	10	3521	0	3612
17780	3432	10	10	94	0	3546
17781	50	11	8	3564	0	3633
17782	3526	7	13	51	0	3597
17783	4475	7	21	71	0	4574
17784	162	8	13	4499	0	4682
17785	140	10	7	4452	0	4609
17786	20	4516	13	202	0	4751
17787	4635	89	15	127	0	4866
17788	101	4785	17	28	0	4931
17789	4817	107	10	27	0	4961
17790	116	133	4642	19	0	4910
17791	4659	16	100	22	0	4797
17792	4814	16	128	34	0	4992
17793	236	14	15	4666	0	4931
17794	150	21	4689	107	0	4967
17795	29	4731	114	153	0	5027
17796	35	124	127	4858	0	5144
17797	22	143	4843	136	0	5144
17798	33	15	111	4769	0	4928
17799	4592	16	135	130	0	4873
17800	122	24	4630	146	0	4922
17801	140	4558	113	43	0	4854
17802	27	4741	149	55	0	4972
17803	52	229	19	3934	0	4234
17804	24	4816	12	87	0	4939
17805	4733	115	16	108	0	4972
17806	4802	137	8	37	0	4984
17807	4880	27	12	23	0	4942
17808	251	32	4513	17	0	4813
17809	4625	17	106	32	0	4780
17810	127	17	143	4553	0	4840
17811	153	14	14	4648	0	4829
17812	46	15	15	4781	0	4857
17813	31	10	32	4763	0	4836
17814	28	29	4500	257	0	4814
17815	25	26	4528	165	0	4744
17816	27	20	4605	47	0	4699
17817	4179	16	251	35	0	4481
17818	125	4417	147	40	0	4729
17819	157	116	23	4365	0	4661
17820	4361	142	28	122	0	4653
17821	142	4384	25	152	0	4703
17822	156	4538	33	37	0	4764
17823	4451	246	22	32	0	4751
17824	4542	153	18	26	0	4739
17825	251	4501	11	35	0	4798
17826	169	127	11	3963	0	4270
17827	38	4379	29	121	0	4567
17828	4229	121	24	142	0	4516
17829	4285	143	16	35	0	4479
17830	4235	34	17	45	0	4331
17831	263	4011	22	45	0	4341
17832	173	123	14	4074	0	4384
17833	45	144	4008	143	0	4340
17834	41	37	127	4084	0	4289
17835	59	29	139	4131	0	4358
17836	50	31	3983	261	0	4325
17837	3922	21	123	166	0	4232
17838	141	29	143	4042	0	4355
17839	166	23	22	4012	0	4223
17840	42	4031	29	259	0	4361
17841	4064	130	25	150	0	4369
17842	150	147	19	3989	0	4305
17843	174	4018	27	136	0	4355
17844	3773	123	22	151	0	4069
17845	125	3820	34	46	0	4025
17846	3600	119	20	30	0	3769
17847	131	122	3467	39	0	3759
17848	119	32	3362	31	0	3544
17849	45	26	3349	27	0	3447
17850	31	3190	222	34	0	3477
17851	33	108	131	2820	0	3092
17852	35	3205	31	87	0	3358
17853	3133	109	19	113	0	3374
17854	123	118	3106	25	0	3372
17855	3056	38	97	28	0	3219
17856	3059	24	113	30	0	3226
17857	218	19	29	2979	0	3245
17858	3097	24	16	106	0	3243
17859	126	22	18	3085	0	3251
17860	129	24	2966	111	0	3230
17861	2877	24	98	124	0	3123
17862	102	2971	128	31	0	3232
17863	128	98	25	2977	0	3228
17864	2944	123	14	102	0	3183
17865	121	30	15	3022	0	3188
17866	137	23	2837	107	0	3104
17867	35	21	95	2877	0	3028
17868	31	2870	117	103	0	3121
17869	2847	93	22	117	0	3079
17870	113	116	20	2788	0	3037
17871	2888	17	13	122	0	3040
17872	115	17	15	2861	0	3008
17873	125	20	18	2696	0	2859
17874	38	2775	25	184	0	3022
17875	2745	93	13	124	0	2975
17876	105	2955	21	35	0	3116
17877	114	105	8	2534	0	2761
17878	30	2750	21	91	0	2892
17879	2652	96	17	93	0	2858
17880	2675	110	13	33	0	2831
17881	2692	19	11	29	0	2751
17882	179	2535	18	17	0	2749
17883	48	1593	6	10	0	1657
17884	1561	62	7	7	0	1637
17885	36	1604	4	13	0	1657
17886	40	47	4	1514	0	1605
17887	10	35	1439	29	0	1513
17888	1281	4	35	29	0	1349
17889	1352	7	21	7	0	1387
17890	1359	3	2	7	0	1371
17891	46	1322	7	7	0	1382
17892	1276	23	1	2	0	1302
17893	29	21	1264	4	0	1318
17894	23	1277	22	3	0	1325
17895	7	26	13	1035	0	1081
17896	6	1094	6	7	0	1113
17897	1024	6	3	15	0	1048
17898	6	1111	1	3	0	1121
17899	12	8	2	1074	0	1096
17900	2	1131	0	5	0	1138
17901	3	5	1	1195	0	1204
17902	4	11	1	1144	0	1160
17903	3	7	1173	14	0	1197
17904	2	1	6	1135	0	1144
17905	1115	4	11	10	0	1140
17906	1092	2	3	13	0	1110
17907	18	2	1	1118	0	1139
17908	19	3	1091	10	0	1123
17909	3	1	7	1098	0	1109
17910	1097	0	11	11	0	1119
17911	1209	1	4	17	0	1231
17912	1222	0	1	6	0	1229
17913	16	1337	6	2	0	1361
17914	1375	6	1	7	0	1389
17915	9	13	1391	0	0	1413
17916	1519	2	10	10	0	1541
17917	12	4	12	1607	0	1635
17918	17	0	2	1611	0	1630
17919	3	3	1	1643	0	1650
17920	1586	1	1	29	0	1617
17921	1560	3	2	20	0	1585
17922	28	1	1	1567	0	1597
17923	17	5	1606	12	0	1640
17924	4	1	9	1624	0	1638
17925	3	0	15	1611	0	1629
17926	2	4	1575	29	0	1610
17927	1	1556	11	17	0	1585
17928	4	9	16	1619	0	1648
17929	1611	17	3	13	0	1644
17930	11	3	1	1636	0	1651
17931	19	5	1	1658	0	1683
17932	1643	1	1	32	0	1677
17933	13	1624	7	19	0	1663
17934	19	1660	2	7	0	1688
17935	1636	27	2	5	0	1670
17936	14	21	1642	3	0	1680
17937	1514	7	10	6	0	1537
17938	21	7	1739	1	0	1768
17939	20	1758	16	4	0	1798
17940	1761	11	17	12	0	1801
17941	1784	18	3	8	0	1813
17942	1821	1	3	4	0	1829
17943	1834	3	0	5	0	1842
17944	33	8	1844	1	0	1886
17945	22	4	10	1829	0	1865
17946	1829	1	19	45	0	1894
17947	18	6	1994	23	0	2041
17948	28	6	1996	3	0	2033
17949	4	1952	24	1	0	1981
17950	1957	9	13	0	0	1979
17951	10	15	2	1932	0	1959
17952	2026	1	3	13	0	2043
17953	15	2006	5	17	0	2043
17954	19	16	3	2157	0	2195
17955	5	15	1	2186	0	2207
17956	2	3	0	2193	0	2198
17957	2	3	2220	43	0	2268
17958	2	2213	22	30	0	2267
17959	2405	15	22	3	0	2445
17960	20	24	1	2400	0	2445
17961	2417	2	1	24	0	2444
17962	2357	2	2	30	0	2391
17963	53	1	1	2369	0	2424
17964	31	7	2407	24	0	2469
17965	7	0	23	2408	0	2438
17966	2	2457	36	22	0	2517
17967	5	21	3	2523	0	2552
17968	0	29	2432	82	0	2543
17969	2402	2	21	33	0	2458
17970	22	3	28	2531	0	2584
17971	2541	1	3	26	0	2571
17972	28	4	2539	28	0	2599
17973	2338	3	21	14	0	2376
17974	26	5	2540	5	0	2576
17975	2355	5	21	12	0	2393
17976	22	2422	30	6	0	2480
17977	26	2613	11	5	0	2655
17978	8	47	1	2587	0	2643
17979	15	30	1	2488	0	2534
17980	6	3	1	2650	0	2660
17981	2601	2	3	49	0	2655
17982	27	2	0	2642	0	2671
17983	32	10	2600	30	0	2672
17984	2468	2	26	41	0	2537
17985	22	2658	36	11	0	2727
17986	2715	20	3	12	0	2750
17987	2615	28	8	16	0	2667
17988	54	7	2735	3	0	2799
17989	36	3	26	2638	0	2703
17990	9	3	27	2798	0	2837
17991	11	8	2814	52	0	2885
17992	12	2802	29	36	0	2879
17993	2782	21	32	9	0	2844
17994	2805	33	3	11	0	2852
17995	60	5	6	2905	0	2976
17996	37	3	6	2912	0	2958
17997	11	4	8	3064	0	3087
17998	2945	6	6	66	0	3023
17999	31	3044	7	45	0	3127
18000	3046	29	7	16	0	3098
18001	2969	38	6	11	0	3024
18002	76	12	3123	13	0	3224
18003	54	6	35	2975	0	3070
18004	14	3165	44	35	0	3258
18005	15	34	12	3231	0	3292
18006	14	40	6	3372	0	3432
18007	12	14	3472	76	0	3574
18008	3564	4	44	50	0	3662
18009	3903	9	47	24	0	3983
18010	4067	2	8	16	0	4093
18011	111	4	9	3927	0	4051
18012	71	7	7	3735	0	3820
18013	19	3793	18	121	0	3951
18014	9	3966	10	77	0	4062
18015	3904	103	6	22	0	4035
18016	52	3840	12	17	0	3921
18017	65	63	3834	9	0	3971
18018	28	60	54	3872	0	4014
18019	3984	9	61	71	0	4125
18020	76	11	3968	64	0	4119
18021	73	16	3918	18	0	4025
18022	3957	6	111	20	0	4094
18023	3981	7	68	17	0	4073
18024	120	12	14	3939	0	4085
18025	71	19	3934	60	0	4084
18026	24	9	56	4009	0	4098
18027	25	23	3935	66	0	4049
18028	18	11	4000	70	0	4099
18029	10	4028	106	40	0	4184
18030	4107	52	64	23	0	4246
18031	4082	61	19	24	0	4186
18032	119	4050	24	12	0	4205
18033	94	80	12	4021	0	4207
18034	37	64	13	4091	0	4205
18035	30	19	6	4210	0	4265
18036	4110	18	12	123	0	4263
18037	62	4101	25	88	0	4276
18038	4077	58	12	33	0	4180
18039	4028	59	21	20	0	4128
18040	121	25	3955	13	0	4114
18041	81	3942	71	15	0	4109
18042	45	61	63	3992	0	4161
18043	28	68	4010	65	0	4171
18044	3832	13	66	87	0	3998
18045	4003	10	65	33	0	4111
18046	4043	12	21	33	0	4109
18047	3955	4	21	17	0	3997
18048	131	15	16	3817	0	3979
18049	87	22	3802	62	0	3973
18050	41	13	61	3857	0	3972
18051	3812	12	68	73	0	3965
18052	3781	14	17	75	0	3887
18053	102	3824	29	35	0	3990
18054	3789	48	22	23	0	3882
18055	75	61	3720	22	0	3878
18056	76	18	3716	18	0	3828
18057	3614	14	90	24	0	3742
18058	74	3710	60	13	0	3857
18059	70	44	12	3435	0	3561
18060	25	3614	24	53	0	3716
18061	34	56	7	3632	0	3729
18062	33	40	10	3662	0	3745
18063	32	17	9	3831	0	3889
18064	3730	18	6	93	0	3847
18065	3793	25	11	54	0	3883
18066	3757	16	18	19	0	3810
18067	106	18	3653	17	0	3794
18068	3532	7	64	27	0	3630
18069	74	16	62	3726	0	3878
18070	77	11	18	3903	0	4009
18071	34	17	3904	104	0	4059
18072	35	9	70	4141	0	4255
18073	4270	12	62	88	0	4432
18074	84	13	4258	81	0	4436
18075	90	6	82	4252	0	4430
18076	4308	10	76	93	0	4487
18077	4208	12	24	81	0	4325
18078	148	19	4203	22	0	4392
18079	94	21	4232	25	0	4372
18080	44	16	133	4200	0	4393
18081	4280	14	77	98	0	4469
18082	4400	16	27	81	0	4524
18083	156	18	18	4098	0	4290
18084	96	4375	29	84	0	4584
18085	4340	73	21	87	0	4521
18086	96	4390	22	40	0	4548
18087	90	79	16	4415	0	4600
18088	45	79	4330	93	0	4547
18089	37	28	4278	86	0	4429
18090	42	17	4371	23	0	4453
18091	46	12	155	4136	0	4349
18092	40	13	83	4232	0	4368
18093	4211	13	31	139	0	4394
18094	102	4140	27	145	0	4414
18095	4258	80	20	41	0	4399
18096	117	65	18	3842	0	4042
18097	95	4076	26	85	0	4282
18098	42	4217	21	82	0	4362
18099	43	125	22	4095	0	4285
18100	4120	65	34	94	0	4313
18101	99	4091	31	75	0	4296
18102	3916	68	17	29	0	4030
18103	84	3950	22	31	0	4087
18104	3868	73	20	29	0	3990
18105	91	67	3770	25	0	3953
18106	93	22	3703	36	0	3854
18107	30	3587	130	18	0	3765
18108	3193	58	97	45	0	3393
18109	66	3117	14	18	0	3215
18110	48	2955	16	13	0	3032
18111	35	83	9	2881	0	3008
18112	2883	44	13	52	0	2992
18113	57	3012	14	41	0	3124
18114	2996	43	11	17	0	3067
18115	54	2995	8	10	0	3067
18116	2864	42	7	14	0	2927
18117	45	2845	10	17	0	2917
18118	41	2873	12	10	0	2936
18119	11	68	5	2677	0	2761
18120	13	2834	11	37	0	2895
18121	2766	37	7	41	0	2851
18122	44	39	2736	9	0	2828
18123	41	10	42	2740	0	2833
18124	13	15	2823	47	0	2898
18125	10	8	44	2758	0	2820
18126	14	8	40	2786	0	2848
18127	11	9	2645	77	0	2742
18128	2260	8	41	46	0	2355
18129	46	2610	43	12	0	2711
18130	2614	43	8	26	0	2691
18131	49	2617	17	57	0	2740
18132	49	42	7	2633	0	2731
18133	2660	44	11	45	0	2760
18134	2692	10	16	38	0	2756
18135	2707	15	12	17	0	2751
18136	82	18	12	2604	0	2716
18137	58	12	17	2589	0	2676
18138	22	2704	17	74	0	2817
18139	2741	46	9	45	0	2841
18140	2794	44	8	18	0	2864
18141	2778	14	12	22	0	2826
18142	2671	17	12	16	0	2716
18143	85	2605	18	15	0	2723
18144	54	47	17	2626	0	2744
18145	24	53	2660	45	0	2782
18146	2561	19	41	51	0	2672
18147	2744	19	38	18	0	2819
18148	86	24	2681	17	0	2808
18149	57	23	2702	13	0	2795
18150	24	20	80	2605	0	2729
18151	29	13	46	2725	0	2813
18152	19	24	10	2783	0	2836
18153	2642	19	15	80	0	2756
18154	49	21	13	2651	0	2734
18155	52	20	2619	56	0	2747
18156	18	21	49	2698	0	2786
18157	20	22	2697	57	0	2796
18158	16	19	46	2668	0	2749
18159	22	16	46	2887	0	2971
18160	18	18	2841	90	0	2967
18161	2584	22	48	61	0	2715
18162	61	2881	54	19	0	3015
18163	2949	62	9	13	0	3033
18164	69	63	6	2997	0	3135
18165	3019	21	8	63	0	3111
18166	67	3282	6	64	0	3419
18167	65	3443	9	21	0	3538
18168	24	122	8	3592	0	3746
18169	28	72	3889	74	0	4063
18170	22	33	3821	67	0	3943
18171	17	3787	152	25	0	3981
18172	3245	73	64	11	0	3393
18173	56	57	15	3247	0	3375
18174	3269	11	15	69	0	3364
18175	68	3239	22	54	0	3383
18176	65	3306	17	9	0	3397
18177	17	123	6	3323	0	3469
18178	3379	62	5	66	0	3512
18179	3396	18	4	77	0	3495
18180	123	28	3360	14	0	3525
18181	65	18	3266	20	0	3369
18182	3191	14	110	9	0	3324
18183	68	3314	62	16	0	3460
18184	3322	58	17	9	0	3406
18185	85	61	14	3240	0	3400
18186	67	18	3232	60	0	3377
18187	3002	13	64	66	0	3145
18188	67	3147	59	17	0	3290
18189	62	3272	19	11	0	3364
18190	20	112	17	3213	0	3362
18191	3266	61	12	72	0	3411
18192	74	15	16	3303	0	3408
18193	3357	18	10	80	0	3465
18194	84	24	3255	65	0	3428
18195	3227	20	60	27	0	3334
18196	3291	15	51	26	0	3383
18197	138	18	3112	23	0	3291
18198	3071	11	67	13	0	3162
18199	92	3098	67	15	0	3272
18200	75	68	27	2953	0	3123
18201	40	3154	23	57	0	3274
18202	3130	74	11	59	0	3274
18203	81	70	19	3067	0	3237
18204	78	3101	15	69	0	3263
18205	27	91	7	3087	0	3212
18206	30	3163	19	78	0	3290
18207	27	85	8	3195	0	3315
18208	3134	78	11	81	0	3304
18209	68	32	12	3189	0	3301
18210	72	34	3079	90	0	3275
18211	3019	16	61	86	0	3182
18212	83	21	60	3076	0	3240
18213	85	18	2929	86	0	3118
18214	33	22	2822	77	0	2954
18215	40	11	2992	34	0	3077
18216	26	10	131	2849	0	3016
18217	32	13	85	2950	0	3080
18218	30	18	34	3003	0	3085
18219	20	12	39	3025	0	3096
18220	2927	7	31	142	0	3107
18221	3027	19	21	90	0	3157
18222	3095	14	14	50	0	3173
18223	3177	15	17	41	0	3250
18224	157	12	9	3036	0	3214
18225	104	27	3053	84	0	3268
18226	3047	27	66	77	0	3217
18227	3249	19	60	37	0	3365
18228	150	23	17	3166	0	3356
18229	95	13	20	3227	0	3355
18230	3235	15	18	139	0	3407
18231	100	13	19	3077	0	3209
18232	88	3072	23	97	0	3280
18233	3147	65	20	84	0	3316
18234	3133	60	18	43	0	3254
18235	125	30	3282	38	0	3475
18236	92	20	71	3287	0	3470
18237	51	11	70	3359	0	3491
18238	3317	18	29	136	0	3500
18239	3369	15	21	84	0	3489
18240	145	13	16	3362	0	3536
18241	93	15	3333	98	0	3539
18242	50	20	3328	90	0	3488
18243	50	10	117	3358	0	3535
18244	43	6	76	3421	0	3546
18245	3273	8	34	137	0	3452
18246	89	3203	28	99	0	3419
18247	74	3168	28	41	0	3311
18248	32	3322	34	34	0	3422
18249	58	119	15	3306	0	3498
18250	3303	71	10	90	0	3474
18251	3302	25	10	77	0	3414
18252	125	3300	13	33	0	3471
18253	3352	71	9	30	0	3462
18254	93	68	8	3294	0	3463
18255	84	29	3222	87	0	3422
18256	47	18	56	3230	0	3351
18257	35	12	63	3236	0	3346
18258	41	19	12	3245	0	3317
18259	3009	8	16	127	0	3160
18260	71	6	14	2951	0	3042
18261	63	2921	25	80	0	3089
18262	2829	51	31	85	0	2996
18263	63	2750	15	45	0	2873
18264	53	2589	19	33	0	2694
18265	23	2653	20	20	0	2716
18266	22	71	2251	29	0	2373
18267	12	2189	72	13	0	2286
18268	8	31	1886	9	0	1934
18269	1622	14	29	11	0	1676
18270	1644	4	8	8	0	1664
18271	22	3	1720	1	0	1746
18272	1628	3	10	9	0	1650
18273	1751	2	11	8	0	1772
18274	15	6	1817	8	0	1846
18275	12	1865	9	7	0	1893
18276	8	9	8	1842	0	1867
18277	1879	10	0	20	0	1909
18278	27	5	3	1849	0	1884
18279	1979	4	1	15	0	1999
18280	1978	3	1	14	0	1996
18281	24	7	2009	4	0	2044
18282	1950	1	10	11	0	1972
18283	13	2061	11	3	0	2088
18284	2079	9	2	11	0	2101
18285	15	12	3	2070	0	2100
18286	16	1	2070	17	0	2104
18287	7	3	10	2034	0	2054
18288	2027	2	13	13	0	2055
18289	11	2033	1	20	0	2065
18290	15	10	2053	8	0	2086
18291	8	11	10	1967	0	1996
18292	8	6	2063	19	0	2096
18293	7	2101	11	14	0	2133
18294	2055	9	13	20	0	2097
18295	18	12	4	2082	0	2116
18296	18	6	2128	16	0	2168
18297	5	6	2055	18	0	2084
18298	2118	2	20	9	0	2149
18299	17	4	13	2217	0	2251
18300	15	6	5	2227	0	2253
18301	9	9	2230	24	0	2272
18302	6	8	2219	17	0	2250
18303	11	2361	23	10	0	2405
18304	8	13	13	2364	0	2398
18305	7	13	9	2318	0	2347
18306	13	2355	11	16	0	2395
18307	7	17	2328	14	0	2366
18308	2158	11	15	10	0	2194
18309	19	6	9	2356	0	2390
18310	20	6	2418	14	0	2458
18311	9	6	11	2289	0	2315
18312	7	2406	14	17	0	2444
18313	17	15	2375	18	0	2425
18314	2165	13	12	14	0	2204
18315	17	11	2455	9	0	2492
18316	17	12	2405	8	0	2442
18317	3	8	2326	13	0	2350
18318	2	5	2493	9	0	2509
18319	8	3	34	2431	0	2476
18320	8	6	2597	24	0	2635
18321	11	3	20	2441	0	2475
18322	6	2591	23	19	0	2639
18323	2773	19	7	27	0	2826
18324	33	26	6	2888	0	2953
18325	32	9	2921	30	0	2992
18326	7	2926	31	44	0	3008
18327	7	25	33	2854	0	2919
18328	2832	33	7	35	0	2907
18329	27	2955	5	29	0	3016
18330	33	27	2	2947	0	3009
18331	2986	32	6	32	0	3056
18332	33	10	2981	34	0	3058
18333	2944	10	30	13	0	2997
18334	38	6	3050	7	0	3101
18335	2735	3	29	3	0	2770
18336	2756	4	36	4	0	2800
18337	57	5	2792	6	0	2860
18338	33	2750	34	0	0	2817
18339	14	28	23	2641	0	2706
18340	3	33	2806	26	0	2868
18341	7	4	28	2733	0	2772
18342	10	4	28	2858	0	2900
18343	3	5	2889	60	0	2957
18344	13	9	2846	37	0	2905
18345	5	2	58	2826	0	2891
18346	2871	1	37	35	0	2944
18347	30	2842	15	35	0	2922
18348	32	2929	3	11	0	2975
18349	2858	54	1	13	0	2926
18350	3080	38	2	10	0	3130
18351	60	8	6	3172	0	3246
18352	42	4	3	3214	0	3263
18353	10	5	4	3263	0	3282
18354	3165	2	3	67	0	3237
18355	32	3113	9	48	0	3202
18356	35	3214	9	10	0	3268
18357	15	50	3	3194	0	3262
18358	8	36	5	3247	0	3296
18359	9	9	4	3288	0	3310
18360	3217	7	4	74	0	3302
18361	28	3280	6	58	0	3372
18362	3314	29	6	19	0	3368
18363	36	45	3287	9	0	3377
18364	38	3379	35	5	0	3457
18365	16	31	39	3255	0	3341
18366	3192	37	11	37	0	3277
18367	36	10	3299	41	0	3386
18368	46	8	3354	14	0	3422
18369	19	10	69	3319	0	3417
18370	9	4	50	3383	0	3446
18371	7	4	13	3363	0	3387
18372	9	8	4	3311	0	3332
18373	8	3	2	3296	0	3309
18374	7	3165	8	86	0	3266
18375	7	30	5	3189	0	3231
18376	3130	45	29	46	0	3250
18377	35	3167	11	45	0	3258
18378	3177	33	5	19	0	3234
18379	43	50	3096	14	0	3203
18380	44	19	3081	10	0	3154
18381	16	6	74	3087	0	3183
18382	7	13	4033	49	0	4102
18383	11	4	82	3994	0	4091
18384	11	8	80	4012	0	4111
18385	4024	5	21	157	0	4207
18386	3998	7	13	96	0	4114
18387	152	4154	13	36	0	4355
18388	89	4302	11	19	0	4421
18389	20	159	8	4221	0	4408
18390	4286	95	11	92	0	4484
18391	95	24	4389	89	0	4597
18392	89	11	95	4414	0	4609
18393	26	9	88	4444	0	4567
18394	15	21	4356	194	0	4586
18395	11	4330	109	129	0	4579
18396	21	93	92	4267	0	4473
18397	12	104	4346	118	0	4580
18398	27	24	96	4341	0	4488
18399	4074	14	95	120	0	4303
18400	99	4137	33	110	0	4379
18401	97	4272	20	32	0	4421
18402	31	174	18	4165	0	4388
18403	4016	104	16	114	0	4250
18404	95	4088	20	118	0	4321
18405	4157	97	19	45	0	4318
18406	115	106	4138	39	0	4398
18407	107	34	4235	41	0	4417
18408	50	26	195	3969	0	4240
18409	44	13	115	4319	0	4491
18410	4226	22	35	212	0	4495
18411	129	24	19	4288	0	4460
18412	120	24	4190	136	0	4470
18413	36	25	109	4209	0	4379
18414	42	17	114	4291	0	4464
18415	17	20	4126	233	0	4396
18416	3891	18	117	146	0	4172
18417	121	21	117	4160	0	4419
18418	4061	17	35	137	0	4250
18419	109	3933	33	131	0	4206
18420	3925	98	50	47	0	4120
18421	109	3959	28	39	0	4135
18422	92	3919	25	49	0	4085
18423	91	179	42	3489	0	3801
18424	3474	105	33	113	0	3725
18425	3552	28	12	106	0	3698
18426	173	32	13	3515	0	3733
18427	3598	29	18	110	0	3755
18428	3572	21	23	105	0	3721
18429	199	23	24	3434	0	3680
18430	3357	34	30	112	0	3533
18431	126	3336	30	118	0	3610
18432	3394	97	29	56	0	3576
18433	124	96	3334	46	0	3600
18434	3458	27	97	60	0	3642
18435	120	19	100	3443	0	3682
18436	114	17	42	3512	0	3685
18437	38	21	35	3573	0	3667
18438	48	14	32	3553	0	3647
18439	40	19	43	3478	0	3580
18440	37	3193	39	219	0	3488
18441	41	3351	34	134	0	3560
18442	3266	165	29	54	0	3514
18443	117	114	3202	47	0	3480
18444	3156	44	97	50	0	3347
18445	131	54	3239	42	0	3466
18446	115	41	103	3185	0	3444
18447	75	35	89	3310	0	3509
18448	3127	33	29	193	0	3382
18449	127	43	3128	127	0	3425
18450	138	27	95	3045	0	3305
18451	73	29	3063	138	0	3303
18452	67	3073	102	125	0	3367
18453	69	104	99	3134	0	3406
18454	3146	99	40	134	0	3419
18455	3148	33	28	135	0	3344
18456	3152	28	28	64	0	3272
18457	204	3095	47	63	0	3409
18458	143	3192	32	58	0	3425
18459	2760	167	39	90	0	3056
18460	116	3122	45	76	0	3359
18461	105	3128	27	73	0	3333
18462	56	178	3025	81	0	3340
18463	46	3031	106	59	0	3242
18464	41	3026	105	50	0	3222
18465	46	178	25	2961	0	3210
18466	55	111	2976	116	0	3258
18467	53	57	2931	98	0	3139
18468	2749	32	172	55	0	3008
18469	135	27	2939	43	0	3144
18470	3037	24	112	61	0	3234
18471	128	22	102	2955	0	3207
18472	128	3031	44	124	0	3327
18473	3162	95	31	115	0	3403
18474	3318	94	32	63	0	3507
18475	189	30	36	3276	0	3531
18476	128	35	27	3292	0	3482
18477	80	16	25	3343	0	3464
18478	3158	25	29	188	0	3400
18479	3057	27	22	124	0	3230
18480	3209	28	12	61	0	3310
18481	202	2965	17	50	0	3234
18482	1991	48	7	18	0	2064
18483	53	1950	12	17	0	2032
18484	43	1940	12	12	0	2007
18485	11	90	8	1754	0	1863
18486	9	1819	10	32	0	1870
18487	1756	36	7	31	0	1830
18488	34	37	6	1727	0	1804
18489	1729	7	7	32	0	1775
18490	32	1663	11	32	0	1738
18491	26	1746	9	10	0	1791
18492	1762	48	6	11	0	1827
18493	35	1790	14	9	0	1848
18494	34	29	6	1780	0	1849
18495	10	25	3	1817	0	1855
18496	1824	9	8	52	0	1893
18497	42	6	5	1806	0	1859
18498	32	12	1834	35	0	1913
18499	14	10	28	1878	0	1930
18500	1884	4	30	37	0	1955
18501	40	1882	6	34	0	1962
18502	1997	38	7	7	0	2049
18503	2017	33	5	13	0	2068
18504	2101	4	4	9	0	2118
18505	70	14	2095	9	0	2188
18506	37	11	2022	8	0	2078
18507	1904	6	54	7	0	1971
18508	38	2062	26	5	0	2131
18509	26	30	25	2081	0	2162
18510	6	28	5	2059	0	2098
18511	4	2063	8	49	0	2124
18512	8	2142	9	22	0	2181
18513	4	48	3	2135	0	2190
18514	3	24	2	2177	0	2206
18515	7	6	2131	46	0	2190
18516	7	7	2036	26	0	2076
18517	2028	7	49	8	0	2092
18518	2167	2	26	7	0	2202
18519	52	6	5	2174	0	2237
18520	27	6	2178	30	0	2241
18521	11	3	27	2168	0	2209
18522	2130	8	24	32	0	2194
18523	33	7	2195	30	0	2265
18524	33	6	28	2285	0	2352
18525	13	6	2310	31	0	2360
18526	8	2232	32	32	0	2304
18527	11	30	2283	13	0	2337
18528	8	28	26	2217	0	2279
18529	2287	8	24	27	0	2346
18530	35	6	4	2354	0	2399
18531	2402	7	7	31	0	2447
18532	2434	7	9	31	0	2481
18533	2365	6	6	12	0	2389
18534	57	12	2280	5	0	2354
18535	2327	6	25	13	0	2371
18536	35	7	28	2362	0	2432
18537	30	3	9	2384	0	2426
18538	15	10	2345	51	0	2421
18539	9	8	29	2384	0	2430
18540	2437	4	22	40	0	2503
18541	29	2495	13	34	0	2571
18542	2542	29	4	15	0	2590
18543	2566	24	7	12	0	2609
18544	2588	11	5	15	0	2619
18545	57	6	6	2524	0	2593
18546	30	13	2495	32	0	2570
18547	21	7	28	2578	0	2634
18548	12	2	27	2619	0	2660
18549	2598	1	15	58	0	2672
18550	2531	1	8	38	0	2578
18551	55	10	2464	10	0	2539
18552	29	8	26	2446	0	2509
18553	14	5	2484	38	0	2541
18554	2427	4	33	40	0	2504
18555	38	2874	50	9	0	2971
18556	2884	35	12	16	0	2947
18557	44	2996	14	17	0	3071
18558	3008	34	15	17	0	3074
18559	42	3100	15	11	0	3168
18560	46	39	10	3108	0	3203
18561	23	35	5	3242	0	3305
18562	3271	5	6	79	0	3361
18563	3276	2	6	53	0	3337
18564	3292	3	13	15	0	3323
18565	3217	4	10	18	0	3249
18566	3278	6	10	15	0	3309
18567	88	7	8	3158	0	3261
18568	51	3168	13	44	0	3276
18569	18	41	7	3124	0	3190
18570	16	3087	11	46	0	3160
18571	20	41	8	2970	0	3039
18572	17	3008	10	49	0	3084
18573	19	39	7	3010	0	3075
18574	23	34	2888	43	0	2988
18575	2694	7	37	46	0	2784
18576	55	2891	35	17	0	2998
18577	2960	42	12	8	0	3022
18578	58	35	2918	20	0	3031
18579	2835	11	48	20	0	2914
18580	62	11	3196	21	0	3290
18581	52	16	51	3177	0	3296
18582	24	3386	53	54	0	3517
18583	27	55	3439	49	0	3570
18584	24	45	53	3437	0	3559
18585	3294	13	51	60	0	3418
18586	75	12	12	3526	0	3625
18587	62	8	6	3545	0	3621
18588	31	11	2	3603	0	3647
18589	23	12	3413	102	0	3550
18590	23	14	50	3379	0	3466
18591	14	3330	48	65	0	3457
18592	20	52	9	3386	0	3467
18593	30	45	8	3405	0	3488
18594	3304	11	7	93	0	3415
18595	66	8	4	3455	0	3533
18596	58	11	3447	56	0	3572
18597	26	7	3452	60	0	3545
18598	18	9	3497	20	0	3544
18599	12	3437	94	21	0	3564
18600	3405	53	51	18	0	3527
18601	54	3448	16	14	0	3532
18602	3406	51	11	15	0	3483
18603	57	53	5	3282	0	3397
18604	62	11	3331	55	0	3459
18605	16	13	3209	57	0	3295
18606	13	3373	102	13	0	3501
18607	13	52	58	3359	0	3482
18608	15	51	14	3359	0	3439
18609	16	10	9	3415	0	3450
18610	9	19	3319	103	0	3450
18611	2926	5	60	83	0	3074
18612	63	14	3390	23	0	3490
18613	68	8	65	3280	0	3421
18614	13	5	60	3425	0	3503
18615	20	15	3327	123	0	3485
18616	2996	5	73	81	0	3155
18617	66	3324	63	30	0	3483
18618	3376	63	9	28	0	3476
18619	72	60	17	3179	0	3328
18620	57	3345	19	69	0	3490
18621	20	63	13	3404	0	3500
18622	3355	59	20	77	0	3511
18623	65	17	13	3371	0	3466
18624	67	16	3285	82	0	3450
18625	3201	10	68	82	0	3361
18626	3341	10	60	33	0	3444
18627	130	20	3298	17	0	3465
18628	80	8	65	3284	0	3437
18629	3329	9	76	69	0	3483
18630	78	8	16	3324	0	3426
18631	70	9	26	3272	0	3377
18632	20	13	17	3324	0	3374
18633	28	14	13	3336	0	3391
18634	11	16	3298	136	0	3461
18635	21	7	70	3300	0	3398
18636	20	11	3275	88	0	3394
18637	3102	13	78	91	0	3284
18638	3318	7	69	33	0	3427
18639	3333	12	17	31	0	3393
18640	3318	5	20	39	0	3382
18641	134	12	18	3153	0	3317
18642	3181	9	18	79	0	3287
18643	75	6	3079	69	0	3229
18644	73	17	3087	31	0	3208
18645	2890	6	125	31	0	3052
18646	77	3016	80	29	0	3202
18647	68	3130	29	28	0	3255
18648	21	102	23	3074	0	3220
18649	27	61	3066	72	0	3226
18650	2779	18	66	93	0	2956
18651	73	15	3118	29	0	3235
18652	69	2944	68	31	0	3112
18653	30	53	3004	31	0	3118
18654	18	2883	65	28	0	2994
18655	2400	49	77	30	0	2556
18656	54	2457	17	28	0	2556
18657	54	2348	18	25	0	2445
18658	23	74	25	2329	0	2451
18659	27	50	2350	58	0	2485
18660	15	11	55	2238	0	2319
18661	24	7	51	2254	0	2336
18662	28	8	2178	95	0	2309
18663	19	5	51	2096	0	2171
18664	22	2121	55	56	0	2254
18665	20	37	18	2252	0	2327
18666	2188	44	21	57	0	2310
18667	54	11	16	2241	0	2322
18668	48	15	2184	62	0	2309
18669	32	10	45	2245	0	2332
18670	22	12	2236	51	0	2321
18671	2120	14	50	57	0	2241
18672	56	8	54	2209	0	2327
18673	2191	15	20	52	0	2278
18674	60	14	2157	56	0	2287
18675	2010	11	44	28	0	2093
18676	56	2251	58	20	0	2385
18677	51	40	2267	30	0	2388
18678	25	43	43	2216	0	2327
18679	13	15	2314	49	0	2391
18680	10	2113	48	54	0	2225
18681	13	2155	43	32	0	2243
18682	1955	76	8	15	0	2054
18683	40	2140	8	17	0	2205
18684	2127	41	8	19	0	2195
18685	48	35	10	2154	0	2247
18686	50	7	2130	47	0	2234
18687	13	2157	49	44	0	2263
18688	16	42	40	2164	0	2262
18689	13	35	13	2269	0	2330
18690	18	10	8	2331	0	2367
18691	11	9	10	2272	0	2302
18692	11	2220	14	86	0	2331
18693	11	2322	8	48	0	2389
18694	2195	66	12	14	0	2287
18695	40	2225	11	9	0	2285
18696	33	40	7	2161	0	2241
18697	9	34	2144	45	0	2232
18698	8	2121	43	38	0	2210
18699	13	38	35	2096	0	2182
18700	7	50	6	2048	0	2111
18701	10	2112	11	76	0	2209
18702	2077	40	7	47	0	2171
18703	36	40	2073	15	0	2164
18704	1878	10	32	10	0	1930
18705	31	2004	35	16	0	2086
18706	1883	26	10	11	0	1930
18707	29	1968	6	4	0	2007
18708	30	32	2	2053	0	2117
18709	11	46	3	2110	0	2170
18710	2132	10	5	68	0	2215
18711	40	6	3	2170	0	2219
18712	35	10	2167	39	0	2251
18713	6	2136	36	41	0	2219
18714	3	2168	34	14	0	2219
18715	5	60	6	2135	0	2206
18716	2	42	2135	35	0	2214
18717	5	10	31	2133	0	2179
18718	10	7	30	2149	0	2196
18719	3	12	2140	65	0	2220
18720	4	11	2068	44	0	2127
18721	7	2114	59	11	0	2191
18722	2130	35	35	6	0	2206
18723	35	65	8	2028	0	2136
18724	27	2013	5	36	0	2081
18725	2052	35	6	33	0	2126
18726	32	32	2	2079	0	2145
18727	34	8	5	2064	0	2111
18728	5	2031	5	63	0	2104
18729	4	37	5	2080	0	2126
18730	2055	34	3	40	0	2132
18731	34	12	5	2079	0	2130
18732	32	7	5	2103	0	2147
18733	10	13	2040	55	0	2118
18734	11	17	1885	37	0	1950
18735	1906	9	58	23	0	1996
18736	33	9	34	1963	0	2039
18737	35	14	6	1961	0	2016
18738	9	9	4	2006	0	2028
18739	8	11	1930	71	0	2020
18740	1830	10	34	45	0	1919
18741	35	18	35	1909	0	1997
18742	42	10	6	1943	0	2001
18743	1888	15	10	70	0	1983
18744	26	1893	10	55	0	1984
18745	36	41	1879	23	0	1979
18746	16	34	38	1852	0	1940
18747	10	1820	37	46	0	1913
18748	11	35	14	1880	0	1940
18749	1841	35	10	48	0	1934
18750	38	14	12	1834	0	1898
18751	1814	14	8	44	0	1880
18752	1795	13	6	46	0	1860
18753	63	11	4	1717	0	1795
18754	39	1718	5	48	0	1810
18755	8	1800	14	47	0	1869
18756	13	60	1773	22	0	1868
18757	13	44	37	1671	0	1765
18758	12	12	32	1862	0	1918
18759	12	11	7	1897	0	1927
18760	1812	12	13	80	0	1917
18761	45	13	8	1859	0	1925
18762	40	12	1816	59	0	1927
18763	1800	4	34	59	0	1897
18764	48	11	34	1859	0	1952
18765	39	10	12	1903	0	1964
18766	20	10	1846	80	0	1956
18767	1744	8	39	64	0	1855
18768	44	15	36	1895	0	1990
18769	47	10	1887	59	0	2003
18770	19	9	38	1912	0	1978
18771	20	12	36	1691	0	1759
18772	16	1907	18	75	0	2016
18773	1901	36	13	54	0	2004
18774	1902	37	9	29	0	1977
18775	62	1899	17	24	0	2002
18776	1823	34	8	23	0	1888
18777	1708	38	8	26	0	1780
18778	66	7	7	1694	0	1774
18779	47	3	1614	52	0	1716
18780	20	9	1559	39	0	1627
18781	15	10	1540	20	0	1585
18782	38	8	1610	20	0	1676
18783	7	6	51	1491	0	1555
18784	14	7	30	1556	0	1607
18785	9	8	14	1534	0	1565
18786	9	2	10	1580	0	1601
18787	1630	6	9	60	0	1705
18788	33	1620	12	43	0	1708
18789	1670	25	9	19	0	1723
18790	35	27	1605	14	0	1681
18791	33	10	1679	19	0	1741
18792	9	23	53	1734	0	1819
18793	1767	6	35	36	0	1844
18794	1642	4	6	38	0	1690
18795	54	1722	11	21	0	1808
18796	37	1725	8	8	0	1778
18797	8	50	7	1722	0	1787
18798	1717	27	10	35	0	1789
18799	35	1714	12	31	0	1792
18800	1796	29	6	21	0	1852
18801	1837	26	6	21	0	1890
18802	1904	8	9	20	0	1941
18803	61	12	1923	9	0	2005
18804	34	1949	29	11	0	2023
18805	1939	29	25	18	0	2011
18806	1952	25	6	16	0	1999
18807	55	1892	8	15	0	1970
18808	22	1826	7	5	0	1860
18809	1732	33	35	9	0	1809
18810	29	18	2	1711	0	1760
18811	22	8	1712	25	0	1767
18812	1599	2	45	24	0	1670
18813	21	3	21	1654	0	1699
18814	25	1675	6	42	0	1748
18815	7	23	7	1775	0	1812
18816	7	23	1778	28	0	1836
18817	9	9	20	1777	0	1815
18818	1911	2	24	38	0	1975
18819	32	2	5	1924	0	1963
18820	27	6	2	1931	0	1966
18821	10	8	2025	49	0	2092
18822	15	5	22	1934	0	1976
18823	10	2058	33	25	0	2126
18824	2083	24	11	27	0	2145
18825	2002	25	6	16	0	2049
18826	51	11	2058	8	0	2128
18827	26	2	23	1931	0	1982
18828	9	1987	20	29	0	2045
18829	6	2052	10	22	0	2090
18830	2029	39	3	7	0	2078
18831	29	25	3	2114	0	2171
18832	21	14	2152	32	0	2219
18833	10	11	2121	27	0	2169
18834	9	6	48	2154	0	2217
18835	2145	8	25	36	0	2214
18836	2170	3	6	25	0	2204
18837	55	6	5	2238	0	2304
18838	30	4	2246	32	0	2312
18839	11	2291	31	26	0	2359
18840	2284	27	24	11	0	2346
18841	32	2358	14	6	0	2410
18842	2371	31	5	11	0	2418
18843	34	25	8	2370	0	2437
18844	30	11	2393	31	0	2465
18845	14	7	29	2374	0	2424
18846	2311	5	26	41	0	2383
18847	37	10	2369	39	0	2455
18848	29	2378	33	18	0	2458
18849	10	35	21	2396	0	2462
18850	2410	25	7	38	0	2480
18851	39	12	2399	26	0	2476
18852	36	6	37	2349	0	2428
18853	16	7	28	2465	0	2516
18854	13	10	2485	54	0	2562
18855	12	9	32	2430	0	2483
18856	11	21	2457	35	0	2524
18857	2311	7	34	32	0	2384
18858	33	10	24	2432	0	2499
18859	32	18	2655	32	0	2737
18860	14	2715	41	32	0	2802
18861	2789	33	25	15	0	2862
18862	3016	29	7	15	0	3067
18863	76	8	7	3316	0	3407
18864	37	3526	9	58	0	3630
18865	3540	63	9	46	0	3658
18866	72	48	8	3524	0	3652
18867	52	23	3544	60	0	3679
18868	3354	12	64	57	0	3487
18869	72	3484	49	15	0	3620
18870	52	68	11	3543	0	3674
18871	3559	50	11	70	0	3690
18872	66	12	3565	51	0	3694
18873	58	10	3607	19	0	3694
18874	14	5	118	3437	0	3574
18875	12	18	3637	69	0	3736
18876	20	9	67	3430	0	3526
18877	15	3540	56	71	0	3682
18878	13	62	13	3702	0	3790
18879	3624	48	13	79	0	3764
18880	67	13	3651	69	0	3800
18881	59	3655	73	14	0	3801
18882	13	60	58	3537	0	3668
18883	8	65	3619	62	0	3754
18884	23	58	62	3462	0	3605
18885	11	3620	60	64	0	3755
18886	7	3694	25	55	0	3781
18887	3394	97	19	16	0	3526
18888	53	3539	15	14	0	3621
18889	51	59	3376	7	0	3493
18890	3074	49	66	17	0	3206
18891	51	12	3388	10	0	3461
18892	51	5	55	3092	0	3203
18893	10	8	3346	57	0	3421
18894	3	3348	56	52	0	3459
18895	11	48	50	3327	0	3436
18896	10	46	6	3405	0	3467
18897	8	8	6	3405	0	3427
18898	7	12	3364	101	0	3484
18899	17	5	55	3303	0	3380
18900	8	4	52	3352	0	3416
18901	3215	10	16	98	0	3339
18902	3283	2	10	62	0	3357
18903	104	9	3247	16	0	3376
18904	56	3199	62	13	0	3330
18905	14	59	3259	13	0	3345
18906	16	51	61	3245	0	3373
18907	17	12	3338	56	0	3423
18908	6	6	62	3253	0	3327
18909	7	2	57	3321	0	3387
18910	11	11	3265	105	0	3392
18911	2921	6	65	65	0	3057
18912	56	3288	52	20	0	3416
18913	50	60	10	3304	0	3424
18914	22	58	3407	64	0	3551
18915	19	20	3309	50	0	3398
18916	3143	10	102	16	0	3271
18917	59	3319	63	8	0	3449
18918	45	55	10	3224	0	3334
18919	3271	41	12	66	0	3390
18920	59	10	9	3299	0	3377
18921	47	10	9	3246	0	3312
18922	11	16	3184	102	0	3313
18923	2990	8	63	58	0	3119
18924	3193	3	50	24	0	3270
18925	99	8	16	3177	0	3300
18926	3162	4	10	67	0	3243
18927	72	7	9	3140	0	3228
18928	48	3055	15	65	0	3183
18929	15	3216	13	56	0	3300
18930	13	89	10	3210	0	3322
18931	3079	49	8	61	0	3197
18932	62	13	5	3089	0	3169
18933	3091	11	9	66	0	3177
18934	3084	4	8	60	0	3156
18935	102	4	12	3028	0	3146
18936	60	5	3	3098	0	3166
18937	19	12	2993	96	0	3120
18938	20	16	3079	50	0	3165
18939	17	4	102	2988	0	3111
18940	8	15	3160	70	0	3253
18941	3044	7	72	56	0	3179
18942	65	3	53	3280	0	3401
18943	51	14	3411	83	0	3559
18944	3483	7	79	54	0	3623
18945	3706	5	52	23	0	3786
18946	150	3924	19	13	0	4106
18947	83	87	11	3987	0	4168
18948	23	80	4067	91	0	4261
18949	4029	20	89	76	0	4214
18950	4193	8	73	24	0	4298
18951	159	10	4227	17	0	4413
18952	4290	6	97	9	0	4402
18953	109	7	73	4187	0	4376
18954	92	7	16	4280	0	4395
18955	4205	3	16	169	0	4393
18956	4278	2	8	99	0	4387
18957	166	3	12	4224	0	4405
18958	87	12	4233	113	0	4445
18959	26	3993	104	81	0	4204
18960	22	87	4043	22	0	4174
18961	27	101	3924	19	0	4071
18962	9	3743	153	17	0	3922
18963	14	56	108	3021	0	3199
18964	16	49	18	3119	0	3202
18965	14	18	3069	107	0	3208
18966	22	5	63	3105	0	3195
18967	3110	6	55	73	0	3244
18968	69	14	3231	65	0	3379
18969	3244	4	66	31	0	3345
18970	3314	2	63	16	0	3395
18971	3390	7	23	17	0	3437
18972	127	16	3242	15	0	3400
18973	75	9	3280	19	0	3383
18974	34	5	117	3161	0	3317
18975	35	13	59	3009	0	3116
18976	25	3223	30	99	0	3377
18977	3212	50	25	66	0	3353
18978	3196	47	20	21	0	3284
18979	113	3175	16	21	0	3325
18980	3149	57	21	30	0	3257
18981	79	3132	28	16	0	3255
18982	3172	69	14	28	0	3283
18983	88	42	16	3014	0	3160
18984	54	20	3020	74	0	3168
18985	29	28	2986	51	0	3094
18986	22	12	111	2941	0	3086
18987	30	9	68	2992	0	3099
18988	23	20	2996	104	0	3143
18989	21	15	76	2947	0	3059
18990	25	11	55	3017	0	3108
18991	2967	9	28	112	0	3116
18992	3026	11	24	68	0	3129
18993	2980	4	27	33	0	3044
18994	124	13	2831	31	0	2999
18995	70	2855	81	19	0	3025
18996	53	57	48	2757	0	2915
18997	37	47	2824	60	0	2968
18998	40	2838	74	43	0	2995
18999	2861	64	50	24	0	2999
19000	86	43	34	2841	0	3004
19001	67	20	25	2926	0	3038
19002	2891	16	21	113	0	3041
19003	88	18	12	2935	0	3053
19004	72	18	19	2967	0	3076
19005	2934	14	20	107	0	3075
19006	79	19	2834	72	0	3004
19007	69	2825	76	29	0	2999
19008	2816	63	50	33	0	2962
19009	71	51	2858	33	0	3013
19010	2764	23	75	33	0	2895
19011	77	2850	64	30	0	3021
19012	2814	55	35	37	0	2941
19013	2826	40	31	32	0	2929
19014	2713	18	31	37	0	2799
19015	121	8	27	2646	0	2802
19016	72	14	23	2645	0	2754
19017	36	2624	28	117	0	2805
19018	37	2658	27	68	0	2790
19019	36	2689	22	32	0	2779
19020	2634	97	13	27	0	2771
19021	82	52	2629	27	0	2790
19022	67	20	73	2627	0	2787
19023	31	24	50	2637	0	2742
19024	29	2656	26	98	0	2809
19025	25	59	25	2689	0	2798
19026	33	48	19	2631	0	2731
19027	38	2708	18	105	0	2869
19028	2674	55	14	75	0	2818
19029	67	2760	18	40	0	2885
19030	60	70	2678	28	0	2836
19031	2644	44	52	35	0	2775
19032	75	2725	52	27	0	2879
19033	2715	61	25	21	0	2822
19034	90	52	21	2718	0	2881
19035	77	20	15	2791	0	2903
19036	38	30	2773	98	0	2939
19037	31	28	2795	58	0	2912
19038	35	18	78	2705	0	2836
19039	2664	20	73	62	0	2819
19040	2630	22	15	50	0	2717
19041	94	2593	16	20	0	2723
19042	63	2503	18	14	0	2598
19043	25	2421	10	20	0	2476
19044	28	124	34	1903	0	2089
19045	1936	13	10	20	0	1979
19046	1909	4	2	12	0	1927
19047	1897	5	1	8	0	1911
19048	41	6	1884	4	0	1935
19049	24	2220	24	5	0	2273
19050	8	28	21	2345	0	2402
19051	2367	27	3	35	0	2432
19052	35	6	1	2430	0	2472
19053	37	7	3	2487	0	2534
19054	2485	6	1	73	0	2565
19055	2723	4	2	44	0	2773
19056	86	6	2771	5	0	2868
19057	51	2	46	2734	0	2833
19058	6	13	2717	53	0	2789
19059	11	4	47	2718	0	2780
19060	6	7	2714	56	0	2783
19061	3	4	49	2717	0	2773
19062	2590	5	43	53	0	2691
19063	49	2691	7	55	0	2802
19064	45	2768	12	7	0	2832
19065	19	93	5	2337	0	2454
19066	6	2774	8	35	0	2823
19067	2735	48	4	44	0	2831
19068	2634	50	2	15	0	2701
19069	103	11	2606	13	0	2733
19070	55	2646	50	8	0	2759
19071	11	49	48	2620	0	2728
19072	11	57	2631	48	0	2747
19073	2585	5	46	56	0	2692
19074	56	4	49	2642	0	2751
19075	60	6	2664	52	0	2782
19076	16	5	46	2715	0	2782
19077	2667	7	58	57	0	2789
19078	54	14	2667	55	0	2790
19079	2697	6	48	17	0	2768
19080	2730	2	54	9	0	2795
19081	105	3	7	2652	0	2767
19082	63	10	2690	56	0	2819
19083	13	14	2692	55	0	2774
19084	2595	6	97	14	0	2712
19085	2681	6	56	15	0	2758
19086	107	11	2623	20	0	2761
19087	69	4	50	2595	0	2718
19088	15	11	59	2526	0	2611
19089	12	2599	16	103	0	2730
19090	12	51	10	2647	0	2720
19091	2612	55	17	61	0	2745
19092	66	8	11	2661	0	2746
19093	59	11	2618	67	0	2755
19094	2513	7	65	64	0	2649
19095	59	12	50	2577	0	2698
19096	63	24	2561	59	0	2707
19097	18	2519	59	70	0	2666
19098	2444	54	55	16	0	2569
19099	51	2559	20	17	0	2647
19100	2533	57	12	18	0	2620
19101	68	57	2478	14	0	2617
19102	62	2418	60	16	0	2556
19103	14	2476	70	15	0	2575
19104	17	97	10	2388	0	2512
19105	22	50	14	2461	0	2547
19106	21	11	2417	109	0	2558
19107	14	6	62	2445	0	2527
19108	2392	5	61	73	0	2531
19109	69	12	2382	60	0	2523
19110	74	8	55	2345	0	2482
19111	21	10	2390	61	0	2482
19112	2255	7	63	70	0	2395
19113	60	2348	62	20	0	2490
19114	2454	52	12	23	0	2541
19115	2419	53	23	17	0	2512
19116	2466	9	17	19	0	2511
19117	113	11	2327	20	0	2471
19118	65	2347	61	13	0	2486
19119	24	56	62	2400	0	2542
19120	22	54	13	2516	0	2605
19121	2528	12	17	113	0	2670
19122	71	11	12	2576	0	2670
19123	2621	9	9	77	0	2716
19124	2603	6	12	71	0	2692
19125	2645	8	21	24	0	2698
19126	2657	6	19	20	0	2702
19127	122	11	13	2514	0	2660
19128	2558	4	11	69	0	2642
19129	68	13	2454	64	0	2599
19130	2467	11	67	19	0	2564
19131	2501	12	54	21	0	2588
19132	120	14	2410	16	0	2560
19133	2460	12	62	20	0	2554
19134	2511	9	61	14	0	2595
19135	113	13	16	2415	0	2557
19136	68	13	16	2429	0	2526
19137	2383	14	14	111	0	2522
19138	70	11	15	2415	0	2511
19139	65	3	16	2381	0	2465
19140	23	2233	20	130	0	2406
19141	29	47	12	2314	0	2402
19142	2197	44	15	61	0	2317
19143	64	4	19	2209	0	2296
19144	61	8	7	2152	0	2228
19145	24	2089	16	90	0	2219
19146	32	45	8	1975	0	2060
19147	27	35	8	1911	0	1981
19148	1796	9	17	75	0	1897
19149	41	33	7	1324	0	1405
19150	28	4	1234	28	0	1294
19151	8	1183	27	24	0	1242
19152	5	1171	21	9	0	1206
19153	1119	29	2	4	0	1154
19154	23	1139	20	4	0	1186
19155	881	10	31	5	0	927
19156	11	841	19	4	0	875
19157	845	9	2	4	0	860
19158	11	4	1	910	0	926
19159	6	1	1	936	0	944
19160	2	921	2	16	0	941
19161	1	10	2	942	0	955
19162	3	9	981	11	0	1004
19163	925	9	10	8	0	952
19164	9	1119	7	2	0	1137
19165	1101	14	0	2	0	1117
19166	1118	6	2	2	0	1128
19167	1126	2	0	3	0	1131
19168	19	1	3	1076	0	1099
19169	9	1	0	1082	0	1092
19170	4	1082	6	17	0	1109
19171	1075	14	1	7	0	1097
19172	15	1091	0	2	0	1108
19173	1080	15	0	5	0	1100
19174	17	9	1075	2	0	1103
19175	1105	4	14	1	0	1124
19176	20	0	6	1123	0	1149
19177	11	6	1106	16	0	1139
19178	5	0	1111	11	0	1127
19179	2	0	25	1100	0	1127
19180	4	2	1121	16	0	1143
19181	3	2	16	1120	0	1141
19182	1047	1	10	22	0	1080
19183	21	0	4	1082	0	1107
19184	13	4	1061	20	0	1098
19185	6	1051	16	12	0	1085
19186	6	1110	12	6	0	1134
19187	17	23	2	1087	0	1129
19188	1114	11	2	17	0	1144
19189	19	3	3	1136	0	1161
19190	18	2	0	1163	0	1183
19191	9	1	3	1171	0	1184
19192	6	3	2	1168	0	1179
19193	7	3	1127	29	0	1166
19194	3	7	1092	14	0	1116
19195	1079	0	23	8	0	1110
19196	1139	2	12	8	0	1161
19197	30	1	3	1132	0	1166
19198	14	1	1	1146	0	1162
19199	11	5	1126	24	0	1166
19200	3	1132	18	16	0	1169
19201	1142	16	12	7	0	1177
19202	1151	12	4	7	0	1174
19203	27	5	1	1157	0	1190
19204	17	6	1185	21	0	1229
19205	9	7	12	1148	0	1176
19206	3	1185	12	23	0	1223
19207	4	20	1169	17	0	1210
19208	1146	13	15	9	0	1183
19209	19	7	11	1173	0	1210
19210	1192	1	6	23	0	1222
19211	17	9	1175	14	0	1215
19212	1191	4	16	8	0	1219
19213	21	4	11	1207	0	1243
19214	1160	5	5	20	0	1190
19215	25	26	4	1132	0	1187
19216	14	1144	6	22	0	1186
19217	11	1160	9	14	0	1194
19218	7	52	3	1143	0	1205
19219	11	15	1052	14	0	1092
19220	4	1040	17	17	0	1078
19221	12	16	13	1023	0	1064
19222	1016	13	6	18	0	1053
19223	984	8	3	21	0	1016
19224	33	3	4	992	0	1032
19225	29	3	4	976	0	1012
19226	9	950	3	39	0	1001
19227	7	990	4	23	0	1024
19228	970	27	6	11	0	1014
19229	20	18	3	967	0	1008
19230	22	6	4	952	0	984
19231	6	6	927	33	0	972
19232	11	0	17	945	0	973
19233	8	3	19	933	0	963
19234	7	1	6	963	0	977
19235	3	6	972	36	0	1017
19236	5	2	18	977	0	1002
19237	934	2	19	22	0	977
19238	20	1	936	20	0	977
19239	929	1	18	10	0	958
19240	22	2	19	941	0	984
19241	21	3	7	959	0	990
19242	9	2	2	1039	0	1052
19243	4	6	1005	34	0	1049
19244	927	3	19	28	0	977
19245	21	1016	29	8	0	1074
19246	1020	15	3	9	0	1047
19247	23	1068	5	8	0	1104
19248	17	17	6	1057	0	1097
19249	1056	18	4	18	0	1096
19250	14	7	1039	27	0	1087
19251	1013	3	14	8	0	1038
19252	17	6	1156	15	0	1194
19253	24	2	16	1127	0	1169
19254	5	2	1138	20	0	1165
19255	3	1121	20	22	0	1166
19256	8	15	19	1096	0	1138
19257	1093	18	7	17	0	1135
19258	18	4	4	1043	0	1069
19259	20	1036	6	18	0	1080
19260	9	15	3	1057	0	1084
19261	1077	17	1	21	0	1116
19262	982	1	26	19	0	1028
19263	31	975	2	9	0	1017
19264	16	921	1	4	0	942
19265	8	18	0	893	0	919
19266	1	15	1	914	0	931
19267	897	1	2	20	0	920
19268	888	0	0	18	0	906
19269	20	892	2	2	0	916
19270	16	6	1	890	0	913
19271	4	13	0	899	0	916
19272	2	5	892	22	0	921
19273	2	875	7	14	0	898
19274	0	865	15	2	0	882
19275	1	13	0	838	0	852
19276	1	12	835	10	0	858
19277	4	1	853	13	0	871
19278	0	1	18	835	0	854
19279	1	0	11	862	0	874
19280	0	5	850	18	0	873
19281	2	1	6	874	0	883
19282	3	1	903	6	0	913
19283	899	0	9	14	0	922
19284	10	0	12	909	0	931
19285	13	4	961	10	0	988
19286	0	3	932	16	0	951
19287	1	3	24	1056	0	1084
19288	5	4	1205	18	0	1232
19289	3	3	1192	22	0	1220
19290	4	1157	40	5	0	1206
19291	1175	21	23	3	0	1222
19292	19	22	1221	5	0	1267
19293	21	4	20	1208	0	1253
19294	4	0	21	1270	0	1295
19295	3	0	4	1299	0	1306
19296	2	5	1254	46	0	1307
19297	5	3	24	1250	0	1282
19298	1258	1	23	30	0	1312
19299	28	1	3	1250	0	1282
19300	23	3	1263	27	0	1316
19301	7	2	28	1277	0	1314
19302	1262	3	21	32	0	1318
19303	1292	2	3	27	0	1324
19304	1266	1	4	6	0	1277
19305	50	2	4	1211	0	1267
19306	1240	3	2	28	0	1273
19307	1259	3	2	26	0	1290
19308	1260	0	4	7	0	1271
19309	46	1255	3	4	0	1308
19310	1280	24	6	5	0	1315
19311	30	21	4	1237	0	1292
19312	21	3	1214	31	0	1269
19313	3	1223	27	26	0	1279
19314	1215	24	24	7	0	1270
19315	24	21	7	1219	0	1271
19316	22	3	3	1184	0	1212
19317	6	1195	6	43	0	1250
19318	4	1229	10	22	0	1265
19319	1187	47	5	6	0	1245
19320	25	1243	4	5	0	1277
19321	1118	27	3	7	0	1155
19322	26	1132	7	3	0	1168
19323	1119	46	6	3	0	1174
19324	24	1137	3	10	0	1174
19325	17	1170	5	4	0	1196
19326	1166	39	5	6	0	1216
19327	25	19	1174	7	0	1225
19328	15	1169	26	19	0	1229
19329	9	22	20	1211	0	1262
19330	2	17	5	1271	0	1295
19331	6	3	8	1274	0	1291
19332	7	2	2	1291	0	1302
19333	8	3	1230	51	0	1292
19334	1179	3	28	24	0	1234
19335	31	0	18	1257	0	1306
19336	1290	2	6	28	0	1326
19337	1325	2	6	24	0	1357
19338	1344	4	4	6	0	1358
19339	1336	4	1	10	0	1351
19340	54	7	1339	6	0	1406
19341	28	5	31	1334	0	1398
19342	12	4	1329	34	0	1379
19343	4	1282	43	39	0	1368
19344	11	39	31	1150	0	1231
19345	9	47	7	1267	0	1330
19346	8	6	9	1351	0	1374
19347	8	4	12	1303	0	1327
19348	7	7	1240	64	0	1318
19349	7	7	30	1265	0	1309
19350	11	1	28	1290	0	1330
19351	1258	6	10	60	0	1334
19352	1220	3	5	32	0	1260
19353	61	4	3	1240	0	1308
19354	40	3	9	1278	0	1330
19355	13	4	13	1321	0	1351
19356	1303	4	6	75	0	1388
19357	1358	7	7	39	0	1411
19358	1340	4	10	11	0	1365
19359	1357	5	6	13	0	1381
19360	72	1303	6	20	0	1401
19361	1322	35	7	11	0	1375
19362	1318	28	7	8	0	1361
19363	74	4	2	1280	0	1360
19364	40	5	4	1283	0	1332
19365	1231	8	4	71	0	1314
19366	42	1222	9	44	0	1317
19367	40	1321	6	12	0	1379
19368	1367	67	3	12	0	1449
19369	52	33	3	1351	0	1439
19370	39	8	5	1398	0	1450
19371	19	2	4	1432	0	1457
19372	17	8	3	1439	0	1467
19373	19	8	4	1408	0	1439
19374	16	1375	4	72	0	1467
19375	13	40	2	1371	0	1426
19376	1315	29	0	48	0	1392
19377	44	10	5	1310	0	1369
19378	35	8	4	1327	0	1374
19379	1291	10	2	66	0	1369
19380	47	1331	6	36	0	1420
19381	35	69	2	1259	0	1365
19382	14	1338	7	43	0	1402
19383	9	59	5	1333	0	1406
19384	9	34	1300	47	0	1390
19385	1165	8	30	38	0	1241
19386	38	1255	24	16	0	1333
19387	1124	23	3	19	0	1169
19388	27	23	1012	13	0	1075
19389	21	12	21	936	0	990
19390	9	977	18	23	0	1027
19391	6	1034	8	26	0	1074
19392	1015	34	1	10	0	1060
19393	24	20	3	985	0	1032
19394	26	10	1085	27	0	1148
19395	6	2	17	1136	0	1161
19396	4	6	1125	29	0	1164
19397	1047	0	20	28	0	1095
19398	24	3	1128	9	0	1164
19399	25	4	20	1059	0	1108
19400	8	1094	19	25	0	1146
19401	9	19	5	1045	0	1078
19402	7	1122	0	27	0	1156
19403	1156	19	2	28	0	1205
19404	22	21	2	1190	0	1235
19405	28	5	1203	29	0	1265
19406	7	7	1211	27	0	1252
19407	1148	5	33	13	0	1199
19408	1232	5	22	7	0	1266
19409	1221	4	2	8	0	1235
19410	1213	4	2	11	0	1230
19411	38	1189	5	14	0	1246
19412	1218	19	3	6	0	1246
19413	1211	23	1	13	0	1248
19414	41	11	1176	9	0	1237
19415	26	5	17	1167	0	1215
19416	1188	5	21	24	0	1238
19417	23	4	1182	31	0	1240
19418	25	6	18	1175	0	1224
19419	12	5	1228	28	0	1273
19420	10	5	20	1149	0	1184
19421	11	1200	22	26	0	1259
19422	1217	22	3	25	0	1267
19423	22	23	1184	15	0	1244
19424	1161	9	15	10	0	1195
19425	24	4	17	1183	0	1228
19426	1165	6	6	23	0	1200
19427	26	8	4	1160	0	1198
19428	1267	5	6	30	0	1308
19429	25	6	1187	29	0	1247
19430	1225	7	17	14	0	1263
19431	23	6	21	1253	0	1303
19432	27	4	7	1257	0	1295
19433	1255	8	3	34	0	1300
19434	23	7	3	1266	0	1299
19435	22	8	1245	27	0	1302
19436	13	4	17	1254	0	1288
19437	1193	2	16	27	0	1238
19438	17	1206	11	17	0	1251
19439	18	1197	5	7	0	1227
19440	1122	20	1	11	0	1154
19441	14	1169	6	6	0	1195
19442	12	10	4	1147	0	1173
19443	1185	7	1	18	0	1211
19444	1185	6	2	10	0	1203
19445	1185	2	1	7	0	1195
19446	25	5	1190	5	0	1225
19447	15	3	9	1199	0	1226
19448	4	1230	11	13	0	1258
19449	4	10	3	1246	0	1263
19450	6	12	1251	14	0	1283
19451	4	1181	11	14	0	1210
19452	8	39	6	1131	0	1184
19453	1061	6	24	12	0	1103
19454	5	1075	4	5	0	1089
19455	8	6	1111	1	0	1126
19456	2	2	7	1119	0	1130
19457	3	1	1127	11	0	1142
19458	3	1	8	1082	0	1094
19459	1106	1	6	9	0	1122
19460	9	1	1	1143	0	1154
19461	1152	1	0	13	0	1166
19462	1162	1	0	7	0	1170
19463	14	1205	2	2	0	1223
19464	1226	10	1	4	0	1241
19465	11	1224	3	0	0	1238
19466	9	12	1287	2	0	1310
19467	4	7	15	1224	0	1250
19468	0	2	7	1298	0	1307
19469	2	3	1260	28	0	1293
19470	2	1260	17	11	0	1290
19471	1270	15	9	2	0	1296
19472	1272	8	1	2	0	1283
19473	30	0	0	1350	0	1380
19474	9	0	0	1343	0	1352
19475	3	0	1	1371	0	1375
19476	1317	0	0	33	0	1350
19477	20	5	1343	9	0	1377
19478	11	3	1345	2	0	1361
19479	5	3	28	1339	0	1375
19480	0	1	1298	24	0	1323
19481	2	5	1299	12	0	1318
19482	2	2	28	1215	0	1247
19483	1	6	1281	21	0	1309
19484	1	1272	25	12	0	1310
19485	1	22	10	1275	0	1308
19486	1	12	1292	24	0	1329
19487	3	3	21	1255	0	1282
19488	1	1287	13	21	0	1322
19489	4	20	2	1300	0	1326
19490	7	12	1300	23	0	1342
19491	2	4	24	1226	0	1256
19492	1237	1	8	26	0	1272
19493	22	6	1279	13	0	1320
19494	1108	0	21	8	0	1137
19495	21	1181	11	3	0	1216
19496	1223	20	3	3	0	1249
19497	25	11	2	1241	0	1279
19498	13	1301	5	23	0	1342
19499	1355	22	2	14	0	1393
19500	27	15	3	1430	0	1475
19501	18	5	1450	30	0	1503
19502	4	1469	29	22	0	1524
19503	2	27	21	1419	0	1469
19504	1387	21	1	33	0	1442
19505	1370	4	3	24	0	1401
19506	48	3	5	1326	0	1382
19507	19	6	1332	33	0	1390
19508	1241	3	27	24	0	1295
19509	29	0	1354	8	0	1391
19510	22	2	31	1346	0	1401
19511	1391	1	23	35	0	1450
19512	32	1404	5	21	0	1462
19513	1433	30	4	5	0	1472
19514	36	19	1431	6	0	1492
19515	1425	2	30	7	0	1464
19516	37	2	21	1453	0	1513
19517	26	1	7	1494	0	1528
19518	3	9	1471	54	0	1537
19519	6	1	32	1453	0	1492
19520	1467	3	24	34	0	1528
19521	34	2	7	1449	0	1492
19522	24	1448	9	34	0	1515
19523	10	30	4	1443	0	1487
19524	5	1490	6	33	0	1534
19525	6	37	1465	24	0	1532
19526	1396	23	31	9	0	1459
19527	31	4	27	1490	0	1552
19528	26	4	1368	37	0	1435
19529	7	1361	38	23	0	1429
19530	7	32	24	1366	0	1429
19531	8	22	3	1400	0	1433
19532	1367	9	2	59	0	1437
19533	41	1	6	1416	0	1464
19534	1414	2	7	39	0	1462
19535	1400	6	3	24	0	1433
19536	57	1360	4	11	0	1432
19537	1435	33	4	10	0	1482
19538	44	26	7	1491	0	1568
19539	29	10	1466	43	0	1548
19540	1468	3	41	35	0	1547
19541	44	5	28	1462	0	1539
19542	34	11	1484	39	0	1568
19543	1413	6	39	36	0	1494
19544	43	7	32	1475	0	1557
19545	35	1518	12	37	0	1602
19546	21	37	6	1415	0	1479
19547	6	1467	8	50	0	1531
19548	1435	40	11	28	0	1514
19549	43	33	1482	18	0	1576
19550	27	1510	43	12	0	1592
19551	14	37	28	1533	0	1612
19552	14	31	1555	44	0	1644
19553	10	11	1531	43	0	1595
19554	12	1569	71	7	0	1659
19555	14	45	39	1492	0	1590
19556	12	28	9	1510	0	1559
19557	13	7	10	1811	0	1841
19558	1813	7	3	84	0	1907
19559	56	8	1944	50	0	2058
19560	39	1931	57	21	0	2048
19561	16	53	41	1891	0	2001
19562	9	39	7	1968	0	2023
19563	11	10	1884	94	0	1999
19564	10	5	54	1913	0	1982
19565	9	13	1918	59	0	1999
19566	10	7	1806	46	0	1869
19567	14	10	1858	18	0	1900
19568	9	9	80	1739	0	1837
19569	17	8	40	1828	0	1893
19570	8	8	14	1919	0	1949
19571	1854	4	9	87	0	1954
19572	51	1866	16	46	0	1979
19573	1842	44	5	20	0	1911
19574	1800	32	10	22	0	1864
19575	1867	12	9	16	0	1904
19576	89	1882	8	13	0	1992
19577	1909	50	5	24	0	1988
19578	1970	40	4	19	0	2033
19579	84	11	10	1951	0	2056
19580	55	11	9	1957	0	2032
19581	20	6	13	2016	0	2055
19582	11	14	1925	90	0	2040
19583	1852	10	51	55	0	1968
19584	55	4	43	1939	0	2041
19585	1937	3	28	64	0	2032
19586	59	1901	18	48	0	2026
19587	42	50	13	1911	0	2016
19588	23	39	8	1978	0	2048
19589	1933	14	11	97	0	2055
19590	59	11	9	1983	0	2062
19591	1938	16	8	79	0	2041
19592	1959	14	18	53	0	2044
19593	96	1894	15	21	0	2026
19594	50	1932	16	18	0	2016
19595	24	87	18	1868	0	1997
19596	14	1925	17	68	0	2024
19597	25	73	10	1908	0	2016
19598	10	37	1812	83	0	1942
19599	19	19	1768	46	0	1852
19600	1605	9	85	23	0	1722
19601	1692	8	35	25	0	1760
19602	78	1644	21	25	0	1768
19603	1652	62	12	23	0	1749
19604	65	1740	15	18	0	1838
19605	34	69	16	1739	0	1858
19606	19	32	9	1798	0	1858
19607	14	11	15	1828	0	1868
19608	14	10	19	1837	0	1880
19609	1741	8	16	102	0	1867
19610	60	1731	14	55	0	1860
19611	1707	55	14	27	0	1803
19612	1750	32	12	24	0	1818
19613	87	19	1672	28	0	1806
19614	1641	13	56	21	0	1731
19615	77	1662	33	14	0	1786
19616	48	61	16	1630	0	1755
19617	28	35	7	1611	0	1681
19618	22	1632	11	80	0	1745
19619	1662	58	12	39	0	1771
19620	67	36	1626	21	0	1750
19621	1618	11	63	29	0	1721
19622	76	8	1680	26	0	1790
19623	47	14	66	1635	0	1762
19624	26	10	36	1710	0	1782
19625	22	10	16	1747	0	1795
19626	1714	12	11	107	0	1844
19627	71	16	1734	58	0	1879
19628	1752	15	59	38	0	1864
19629	1849	12	33	35	0	1929
19630	1826	11	20	29	0	1886
19631	1838	10	14	27	0	1889
19632	98	12	20	1769	0	1899
19633	51	13	1722	73	0	1859
19634	35	8	54	1723	0	1820
19635	23	9	1701	70	0	1803
19636	27	10	1676	45	0	1758
19637	41	1634	63	20	0	1758
19638	24	50	23	1531	0	1628
19639	22	27	8	1616	0	1673
19640	34	21	7	1443	0	1505
19641	25	13	6	1611	0	1655
19642	1546	11	7	74	0	1638
19643	1568	12	3	38	0	1621
19644	80	7	6	1527	0	1620
19645	36	5	1474	65	0	1580
19646	20	3	48	1506	0	1577
19647	19	7	23	1559	0	1608
19648	21	6	1497	71	0	1595
19649	19	6	48	1464	0	1537
19650	1494	6	25	51	0	1576
19651	1527	14	8	31	0	1580
19652	1539	8	1	26	0	1574
19653	68	14	7	1489	0	1578
19654	1455	6	7	64	0	1532
19655	1465	3	5	30	0	1503
19656	66	6	1436	20	0	1528
19657	21	5	1105	5	0	1136
19658	11	2	1091	6	0	1110
19659	896	1	24	2	0	923
19660	22	928	5	5	0	960
19661	914	19	2	5	0	940
19662	19	966	6	2	0	993
19663	5	19	5	978	0	1007
19664	6	5	2	1019	0	1032
19665	3	3	2	1021	0	1029
19666	4	3	992	25	0	1024
19667	900	1	20	9	0	930
19668	24	3	6	992	0	1025
19669	7	0	947	20	0	974
19670	2	3	896	8	0	909
19671	860	0	22	6	0	888
19672	17	933	8	4	0	962
19673	958	18	0	2	0	978
19674	955	6	1	3	0	965
19675	22	938	3	3	0	966
19676	889	16	1	4	0	910
19677	20	8	916	0	0	944
19678	7	1	870	2	0	880
19679	3	3	901	3	0	910
19680	5	0	21	942	0	968
19681	4	3	990	20	0	1017
19682	939	1	18	6	0	964
19683	997	0	5	1	0	1003
19684	25	2	986	0	0	1013
19685	6	0	17	981	0	1004
19686	994	0	7	18	0	1019
19687	18	1100	3	7	0	1128
19688	7	1137	2	1	0	1147
19689	1134	23	0	2	0	1159
19690	6	4	1130	2	0	1142
19691	4	1	3	1079	0	1087
19692	1	0	3	1116	0	1120
19693	1	0	1	1133	0	1135
19694	1	1170	2	8	0	1181
19695	3	2	0	1156	0	1161
19696	1246	4	1	6	0	1257
19697	3	1	0	1276	0	1280
19698	9	1265	5	5	0	1284
19699	1287	5	0	10	0	1302
19700	5	7	0	1300	0	1312
19701	8	0	0	1320	0	1328
19702	1356	0	0	13	0	1369
19703	1377	1	0	11	0	1389
19704	15	1	1	1364	0	1381
19705	1410	0	1	8	0	1419
19706	1445	0	1	15	0	1461
19707	25	1474	1	0	0	1500
19708	1477	11	0	4	0	1492
19709	11	1476	1	0	0	1488
19710	18	10	3	1472	0	1503
19711	4	19	1543	12	0	1578
19712	2	2	11	1556	0	1571
19713	1	1	15	1572	0	1589
19714	2	0	0	1619	0	1621
19715	1594	0	0	28	0	1622
19716	14	1585	5	20	0	1624
19717	1639	12	0	7	0	1658
19718	12	1741	3	3	0	1759
19719	1776	15	0	25	0	1816
19720	1789	17	0	5	0	1811
19721	1806	2	1	3	0	1812
19722	1763	1	3	3	0	1770
19723	31	4	1766	3	0	1804
19724	22	0	15	1773	0	1810
19725	6	0	19	1969	0	1994
19726	4	4	1917	44	0	1969
19727	1828	3	24	29	0	1884
19728	28	0	26	1865	0	1919
19729	28	5	1837	26	0	1896
19730	8	5	1819	28	0	1860
19731	7	2	47	1882	0	1938
19732	6	4	2037	32	0	2079
19733	3	0	29	2031	0	2063
19734	5	1	28	2052	0	2086
19735	5	4	2019	50	0	2078
19736	1884	2	26	35	0	1947
19737	30	0	27	2042	0	2099
19738	30	11	2029	33	0	2103
19739	7	4	28	2076	0	2115
19740	2074	2	27	32	0	2135
19741	29	5	2055	33	0	2122
19742	2047	2	29	10	0	2088
19743	2125	1	29	12	0	2167
19744	58	1	4	2116	0	2179
19745	33	4	6	2123	0	2166
19746	11	5	2103	56	0	2175
19747	10	3	26	2121	0	2160
19748	5	3	33	2017	0	2058
19749	8	3	5	2161	0	2177
19750	9	5	2067	58	0	2139
19751	1994	2	25	44	0	2065
19752	2079	1	33	13	0	2126
19753	2135	5	8	12	0	2160
19754	2180	5	7	9	0	2201
19755	67	5	5	2133	0	2210
19756	2154	4	4	34	0	2196
19757	2184	1	8	41	0	2234
19758	1909	15	14	15	0	1953
19759	2212	2	7	13	0	2234
19760	57	2152	14	11	0	2234
19761	2212	23	7	16	0	2258
19762	2201	27	7	18	0	2253
19763	64	2172	14	17	0	2267
19764	2231	30	8	13	0	2282
19765	38	30	10	2228	0	2306
19766	39	6	8	2246	0	2299
19767	2188	5	11	68	0	2272
19768	39	2185	13	42	0	2279
19769	42	2220	13	14	0	2289
19770	15	59	8	2291	0	2373
19771	15	37	2296	44	0	2392
19772	14	4	34	2297	0	2349
19773	17	4	37	2306	0	2364
19774	2290	3	10	70	0	2373
19775	2319	5	10	42	0	2376
19776	68	3	7	2312	0	2390
19777	43	10	2286	46	0	2385
19778	19	3	39	2319	0	2380
19779	2309	1	38	46	0	2394
19780	44	4	2377	47	0	2472
19781	45	2337	47	15	0	2444
19782	2366	35	40	19	0	2460
19783	48	32	13	2349	0	2442
19784	49	6	11	2373	0	2439
19785	18	2	3	2449	0	2472
19786	16	3	2358	78	0	2455
19787	2004	2	43	56	0	2105
19788	49	9	2231	17	0	2306
19789	54	2190	50	9	0	2303
19790	22	31	38	2288	0	2379
19791	20	37	8	2320	0	2385
19792	17	6	8	2511	0	2542
19793	18	8	2416	98	0	2540
19794	21	6	2344	53	0	2424
19795	16	7	2403	13	0	2439
19796	10	2356	85	18	0	2469
19797	15	45	46	2321	0	2427
19798	2380	39	10	54	0	2483
19799	2461	6	7	48	0	2522
19800	99	9	2682	16	0	2806
19801	49	2812	59	24	0	2944
19802	22	55	2887	14	0	2978
19803	10	3026	61	16	0	3113
19804	2938	59	43	12	0	3052
19805	2934	42	7	10	0	2993
19806	96	2864	13	12	0	2985
19807	2890	57	6	13	0	2966
19808	73	42	9	2815	0	2939
19809	49	8	9	2864	0	2930
19810	2841	6	5	96	0	2948
19811	2777	6	2	49	0	2834
19812	2767	8	2	20	0	2797
19813	105	2671	7	13	0	2796
19814	52	2740	13	15	0	2820
19815	2735	86	9	14	0	2844
19816	56	47	2743	19	0	2865
19817	51	30	53	2667	0	2801
19818	2585	6	43	58	0	2692
19819	65	2496	11	46	0	2618
19820	43	2673	13	18	0	2747
19821	2672	92	4	11	0	2779
19822	65	45	2603	29	0	2742
19823	2480	18	48	11	0	2557
19824	64	5	2521	9	0	2599
19825	36	8	2387	5	0	2436
19826	13	6	71	2311	0	2401
19827	8	11	2505	41	0	2565
19828	2470	5	46	36	0	2557
19829	2592	5	34	16	0	2647
19830	2705	6	12	10	0	2733
19831	2647	5	6	16	0	2674
19832	80	4	7	2538	0	2629
19833	2515	8	3	49	0	2575
19834	47	2472	13	36	0	2568
19835	46	45	5	2328	0	2424
19836	8	2509	20	36	0	2573
19837	2539	43	7	39	0	2628
19838	2545	32	8	13	0	2598
19839	81	7	8	2515	0	2611
19840	2541	8	8	46	0	2603
19841	2546	3	7	36	0	2592
19842	80	8	9	2456	0	2553
19843	47	9	7	2477	0	2540
19844	23	6	6	2512	0	2547
19845	17	7	2419	76	0	2519
19846	17	8	2330	39	0	2394
19847	14	14	2436	11	0	2475
19848	15	16	74	2371	0	2476
19849	22	7	2505	44	0	2578
19850	17	9	52	2459	0	2537
19851	21	12	2649	53	0	2735
19852	17	9	2586	39	0	2651
19853	2416	7	76	15	0	2514
19854	51	2543	42	14	0	2650
19855	2578	45	13	15	0	2651
19856	56	35	7	2545	0	2643
19857	51	8	8	2510	0	2577
19858	15	11	2501	77	0	2604
19859	14	2492	52	50	0	2608
19860	17	47	40	2591	0	2695
19861	15	44	2598	49	0	2706
19862	17	2596	52	36	0	2701
19863	20	44	39	2602	0	2705
19864	2553	33	11	54	0	2651
19865	2608	8	9	36	0	2661
19866	80	13	15	2584	0	2692
19867	2607	8	6	51	0	2672
19868	52	2575	16	43	0	2686
19869	52	43	15	2651	0	2761
19870	26	45	2722	52	0	2845
19871	23	9	49	2708	0	2789
19872	21	10	2738	54	0	2823
19873	2554	10	51	45	0	2660
19874	63	10	33	2651	0	2757
19875	51	2744	12	49	0	2856
19876	43	48	17	2753	0	2861
19877	19	35	2715	69	0	2838
19878	21	12	2711	45	0	2789
19879	21	13	2711	15	0	2760
19880	2411	17	74	12	0	2514
19881	51	2602	34	15	0	2702
19882	36	45	15	2526	0	2622
19883	2557	30	12	52	0	2651
19884	43	2540	19	35	0	2637
19885	2651	38	16	21	0	2726
19886	2683	25	16	12	0	2736
19887	2717	11	8	13	0	2749
19888	2733	5	14	8	0	2760
19889	81	9	2667	10	0	2767
19890	2530	4	46	15	0	2595
19891	50	10	2668	9	0	2737
19892	2126	10	53	11	0	2200
19893	46	6	22	2496	0	2570
19894	33	6	2476	34	0	2549
19895	13	2454	29	23	0	2519
19896	13	76	18	2313	0	2420
19897	14	2417	11	28	0	2470
19898	15	2457	8	18	0	2498
19899	2176	33	3	9	0	2221
19900	28	19	2100	7	0	2154
19901	17	2060	22	4	0	2103
19902	1970	14	12	7	0	2003
19903	17	2035	6	3	0	2061
19904	1974	15	1	3	0	1993
19905	15	10	3	1948	0	1976
19906	1992	1	2	15	0	2010
19907	11	3	3	1978	0	1995
19908	2041	2	2	25	0	2070
19909	15	1	3	2053	0	2072
19910	10	2318	5	35	0	2368
19911	10	16	0	2385	0	2411
19912	2367	8	2	17	0	2394
19913	11	2370	4	13	0	2398
19914	12	10	3	2371	0	2396
19915	2396	11	2	18	0	2427
19916	16	1	1	2420	0	2438
19917	10	1	5	2411	0	2427
19918	4	4	2433	23	0	2464
19919	5	6	2391	12	0	2414
19920	5	3	20	2314	0	2342
19921	4	9	2381	12	0	2406
19922	6	3	10	2369	0	2388
19923	8	2	10	2242	0	2262
19924	2	3	1	2424	0	2430
19925	4	8	2368	24	0	2404
19926	5	4	12	2284	0	2305
19927	5	1	10	2254	0	2270
19928	3	2264	3	23	0	2293
19929	6	13	0	2291	0	2310
19930	2201	9	2	21	0	2233
19931	14	1	5	2295	0	2315
19932	11	5	2917	18	0	2951
19933	2773	2	45	20	0	2840
19934	41	3140	32	8	0	3221
19935	37	48	11	3176	0	3272
19936	20	43	3160	48	0	3271
19937	2916	19	49	46	0	3030
19938	45	3159	46	21	0	3271
19939	3248	49	15	10	0	3322
19940	65	40	8	3199	0	3312
19941	3220	17	4	51	0	3292
19942	74	7	3187	49	0	3317
19943	46	3149	54	21	0	3270
19944	20	3531	46	12	0	3609
19945	3574	85	16	14	0	3689
19946	3605	51	5	9	0	3670
19947	90	25	3559	9	0	3683
19948	3475	8	52	8	0	3543
19949	3531	3	45	16	0	3595
19950	3514	5	17	11	0	3547
19951	97	3407	20	4	0	3528
19952	59	3478	9	4	0	3550
19953	3429	91	5	8	0	3533
19954	3415	53	7	9	0	3484
19955	98	3463	6	4	0	3571
19956	54	60	14	3480	0	3608
19957	39	43	3492	54	0	3628
19958	3352	18	50	44	0	3464
19959	3174	15	54	27	0	3270
19960	3600	16	24	11	0	3651
19961	95	3583	15	5	0	3698
19962	64	59	3549	3	0	3675
19963	3560	40	47	9	0	3656
19964	62	32	62	3601	0	3757
19965	56	8	17	3659	0	3740
19966	29	8	17	3709	0	3763
19967	29	11	3678	100	0	3818
19968	13	5	51	3621	0	3690
19969	21	8	3622	67	0	3718
19970	9	3507	70	43	0	3629
19971	3411	48	62	23	0	3544
19972	59	3478	25	12	0	3574
19973	38	3560	9	19	0	3626
19974	3528	82	8	23	0	3641
19975	52	3550	17	21	0	3640
19976	50	62	17	3461	0	3590
19977	24	3550	6	58	0	3638
19978	3494	68	13	37	0	3612
19979	47	3558	7	21	0	3633
19980	47	69	8	3549	0	3673
19981	29	54	3469	50	0	3602
19982	17	32	48	3523	0	3620
19983	21	3537	40	65	0	3663
19984	8	72	19	3618	0	3717
19985	12	38	12	3584	0	3646
19986	16	34	10	3585	0	3645
19987	28	15	4	3678	0	3725
19988	11	24	7	3657	0	3699
19989	16	8	9	3675	0	3708
19990	16	11	3613	113	0	3753
19991	3318	10	53	79	0	3460
19992	66	20	48	3663	0	3797
19993	50	10	3640	85	0	3785
19994	39	13	3620	71	0	3743
19995	22	16	105	3648	0	3791
19996	3659	16	68	86	0	3829
19997	66	15	3617	68	0	3766
19998	3506	12	63	46	0	3627
19999	81	16	3823	18	0	3938
20000	80	25	78	3747	0	3930
20001	37	15	56	3902	0	4010
20002	35	19	3848	97	0	3999
20003	3444	15	77	65	0	3601
20004	73	11	56	3738	0	3878
20005	75	24	3743	65	0	3907
20006	44	11	3771	58	0	3884
20007	57	13	102	3461	0	3633
20008	16	3689	90	63	0	3858
20009	3752	55	33	59	0	3899
20010	3545	48	22	39	0	3654
20011	114	36	3514	11	0	3675
20012	90	20	59	3407	0	3576
20013	3503	13	56	80	0	3652
20014	69	25	3506	65	0	3665
20015	3397	7	80	33	0	3517
20016	93	3473	59	32	0	3657
20017	64	65	26	3575	0	3730
20018	49	55	23	3621	0	3748
20019	3726	29	18	109	0	3882
20020	99	12	25	3789	0	3925
20021	67	18	12	3811	0	3908
20022	51	13	14	3849	0	3927
20023	3696	14	21	141	0	3872
20024	89	11	3751	90	0	3941
20025	3743	23	72	52	0	3890
20026	3832	9	59	43	0	3943
20027	3911	11	34	35	0	3991
20028	161	14	14	3823	0	4012
20029	91	23	3827	93	0	4034
20030	39	3753	74	87	0	3953
20031	26	3778	66	38	0	3908
20032	19	3210	16	14	0	3259
20033	9	66	3196	17	0	3288
20034	17	124	34	3444	0	3619
20035	3603	8	34	58	0	3703
20036	3896	6	10	64	0	3976
20037	111	2	9	4125	0	4247
20038	73	6	4127	67	0	4273
20039	27	8	4108	89	0	4232
20040	12	2	125	4202	0	4341
20041	13	5	4264	85	0	4367
20042	15	1	85	4304	0	4405
20043	7	4	85	4121	0	4217
20044	11	4045	24	139	0	4219
20045	18	70	11	4150	0	4249
20046	17	74	12	4211	0	4314
20047	4142	13	18	165	0	4338
20048	81	1	18	4237	0	4337
20049	94	3	8	4208	0	4313
20050	4052	5	14	169	0	4240
20051	82	4069	26	102	0	4279
20052	4180	70	23	33	0	4306
20053	95	83	4072	45	0	4295
20054	4122	19	89	26	0	4256
20055	4113	6	94	21	0	4234
20056	160	14	4076	25	0	4275
20057	107	19	4037	24	0	4187
20058	50	9	155	3868	0	4082
20059	3893	2	104	91	0	4090
20060	92	9	3879	94	0	4074
20061	93	6	97	3854	0	4050
20062	27	11	3913	96	0	4047
20063	22	6	110	3848	0	3986
20064	35	10	90	3864	0	3999
20065	3859	10	34	173	0	4076
20066	3894	10	22	135	0	4061
20067	3954	8	25	53	0	4040
20068	182	13	3862	48	0	4105
20069	111	14	3813	49	0	3987
20070	45	14	176	3769	0	4004
20071	47	18	108	3809	0	3982
20072	37	14	40	3949	0	4040
20073	3740	18	34	197	0	3989
20074	106	3755	35	135	0	4031
20075	3816	80	30	54	0	3980
20076	3624	91	28	53	0	3796
20077	169	3638	42	60	0	3909
20078	122	3693	34	57	0	3906
20079	3664	150	34	60	0	3908
20080	102	98	39	3535	0	3774
20081	127	3624	38	134	0	3923
20082	78	73	37	3691	0	3879
20083	75	93	3600	132	0	3900
20084	70	13	110	3636	0	3829
20085	3568	15	138	143	0	3864
20086	120	20	3524	141	0	3805
20087	131	24	3517	84	0	3756
20088	72	25	201	3065	0	3363
20089	58	3294	155	134	0	3641
20090	46	3348	61	159	0	3614
20091	56	3454	54	103	0	3667
20092	3408	147	58	100	0	3713
20093	3436	95	43	110	0	3684
20094	3428	26	42	119	0	3615
20095	201	3318	48	112	0	3679
20096	3468	75	46	102	0	3691
20097	3409	90	50	96	0	3645
20098	208	52	3354	82	0	3696
20099	165	3112	119	79	0	3475
20100	99	100	122	3154	0	3475
20101	3169	86	68	132	0	3455
20102	148	43	3126	163	0	3480
20103	153	27	127	3026	0	3333
20104	79	3092	141	162	0	3474
20105	92	85	84	3153	0	3414
20106	99	94	66	3190	0	3449
20107	3177	37	71	217	0	3502
20108	3203	28	78	166	0	3475
20109	198	48	73	3149	0	3468
20110	154	48	3059	161	0	3422
20111	101	43	3052	157	0	3353
20112	3056	29	172	119	0	3376
20113	173	50	3112	92	0	3427
20114	194	41	128	2633	0	2996
20115	116	2855	144	121	0	3236
20116	2888	78	89	133	0	3188
20117	151	2843	78	94	0	3166
20118	2897	91	83	105	0	3176
20119	149	97	69	2823	0	3138
20120	149	50	67	2805	0	3071
20121	2811	46	48	181	0	3086
20122	2855	52	60	135	0	3102
20123	217	53	52	2787	0	3109
20124	185	56	57	2779	0	3077
20125	113	67	2728	169	0	3077
20126	96	67	2709	125	0	2997
20127	2686	53	161	89	0	2989
20128	135	53	2637	90	0	2915
20129	2658	43	101	86	0	2888
20130	2686	43	95	87	0	2911
20131	189	41	2610	92	0	2932
20132	149	2541	113	85	0	2888
20133	95	2521	107	63	0	2786
20134	64	87	2097	30	0	2278
20135	86	173	131	1774	0	2164
20136	1583	46	159	47	0	1835
20137	1501	10	10	30	0	1551
20138	1650	9	14	26	0	1699
20139	1933	6	14	22	0	1975
20140	1891	9	2	19	0	1921
20141	73	1933	17	29	0	2052
20142	1917	37	7	12	0	1973
20143	43	1912	12	7	0	1974
20144	1860	40	7	4	0	1911
20145	41	29	1787	0	0	1857
20146	27	3	29	1738	0	1797
20147	9	3	23	1659	0	1694
20148	2	1707	9	55	0	1773
20149	1745	32	0	28	0	1805
20150	1763	27	1	5	0	1796
20151	58	2	2	1705	0	1767
20152	30	1	2	1734	0	1767
20153	1709	0	0	59	0	1768
20154	33	3	0	1711	0	1747
20155	28	2	0	1712	0	1742
20156	1683	0	1	63	0	1747
20157	34	0	0	1694	0	1728
20158	1688	0	1	42	0	1731
20159	1672	1	0	31	0	1704
20160	59	5	1658	9	0	1731
20161	1681	1	33	7	0	1722
20162	1683	0	26	7	0	1716
20163	1711	0	3	3	0	1717
20164	61	4	1624	3	0	1692
20165	32	1	34	1588	0	1655
20166	9	29	27	1611	0	1676
20167	4	6	1590	53	0	1653
20168	1550	2	32	28	0	1612
20169	38	2	26	1588	0	1654
20170	32	4	1571	37	0	1644
20171	7	4	1613	28	0	1652
20172	8	2	59	1578	0	1647
20173	5	9	1617	36	0	1667
20174	7	4	37	1599	0	1647
20175	3	4	30	1609	0	1646
20176	8	2	1613	65	0	1688
20177	9	0	39	1499	0	1547
20178	5	1539	35	32	0	1611
20179	11	1623	5	28	0	1667
20180	1590	62	6	5	0	1663
20181	1557	34	1	15	0	1607
20182	70	1554	10	4	0	1638
20183	1591	37	4	7	0	1639
20184	1579	32	2	9	0	1622
20185	75	10	4	1545	0	1634
20186	40	3	4	1591	0	1638
20187	1521	6	4	75	0	1606
20188	45	1499	4	39	0	1587
20189	40	1565	3	8	0	1616
20190	25	68	4	1525	0	1622
20191	15	38	1574	42	0	1669
20192	1463	6	41	50	0	1560
20193	1536	5	31	17	0	1589
20194	1514	6	7	8	0	1535
20195	77	1547	5	13	0	1642
20196	44	45	2	1515	0	1606
20197	19	36	9	1585	0	1649
20198	1581	7	6	82	0	1676
20199	57	1565	3	47	0	1672
20200	56	40	8	1551	0	1655
20201	22	40	9	1597	0	1668
20202	29	7	6	1608	0	1650
20203	1552	8	6	84	0	1650
20204	63	1548	7	49	0	1667
20205	58	50	7	1425	0	1540
20206	19	1546	12	44	0	1621
20207	1503	43	10	48	0	1604
20208	61	40	1499	19	0	1619
20209	1485	6	45	28	0	1564
20210	59	10	1490	18	0	1577
20211	62	9	44	1456	0	1571
20212	1456	8	40	57	0	1561
20213	59	6	1511	49	0	1625
20214	1542	2	46	16	0	1606
20215	1587	4	40	23	0	1654
20216	1626	2	12	19	0	1659
20217	86	3	14	1561	0	1664
20218	54	5	9	1578	0	1646
20219	14	8	11	1622	0	1655
20220	1535	6	8	85	0	1634
20221	55	1523	14	52	0	1644
20222	1532	41	12	12	0	1597
20223	1536	36	8	23	0	1603
20224	82	8	1477	15	0	1582
20225	1481	6	41	9	0	1537
20226	1502	5	42	18	0	1567
20227	85	6	7	1495	0	1593
20228	48	12	12	1508	0	1580
20229	19	8	11	1573	0	1611
20230	1474	8	8	83	0	1573
20231	1439	4	11	52	0	1506
20232	1378	7	6	13	0	1404
20233	66	1291	15	10	0	1382
20234	36	1228	8	14	0	1286
20235	9	1249	7	10	0	1275
20236	1203	59	6	11	0	1279
20237	39	35	1185	10	0	1269
20238	41	2	994	8	0	1045
20239	697	0	33	3	0	733
20240	16	2	759	7	0	784
20241	15	0	9	582	0	606
20242	2	599	12	7	0	620
20243	622	9	1	10	0	642
20244	616	9	3	3	0	631
20245	628	0	1	3	0	632
20246	24	1	0	666	0	691
20247	10	4	680	9	0	703
20248	3	1	674	13	0	691
20249	666	0	17	7	0	690
20250	697	0	10	3	0	710
20251	714	2	0	2	0	718
20252	19	2	0	708	0	729
20253	13	0	0	729	0	742
20254	3	3	710	19	0	735
20255	685	2	9	9	0	705
20256	13	0	9	724	0	746
20257	14	0	0	725	0	739
20258	1	0	2	736	0	739
20259	1	738	2	18	0	759
20260	4	9	0	742	0	755
20261	2	10	1	741	0	754
20262	728	0	0	17	0	745
20263	10	2	728	10	0	750
20264	710	1	8	1	0	720
20265	745	0	9	3	0	757
20266	19	1	0	740	0	760
20267	11	1	1	744	0	757
20268	720	2	1	18	0	741
20269	8	4	713	10	0	735
20270	12	714	9	0	0	735
20271	3	7	8	684	0	702
20272	683	8	2	8	0	701
20273	10	0	0	692	0	702
20274	8	0	694	9	0	711
20275	0	3	709	10	0	722
20276	665	2	15	1	0	683
20277	10	0	8	733	0	751
20278	11	1	733	8	0	753
20279	699	1	5	9	0	714
20280	799	0	6	6	0	811
20281	10	1	1	799	0	811
20282	6	0	1	809	0	816
20283	2	802	2	12	0	818
20284	854	5	1	9	0	869
20285	9	7	0	858	0	874
20286	10	0	1	860	0	871
20287	2	3	890	14	0	909
20288	822	0	7	9	0	838
20289	889	0	7	2	0	898
20290	11	881	3	2	0	897
20291	5	8	849	2	0	864
20292	1	5	869	4	0	879
20293	2	1	9	855	0	867
20294	876	14	5	13	0	908
20295	5	0	1	866	0	872
20296	891	0	1	5	0	897
20297	918	1	1	9	0	929
20298	930	1	0	6	0	937
20299	7	1	1	951	0	960
20300	4	1	0	961	0	966
20301	972	1	0	9	0	982
20302	5	3	1029	3	0	1040
20303	915	0	0	4	0	919
20304	958	0	0	1	0	959
20305	0	3	984	0	0	987
20306	1	4	971	3	0	979
20307	0	985	1	0	0	986
20308	1	0	0	991	0	992
20309	861	2	1	5	0	869
20310	0	0	0	1020	0	1020
20311	0	2	1034	1	0	1037
20312	0	1020	1	1	0	1022
20313	0	972	1	2	0	975
20314	1	0	2	981	0	984
20315	3	0	0	964	0	967
20316	1	1048	2	1	0	1052
20317	0	4	1015	0	0	1019
20318	943	2	0	3	0	948
20319	1038	1	1	1	0	1041
20320	3	1054	0	0	0	1057
20321	1039	2	1	3	0	1045
20322	3	1	1	1037	0	1042
20323	1027	1	0	4	0	1032
20324	3	0	1	1033	0	1037
20325	3	1144	2	5	0	1154
20326	2	11	1165	3	0	1181
20327	2	5	8	1278	0	1293
20328	4	1	6	1300	0	1311
20329	1	1	0	1357	0	1359
20330	1395	0	0	17	0	1412
20331	13	0	0	1387	0	1400
20332	7	2	1471	12	0	1492
20333	0	6	1593	6	0	1605
20334	1569	0	28	3	0	1600
20335	18	2	1611	2	0	1633
20336	1605	0	17	3	0	1625
20337	19	0	11	1665	0	1695
20338	14	0	0	1740	0	1754
20339	2	2	1	1884	0	1889
20340	5	1	2	1855	0	1863
20341	1821	1	5	44	0	1871
20342	26	2	1863	18	0	1909
20343	20	0	26	1788	0	1834
20344	1	1888	20	27	0	1936
20345	1895	24	1	19	0	1939
20346	27	18	0	1828	0	1873
20347	1833	0	2	33	0	1868
20348	27	2	1848	21	0	1898
20349	24	1	29	1747	0	1801
20350	1	1833	25	31	0	1890
20351	1841	26	2	28	0	1897
20352	33	22	1815	8	0	1878
20353	29	1	30	1784	0	1844
20354	6	2	20	1881	0	1909
20355	1861	2	4	52	0	1919
20356	35	3	1857	26	0	1921
20357	24	5	1860	4	0	1893
20358	4	2	51	1841	0	1898
20359	9	5	1859	30	0	1903
20360	9	6	1881	27	0	1923
20361	4	3	48	1811	0	1866
20362	7	1	23	1852	0	1883
20363	7	2	3	1960	0	1972
20364	1922	1	3	60	0	1986
20365	32	1918	12	26	0	1988
20366	1926	27	7	12	0	1972
20367	30	23	8	1884	0	1945
20368	28	1935	9	38	0	2010
20369	8	27	4	2007	0	2046
20370	2103	21	3	37	0	2164
20371	35	2126	14	35	0	2210
20372	31	38	7	2166	0	2242
20373	8	34	2189	48	0	2279
20374	2136	2	44	37	0	2219
20375	46	2	38	2169	0	2255
20376	35	6	6	2213	0	2260
20377	10	9	2137	78	0	2234
20378	12	9	2129	40	0	2190
20379	2033	4	72	19	0	2128
20380	51	2036	40	17	0	2144
20381	43	40	12	2044	0	2139
20382	2068	30	13	58	0	2169
20383	48	6	2083	44	0	2181
20384	38	2027	48	18	0	2131
20385	11	42	35	2026	0	2114
20386	2051	32	11	56	0	2150
20387	2009	5	11	48	0	2073
20388	2037	5	13	24	0	2079
20389	80	1975	12	13	0	2080
20390	40	44	2014	18	0	2116
20391	14	33	49	2014	0	2110
20392	23	13	46	1829	0	1911
20393	20	5	15	2049	0	2089
20394	16	9	7	1975	0	2007
20395	1919	11	7	88	0	2025
20396	1904	3	12	47	0	1966
20397	83	12	1843	21	0	1959
20398	42	12	1824	23	0	1901
20399	1756	7	75	28	0	1866
20400	1817	9	42	15	0	1883
20401	86	7	19	1715	0	1827
20402	43	1712	21	60	0	1836
20403	1712	43	15	50	0	1820
20404	52	1707	16	25	0	1800
20405	44	1707	17	27	0	1795
20406	21	66	15	1770	0	1872
20407	15	35	14	1795	0	1859
20408	16	5	10	1835	0	1866
20409	25	8	13	1811	0	1857
20410	17	14	1718	83	0	1832
20411	1660	8	44	53	0	1765
20412	1739	10	41	30	0	1820
20413	86	15	16	1682	0	1799
20414	44	12	8	1728	0	1792
20415	1699	8	11	85	0	1803
20416	58	17	1626	45	0	1746
20417	1691	6	56	30	0	1783
20418	1723	12	43	24	0	1802
20419	79	18	1625	49	0	1771
20420	1697	8	42	28	0	1775
20421	55	8	37	1697	0	1797
20422	50	6	18	1723	0	1797
20423	29	9	14	1753	0	1805
20424	26	3	17	1717	0	1763
20425	1543	13	11	76	0	1643
20426	55	9	15	1522	0	1601
20427	38	4	13	1363	0	1418
20428	16	1227	13	62	0	1318
20429	14	1295	20	36	0	1365
20430	13	48	4	1268	0	1333
20431	1249	28	7	44	0	1328
20432	46	5	7	1155	0	1213
20433	24	9	974	30	0	1037
20434	8	6	947	27	0	988
20435	925	3	38	10	0	976
20436	29	921	23	9	0	982
20437	861	19	19	12	0	911
20438	30	19	820	6	0	875
20439	15	18	24	695	0	752
20440	689	2	14	17	0	722
20441	20	700	2	13	0	735
20442	690	14	4	7	0	715
20443	17	17	755	8	0	797
20444	16	3	14	749	0	782
20445	7	2	13	801	0	823
20446	813	4	5	31	0	853
20447	826	1	2	18	0	847
20448	846	4	3	6	0	859
20449	844	4	2	5	0	855
20450	850	3	1	10	0	864
20451	29	813	6	6	0	854
20452	13	14	4	835	0	866
20453	839	12	2	21	0	874
20454	20	1	2	831	0	854
20455	18	0	2	827	0	847
20456	11	3	1	841	0	856
20457	11	831	2	24	0	868
20458	835	13	5	11	0	864
20459	16	12	4	825	0	857
20460	780	0	3	21	0	804
20461	767	2	2	16	0	787
20462	26	739	3	9	0	777
20463	744	12	1	9	0	766
20464	17	12	723	5	0	757
20465	719	0	13	3	0	735
20466	17	0	21	705	0	743
20467	15	2	767	15	0	799
20468	6	783	13	10	0	812
20469	4	14	760	6	0	784
20470	3	624	10	2	0	639
20471	599	5	2	3	0	609
20472	602	3	14	2	0	621
20473	571	0	1	0	0	572
20474	5	581	2	1	0	589
20475	558	2	1	0	0	561
20476	3	3	589	1	0	596
20477	3	0	597	0	0	600
20478	0	3	2	592	0	597
20479	2	0	1	620	0	623
20480	0	603	3	3	0	609
20481	606	0	0	5	0	611
20482	0	2	0	614	0	616
20483	2	646	2	1	0	651
20484	1	0	0	668	0	669
20485	662	2	0	0	0	664
20486	640	0	0	2	0	642
20487	4	1	613	2	0	620
20488	3	2	0	620	0	625
20489	2	0	632	1	0	635
20490	1	1	0	606	0	608
20491	1	0	618	0	0	619
20492	1	0	0	602	0	603
20493	1	1	614	1	0	617
20494	1	0	0	601	0	602
20495	1	1	629	4	0	635
20496	1	0	1	605	0	607
20497	1	0	2	632	0	635
20498	0	677	2	3	0	682
20499	0	1	0	680	0	681
20500	1	3	677	0	0	681
20501	1	0	0	672	0	673
20502	0	1	2	682	0	685
20503	698	0	0	4	0	702
20504	2	0	0	704	0	706
20505	3	0	0	696	0	699
20506	1	0	671	5	0	677
20507	635	0	2	4	0	641
20508	0	0	3	692	0	695
20509	5	0	0	706	0	711
20510	1	0	1	716	0	718
20511	708	0	0	10	0	718
20512	2	0	1	711	0	714
20513	3	2	0	713	0	718
20514	702	1	1	5	0	709
20515	0	719	0	6	0	725
20516	3	1	0	713	0	717
20517	0	4	0	716	0	720
20518	2	3	702	4	0	711
20519	516	1	2	10	0	529
20520	0	2	3	709	0	714
20521	3	2	676	5	0	686
20522	697	0	2	3	0	702
20523	2	0	2	761	0	765
20524	4	0	2	754	0	760
20525	0	1	1	768	0	770
20526	2	0	1	767	0	770
20527	1	1	891	4	0	897
20528	3	0	4	894	0	901
20529	1	0	6	1205	0	1212
20530	2	5	1349	22	0	1378
20531	1378	3	18	19	0	1418
20532	1447	0	25	10	0	1482
20533	1468	1	10	2	0	1481
20534	57	4	2	1423	0	1486
20535	1476	0	1	25	0	1502
20536	1464	0	0	28	0	1492
20537	53	2	1	1440	0	1496
20538	1516	0	2	25	0	1543
20539	1522	0	3	33	0	1558
20540	1543	0	3	7	0	1553
20541	1556	0	2	7	0	1565
20542	59	1	2	1450	0	1512
20543	38	1411	3	26	0	1478
20544	16	1434	3	28	0	1481
20545	6	1460	0	16	0	1482
20546	1375	55	3	7	0	1440
20547	1431	34	1	4	0	1470
20548	53	19	1411	6	0	1489
20549	1455	5	23	5	0	1488
20550	41	2	30	1448	0	1521
20551	38	1	11	1477	0	1527
20552	19	0	4	1512	0	1535
20553	1481	0	2	65	0	1548
20554	30	1	2	1504	0	1537
20555	35	1460	5	37	0	1537
20556	15	23	1	1506	0	1545
20557	8	33	1507	36	0	1584
20558	11	9	24	1525	0	1569
20559	1504	7	30	41	0	1582
20560	34	4	1503	33	0	1574
20561	42	3	26	1504	0	1575
20562	17	3	32	1497	0	1549
20563	14	3	13	1512	0	1542
20564	11	1505	6	66	0	1588
20565	15	23	2	1551	0	1591
20566	1529	29	1	39	0	1598
20567	1469	10	3	44	0	1526
20568	65	3	1409	22	0	1499
20569	50	7	1435	8	0	1500
20570	26	4	54	1405	0	1489
20571	17	6	39	1452	0	1514
20572	12	9	1433	60	0	1514
20573	15	5	29	1313	0	1362
20574	17	1404	39	38	0	1498
20575	1472	25	8	45	0	1550
20576	1430	34	6	23	0	1493
20577	1453	13	6	16	0	1488
20578	73	13	1408	11	0	1505
20579	54	2	27	1434	0	1517
20580	28	6	1441	33	0	1508
20581	1358	3	42	46	0	1449
20582	39	1404	41	19	0	1503
20583	41	31	12	1373	0	1457
20584	1380	37	6	39	0	1462
20585	39	14	9	1405	0	1467
20586	40	2	8	1417	0	1467
20587	21	8	1372	74	0	1475
20588	1327	7	32	51	0	1417
20589	41	1396	40	26	0	1503
20590	40	30	18	1430	0	1518
20591	1435	32	3	46	0	1516
20592	47	11	8	1464	0	1530
20593	1467	5	8	51	0	1531
20594	51	1454	6	49	0	1560
20595	1488	32	9	25	0	1554
20596	56	38	1486	19	0	1599
20597	1496	14	38	16	0	1564
20598	1502	3	41	20	0	1566
20599	1572	10	20	21	0	1623
20600	98	3	7	1520	0	1628
20601	69	9	9	1481	0	1568
20602	41	7	6	1530	0	1584
20603	25	1501	7	82	0	1615
20604	1535	37	9	58	0	1639
20605	60	33	7	1522	0	1622
20606	57	13	9	1557	0	1636
20607	38	8	9	1588	0	1643
20608	1543	7	14	77	0	1641
20609	57	5	9	1546	0	1617
20610	53	9	1483	62	0	1607
20611	28	1479	39	58	0	1604
20612	22	43	35	1526	0	1626
20613	17	48	18	1538	0	1621
20614	21	18	6	1578	0	1623
20615	19	13	1486	89	0	1607
20616	29	7	1515	57	0	1608
20617	26	6	72	1518	0	1622
20618	23	9	1605	55	0	1692
20619	22	4	43	1619	0	1688
20620	1608	8	40	65	0	1721
20621	1675	3	17	71	0	1766
20622	1654	10	11	37	0	1712
20623	90	15	1555	28	0	1688
20624	1580	16	37	16	0	1649
20625	62	7	43	1611	0	1723
20626	56	3	1583	56	0	1698
20627	27	4	1523	50	0	1604
20628	22	1494	66	34	0	1616
20629	7	1192	37	12	0	1248
20630	954	24	51	12	0	1041
20631	11	9	4	947	0	971
20632	12	2	932	18	0	964
20633	9	2	13	969	0	993
20634	998	1	7	20	0	1026
20635	17	4	1125	14	0	1160
20636	1133	2	18	10	0	1163
20637	1247	1	17	6	0	1271
20638	1237	1	3	10	0	1251
20639	34	1210	5	4	0	1253
20640	1257	14	4	8	0	1283
20641	19	17	5	1243	0	1284
20642	18	5	3	1242	0	1268
20643	8	4	1	1264	0	1277
20644	4	3	3	1256	0	1266
20645	1199	1	4	34	0	1238
20646	19	1194	8	24	0	1245
20647	19	1180	4	7	0	1210
20648	7	1179	2	7	0	1195
20649	1199	28	3	8	0	1238
20650	1196	15	25	5	0	1241
20651	1208	2	3	6	0	1219
20652	1206	2	2	3	0	1213
20653	39	4	3	1169	0	1215
20654	24	1	0	1174	0	1199
20655	1156	1	1	39	0	1197
20656	17	1162	6	24	0	1209
20657	1135	17	3	8	0	1163
20658	1152	15	3	3	0	1173
20659	35	2	3	1135	0	1175
20660	22	1149	3	19	0	1193
20661	7	19	2	1191	0	1219
20662	1176	16	2	25	0	1219
20663	23	12	1253	18	0	1306
20664	27	2	19	1230	0	1278
20665	6	1284	21	19	0	1330
20666	1277	18	6	21	0	1322
20667	1270	18	3	12	0	1303
20668	33	8	1304	10	0	1355
20669	26	1257	20	3	0	1306
20670	23	27	1284	0	0	1334
20671	7	21	16	1254	0	1298
20672	8	8	1292	17	0	1325
20673	9	2	1289	21	0	1321
20674	4	1300	34	5	0	1343
20675	1294	13	16	6	0	1329
20676	1303	16	3	5	0	1327
20677	26	1321	5	7	0	1359
20678	17	1333	3	4	0	1357
20679	9	30	1286	3	0	1328
20680	6	23	1285	3	0	1317
20681	6	9	1338	3	0	1356
20682	5	3	29	1386	0	1423
20683	6	4	1435	18	0	1463
20684	5	3	19	1410	0	1437
20685	4	2	20	1404	0	1430
20686	3	4	1432	36	0	1475
20687	3	1436	20	19	0	1478
20688	6	14	17	1414	0	1451
20689	1395	17	2	15	0	1429
20690	21	3	4	1423	0	1451
20691	26	8	1411	19	0	1464
20692	6	1409	15	21	0	1451
20693	10	1498	20	8	0	1536
20694	9	33	9	1433	0	1484
20695	1453	27	6	20	0	1506
20696	1472	7	4	29	0	1512
20697	44	1	4	1442	0	1491
20698	29	1534	12	20	0	1595
20699	11	19	4	1520	0	1554
20700	8	27	2	1568	0	1605
20701	6	9	3	1584	0	1602
20702	1601	4	3	53	0	1661
20703	21	1573	12	34	0	1640
20704	1605	19	4	12	0	1640
20705	1590	28	7	4	0	1629
20706	1600	6	4	12	0	1622
20707	1635	7	7	7	0	1656
20708	56	4	3	1574	0	1637
20709	40	11	1590	27	0	1668
20710	11	1637	23	33	0	1704
20711	1663	25	31	10	0	1729
20712	1665	31	8	9	0	1713
20713	1692	7	5	10	0	1714
20714	56	13	1628	6	0	1703
20715	1639	6	24	9	0	1678
20716	1653	2	36	6	0	1697
20717	61	5	3	1636	0	1705
20718	40	6	1547	28	0	1621
20719	12	1535	29	31	0	1607
20720	10	27	29	1542	0	1608
20721	1513	34	1	28	0	1576
20722	30	3	5	1550	0	1588
20723	37	5	4	1578	0	1624
20724	1618	5	4	53	0	1680
20725	32	4	1616	38	0	1690
20726	1680	7	28	11	0	1726
20727	1612	5	37	6	0	1660
20728	1627	2	4	10	0	1643
20729	1621	4	7	8	0	1640
20730	67	9	1575	7	0	1658
20731	41	4	26	1567	0	1638
20732	12	6	1642	26	0	1686
20733	12	4	22	1601	0	1639
20734	11	3	1586	26	0	1626
20735	1339	2	25	33	0	1399
20736	20	1369	33	8	0	1430
20737	29	1366	3	5	0	1403
20738	13	49	1	1752	0	1815
20739	11	27	4	1704	0	1746
20740	10	1844	10	71	0	1935
20741	1855	42	2	37	0	1936
20742	2018	35	5	5	0	2063
20743	2113	2	0	8	0	2123
20744	2184	1	2	7	0	2194
20745	95	0	1	2118	0	2214
20746	49	4	4	2203	0	2260
20747	2162	5	2	101	0	2270
20748	65	1	2	2191	0	2259
20749	48	3	2094	60	0	2205
20750	8	9	2126	50	0	2193
20751	7	4	87	2118	0	2216
20752	9	5	2159	57	0	2230
20753	2150	3	56	48	0	2257
20754	57	3	45	2196	0	2301
20755	2240	1	5	58	0	2304
20756	59	2	2198	50	0	2309
20757	62	1	54	2171	0	2288
20758	8	2	2239	55	0	2304
20759	11	2184	59	52	0	2306
20760	2195	48	51	12	0	2306
20761	2193	43	4	15	0	2255
20762	101	2142	14	9	0	2266
20763	2195	49	7	17	0	2268
20764	65	44	3	2139	0	2251
20765	58	4	7	2195	0	2264
20766	2126	2	8	108	0	2244
20767	58	2105	10	57	0	2230
20768	54	2154	14	16	0	2238
20769	23	102	8	2086	0	2219
20770	2104	52	4	63	0	2223
20771	2154	6	7	55	0	2222
20772	2153	6	6	16	0	2181
20773	109	9	2060	14	0	2192
20774	61	8	2021	16	0	2106
20775	23	2010	97	10	0	2140
20776	2035	53	47	12	0	2147
20777	76	50	12	1963	0	2101
20778	2017	10	13	65	0	2105
20779	2004	4	9	59	0	2076
20780	119	5	8	1946	0	2078
20781	67	11	1974	66	0	2118
20782	1910	2	60	59	0	2031
20783	76	5	53	1893	0	2027
20784	65	13	1882	66	0	2026
20785	1881	6	61	62	0	2010
20786	1892	5	78	32	0	2007
20787	116	5	11	1885	0	2017
20788	72	10	1851	66	0	1999
20789	26	6	61	1796	0	1889
20790	21	1824	72	62	0	1979
20791	35	55	1836	55	0	1981
20792	28	1895	68	22	0	2013
20793	1832	51	54	15	0	1952
20794	1860	45	19	11	0	1935
20795	1876	9	10	23	0	1918
20796	1857	9	15	18	0	1899
20797	116	10	12	1759	0	1897
20798	1721	9	8	66	0	1804
20799	72	10	11	1710	0	1803
20800	1643	14	12	57	0	1726
20801	70	1592	14	54	0	1730
20802	57	48	12	1492	0	1609
20803	23	1579	17	55	0	1674
20804	1572	49	7	48	0	1676
20805	1598	36	5	20	0	1659
20806	93	1551	22	19	0	1685
20807	62	49	8	1548	0	1667
20808	26	45	1536	52	0	1659
20809	26	19	47	1548	0	1640
20810	27	9	1520	61	0	1617
20811	37	9	48	1359	0	1453
20812	19	1457	41	42	0	1559
20813	1493	47	14	42	0	1596
20814	1528	37	16	14	0	1595
20815	96	6	10	1483	0	1595
20816	1630	10	11	58	0	1709
20817	76	8	13	1605	0	1702
20818	50	7	11	1620	0	1688
20819	29	6	10	1664	0	1709
20820	1587	6	9	89	0	1691
20821	1478	6	8	55	0	1547
20822	1516	11	10	16	0	1553
20823	85	1416	19	18	0	1538
20824	1413	36	13	13	0	1475
20825	53	1359	11	12	0	1435
20826	1359	40	10	13	0	1422
20827	53	30	7	1304	0	1394
20828	47	10	9	1350	0	1416
20829	1323	6	13	68	0	1410
20830	1362	9	4	47	0	1422
20831	70	1331	14	17	0	1432
20832	1289	36	8	13	0	1346
20833	50	29	2	1249	0	1330
20834	40	6	10	1278	0	1334
20835	1254	6	5	65	0	1330
20836	57	7	1214	31	0	1309
20837	38	1177	37	22	0	1274
20838	16	17	18	925	0	976
20839	23	18	920	20	0	981
20840	14	67	11	815	0	907
20841	872	4	16	19	0	911
20842	10	744	6	17	0	777
20843	14	666	2	7	0	689
20844	18	614	3	5	0	640
20845	20	37	4	536	0	597
20846	545	8	0	4	0	557
20847	2	1	0	476	0	479
20848	473	0	1	3	0	477
20849	469	0	2	5	0	476
20850	10	0	0	469	0	479
20851	415	0	1	2	0	418
20852	4	1	0	406	0	411
20853	3	1	380	2	0	386
20854	370	1	1	3	0	375
20855	3	0	443	1	0	447
20856	397	1	0	1	0	399
20857	2	1	424	0	0	427
20858	3	1	0	397	0	401
20859	1	0	2	404	0	407
20860	401	1	0	2	0	404
20861	2	0	0	398	0	400
20862	416	0	0	2	0	418
20863	2	384	2	3	0	391
20864	393	2	0	0	0	395
20865	3	3	0	392	0	398
20866	3	1	0	396	0	400
20867	2	0	0	399	0	401
20868	0	0	0	397	0	397
20869	0	0	390	6	0	396
20870	2	1	378	3	0	384
20871	1	0	5	381	0	387
20872	0	2	393	1	0	396
20873	1	383	2	5	0	391
20874	1	1	4	388	0	394
20875	0	3	415	3	0	421
20876	1	0	385	2	0	388
20877	0	0	5	373	0	378
20878	2	0	3	377	0	382
20879	0	390	0	5	0	395
20880	1	1	0	399	0	401
20881	0	3	352	1	0	356
20882	316	0	1	4	0	321
20883	1	1	4	344	0	350
20884	357	0	0	2	0	359
20885	350	0	0	4	0	354
20886	457	0	0	6	0	463
20887	4	0	472	2	0	478
20888	4	0	462	2	0	468
20889	369	2	5	2	0	378
20890	1	0	473	1	0	475
20891	3	0	1	438	0	442
20892	0	0	4	450	0	454
20893	0	1	463	5	0	469
20894	0	465	1	5	0	471
20895	492	1	5	1	0	499
20896	1	510	2	0	0	513
20897	3	545	1	1	0	550
20898	552	4	1	1	0	558
20899	1	6	657	0	0	664
20900	5	1	671	1	0	678
20901	0	0	12	662	0	674
20902	681	0	7	4	0	692
20903	4	689	1	8	0	702
20904	691	5	0	1	0	697
20905	5	8	698	2	0	713
20906	7	686	4	1	0	698
20907	0	5	7	698	0	710
20908	1	8	728	4	0	741
20909	2	0	3	722	0	727
20910	3	1	8	646	0	658
20911	2	1	0	755	0	758
20912	1	1	1	756	0	759
20913	739	0	3	14	0	756
20914	740	1	2	11	0	754
20915	17	2	765	0	0	784
20916	647	1	7	6	0	661
20917	5	674	10	2	0	691
20918	688	6	1	1	0	696
20919	5	12	671	1	0	689
20920	12	2	6	699	0	719
20921	4	3	716	10	0	733
20922	2	5	684	12	0	703
20923	4	1	17	674	0	696
20924	3	0	13	690	0	706
20925	2	1	693	20	0	716
20926	2	677	10	12	0	701
20927	0	700	15	1	0	716
20928	1	21	2	690	0	714
20929	676	11	2	10	0	699
20930	9	690	5	13	0	717
20931	10	8	707	4	0	729
20932	2	12	687	3	0	704
20933	1	7	708	3	0	719
20934	6	2	21	669	0	698
20935	681	1	17	11	0	710
20936	12	693	2	14	0	721
20937	18	11	704	4	0	737
20938	4	728	10	3	0	745
20939	3	8	15	765	0	791
20940	5	13	768	13	0	799
20941	5	758	13	13	0	789
20942	1	11	15	752	0	779
20943	4	13	2	782	0	801
20944	2	1	776	24	0	803
20945	6	0	11	746	0	763
20946	1	772	14	12	0	799
20947	2	10	770	12	0	794
20948	739	12	13	3	0	767
20949	12	2	16	772	0	802
20950	15	1	0	759	0	775
20951	3	782	5	19	0	809
20952	781	11	3	12	0	807
20953	11	14	746	1	0	772
20954	717	3	11	6	0	737
20955	10	0	15	738	0	763
20956	14	740	4	11	0	769
20957	3	13	3	769	0	788
20958	1	12	4	771	0	788
20959	755	1	4	24	0	784
20960	769	4	5	14	0	792
20961	21	3	4	787	0	815
20962	13	4	767	9	0	793
20963	690	4	11	15	0	720
20964	9	789	15	4	0	817
20965	13	10	3	830	0	856
20966	1	14	2	877	0	894
20967	0	3	4	895	0	902
20968	2	3	889	22	0	916
20969	6	2	14	868	0	890
20970	3	882	14	11	0	910
20971	2	9	5	858	0	874
20972	1	900	4	11	0	916
20973	1	13	2	903	0	919
20974	4	12	888	13	0	917
20975	765	1	12	12	0	790
20976	15	3	13	889	0	920
20977	10	4	893	19	0	926
20978	3	897	13	15	0	928
20979	884	11	13	6	0	914
20980	10	14	909	7	0	940
20981	902	4	13	8	0	927
20982	14	1	12	942	0	969
20983	14	4	4	901	0	923
20984	2	943	9	28	0	982
20985	936	11	5	18	0	970
20986	829	18	3	2	0	852
20987	22	890	4	8	0	924
20988	15	12	2	905	0	934
20989	2	13	2	923	0	940
20990	5	4	5	928	0	942
20991	5	4	892	28	0	929
20992	848	2	14	19	0	883
20993	15	1	16	902	0	934
20994	15	9	2	915	0	941
20995	8	3	856	27	0	894
20996	2	8	864	15	0	889
20997	10	1	28	829	0	868
20998	4	4	824	23	0	855
20999	682	5	10	11	0	708
21000	9	5	11	678	0	703
21001	10	2	8	687	0	707
21002	3	5	696	18	0	722
21003	7	1	8	714	0	730
21004	4	1	722	12	0	739
21005	2	701	10	18	0	731
21006	679	11	13	6	0	709
21007	690	9	2	8	0	709
21008	17	659	8	7	0	691
21009	8	11	4	690	0	713
21010	4	14	696	12	0	726
21011	1	4	12	693	0	710
21012	683	0	7	14	0	704
21013	11	691	7	10	0	719
21014	676	10	1	7	0	694
21015	8	10	3	662	0	683
21016	669	2	3	9	0	683
21017	12	670	5	7	0	694
21018	695	10	1	4	0	710
21019	10	8	688	8	0	714
21020	7	669	7	5	0	688
21021	3	5	6	685	0	699
21022	725	4	4	14	0	747
21023	715	3	2	7	0	727
21024	16	2	2	710	0	730
21025	721	2	1	10	0	734
21026	714	3	5	10	0	732
21027	735	1	2	7	0	745
21028	13	2	3	740	0	758
21029	10	1	728	13	0	752
21030	3	5	689	5	0	702
21031	4	4	714	4	0	726
21032	702	0	8	4	0	714
21033	6	2	5	717	0	730
21034	8	756	1	7	0	772
21035	1	8	3	743	0	755
21036	3	769	2	7	0	781
21037	735	5	4	7	0	751
21038	13	5	3	732	0	753
21039	5	3	2	699	0	709
21040	693	3	2	10	0	708
21041	7	0	4	717	0	728
21042	8	2	3	721	0	734
21043	735	0	1	13	0	749
21044	9	5	799	9	0	822
21045	10	2	7	790	0	809
21046	5	1	789	12	0	807
21047	775	2	9	11	0	797
21048	11	3	10	795	0	819
21049	801	1	2	8	0	812
21050	9	0	3	821	0	833
21051	8	3	817	13	0	841
21052	2	2	10	834	0	848
21053	825	0	10	11	0	846
21054	12	819	3	10	0	844
21055	13	8	813	5	0	839
21056	767	10	10	4	0	791
21057	11	807	12	3	0	833
21058	12	842	1	3	0	858
21059	4	906	4	2	0	916
21060	7	19	1	949	0	976
21061	995	9	4	12	0	1020
21062	999	0	5	13	0	1017
21063	26	5	995	3	0	1029
21064	964	1	13	6	0	984
21065	14	947	18	2	0	981
21066	15	12	2	894	0	923
21067	903	14	2	15	0	934
21068	930	1	1	17	0	949
21069	957	1	1	2	0	961
21070	953	0	0	7	0	960
21071	966	1	2	4	0	973
21072	28	1	2	955	0	986
21073	17	0	970	14	0	1001
21074	2	2	12	988	0	1004
21075	5	5	17	968	0	995
21076	951	1	1	26	0	979
21077	12	935	2	14	0	963
21078	935	14	0	1	0	950
21079	941	15	0	0	0	956
21080	953	1	1	0	0	955
21081	965	0	2	3	0	970
21082	30	1	943	2	0	976
21083	946	1	12	4	0	963
21084	967	0	16	3	0	986
21085	843	4	5	4	0	856
21086	957	1	0	4	0	962
21087	27	0	1	916	0	944
21088	19	1	879	11	0	910
21089	867	0	11	16	0	894
21090	16	883	16	1	0	916
21091	17	11	2	838	0	868
21092	2	908	3	12	0	925
21093	2	11	2	914	0	929
21094	919	15	1	12	0	947
21095	934	3	2	17	0	956
21096	959	1	1	2	0	963
21097	31	5	898	3	0	937
21098	916	1	10	5	0	932
21099	16	3	916	0	0	935
21100	20	2	905	1	0	928
21101	10	1	922	4	0	937
21102	7	3	27	805	0	842
21103	6	2	14	890	0	912
21104	8	1	2	899	0	910
21105	8	1	2	882	0	893
21106	9	1	1	865	0	876
21107	8	1	0	868	0	877
21108	5	887	7	26	0	925
21109	848	13	1	19	0	881
21110	12	880	7	2	0	901
21111	20	12	1	871	0	904
21112	6	19	1	895	0	921
21113	890	2	0	29	0	921
21114	14	884	6	18	0	922
21115	926	10	1	6	0	943
21116	20	15	2	907	0	944
21117	21	1	7	916	0	945
21118	8	3	2	908	0	921
21119	6	4	877	27	0	914
21120	7	1	15	889	0	912
21121	11	3	866	15	0	895
21122	6	1	951	20	0	978
21123	5	1	1035	8	0	1049
21124	12	0	33	998	0	1043
21125	4	4	26	1032	0	1066
21126	8	2	1	1066	0	1077
21127	1005	7	3	39	0	1054
21128	16	5	1	1046	0	1068
21129	1049	3	3	20	0	1075
21130	24	1047	4	28	0	1103
21131	1082	19	1	8	0	1110
21132	1157	22	1	13	0	1193
21133	49	1219	5	6	0	1279
21134	1247	16	5	11	0	1279
21135	1288	22	3	8	0	1321
21136	1334	4	7	7	0	1352
21137	1327	2	3	13	0	1345
21138	44	26	1262	15	0	1347
21139	30	1282	22	8	0	1342
21140	10	20	25	1282	0	1337
21141	1275	24	6	23	0	1328
21142	24	5	1286	31	0	1346
21143	34	1286	23	8	0	1351
21144	10	15	22	1171	0	1218
21145	6	1267	7	17	0	1297
21146	13	15	0	1260	0	1288
21147	14	20	3	1278	0	1315
21148	14	3	1256	34	0	1307
21149	14	6	1238	19	0	1277
21150	1112	5	33	5	0	1155
21151	22	6	1251	6	0	1285
21152	29	10	1269	6	0	1314
21153	9	2	34	1252	0	1297
21154	7	17	24	1209	0	1257
21155	7	1297	5	34	0	1343
21156	8	1359	8	22	0	1397
21157	9	39	1438	6	0	1492
21158	12	41	21	1414	0	1488
21159	7	5	1441	22	0	1475
21160	4	4	1313	24	0	1345
21161	3	1296	33	3	0	1335
21162	10	16	26	1256	0	1308
21163	1290	17	5	14	0	1326
21164	14	3	6	1314	0	1337
21165	1303	5	4	23	0	1335
21166	1320	2	7	24	0	1353
21167	1339	9	5	7	0	1360
21168	29	5	1320	6	0	1360
21169	1311	2	16	6	0	1335
21170	19	2	21	1317	0	1359
21171	1361	4	8	19	0	1392
21172	1318	2	4	20	0	1344
21173	28	1292	3	9	0	1332
21174	1318	11	4	9	0	1342
21175	16	16	1403	4	0	1439
21176	1369	1	14	6	0	1390
21177	1373	1	17	7	0	1398
21178	33	1394	10	5	0	1442
21179	1409	13	3	3	0	1428
21180	14	14	7	1368	0	1403
21181	20	5	1	1381	0	1407
21182	5	1382	2	28	0	1417
21183	9	12	1	1392	0	1414
21184	6	16	4	1384	0	1410
21185	7	10	1399	26	0	1442
21186	8	4	1393	19	0	1424
21187	1335	4	33	4	0	1376
21188	1413	1	19	5	0	1438
21189	34	3	2	1456	0	1495
21190	19	5	1477	21	0	1522
21191	6	1477	24	18	0	1525
21192	3	18	18	1481	0	1520
21193	5	20	1535	20	0	1580
21194	1436	4	23	18	0	1481
21195	29	2	17	1517	0	1565
21196	23	1575	9	27	0	1634
21197	7	25	9	1599	0	1640
21198	7	21	4	1605	0	1637
21199	10	2	8	1660	0	1680
21200	1647	0	9	43	0	1699
21201	30	7	3	1664	0	1704
21202	1670	7	4	32	0	1713
21203	1657	10	6	26	0	1699
21204	48	6	1664	17	0	1735
21205	30	1661	31	9	0	1731
21206	19	26	25	1479	0	1549
21207	11	1771	6	22	0	1810
21208	1739	29	8	22	0	1798
21209	33	30	6	1720	0	1789
21210	32	7	1712	36	0	1787
21211	11	5	1717	34	0	1767
21212	16	4	1761	9	0	1790
21213	1693	6	53	12	0	1764
21214	37	1759	30	8	0	1834
21215	1741	28	9	10	0	1788
21216	35	1760	14	8	0	1817
21217	39	29	9	1712	0	1789
21218	17	28	6	1691	0	1742
21219	13	1752	6	56	0	1827
21220	13	30	1750	32	0	1825
21221	10	1804	36	12	0	1862
21222	1629	32	29	12	0	1702
21223	32	21	8	1590	0	1651
21224	33	10	1611	33	0	1687
21225	17	10	1624	24	0	1675
21226	11	8	45	1593	0	1657
21227	17	14	1626	33	0	1690
21228	14	5	1583	35	0	1637
21229	1489	5	48	19	0	1561
21230	29	1539	29	27	0	1624
21231	1511	30	4	10	0	1555
21232	32	25	1437	14	0	1508
21233	32	1322	36	4	0	1394
21234	17	1311	27	7	0	1362
21235	29	37	7	1234	0	1307
21236	12	28	9	1245	0	1294
21237	9	7	6	1270	0	1292
21238	6	10	1244	52	0	1312
21239	9	6	25	1282	0	1322
21240	18	5	21	1288	0	1332
21241	1266	0	7	57	0	1330
21242	28	1243	10	30	0	1311
21243	35	24	8	1273	0	1340
21244	1263	24	9	38	0	1334
21245	1272	8	5	30	0	1315
21246	58	4	5	1246	0	1313
21247	28	12	1291	34	0	1365
21248	16	7	27	1311	0	1361
21249	11	7	1309	37	0	1364
21250	1290	6	36	35	0	1367
21251	1461	6	38	10	0	1515
21252	65	8	9	1430	0	1512
21253	42	8	1401	39	0	1490
21254	8	1442	36	35	0	1521
21255	16	39	1461	11	0	1527
21256	7	32	35	1238	0	1312
21257	2	1375	33	36	0	1446
21258	1333	37	5	27	0	1402
21259	37	30	5	1242	0	1314
21260	33	1317	10	37	0	1397
21261	1349	38	6	33	0	1426
21262	43	27	7	1329	0	1406
21263	28	1349	10	38	0	1425
21264	9	40	7	1356	0	1412
21265	6	32	1320	38	0	1396
21266	1253	5	33	40	0	1331
21267	1322	7	28	6	0	1363
21268	59	5	1290	9	0	1363
21269	25	1280	41	10	0	1356
21270	1285	34	50	8	0	1377
21271	40	25	7	1283	0	1355
21272	31	1	8	1294	0	1334
21273	5	10	3	1348	0	1366
21274	9	5	3	1352	0	1369
21275	9	4	6	1260	0	1279
21276	1209	4	3	66	0	1282
21277	1241	3	3	36	0	1283
21278	57	4	7	1213	0	1281
21279	31	4	3	1249	0	1287
21280	2	6	1216	62	0	1286
21281	15	7	1182	24	0	1228
21282	1168	4	57	7	0	1236
21283	38	2	24	1196	0	1260
21284	36	5	1185	34	0	1260
21285	6	6	34	1154	0	1200
21286	1154	3	28	36	0	1221
21287	1169	0	5	31	0	1205
21288	57	1	4	1144	0	1206
21289	31	0	5	1133	0	1169
21290	1089	3	5	53	0	1150
21291	33	4	3	1077	0	1117
21292	27	1079	7	29	0	1142
21293	9	25	2	1064	0	1100
21294	5	25	2	1047	0	1079
21295	4	4	1028	48	0	1084
21296	5	5	979	26	0	1015
21297	4	996	43	5	0	1048
21298	991	21	24	8	0	1044
21299	971	19	4	10	0	1004
21300	971	1	4	4	0	980
21301	43	925	3	3	0	974
21302	23	955	5	7	0	990
21303	921	44	4	7	0	976
21304	25	930	3	4	0	962
21305	27	25	889	4	0	945
21306	4	923	26	7	0	960
21307	4	30	847	10	0	891
21308	837	18	21	2	0	878
21309	855	3	15	8	0	881
21310	34	876	5	9	0	924
21311	877	22	3	8	0	910
21312	921	18	6	7	0	952
21313	957	2	2	7	0	968
21314	49	3	3	935	0	990
21315	956	2	7	28	0	993
21316	30	4	934	21	0	989
21317	943	4	19	9	0	975
21318	27	4	26	945	0	1002
21319	28	1	931	30	0	990
21320	11	5	958	26	0	1000
21321	9	4	40	950	0	1003
21322	4	2	21	974	0	1001
21323	958	2	3	48	0	1011
21324	26	3	2	954	0	985
21325	22	4	923	34	0	983
21326	7	3	23	912	0	945
21327	5	931	25	27	0	988
21328	938	24	4	26	0	992
21329	31	19	2	937	0	989
21330	24	6	930	27	0	987
21331	5	935	27	23	0	990
21332	915	23	19	9	0	966
21333	31	18	6	909	0	964
21334	24	4	925	26	0	979
21335	9	920	24	21	0	974
21336	940	23	21	11	0	995
21337	957	19	4	5	0	985
21338	967	4	2	12	0	985
21339	45	5	4	908	0	962
21340	25	4	2	932	0	963
21341	917	3	1	42	0	963
21342	27	910	6	24	0	967
21343	886	20	4	5	0	915
21344	24	19	3	876	0	922
21345	909	4	6	25	0	944
21346	27	1	7	889	0	924
21347	31	5	5	848	0	889
21348	13	30	4	847	0	894
21349	15	5	7	883	0	910
21350	8	6	805	30	0	849
21351	6	4	678	18	0	706
21352	604	1	18	7	0	630
21353	13	1	671	9	0	694
21354	9	1	603	6	0	619
21355	583	4	16	5	0	608
21356	603	1	12	8	0	624
21357	16	3	2	622	0	643
21358	636	1	5	10	0	652
21359	8	625	4	12	0	649
21360	632	7	2	7	0	648
21361	618	12	2	6	0	638
21362	660	4	3	5	0	672
21363	18	2	3	628	0	651
21364	11	612	5	9	0	637
21365	7	644	3	10	0	664
21366	634	15	3	3	0	655
21367	630	10	3	4	0	647
21368	17	3	2	629	0	651
21369	14	2	2	619	0	637
21370	6	605	7	15	0	633
21371	626	7	2	9	0	644
21372	10	10	619	5	0	644
21373	14	2	5	597	0	618
21374	7	0	10	602	0	619
21375	7	2	602	15	0	626
21376	5	2	5	584	0	596
21377	5	509	9	12	0	535
21378	8	5	2	616	0	631
21379	6	8	2	613	0	629
21380	6	572	5	14	0	597
21381	3	618	4	15	0	640
21382	8	11	1	608	0	628
21383	611	7	5	10	0	633
21384	7	1	6	625	0	639
21385	11	2	4	623	0	640
21386	8	614	4	11	0	637
21387	5	3	5	643	0	656
21388	7	7	3	640	0	657
21389	6	3	1	643	0	653
21390	637	1	2	13	0	653
21391	14	0	1	633	0	648
21392	14	2	0	620	0	636
21393	6	2	0	604	0	612
21394	4	4	580	13	0	601
21395	503	3	4	8	0	518
21396	10	572	6	3	0	591
21397	571	2	1	3	0	577
21398	5	7	0	565	0	577
21399	7	6	552	4	0	569
21400	486	4	3	9	0	502
21401	7	3	699	3	0	712
21402	8	1	4	718	0	731
21403	742	1	6	8	0	757
21404	737	3	3	10	0	753
21405	779	2	3	4	0	788
21406	10	1	2	775	0	788
21407	8	3	1	793	0	805
21408	5	0	2	789	0	796
21409	0	750	3	14	0	767
21410	1	736	1	8	0	746
21411	0	714	1	1	0	716
21412	0	677	0	3	0	680
21413	0	0	0	686	0	686
21414	0	0	0	684	0	684
21415	662	0	0	2	0	664
21416	648	0	0	0	0	648
21417	656	0	0	1	0	657
21418	2	0	0	648	0	650
21419	0	0	0	660	0	660
21420	620	0	0	3	0	623
21421	591	0	0	0	0	591
21422	0	2	606	1	0	609
21423	0	3	581	0	0	584
21424	2	2	597	0	0	601
21425	1	0	629	0	0	630
21426	0	0	0	623	0	623
21427	644	0	0	2	0	646
21428	0	668	3	2	0	673
21429	0	0	0	675	0	675
21430	2	0	697	1	0	700
21431	0	760	0	1	0	761
21432	0	0	0	788	0	788
21433	0	2	793	0	0	795
21434	0	0	0	779	0	779
21435	2	0	1	797	0	800
21436	814	0	0	3	0	817
21437	1	0	0	832	0	833
21438	2	3	823	2	0	830
21439	0	0	1	817	0	818
21440	0	891	1	2	0	894
21441	0	1	0	946	0	947
21442	0	0	0	946	0	946
21443	0	0	0	953	0	953
21444	949	0	0	3	0	952
21445	979	0	0	1	0	980
21446	1043	0	0	1	0	1044
21447	1043	1	0	5	0	1049
21448	2	1	1051	0	0	1054
21449	989	0	1	1	0	991
21450	1052	0	0	2	0	1054
21451	4	2	1094	0	0	1100
21452	2	5	1149	3	0	1159
21453	3	0	1	1130	0	1134
21454	1	1150	1	1	0	1153
21455	1178	1	0	1	0	1180
21456	1186	0	0	3	0	1189
21457	1164	0	1	1	0	1166
21458	1	0	0	1159	0	1160
21459	0	1215	2	1	0	1218
21460	1244	1	0	3	0	1248
21461	1248	0	0	3	0	1251
21462	1	0	0	1257	0	1258
21463	0	3	1260	3	0	1266
21464	1259	2	2	3	0	1266
21465	1	0	0	1367	0	1368
21466	1376	0	2	5	0	1383
21467	2	0	0	1399	0	1401
21468	0	1	1433	3	0	1437
21469	1590	1	1	7	0	1599
21470	2	0	0	1649	0	1651
21471	1	0	1	1642	0	1644
21472	3	0	0	1655	0	1658
21473	0	0	0	1656	0	1656
21474	1679	1	1	5	0	1686
21475	2	0	1	1671	0	1674
21476	2	1683	1	15	0	1701
21477	2	2	1	1709	0	1714
21478	1	1711	2	6	0	1720
21479	0	3	0	1730	0	1733
21480	2	0	0	1738	0	1740
21481	0	1716	0	15	0	1731
21482	0	4	0	1746	0	1750
21483	0	0	0	1727	0	1727
21484	1699	2	0	8	0	1709
21485	4	0	1735	2	0	1741
21486	1	0	3	1752	0	1756
21487	1774	0	0	6	0	1780
21488	1787	1	2	2	0	1792
21489	1798	0	0	7	0	1805
21490	13	3	1821	0	0	1837
21491	4	3	1877	2	0	1886
21492	2	1	9	1915	0	1927
21493	1942	0	6	11	0	1959
21494	7	2	1943	7	0	1959
21495	1851	2	7	7	0	1867
21496	9	1954	6	0	0	1969
21497	9	8	3	2065	0	2085
21498	5	5	0	2116	0	2126
21499	2122	2	1	15	0	2140
21500	7	0	0	2160	0	2167
21501	2035	1	0	11	0	2047
21502	2042	1	0	11	0	2054
21503	15	0	0	2036	0	2051
21504	8	0	0	2049	0	2057
21505	1995	0	0	17	0	2012
21506	9	1	2199	7	0	2216
21507	2168	0	9	11	0	2188
21508	11	2	2485	2	0	2500
21509	2514	0	9	7	0	2530
21510	2706	1	4	10	0	2721
21511	2691	0	2	3	0	2696
21512	2704	0	0	2	0	2706
21513	11	2673	4	3	0	2691
21514	2740	7	7	7	0	2761
21515	2757	4	1	7	0	2769
21516	12	2907	6	1	0	2926
21517	2929	7	1	9	0	2946
21518	12	9	2892	1	0	2914
21519	2817	2	9	3	0	2831
21520	12	7	2956	3	0	2978
21521	7	0	10	2968	0	2985
21522	6	0	6	3006	0	3018
21523	6	3	3190	21	0	3220
21524	1	1	15	3159	0	3176
21525	9	19	24	2503	0	2555
21526	3386	1	2	27	0	3416
21527	15	0	0	3395	0	3410
21528	15	1	1	3368	0	3385
21529	4	0	1	3399	0	3404
21530	3	3362	3	20	0	3388
21531	4	12	0	3361	0	3377
21532	3282	9	0	25	0	3316
21533	17	12	3406	11	0	3446
21534	15	2	13	3423	0	3453
21535	8	4	3451	23	0	3486
21536	3262	1	17	21	0	3301
21537	17	2	13	3596	0	3628
21538	21	9	4324	26	0	4380
21539	11	3	54	4340	0	4408
21540	10	5	43	4358	0	4416
21541	5	4409	23	96	0	4533
21542	8	54	5	4598	0	4665
21543	8	42	4	4762	0	4816
21544	12	26	4792	115	0	4945
21545	10	5	68	4753	0	4836
21546	6	6	48	4802	0	4862
21547	4658	4	20	126	0	4808
21548	4662	0	4	77	0	4743
21549	113	4720	11	31	0	4875
21550	4759	70	4	25	0	4858
21551	4711	47	5	14	0	4777
21552	117	4706	12	12	0	4847
21553	80	68	2	4663	0	4813
21554	4751	47	3	84	0	4885
21555	4789	20	5	58	0	4872
21556	4780	6	5	30	0	4821
21557	139	4696	10	15	0	4860
21558	88	76	4808	14	0	4986
21559	4981	53	74	18	0	5126
21560	5215	20	53	14	0	5302
21561	148	5169	26	14	0	5357
21562	5245	88	6	22	0	5361
21563	5283	69	9	12	0	5373
21564	169	22	7	5135	0	5333
21565	103	19	5194	101	0	5417
21566	40	9	91	5385	0	5525
21567	30	5	70	5437	0	5542
21568	14	8	24	5521	0	5567
21569	20	26	5135	190	0	5371
21570	28	3	99	4984	0	5114
21571	37	7	78	5233	0	5355
21572	21	8	24	5302	0	5355
21573	26	8	7	5350	0	5391
21574	26	9	12	5274	0	5321
21575	27	5204	18	202	0	5451
21576	23	102	7	5307	0	5439
21577	22	85	13	5504	0	5624
21578	23	34	5307	203	0	5567
21579	29	16	103	5881	0	6029
21580	23	13	93	6017	0	6146
21581	31	9	32	6237	0	6309
21582	40	10	16	6356	0	6422
21583	6154	16	13	287	0	6470
21584	164	18	14	6326	0	6522
21585	149	31	11	6374	0	6565
21586	70	36	6112	275	0	6493
21587	51	5947	139	175	0	6312
21588	29	6229	142	77	0	6477
21589	6040	225	46	79	0	6390
21590	144	6156	38	69	0	6407
21591	124	148	20	6013	0	6305
21592	5927	122	14	202	0	6265
21593	166	51	6000	173	0	6390
21594	137	25	151	5905	0	6218
21595	49	6091	133	196	0	6469
21596	40	146	37	6050	0	6273
21597	22	6131	30	228	0	6411
21598	29	168	21	6163	0	6381
21599	6027	136	11	237	0	6411
21600	169	58	6126	193	0	6546
21601	151	21	158	5845	0	6175
21602	54	6173	155	188	0	6570
21603	6150	153	43	190	0	6536
21604	171	140	6146	109	0	6566
21605	150	39	158	6160	0	6507
21606	64	40	5999	232	0	6335
21607	48	27	174	5977	0	6226
21608	49	31	5797	239	0	6116
21609	42	18	197	5636	0	5893
21610	36	25	142	5712	0	5915
21611	5479	34	62	326	0	5901
21612	5623	41	30	204	0	5898
21613	300	37	27	5420	0	5784
21614	180	5425	29	213	0	5847
21615	58	176	21	5563	0	5818
21616	57	138	29	5473	0	5697
21617	5181	39	30	342	0	5592
21618	155	5246	47	231	0	5679
21619	5325	175	30	98	0	5628
21620	5230	155	24	95	0	5504
21621	273	5082	36	100	0	5491
21622	177	5340	36	92	0	5645
21623	5005	269	26	114	0	5414
21624	180	153	4930	118	0	5381
21625	4978	51	176	104	0	5309
21626	4962	46	137	92	0	5237
21627	300	4830	55	113	0	5298
21628	197	185	37	4290	0	4709
21629	78	4910	76	214	0	5278
21630	4812	196	44	198	0	5250
21631	4888	161	53	116	0	5218
21632	304	63	52	4684	0	5103
21633	184	61	51	4834	0	5130
21634	4493	64	29	352	0	4938
21635	204	4543	43	232	0	5022
21636	181	4544	46	117	0	4888
21637	77	4511	44	104	0	4736
21638	36	3643	28	97	0	3804
21639	55	3673	25	85	0	3838
21640	52	234	43	3440	0	3769
21641	48	137	3354	171	0	3710
21642	60	3324	105	137	0	3626
21643	3154	125	105	63	0	3447
21644	132	112	39	3089	0	3372
21645	3167	53	22	143	0	3385
21646	134	3089	47	123	0	3393
21647	3154	120	44	61	0	3379
21648	137	3179	51	59	0	3426
21649	130	120	44	3130	0	3424
21650	3143	105	37	128	0	3413
21651	3205	42	40	139	0	3426
21652	199	36	42	3147	0	3424
21653	131	32	35	3150	0	3348
21654	71	3059	34	210	0	3374
21655	77	109	23	3152	0	3361
21656	59	108	9	3170	0	3346
21657	54	50	15	3126	0	3245
21658	63	2787	20	218	0	3088
21659	2484	89	15	123	0	2711
21660	104	2508	16	62	0	2690
21661	2479	115	6	42	0	2642
21662	110	2472	14	42	0	2638
21663	112	101	2368	44	0	2625
21664	92	97	70	2335	0	2594
21665	50	55	2329	76	0	2510
21666	61	37	2235	70	0	2403
21667	44	36	133	2175	0	2388
21668	48	39	2227	92	0	2406
21669	59	37	78	2210	0	2384
21670	60	33	75	2211	0	2379
21671	55	31	22	2308	0	2416
21672	2202	27	19	147	0	2395
21673	109	33	13	2245	0	2400
21674	106	24	9	2271	0	2410
21675	2091	24	7	147	0	2269
21676	93	2040	9	104	0	2246
21677	78	1862	7	46	0	1993
21678	51	1896	3	41	0	1991
21679	29	121	2	1236	0	1388
21680	25	35	1246	52	0	1358
21681	1006	48	24	34	0	1112
21682	31	1059	14	19	0	1123
21683	954	26	11	7	0	998
21684	953	22	1	11	0	987
21685	967	12	4	5	0	988
21686	40	14	1002	8	0	1064
21687	26	8	21	1008	0	1063
21688	16	13	17	1021	0	1067
21689	16	10	5	1067	0	1098
21690	21	8	5	1027	0	1061
21691	8	1031	8	37	0	1084
21692	1019	19	7	25	0	1070
21693	24	17	887	13	0	941
21694	841	5	11	11	0	868
21695	16	5	9	795	0	825
21696	13	782	3	22	0	820
21697	8	878	4	14	0	904
21698	9	53	2	785	0	849
21699	6	827	0	17	0	850
21700	708	10	4	10	0	732
21701	6	6	669	7	0	688
21702	6	12	5	613	0	636
21703	1	0	5	666	0	672
21704	6	1	1	676	0	684
21705	3	4	2	669	0	678
21706	653	3	2	5	0	663
21707	10	719	1	3	0	733
21708	870	11	3	6	0	890
21709	21	4	3	877	0	905
21710	12	3	2	879	0	896
21711	2	917	3	32	0	954
21712	918	19	1	16	0	954
21713	971	15	0	7	0	993
21714	33	1048	3	3	0	1087
21715	25	20	3	975	0	1023
21716	7	1047	8	18	0	1080
21717	1048	25	3	19	0	1095
21718	23	19	1045	8	0	1095
21719	18	5	1029	5	0	1057
21720	969	2	37	7	0	1015
21721	22	1034	22	4	0	1082
21722	24	22	3	1029	0	1078
21723	9	17	4	1048	0	1078
21724	6	3	1031	44	0	1084
21725	2	3	20	1028	0	1053
21726	5	19	18	1027	0	1069
21727	4	1033	5	42	0	1084
21728	5	25	2	1059	0	1091
21729	5	21	1	1056	0	1083
21730	1024	6	1	46	0	1077
21731	24	1012	6	23	0	1065
21732	21	1050	5	8	0	1084
21733	5	41	3	1032	0	1081
21734	3	22	2	1039	0	1066
21735	10	3	0	1054	0	1067
21736	6	1036	4	39	0	1085
21737	5	23	2	1072	0	1102
21738	5	19	3	1059	0	1086
21739	4	3	1	1086	0	1094
21740	5	2	1	1056	0	1064
21741	3	1004	1	43	0	1051
21742	1	1050	5	23	0	1079
21743	1031	38	2	7	0	1078
21744	1051	17	3	8	0	1079
21745	42	2	1	1040	0	1085
21746	20	9	1029	25	0	1083
21747	5	6	20	1028	0	1059
21748	5	4	16	1001	0	1026
21749	975	5	5	41	0	1026
21750	24	1027	2	23	0	1076
21751	22	27	3	1038	0	1090
21752	9	18	3	1072	0	1102
21753	2	8	1047	44	0	1101
21754	3	7	1052	24	0	1086
21755	6	2	39	1031	0	1078
21756	3	3	21	1015	0	1042
21757	7	1018	8	39	0	1072
21758	4	1054	5	20	0	1083
21759	1030	38	2	8	0	1078
21760	26	18	3	1032	0	1079
21761	18	5	1005	30	0	1058
21762	4	985	27	20	0	1036
21763	4	26	18	996	0	1044
21764	991	17	3	31	0	1042
21765	24	7	1	1012	0	1044
21766	992	5	3	30	0	1030
21767	23	1024	3	23	0	1073
21768	1046	26	2	10	0	1084
21769	29	23	2	1037	0	1091
21770	20	7	1069	30	0	1126
21771	4	4	25	1033	0	1066
21772	3	1111	23	29	0	1166
21773	6	30	4	1105	0	1145
21774	2	1181	3	31	0	1217
21775	4	33	2	1230	0	1269
21776	10	23	1177	40	0	1250
21777	8	5	1181	26	0	1220
21778	1	6	1203	18	0	1228
21779	1117	2	54	11	0	1184
21780	33	1168	31	5	0	1237
21781	27	1214	7	7	0	1255
21782	1199	50	1	12	0	1262
21783	1219	34	2	6	0	1261
21784	52	10	3	1204	0	1269
21785	33	10	1202	32	0	1277
21786	11	5	1131	27	0	1174
21787	6	1	57	1117	0	1181
21788	1125	4	29	36	0	1194
21789	30	1100	7	28	0	1165
21790	22	33	2	1099	0	1156
21791	1071	25	3	39	0	1138
21792	1080	5	2	32	0	1119
21793	52	7	1056	13	0	1128
21794	1010	7	34	10	0	1061
21795	48	8	1077	9	0	1142
21796	31	5	1119	10	0	1165
21797	14	5	52	1014	0	1085
21798	3	7	28	1056	0	1094
21799	7	7	10	1085	0	1109
21800	8	8	1028	63	0	1107
21801	1030	4	35	37	0	1106
21802	35	2	26	1087	0	1150
21803	1052	5	13	39	0	1109
21804	1049	5	5	37	0	1096
21805	52	1079	8	14	0	1153
21806	29	1101	9	11	0	1150
21807	9	1070	7	14	0	1100
21808	7	50	2	870	0	929
21809	5	26	858	22	0	911
21810	10	8	22	829	0	869
21811	6	818	18	27	0	869
21812	7	795	9	17	0	828
21813	6	25	6	747	0	784
21814	714	16	4	21	0	755
21815	18	706	5	21	0	750
21816	16	714	3	11	0	744
21817	723	29	3	9	0	764
21818	21	16	4	716	0	757
21819	16	7	2	772	0	797
21820	9	4	4	783	0	800
21821	730	5	5	35	0	775
21822	744	3	5	23	0	775
21823	31	2	4	748	0	785
21824	18	7	735	20	0	780
21825	719	3	17	20	0	759
21826	24	3	18	730	0	775
21827	17	4	746	29	0	796
21828	7	7	761	19	0	794
21829	10	1	31	762	0	804
21830	10	5	897	27	0	939
21831	8	6	25	1011	0	1050
21832	10	6	20	1017	0	1053
21833	6	5	5	1098	0	1114
21834	1058	3	6	50	0	1117
21835	27	4	4	1091	0	1126
21836	21	5	5	1073	0	1104
21837	10	3	9	1095	0	1117
21838	11	4	4	1106	0	1125
21839	7	3	1046	53	0	1109
21840	3	1045	30	32	0	1110
21841	3	25	22	1049	0	1099
21842	8	21	6	1014	0	1049
21843	6	1018	6	48	0	1078
21844	4	1059	5	26	0	1094
21845	1038	40	4	19	0	1101
21846	24	1063	2	13	0	1102
21847	25	33	6	1041	0	1105
21848	13	21	1021	30	0	1085
21849	959	7	23	32	0	1021
21850	28	6	988	11	0	1033
21851	978	5	24	12	0	1019
21852	981	3	24	10	0	1018
21853	45	6	963	9	0	1023
21854	25	2	24	915	0	966
21855	8	935	28	29	0	1000
21856	7	25	12	977	0	1021
21857	966	21	5	42	0	1034
21858	981	7	2	35	0	1025
21859	43	974	7	21	0	1045
21860	1008	26	4	19	0	1057
21861	33	22	4	1001	0	1060
21862	1018	13	2	38	0	1071
21863	1021	5	6	35	0	1067
21864	48	3	3	1041	0	1095
21865	1018	8	6	36	0	1068
21866	970	10	5	33	0	1018
21867	44	4	961	19	0	1028
21868	944	8	22	13	0	987
21869	30	12	949	19	0	1010
21870	20	7	912	10	0	949
21871	13	953	38	11	0	1015
21872	6	19	23	880	0	928
21873	11	20	906	20	0	957
21874	11	9	881	21	0	922
21875	851	5	32	12	0	900
21876	21	2	18	859	0	900
21877	18	9	11	928	0	966
21878	13	2	4	957	0	976
21879	7	2	6	952	0	967
21880	14	5	2	956	0	977
21881	11	8	921	41	0	981
21882	11	6	912	26	0	955
21883	7	4	32	916	0	959
21884	910	1	21	21	0	953
21885	23	889	13	23	0	948
21886	25	19	6	903	0	953
21887	906	15	4	25	0	950
21888	26	898	4	23	0	951
21889	26	47	5	891	0	969
21890	11	17	8	942	0	978
21891	12	5	9	963	0	989
21892	933	4	6	39	0	982
21893	21	9	921	30	0	981
21894	942	2	19	15	0	978
21895	27	4	20	948	0	999
21896	19	6	11	891	0	927
21897	15	894	6	37	0	952
21898	4	21	892	29	0	946
21899	842	15	21	16	0	894
21900	880	8	20	14	0	922
21901	35	8	853	18	0	914
21902	825	4	18	15	0	862
21903	22	858	22	10	0	912
21904	20	868	12	12	0	912
21905	10	860	9	15	0	894
21906	814	30	11	11	0	866
21907	23	25	821	11	0	880
21908	22	9	20	790	0	841
21909	14	808	17	22	0	861
21910	11	818	15	18	0	862
21911	9	822	8	13	0	852
21912	25	37	1	613	0	676
21913	739	12	3	25	0	779
21914	20	756	2	22	0	800
21915	17	13	5	764	0	799
21916	13	11	4	778	0	806
21917	739	3	5	27	0	774
21918	24	1	6	749	0	780
21919	17	4	6	742	0	769
21920	11	8	724	27	0	770
21921	10	6	12	728	0	756
21922	12	6	15	750	0	783
21923	740	2	8	24	0	774
21924	750	3	6	17	0	776
21925	32	3	6	737	0	778
21926	725	5	5	22	0	757
21927	693	7	8	21	0	729
21928	27	692	5	11	0	735
21929	18	14	698	6	0	736
21930	8	577	13	5	0	603
21931	5	42	10	426	0	483
21932	406	4	3	20	0	433
21933	7	409	3	4	0	423
21934	5	7	0	406	0	418
21935	407	4	0	8	0	419
21936	413	1	0	4	0	418
21937	8	2	0	397	0	407
21938	5	2	440	9	0	456
21939	3	0	5	443	0	451
21940	0	0	3	461	0	464
21941	5	0	448	9	0	462
21942	4	1	7	435	0	447
21943	3	0	4	452	0	459
21944	449	1	1	9	0	460
21945	6	0	2	452	0	460
21946	4	2	0	454	0	460
21947	444	1	1	8	0	454
21948	466	2	2	4	0	474
21949	471	1	0	2	0	474
21950	13	3	458	0	0	474
21951	6	2	6	444	0	458
21952	2	457	7	7	0	473
21953	3	7	1	471	0	482
21954	3	12	470	8	0	493
21955	3	1	6	465	0	475
21956	0	3	487	6	0	496
21957	459	11	6	5	0	481
21958	467	1	4	4	0	476
21959	9	1	1	476	0	487
21960	5	1	1	472	0	479
21961	3	0	0	465	0	468
21962	5	476	1	9	0	491
21963	479	5	0	8	0	492
21964	460	3	1	6	0	470
21965	10	1	1	461	0	473
21966	5	1	0	467	0	473
21967	4	1	0	474	0	479
21968	2	1	0	470	0	473
21969	2	4	450	14	0	470
21970	1	0	7	463	0	471
21971	409	0	3	10	0	422
21972	415	1	1	5	0	422
21973	10	2	1	390	0	403
21974	5	1	364	9	0	379
21975	316	2	4	4	0	326
21976	9	0	2	327	0	338
21977	3	336	0	4	0	343
21978	0	346	1	2	0	349
21979	387	6	0	2	0	395
21980	4	2	0	395	0	401
21981	2	1	0	433	0	436
21982	0	0	0	442	0	442
21983	1	0	0	435	0	436
21984	1	0	0	454	0	455
21985	2	1	463	9	0	475
21986	0	0	466	5	0	471
21987	2	4	472	0	0	478
21988	0	1	10	455	0	466
21989	1	2	492	7	0	502
21990	0	1	8	494	0	503
21991	1	0	7	513	0	521
21992	0	1	2	526	0	529
21993	553	0	1	15	0	569
21994	9	0	0	540	0	549
21995	7	0	1	556	0	564
21996	540	0	0	20	0	560
21997	9	535	0	9	0	553
21998	7	586	2	5	0	600
21999	590	15	1	1	0	607
22000	8	608	2	1	0	619
22001	609	10	1	0	0	620
22002	606	8	0	2	0	616
22003	619	1	0	0	0	620
22004	600	1	0	2	0	603
22005	623	0	0	4	0	627
22006	20	617	1	1	0	639
22007	625	10	0	1	0	636
22008	622	8	0	0	0	630
22009	21	671	0	0	0	692
22010	742	12	0	3	0	757
22011	755	8	0	1	0	764
22012	828	1	0	2	0	831
22013	863	3	0	1	0	867
22014	33	2	842	2	0	879
22015	18	2	17	916	0	953
22016	8	0	16	957	0	981
22017	6	4	940	34	0	984
22018	3	0	937	22	0	962
22019	907	0	34	6	0	947
22020	20	0	18	961	0	999
22021	17	3	973	18	0	1011
22022	2	2	962	16	0	982
22023	939	1	34	3	0	977
22024	990	0	18	4	0	1012
22025	996	1	5	0	0	1002
22026	38	3	972	1	0	1014
22027	23	0	18	963	0	1004
22028	7	2	1014	22	0	1045
22029	947	2	22	18	0	989
22030	22	1	1036	3	0	1062
22031	18	2	24	993	0	1037
22032	7	0	20	973	0	1000
22033	3	1039	5	35	0	1082
22034	1037	19	7	18	0	1081
22035	22	18	1033	7	0	1080
22036	1033	2	22	10	0	1067
22037	23	4	1072	4	0	1103
22038	24	0	28	998	0	1050
22039	7	1	20	1032	0	1060
22040	9	1	5	1049	0	1064
22041	1022	1	7	37	0	1067
22042	26	2	4	1017	0	1049
22043	20	0	4	1024	0	1048
22044	9	1001	2	40	0	1052
22045	7	20	4	1025	0	1056
22046	978	16	4	27	0	1025
22047	23	5	1006	21	0	1055
22048	20	1	21	979	0	1021
22049	9	2	999	22	0	1032
22050	4	973	26	19	0	1022
22051	4	21	986	8	0	1019
22052	955	15	22	6	0	998
22053	980	4	32	8	0	1024
22054	33	1	9	964	0	1007
22055	980	0	7	23	0	1010
22056	961	1	2	21	0	985
22057	35	0	4	953	0	992
22058	20	1	4	955	0	980
22059	5	2	940	39	0	986
22060	8	918	21	22	0	969
22061	929	18	16	7	0	970
22062	23	915	5	7	0	950
22063	20	20	7	910	0	957
22064	8	16	6	927	0	957
22065	10	2	5	939	0	956
22066	12	3	7	943	0	965
22067	10	1	906	36	0	953
22068	855	2	26	26	0	909
22069	924	3	19	13	0	959
22070	36	3	9	910	0	958
22071	932	2	10	21	0	965
22072	33	0	7	924	0	964
22073	27	2	900	29	0	958
22074	11	1	20	901	0	933
22075	8	886	22	25	0	941
22076	8	18	8	853	0	887
22077	7	874	8	26	0	915
22078	11	20	4	818	0	853
22079	5	823	14	21	0	863
22080	786	22	4	29	0	841
22081	21	20	767	16	0	824
22082	17	753	22	15	0	807
22083	11	779	22	10	0	822
22084	8	28	36	735	0	807
22085	10	16	5	743	0	774
22086	5	7	8	760	0	780
22087	5	5	6	751	0	767
22088	15	729	9	31	0	784
22089	15	12	7	701	0	735
22090	13	13	7	706	0	739
22091	669	4	6	35	0	714
22092	20	7	8	687	0	722
22093	16	4	681	27	0	728
22094	11	6	678	20	0	715
22095	628	2	25	11	0	666
22096	18	664	18	16	0	716
22097	16	703	8	13	0	740
22098	10	29	6	666	0	711
22099	6	17	2	682	0	707
22100	5	7	657	36	0	705
22101	625	5	20	24	0	674
22102	654	9	15	14	0	692
22103	27	6	723	13	0	769
22104	13	7	715	11	0	746
22105	685	4	23	12	0	724
22106	711	0	12	12	0	735
22107	713	3	4	14	0	734
22108	712	3	5	16	0	736
22109	23	632	9	14	0	678
22110	591	8	4	8	0	611
22111	12	11	562	11	0	596
22112	9	2	490	7	0	508
22113	12	4	510	3	0	529
22114	21	36	39	401	0	497
22115	399	0	2	5	0	406
22116	410	1	3	4	0	418
22117	5	2	0	412	0	419
22118	1	0	1	403	0	405
22119	0	2	4	409	0	415
22120	3	423	2	5	0	433
22121	436	4	2	4	0	446
22122	446	1	0	4	0	451
22123	449	1	1	5	0	456
22124	439	1	1	6	0	447
22125	439	1	1	4	0	445
22126	2	0	1	439	0	442
22127	0	433	5	5	0	443
22128	7	1	2	400	0	410
22129	2	0	1	407	0	410
22130	407	0	1	4	0	412
22131	4	0	425	2	0	431
22132	3	0	386	3	0	392
22133	0	1	386	1	0	388
22134	419	0	2	1	0	422
22135	448	0	11	6	0	465
22136	2	0	0	488	0	490
22137	2	0	0	484	0	486
22138	1	0	0	553	0	554
22139	1	0	553	2	0	556
22140	0	0	1	540	0	541
22141	0	3	610	2	0	615
22142	1	0	0	598	0	599
22143	1	0	2	603	0	606
22144	0	1	1	617	0	619
22145	611	0	1	3	0	615
22146	610	0	1	3	0	614
22147	2	0	622	2	0	626
22148	597	0	1	2	0	600
22149	605	0	2	5	0	612
22150	1	0	1	618	0	620
22151	614	0	3	0	0	617
22152	1	0	0	656	0	657
22153	4	0	1	661	0	666
22154	1	0	645	8	0	654
22155	591	0	5	7	0	603
22156	4	0	5	664	0	673
22157	6	1	669	5	0	681
22158	4	5	686	7	0	702
22159	0	1	8	694	0	703
22160	2	0	3	717	0	722
22161	726	0	0	12	0	738
22162	3	0	1	734	0	738
22163	8	0	0	728	0	736
22164	1	0	1	741	0	743
22165	2	0	4	748	0	754
22166	763	0	2	9	0	774
22167	757	0	1	11	0	769
22168	767	2	1	6	0	776
22169	782	0	3	4	0	789
22170	10	0	1	823	0	834
22171	834	0	1	7	0	842
22172	7	0	1	836	0	844
22173	857	0	0	9	0	866
22174	8	0	0	855	0	863
22175	9	0	1	866	0	876
22176	2	904	1	12	0	919
22177	1	5	2	930	0	938
22178	903	7	0	7	0	917
22179	883	0	1	11	0	895
22180	13	3	926	3	0	945
22181	10	921	6	3	0	940
22182	917	5	7	7	0	936
22183	5	980	1	6	0	992
22184	1000	6	2	3	0	1011
22185	8	1086	3	3	0	1100
22186	11	8	1073	8	0	1100
22187	3	1110	7	5	0	1125
22188	0	1113	13	3	0	1129
22189	4	16	1	1184	0	1205
22190	1192	9	1	13	0	1215
22191	13	1	1	1194	0	1209
22192	14	0	1	1190	0	1205
22193	1173	3	1	29	0	1206
22194	1179	2	1	17	0	1199
22195	25	3	0	1181	0	1209
22196	18	1	1	1190	0	1210
22197	5	1	0	1193	0	1199
22198	1143	0	2	25	0	1170
22199	12	4	1144	15	0	1175
22200	17	1	11	1150	0	1179
22201	5	4	1175	15	0	1199
22202	5	1155	13	20	0	1193
22203	3	11	1119	3	0	1136
22204	4	13	12	1090	0	1119
22205	2	4	1113	18	0	1137
22206	1061	5	15	14	0	1095
22207	14	2	16	1099	0	1131
22208	16	1120	0	18	0	1154
22209	5	11	4	1110	0	1130
22210	6	1122	3	11	0	1142
22211	3	1110	4	16	0	1133
22212	4	1153	0	7	0	1164
22213	10	27	2	1043	0	1082
22214	4	1107	2	16	0	1129
22215	1082	12	3	16	0	1113
22216	14	15	1064	5	0	1098
22217	21	3	1036	5	0	1065
22218	8	5	1108	4	0	1125
22219	2	1	26	1111	0	1140
22220	6	4	14	1061	0	1085
22221	6	2	2	1062	0	1072
22222	8	3	2	1047	0	1060
22223	9	1	19	992	0	1021
22224	5	1047	7	30	0	1089
22225	3	14	1034	17	0	1068
22226	7	15	1028	11	0	1061
22227	4	1067	27	11	0	1109
22228	9	13	14	1070	0	1106
22229	5	12	4	1080	0	1101
22230	6	3	5	1083	0	1097
22231	1041	7	3	25	0	1076
22232	13	11	1049	13	0	1086
22233	1026	5	13	9	0	1053
22234	1032	4	12	7	0	1055
22235	27	986	9	5	0	1027
22236	17	993	6	4	0	1020
22237	1020	27	24	5	0	1076
22238	14	15	1	995	0	1025
22239	18	3	1	1034	0	1056
22240	7	8	1050	32	0	1097
22241	4	2	1038	19	0	1063
22242	4	3	26	1070	0	1103
22243	1115	4	17	20	0	1156
22244	17	7	1176	21	0	1221
22245	1188	3	20	6	0	1217
22246	20	4	19	1183	0	1226
22247	19	1	7	1265	0	1292
22248	3	0	3	1319	0	1325
22249	1	5	1324	41	0	1371
22250	5	1333	18	25	0	1381
22251	3	1404	24	5	0	1436
22252	1384	33	5	7	0	1429
22253	1400	20	1	10	0	1431
22254	35	5	3	1399	0	1442
22255	1438	5	4	20	0	1467
22256	19	9	1402	21	0	1451
22257	24	2	1403	10	0	1439
22258	4	3	36	1422	0	1465
22259	1497	3	20	24	0	1544
22260	25	2	8	1540	0	1575
22261	28	4	5	1577	0	1614
22262	1581	2	5	47	0	1635
22263	1619	2	6	31	0	1658
22264	47	1698	6	7	0	1758
22265	1738	30	2	8	0	1778
22266	31	28	3	1674	0	1736
22267	32	1713	5	34	0	1784
22268	1690	27	5	35	0	1757
22269	31	1763	8	5	0	1807
22270	31	27	3	1706	0	1767
22271	1698	31	3	32	0	1764
22272	33	9	1686	32	0	1760
22273	31	9	1671	11	0	1722
22274	15	4	50	1645	0	1714
22275	8	1	30	1632	0	1671
22276	3	5	8	1591	0	1607
22277	4	1778	7	52	0	1841
22278	1799	30	0	29	0	1858
22279	1802	32	2	9	0	1845
22280	1833	3	3	12	0	1851
22281	67	1952	3	7	0	2029
22282	36	34	7	2056	0	2133
22283	5	33	6	2066	0	2110
22284	7	7	5	2068	0	2087
22285	1881	2	4	80	0	1967
22286	39	1903	5	42	0	1989
22287	42	40	2	1902	0	1986
22288	11	37	3	1931	0	1982
22289	11	7	1859	74	0	1951
22290	6	1861	38	42	0	1947
22291	11	37	37	1862	0	1947
22292	7	36	7	1910	0	1960
22293	11	7	1	1902	0	1921
22294	1822	6	1	74	0	1903
22295	39	1813	6	51	0	1909
22296	1865	39	3	13	0	1920
22297	50	34	1	1821	0	1906
22298	1877	4	7	40	0	1928
22299	39	11	1829	37	0	1916
22300	1845	9	34	14	0	1902
22301	1845	5	35	22	0	1907
22302	74	5	1838	19	0	1936
22303	53	9	30	1846	0	1938
22304	21	7	38	1860	0	1926
22305	1873	10	6	77	0	1966
22306	47	3	5	1982	0	2037
22307	45	6	6	1999	0	2056
22308	10	11	8	2047	0	2076
22309	14	11	1948	84	0	2057
22310	1787	9	29	68	0	1893
22311	44	1973	44	16	0	2077
22312	55	39	6	1881	0	1981
22313	19	1963	6	44	0	2032
22314	19	2004	11	48	0	2082
22315	12	75	8	2004	0	2099
22316	14	56	1967	57	0	2094
22317	13	15	1984	60	0	2072
22318	14	18	75	1955	0	2062
22319	20	9	1997	60	0	2086
22320	1929	8	43	52	0	2032
22321	50	14	48	2016	0	2128
22322	57	11	10	2059	0	2137
22323	16	2037	8	104	0	2165
22324	18	41	8	2079	0	2146
22325	13	48	13	2039	0	2113
22326	15	2027	11	97	0	2150
22327	22	45	7	2050	0	2124
22328	22	47	11	2016	0	2096
22329	17	2002	9	102	0	2130
22330	2000	45	9	72	0	2126
22331	57	55	1988	32	0	2132
22332	58	18	2018	27	0	2121
22333	19	29	75	1966	0	2089
22334	18	11	70	1993	0	2092
22335	16	13	1969	104	0	2102
22336	18	12	1943	67	0	2040
22337	1719	23	79	30	0	1851
22338	47	1898	55	30	0	2030
22339	1891	45	10	39	0	1985
22340	47	50	1838	40	0	1975
22341	56	1828	50	29	0	1963
22342	25	48	45	1846	0	1964
22343	19	46	1893	61	0	2019
22344	13	9	1874	65	0	1961
22345	22	11	84	1942	0	2059
22346	23	16	1951	61	0	2051
22347	21	1868	45	65	0	1999
22348	19	47	50	1835	0	1951
22349	22	46	1831	60	0	1959
22350	14	1801	54	62	0	1931
22351	1772	52	64	24	0	1912
22352	64	45	1757	24	0	1890
22353	48	1811	57	27	0	1943
22354	15	45	60	1765	0	1885
22355	14	45	18	1831	0	1908
22356	1780	14	20	98	0	1912
22357	59	9	8	1780	0	1856
22358	40	13	14	1726	0	1793
22359	1675	13	9	101	0	1798
22360	47	12	10	1699	0	1768
22361	43	12	1610	62	0	1727
22362	20	9	45	1604	0	1678
22363	11	9	1595	57	0	1672
22364	10	3	1501	45	0	1559
22365	9	11	1504	19	0	1543
22366	63	4	60	1348	0	1475
22367	11	4	38	1411	0	1464
22368	1398	3	12	60	0	1473
22369	31	2	16	1336	0	1385
22370	28	1416	9	41	0	1494
22371	13	29	3	1453	0	1498
22372	9	24	7	1410	0	1450
22373	1	1445	15	62	0	1523
22374	1428	34	1	48	0	1511
22375	1432	30	10	20	0	1492
22376	53	1404	15	13	0	1485
22377	26	1283	10	12	0	1331
22378	6	96	7	1226	0	1335
22379	1265	28	6	28	0	1327
22380	26	8	1266	27	0	1327
22381	24	6	1140	8	0	1178
22382	1015	7	25	5	0	1052
22383	19	1084	19	5	0	1127
22384	17	17	11	1087	0	1132
22385	6	19	8	1070	0	1103
22386	5	6	6	1091	0	1108
22387	3	6	5	1089	0	1103
22388	9	1081	9	29	0	1128
22389	1	17	5	1107	0	1130
22390	1087	17	3	30	0	1137
22391	18	7	2	1132	0	1159
22392	16	4	2	1133	0	1155
22393	1115	1	7	38	0	1161
22394	1126	6	6	22	0	1160
22395	1140	5	0	15	0	1160
22396	1141	4	2	9	0	1156
22397	37	5	3	1116	0	1161
22398	1123	1	4	24	0	1152
22399	25	2	1	1116	0	1144
22400	1105	3	2	23	0	1133
22401	1111	1	4	19	0	1135
22402	34	2	4	1107	0	1147
22403	24	6	1096	25	0	1151
22404	1091	0	18	26	0	1135
22405	1119	2	17	9	0	1147
22406	1075	2	8	12	0	1097
22407	1086	4	5	8	0	1103
22408	34	3	4	1100	0	1141
22409	20	3	1120	22	0	1165
22410	16	3	1143	15	0	1177
22411	1095	3	23	14	0	1135
22412	1172	4	12	5	0	1193
22413	32	1169	10	6	0	1217
22414	14	1141	3	6	0	1164
22415	1131	20	5	7	0	1163
22416	22	12	2	1126	0	1162
22417	13	6	4	1160	0	1183
22418	1153	3	4	27	0	1187
22419	17	1121	4	14	0	1156
22420	1148	16	1	14	0	1179
22421	25	16	1134	6	0	1181
22422	1084	5	14	11	0	1114
22423	18	1	12	1127	0	1158
22424	19	1	1199	21	0	1240
22425	7	1212	15	16	0	1250
22426	11	13	10	1263	0	1297
22427	8	13	1294	16	0	1331
22428	9	5	11	1274	0	1299
22429	1331	2	14	29	0	1376
22430	20	7	1361	16	0	1404
22431	1287	3	17	10	0	1317
22432	24	1388	14	9	0	1435
22433	14	12	12	1399	0	1437
22434	11	15	1534	17	0	1577
22435	11	4	16	1504	0	1535
22436	6	5	1539	26	0	1576
22437	8	1513	21	27	0	1569
22438	1509	15	11	8	0	1543
22439	20	1594	6	10	0	1630
22440	12	19	5	1553	0	1589
22441	10	25	1	1561	0	1597
22442	8	9	1505	26	0	1548
22443	1118	8	9	21	0	1156
22444	16	1380	15	5	0	1416
22445	9	1262	6	1	0	1278
22446	5	1280	3	6	0	1294
22447	3	20	2	1247	0	1272
22448	2	1273	3	6	0	1284
22449	7	4	2	1234	0	1247
22450	1	1254	3	10	0	1268
22451	3	5	0	1223	0	1231
22452	1	1297	6	5	0	1309
22453	1334	4	5	5	0	1348
22454	4	5	1351	2	0	1362
22455	1279	2	6	6	0	1293
22456	1331	3	5	5	0	1344
22457	1365	1	4	6	0	1376
22458	7	1379	7	1	0	1394
22459	1384	4	4	5	0	1397
22460	1380	5	2	3	0	1390
22461	1412	5	4	5	0	1426
22462	15	4	1394	3	0	1416
22463	10	3	9	1374	0	1396
22464	8	6	1389	11	0	1414
22465	3	3	10	1385	0	1401
22466	1391	3	6	17	0	1417
22467	9	1414	9	6	0	1438
22468	9	13	1601	6	0	1629
22469	6	11	11	1682	0	1710
22470	1	5	11	1700	0	1717
22471	4	5	1976	24	0	2009
22472	1893	8	22	17	0	1940
22473	2002	3	28	10	0	2043
22474	2055	3	7	9	0	2074
22475	55	3	4	2032	0	2094
22476	36	2013	5	24	0	2078
22477	11	2087	4	32	0	2134
22478	12	59	2	2057	0	2130
22479	6	36	3	2027	0	2072
22480	4	2048	8	52	0	2112
22481	2048	25	2	36	0	2111
22482	28	2089	5	9	0	2131
22483	33	31	3	2048	0	2115
22484	10	37	2044	28	0	2119
22485	7	7	29	2043	0	2086
22486	2072	3	32	38	0	2145
22487	29	5	2048	33	0	2115
22488	2076	2	26	10	0	2114
22489	2118	4	35	7	0	2164
22490	2165	3	6	6	0	2180
22491	2223	2	3	11	0	2239
22492	2246	4	6	6	0	2262
22493	63	8	2181	4	0	2256
22494	45	7	2189	6	0	2247
22495	2304	3	60	5	0	2372
22496	2405	3	37	8	0	2453
22497	72	7	4	2446	0	2529
22498	43	2517	8	37	0	2605
22499	12	32	6	2556	0	2606
22500	2606	40	1	44	0	2691
22501	43	8	2	2498	0	2551
22502	44	2711	4	39	0	2798
22503	2736	37	2	46	0	2821
22504	2733	43	4	12	0	2792
22505	2739	11	3	14	0	2767
22506	80	2702	17	8	0	2807
22507	56	37	4	2672	0	2769
22508	23	41	2	2612	0	2678
22509	13	2590	7	73	0	2683
22510	12	35	5	2644	0	2696
22511	2608	46	6	45	0	2705
22512	2604	9	7	49	0	2669
22513	89	2603	11	12	0	2715
22514	55	36	8	2628	0	2727
22515	16	45	10	2661	0	2732
22516	27	7	3	2713	0	2750
22517	2609	6	4	87	0	2706
22518	44	13	2586	56	0	2699
22519	2480	5	43	28	0	2556
22520	57	8	2646	16	0	2727
22521	63	10	45	2424	0	2542
22522	24	2535	55	47	0	2661
22523	24	2638	13	49	0	2724
22524	2544	79	5	22	0	2650
22525	2529	52	6	24	0	2611
22526	87	2447	10	19	0	2563
22527	67	2500	6	22	0	2595
22528	2514	84	11	19	0	2628
22529	2499	63	9	19	0	2590
22530	104	2558	10	15	0	2687
22531	2668	51	9	17	0	2745
22532	64	63	2580	19	0	2726
22533	2667	17	41	20	0	2745
22534	2657	12	51	17	0	2737
22535	115	9	11	2569	0	2704
22536	79	2541	12	61	0	2693
22537	35	60	11	2602	0	2708
22538	2598	55	9	66	0	2728
22539	93	9	6	2595	0	2703
22540	75	11	9	2661	0	2756
22541	30	15	2623	115	0	2783
22542	34	12	57	2669	0	2772
22543	27	8	59	2703	0	2797
22544	2640	12	16	118	0	2786
22545	73	18	2655	74	0	2820
22546	2699	14	62	32	0	2807
22547	83	19	49	2709	0	2860
22548	77	15	11	2743	0	2846
22549	40	12	14	2708	0	2774
22550	23	2654	8	117	0	2802
22551	27	2798	9	70	0	2904
22552	29	104	9	2695	0	2837
22553	2669	62	7	66	0	2804
22554	2722	19	8	65	0	2814
22555	129	17	8	2665	0	2819
22556	2719	15	3	74	0	2811
22557	82	19	6	2712	0	2819
22558	73	11	3	2698	0	2785
22559	2590	15	4	119	0	2728
22560	66	2615	14	79	0	2774
22561	2639	63	9	24	0	2735
22562	2607	47	8	32	0	2694
22563	2619	18	4	29	0	2670
22564	112	2576	10	29	0	2727
22565	68	60	9	2620	0	2757
22566	32	50	11	2660	0	2753
22567	27	19	2533	118	0	2697
22568	28	33	51	2375	0	2487
22569	19	26	2219	62	0	2326
22570	19	2150	62	52	0	2283
22571	19	1853	30	13	0	1915
22572	14	1886	11	18	0	1929
22573	13	57	6	1904	0	1980
22574	29	30	4	1911	0	1974
22575	7	11	5	1846	0	1869
22576	12	8	1	1905	0	1926
22577	9	13	1881	63	0	1966
22578	13	9	2207	36	0	2265
22579	22	9	54	2241	0	2326
22580	12	11	2316	54	0	2393
22581	2258	10	40	41	0	2349
22582	2352	2	35	22	0	2411
22583	73	11	2406	21	0	2511
22584	48	8	36	2420	0	2512
22585	20	10	36	2506	0	2572
22586	21	5	10	2545	0	2581
22587	25	8	8	2553	0	2594
22588	19	2	11	2687	0	2719
22589	2172	14	7	88	0	2281
22590	2494	6	10	67	0	2577
22591	71	2477	13	73	0	2634
22592	48	46	2486	21	0	2601
22593	15	2531	41	23	0	2610
22594	13	2539	39	20	0	2611
22595	2351	70	8	13	0	2442
22596	40	2388	13	16	0	2457
22597	33	2258	10	10	0	2311
22598	2212	70	4	16	0	2302
22599	39	37	2200	10	0	2286
22600	2167	10	34	8	0	2219
22601	41	11	30	2188	0	2270
22602	40	8	7	2030	0	2085
22603	18	7	6	2041	0	2072
22604	13	8	1980	73	0	2074
22605	11	1985	38	44	0	2078
22606	1964	36	31	27	0	2058
22607	39	33	13	2027	0	2112
22608	39	2065	9	44	0	2157
22609	13	42	13	2128	0	2196
22610	22	44	2062	39	0	2167
22611	19	10	39	2095	0	2163
22612	9	10	34	2114	0	2167
22613	10	8	8	2172	0	2198
22614	2121	7	7	84	0	2219
22615	44	5	7	2173	0	2229
22616	35	5	2114	63	0	2217
22617	9	2065	34	56	0	2164
22618	15	38	32	2081	0	2166
22619	16	38	10	2093	0	2157
22620	7	16	2039	76	0	2138
22621	10	19	2023	39	0	2091
22622	1950	27	83	23	0	2083
22623	1965	18	37	22	0	2042
22624	72	1962	20	13	0	2067
22625	1986	37	16	13	0	2052
22626	47	37	1949	14	0	2047
22627	40	10	1931	22	0	2003
22628	1879	7	58	30	0	1974
22629	1950	6	28	33	0	2017
22630	61	3	1883	32	0	1979
22631	1819	4	37	30	0	1890
22632	47	9	1876	21	0	1953
22633	1801	7	28	11	0	1847
22634	1794	19	32	10	0	1855
22635	45	20	19	1612	0	1696
22636	35	1827	17	24	0	1903
22637	1471	39	15	36	0	1561
22638	34	40	1857	19	0	1950
22639	35	1826	21	18	0	1900
22640	1817	27	31	17	0	1892
22641	1753	34	11	21	0	1819
22642	51	1755	16	24	0	1846
22643	44	21	15	1785	0	1865
22644	16	33	1754	44	0	1847
22645	12	7	29	1778	0	1826
22646	18	13	1755	33	0	1819
22647	13	15	33	1741	0	1802
22648	18	13	35	1731	0	1797
22649	20	16	1717	51	0	1804
22650	14	1697	29	47	0	1787
22651	21	31	33	1601	0	1686
22652	24	41	1310	45	0	1420
22653	1588	12	28	46	0	1674
22654	35	15	28	1653	0	1731
22655	39	9	16	1684	0	1748
22656	1654	5	19	71	0	1749
22657	46	4	17	1692	0	1759
22658	50	9	15	1647	0	1721
22659	20	1684	21	64	0	1789
22660	18	33	17	1753	0	1821
22661	18	39	1741	43	0	1841
22662	19	9	38	1675	0	1741
22663	22	1709	38	44	0	1813
22664	19	1747	24	41	0	1831
22665	19	61	16	1736	0	1832
22666	1740	39	13	40	0	1832
22667	43	16	15	1751	0	1825
22668	1751	25	21	34	0	1831
22669	50	12	16	1757	0	1835
22670	1756	9	20	45	0	1830
22671	1758	11	17	45	0	1831
22672	75	21	14	1698	0	1808
22673	45	21	27	1626	0	1719
22674	18	1622	29	70	0	1739
22675	27	1668	22	43	0	1760
22676	23	44	1612	32	0	1711
22677	18	1610	36	32	0	1696
22678	1177	22	36	14	0	1249
22679	29	17	8	1148	0	1202
22680	19	1137	12	25	0	1193
22681	1144	21	7	22	0	1194
22682	29	16	6	1119	0	1170
22683	24	5	11	1030	0	1070
22684	13	5	6	1086	0	1110
22685	15	5	15	1070	0	1105
22686	15	1144	11	37	0	1207
22687	18	1177	8	24	0	1227
22688	1115	25	8	13	0	1161
22689	27	1159	8	10	0	1204
22690	21	18	9	1123	0	1171
22691	9	13	6	1122	0	1150
22692	12	5	2	1136	0	1155
22693	9	5	2	1146	0	1162
22694	1113	9	5	32	0	1159
22695	1148	3	4	22	0	1177
22696	36	3	1167	7	0	1213
22697	22	5	24	1161	0	1212
22698	14	7	1179	28	0	1228
22699	8	1	24	1161	0	1194
22700	3	7	20	1168	0	1198
22701	1165	7	2	47	0	1221
22702	25	3	5	1174	0	1207
22703	16	6	1150	36	0	1208
22704	6	5	1127	20	0	1158
22705	1092	2	36	12	0	1142
22706	27	4	1153	10	0	1194
22707	18	5	26	1056	0	1105
22708	7	8	1075	30	0	1120
22709	6	3	25	1033	0	1067
22710	4	1038	17	32	0	1091
22711	2	26	5	1009	0	1042
22712	0	1048	6	31	0	1085
22713	1	1041	2	22	0	1066
22714	6	35	1	1019	0	1061
22715	1003	16	1	26	0	1046
22716	22	1026	5	20	0	1073
22717	16	22	2	1033	0	1073
22718	1065	16	2	27	0	1110
22719	1085	4	2	21	0	1112
22720	1124	3	3	13	0	1143
22721	40	1	1	1094	0	1136
22722	20	3	3	1109	0	1135
22723	1099	4	4	35	0	1142
22724	1113	1	2	25	0	1141
22725	1135	4	4	9	0	1152
22726	37	4	3	1095	0	1139
22727	20	4	1058	28	0	1110
22728	1029	5	23	18	0	1075
22729	27	3	15	1002	0	1047
22730	14	1023	6	31	0	1074
22731	6	21	3	1027	0	1057
22732	8	1022	3	27	0	1060
22733	3	22	6	1018	0	1049
22734	6	18	977	32	0	1033
22735	3	1003	26	18	0	1050
22736	9	19	17	921	0	966
22737	7	15	8	937	0	967
22738	7	4	4	958	0	973
22739	939	3	5	46	0	993
22740	22	978	7	25	0	1032
22741	20	22	5	994	0	1041
22742	1021	17	2	29	0	1069
22743	1038	9	5	21	0	1073
22744	44	5	5	1033	0	1087
22745	30	5	1043	30	0	1108
22746	16	9	28	1006	0	1059
22747	12	1051	27	28	0	1118
22748	6	22	6	1080	0	1114
22749	1064	22	10	35	0	1131
22750	30	8	1	1095	0	1134
22751	24	6	1100	40	0	1170
22752	14	1139	26	30	0	1209
22753	1151	30	25	15	0	1221
22754	28	30	1158	13	0	1229
22755	1171	12	29	12	0	1224
22756	41	5	28	1159	0	1233
22757	34	5	8	1135	0	1182
22758	13	1160	5	56	0	1234
22759	1184	21	4	37	0	1246
22760	28	22	3	1186	0	1239
22761	31	8	5	1168	0	1212
22762	13	3	3	1197	0	1216
22763	14	6	1155	54	0	1229
22764	11	3	25	1189	0	1228
22765	1231	2	29	42	0	1304
22766	1271	2	8	39	0	1320
22767	47	7	9	1263	0	1326
22768	32	3	2	1285	0	1322
22769	1255	7	4	52	0	1318
22770	30	8	1242	36	0	1316
22771	1254	7	24	20	0	1305
22772	35	5	1263	12	0	1315
22773	33	10	1297	7	0	1347
22774	11	8	46	1242	0	1307
22775	8	5	1293	29	0	1335
22776	1273	5	30	33	0	1341
22777	31	3	26	1318	0	1378
22778	29	7	1332	37	0	1405
22779	1277	5	21	37	0	1340
22780	1299	7	22	15	0	1343
22781	52	7	1316	11	0	1386
22782	39	4	25	1216	0	1284
22783	13	1345	24	23	0	1405
22784	1367	24	9	32	0	1432
22785	27	33	1346	13	0	1419
22786	1174	5	19	15	0	1213
22787	28	1250	24	12	0	1314
22788	1213	16	7	12	0	1248
22789	1186	16	2	8	0	1212
22790	1253	5	5	8	0	1271
22791	29	1	5	1248	0	1283
22792	22	1247	3	19	0	1291
22793	12	16	1231	18	0	1277
22794	4	1278	21	8	0	1311
22795	9	21	12	1120	0	1162
22796	6	1198	11	8	0	1223
22797	3	1196	10	23	0	1232
22798	1175	17	1	9	0	1202
22799	14	14	1194	2	0	1224
22800	19	9	1218	4	0	1250
22801	2	5	1210	15	0	1232
22802	4	1219	26	4	0	1253
22803	1249	10	13	4	0	1276
22804	1239	13	4	5	0	1261
22805	1243	3	4	12	0	1262
22806	25	1233	2	6	0	1266
22807	16	11	0	1262	0	1289
22808	11	12	1268	11	0	1302
22809	4	8	1275	17	0	1304
22810	1289	7	19	8	0	1323
22811	1341	6	17	5	0	1369
22812	1341	3	4	7	0	1355
22813	34	1	1319	5	0	1359
22814	1299	1	9	13	0	1322
22815	13	3	15	1324	0	1355
22816	18	7	2	1323	0	1350
22817	6	4	1409	22	0	1441
22818	3	1407	17	18	0	1445
22819	7	10	10	1391	0	1418
22820	3	15	1370	25	0	1413
22821	1236	7	14	18	0	1275
22822	17	3	12	1387	0	1419
22823	20	0	11	1382	0	1413
22824	1368	2	4	32	0	1406
22825	16	1	5	1367	0	1389
22826	1365	4	4	20	0	1393
22827	1368	0	7	19	0	1394
22828	30	2	5	1356	0	1393
22829	29	0	2	1374	0	1405
22830	1349	5	8	29	0	1391
22831	18	1	7	1374	0	1400
22832	1406	2	11	28	0	1447
22833	1437	1	10	18	0	1466
22834	1451	1	3	11	0	1466
22835	33	2	7	1408	0	1450
22836	26	2	6	1472	0	1506
22837	1457	4	7	31	0	1499
22838	23	1426	9	26	0	1484
22839	16	1415	6	9	0	1446
22840	1373	17	2	11	0	1403
22841	10	16	1372	6	0	1404
22842	1333	6	9	1	0	1349
22843	16	3	11	1372	0	1402
22844	15	6	1361	8	0	1390
22845	1312	4	7	12	0	1335
22846	11	3	8	1376	0	1398
22847	16	3	2	1390	0	1411
22848	12	2	2	1411	0	1427
22849	5	0	1	1404	0	1410
22850	1374	5	0	16	0	1395
22851	10	1340	4	11	0	1365
22852	1234	4	5	6	0	1249
22853	5	4	1282	7	0	1298
22854	7	8	1301	4	0	1320
22855	2	1344	9	4	0	1359
22856	6	5	4	1329	0	1344
22857	6	6	1344	5	0	1361
22858	6	1241	3	25	0	1275
22859	12	5	1282	7	0	1306
22860	2	1	4	1247	0	1254
22861	1	3	2	1295	0	1301
22862	1298	1	2	5	0	1306
22863	3	0	0	1271	0	1274
22864	1264	1	0	5	0	1270
22865	5	1	1232	4	0	1242
22866	1	1242	3	3	0	1249
22867	1	2	1	1318	0	1322
22868	2	1	1	1454	0	1458
22869	3	1	1466	3	0	1473
22870	4	5	1408	2	0	1419
22871	1342	0	3	8	0	1353
22872	1491	1	2	1	0	1495
22873	6	0	1	1476	0	1483
22874	2	0	0	1477	0	1479
22875	2	1460	1	3	0	1466
22876	0	2	1	1486	0	1489
22877	1453	1	0	9	0	1463
22878	1513	0	0	5	0	1518
22879	7	1548	1	2	0	1558
22880	1555	7	0	4	0	1566
22881	1567	1	1	2	0	1571
22882	8	1	1	1720	0	1730
22883	4	1716	1	11	0	1732
22884	4	11	0	1735	0	1750
22885	1	7	3	1765	0	1776
22886	2	4	1733	20	0	1759
22887	1775	1	16	16	0	1808
22888	17	0	7	1899	0	1923
22889	16	1	2	2042	0	2061
22890	3	2285	4	40	0	2332
22891	2	31	0	2447	0	2480
22892	2450	24	2	40	0	2516
22893	2624	3	1	37	0	2665
22894	69	5	2654	15	0	2743
22895	42	5	2759	6	0	2812
22896	4	6	78	2726	0	2814
22897	4	0	40	2877	0	2921
22898	10	5	2852	78	0	2945
22899	8	3	2872	44	0	2927
22900	7	1	84	2753	0	2845
22901	2	5	2903	53	0	2963
22902	8	4	2906	41	0	2959
22903	1	2	82	2796	0	2881
22904	2889	0	48	45	0	2982
22905	2927	3	10	42	0	2982
22906	83	3	9	2835	0	2930
22907	47	5	8	2938	0	2998
22908	2878	1	4	89	0	2972
22909	54	2	3	2873	0	2932
22910	2866	0	4	55	0	2925
22911	2845	2	5	44	0	2896
22912	87	1	2	2842	0	2932
22913	46	5	2	2871	0	2924
22914	2783	1	5	89	0	2878
22915	46	2781	7	55	0	2889
22916	48	2839	6	13	0	2906
22917	17	76	3	2710	0	2806
22918	3	52	2690	52	0	2797
22919	8	6	47	2693	0	2754
22920	2695	4	39	60	0	2798
22921	54	7	7	2726	0	2794
22922	2736	5	3	58	0	2802
22923	55	12	2671	50	0	2788
22924	2668	4	51	21	0	2744
22925	56	3	41	2726	0	2826
22926	50	2	10	2776	0	2838
22927	17	9	2763	91	0	2880
22928	17	6	49	2783	0	2855
22929	8	1	50	2843	0	2902
22930	9	6	15	2905	0	2935
22931	2796	3	11	105	0	2915
22932	52	10	2785	57	0	2904
22933	54	13	2734	35	0	2836
22934	2712	4	91	23	0	2830
22935	2772	5	62	24	0	2863
22936	91	8	2768	26	0	2893
22937	64	4	57	2662	0	2787
22938	22	2783	64	55	0	2924
22939	20	41	31	2850	0	2942
22940	2840	35	20	80	0	2975
22941	2862	9	26	57	0	2954
22942	90	4	26	2817	0	2937
22943	55	2831	21	73	0	2980
22944	24	47	25	2721	0	2817
22945	23	2857	25	65	0	2970
22946	2837	50	18	62	0	2967
22947	2765	37	23	43	0	2868
22948	2816	10	23	26	0	2875
22949	103	2685	25	43	0	2856
22950	58	2762	31	35	0	2886
22951	34	104	19	2765	0	2922
22952	32	43	20	2804	0	2899
22953	33	7	21	2802	0	2863
22954	47	3	16	2783	0	2849
22955	28	15	2668	108	0	2819
22956	2514	11	53	84	0	2662
22957	73	17	2703	44	0	2837
22958	2705	9	63	40	0	2817
22959	72	11	2814	47	0	2944
22960	2765	10	58	47	0	2880
22961	77	13	2860	35	0	2985
22962	2759	8	62	41	0	2870
22963	81	4	61	2848	0	2994
22964	2914	5	12	88	0	3019
22965	86	4	19	2955	0	3064
22966	70	10	19	2959	0	3058
22967	47	10	21	2833	0	2911
22968	22	2693	22	121	0	2858
22969	2662	47	18	83	0	2810
22970	2696	39	17	50	0	2802
22971	110	2680	23	40	0	2853
22972	67	51	23	2710	0	2851
22973	34	50	2662	83	0	2829
22974	2619	13	66	68	0	2766
22975	2721	5	53	40	0	2819
22976	2721	6	26	28	0	2781
22977	117	8	15	2560	0	2700
22978	66	2536	24	74	0	2700
22979	30	46	20	2584	0	2680
22980	2532	44	16	72	0	2664
22981	91	10	11	2423	0	2535
22982	50	2355	18	74	0	2497
22983	2312	51	18	53	0	2434
22984	56	40	2330	47	0	2473
22985	63	21	2413	22	0	2519
22986	33	2401	79	21	0	2534
22987	25	2254	43	19	0	2341
22988	46	66	2147	14	0	2273
22989	40	69	1936	14	0	2059
22990	11	121	74	1533	0	1739
22991	1653	1	10	19	0	1683
22992	19	2	1715	9	0	1745
22993	6	1633	8	6	0	1653
22994	1607	7	19	4	0	1637
22995	6	1512	2	1	0	1521
22996	1473	6	10	6	0	1495
22997	6	1465	4	4	0	1479
22998	4	1510	2	3	0	1519
22999	0	10	4	1548	0	1562
23000	1	5	2	1562	0	1570
23001	4	4	1482	10	0	1500
23002	3	0	4	1443	0	1450
23003	1473	1	4	8	0	1486
23004	1478	2	0	6	0	1486
23005	8	2	1	1483	0	1494
23006	5	3	1507	6	0	1521
23007	3	5	1493	7	0	1508
23008	0	4	9	1526	0	1539
23009	2	9	1548	6	0	1565
23010	2	0	8	1524	0	1534
23011	1	1	6	1563	0	1571
23012	3	5	1746	14	0	1768
23013	1637	1	17	10	0	1665
23014	1752	3	11	5	0	1771
23015	28	2	1797	1	0	1828
23016	14	3	1829	5	0	1851
23017	4	0	35	1791	0	1830
23018	3	2	16	2006	0	2027
23019	5	2	0	2060	0	2067
23020	2	0	2	2058	0	2062
23021	2046	1	1	58	0	2106
23022	2109	1	4	32	0	2146
23023	53	3	2	2247	0	2305
23024	29	2	1	2333	0	2365
23025	6	7	2415	74	0	2502
23026	4	2	51	2463	0	2520
23027	5	4	44	2685	0	2738
23028	2756	1	6	114	0	2877
23029	72	2933	7	58	0	3070
23030	68	77	1	2896	0	3042
23031	10	63	3	2988	0	3064
23032	8	8	3	2963	0	2982
23033	5	2729	10	142	0	2886
23034	4	2923	13	78	0	3018
23035	5	137	2	2886	0	3030
23036	5	67	4	2905	0	2981
23037	8	5	2	2975	0	2990
23038	2767	1	4	151	0	2923
23039	78	2793	7	74	0	2952
23040	2845	76	3	15	0	2939
23041	2872	64	4	16	0	2956
23042	141	5	6	2767	0	2919
23043	72	2757	8	84	0	2921
23044	2751	77	3	74	0	2905
23045	78	69	2	2778	0	2927
23046	2865	7	5	90	0	2967
23047	87	4	3	2894	0	2988
23048	66	10	2842	89	0	3007
23049	14	15	2880	68	0	2977
23050	8	10	139	2832	0	2989
23051	12	5	69	2895	0	2981
23052	13	3	11	2862	0	2889
23053	8	2779	13	142	0	2942
23054	11	2919	7	79	0	3016
23055	2834	142	6	27	0	3009
23056	2842	72	4	24	0	2942
23057	134	2805	9	24	0	2972
23058	71	2778	5	20	0	2874
23059	15	2847	9	19	0	2890
23060	2689	142	4	25	0	2860
23061	72	2737	7	25	0	2841
23062	76	82	3	2697	0	2858
23063	2688	65	4	94	0	2851
23064	2741	19	6	86	0	2852
23065	154	10	6	2599	0	2769
23066	85	12	2604	89	0	2790
23067	22	17	2659	84	0	2782
23068	18	12	137	2612	0	2779
23069	17	11	2684	95	0	2807
23070	16	14	83	2646	0	2759
23071	21	15	67	2647	0	2750
23072	13	24	2571	157	0	2765
23073	19	20	2608	93	0	2740
23074	23	13	144	2528	0	2708
23075	19	14	74	2673	0	2780
23076	2544	16	19	158	0	2737
23077	89	2551	21	93	0	2754
23078	75	2640	19	37	0	2771
23079	2542	140	11	37	0	2730
23080	2599	78	9	47	0	2733
23081	152	2517	17	65	0	2751
23082	83	2598	19	34	0	2734
23083	2550	146	9	38	0	2743
23084	95	79	8	2535	0	2717
23085	2453	23	6	108	0	2590
23086	92	2416	11	95	0	2614
23087	2483	86	18	38	0	2625
23088	102	81	2384	36	0	2603
23089	2416	19	80	54	0	2569
23090	94	16	2452	40	0	2602
23091	89	17	91	2336	0	2533
23092	2227	19	71	110	0	2427
23093	88	19	2126	105	0	2338
23094	85	15	86	2096	0	2282
23095	2077	22	75	103	0	2277
23096	81	28	2060	104	0	2273
23097	82	20	82	2089	0	2273
23098	2040	20	71	104	0	2235
23099	80	1997	12	110	0	2199
23100	83	89	16	2007	0	2195
23101	36	83	19	2032	0	2170
23102	26	30	10	2084	0	2150
23103	29	2007	14	158	0	2208
23104	36	109	9	2087	0	2241
23105	37	87	7	2116	0	2247
23106	38	29	9	2132	0	2208
23107	40	21	6	2128	0	2195
23108	39	27	1957	153	0	2176
23109	1889	17	76	95	0	2077
23110	2000	21	79	25	0	2125
23111	142	1902	25	31	0	2100
23112	84	70	10	1773	0	1937
23113	34	67	13	1781	0	1895
23114	22	1759	25	134	0	1940
23115	25	61	25	1763	0	1874
23116	1657	56	14	88	0	1815
23117	61	1616	25	70	0	1772
23118	1559	46	21	24	0	1650
23119	58	54	8	1506	0	1626
23120	61	14	1477	64	0	1616
23121	15	1482	57	59	0	1613
23122	1395	50	78	25	0	1548
23123	51	1353	9	13	0	1426
23124	48	1311	16	11	0	1386
23125	1133	54	6	9	0	1202
23126	27	37	1113	16	0	1193
23127	23	920	18	7	0	968
23128	637	9	107	9	0	762
23129	564	11	1	1	0	577
23130	6	568	2	0	0	576
23131	5	2	0	592	0	599
23132	1	7	592	2	0	602
23133	0	3	2	587	0	592
23134	0	0	6	597	0	603
23135	1	0	1	643	0	645
23136	2	2	635	7	0	646
23137	0	0	2	604	0	606
23138	2	0	623	2	0	627
23139	2	2	602	7	0	613
23140	500	1	9	5	0	515
23141	2	611	5	1	0	619
23142	5	607	1	1	0	614
23143	0	6	0	638	0	644
23144	707	5	2	5	0	719
23145	717	1	0	6	0	724
23146	661	0	1	1	0	663
23147	663	0	0	2	0	665
23148	628	0	0	1	0	629
23149	11	2	622	0	0	635
23150	8	0	3	623	0	634
23151	0	623	8	3	0	634
23152	1	3	0	636	0	640
23153	648	6	1	3	0	658
23154	3	658	1	7	0	669
23155	6	3	0	666	0	675
23156	662	5	1	6	0	674
23157	706	0	0	10	0	716
23158	10	0	1	719	0	730
23159	6	0	1	712	0	719
23160	1	0	0	710	0	711
23161	2	2	693	13	0	710
23162	1	4	711	7	0	723
23163	1	24	8	713	0	746
23164	4	2	7	750	0	763
23165	758	0	1	9	0	768
23166	726	1	0	7	0	734
23167	763	1	0	2	0	766
23168	811	1	0	2	0	814
23169	799	1	0	1	0	801
23170	9	855	4	3	0	871
23171	986	7	1	6	0	1000
23172	1015	7	1	7	0	1030
23173	1049	1	1	5	0	1056
23174	10	2	1	1070	0	1083
23175	7	4	1066	5	0	1082
23176	4	0	6	1080	0	1090
23177	2	5	1235	6	0	1248
23178	5	1	5	1186	0	1197
23179	3	1251	10	6	0	1270
23180	1274	7	1	10	0	1292
23181	1403	8	1	10	0	1422
23182	12	1	3	1391	0	1407
23183	10	2	1	1465	0	1478
23184	3	1	1	1488	0	1493
23185	2	1529	4	16	0	1551
23186	1534	6	3	9	0	1552
23187	1522	7	1	5	0	1535
23188	13	1561	4	2	0	1580
23189	7	6	1	1549	0	1563
23190	2	9	1	1518	0	1530
23191	2	1551	2	10	0	1565
23192	1547	8	0	11	0	1566
23193	1567	8	2	5	0	1582
23194	20	2	0	1568	0	1590
23195	10	3	1590	8	0	1611
23196	4	5	1529	10	0	1548
23197	2	2	14	1663	0	1681
23198	3	2	8	1678	0	1691
23199	3	1	0	1782	0	1786
23200	1783	2	0	18	0	1803
23201	1825	5	1	12	0	1843
23202	16	1898	3	8	0	1925
23203	1883	7	3	7	0	1900
23204	11	13	1926	3	0	1953
23205	18	7	1896	5	0	1926
23206	4	2029	24	3	0	2060
23207	2004	8	12	4	0	2028
23208	9	2088	7	0	0	2104
23209	2085	12	4	4	0	2105
23210	12	17	2086	2	0	2117
23211	17	6	2055	4	0	2082
23212	7	2	22	2035	0	2066
23213	6	5	2212	16	0	2239
23214	5	0	10	2227	0	2242
23215	2	5	16	2028	0	2051
23216	2	2311	6	27	0	2346
23217	2	12	5	2308	0	2327
23218	5	14	1	2328	0	2348
23219	2359	2	3	29	0	2393
23220	12	2383	6	19	0	2420
23221	19	12	1	2453	0	2485
23222	6	15	2449	18	0	2488
23223	2084	2	13	25	0	2124
23224	15	6	2488	7	0	2516
23225	16	1	14	2370	0	2401
23226	3	2553	24	16	0	2596
23227	5	18	4	2509	0	2536
23228	2604	17	2	17	0	2640
23229	2567	3	3	19	0	2592
23230	34	2665	6	4	0	2709
23231	2742	21	4	9	0	2776
23232	2760	19	3	15	0	2797
23233	2945	7	4	16	0	2972
23234	3007	4	4	8	0	3023
23235	2746	4	5	12	0	2767
23236	41	7	2913	39	0	3000
23237	27	5	23	2901	0	2956
23238	8	4	20	2869	0	2901
23239	11	3	0	2943	0	2957
23240	6	2986	12	44	0	3048
23241	7	26	7	2999	0	3039
23242	10	26	2990	28	0	3054
23243	6	2999	26	27	0	3058
23244	5	2971	24	10	0	3010
23245	6	37	6	2989	0	3038
23246	9	22	9	2979	0	3019
23247	3	9	4	2915	0	2931
23248	7	2927	4	43	0	2981
23249	8	2977	10	23	0	3018
23250	3003	41	5	10	0	3059
23251	2994	20	2	13	0	3029
23252	45	3078	12	8	0	3143
23253	3159	26	3	11	0	3199
23254	3253	26	5	22	0	3306
23255	53	4	7	3298	0	3362
23256	31	8	8	3478	0	3525
23257	12	7	4	3497	0	3520
23258	13	16	3417	58	0	3504
23259	12	13	3367	34	0	3426
23260	11	3587	60	16	0	3674
23261	3604	32	34	21	0	3691
23262	34	44	3752	15	0	3845
23263	3563	7	42	19	0	3631
23264	37	13	3908	16	0	3974
23265	3770	7	46	13	0	3836
23266	42	4064	47	13	0	4166
23267	4020	45	6	26	0	4097
23268	48	46	8	4006	0	4108
23269	58	12	9	4110	0	4189
23270	18	20	4139	90	0	4267
23271	13	4175	49	53	0	4290
23272	14	50	48	4183	0	4295
23273	14	54	4138	53	0	4259
23274	3681	11	45	58	0	3795
23275	46	4122	49	14	0	4231
23276	4112	46	17	18	0	4193
23277	45	4023	23	14	0	4105
23278	51	46	10	3970	0	4077
23279	3941	49	8	52	0	4050
23280	46	4000	13	53	0	4112
23281	48	45	7	3948	0	4048
23282	8	60	3915	56	0	4039
23283	3599	16	54	49	0	3718
23284	49	9	42	3864	0	3964
23285	54	10	3858	51	0	3973
23286	20	3852	44	54	0	3970
23287	19	50	41	3832	0	3942
23288	18	54	3821	48	0	3941
23289	18	9	43	3669	0	3739
23290	18	3915	48	46	0	4027
23291	13	3988	13	59	0	4073
23292	14	90	3930	18	0	4052
23293	13	49	44	3850	0	3956
23294	19	21	4009	46	0	4095
23295	3725	12	41	52	0	3830
23296	53	11	47	3778	0	3889
23297	41	3757	19	45	0	3862
23298	13	3884	10	45	0	3952
23299	3739	72	6	20	0	3837
23300	45	3954	12	15	0	4026
23301	3760	44	12	26	0	3842
23302	48	44	3728	5	0	3825
23303	3499	11	39	19	0	3568
23304	37	3756	42	17	0	3852
23305	3778	41	10	13	0	3842
23306	42	3731	11	10	0	3794
23307	44	44	58	3628	0	3774
23308	12	40	6	3708	0	3766
23309	11	13	3678	67	0	3769
23310	3350	15	38	49	0	3452
23311	44	18	3698	11	0	3771
23312	3600	10	44	20	0	3674
23313	42	4	44	3621	0	3711
23314	43	13	8	3583	0	3647
23315	8	3616	14	78	0	3716
23316	11	39	8	3786	0	3844
23317	14	41	8	3824	0	3887
23318	12	15	3752	89	0	3868
23319	3251	8	45	63	0	3367
23320	49	3600	49	12	0	3710
23321	3617	44	14	12	0	3687
23322	51	44	9	3585	0	3689
23323	52	14	8	3608	0	3682
23324	3518	10	7	79	0	3614
23325	43	3549	14	53	0	3659
23326	3472	40	8	19	0	3539
23327	50	3476	12	14	0	3552
23328	44	3454	14	14	0	3526
23329	3417	74	19	12	0	3522
23330	45	44	12	3361	0	3462
23331	51	27	3519	38	0	3635
23332	19	12	37	3483	0	3551
23333	16	6	48	3374	0	3444
23334	12	3434	16	88	0	3550
23335	16	47	4	3504	0	3571
23336	13	52	9	3493	0	3567
23337	16	15	8	3558	0	3597
23338	18	13	8	3580	0	3619
23339	13	19	3430	91	0	3553
23340	12	20	3597	60	0	3689
23341	12	13	81	3633	0	3739
23342	14	17	3667	61	0	3759
23343	13	21	3562	60	0	3656
23344	23	10	87	3627	0	3747
23345	17	19	3809	54	0	3899
23346	24	20	48	3515	0	3607
23347	10	3764	62	103	0	3939
23348	3863	56	17	67	0	4003
23349	58	69	4384	25	0	4536
23350	78	14	73	4353	0	4518
23351	12	27	4505	73	0	4617
23352	17	8	77	4861	0	4963
23353	21	10	80	5054	0	5165
23354	4947	11	20	185	0	5163
23355	110	11	13	5107	0	5241
23356	4759	12	8	130	0	4909
23357	4883	11	15	117	0	5026
23358	187	4835	16	36	0	5074
23359	4849	97	10	34	0	4990
23360	107	4760	25	18	0	4910
23361	94	4777	17	35	0	4923
23362	4573	163	23	24	0	4783
23363	110	89	4574	20	0	4793
23364	89	21	4550	21	0	4681
23365	4366	57	181	14	0	4618
23366	4453	13	93	16	0	4575
23367	169	4453	28	19	0	4669
23368	4612	83	25	17	0	4737
23369	4525	84	23	21	0	4653
23370	4394	14	15	23	0	4446
23371	179	16	15	4281	0	4491
23372	4269	10	15	107	0	4401
23373	103	4345	23	101	0	4572
23374	109	84	10	4429	0	4632
23375	35	85	18	4417	0	4555
23376	29	4370	20	176	0	4595
23377	30	95	13	4511	0	4649
23378	4404	94	12	115	0	4625
23379	4469	23	14	114	0	4620
23380	183	4300	21	40	0	4544
23381	100	4420	21	31	0	4572
23382	4386	160	17	30	0	4593
23383	118	102	4330	28	0	4578
23384	116	37	4337	26	0	4516
23385	45	33	167	4215	0	4460
23386	52	26	89	4368	0	4535
23387	48	32	4320	179	0	4579
23388	50	4167	108	116	0	4441
23389	49	106	105	4015	0	4275
23390	49	109	4241	112	0	4511
23391	48	27	94	4236	0	4405
23392	49	32	101	4149	0	4331
23393	40	4405	34	178	0	4657
23394	51	101	24	4350	0	4526
23395	50	91	24	4406	0	4571
23396	44	29	27	4512	0	4612
23397	4350	31	17	195	0	4593
23398	140	25	16	4188	0	4369
23399	115	4285	33	117	0	4550
23400	4215	98	16	128	0	4457
23401	134	116	4160	39	0	4449
23402	121	38	4201	40	0	4400
23403	4138	33	173	49	0	4393
23404	143	27	102	4121	0	4393
23405	119	50	4358	119	0	4646
23406	54	26	111	4367	0	4558
23407	50	21	111	4393	0	4575
23408	4316	37	35	190	0	4578
23409	4313	30	25	134	0	4502
23410	197	4356	39	55	0	4647
23411	124	104	23	4265	0	4516
23412	58	100	4264	125	0	4547
23413	45	4411	113	114	0	4683
23414	4351	135	91	58	0	4635
23415	122	4599	42	56	0	4819
23416	4479	113	29	47	0	4668
23417	134	105	4411	52	0	4702
23418	4368	42	106	48	0	4564
23419	4566	37	102	40	0	4745
23420	204	45	4530	39	0	4818
23421	131	35	114	4208	0	4488
23422	53	4472	112	119	0	4756
23423	46	4735	33	106	0	4920
23424	46	4849	29	54	0	4978
23425	55	184	30	4642	0	4911
23426	55	96	4717	135	0	5003
23427	51	43	105	4702	0	4901
23428	49	37	86	4808	0	4980
23429	50	42	4738	201	0	5031
23430	40	4716	133	110	0	4999
23431	45	115	93	4499	0	4752
23432	4557	87	31	143	0	4818
23433	126	25	36	4561	0	4748
23434	103	26	37	4447	0	4613
23435	51	4474	37	185	0	4747
23436	4519	110	17	118	0	4764
23437	132	82	30	4679	0	4923
23438	111	36	4659	128	0	4934
23439	38	4663	107	115	0	4923
23440	4459	106	84	40	0	4689
23441	117	85	4496	42	0	4740
23442	4443	39	99	39	0	4620
23443	139	33	85	4372	0	4629
23444	84	4451	38	94	0	4667
23445	4366	99	27	91	0	4583
23446	4460	71	26	45	0	4602
23447	149	4475	35	43	0	4702
23448	93	95	18	4258	0	4464
23449	31	46	19	3962	0	4058
23450	3810	18	17	101	0	3946
23451	80	3799	15	63	0	3957
23452	38	46	16	3321	0	3421
23453	14	3205	9	47	0	3275
23454	11	3141	13	30	0	3195
23455	9	63	33	3020	0	3125
23456	2999	23	6	33	0	3061
23457	34	2998	7	17	0	3056
23458	21	29	8	3003	0	3061
23459	15	13	6	3035	0	3069
23460	8	14	3017	43	0	3082
23461	12	17	2925	26	0	2980
23462	7	3052	41	14	0	3114
23463	8	37	2968	15	0	3028
23464	11	18	28	2882	0	2939
23465	7	18	3026	27	0	3078
23466	9	3	25	3059	0	3096
23467	10	4	28	3127	0	3169
23468	11	9	7	3123	0	3150
23469	3021	8	4	43	0	3076
23470	29	6	5	3029	0	3069
23471	21	9	2	3012	0	3044
23472	8	3017	9	37	0	3071
23473	9	28	3	3001	0	3041
23474	2918	21	4	33	0	2976
23475	23	3015	7	24	0	3069
23476	3068	27	4	24	0	3123
23477	31	24	3073	15	0	3143
23478	16	18	3041	8	0	3083
23479	14	9	41	3096	0	3160
23480	14	9	21	3158	0	3202
23481	8	3190	22	43	0	3263
23482	8	33	15	3031	0	3087
23483	3149	24	5	37	0	3215
23484	3198	9	15	26	0	3248
23485	44	15	11	3278	0	3348
23486	25	21	3621	43	0	3710
23487	17	12	33	3649	0	3711
23488	15	11	23	3891	0	3940
23489	11	15	13	3935	0	3974
23490	7	10	13	3887	0	3917
23491	7	11	11	3788	0	3817
23492	7	3804	12	70	0	3893
23493	3679	32	8	44	0	3763
23494	3686	26	11	33	0	3756
23495	3735	16	9	29	0	3789
23496	54	3781	11	26	0	3872
23497	3752	37	7	30	0	3826
23498	45	3767	8	27	0	3847
23499	35	54	3670	23	0	3782
23500	19	34	39	3589	0	3681
23501	20	19	3694	49	0	3782
23502	10	3681	50	40	0	3781
23503	3589	38	37	37	0	3701
23504	45	32	3801	32	0	3910
23505	39	25	4018	23	0	4105
23506	19	4207	81	25	0	4332
23507	34	55	43	4265	0	4397
23508	21	55	4680	76	0	4832
23509	19	18	66	4555	0	4658
23510	20	15	51	5104	0	5190
23511	19	12	16	5404	0	5451
23512	5647	8	13	161	0	5829
23513	5640	12	10	91	0	5753
23514	165	13	7	5593	0	5778
23515	5570	13	12	103	0	5698
23516	88	26	5398	95	0	5607
23517	99	18	5397	23	0	5537
23518	26	20	5626	25	0	5697
23519	19	14	5614	32	0	5679
23520	22	5579	150	21	0	5772
23521	61	76	103	5359	0	5599
23522	18	79	5512	92	0	5701
23523	5041	14	91	91	0	5237
23524	5414	12	82	31	0	5539
23525	140	5494	35	28	0	5697
23526	5535	80	29	12	0	5656
23527	103	79	34	5505	0	5721
23528	94	31	5663	87	0	5875
23529	27	19	106	5255	0	5407
23530	17	5679	103	84	0	5883
23531	5645	84	34	101	0	5864
23532	5661	76	23	49	0	5809
23533	161	5759	33	28	0	5981
23534	5918	87	12	39	0	6056
23535	5813	87	14	32	0	5946
23536	178	5832	29	23	0	6062
23537	116	91	24	5492	0	5723
23538	27	5700	28	107	0	5862
23539	5692	94	18	92	0	5896
23540	110	83	29	5702	0	5924
23541	5749	30	29	101	0	5909
23542	112	20	21	5733	0	5886
23543	106	39	5617	108	0	5870
23544	5448	25	98	95	0	5666
23545	116	26	5741	40	0	5923
23546	109	16	97	5531	0	5753
23547	45	29	5635	101	0	5810
23548	38	23	98	5584	0	5743
23549	45	33	5607	107	0	5792
23550	5288	12	106	115	0	5521
23551	108	5557	105	54	0	5824
23552	5598	86	33	39	0	5756
23553	109	81	31	5572	0	5793
23554	5531	24	44	99	0	5698
23555	119	5548	38	99	0	5804
23556	103	5544	50	40	0	5737
23557	33	5839	38	34	0	5944
23558	5802	161	28	40	0	6031
23559	114	90	23	5789	0	6016
23560	117	31	39	5870	0	6057
23561	48	40	5747	181	0	6016
23562	40	64	5739	97	0	5940
23563	68	19	158	5805	0	6050
23564	47	32	6036	121	0	6236
23565	34	5897	120	103	0	6154
23566	5831	107	112	43	0	6093
23567	119	104	5890	30	0	6143
23568	106	42	5901	45	0	6094
23569	46	20	184	5770	0	6020
23570	5931	29	107	127	0	6194
23571	122	17	48	5989	0	6176
23572	5984	18	42	125	0	6169
23573	120	17	51	6012	0	6200
23574	106	32	6181	131	0	6450
23575	53	6018	131	108	0	6310
23576	61	113	6218	43	0	6435
23577	49	6255	135	38	0	6477
23578	46	93	107	6194	0	6440
23579	6111	95	45	120	0	6371
23580	124	37	6159	133	0	6453
23581	135	24	117	6087	0	6363
23582	66	26	103	6296	0	6491
23583	6228	27	41	199	0	6495
23584	127	24	34	6107	0	6292
23585	95	6221	63	117	0	6496
23586	5871	99	41	109	0	6120
23587	107	112	5792	54	0	6065
23588	5490	31	104	34	0	5659
23589	106	5743	104	39	0	5992
23590	131	106	29	5341	0	5607
23591	43	5834	34	122	0	6033
23592	5751	97	38	103	0	5989
23593	128	104	5814	46	0	6092
23594	5713	64	91	52	0	5920
23595	109	5942	106	41	0	6198
23596	108	94	31	5942	0	6175
23597	5976	84	24	112	0	6196
23598	6032	30	37	97	0	6196
23599	175	23	27	6032	0	6257
23600	100	41	27	6064	0	6232
23601	49	6082	31	177	0	6339
23602	51	140	24	6088	0	6303
23603	43	7100	29	101	0	7273
23604	42	7249	40	98	0	7429
23605	37	240	20	6451	0	6748
23606	20	6721	32	128	0	6901
23607	56	113	6734	115	0	7018
23608	52	108	6929	29	0	7118
23609	27	6908	231	61	0	7227
23610	51	127	6922	29	0	7129
23611	20	113	6871	26	0	7030
23612	14	18	6524	10	0	6566
23613	9	6334	215	16	0	6574
23614	6241	111	108	9	0	6469
23615	109	6327	32	13	0	6481
23616	124	132	6278	13	0	6547
23617	19	95	122	6126	0	6362
23618	6134	18	98	118	0	6368
23619	125	21	6171	93	0	6410
23620	104	13	126	6055	0	6298
23621	22	15	6367	125	0	6529
23622	19	6	132	6215	0	6372
23623	6073	13	107	138	0	6331
23624	124	20	6226	111	0	6481
23625	97	6194	132	27	0	6450
23626	22	124	98	5931	0	6175
23627	6152	105	21	118	0	6396
23628	127	30	6145	99	0	6401
23629	116	19	123	5505	0	5763
23630	20	6124	115	100	0	6359
23631	6277	113	25	89	0	6504
23632	6503	99	27	18	0	6647
23633	227	22	19	6258	0	6526
23634	120	6523	26	134	0	6803
23635	27	6722	27	102	0	6878
23636	6881	240	22	27	0	7170
23637	164	136	17	6599	0	6916
23638	128	6926	32	158	0	7244
23639	6882	179	18	132	0	7211
23640	173	132	18	6979	0	7302
23641	145	26	18	7117	0	7306
23642	31	33	6735	290	0	7089
23643	23	6960	168	149	0	7300
23644	16	7249	141	35	0	7441
23645	30	280	24	7024	0	7358
23646	7056	142	30	170	0	7398
23647	167	7046	28	135	0	7376
23648	7126	173	20	34	0	7353
23649	177	7132	38	25	0	7372
23650	146	177	25	6940	0	7288
23651	7054	146	15	173	0	7388
23652	190	37	12	7159	0	7398
23653	159	46	7018	180	0	7403
23654	40	30	168	6631	0	6869
23655	21	6923	159	189	0	7292
23656	6879	173	39	144	0	7235
23657	186	6968	40	37	0	7231
23658	161	188	29	6601	0	6979
23659	48	143	32	6879	0	7102
23660	31	59	6698	290	0	7078
23661	25	46	6775	164	0	7010
23662	38	47	299	6497	0	6881
23663	30	46	6567	183	0	6826
23664	16	6396	203	158	0	6773
23665	6282	178	145	51	0	6656
23666	180	158	6368	34	0	6740
23667	6337	47	173	39	0	6596
23668	6522	38	151	46	0	6757
23669	6578	47	40	42	0	6707
23670	6610	38	42	42	0	6732
23671	311	33	41	6304	0	6689
23672	171	39	43	6204	0	6457
23673	50	6250	50	286	0	6636
23674	6099	183	45	156	0	6483
23675	182	170	6097	48	0	6497
23676	163	47	181	5842	0	6233
23677	60	49	162	6016	0	6287
23678	59	55	5796	308	0	6218
23679	42	5845	193	171	0	6251
23680	71	178	160	5509	0	5918
23681	53	152	51	5988	0	6244
23682	5751	46	48	315	0	6160
23683	184	5816	49	193	0	6242
23684	170	189	29	5647	0	6035
23685	51	5793	42	192	0	6078
23686	66	191	35	5843	0	6135
23687	5721	152	32	205	0	6110
23688	5881	42	35	173	0	6131
23689	317	42	38	5685	0	6082
23690	5784	33	31	215	0	6063
23691	5703	39	32	181	0	5955
23692	310	5601	50	73	0	6034
23693	189	192	24	5280	0	5685
23694	65	5566	43	196	0	5870
23695	67	202	30	5539	0	5838
23696	5442	174	17	205	0	5838
23697	211	61	19	5574	0	5865
23698	168	52	26	5620	0	5866
23699	76	55	5340	317	0	5788
23700	66	5122	161	189	0	5538
23701	50	5374	145	88	0	5657
23702	5139	273	36	61	0	5509
23703	126	166	20	3900	0	4212
23704	3748	45	24	126	0	3943
23705	131	3632	23	115	0	3901
23706	100	3492	23	48	0	3663
23707	42	3620	24	48	0	3734
23708	2920	125	53	34	0	3132
23709	71	2939	56	23	0	3089
23710	2829	65	33	21	0	2948
23711	2721	49	3	30	0	2803
23712	2843	14	7	31	0	2895
23713	105	10	9	2994	0	3118
23714	58	14	14	3033	0	3119
23715	16	9	12	3084	0	3121
23716	18	7	11	3057	0	3093
23717	2959	14	7	118	0	3098
23718	74	2946	12	61	0	3093
23719	59	68	11	2962	0	3100
23720	2965	46	7	86	0	3104
23721	73	13	10	2907	0	3003
23722	61	7	8	2946	0	3022
23723	2819	17	4	118	0	2958
23724	79	12	2783	61	0	2935
23725	58	12	59	2791	0	2920
23726	19	18	2872	82	0	2991
23727	22	7	65	2850	0	2944
23728	22	10	49	2877	0	2958
23729	2806	11	13	116	0	2946
23730	67	2753	12	70	0	2902
23731	50	2676	15	16	0	2757
23732	2467	74	3	18	0	2562
23733	51	2475	15	20	0	2561
23734	2430	40	1	20	0	2491
23735	49	25	2400	13	0	2487
23736	2043	0	18	9	0	2070
23737	2098	0	10	8	0	2116
23738	2124	2	1	12	0	2139
23739	36	2	0	2089	0	2127
23740	16	1	3	2065	0	2085
23741	3	2077	1	29	0	2110
23742	1	18	2	2078	0	2099
23743	2036	13	1	24	0	2074
23744	18	2038	3	18	0	2077
23745	15	2062	2	5	0	2084
23746	2028	30	5	7	0	2070
23747	19	23	2036	3	0	2081
23748	19	4	19	1987	0	2029
23749	3	6	2071	24	0	2104
23750	8	2	20	1992	0	2022
23751	3	2039	24	15	0	2081
23752	2	20	1	2059	0	2082
23753	2046	14	1	28	0	2089
23754	21	1	2	2071	0	2095
23755	17	3	2088	23	0	2131
23756	1851	2	18	21	0	1892
23757	21	2117	15	4	0	2157
23758	16	2229	2	3	0	2250
23759	2332	39	0	14	0	2385
23760	2484	18	0	17	0	2519
23761	50	9	2478	4	0	2541
23762	2338	5	33	14	0	2390
23763	36	2476	29	7	0	2548
23764	2533	32	5	9	0	2579
23765	44	29	3	2411	0	2487
23766	28	2404	8	32	0	2472
23767	2379	36	17	30	0	2462
23768	42	29	2443	7	0	2521
23769	25	1	36	2450	0	2512
23770	2535	4	26	49	0	2614
23771	40	9	2529	31	0	2609
23772	2540	2	38	13	0	2593
23773	38	4	26	2536	0	2604
23774	28	6	3	2603	0	2640
23775	11	12	2610	64	0	2697
23776	11	0	35	2638	0	2684
23777	2649	4	30	44	0	2727
23778	38	2585	8	28	0	2659
23779	2646	35	7	9	0	2697
23780	2644	30	2	13	0	2689
23781	68	4	2	2627	0	2701
23782	33	13	2634	39	0	2719
23783	10	5	34	2585	0	2634
23784	2608	5	26	42	0	2681
23785	36	2570	5	31	0	2642
23786	2654	34	2	15	0	2705
23787	41	25	5	2624	0	2695
23788	35	6	1	2669	0	2711
23789	12	7	1	2681	0	2701
23790	15	13	2620	59	0	2707
23791	11	3	36	2611	0	2661
23792	14	9	2586	43	0	2652
23793	8	13	2644	32	0	2697
23794	13	3	59	3163	0	3238
23795	11	18	3240	54	0	3323
23796	3304	9	51	61	0	3425
23797	60	9	54	3469	0	3592
23798	66	6	16	3411	0	3499
23799	15	3552	10	119	0	3696
23800	3588	55	9	70	0	3722
23801	3804	65	11	25	0	3905
23802	127	3893	8	9	0	4037
23803	81	60	8	3876	0	4025
23804	22	69	3891	63	0	4045
23805	3656	16	62	76	0	3810
23806	3949	6	64	27	0	4046
23807	133	9	15	3786	0	3943
23808	79	11	3708	70	0	3868
23809	23	3645	70	69	0	3807
23810	3573	67	64	24	0	3728
23811	78	75	3569	13	0	3735
23812	78	3488	68	12	0	3646
23813	3322	54	67	14	0	3457
23814	3376	62	16	11	0	3465
23815	118	16	7	3285	0	3426
23816	79	3324	9	53	0	3465
23817	26	51	4	3512	0	3593
23818	15	70	5	3515	0	3605
23819	25	14	10	3516	0	3565
23820	12	8	7	3586	0	3613
23821	11	9	3457	131	0	3608
23822	19	6	57	3470	0	3552
23823	19	7	68	3508	0	3602
23824	24	11	3441	119	0	3595
23825	17	3428	63	82	0	3590
23826	3399	52	70	36	0	3557
23827	3407	66	21	20	0	3514
23828	127	22	7	3431	0	3587
23829	3473	10	8	62	0	3553
23830	80	7	11	3535	0	3633
23831	86	19	3544	81	0	3730
23832	29	15	3518	91	0	3653
23833	18	3482	136	38	0	3674
23834	3416	61	88	25	0	3590
23835	78	84	3732	20	0	3914
23836	93	23	81	3441	0	3638
23837	40	8	90	3853	0	3991
23838	29	15	22	3964	0	4030
23839	20	11	8	3994	0	4033
23840	24	6	22	4018	0	4070
23841	16	20	3828	195	0	4059
23842	29	18	73	3945	0	4065
23843	3841	11	102	107	0	4061
23844	79	3775	43	125	0	4022
23845	3839	77	17	49	0	3982
23846	102	3849	30	28	0	4009
23847	3855	90	15	33	0	3993
23848	3911	102	15	37	0	4065
23849	177	31	13	3812	0	4033
23850	125	17	17	3898	0	4057
23851	3792	16	17	179	0	4004
23852	3760	18	13	142	0	3933
23853	3843	14	17	52	0	3926
23854	184	3666	31	31	0	3912
23855	134	3643	27	102	0	3906
23856	61	155	3674	27	0	3917
23857	34	118	73	3584	0	3809
23858	21	44	3627	100	0	3792
23859	27	3416	90	130	0	3663
23860	28	62	95	3285	0	3470
23861	33	87	26	3309	0	3455
23862	30	25	17	3429	0	3501
23863	3278	18	20	177	0	3493
23864	3282	14	27	136	0	3459
23865	148	3344	23	57	0	3572
23866	115	73	17	3366	0	3571
23867	46	98	3345	93	0	3582
23868	30	43	3243	115	0	3431
23869	3229	14	146	49	0	3438
23870	3260	18	105	42	0	3425
23871	165	11	27	3247	0	3450
23872	3309	20	23	90	0	3442
23873	98	23	3187	118	0	3426
23874	111	3181	79	57	0	3428
23875	57	63	97	3179	0	3396
23876	40	105	3247	85	0	3477
23877	37	35	72	3347	0	3491
23878	36	17	102	3349	0	3504
23879	29	26	3307	189	0	3551
23880	3137	14	74	143	0	3368
23881	3359	19	97	73	0	3548
23882	161	3427	48	53	0	3689
23883	3540	75	19	57	0	3691
23884	3505	99	25	61	0	3690
23885	180	36	3456	50	0	3722
23886	3436	25	80	48	0	3589
23887	108	3622	115	38	0	3883
23888	3712	85	34	44	0	3875
23889	3787	106	25	47	0	3965
23890	3945	29	28	47	0	4049
23891	3825	27	16	43	0	3911
23892	3948	19	15	38	0	4020
23893	212	3720	22	36	0	3990
23894	3188	58	8	37	0	3291
23895	86	3135	25	34	0	3280
23896	83	2769	17	30	0	2899
23897	35	2950	12	32	0	3029
23898	2859	107	28	23	0	3017
23899	2880	83	13	32	0	3008
23900	135	22	2921	22	0	3100
23901	3056	11	57	23	0	3147
23902	3010	15	70	21	0	3116
23903	132	20	3074	27	0	3253
23904	93	17	68	3012	0	3190
23905	43	14	80	3005	0	3142
23906	31	9	20	3232	0	3292
23907	26	17	18	3265	0	3326
23908	37	13	10	3256	0	3316
23909	27	20	3085	148	0	3280
23910	22	3075	64	89	0	3250
23911	3067	58	80	34	0	3239
23912	79	3142	22	20	0	3263
23913	3140	71	14	18	0	3243
23914	3128	74	8	25	0	3235
23915	142	29	3016	23	0	3210
23916	107	12	58	2741	0	2918
23917	36	2944	85	51	0	3116
23918	2996	65	19	66	0	3146
23919	2964	79	11	26	0	3080
23920	3013	22	16	16	0	3067
23921	146	3056	22	9	0	3233
23922	3151	55	13	19	0	3238
23923	3172	72	16	14	0	3274
23924	3197	20	10	18	0	3245
23925	151	14	9	3071	0	3245
23926	99	10	11	3106	0	3226
23927	40	16	9	3200	0	3265
23928	3078	10	7	131	0	3226
23929	77	3094	12	83	0	3266
23930	3114	49	8	28	0	3199
23931	3011	68	9	17	0	3105
23932	2980	21	11	11	0	3023
23933	2964	6	7	13	0	2990
23934	131	2831	9	11	0	2982
23935	2527	46	4	12	0	2589
23936	66	2471	6	11	0	2554
23937	52	2394	6	9	0	2461
23938	2439	76	4	8	0	2527
23939	57	2444	15	7	0	2523
23940	49	2453	7	7	0	2516
23941	2435	72	23	5	0	2535
23942	2435	40	3	3	0	2481
23943	77	14	0	2352	0	2443
23944	56	6	4	2397	0	2463
23945	2456	8	4	78	0	2546
23946	2577	8	3	46	0	2634
23947	2556	11	8	13	0	2588
23948	79	12	2438	7	0	2536
23949	2661	10	32	25	0	2728
23950	58	6	34	2676	0	2774
23951	51	8	9	2731	0	2799
23952	27	6	6	2772	0	2811
23953	21	8	7	2770	0	2806
23954	14	15	2654	74	0	2757
23955	14	11	2707	46	0	2778
23956	14	10	66	2706	0	2796
23957	23	14	2722	46	0	2805
23958	24	10	2688	44	0	2766
23959	19	6	76	2611	0	2712
23960	16	7	40	2724	0	2787
23961	21	9	7	2873	0	2910
23962	15	12	7	2815	0	2849
23963	2787	10	3	85	0	2885
23964	2896	8	2	58	0	2964
23965	84	7	9	2801	0	2901
23966	53	9	7	2817	0	2886
23967	32	9	4	2834	0	2879
23968	26	12	7	2825	0	2870
23969	33	4	6	2787	0	2830
23970	24	2741	11	83	0	2859
23971	2735	42	8	58	0	2843
23972	49	2775	4	39	0	2867
23973	2781	43	2	25	0	2851
23974	2780	35	6	22	0	2843
23975	2829	12	5	19	0	2865
23976	87	14	4	2673	0	2778
23977	2729	8	4	52	0	2793
23978	61	11	3	2713	0	2788
23979	46	10	5	2662	0	2723
23980	2638	11	5	75	0	2729
23981	45	2643	7	45	0	2740
23982	40	2606	8	15	0	2669
23983	2563	60	2	13	0	2638
23984	50	41	2637	9	0	2737
23985	2408	11	39	9	0	2467
23986	59	14	25	2575	0	2673
23987	44	2500	6	35	0	2585
23988	17	2566	7	29	0	2619
23989	2533	73	17	19	0	2642
23990	36	23	0	2590	0	2649
23991	26	2666	7	27	0	2726
23992	2661	28	3	30	0	2722
23993	2669	20	0	18	0	2707
23994	2661	7	3	8	0	2679
23995	2703	10	1	13	0	2727
23996	48	2647	6	7	0	2708
23997	24	2637	5	5	0	2671
23998	2673	35	15	9	0	2732
23999	2740	12	1	11	0	2764
24000	55	7	2543	2	0	2607
24001	17	2491	18	5	0	2531
24002	2469	18	9	12	0	2508
24003	2583	14	4	6	0	2607
24004	35	12	2628	3	0	2678
24005	2516	3	20	9	0	2548
24006	30	9	2783	7	0	2829
24007	22	6	2943	3	0	2974
24008	10	4	46	2742	0	2802
24009	5	2848	59	27	0	2939
24010	3030	29	2	24	0	3085
24011	36	22	0	3022	0	3080
24012	26	6	2	3057	0	3091
24013	9	1	1	3102	0	3113
24014	3026	1	2	59	0	3088
24015	34	3	0	3114	0	3151
24016	29	1	2	3199	0	3231
24017	6	5	3187	54	0	3252
24018	3008	2	32	34	0	3076
24019	3236	3	29	9	0	3277
24020	75	7	3254	3	0	3339
24021	3079	2	34	8	0	3123
24022	47	4	31	3052	0	3134
24023	41	3167	9	41	0	3258
24024	7	34	6	3216	0	3263
24025	3151	33	4	41	0	3229
24026	41	3203	5	36	0	3285
24027	45	38	4	3264	0	3351
24028	7	33	3	3415	0	3458
24029	13	5	2	3449	0	3469
24030	11	0	8	3256	0	3275
24031	6	3534	10	80	0	3630
24032	3577	50	3	50	0	3680
24033	3621	43	2	11	0	3677
24034	96	3683	8	7	0	3794
24035	4014	48	4	18	0	4084
24036	4048	47	3	14	0	4112
24037	4053	10	3	14	0	4080
24038	139	11	3939	6	0	4095
24039	79	4	65	3889	0	4037
24040	10	10	3872	75	0	3967
24041	3793	5	75	72	0	3945
24042	74	3926	66	14	0	4080
24043	3925	62	10	16	0	4013
24044	69	4084	15	16	0	4184
24045	76	70	8	3814	0	3968
24046	30	67	2	3943	0	4042
24047	16	21	3915	126	0	4078
24048	8	3962	83	89	0	4142
24049	3751	65	69	32	0	3917
24050	80	71	3786	9	0	3946
24051	3754	11	72	22	0	3859
24052	83	10	64	3784	0	3941
24053	85	15	3784	78	0	3962
24054	24	3770	79	85	0	3958
24055	27	74	68	3698	0	3867
24056	19	79	3770	80	0	3948
24057	29	27	3763	80	0	3899
24058	23	3761	140	18	0	3942
24059	38	68	86	3653	0	3845
24060	39	69	21	3521	0	3650
24061	28	3628	22	133	0	3811
24062	3677	71	21	79	0	3848
24063	88	69	15	3523	0	3695
24064	79	3618	16	77	0	3790
24065	3606	77	13	84	0	3780
24066	3623	78	19	23	0	3743
24067	3788	26	11	23	0	3848
24068	153	3698	18	29	0	3898
24069	3817	70	19	32	0	3938
24070	3807	77	15	31	0	3930
24071	155	32	22	3717	0	3926
24072	3792	23	12	90	0	3917
24073	108	30	17	3787	0	3942
24074	100	25	3641	94	0	3860
24075	42	26	3700	87	0	3855
24076	35	13	143	3698	0	3889
24077	36	25	3724	98	0	3883
24078	3463	26	87	95	0	3671
24079	100	19	83	3637	0	3839
24080	102	16	30	3718	0	3866
24081	43	25	3601	151	0	3820
24082	40	3502	83	94	0	3719
24083	29	3678	87	40	0	3834
24084	44	135	26	3536	0	3741
24085	31	91	17	3654	0	3793
24086	30	29	3553	151	0	3763
24087	25	27	3623	96	0	3771
24088	41	19	140	3597	0	3797
24089	30	28	3552	88	0	3698
24090	3275	27	79	92	0	3473
24091	96	31	80	3342	0	3549
24092	3419	28	20	82	0	3549
24093	109	27	14	3400	0	3550
24094	100	19	15	3450	0	3584
24095	41	23	3379	162	0	3605
24096	35	3344	94	97	0	3570
24097	33	77	84	3298	0	3492
24098	35	75	3255	87	0	3452
24099	34	3142	95	83	0	3354
24100	46	95	97	3188	0	3426
24101	3245	73	28	83	0	3429
24102	89	19	3255	91	0	3454
24103	3000	15	78	40	0	3133
24104	86	18	3053	33	0	3190
24105	2730	16	85	18	0	2849
24106	74	2829	71	29	0	3003
24107	61	2641	26	27	0	2755
24108	19	112	20	2413	0	2564
24109	41	2511	15	54	0	2621
24110	2463	60	14	109	0	2646
24111	65	53	16	2532	0	2666
24112	67	12	19	2559	0	2657
24113	23	11	16	2621	0	2671
24114	17	16	2490	119	0	2642
24115	20	9	56	2527	0	2612
24116	18	11	2492	83	0	2604
24117	11	2401	69	65	0	2546
24118	2262	53	56	21	0	2392
24119	51	2356	20	28	0	2455
24120	2428	48	21	27	0	2524
24121	2443	47	16	18	0	2524
24122	2474	17	12	25	0	2528
24123	2401	8	18	24	0	2451
24124	99	7	2261	25	0	2392
24125	60	11	58	2244	0	2373
24126	25	16	60	2261	0	2362
24127	26	12	12	2339	0	2389
24128	2049	14	12	104	0	2179
24129	2071	14	12	61	0	2158
24130	78	2134	16	28	0	2256
24131	40	33	1921	22	0	2016
24132	19	31	1901	16	0	1967
24133	12	1883	69	8	0	1972
24134	11	1872	41	14	0	1938
24135	29	55	8	1518	0	1610
24136	6	16	7	1462	0	1491
24137	1506	6	2	29	0	1543
24138	23	1507	6	20	0	1556
24139	16	17	4	1522	0	1559
24140	7	15	1537	24	0	1583
24141	7	5	19	1605	0	1636
24142	7	6	16	1603	0	1632
24143	5	7	7	1629	0	1648
24144	8	3	5	1550	0	1566
24145	11	4	1490	39	0	1544
24146	9	1520	21	21	0	1571
24147	9	1573	22	11	0	1615
24148	1494	28	9	7	0	1538
24149	21	1525	9	6	0	1561
24150	22	1574	8	3	0	1607
24151	5	39	8	1535	0	1587
24152	11	20	3	1593	0	1627
24153	10	12	4	1654	0	1680
24154	9	11	1598	43	0	1661
24155	16	1582	19	27	0	1644
24156	11	19	26	1534	0	1590
24157	13	1655	7	28	0	1703
24158	1588	21	10	27	0	1646
24159	18	1611	9	18	0	1656
24160	1596	18	6	19	0	1639
24161	19	35	1564	8	0	1626
24162	1554	12	17	14	0	1597
24163	21	11	21	1585	0	1638
24164	26	14	1614	21	0	1675
24165	1534	10	17	27	0	1588
24166	1615	12	21	9	0	1657
24167	1558	9	5	17	0	1589
24168	34	4	16	1494	0	1548
24169	27	11	1501	28	0	1567
24170	1528	5	25	31	0	1589
24171	20	12	18	1716	0	1766
24172	30	3	7	1710	0	1750
24173	6	12	1755	36	0	1809
24174	16	1758	23	28	0	1825
24175	14	23	15	1671	0	1723
24176	9	1774	13	19	0	1815
24177	1713	25	8	26	0	1772
24178	1729	22	9	16	0	1776
24179	35	13	5	1724	0	1777
24180	1738	5	10	24	0	1777
24181	27	1712	10	26	0	1775
24182	1713	20	4	14	0	1751
24183	32	1743	8	9	0	1792
24184	22	24	7	1728	0	1781
24185	19	19	7	1654	0	1699
24186	12	1751	10	30	0	1803
24187	7	23	5	1733	0	1768
24188	8	25	1692	34	0	1759
24189	9	1678	21	27	0	1735
24190	1634	15	16	24	0	1689
24191	13	1684	12	16	0	1725
24192	20	23	7	1679	0	1729
24193	14	19	1678	23	0	1734
24194	14	14	12	1687	0	1727
24195	9	6	16	1654	0	1685
24196	1598	7	11	35	0	1651
24197	16	6	1667	30	0	1719
24198	19	1629	16	21	0	1685
24199	14	18	1733	16	0	1781
24200	6	15	1677	11	0	1709
24201	6	8	1619	5	0	1638
24202	33	2	25	1494	0	1554
24203	1621	3	16	7	0	1647
24204	11	1614	10	19	0	1654
24205	1689	9	7	10	0	1715
24206	1796	16	5	10	0	1827
24207	26	5	3	1748	0	1782
24208	24	1778	4	8	0	1814
24209	1774	14	0	16	0	1804
24210	11	1783	3	10	0	1807
24211	21	15	1	1698	0	1735
24212	9	17	0	1806	0	1832
24213	2	1821	2	27	0	1852
24214	4	9	2	1835	0	1850
24215	3	24	1761	11	0	1799
24216	5	9	1802	19	0	1835
24217	1	4	24	1811	0	1840
24218	3	3	20	1863	0	1889
24219	6	4	1805	29	0	1844
24220	1	5	1751	24	0	1781
24221	1575	3	27	13	0	1618
24222	9	1742	27	5	0	1783
24223	17	1900	11	3	0	1931
24224	8	27	4	1860	0	1899
24225	1	23	4	1885	0	1913
24226	8	4	3	1909	0	1924
24227	5	6	1868	26	0	1905
24228	5	5	1818	26	0	1854
24229	6	2	25	1867	0	1900
24230	3	8	1853	12	0	1876
24231	5	1796	18	27	0	1846
24232	1791	12	20	15	0	1838
24233	12	19	1801	8	0	1840
24234	17	6	1783	6	0	1812
24235	5	3	29	1814	0	1851
24236	3	8	2078	16	0	2105
24237	6	2101	27	25	0	2159
24238	3	25	29	2095	0	2152
24239	4	27	2152	23	0	2206
24240	0	2107	28	36	0	2171
24241	2042	20	30	13	0	2105
24242	23	30	11	2050	0	2114
24243	31	6	4	2093	0	2134
24244	2083	4	3	50	0	2140
24245	25	2093	6	29	0	2153
24246	2058	27	4	11	0	2100
24247	2050	24	3	10	0	2087
24248	2045	7	5	9	0	2066
24249	53	6	2	1992	0	2053
24250	1985	2	6	28	0	2021
24251	31	1830	8	29	0	1898
24252	31	1906	6	10	0	1953
24253	1974	41	4	3	0	2022
24254	35	29	1	2017	0	2082
24255	34	9	0	2041	0	2084
24256	14	5	3	2077	0	2099
24257	8	9	1969	55	0	2041
24258	4	2012	29	38	0	2083
24259	4	28	28	2015	0	2075
24260	2005	31	7	34	0	2077
24261	27	8	2	2048	0	2085
24262	30	2	2002	37	0	2071
24263	5	2016	29	38	0	2088
24264	2011	30	30	13	0	2084
24265	2021	28	9	13	0	2071
24266	2030	5	11	6	0	2052
24267	57	4	7	2020	0	2088
24268	38	5	1992	30	0	2065
24269	15	10	1996	33	0	2054
24270	10	2006	61	10	0	2087
24271	6	28	34	1920	0	1988
24272	25	32	6	1964	0	2027
24273	1896	8	2	58	0	1964
24274	27	6	5	1951	0	1989
24275	2048	2	3	37	0	2090
24276	32	7	1993	40	0	2072
24277	41	1	2076	13	0	2131
24278	7	0	68	2042	0	2117
24279	8	1	40	2134	0	2183
24280	2	3	5	2224	0	2234
24281	2284	3	5	73	0	2365
24282	2464	4	5	44	0	2517
24283	83	1	6	2409	0	2499
24284	47	4	2365	57	0	2473
24285	5	7	2420	49	0	2481
24286	5	0	89	2375	0	2469
24287	2522	1	47	57	0	2627
24288	56	4	7	2533	0	2600
24289	48	3	5	2625	0	2681
24290	6	10	2591	97	0	2704
24291	6	10	2565	51	0	2632
24292	2416	2	100	15	0	2533
24293	62	6	2606	8	0	2682
24294	50	4	59	2486	0	2599
24295	14	21	47	2516	0	2598
24296	2485	3	35	98	0	2621
24297	59	2468	8	55	0	2590
24298	2515	54	3	11	0	2583
24299	61	2399	9	10	0	2479
24300	2351	55	3	7	0	2416
24301	59	47	2320	12	0	2438
24302	2116	3	76	8	0	2203
24303	2245	3	40	9	0	2297
24304	95	2	7	2243	0	2347
24305	46	7	2193	57	0	2303
24306	16	3	53	2106	0	2178
24307	12	3	44	2126	0	2185
24308	10	2125	10	89	0	2234
24309	9	46	9	2078	0	2142
24310	8	2131	14	55	0	2208
24311	4	53	9	2123	0	2189
24312	2066	40	3	66	0	2175
24313	64	4	3	2120	0	2191
24314	48	15	2083	63	0	2209
24315	2052	5	55	50	0	2162
24316	63	4	2163	11	0	2241
24317	2098	3	62	12	0	2175
24318	2189	4	46	10	0	2249
24319	105	2111	16	12	0	2244
24320	52	2259	12	13	0	2336
24321	2166	98	6	20	0	2290
24322	2247	50	11	13	0	2321
24323	2186	8	6	11	0	2211
24324	2144	9	6	15	0	2174
24325	2148	2	7	14	0	2171
24326	107	6	8	2063	0	2184
24327	57	3	8	2119	0	2187
24328	14	11	2044	107	0	2176
24329	2013	5	58	55	0	2131
24330	69	4	44	2056	0	2173
24331	53	6	14	2115	0	2188
24332	23	6	2095	107	0	2231
24333	11	2042	70	61	0	2184
24334	20	2138	52	21	0	2231
24335	2078	95	11	28	0	2212
24336	1898	46	9	16	0	1969
24337	85	1797	13	18	0	1913
24338	48	1810	11	10	0	1879
24339	1807	78	8	11	0	1904
24340	1867	36	6	14	0	1923
24341	85	12	9	1832	0	1938
24342	46	5	6	1887	0	1944
24343	21	4	7	1923	0	1955
24344	1843	5	7	91	0	1946
24345	1931	6	7	48	0	1992
24346	96	6	6	1923	0	2031
24347	1968	5	6	64	0	2043
24348	64	7	1959	46	0	2076
24349	56	1	57	1959	0	2073
24350	22	8	2018	57	0	2105
24351	15	1931	59	55	0	2060
24352	17	88	45	1917	0	2067
24353	1917	35	13	64	0	2029
24354	60	11	7	1913	0	1991
24355	49	8	7	1919	0	1983
24356	24	6	1846	88	0	1964
24357	21	9	1851	46	0	1927
24358	12	1861	85	20	0	1978
24359	1869	54	40	13	0	1976
24360	1914	37	9	12	0	1972
24361	1949	12	3	10	0	1974
24362	1963	5	2	13	0	1983
24363	100	4	6	1871	0	1981
24364	55	8	7	1832	0	1902
24365	20	1849	9	83	0	1961
24366	1855	49	3	50	0	1957
24367	1879	37	6	18	0	1940
24368	91	13	1811	11	0	1926
24369	1563	3	50	11	0	1627
24370	60	1566	37	33	0	1696
24371	45	74	9	1485	0	1613
24372	16	1617	7	55	0	1695
24373	1577	49	10	39	0	1675
24374	49	1589	4	18	0	1660
24375	29	46	7	1474	0	1556
24376	18	29	3	1512	0	1562
24377	10	8	5	1461	0	1484
24378	7	1404	6	73	0	1490
24379	9	74	5	1387	0	1475
24380	17	23	3	1316	0	1359
24381	4	1150	3	47	0	1204
24382	3	1093	2	23	0	1121
24383	1024	40	0	9	0	1073
24384	29	1049	6	2	0	1086
24385	988	24	1	7	0	1020
24386	27	19	960	6	0	1012
24387	19	952	24	2	0	997
24388	951	23	16	4	0	994
24389	903	13	5	5	0	926
24390	36	9	888	2	0	935
24391	21	3	20	880	0	924
24392	7	5	909	25	0	946
24393	5	900	28	20	0	953
24394	900	25	14	11	0	950
24395	25	911	6	6	0	948
24396	18	28	5	888	0	939
24397	8	19	3	946	0	976
24398	6	7	922	38	0	973
24399	6	6	878	18	0	908
24400	828	4	37	6	0	875
24401	852	3	21	5	0	881
24402	868	0	2	7	0	877
24403	862	7	1	4	0	874
24404	42	840	2	9	0	893
24405	25	26	0	820	0	871
24406	7	20	1	841	0	869
24407	8	867	2	41	0	918
24408	880	22	5	16	0	923
24409	898	21	3	6	0	928
24410	45	7	858	4	0	914
24411	868	5	22	6	0	901
24412	28	3	25	862	0	918
24413	21	6	850	24	0	901
24414	12	3	25	829	0	869
24415	4	5	833	28	0	870
24416	6	2	822	23	0	853
24417	8	8	40	763	0	819
24418	3	798	17	19	0	837
24419	795	19	5	16	0	835
24420	746	15	3	4	0	768
24421	30	878	8	3	0	919
24422	20	945	4	2	0	971
24423	963	29	1	5	0	998
24424	967	18	0	8	0	993
24425	994	2	2	6	0	1004
24426	999	3	4	4	0	1010
24427	33	5	1	1032	0	1071
24428	19	3	1076	20	0	1118
24429	6	1078	18	21	0	1123
24430	1062	18	17	2	0	1099
24431	22	1095	3	2	0	1122
24432	1084	16	4	1	0	1105
24433	1067	18	1	1	0	1087
24434	34	3	1089	5	0	1131
24435	19	1126	16	4	0	1165
24436	3	12	17	1152	0	1184
24437	2	18	1	1170	0	1191
24438	3	1	4	1159	0	1167
24439	1142	3	2	31	0	1178
24440	1103	2	0	17	0	1122
24441	1114	2	1	3	0	1120
24442	33	1072	2	20	0	1127
24443	1055	15	3	6	0	1079
24444	11	1063	4	4	0	1082
24445	15	13	1048	7	0	1083
24446	2	1037	12	6	0	1057
24447	14	19	14	971	0	1018
24448	5	12	3	981	0	1001
24449	4	5	967	21	0	997
24450	5	4	10	918	0	937
24451	7	4	12	952	0	975
24452	990	1	3	22	0	1016
24453	993	6	3	15	0	1017
24454	1079	3	3	2	0	1087
24455	30	1070	2	4	0	1106
24456	1079	15	4	5	0	1103
24457	1060	17	2	3	0	1082
24458	31	1086	4	4	0	1125
24459	18	11	4	1069	0	1102
24460	6	15	2	1085	0	1108
24461	1050	4	4	29	0	1087
24462	17	7	1060	16	0	1100
24463	16	1081	12	6	0	1115
24464	6	13	13	1035	0	1067
24465	6	1074	6	9	0	1095
24466	5	1072	16	13	0	1106
24467	1071	21	19	4	0	1115
24468	1074	14	1	1	0	1090
24469	19	4	2	1069	0	1094
24470	12	3	3	1065	0	1083
24471	4	5	2	1081	0	1092
24472	5	1	3	1069	0	1078
24473	4	4	1016	23	0	1047
24474	8	5	957	12	0	982
24475	5	3	16	1044	0	1068
24476	8	3	1090	11	0	1112
24477	4	1101	12	11	0	1128
24478	1098	9	14	3	0	1124
24479	1111	12	2	6	0	1131
24480	22	3	2	1120	0	1147
24481	14	2	3	1100	0	1119
24482	6	5	4	1115	0	1130
24483	4	1111	3	21	0	1139
24484	1121	12	1	19	0	1153
24485	1118	13	0	6	0	1137
24486	25	6	1146	4	0	1181
24487	21	1	11	1266	0	1299
24488	4	6	1305	15	0	1330
24489	3	5	14	1401	0	1423
24490	8	4	18	1379	0	1409
24491	7	7	3	1353	0	1370
24492	10	2	3	1421	0	1436
24493	1374	4	4	41	0	1423
24494	1395	1	0	27	0	1423
24495	1422	2	3	11	0	1438
24496	45	4	2	1397	0	1448
24497	27	3	1370	19	0	1419
24498	1335	1	15	27	0	1378
24499	17	64	21	1357	0	1459
24500	1433	2	6	17	0	1458
24501	27	3	3	1440	0	1473
24502	22	1401	5	27	0	1455
24503	13	1501	7	23	0	1544
24504	9	31	2	1498	0	1540
24505	9	26	1	1487	0	1523
24506	7	7	2	1485	0	1501
24507	3	1448	3	42	0	1496
24508	1440	18	3	23	0	1484
24509	17	1476	5	11	0	1509
24510	21	21	1511	10	0	1563
24511	11	18	17	1465	0	1511
24512	3	1550	25	23	0	1601
24513	6	15	10	1558	0	1589
24514	8	21	2	1565	0	1596
24515	4	9	1539	44	0	1596
24516	1376	3	18	42	0	1439
24517	25	1592	24	19	0	1660
24518	1638	17	8	11	0	1674
24519	1648	25	0	11	0	1684
24520	1660	7	4	8	0	1679
24521	54	2	1457	7	0	1520
24522	34	5	17	1410	0	1466
24523	14	2	28	1437	0	1481
24524	8	6	1411	51	0	1476
24525	1223	4	17	44	0	1288
24526	22	5	1414	21	0	1462
24527	19	6	1358	13	0	1396
24528	12	1377	34	11	0	1434
24529	7	16	22	1376	0	1421
24530	6	23	1400	24	0	1453
24531	1296	9	15	30	0	1350
24532	1328	4	22	13	0	1367
24533	42	4	1318	28	0	1392
24534	33	6	16	1308	0	1363
24535	17	7	1412	23	0	1459
24536	7	1402	25	29	0	1463
24537	1520	21	21	15	0	1577
24538	1552	22	11	8	0	1593
24539	1580	8	7	11	0	1606
24540	53	5	4	1545	0	1607
24541	33	5	5	1587	0	1630
24542	14	7	1544	48	0	1613
24543	1488	9	21	36	0	1554
24544	26	8	26	1572	0	1632
24545	1569	4	12	30	0	1615
24546	31	7	1551	41	0	1630
24547	25	8	1594	22	0	1649
24548	13	7	46	1521	0	1587
24549	9	6	33	1594	0	1642
24550	11	7	1587	48	0	1653
24551	1519	4	27	34	0	1584
24552	27	9	28	1481	0	1545
24553	32	1577	18	30	0	1657
24554	1538	18	10	28	0	1594
24555	33	1558	11	16	0	1618
24556	1563	23	11	11	0	1608
24557	35	24	1564	21	0	1644
24558	33	9	1627	18	0	1687
24559	20	1669	52	10	0	1751
24560	1669	19	29	10	0	1727
24561	32	31	1655	14	0	1732
24562	1609	7	31	11	0	1658
24563	32	1621	39	15	0	1707
24564	38	25	11	1623	0	1697
24565	21	27	16	1542	0	1606
24566	20	1652	20	46	0	1738
24567	1675	23	13	37	0	1748
24568	1738	29	11	19	0	1797
24569	1797	15	10	18	0	1840
24570	62	8	1760	15	0	1845
24571	45	11	34	1750	0	1840
24572	27	10	28	1774	0	1839
24573	18	10	18	1805	0	1851
24574	19	9	1783	60	0	1871
24575	16	1720	33	46	0	1815
24576	1684	32	36	20	0	1772
24577	46	30	1688	9	0	1773
24578	1641	20	30	12	0	1703
24579	49	1675	30	15	0	1769
24580	1692	31	19	9	0	1751
24581	49	29	16	1672	0	1766
24582	1693	12	17	35	0	1757
24583	44	10	13	1711	0	1778
24584	43	8	1775	49	0	1875
24585	33	14	39	1787	0	1873
24586	25	5	1721	41	0	1792
24587	1483	9	37	24	0	1553
24588	37	1652	30	18	0	1737
24589	20	31	18	1409	0	1478
24590	12	1574	7	23	0	1616
24591	1554	31	12	21	0	1618
24592	1545	18	8	10	0	1581
24593	45	1540	12	6	0	1603
24594	1566	25	13	5	0	1609
24595	1585	14	28	11	0	1638
24596	37	10	11	1559	0	1617
24597	25	9	6	1582	0	1622
24598	1605	10	6	38	0	1659
24599	1623	4	1	25	0	1653
24600	44	7	10	1585	0	1646
24601	33	5	7	1690	0	1735
24602	1701	7	7	41	0	1756
24603	26	7	1658	25	0	1716
24604	1568	3	21	20	0	1612
24605	25	10	1676	14	0	1725
24606	33	1656	31	10	0	1730
24607	36	27	23	1620	0	1706
24608	18	17	1674	26	0	1735
24609	11	1778	27	25	0	1841
24610	1731	23	22	17	0	1793
24611	30	25	1739	10	0	1804
24612	1721	6	24	12	0	1763
24613	1782	3	19	10	0	1814
24614	1820	11	7	12	0	1850
24615	52	2	2	1669	0	1725
24616	26	1726	9	25	0	1786
24617	1697	18	12	27	0	1754
24618	30	26	1714	10	0	1780
24619	1584	11	23	8	0	1626
24620	27	4	1760	11	0	1802
24621	29	1732	27	8	0	1796
24622	17	22	22	1711	0	1772
24623	17	19	7	1708	0	1751
24624	11	1708	12	42	0	1773
24625	13	26	9	1753	0	1801
24626	17	24	1731	27	0	1799
24627	14	1764	30	18	0	1826
24628	14	25	23	1686	0	1748
24629	1682	25	7	30	0	1744
24630	1739	7	3	24	0	1773
24631	53	4	5	1704	0	1766
24632	30	1757	4	32	0	1823
24633	19	25	3	1794	0	1841
24634	19	21	10	1766	0	1816
24635	15	12	1613	45	0	1685
24636	12	1626	26	30	0	1694
24637	9	41	19	1500	0	1569
24638	12	32	1486	21	0	1551
24639	9	1481	20	24	0	1534
24640	10	19	20	1495	0	1544
24641	1500	19	5	20	0	1544
24642	26	1627	13	17	0	1683
24643	24	15	8	1652	0	1699
24644	1699	18	5	23	0	1745
24645	1718	9	3	17	0	1747
24646	1716	6	7	11	0	1740
24647	1745	6	6	11	0	1768
24648	41	6	5	1727	0	1779
24649	29	6	1733	18	0	1786
24650	13	6	24	1652	0	1695
24651	10	1713	29	28	0	1780
24652	1728	29	13	18	0	1788
24653	24	25	1677	11	0	1737
24654	1557	6	17	51	0	1631
24655	20	10	1663	5	0	1698
24656	24	4	20	1637	0	1685
24657	15	8	1644	20	0	1687
24658	10	24	22	1550	0	1606
24659	11	10	1554	26	0	1601
24660	10	4	21	1551	0	1586
24661	1572	5	21	23	0	1621
24662	18	1702	12	24	0	1756
24663	28	17	5	1729	0	1779
24664	12	36	5	1756	0	1809
24665	9	7	1898	44	0	1958
24666	11	3	1830	30	0	1874
24667	1732	9	34	9	0	1784
24668	20	1803	29	12	0	1864
24669	1779	12	14	13	0	1818
24670	1814	18	6	14	0	1852
24671	35	7	5	1746	0	1793
24672	25	1803	6	19	0	1853
24673	1863	14	6	26	0	1909
24674	1950	19	9	11	0	1989
24675	1995	7	6	13	0	2021
24676	2004	5	7	11	0	2027
24677	2001	4	8	8	0	2021
24678	33	7	1930	9	0	1979
24679	1940	2	20	9	0	1971
24680	18	10	1960	12	0	2000
24681	26	5	14	1899	0	1944
24682	13	5	22	2017	0	2057
24683	11	10	1949	28	0	1998
24684	1841	4	12	33	0	1890
24685	17	7	23	2028	0	2075
24686	29	5	7	2074	0	2115
24687	13	4	11	2131	0	2159
24688	13	5	3	2065	0	2086
24689	11	7	7	2079	0	2104
24690	11	4	2125	38	0	2178
24691	12	2	23	2106	0	2143
24692	9	11	2184	23	0	2227
24693	9	11	2230	35	0	2285
24694	2193	6	49	14	0	2262
24695	2302	1	39	9	0	2351
24696	2446	6	10	11	0	2473
24697	63	10	2545	13	0	2631
24698	49	9	2591	9	0	2658
24699	17	8	2723	11	0	2759
24700	10	2770	89	7	0	2876
24701	24	35	54	2778	0	2891
24702	2923	45	7	59	0	3034
24703	54	5	10	3159	0	3228
24704	58	3209	10	65	0	3342
24705	3213	58	7	69	0	3347
24706	66	59	4	3137	0	3266
24707	67	3217	11	64	0	3359
24708	19	54	10	3297	0	3380
24709	7	62	11	3281	0	3361
24710	3188	5	10	125	0	3328
24711	61	8	9	3265	0	3343
24712	65	10	3177	73	0	3325
24713	13	5	60	3150	0	3228
24714	13	3102	69	68	0	3252
24715	17	3169	23	101	0	3310
24716	20	111	12	3101	0	3244
24717	13	69	18	3069	0	3169
24718	14	3026	19	120	0	3179
24719	15	3070	20	71	0	3176
24720	19	3262	10	24	0	3315
24721	19	123	9	2921	0	3072
24722	14	3230	13	71	0	3328
24723	3148	66	11	68	0	3293
24724	69	76	3174	19	0	3338
24725	76	24	58	3066	0	3224
24726	16	3217	67	73	0	3373
24727	3124	65	13	88	0	3290
24728	70	76	3131	41	0	3318
24729	72	3158	67	25	0	3322
24730	3113	65	66	42	0	3286
24731	66	3179	24	31	0	3300
24732	65	3171	15	38	0	3289
24733	13	130	13	3052	0	3208
24734	22	3184	19	73	0	3298
24735	3104	74	8	82	0	3268
24736	68	88	11	3126	0	3293
24737	69	38	3043	80	0	3230
24738	17	25	3079	90	0	3211
24739	22	26	113	3041	0	3202
24740	16	37	3119	78	0	3250
24741	15	37	67	3109	0	3228
24742	2918	21	67	90	0	3096
24743	72	39	2934	70	0	3115
24744	76	22	66	2836	0	3000
24745	14	2896	78	72	0	3060
24746	19	73	17	2978	0	3087
24747	25	78	15	2931	0	3049
24748	24	3031	26	112	0	3193
24749	21	79	17	3143	0	3260
24750	15	74	17	3153	0	3259
24751	21	38	3089	123	0	3271
24752	19	3055	72	87	0	3233
24753	3071	86	76	32	0	3265
24754	74	69	13	3118	0	3274
24755	74	43	3092	88	0	3297
24756	31	32	62	3120	0	3245
24757	17	34	3184	80	0	3315
24758	2916	33	70	98	0	3117
24759	77	3169	74	29	0	3349
24760	70	74	24	3169	0	3337
24761	25	85	26	3243	0	3379
24762	3056	21	25	136	0	3238
24763	77	26	19	3115	0	3237
24764	71	43	3033	83	0	3230
24765	34	24	72	2828	0	2958
24766	16	2818	80	97	0	3011
24767	18	2960	37	72	0	3087
24768	21	3037	22	55	0	3135
24769	23	129	23	2937	0	3112
24770	23	84	2904	98	0	3109
24771	20	2942	73	93	0	3128
24772	2841	82	72	45	0	3040
24773	66	3035	33	40	0	3174
24774	2972	80	15	49	0	3116
24775	2944	78	21	41	0	3084
24776	123	27	2870	39	0	3059
24777	2883	27	68	40	0	3018
24778	3016	34	71	43	0	3164
24779	3085	23	24	50	0	3182
24780	3134	21	25	53	0	3233
24781	120	45	3104	24	0	3293
24782	3015	25	63	35	0	3138
24783	3164	36	62	41	0	3303
24784	123	3237	39	33	0	3432
24785	75	75	11	3093	0	3254
24786	31	71	24	3086	0	3212
24787	31	3070	24	130	0	3255
24788	3054	79	20	82	0	3235
24789	76	3086	23	37	0	3222
24790	2832	73	17	33	0	2955
24791	2844	63	14	17	0	2938
24792	107	2893	19	33	0	3052
24793	50	55	17	2741	0	2863
24794	25	54	2763	71	0	2913
24795	21	2652	73	48	0	2794
24796	26	66	36	2434	0	2562
24797	17	2460	16	52	0	2545
24798	15	2677	16	41	0	2749
24799	16	84	7	2527	0	2634
24800	17	49	2599	62	0	2727
24801	14	2519	53	45	0	2631
24802	16	2549	50	18	0	2633
24803	2191	64	18	11	0	2284
24804	31	35	4	2275	0	2345
24805	32	9	1	2338	0	2380
24806	12	4	1	2411	0	2428
24807	6	7	2355	74	0	2442
24808	5	6	40	2444	0	2495
24809	5	2526	41	46	0	2618
24810	2605	44	9	42	0	2700
24811	52	47	1	2593	0	2693
24812	51	12	2581	48	0	2692
24813	2530	5	45	48	0	2628
24814	53	1	45	2605	0	2704
24815	51	11	2735	51	0	2848
24816	17	8	2743	52	0	2820
24817	2684	5	99	13	0	2801
24818	2854	7	53	6	0	2920
24819	2875	5	6	7	0	2893
24820	2864	3	8	12	0	2887
24821	115	10	2830	6	0	2961
24822	63	2878	56	3	0	3000
24823	2854	57	54	11	0	2976
24824	56	2868	17	6	0	2947
24825	2817	62	8	11	0	2898
24826	61	2853	8	13	0	2935
24827	61	62	7	2811	0	2941
24828	17	57	6	2846	0	2926
24829	13	12	5	2834	0	2864
24830	12	2760	10	109	0	2891
24831	14	2851	9	59	0	2933
24832	11	115	3	2638	0	2767
24833	13	2795	6	58	0	2872
24834	11	68	2726	58	0	2863
24835	16	64	79	2700	0	2859
24836	7	24	2806	65	0	2902
24837	2639	7	65	65	0	2776
24838	2737	9	64	20	0	2830
24839	115	11	2706	16	0	2848
24840	67	13	2763	10	0	2853
24841	19	14	108	2685	0	2826
24842	9	12	2758	70	0	2849
24843	12	14	69	2583	0	2678
24844	17	2466	77	65	0	2625
24845	18	67	13	2726	0	2824
24846	19	64	15	2733	0	2831
24847	22	13	7	2804	0	2846
24848	16	15	2581	129	0	2741
24849	17	11	64	2585	0	2677
24850	11	15	73	2562	0	2661
24851	19	15	12	2486	0	2532
24852	8	2582	17	109	0	2716
24853	2584	66	7	62	0	2719
24854	2597	68	11	28	0	2704
24855	2637	14	18	29	0	2698
24856	121	11	13	2546	0	2691
24857	71	11	2500	83	0	2665
24858	21	14	2550	70	0	2655
24859	21	2532	124	18	0	2695
24860	2433	60	64	26	0	2583
24861	62	2531	28	19	0	2640
24862	2522	64	21	24	0	2631
24863	74	2512	23	26	0	2635
24864	2486	70	25	18	0	2599
24865	76	2591	15	21	0	2703
24866	75	65	18	2551	0	2709
24867	32	71	2495	74	0	2672
24868	29	29	2579	68	0	2705
24869	32	19	112	2478	0	2641
24870	34	17	77	2540	0	2668
24871	33	19	15	2655	0	2722
24872	37	23	2549	132	0	2741
24873	25	22	72	2479	0	2598
24874	2394	25	70	78	0	2567
24875	2453	13	14	85	0	2565
24876	120	2403	31	29	0	2583
24877	2457	64	32	26	0	2579
24878	72	2373	30	34	0	2509
24879	2303	68	32	38	0	2441
24880	2295	65	24	28	0	2412
24881	2264	26	17	27	0	2334
24882	131	26	2258	18	0	2433
24883	80	40	2219	26	0	2365
24884	2122	21	105	29	0	2277
24885	2240	19	72	16	0	2347
24886	122	20	25	2189	0	2356
24887	95	21	13	2302	0	2431
24888	50	22	20	2388	0	2480
24889	36	16	22	2425	0	2499
24890	28	20	18	2448	0	2514
24891	2330	23	24	132	0	2509
24892	66	21	20	2291	0	2398
24893	68	23	2194	71	0	2356
24894	2056	17	52	83	0	2208
24895	2119	19	75	36	0	2249
24896	101	2103	28	34	0	2266
24897	67	2199	14	43	0	2323
24898	1893	73	14	19	0	1999
24899	43	1959	16	17	0	2035
24900	1840	34	13	20	0	1907
24901	1988	38	15	21	0	2062
24902	2058	6	19	15	0	2098
24903	87	3	9	1902	0	2001
24904	41	1891	19	43	0	1994
24905	1898	32	10	45	0	1985
24906	43	42	9	1814	0	1908
24907	47	6	11	1790	0	1854
24908	1605	2	9	70	0	1686
24909	31	1581	5	45	0	1662
24910	26	24	6	1501	0	1557
24911	1481	25	5	40	0	1551
24912	35	1514	7	26	0	1582
24913	1622	26	2	21	0	1671
24914	34	25	1523	18	0	1600
24915	1471	5	20	14	0	1510
24916	28	1519	21	9	0	1577
24917	1493	20	2	14	0	1529
24918	1470	17	2	10	0	1499
24919	40	1536	4	6	0	1586
24920	1566	21	3	12	0	1602
24921	26	1581	4	7	0	1618
24922	1611	20	4	5	0	1640
24923	27	21	1	1596	0	1645
24924	21	9	2	1624	0	1656
24925	12	6	0	1651	0	1669
24926	7	13	1584	40	0	1644
24927	11	6	19	1593	0	1629
24928	8	7	1611	29	0	1655
24929	13	2	23	1591	0	1629
24930	8	1595	25	20	0	1648
24931	8	24	4	1649	0	1685
24932	8	18	1624	26	0	1676
24933	6	6	1653	34	0	1699
24934	6	3	36	1675	0	1720
24935	1656	4	17	30	0	1707
24936	1660	6	4	18	0	1688
24937	36	1651	5	14	0	1706
24938	22	22	1	1661	0	1706
24939	10	24	1702	29	0	1765
24940	10	8	25	1678	0	1721
24941	13	8	1678	29	0	1728
24942	1602	1	27	23	0	1653
24943	27	10	19	1682	0	1738
24944	33	12	1651	24	0	1720
24945	13	7	24	1657	0	1701
24946	12	5	18	1685	0	1720
24947	9	9	1685	42	0	1745
24948	9	6	26	1645	0	1686
24949	1658	5	17	37	0	1717
24950	1706	5	3	32	0	1746
24951	45	5	2	1714	0	1766
24952	1731	6	3	40	0	1780
24953	31	7	1715	31	0	1784
24954	27	5	1703	15	0	1750
24955	1682	4	47	14	0	1747
24956	1743	4	28	10	0	1785
24957	49	9	7	1686	0	1751
24958	36	12	4	1728	0	1780
24959	17	12	1668	47	0	1744
24960	14	6	30	1542	0	1592
24961	8	1665	29	25	0	1727
24962	1680	28	7	23	0	1738
24963	1754	24	4	9	0	1791
24964	59	1737	4	10	0	1810
24965	1643	32	5	17	0	1697
24966	1600	24	7	26	0	1657
24967	50	1622	13	13	0	1698
24968	1589	31	9	16	0	1645
24969	41	1608	15	11	0	1675
24970	1612	28	5	16	0	1661
24971	37	31	1556	19	0	1643
24972	29	9	32	1564	0	1634
24973	12	7	24	1634	0	1677
24974	11	5	12	1744	0	1772
24975	1709	9	13	67	0	1798
24976	48	6	6	1855	0	1915
24977	38	6	1863	54	0	1961
24978	1915	7	47	36	0	2005
24979	54	6	25	1941	0	2026
24980	36	1959	21	43	0	2059
24981	22	2021	15	35	0	2093
24982	14	64	10	1916	0	2004
24983	23	34	4	1916	0	1977
24984	19	14	8	1941	0	1982
24985	13	7	1852	78	0	1950
24986	3	1837	49	48	0	1937
24987	1748	37	28	24	0	1837
24988	1702	19	10	16	0	1747
24989	60	1700	8	11	0	1779
24990	28	1723	5	16	0	1772
24991	15	65	12	1652	0	1744
24992	25	27	1666	42	0	1760
24993	1614	9	39	26	0	1688
24994	1679	3	20	16	0	1718
24995	56	6	11	1646	0	1719
24996	30	4	10	1677	0	1721
24997	1623	3	5	62	0	1693
24998	44	5	1629	35	0	1713
24999	1617	1	42	23	0	1683
25000	44	1626	27	10	0	1707
25001	20	37	10	1429	0	1496
25002	12	1477	6	33	0	1528
25003	1490	31	2	19	0	1542
25004	30	12	3	1479	0	1524
25005	19	5	6	1479	0	1509
25006	9	1478	10	32	0	1529
25007	1476	23	5	20	0	1524
25008	1485	17	2	5	0	1509
25009	43	13	1451	4	0	1511
25010	20	5	1391	9	0	1425
25011	1385	2	33	14	0	1434
25012	28	5	1419	9	0	1461
25013	21	5	1305	5	0	1336
25014	1244	29	47	3	0	1323
25015	23	7	1517	4	0	1551
25016	19	2	47	1497	0	1565
25017	8	3	20	1554	0	1585
25018	1617	2	9	71	0	1699
25019	48	5	1618	31	0	1702
25020	1656	2	52	13	0	1723
25021	61	1	33	1648	0	1743
25022	1747	1	8	60	0	1816
25023	1809	1	7	41	0	1858
25024	1854	3	5	13	0	1875
25025	104	1	3	1771	0	1879
25026	1832	1	5	56	0	1894
25027	77	3	2	1812	0	1894
25028	49	5	2	1822	0	1878
25029	24	3	1	1852	0	1880
25030	12	2	3	1865	0	1882
25031	1767	3	1	99	0	1870
25032	1801	1	4	54	0	1860
25033	92	3	1760	24	0	1879
25034	1774	2	54	16	0	1846
25035	1824	2	32	9	0	1867
25036	96	2	8	1724	0	1830
25037	52	1741	11	54	0	1858
25038	1761	51	6	43	0	1861
25039	63	32	7	1702	0	1804
25040	1715	12	5	59	0	1791
25041	69	1679	10	41	0	1799
25042	1728	53	3	15	0	1799
25043	69	33	2	1658	0	1762
25044	41	1668	10	58	0	1777
25045	1746	56	4	47	0	1853
25046	65	1746	8	17	0	1836
25047	40	1779	8	14	0	1841
25048	1759	87	10	11	0	1867
25049	71	41	1687	17	0	1816
25050	1696	14	52	18	0	1780
25051	80	9	31	1665	0	1785
25052	43	11	1675	60	0	1789
25053	29	6	57	1666	0	1758
25054	22	4	34	1734	0	1794
25055	23	5	1668	88	0	1784
25056	1664	3	59	49	0	1775
25057	80	2	36	1691	0	1809
25058	46	0	13	1728	0	1787
25059	34	3	10	1750	0	1797
25060	1684	2	9	111	0	1806
25061	70	4	1681	68	0	1823
25062	49	0	1721	40	0	1810
25063	30	3	78	1641	0	1752
25064	33	2	1653	70	0	1758
25065	1609	0	60	57	0	1726
25066	66	1622	50	28	0	1766
25067	1670	46	17	24	0	1757
25068	87	32	14	1580	0	1713
25069	60	1595	12	66	0	1733
25070	40	67	12	1591	0	1710
25071	36	1623	14	61	0	1734
25072	29	61	4	1652	0	1746
25073	27	43	1565	76	0	1711
25074	21	27	1494	51	0	1593
25075	28	1490	75	23	0	1616
25076	1353	53	33	34	0	1473
25077	52	38	13	1337	0	1440
25078	52	16	10	1295	0	1373
25079	1310	18	6	69	0	1403
25080	1286	16	7	49	0	1358
25081	85	11	10	1283	0	1389
25082	55	8	1285	50	0	1398
25083	33	1295	41	46	0	1415
25084	24	47	36	1292	0	1399
25085	27	35	15	1240	0	1317
25086	21	1301	14	77	0	1413
25087	1322	41	10	52	0	1425
25088	51	44	1312	20	0	1427
25089	53	13	41	1301	0	1408
25090	19	13	33	1330	0	1395
25091	20	14	1294	84	0	1412
25092	12	14	48	1333	0	1407
25093	1335	9	43	47	0	1434
25094	1334	6	23	56	0	1419
25095	1373	10	23	20	0	1426
25096	80	1312	17	32	0	1441
25097	1362	43	18	21	0	1444
25098	70	33	13	1299	0	1415
25099	52	20	12	1250	0	1334
25100	27	1360	19	77	0	1483
25101	1525	46	10	57	0	1638
25102	1675	39	9	27	0	1750
25103	1663	17	9	27	0	1716
25104	1712	14	11	21	0	1758
25105	1688	10	9	32	0	1739
25106	107	14	1633	20	0	1774
25107	1666	6	63	15	0	1750
25108	1678	21	45	13	0	1757
25109	1691	12	15	18	0	1736
25110	112	3	16	1620	0	1751
25111	65	8	13	1649	0	1735
25112	40	11	1568	100	0	1719
25113	1323	13	65	54	0	1455
25114	60	1549	44	43	0	1696
25115	33	1349	12	17	0	1411
25116	18	51	1319	11	0	1399
25117	14	1320	34	9	0	1377
25118	12	1258	22	9	0	1301
25119	27	57	23	1053	0	1160
25120	1	1166	1	23	0	1191
25121	1125	21	2	10	0	1158
25122	1076	14	0	1	0	1091
25123	34	5	0	1021	0	1060
25124	17	3	1014	21	0	1055
25125	981	3	20	16	0	1020
25126	23	1	1007	7	0	1038
25127	18	2	1015	1	0	1036
25128	7	3	29	946	0	985
25129	6	2	17	1013	0	1038
25130	6	1	1008	31	0	1046
25131	6	972	21	18	0	1017
25132	3	1094	19	5	0	1121
25133	1054	30	5	4	0	1093
25134	1059	14	1	8	0	1082
25135	35	3	1062	1	0	1101
25136	1050	4	20	2	0	1076
25137	1108	4	13	8	0	1133
25138	37	5	3	1109	0	1154
25139	22	2	2	1137	0	1163
25140	9	2	3	1164	0	1178
25141	1144	2	2	41	0	1189
25142	1165	4	3	23	0	1195
25143	1187	2	2	8	0	1199
25144	44	3	5	1170	0	1222
25145	30	4	1119	24	0	1177
25146	1112	4	21	17	0	1154
25147	1142	2	16	7	0	1167
25148	39	2	8	1106	0	1155
25149	22	1120	4	24	0	1170
25150	13	24	5	1131	0	1173
25151	13	1145	3	29	0	1190
25152	9	22	5	1108	0	1144
25153	8	1152	6	33	0	1199
25154	1107	25	5	18	0	1155
25155	32	15	9	1076	0	1132
25156	20	1091	4	21	0	1136
25157	16	26	1088	20	0	1150
25158	1075	16	26	8	0	1125
25159	28	8	13	1098	0	1147
25160	19	1105	12	25	0	1161
25161	12	28	2	1069	0	1111
25162	9	1084	6	36	0	1135
25163	10	1132	6	17	0	1165
25164	1109	33	3	9	0	1154
25165	1125	16	5	8	0	1154
25166	39	6	1170	2	0	1217
25167	1153	8	24	7	0	1192
25168	1176	6	18	6	0	1206
25169	39	1167	9	3	0	1218
25170	23	22	2	1181	0	1228
25171	8	16	6	1215	0	1245
25172	12	7	1182	36	0	1237
25173	8	8	1164	17	0	1197
25174	1159	5	33	10	0	1207
25175	1211	2	19	8	0	1240
25176	1219	4	7	7	0	1237
25177	39	2	1148	5	0	1194
25178	23	4	22	1119	0	1168
25179	1140	1	16	27	0	1184
25180	27	3	4	1136	0	1170
25181	12	5	1096	28	0	1141
25182	1018	4	22	15	0	1059
25183	29	7	1173	7	0	1216
25184	16	1146	24	6	0	1192
25185	1180	20	8	5	0	1213
25186	23	10	1161	5	0	1199
25187	18	4	20	1153	0	1195
25188	1189	1	9	22	0	1221
25189	23	5	2	1238	0	1268
25190	1249	1	1	32	0	1283
25191	24	3	3	1233	0	1263
25192	1246	4	3	27	0	1280
25193	1257	4	4	11	0	1276
25194	1254	2	1	10	0	1267
25195	1228	6	5	4	0	1243
25196	38	1	4	1223	0	1266
25197	16	4	1211	25	0	1256
25198	8	8	1223	14	0	1253
25199	4	1223	36	8	0	1271
25200	5	1121	31	4	0	1161
25201	930	15	56	7	0	1008
25202	13	3	0	912	0	928
25203	3	3	913	12	0	931
25204	1	0	927	3	0	931
25205	2	14	10	910	0	936
25206	928	1	2	11	0	942
25207	7	949	0	5	0	961
25208	1001	7	0	4	0	1012
25209	7	4	0	991	0	1002
25210	6	1	0	999	0	1006
25211	5	2	0	1023	0	1030
25212	2	1	987	14	0	1004
25213	3	2	987	6	0	998
25214	2	980	17	1	0	1000
25215	2	12	3	1014	0	1031
25216	1005	4	0	12	0	1021
25217	10	1	971	7	0	989
25218	6	5	961	3	0	975
25219	2	1	16	959	0	978
25220	2	1	4	1002	0	1009
25221	5	0	0	1051	0	1056
25222	4	0	1	1138	0	1143
25223	1122	1	2	22	0	1147
25224	18	0	3	1122	0	1143
25225	1115	0	0	19	0	1134
25226	20	1	1186	8	0	1215
25227	9	1187	19	1	0	1216
25228	53	18	6	1124	0	1201
25229	4	8	1189	19	0	1220
25230	0	4	1182	7	0	1193
25231	3	1175	26	3	0	1207
25232	3	18	8	1127	0	1156
25233	2	7	3	1147	0	1159
25234	3	0	1193	24	0	1220
25235	1126	2	20	12	0	1160
25236	22	1	9	1180	0	1212
25237	10	2	2	1166	0	1180
25238	2	3	1106	28	0	1139
25239	4	1116	24	11	0	1155
25240	3	1290	9	3	0	1305
25241	1290	37	2	4	0	1333
25242	30	16	1	1296	0	1343
25243	1360	2	3	30	0	1395
25244	33	6	1315	43	0	1397
25245	19	1	27	1338	0	1385
25246	1349	1	14	33	0	1397
25247	1368	1	3	17	0	1389
25248	49	1	1	1346	0	1397
25249	20	3	1358	35	0	1416
25250	5	3	1558	18	0	1584
25251	4	1	49	1581	0	1635
25252	1	5	1599	33	0	1638
25253	1511	3	34	26	0	1574
25254	32	1727	25	7	0	1791
25255	1764	28	8	8	0	1808
25256	1767	20	5	3	0	1795
25257	53	5	4	1750	0	1812
25258	23	4	3	1792	0	1822
25259	1764	2	3	54	0	1823
25260	34	5	3	1770	0	1812
25261	25	6	1780	39	0	1850
25262	8	1790	37	26	0	1861
25263	9	30	24	1805	0	1868
25264	14	23	6	1826	0	1869
25265	8	8	5	1851	0	1872
25266	7	8	1766	60	0	1841
25267	11	1749	38	29	0	1827
25268	6	36	25	1775	0	1842
25269	9	25	1777	40	0	1851
25270	6	5	39	1782	0	1832
25271	1715	3	29	47	0	1794
25272	43	3	12	1760	0	1818
25273	27	6	1751	40	0	1824
25274	1627	3	35	38	0	1703
25275	62	1716	31	13	0	1822
25276	31	1807	17	8	0	1863
25277	1816	54	5	17	0	1892
25278	45	26	1825	12	0	1908
25279	42	6	35	1850	0	1933
25280	15	5	25	1930	0	1975
25281	13	5	1953	62	0	2033
25282	14	1945	40	39	0	2038
25283	13	40	26	1784	0	1863
25284	15	23	1888	43	0	1969
25285	14	10	38	1869	0	1931
25286	1859	7	29	54	0	1949
25287	38	11	1883	42	0	1974
25288	33	8	40	1897	0	1978
25289	17	5	28	1896	0	1946
25290	14	8	1839	62	0	1923
25291	17	11	35	1728	0	1791
25292	12	1682	33	50	0	1777
25293	24	35	15	1620	0	1694
25294	13	1815	11	44	0	1883
25295	1849	33	11	35	0	1928
25296	1795	30	13	18	0	1856
25297	66	9	1799	21	0	1895
25298	34	14	1734	16	0	1798
25299	14	10	1776	20	0	1820
25300	19	1743	59	16	0	1837
25301	11	34	29	1801	0	1875
25302	9	27	1808	44	0	1888
25303	19	8	46	1739	0	1812
25304	12	12	34	1793	0	1851
25305	18	9	1820	68	0	1915
25306	18	10	36	1843	0	1907
25307	13	9	34	1800	0	1856
25308	11	1753	18	69	0	1851
25309	16	37	11	1815	0	1879
25310	15	25	20	1820	0	1880
25311	10	16	1758	67	0	1851
25312	10	11	31	1749	0	1801
25313	17	7	1795	45	0	1864
25314	9	13	1779	46	0	1847
25315	1657	8	59	25	0	1749
25316	35	13	39	1662	0	1749
25317	26	1787	18	48	0	1879
25318	16	1876	22	37	0	1951
25319	17	46	15	1842	0	1920
25320	12	30	1859	39	0	1940
25321	15	1801	42	35	0	1893
25322	16	21	30	1750	0	1817
25323	6	31	1810	35	0	1882
25324	13	1842	29	36	0	1920
25325	1869	26	49	25	0	1969
25326	1840	26	17	23	0	1906
25327	1831	9	17	27	0	1884
25328	42	8	16	1967	0	2033
25329	26	11	12	2003	0	2052
25330	10	9	13	2028	0	2060
25331	10	12	2048	59	0	2129
25332	1922	7	34	48	0	2011
25333	29	8	31	1968	0	2036
25334	23	9	1914	33	0	1979
25335	1900	7	33	35	0	1975
25336	1990	9	32	23	0	2054
25337	46	17	1696	18	0	1777
25338	1931	2	29	28	0	1990
25339	25	1968	28	23	0	2044
25340	17	10	1715	6	0	1748
25341	1613	5	22	11	0	1651
25342	8	1675	10	7	0	1700
25343	7	7	0	1615	0	1629
25344	2	1679	8	6	0	1695
25345	3	6	2	1682	0	1693
25346	3	8	1674	10	0	1695
25347	1372	2	11	15	0	1400
25348	7	2	1776	4	0	1789
25349	12	1745	9	8	0	1774
25350	3	1742	17	1	0	1763
25351	1719	17	2	7	0	1745
25352	8	17	1715	36	0	1776
25353	11	0	10	1705	0	1726
25354	5	4	1640	11	0	1660
25355	2	1794	10	17	0	1823
25356	5	11	14	1643	0	1673
25357	1	1809	8	11	0	1829
25358	1904	9	2	18	0	1933
25359	1926	12	6	9	0	1953
25360	1931	3	3	5	0	1942
25361	22	4	1894	7	0	1927
25362	14	9	1802	2	0	1827
25363	1785	5	22	5	0	1817
25364	17	3	1965	3	0	1988
25365	16	4	17	1820	0	1857
25366	2	1926	20	13	0	1961
25367	1964	11	6	9	0	1990
25368	1963	14	5	5	0	1987
25369	1981	3	3	6	0	1993
25370	23	4	3	1977	0	2007
25371	13	2	5	2000	0	2020
25372	1990	3	5	27	0	2025
25373	15	2003	6	14	0	2038
25374	2020	11	7	7	0	2045
25375	15	11	4	1996	0	2026
25376	14	4	0	2009	0	2027
25377	1942	3	5	26	0	1976
25378	11	1943	6	16	0	1976
25379	1884	12	3	9	0	1908
25380	12	1918	7	4	0	1941
25381	1857	11	3	5	0	1876
25382	14	9	4	1963	0	1990
25383	1941	1	3	12	0	1957
25384	1997	1	1	14	0	2013
25385	2124	4	1	2	0	2131
25386	27	2251	1	3	0	2282
25387	21	17	2189	5	0	2232
25388	2109	18	19	5	0	2151
25389	2218	2	19	4	0	2243
25390	37	2240	5	1	0	2283
25391	22	19	1	2259	0	2301
25392	7	20	1	2272	0	2300
25393	2260	3	0	37	0	2300
25394	25	1	1	2316	0	2343
25395	24	5	2453	22	0	2504
25396	5	4	2398	23	0	2430
25397	2411	0	42	2	0	2455
25398	26	0	23	2467	0	2516
25399	22	4	3	2510	0	2539
25400	8	1	2	2618	0	2629
25401	4	7	2610	46	0	2667
25402	6	1	25	2661	0	2693
25403	6	2	26	2724	0	2758
25404	4	1	1	2777	0	2783
25405	2697	1	1	62	0	2761
25406	33	1	1	2727	0	2762
25407	37	7	2729	33	0	2806
25408	2767	5	30	32	0	2834
25409	44	6	2913	2	0	2965
25410	2943	2	44	10	0	2999
25411	2684	4	38	11	0	2737
25412	85	5	2	3093	0	3185
25413	35	3112	2	48	0	3197
25414	8	45	3	3136	0	3192
25415	8	45	6	3058	0	3117
25416	6	3128	7	86	0	3227
25417	3071	47	3	47	0	3168
25418	49	3115	8	14	0	3186
25419	3133	50	6	14	0	3203
25420	3133	43	4	11	0	3191
25421	91	4	3	3092	0	3190
25422	44	4	3	3071	0	3122
25423	11	8	3005	93	0	3117
25424	16	5	2880	48	0	2949
25425	2829	2	86	17	0	2934
25426	2948	4	42	21	0	3015
25427	87	2893	11	14	0	3005
25428	44	42	6	2841	0	2933
25429	10	37	3036	50	0	3133
25430	16	3	49	3048	0	3116
25431	2953	3	42	52	0	3050
25432	2971	7	6	48	0	3032
25433	87	3063	10	12	0	3172
25434	49	45	3	3131	0	3228
25435	10	51	2	3167	0	3230
25436	13	9	3	3201	0	3226
25437	9	13	3100	93	0	3215
25438	2705	7	53	66	0	2831
25439	3005	6	38	15	0	3064
25440	90	11	3045	21	0	3167
25441	49	3023	55	22	0	3149
25442	3051	46	40	24	0	3161
25443	3077	36	12	19	0	3144
25444	92	12	3003	18	0	3125
25445	53	9	3083	13	0	3158
25446	24	8	87	3041	0	3160
25447	23	13	3128	49	0	3213
25448	2836	5	63	49	0	2953
25449	2929	12	43	21	0	3005
25450	2972	7	7	33	0	3019
25451	85	6	14	2770	0	2875
25452	50	3007	15	57	0	3129
25453	3035	47	7	48	0	3137
25454	3013	41	14	21	0	3089
25455	93	18	3031	19	0	3161
25456	56	18	2946	68	0	3088
25457	2771	10	75	29	0	2885
25458	61	11	40	2927	0	3039
25459	56	11	2930	55	0	3052
25460	20	2923	69	44	0	3056
25461	27	39	45	2899	0	3010
25462	2896	37	14	51	0	2998
25463	58	2940	16	48	0	3062
25464	51	55	10	2813	0	2929
25465	15	2842	17	54	0	2928
25466	21	2896	17	49	0	2983
25467	22	77	14	2859	0	2972
25468	29	34	11	2850	0	2924
25469	22	2969	16	78	0	3085
25470	2941	48	14	50	0	3053
25471	75	51	2934	21	0	3081
25472	2943	12	43	41	0	3039
25473	64	12	51	3061	0	3188
25474	64	13	17	3055	0	3149
25475	29	8	24	3101	0	3162
25476	36	5	19	3093	0	3153
25477	29	14	3050	97	0	3190
25478	24	10	60	3099	0	3193
25479	27	9	48	3141	0	3225
25480	22	3394	22	97	0	3535
25481	18	71	3421	68	0	3578
25482	17	3446	77	27	0	3567
25483	21	74	3519	25	0	3639
25484	26	3683	75	24	0	3808
25485	27	82	61	3430	0	3600
25486	3395	57	12	73	0	3537
25487	72	3496	20	64	0	3652
25488	76	75	11	3475	0	3637
25489	32	71	3529	71	0	3703
25490	29	3530	76	65	0	3700
25491	3484	73	73	17	0	3647
25492	3470	72	18	20	0	3580
25493	131	3557	23	18	0	3729
25494	63	82	3341	18	0	3504
25495	3141	60	81	18	0	3300
25496	76	20	65	3342	0	3503
25497	3408	19	12	80	0	3519
25498	75	3667	24	69	0	3835
25499	64	3750	22	17	0	3853
25500	28	131	3565	23	0	3747
25501	3591	55	65	39	0	3750
25502	79	30	62	3694	0	3865
25503	3729	22	8	80	0	3839
25504	74	3679	15	63	0	3831
25505	3673	81	9	14	0	3777
25506	3664	67	13	24	0	3768
25507	134	13	3698	21	0	3866
25508	66	3510	53	8	0	3637
25509	15	3583	53	16	0	3667
25510	21	160	12	3176	0	3369
25511	17	3405	7	50	0	3479
25512	3256	57	7	53	0	3373
25513	63	3348	13	6	0	3430
25514	47	84	5	3215	0	3351
25515	16	3300	14	53	0	3383
25516	16	3274	9	41	0	3340
25517	18	3369	13	7	0	3407
25518	21	97	4	3238	0	3360
25519	23	53	6	3347	0	3429
25520	10	16	10	3349	0	3385
25521	15	3276	6	88	0	3385
25522	17	56	3269	55	0	3397
25523	12	68	3267	14	0	3361
25524	3100	28	88	14	0	3230
25525	63	19	49	3269	0	3400
25526	52	24	3277	59	0	3412
25527	15	24	3278	54	0	3371
25528	13	3309	91	15	0	3428
25529	10	63	50	2997	0	3120
25530	10	63	10	3140	0	3223
25531	3074	24	8	99	0	3205
25532	57	20	9	3132	0	3218
25533	48	14	14	3022	0	3098
25534	19	29	3008	98	0	3154
25535	12	15	56	3053	0	3136
25536	18	12	55	3092	0	3177
25537	18	24	3136	100	0	3278
25538	11	16	3163	58	0	3248
25539	14	3170	108	10	0	3302
25540	12	60	3194	21	0	3287
25541	17	54	61	3081	0	3213
25542	23	26	56	2609	0	2714
25543	14	28	3136	110	0	3288
25544	12	3128	66	61	0	3267
25545	2931	59	54	35	0	3079
25546	57	3083	20	23	0	3183
25547	50	67	17	3020	0	3154
25548	9	62	14	3060	0	3145
25549	8	3077	21	106	0	3212
25550	9	60	24	3107	0	3200
25551	12	60	15	3131	0	3218
25552	12	32	2926	110	0	3080
25553	13	2909	78	84	0	3084
25554	11	73	53	2970	0	3107
25555	15	60	2817	68	0	2960
25556	13	23	72	2825	0	2933
25557	13	26	58	2832	0	2929
25558	16	20	24	2902	0	2962
25559	13	27	16	2886	0	2942
25560	24	15	10	2810	0	2859
25561	19	2881	18	104	0	3022
25562	2770	71	20	69	0	2930
25563	56	68	2822	32	0	2978
25564	2443	21	68	42	0	2574
25565	58	26	2940	32	0	3056
25566	51	2986	62	45	0	3144
25567	18	68	3044	34	0	3164
25568	8	3036	72	31	0	3147
25569	16	61	57	2579	0	2713
25570	19	53	22	2685	0	2779
25571	14	2902	24	103	0	3043
25572	14	2984	20	63	0	3081
25573	2972	97	24	30	0	3123
25574	3067	61	15	23	0	3166
25575	3117	18	19	27	0	3181
25576	3148	22	15	34	0	3219
25577	95	19	19	3017	0	3150
25578	49	2984	23	59	0	3115
25579	2969	64	12	58	0	3103
25580	41	37	14	2640	0	2732
25581	2390	13	10	39	0	2452
25582	2342	9	7	38	0	2396
25583	47	2235	11	17	0	2310
25584	19	2048	7	9	0	2083
25585	3	2081	10	5	0	2099
25586	6	30	3	1972	0	2011
25587	5	1998	6	19	0	2028
25588	2003	17	4	19	0	2043
25589	1951	16	3	12	0	1982
25590	2027	7	2	6	0	2042
25591	2069	7	3	11	0	2090
25592	2067	5	2	9	0	2083
25593	31	4	2078	9	0	2122
25594	2092	2	20	7	0	2121
25595	22	9	2139	7	0	2177
25596	2080	5	19	10	0	2114
25597	22	4	21	2052	0	2099
25598	19	6	2030	22	0	2077
25599	7	10	2161	22	0	2200
25600	5	2283	37	3	0	2328
25601	2214	22	33	15	0	2284
25602	2265	18	3	9	0	2295
25603	42	2703	5	4	0	2754
25604	24	40	1	3094	0	3159
25605	3222	32	5	62	0	3321
25606	65	5	3269	48	0	3387
25607	46	3242	63	6	0	3357
25608	3146	66	44	6	0	3262
25609	63	3278	13	7	0	3361
25610	52	69	3	3035	0	3159
25611	10	3275	12	53	0	3350
25612	11	72	4	3068	0	3155
25613	8	3221	10	60	0	3299
25614	4	3329	9	43	0	3385
25615	3175	102	1	12	0	3290
25616	3243	52	2	6	0	3303
25617	105	16	3221	10	0	3352
25618	51	6	3275	12	0	3344
25619	12	10	3303	10	0	3335
25620	11	5	109	3236	0	3361
25621	9	11	3301	68	0	3389
25622	7	7	71	3224	0	3309
25623	10	8	52	3190	0	3260
25624	6	3233	14	101	0	3354
25625	3203	64	4	61	0	3332
25626	70	3352	10	12	0	3444
25627	53	71	5	3392	0	3521
25628	18	56	5	3435	0	3514
25629	16	12	7	3494	0	3529
25630	16	13	3415	115	0	3559
25631	14	9	71	3407	0	3501
25632	17	12	48	3447	0	3524
25633	11	8	15	3533	0	3567
25634	9	24	3320	121	0	3474
25635	12	3289	74	70	0	3445
25636	3247	75	53	27	0	3402
25637	3139	56	9	24	0	3228
25638	114	3348	13	15	0	3490
25639	62	75	9	3277	0	3423
25640	19	65	9	3411	0	3504
25641	18	26	3354	118	0	3516
25642	19	3328	75	82	0	3504
25643	9	76	60	3386	0	3531
25644	26	58	3414	81	0	3579
25645	12	16	79	3398	0	3505
25646	7	18	64	3397	0	3486
25647	16	24	3347	132	0	3519
25648	23	17	72	3372	0	3484
25649	16	17	64	3361	0	3458
25650	20	22	3451	124	0	3617
25651	18	17	81	3473	0	3589
25652	23	21	64	3398	0	3506
25653	17	17	23	3532	0	3589
25654	12	25	3391	148	0	3576
25655	9	11	84	3448	0	3552
25656	3355	21	64	101	0	3541
25657	3405	15	19	89	0	3528
25658	123	3418	25	34	0	3600
25659	3481	83	18	31	0	3613
25660	84	66	3685	42	0	3877
25661	76	21	81	3647	0	3825
25662	29	16	71	3657	0	3773
25663	15	26	19	3834	0	3894
25664	3623	11	17	148	0	3799
25665	72	3582	20	119	0	3793
25666	54	77	22	3417	0	3570
25667	19	3523	27	88	0	3657
25668	3457	75	16	85	0	3633
25669	72	3551	29	28	0	3680
25670	3480	80	17	39	0	3616
25671	81	3405	22	39	0	3547
25672	55	3391	22	40	0	3508
25673	23	119	24	3292	0	3458
25674	18	58	20	3330	0	3426
25675	23	22	23	3350	0	3418
25676	17	14	20	3341	0	3392
25677	20	23	3200	138	0	3381
25678	16	3213	77	85	0	3391
25679	14	78	52	2908	0	3052
25680	15	3076	28	96	0	3215
25681	16	83	3038	70	0	3207
25682	22	51	74	3019	0	3166
25683	17	22	59	3155	0	3253
25684	26	22	3067	124	0	3239
25685	16	3061	78	84	0	3239
25686	9	71	60	2975	0	3115
25687	14	48	3012	97	0	3171
25688	8	3004	74	88	0	3174
25689	18	66	59	3000	0	3143
25690	15	59	2930	91	0	3095
25691	16	25	2920	79	0	3040
25692	16	2879	105	38	0	3038
25693	19	3093	63	28	0	3203
25694	13	121	14	3129	0	3277
25695	24	62	12	3438	0	3536
25696	20	25	3402	148	0	3595
25697	3125	23	90	88	0	3326
25698	3347	16	60	50	0	3473
25699	123	16	3306	41	0	3486
25700	63	3213	81	32	0	3389
25701	18	3234	60	32	0	3344
25702	14	3211	29	21	0	3275
25703	15	2586	38	25	0	2664
25704	40	120	38	2270	0	2468
25705	2	34	4	2794	0	2834
25706	5	11	4	2839	0	2859
25707	4	5	4	2872	0	2885
25708	2	2837	7	99	0	2945
25709	9	47	7	2825	0	2888
25710	0	2830	9	58	0	2897
25711	6	55	1	2886	0	2948
25712	2780	59	6	58	0	2903
25713	48	13	5	2873	0	2939
25714	53	2833	7	64	0	2957
25715	14	46	7	2939	0	3006
25716	11	56	6	2973	0	3046
25717	8	15	1	2963	0	2987
25718	2804	8	5	119	0	2936
25719	55	13	4	2940	0	3012
25720	56	11	2815	63	0	2945
25721	11	2862	48	70	0	2991
25722	9	57	55	2946	0	3067
25723	10	62	9	3010	0	3091
25724	9	16	6	3081	0	3112
25725	2824	11	4	130	0	2969
25726	59	13	2858	88	0	3018
25727	63	6	49	2765	0	2883
25728	15	2819	61	61	0	2956
25729	16	59	10	2898	0	2983
25730	2707	67	6	73	0	2853
25731	49	2785	5	71	0	2910
25732	58	62	2	2787	0	2909
25733	11	64	1	2815	0	2891
25734	9	2762	5	129	0	2905
25735	11	56	5	2892	0	2964
25736	7	59	4	2918	0	2988
25737	7	22	2798	128	0	2955
25738	1	2692	59	106	0	2858
25739	2702	67	57	40	0	2866
25740	58	66	2684	32	0	2840
25741	2605	18	57	30	0	2710
25742	69	19	2704	25	0	2817
25743	64	14	63	2663	0	2804
25744	2630	12	59	84	0	2785
25745	61	14	14	2680	0	2769
25746	2705	6	5	103	0	2819
25747	2735	15	6	81	0	2837
25748	2732	11	11	42	0	2796
25749	125	2671	16	29	0	2841
25750	72	70	6	2637	0	2785
25751	27	64	10	2706	0	2807
25752	21	18	5	2755	0	2799
25753	16	23	2643	141	0	2823
25754	12	9	62	2725	0	2808
25755	2686	14	62	100	0	2862
25756	2709	12	26	90	0	2837
25757	128	17	2653	39	0	2837
25758	2699	13	63	34	0	2809
25759	2757	11	70	35	0	2873
25760	132	16	14	2514	0	2676
25761	2562	15	14	87	0	2678
25762	2560	9	12	90	0	2671
25763	138	10	7	2509	0	2664
25764	2565	12	18	89	0	2684
25765	2569	11	12	87	0	2679
25766	141	12	8	2519	0	2680
25767	90	21	2244	83	0	2438
25768	2348	15	63	85	0	2511
25769	81	14	2519	37	0	2651
25770	82	16	2490	31	0	2619
25771	31	2459	123	43	0	2656
25772	30	62	75	2420	0	2587
25773	28	65	23	2544	0	2660
25774	29	17	13	2562	0	2621
25775	34	20	2478	144	0	2676
25776	28	17	2489	101	0	2635
25777	37	2501	123	42	0	2703
25778	39	62	74	2472	0	2647
25779	31	67	25	2552	0	2675
25780	37	14	20	2626	0	2697
25781	38	13	2513	151	0	2715
25782	26	2511	69	103	0	2709
25783	34	60	65	2488	0	2647
25784	31	65	2516	84	0	2696
25785	30	20	2510	90	0	2650
25786	2463	12	134	34	0	2643
25787	2525	13	82	33	0	2653
25788	2602	14	30	35	0	2681
25789	150	10	19	2433	0	2612
25790	93	16	2527	92	0	2728
25791	34	2462	75	101	0	2672
25792	28	2538	85	43	0	2694
25793	25	114	2188	28	0	2355
25794	43	115	66	1939	0	2163
25795	31	20	66	1751	0	1868
25796	19	1758	24	98	0	1899
25797	24	1851	19	57	0	1951
25798	1812	82	20	24	0	1938
25799	1830	52	8	30	0	1920
25800	1865	8	10	24	0	1907
25801	1809	8	13	21	0	1851
25802	1722	8	11	20	0	1761
25803	98	1575	21	10	0	1704
25804	46	1306	10	12	0	1374
25805	13	1090	12	16	0	1131
25806	1060	34	23	17	0	1134
25807	24	28	5	976	0	1033
25808	17	2	6	998	0	1023
25809	971	2	8	32	0	1013
25810	21	941	6	22	0	990
25811	20	16	9	951	0	996
25812	10	17	10	973	0	1010
25813	9	6	5	1015	0	1035
25814	971	2	6	30	0	1009
25815	23	2	4	988	0	1017
25816	17	6	935	21	0	979
25817	891	1	13	17	0	922
25818	21	4	12	952	0	989
25819	19	1	956	20	0	996
25820	9	954	21	12	0	996
25821	10	950	11	5	0	976
25822	890	23	9	2	0	924
25823	941	7	2	3	0	953
25824	19	1000	1	5	0	1025
25825	14	9	2	1099	0	1124
25826	1103	14	2	12	0	1131
25827	9	3	2	1166	0	1180
25828	16	1	4	1221	0	1242
25829	4	1	1	1233	0	1239
25830	1	2	1	1227	0	1231
25831	2	1192	3	35	0	1232
25832	2	17	2	1228	0	1249
25833	6	17	0	1223	0	1246
25834	7	2	2	1231	0	1242
25835	5	5	1168	37	0	1215
25836	4	1183	14	24	0	1225
25837	2	12	20	1225	0	1259
25838	2	23	1236	14	0	1275
25839	7	7	1186	21	0	1221
25840	4	1238	30	6	0	1278
25841	1212	20	23	4	0	1259
25842	15	23	4	1227	0	1269
25843	1255	7	0	16	0	1278
25844	17	1253	6	19	0	1295
25845	22	15	4	1265	0	1306
25846	1238	22	1	18	0	1279
25847	1253	3	0	25	0	1281
25848	36	1	0	1259	0	1296
25849	24	1	0	1217	0	1242
25850	5	5	1208	38	0	1256
25851	6	3	14	1218	0	1241
25852	4	2	19	1228	0	1253
25853	1180	3	5	38	0	1226
25854	13	1187	6	30	0	1236
25855	18	15	1140	15	0	1188
25856	1094	17	12	13	0	1136
25857	12	1159	23	7	0	1201
25858	21	14	6	1190	0	1231
25859	1145	21	3	18	0	1187
25860	19	3	3	1124	0	1149
25861	21	3	3	1110	0	1137
25862	7	7	1068	37	0	1119
25863	5	5	15	1110	0	1135
25864	1049	4	19	29	0	1101
25865	17	4	4	1106	0	1131
25866	1083	4	2	26	0	1115
25867	16	1059	3	33	0	1111
25868	25	1083	5	15	0	1128
25869	8	31	4	1073	0	1116
25870	3	22	1	1096	0	1122
25871	1041	7	3	42	0	1093
25872	18	1059	7	32	0	1116
25873	1082	16	4	16	0	1118
25874	1075	22	7	11	0	1115
25875	39	8	4	1075	0	1126
25876	1084	8	5	27	0	1124
25877	22	4	1028	31	0	1085
25878	27	10	14	1023	0	1074
25879	9	7	1066	27	0	1109
25880	7	3	20	1075	0	1105
25881	1028	5	24	20	0	1077
25882	1029	8	4	32	0	1073
25883	38	1024	11	16	0	1089
25884	27	15	9	1022	0	1073
25885	11	22	6	1032	0	1071
25886	5	1014	8	45	0	1072
25887	14	13	0	1041	0	1068
25888	13	20	5	1024	0	1062
25889	8	1022	5	41	0	1076
25890	961	19	5	29	0	1014
25891	975	19	7	22	0	1023
25892	34	8	7	970	0	1019
25893	34	8	4	1001	0	1047
25894	14	11	964	43	0	1032
25895	16	5	13	973	0	1007
25896	9	960	24	23	0	1016
25897	972	16	12	31	0	1031
25898	20	16	5	1009	0	1050
25899	28	7	4	972	0	1011
25900	936	4	4	40	0	984
25901	21	930	8	29	0	988
25902	29	17	6	947	0	999
25903	13	20	4	941	0	978
25904	10	947	6	42	0	1005
25905	940	16	6	36	0	998
25906	23	23	910	21	0	977
25907	20	10	903	18	0	951
25908	11	11	32	903	0	957
25909	14	4	914	25	0	957
25910	856	10	14	25	0	905
25911	22	34	17	883	0	956
25912	26	4	922	28	0	980
25913	15	4	878	29	0	926
25914	5	891	24	14	0	934
25915	875	12	21	16	0	924
25916	21	881	8	12	0	922
25917	930	15	3	12	0	960
25918	915	17	3	19	0	954
25919	28	908	11	11	0	958
25920	912	15	4	17	0	948
25921	876	20	2	10	0	908
25922	25	10	817	15	0	867
25923	24	34	8	732	0	798
25924	10	695	11	14	0	730
25925	7	641	3	8	0	659
25926	10	40	2	592	0	644
25927	588	6	1	10	0	605
25928	8	2	0	566	0	576
25929	6	0	2	580	0	588
25930	4	2	1	634	0	641
25931	1	635	3	11	0	650
25932	1	4	1	705	0	711
25933	2	7	756	8	0	773
25934	751	1	10	10	0	772
25935	835	3	8	6	0	852
25936	18	826	1	3	0	848
25937	793	9	1	4	0	807
25938	10	6	1	814	0	831
25939	11	3	795	9	0	818
25940	780	2	9	7	0	798
25941	10	810	8	28	0	856
25942	9	9	1	828	0	847
25943	903	8	0	12	0	923
25944	11	874	3	9	0	897
25945	8	891	5	2	0	906
25946	879	17	0	0	0	896
25947	11	11	872	3	0	897
25948	876	4	9	3	0	892
25949	13	2	9	878	0	902
25950	9	4	2	875	0	890
25951	4	3	893	19	0	919
25952	5	5	894	9	0	913
25953	4	3	19	891	0	917
25954	4	2	894	11	0	911
25955	5	2	928	13	0	948
25956	4	1	18	905	0	928
25957	1	2	12	939	0	954
25958	933	1	4	20	0	958
25959	11	1	2	938	0	952
25960	932	3	4	11	0	950
25961	11	949	3	12	0	975
25962	10	10	1	947	0	968
25963	4	11	946	10	0	971
25964	922	2	11	10	0	945
25965	969	1	8	9	0	987
25966	998	1	2	4	0	1005
25967	984	2	3	5	0	994
25968	975	1	4	6	0	986
25969	19	2	3	962	0	986
25970	13	2	948	10	0	973
25971	7	2	950	11	0	970
25972	8	4	971	3	0	986
25973	921	4	25	4	0	954
25974	988	2	15	3	0	1008
25975	30	0	5	936	0	971
25976	14	967	6	17	0	1004
25977	6	15	4	982	0	1007
25978	5	13	979	18	0	1015
25979	7	4	938	13	0	962
25980	901	3	27	6	0	937
25981	21	4	1014	5	0	1044
25982	16	4	20	993	0	1033
25983	1026	3	15	22	0	1066
25984	1010	0	7	16	0	1033
25985	1063	4	3	7	0	1077
25986	1092	1	4	13	0	1110
25987	30	3	1065	6	0	1104
25988	1037	4	20	5	0	1066
25989	23	1046	19	3	0	1091
25990	20	21	4	1058	0	1103
25991	10	15	1062	17	0	1104
25992	11	3	20	1051	0	1085
25993	9	5	1057	19	0	1090
25994	11	3	18	1029	0	1061
25995	8	6	11	1048	0	1073
25996	4	2	1032	43	0	1081
25997	8	0	22	1039	0	1069
25998	1023	3	18	23	0	1067
25999	17	5	11	1033	0	1066
26000	15	1	7	1044	0	1067
26001	1027	1	7	28	0	1063
26002	24	1057	8	17	0	1106
26003	1071	16	1	14	0	1102
26004	24	1059	4	8	0	1095
26005	1141	19	2	11	0	1173
26006	22	15	1123	10	0	1170
26007	20	4	20	1121	0	1165
26008	8	4	18	1144	0	1174
26009	1128	0	9	31	0	1168
26010	20	1136	9	18	0	1183
26011	20	16	6	1143	0	1185
26012	11	11	4	1151	0	1177
26013	9	1147	5	34	0	1195
26014	1120	15	3	19	0	1157
26015	23	1134	10	4	0	1171
26016	16	16	5	1117	0	1154
26017	8	11	6	1073	0	1098
26018	7	1068	5	32	0	1112
26019	1055	19	4	14	0	1092
26020	26	19	1093	3	0	1141
26021	1105	6	18	6	0	1135
26022	21	1136	12	8	0	1177
26023	15	20	7	1139	0	1181
26024	1134	16	8	22	0	1180
26025	25	2	6	1160	0	1193
26026	20	1	9	1169	0	1199
26027	1155	0	3	39	0	1197
26028	24	1153	4	19	0	1200
26029	15	1139	5	13	0	1172
26030	1093	26	3	2	0	1124
26031	20	14	1164	6	0	1204
26032	15	1098	20	1	0	1134
26033	19	10	28	1041	0	1098
26034	3	9	1244	10	0	1266
26035	5	2	16	1217	0	1240
26036	1205	2	19	18	0	1244
26037	16	1202	4	23	0	1245
26038	19	17	4	1073	0	1113
26039	3	1186	1	11	0	1201
26040	1145	20	0	18	0	1183
26041	1171	17	2	2	0	1192
26042	32	1158	2	4	0	1196
26043	21	19	1	1082	0	1123
26044	4	1185	3	14	0	1206
26045	1192	18	1	20	0	1231
26046	1210	20	2	2	0	1234
26047	37	3	3	1178	0	1221
26048	25	1	1	1202	0	1229
26049	4	4	1157	43	0	1208
26050	1092	1	19	24	0	1136
26051	22	9	1156	5	0	1192
26052	22	3	19	1131	0	1175
26053	1120	2	20	25	0	1167
26054	20	1164	4	24	0	1212
26055	1085	21	0	9	0	1115
26056	21	23	997	4	0	1045
26057	1064	2	11	8	0	1085
26058	21	1126	20	4	0	1171
26059	1131	21	1	7	0	1160
26060	28	1181	3	3	0	1215
26061	22	21	4	1138	0	1185
26062	6	24	1140	23	0	1193
26063	8	10	1132	20	0	1170
26064	7	3	38	1128	0	1176
26065	4	9	1150	19	0	1182
26066	9	1	19	1132	0	1161
26067	4	5	20	1128	0	1157
26068	6	8	1123	42	0	1179
26069	1007	3	23	30	0	1063
26070	1114	5	24	6	0	1149
26071	43	1106	4	9	0	1162
26072	1108	18	7	4	0	1137
26073	17	23	1	1097	0	1138
26074	23	4	1123	20	0	1170
26075	4	2	22	1127	0	1155
26076	8	58	19	1084	0	1169
26077	1046	3	3	33	0	1085
26078	16	1034	5	19	0	1074
26079	22	1053	7	6	0	1088
26080	10	28	2	1046	0	1086
26081	5	23	4	1037	0	1069
26082	3	1045	5	33	0	1086
26083	7	17	2	1056	0	1082
26084	6	18	5	1037	0	1066
26085	6	1028	3	36	0	1073
26086	993	16	2	21	0	1032
26087	17	18	1	981	0	1017
26088	15	1015	2	17	0	1049
26089	9	19	2	1027	0	1057
26090	1013	16	1	21	0	1051
26091	16	1019	6	23	0	1064
26092	1042	20	2	6	0	1070
26093	1038	19	3	9	0	1069
26094	31	4	2	1033	0	1070
26095	1060	5	5	15	0	1085
26096	1086	2	1	25	0	1114
26097	1111	4	1	10	0	1126
26098	1110	5	4	7	0	1126
26099	35	2	3	1101	0	1141
26100	27	4	3	1115	0	1149
26101	7	3	1114	36	0	1160
26102	7	8	12	1135	0	1162
26103	11	3	17	1142	0	1173
26104	7	15	1109	33	0	1164
26105	1005	5	16	23	0	1049
26106	21	1	20	1096	0	1138
26107	23	4	1093	20	0	1140
26108	1042	5	17	24	0	1088
26109	22	3	1142	7	0	1174
26110	23	1175	19	10	0	1227
26111	8	1259	25	6	0	1298
26112	6	37	5	1255	0	1303
26113	9	29	1398	25	0	1461
26114	1362	6	24	30	0	1422
26115	1466	4	27	11	0	1508
26116	49	5	1435	11	0	1500
26117	1430	4	23	9	0	1466
26118	1456	6	31	4	0	1497
26119	53	1453	7	7	0	1520
26120	1433	23	4	9	0	1469
26121	31	29	5	1372	0	1437
26122	29	8	1352	22	0	1411
26123	8	1	24	1242	0	1275
26124	6	1344	33	28	0	1411
26125	11	1367	9	24	0	1411
26126	1374	39	6	5	0	1424
26127	1337	24	2	7	0	1370
26128	1423	7	2	6	0	1438
26129	44	4	4	1395	0	1447
26130	31	14	3	1311	0	1359
26131	6	1302	4	44	0	1356
26132	1290	24	3	25	0	1342
26133	23	1363	9	12	0	1407
26134	1117	13	5	7	0	1142
26135	20	1131	5	4	0	1160
26136	1137	12	1	7	0	1157
26137	1113	14	4	5	0	1136
26138	32	22	3	1046	0	1103
26139	20	1113	6	17	0	1156
26140	5	18	1091	16	0	1130
26141	999	19	10	10	0	1038
26142	15	1057	15	6	0	1093
26143	17	10	1052	7	0	1086
26144	7	16	1122	1	0	1146
26145	7	2	17	1074	0	1100
26146	4	6	11	1047	0	1068
26147	1	1133	2	21	0	1157
26148	1198	8	18	13	0	1237
26149	14	13	3	1180	0	1210
26150	17	1280	3	5	0	1305
26151	5	1332	2	14	0	1353
26152	3	23	1312	5	0	1343
26153	6	18	1318	3	0	1345
26154	1258	4	19	2	0	1283
26155	10	6	1351	6	0	1373
26156	14	4	9	1313	0	1340
26157	6	8	12	1370	0	1396
26158	12	3	1383	23	0	1421
26159	7	6	7	1334	0	1354
26160	7	5	13	1292	0	1317
26161	1302	5	5	23	0	1335
26162	1339	2	8	16	0	1365
26163	24	4	4	1335	0	1367
26164	12	1342	7	12	0	1373
26165	4	1357	8	13	0	1382
26166	1367	19	4	10	0	1400
26167	10	17	1376	9	0	1412
26168	13	6	11	1369	0	1399
26169	1418	6	16	14	0	1454
26170	1422	2	7	18	0	1449
26171	33	4	3	1401	0	1441
26172	21	8	1399	14	0	1442
26173	1	17	1332	17	0	1367
26174	1242	8	28	9	0	1287
26175	1341	5	19	6	0	1371
26176	35	1370	10	5	0	1420
26177	19	1383	13	9	0	1424
26178	1411	27	4	12	0	1454
26179	1439	16	5	14	0	1474
26180	31	3	7	1467	0	1508
26181	23	5	3	1571	0	1602
26182	10	9	6	1582	0	1607
26183	1542	3	5	28	0	1578
26184	26	1	5	1551	0	1583
26185	18	12	1561	21	0	1612
26186	1510	11	18	16	0	1555
26187	24	10	12	1570	0	1616
26188	31	5	1585	15	0	1636
26189	1508	10	19	21	0	1558
26190	1421	10	18	10	0	1459
26191	31	1590	6	7	0	1634
26192	25	1630	6	7	0	1668
26193	9	33	1549	11	0	1602
26194	1485	18	18	8	0	1529
26195	21	1601	23	6	0	1651
26196	27	17	1530	6	0	1580
26197	1389	18	14	9	0	1430
26198	19	1611	22	6	0	1658
26199	15	26	1612	8	0	1661
26200	1509	14	15	7	0	1545
26201	21	1594	14	6	0	1635
26202	17	16	4	1613	0	1650
26203	1614	16	2	21	0	1653
26204	22	1621	7	17	0	1667
26205	21	13	6	1602	0	1642
26206	1548	11	2	24	0	1585
26207	16	4	1607	18	0	1645
26208	17	1576	16	4	0	1613
26209	8	14	1566	11	0	1599
26210	2	57	17	1436	0	1512
26211	33	3	1436	8	0	1480
26212	3	1454	9	8	0	1474
26213	3	1318	7	1	0	1329
26214	3	29	1	1286	0	1319
26215	5	6	0	1261	0	1272
26216	1	1	0	1313	0	1315
26217	1	1	1347	9	0	1358
26218	4	0	7	1332	0	1343
26219	1350	1	3	9	0	1363
26220	1325	2	2	4	0	1333
26221	16	10	1432	1	0	1459
26222	5	1458	10	1	0	1474
26223	1402	7	4	5	0	1418
26224	6	1397	3	2	0	1408
26225	1377	8	0	4	0	1389
26226	1383	4	3	3	0	1393
26227	13	2	1366	2	0	1383
26228	4	1384	9	2	0	1399
26229	0	8	4	1406	0	1418
26230	1	7	1397	7	0	1412
26231	1287	2	8	4	0	1301
26232	6	0	4	1384	0	1394
26233	3	4	1344	6	0	1357
26234	1290	2	7	6	0	1305
26235	8	5	1396	4	0	1413
26236	7	1	8	1429	0	1445
26237	1491	1	5	10	0	1507
26238	8	1590	3	6	0	1607
26239	5	12	1665	5	0	1687
26240	1609	5	7	5	0	1626
26241	1884	4	7	5	0	1900
26242	23	1937	4	1	0	1965
26243	19	16	0	1956	0	1991
26244	5	17	1	1890	0	1913
26245	1830	5	0	40	0	1875
26246	23	1	2	1863	0	1889
26247	17	5	1853	20	0	1895
26248	9	1	15	1785	0	1810
26249	1779	3	18	23	0	1823
26250	19	1763	7	23	0	1812
26251	23	18	4	1681	0	1726
26252	7	1780	7	18	0	1812
26253	1740	27	1	21	0	1789
26254	22	20	1	1919	0	1962
26255	21	4	1	1970	0	1996
26256	7	1969	9	53	0	2038
26257	2	35	1949	40	0	2026
26258	6	24	37	1923	0	1990
26259	5	5	23	1960	0	1993
26260	7	3	7	1927	0	1944
26261	5	1913	10	64	0	1992
26262	4	37	1944	33	0	2018
26263	8	29	1947	8	0	1992
26264	1853	7	58	7	0	1925
26265	1955	3	33	10	0	2001
26266	64	7	1941	5	0	2017
26267	1877	2	33	20	0	1932
26268	41	7	2046	3	0	2097
26269	1921	1	35	12	0	1969
26270	37	1989	32	18	0	2076
26271	2020	31	8	8	0	2067
26272	37	31	2029	7	0	2104
26273	26	9	2095	8	0	2138
26274	14	5	57	2150	0	2226
26275	2219	4	36	45	0	2304
26276	46	2340	16	41	0	2443
26277	38	47	2528	13	0	2626
26278	18	35	45	2591	0	2689
26279	10	10	42	2645	0	2707
26280	2623	5	14	85	0	2727
26281	2550	9	6	49	0	2614
26282	95	7	5	2511	0	2618
26283	2554	8	5	59	0	2626
26284	57	14	2520	54	0	2645
26285	52	9	51	2502	0	2614
26286	19	4	44	2578	0	2645
26287	2542	5	13	99	0	2659
26288	2530	4	8	57	0	2599
26289	95	6	6	2511	0	2618
26290	2530	4	9	59	0	2602
26291	61	12	2467	56	0	2596
26292	50	2437	57	22	0	2566
26293	16	51	2510	17	0	2594
26294	14	44	55	2501	0	2614
26295	2495	12	51	59	0	2617
26296	52	2511	20	52	0	2635
26297	57	54	10	2472	0	2593
26298	21	49	12	2395	0	2477
26299	12	2424	16	98	0	2550
26300	21	60	7	2464	0	2552
26301	14	47	11	2482	0	2554
26302	14	16	8	2509	0	2547
26303	20	20	14	2490	0	2544
26304	14	7	12	2476	0	2509
26305	16	2418	16	109	0	2559
26306	19	54	14	2479	0	2566
26307	14	50	14	2459	0	2537
26308	22	15	2379	116	0	2532
26309	15	2407	60	68	0	2550
26310	25	51	55	2395	0	2526
26311	21	49	18	2428	0	2516
26312	19	13	11	2397	0	2440
26313	24	2332	13	113	0	2482
26314	26	58	2336	71	0	2491
26315	22	48	56	2390	0	2516
26316	27	19	2410	75	0	2531
26317	22	9	2376	68	0	2475
26318	16	13	99	2374	0	2502
26319	2336	9	64	87	0	2496
26320	67	6	18	2385	0	2476
26321	67	10	17	2272	0	2366
26322	23	2333	20	116	0	2492
26323	20	51	14	2462	0	2547
26324	24	50	12	2488	0	2574
26325	22	23	2469	111	0	2625
26326	10	2479	69	80	0	2638
26327	19	55	54	2518	0	2646
26328	2417	52	17	80	0	2566
26329	63	26	2471	70	0	2630
26330	53	14	63	2465	0	2595
26331	20	12	52	2525	0	2609
26332	2467	15	17	125	0	2624
26333	54	2471	20	88	0	2633
26334	2426	51	15	47	0	2539
26335	50	2459	12	41	0	2562
26336	53	57	7	2385	0	2502
26337	2305	50	14	81	0	2450
26338	81	18	2256	75	0	2430
26339	52	2201	58	42	0	2353
26340	17	2277	54	33	0	2381
26341	2001	78	15	27	0	2121
26342	49	39	14	1934	0	2036
26343	39	1952	12	62	0	2065
26344	13	2031	20	56	0	2120
26345	18	73	8	2004	0	2103
26346	9	44	6	2056	0	2115
26347	1978	14	8	97	0	2097
26348	50	1989	13	59	0	2111
26349	37	52	16	1965	0	2070
26350	17	43	1910	64	0	2034
26351	8	1911	58	56	0	2033
26352	18	45	1903	29	0	1995
26353	9	1963	47	24	0	2043
26354	13	45	67	1725	0	1850
26355	15	32	6	1676	0	1729
26356	11	1745	7	65	0	1828
26357	14	35	1699	44	0	1792
26358	1633	30	38	28	0	1729
26359	34	16	27	1791	0	1868
26360	32	13	13	1821	0	1879
26361	13	15	1788	67	0	1883
26362	9	11	38	1803	0	1861
26363	12	17	1811	47	0	1887
26364	11	6	33	1857	0	1907
26365	8	13	1944	48	0	2013
26366	6	2015	42	66	0	2129
26367	16	46	2069	25	0	2156
26368	11	44	43	1986	0	2084
26369	1971	14	39	52	0	2076
26370	46	1964	12	51	0	2073
26371	40	41	13	1975	0	2069
26372	16	50	1931	59	0	2056
26373	8	1991	50	46	0	2095
26374	13	41	31	1774	0	1859
26375	8	35	1775	42	0	1860
26376	5	1626	30	32	0	1693
26377	1408	30	27	50	0	1515
26378	1375	18	3	6	0	1402
26379	41	4	3	1392	0	1440
26380	1405	5	0	24	0	1434
26381	26	1	3	1400	0	1430
26382	23	2	3	1404	0	1432
26383	7	5	1441	41	0	1494
26384	5	1	21	1440	0	1467
26385	4	1	21	1448	0	1474
26386	1431	4	4	44	0	1483
26387	1409	5	2	28	0	1444
26388	44	1411	2	6	0	1463
26389	20	25	1420	8	0	1473
26390	10	21	23	1408	0	1462
26391	4	9	1417	30	0	1460
26392	1314	4	30	24	0	1372
26393	24	8	1406	7	0	1445
26394	25	3	23	1332	0	1383
26395	3	1383	26	24	0	1436
26396	6	28	7	1361	0	1402
26397	6	20	3	1388	0	1417
26398	5	8	1427	43	0	1483
26399	5	4	25	1444	0	1478
26400	1416	4	20	34	0	1474
26401	1457	3	6	23	0	1489
26402	1453	3	7	10	0	1473
26403	1445	1	3	13	0	1462
26404	36	1416	7	11	0	1470
26405	22	1428	5	4	0	1459
26406	14	39	3	1248	0	1304
26407	6	18	4	1392	0	1420
26408	4	1333	4	38	0	1379
26409	5	20	6	1388	0	1419
26410	7	19	8	1390	0	1424
26411	7	8	4	1396	0	1415
26412	9	3	8	1403	0	1423
26413	8	2	2	1409	0	1421
26414	1359	7	8	48	0	1422
26415	25	1352	4	33	0	1414
26416	19	24	1288	13	0	1344
26417	6	19	22	1302	0	1349
26418	4	8	26	1294	0	1332
26419	5	4	7	1331	0	1347
26420	1276	5	9	48	0	1338
26421	30	1465	12	31	0	1538
26422	26	33	4	1430	0	1493
26423	8	1482	7	46	0	1543
26424	16	43	3	1417	0	1479
26425	4	1447	7	46	0	1504
26426	5	38	1449	47	0	1539
26427	7	42	42	1502	0	1593
26428	5	8	1704	54	0	1771
26429	8	6	48	1682	0	1744
26430	14	7	48	1770	0	1839
26431	1752	7	7	97	0	1863
26432	1796	7	6	68	0	1877
26433	1861	8	7	12	0	1888
26434	1857	6	6	17	0	1886
26435	1856	9	11	11	0	1887
26436	108	3	5	1717	0	1833
26437	65	1755	11	49	0	1880
26438	13	44	5	1738	0	1800
26439	9	56	1655	60	0	1780
26440	1609	12	40	63	0	1724
26441	1698	8	49	20	0	1775
26442	96	5	11	1681	0	1793
26443	62	4	5	1649	0	1720
26444	14	1580	10	101	0	1705
26445	16	43	4	1667	0	1730
26446	11	54	7	1622	0	1694
26447	12	1589	11	96	0	1708
26448	11	49	7	1681	0	1748
26449	1542	54	6	59	0	1661
26450	51	17	1586	63	0	1717
26451	1580	3	52	17	0	1652
26452	54	8	1616	20	0	1698
26453	59	8	53	1533	0	1653
26454	16	3	52	1464	0	1535
26455	12	1490	15	102	0	1619
26456	9	1524	7	66	0	1606
26457	12	90	2	1458	0	1562
26458	15	55	1495	54	0	1619
26459	1395	8	39	60	0	1502
26460	52	7	52	1389	0	1500
26461	58	1437	10	47	0	1552
26462	14	42	7	1482	0	1545
26463	9	58	2	1428	0	1497
26464	15	1376	3	93	0	1487
26465	20	34	1	1324	0	1379
26466	5	40	1126	34	0	1205
26467	8	10	1124	42	0	1184
26468	13	4	63	1059	0	1139
26469	3	1149	44	33	0	1229
26470	23	34	4	1145	0	1206
26471	1152	40	2	35	0	1229
26472	1173	4	5	43	0	1225
26473	1121	2	6	15	0	1144
26474	69	1089	5	5	0	1168
26475	41	34	1091	11	0	1177
26476	1075	38	30	17	0	1160
26477	1117	13	40	7	0	1177
26478	69	1077	10	11	0	1167
26479	46	32	0	1045	0	1123
26480	1054	40	10	33	0	1137
26481	1079	5	5	48	0	1137
26482	1114	3	8	11	0	1136
26483	72	2	6	1005	0	1085
26484	1030	4	4	40	0	1078
26485	38	5	6	1029	0	1078
26486	47	3	3	1041	0	1094
26487	1022	2	4	73	0	1101
26488	40	5	5	1051	0	1101
26489	1053	10	5	34	0	1102
26490	40	3	3	1062	0	1108
26491	41	6	10	1052	0	1109
26492	1033	6	2	76	0	1117
26493	39	8	1020	50	0	1117
26494	44	9	30	1047	0	1130
26495	21	3	40	1038	0	1102
26496	17	7	8	1042	0	1074
26497	15	5	5	1069	0	1094
26498	12	9	4	1000	0	1025
26499	7	936	9	80	0	1032
26500	10	33	7	985	0	1035
26501	12	45	938	41	0	1036
26502	9	8	33	984	0	1034
26503	17	5	37	960	0	1019
26504	17	5	10	1012	0	1044
26505	16	5	941	77	0	1039
26506	13	4	953	48	0	1018
26507	923	9	65	13	0	1010
26508	946	10	42	17	0	1015
26509	67	954	7	21	0	1049
26510	52	32	4	976	0	1064
26511	15	45	3	1000	0	1063
26512	9	8	7	1043	0	1067
26513	983	4	8	77	0	1072
26514	1041	3	8	58	0	1110
26515	71	7	4	1036	0	1118
26516	45	6	4	1055	0	1110
26517	15	9	4	1089	0	1117
26518	6	8	3	1097	0	1114
26519	1008	7	6	81	0	1102
26520	34	8	994	54	0	1090
26521	33	751	22	17	0	823
26522	10	691	22	7	0	730
26523	685	26	4	12	0	727
26524	13	20	1	693	0	727
26525	18	10	654	20	0	702
26526	6	2	572	22	0	602
26527	3	573	24	15	0	615
26528	407	7	10	7	0	431
26529	6	6	390	3	0	405
26530	284	1	7	0	0	292
26531	8	0	3	321	0	332
26532	4	0	2	301	0	307
26533	1	303	1	6	0	311
26534	1	348	1	5	0	355
26535	344	7	1	3	0	355
26536	352	5	0	1	0	358
26537	4	360	0	2	0	366
26538	5	3	356	1	0	365
26539	2	3	392	3	0	400
26540	1	1	6	384	0	392
26541	387	1	4	5	0	397
26542	4	392	1	5	0	402
26543	6	3	1	400	0	410
26544	429	3	1	7	0	440
26545	4	2	1	456	0	463
26546	5	1	1	464	0	471
26547	453	1	1	10	0	465
26548	7	446	1	7	0	461
26549	4	473	2	4	0	483
26550	3	10	490	3	0	506
26551	3	7	5	492	0	507
26552	2	2	5	508	0	517
26553	1	4	530	10	0	545
26554	443	1	5	10	0	459
26555	495	0	4	6	0	505
26556	9	0	532	1	0	542
26557	453	2	5	7	0	467
26558	5	4	553	3	0	565
26559	6	566	6	3	0	581
26560	2	4	7	597	0	610
26561	4	5	2	632	0	643
26562	632	2	3	9	0	646
26563	644	1	1	6	0	652
26564	656	2	1	3	0	662
26565	658	0	1	3	0	662
26566	651	1	0	3	0	655
26567	13	2	654	3	0	672
26568	8	655	6	1	0	670
26569	3	5	5	644	0	657
26570	4	663	2	5	0	674
26571	3	689	2	5	0	699
26572	2	8	0	674	0	684
26573	0	6	2	683	0	691
26574	3	3	694	10	0	710
26575	638	2	3	10	0	653
26576	699	1	5	6	0	711
26577	10	705	3	1	0	719
26578	707	3	2	3	0	715
26579	724	7	0	3	0	734
26580	10	3	3	708	0	724
26581	6	4	800	5	0	815
26582	5	2	791	5	0	803
26583	797	1	7	2	0	807
26584	813	2	6	5	0	826
26585	12	815	3	3	0	833
26586	8	850	3	0	0	861
26587	2	10	1	867	0	880
26588	863	6	2	7	0	878
26589	5	4	891	6	0	906
26590	6	3	5	897	0	911
26591	944	1	6	6	0	957
26592	925	1	1	7	0	934
26593	11	1	2	967	0	981
26594	983	1	2	11	0	997
26595	9	1	983	8	0	1001
26596	13	5	1066	2	0	1086
26597	2	3	11	1063	0	1079
26598	3	0	8	1103	0	1114
26599	4	0	1	1101	0	1106
26600	0	1078	6	13	0	1097
26601	2	1106	4	3	0	1115
26602	2	12	4	1112	0	1130
26603	1102	7	0	9	0	1118
26604	8	2	1	1100	0	1111
26605	7	3	2	1096	0	1108
26606	2	1089	1	10	0	1102
26607	3	1136	0	8	0	1147
26608	2	9	1	1131	0	1143
26609	4	6	3	1119	0	1132
26610	1105	1	1	14	0	1121
26611	4	1117	1	6	0	1128
26612	1142	5	0	3	0	1150
26613	6	8	0	1153	0	1167
26614	11	2	1099	4	0	1116
26615	2	4	1101	11	0	1118
26616	1108	1	13	7	0	1129
26617	6	0	7	1202	0	1215
26618	9	1	2	1217	0	1229
26619	2	1	2	1235	0	1240
26620	2	5	1238	15	0	1260
26621	0	3	4	1242	0	1249
26622	2	1253	10	5	0	1270
26623	1	4	0	1278	0	1283
26624	1	6	2	1267	0	1276
26625	0	1302	4	10	0	1316
26626	1	10	0	1338	0	1349
26627	1294	7	0	12	0	1313
26628	6	1287	4	9	0	1306
26629	1374	11	1	3	0	1389
26630	1389	6	1	3	0	1399
26631	21	1	0	1358	0	1380
26632	10	0	1	1360	0	1371
26633	5	2	1	1386	0	1394
26634	3	4	1286	25	0	1318
26635	2	1288	13	11	0	1314
26636	1	1317	8	4	0	1330
26637	1	22	1	1299	0	1323
26638	1286	8	3	20	0	1317
26639	16	3	1	1267	0	1287
26640	10	8	1299	19	0	1336
26641	4	1281	13	9	0	1307
26642	2	1324	10	5	0	1341
26643	1323	22	2	6	0	1353
26644	1303	7	3	9	0	1322
26645	20	1427	6	3	0	1456
26646	1507	15	1	10	0	1533
26647	23	10	1502	3	0	1538
26648	13	4	1511	2	0	1530
26649	1503	2	26	5	0	1536
26650	1578	5	11	10	0	1604
26651	28	1	2	1621	0	1652
26652	1604	0	4	22	0	1630
26653	22	6	1590	13	0	1631
26654	16	7	1719	2	0	1744
26655	7	4	29	1901	0	1941
26656	8	2	13	2182	0	2205
26657	5	1	1	2261	0	2268
26658	9	3	2	2366	0	2380
26659	7	2	1	2565	0	2575
26660	5	14	2463	85	0	2567
26661	11	1	49	2463	0	2524
26662	2499	1	36	65	0	2601
26663	56	3	7	2515	0	2581
26664	2526	5	6	56	0	2593
26665	62	3	3	2536	0	2604
26666	2672	2	5	69	0	2748
26667	2734	0	4	49	0	2787
26668	97	2	5	2692	0	2796
26669	41	1	7	2750	0	2799
26670	2660	3	7	99	0	2769
26671	2673	9	3	50	0	2735
26672	97	4	2673	17	0	2791
26673	48	1	53	2675	0	2777
26674	17	4	39	2733	0	2793
26675	2687	2	7	112	0	2808
26676	2751	2	6	64	0	2823
26677	100	4	7	2761	0	2872
26678	52	2	2	2835	0	2891
26679	20	5	4	2845	0	2874
26680	12	5	4	2802	0	2823
26681	16	2599	8	115	0	2738
26682	7	2664	19	60	0	2750
26683	15	86	8	2611	0	2720
26684	18	2687	4	66	0	2775
26685	18	59	3	2720	0	2800
26686	19	48	2589	77	0	2733
26687	20	12	2561	66	0	2659
26688	16	2604	89	30	0	2739
26689	20	57	53	2554	0	2684
26690	11	41	2559	73	0	2684
26691	17	9	61	2550	0	2637
26692	25	9	38	2593	0	2665
26693	2592	5	9	116	0	2722
26694	61	4	15	2708	0	2788
26695	56	6	2739	82	0	2883
26696	23	10	2683	70	0	2786
26697	30	2725	93	34	0	2882
26698	22	2909	46	28	0	3005
26699	2890	86	11	43	0	3030
26700	74	44	3031	34	0	3183
26701	54	11	60	3018	0	3143
26702	3082	10	46	96	0	3234
26703	3120	11	19	72	0	3222
26704	94	3167	19	38	0	3318
26705	59	63	14	3040	0	3176
26706	30	45	11	3260	0	3346
26707	22	11	16	3275	0	3324
26708	3158	4	18	128	0	3308
26709	65	9	3150	79	0	3303
26710	59	3193	66	39	0	3357
26711	31	58	43	3206	0	3338
26712	29	41	16	3252	0	3338
26713	28	16	3165	122	0	3331
26714	23	9	58	3195	0	3285
26715	36	12	44	3232	0	3324
26716	25	12	13	3249	0	3299
26717	24	18	20	3230	0	3292
26718	25	21	3132	121	0	3299
26719	24	22	68	3159	0	3273
26720	29	19	3169	109	0	3326
26721	26	3147	79	78	0	3330
26722	27	56	51	3157	0	3291
26723	25	41	22	3226	0	3314
26724	34	16	3123	130	0	3303
26725	21	3045	62	95	0	3223
26726	22	56	48	3080	0	3206
26727	24	46	3055	95	0	3220
26728	19	3086	64	82	0	3251
26729	26	54	45	3064	0	3189
26730	31	48	3051	74	0	3204
26731	26	14	58	3054	0	3152
26732	19	22	46	3061	0	3148
26733	20	19	13	3192	0	3244
26734	3122	11	22	113	0	3268
26735	53	3115	19	65	0	3252
26736	3129	47	14	60	0	3250
26737	61	43	3122	39	0	3265
26738	3250	16	56	54	0	3376
26739	3460	17	44	42	0	3563
26740	82	8	24	3413	0	3527
26741	3480	19	20	85	0	3604
26742	3524	14	14	82	0	3634
26743	3614	16	16	45	0	3691
26744	90	12	20	3563	0	3685
26745	51	18	11	3424	0	3504
26746	20	24	3211	88	0	3343
26747	14	13	3100	63	0	3190
26748	2956	13	80	31	0	3080
26749	46	9	45	3178	0	3278
26750	42	3293	22	57	0	3414
26751	3262	42	19	58	0	3381
26752	47	3351	11	31	0	3440
26753	34	3335	17	40	0	3426
26754	24	76	3208	40	0	3348
26755	14	40	3282	10	0	3346
26756	14	40	42	3083	0	3179
26757	4	11	3288	36	0	3339
26758	4	12	3012	19	0	3047
26759	2623	2	13	7	0	2645
26760	2837	1	7	7	0	2852
26761	12	2	3	2858	0	2875
26762	8	2	0	2974	0	2984
26763	5	6	3037	14	0	3062
26764	3	3094	10	8	0	3115
26765	4	5	5	3111	0	3125
26766	3133	3	2	16	0	3154
26767	3	0	2	3209	0	3214
26768	5	3209	4	7	0	3225
26769	7	12	3168	12	0	3199
26770	2	3277	7	3	0	3289
26771	3251	2	3	7	0	3263
26772	3218	5	0	2	0	3225
26773	5	1	1	3213	0	3220
26774	5	13	3311	4	0	3333
26775	3	5	3134	8	0	3150
26776	1	3280	16	2	0	3299
26777	6	9	7	3137	0	3159
26778	2	9	2	3313	0	3326
26779	2	5	3293	14	0	3314
26780	3	2	8	3244	0	3257
26781	3	3440	11	9	0	3463
26782	4	10	3	3437	0	3454
26783	2	12	1	3446	0	3461
26784	3	12	3410	22	0	3447
26785	1	1	12	3385	0	3399
26786	3354	2	22	23	0	3401
26787	18	11	3503	13	0	3545
26788	17	12	3516	3	0	3548
26789	3	3572	37	2	0	3614
26790	1	17	17	3648	0	3683
26791	1	15	4	3773	0	3793
26792	3	8	3704	39	0	3754
26793	3334	3	22	22	0	3381
26794	21	1	20	3609	0	3651
26795	21	10	3544	21	0	3596
26796	10	4	20	3427	0	3461
26797	4	11	3513	27	0	3555
26798	4	6	3398	23	0	3431
26799	4	3560	47	5	0	3616
26800	6	22	23	3299	0	3350
26801	0	3484	14	22	0	3520
26802	3327	24	4	24	0	3379
26803	22	25	3429	9	0	3485
26804	23	3377	26	10	0	3436
26805	7	22	23	3394	0	3446
26806	3353	21	6	29	0	3409
26807	20	3370	13	28	0	3431
26808	23	23	7	3458	0	3511
26809	7	25	2	3434	0	3468
26810	3	3505	11	47	0	3566
26811	3469	28	9	33	0	3539
26812	25	27	11	4143	0	4206
26813	31	6	2	4337	0	4376
26814	9	17	4229	111	0	4366
26815	3	4374	67	68	0	4512
26816	6	64	55	4469	0	4594
26817	6	59	12	4867	0	4944
26818	4	5049	5	148	0	5206
26819	12	86	7	5157	0	5262
26820	11	84	11	5279	0	5385
26821	6	8	13	5326	0	5353
26822	4	5278	21	185	0	5488
26823	5219	102	11	106	0	5438
26824	103	97	5303	29	0	5532
26825	5103	16	111	15	0	5245
26826	107	5304	105	18	0	5534
26827	95	101	13	5318	0	5527
26828	15	106	5458	114	0	5693
26829	9	11	106	5568	0	5694
26830	18	7	99	5578	0	5702
26831	12	11	18	5721	0	5762
26832	7	14	5543	207	0	5771
26833	8	5496	114	124	0	5742
26834	12	112	5591	25	0	5740
26835	15	5607	117	57	0	5796
26836	19	118	5694	31	0	5862
26837	12	97	118	5594	0	5821
26838	5393	21	100	131	0	5645
26839	104	5589	25	121	0	5839
26840	91	122	5595	50	0	5858
26841	16	5622	121	36	0	5795
26842	16	127	5694	33	0	5870
26843	9	113	120	5443	0	5685
26844	23	24	104	5186	0	5337
26845	10	5508	37	204	0	5759
26846	17	5713	19	136	0	5885
26847	5733	207	26	41	0	6007
26848	122	121	26	5793	0	6062
26849	116	39	5822	142	0	6119
26850	29	25	128	5880	0	6062
26851	26	54	5904	146	0	6130
26852	18	34	5914	137	0	6103
26853	28	30	221	5505	0	5784
26854	16	5694	134	139	0	5983
26855	5656	130	31	155	0	5972
26856	128	125	28	5617	0	5898
26857	117	35	35	5488	0	5675
26858	25	5687	47	225	0	5984
26859	5672	148	29	125	0	5974
26860	5723	127	37	51	0	5938
26861	223	39	32	5541	0	5835
26862	119	5571	50	150	0	5890
26863	23	5953	37	143	0	6156
26864	5815	232	32	52	0	6131
26865	117	146	5826	46	0	6135
26866	5634	50	140	54	0	5878
26867	5770	33	124	52	0	5979
26868	5817	39	37	55	0	5948
26869	213	5756	43	56	0	6068
26870	113	142	34	5914	0	6203
26871	5915	138	28	145	0	6226
26872	5946	49	35	137	0	6167
26873	222	5901	60	93	0	6276
26874	6055	133	34	53	0	6275
26875	128	124	38	6036	0	6326
26876	118	33	43	6021	0	6215
26877	26	6038	48	239	0	6351
26878	32	124	35	6197	0	6388
26879	32	141	24	6109	0	6306
26880	33	6081	32	223	0	6369
26881	44	129	27	5794	0	5994
26882	27	6173	41	139	0	6380
26883	6112	136	32	130	0	6410
26884	6022	128	37	57	0	6244
26885	207	6029	43	45	0	6324
26886	124	119	6068	54	0	6365
26887	32	119	111	6108	0	6370
26888	41	60	6170	132	0	6403
26889	36	5966	128	127	0	6257
26890	31	6092	120	47	0	6290
26891	5871	191	35	46	0	6143
26892	128	6303	30	81	0	6542
26893	128	119	25	6008	0	6280
26894	43	6323	38	117	0	6521
26895	39	6383	26	114	0	6562
26896	6306	198	16	49	0	6569
26897	129	120	25	6419	0	6693
26898	115	52	6344	132	0	6643
26899	40	47	6299	127	0	6513
26900	37	6398	201	59	0	6695
26901	6346	121	110	58	0	6635
26902	118	6554	37	38	0	6747
26903	113	147	20	6541	0	6821
26904	6632	112	22	153	0	6919
26905	133	39	16	6823	0	7011
26906	126	45	27	6740	0	6938
26907	40	6717	29	222	0	7008
26908	48	124	16	6785	0	6973
26909	45	133	6748	130	0	7056
26910	6424	41	123	130	0	6718
26911	143	7059	128	86	0	7416
26912	103	6820	40	25	0	6988
26913	6553	187	37	44	0	6821
26914	116	134	6641	21	0	6912
26915	6214	54	101	31	0	6400
26916	111	7215	94	17	0	7437
26917	97	7421	21	19	0	7558
26918	31	219	7386	14	0	7650
26919	14	7675	129	10	0	7828
26920	37	135	142	6728	0	7042
26921	21	109	10	7113	0	7253
26922	10	7286	13	203	0	7512
26923	10	118	10	7332	0	7470
26924	7429	108	2	129	0	7668
26925	115	30	7442	107	0	7694
26926	7358	14	117	29	0	7518
26927	7596	15	104	16	0	7731
26928	7518	16	14	26	0	7574
26929	227	26	7352	10	0	7615
26930	127	12	122	7299	0	7560
26931	25	15	7465	127	0	7632
26932	7051	12	129	120	0	7312
26933	7175	14	112	26	0	7327
26934	226	7315	31	17	0	7589
26935	130	127	13	7188	0	7458
26936	33	7589	26	123	0	7771
26937	23	160	7589	125	0	7897
26938	28	127	137	7560	0	7852
26939	7514	26	126	147	0	7813
26940	7679	15	24	136	0	7854
26941	268	27	17	7092	0	7404
26942	134	7213	37	130	0	7514
26943	36	147	7400	127	0	7710
26944	34	141	7485	28	0	7688
26945	6794	30	259	35	0	7118
26946	151	27	7572	26	0	7776
26947	127	7470	164	31	0	7792
26948	35	146	134	7279	0	7594
26949	32	135	7572	147	0	7886
26950	39	33	155	7270	0	7497
26951	58	32	7516	163	0	7769
26952	6739	15	165	152	0	7071
26953	173	24	148	7070	0	7415
26954	148	7159	47	156	0	7510
26955	36	7262	35	149	0	7482
26956	37	265	36	7057	0	7395
26957	45	144	30	6936	0	7155
26958	29	6991	33	264	0	7317
26959	39	167	6969	150	0	7325
26960	30	143	162	6927	0	7262
26961	30	99	7094	169	0	7392
26962	45	31	6908	146	0	7130
26963	6156	28	291	39	0	6514
26964	164	6618	160	42	0	6984
26965	6676	168	40	45	0	6929
26966	187	154	37	6337	0	6715
26967	148	6541	40	162	0	6891
26968	63	179	43	6588	0	6873
26969	52	149	44	6408	0	6653
26970	41	6296	55	279	0	6671
26971	44	174	6288	156	0	6662
26972	48	153	175	6322	0	6698
26973	6276	47	174	181	0	6678
26974	180	37	58	6312	0	6587
26975	155	41	55	6297	0	6548
26976	60	49	6138	300	0	6547
26977	43	6062	190	171	0	6466
26978	42	189	161	5927	0	6319
26979	40	158	6024	197	0	6419
26980	29	78	6075	173	0	6355
26981	5611	59	289	64	0	6023
26982	162	5920	171	78	0	6331
26983	5891	167	60	73	0	6191
26984	169	5928	65	59	0	6221
26985	160	6020	62	59	0	6301
26986	5671	282	47	66	0	6066
26987	200	155	56	5489	0	5900
26988	164	5611	80	167	0	6022
26989	74	174	44	5775	0	6067
26990	5611	149	58	194	0	6012
26991	191	54	5732	176	0	6153
26992	159	49	5528	65	0	5801
26993	5207	50	299	56	0	5612
26994	184	5416	179	73	0	5852
26995	168	185	5403	50	0	5806
26996	54	5464	200	54	0	5772
26997	55	178	154	5152	0	5539
26998	50	166	5258	190	0	5664
26999	59	57	168	5219	0	5503
27000	51	53	5193	216	0	5513
27001	4850	48	175	188	0	5261
27002	161	5046	178	70	0	5455
27003	5024	165	72	61	0	5322
27004	177	151	66	4296	0	4690
27005	150	4920	73	162	0	5305
27006	4977	172	75	145	0	5369
27007	4981	163	57	51	0	5252
27008	281	68	4993	54	0	5396
27009	153	60	4910	64	0	5187
27010	4144	52	235	42	0	4473
27011	127	4289	147	55	0	4618
27012	117	4195	61	34	0	4407
27013	74	218	70	3957	0	4319
27014	106	108	3941	125	0	4280
27015	39	3741	111	110	0	4001
27016	29	3205	81	64	0	3379
27017	107	138	45	2202	0	2492
27018	2231	49	17	56	0	2353
27019	2336	19	17	55	0	2427
27020	2408	17	21	19	0	2465
27021	92	20	2325	27	0	2464
27022	2309	17	54	15	0	2395
27023	2364	17	54	20	0	2455
27024	2381	16	20	20	0	2437
27025	92	14	20	2177	0	2303
27026	55	2258	20	49	0	2382
27027	2273	51	11	50	0	2385
27028	60	2317	11	13	0	2401
27029	50	40	18	2178	0	2286
27030	32	50	2227	42	0	2351
27031	21	17	45	2248	0	2331
27032	27	15	50	2254	0	2346
27033	25	12	2229	78	0	2344
27034	21	2233	58	42	0	2354
27035	21	29	36	1926	0	2012
27036	1936	34	11	39	0	2020
27037	34	1878	12	29	0	1953
27038	1787	39	6	7	0	1839
27039	37	32	9	1781	0	1859
27040	30	1801	14	26	0	1871
27041	1774	28	13	28	0	1843
27042	38	1858	11	6	0	1913
27043	27	33	1758	8	0	1826
27044	1725	28	21	6	0	1780
27045	1722	5	20	7	0	1754
27046	45	1767	11	3	0	1826
27047	30	25	1646	4	0	1705
27048	7	1663	21	2	0	1693
27049	12	33	30	1074	0	1149
27050	6	28	3	1610	0	1647
27051	9	7	5	1618	0	1639
27052	6	1603	3	40	0	1652
27053	6	21	2	1633	0	1662
27054	11	23	3	1634	0	1671
27055	1602	5	1	40	0	1648
27056	28	5	3	1618	0	1654
27057	27	1	1	1611	0	1640
27058	1615	6	3	43	0	1667
27059	26	1643	2	28	0	1699
27060	1705	24	1	13	0	1743
27061	1695	26	2	7	0	1730
27062	1704	7	4	7	0	1722
27063	50	5	2	1665	0	1722
27064	31	5	3	1698	0	1737
27065	8	6	1656	42	0	1712
27066	7	7	1633	28	0	1675
27067	7	6	1642	12	0	1667
27068	1456	7	45	9	0	1517
27069	32	8	1707	7	0	1754
27070	27	1712	25	5	0	1769
27071	10	23	24	1685	0	1742
27072	8	26	6	1599	0	1639
27073	8	1713	5	32	0	1758
27074	7	31	1736	21	0	1795
27075	7	1794	20	10	0	1831
27076	1728	24	23	13	0	1788
27077	28	29	1824	4	0	1885
27078	30	1803	28	9	0	1870
27079	13	26	1835	9	0	1883
27080	18	26	23	1795	0	1862
27081	8	17	1847	26	0	1898
27082	6	6	25	1788	0	1825
27083	1795	7	28	29	0	1859
27084	30	11	1818	34	0	1893
27085	27	1831	27	15	0	1900
27086	1837	25	22	19	0	1903
27087	29	27	1872	11	0	1939
27088	29	5	1887	14	0	1935
27089	9	9	41	1830	0	1889
27090	12	4	1887	32	0	1935
27091	1660	10	24	27	0	1721
27092	26	1813	25	11	0	1875
27093	36	26	7	1756	0	1825
27094	13	1973	11	22	0	2019
27095	1980	36	6	27	0	2049
27096	36	29	1980	16	0	2061
27097	34	15	2060	13	0	2122
27098	13	12	55	2014	0	2094
27099	11	7	40	2061	0	2119
27100	8	10	21	2196	0	2235
27101	16	8	14	2220	0	2258
27102	12	8	2185	61	0	2266
27103	8	2141	35	42	0	2226
27104	9	30	31	2011	0	2081
27105	8	35	1977	30	0	2050
27106	2	1923	30	31	0	1986
27107	1897	28	27	11	0	1963
27108	28	28	7	1906	0	1969
27109	1909	10	11	27	0	1957
27110	28	1917	9	28	0	1982
27111	1874	25	1	15	0	1915
27112	37	26	1945	7	0	2015
27113	33	12	25	1829	0	1899
27114	10	1942	32	25	0	2009
27115	7	27	1919	28	0	1981
27116	7	1903	30	12	0	1952
27117	10	46	27	1379	0	1462
27118	1765	26	8	53	0	1852
27119	27	1781	7	25	0	1840
27120	1750	23	4	15	0	1792
27121	29	24	1833	10	0	1896
27122	24	10	1812	10	0	1856
27123	1756	1	46	12	0	1815
27124	25	3	34	1813	0	1875
27125	30	7	9	1848	0	1894
27126	10	6	1834	46	0	1896
27127	4	9	1760	23	0	1796
27128	7	1805	38	6	0	1856
27129	1754	21	21	4	0	1800
27130	1713	16	8	5	0	1742
27131	33	1714	9	6	0	1762
27132	21	20	2	1799	0	1842
27133	1838	18	2	22	0	1880
27134	20	3	5	1854	0	1882
27135	1887	4	14	25	0	1930
27136	1894	4	5	22	0	1925
27137	1937	4	5	8	0	1954
27138	36	6	6	1913	0	1961
27139	21	5	1	1899	0	1926
27140	1857	2	7	34	0	1900
27141	1872	6	6	24	0	1908
27142	1846	2	2	9	0	1859
27143	40	1843	9	8	0	1900
27144	1704	18	2	9	0	1733
27145	20	1715	3	6	0	1744
27146	1656	14	8	3	0	1681
27147	16	16	1650	4	0	1686
27148	1455	5	11	8	0	1479
27149	17	1610	13	9	0	1649
27150	12	1672	5	2	0	1691
27151	1688	25	1	8	0	1722
27152	21	10	7	1711	0	1749
27153	14	7	4	1732	0	1757
27154	7	1719	4	32	0	1762
27155	5	1845	9	15	0	1874
27156	1861	34	5	5	0	1905
27157	23	20	1908	13	0	1964
27158	20	4	25	2023	0	2072
27159	1982	6	22	30	0	2040
27160	31	8	1985	28	0	2052
27161	28	2184	24	9	0	2245
27162	2364	36	26	4	0	2430
27163	51	36	2418	3	0	2508
27164	40	8	50	2481	0	2579
27165	16	6	2568	52	0	2642
27166	2363	8	55	47	0	2473
27167	54	2593	41	9	0	2697
27168	2641	53	13	4	0	2711
27169	2597	43	8	5	0	2653
27170	94	8	4	2556	0	2662
27171	2599	3	2	57	0	2661
27172	58	8	3	2606	0	2675
27173	43	3	3	2627	0	2676
27174	12	6	2520	89	0	2627
27175	5	2520	56	47	0	2628
27176	13	51	39	2532	0	2635
27177	14	41	8	2502	0	2565
27178	11	7	2	2538	0	2558
27179	8	2	2445	94	0	2549
27180	2	2421	62	48	0	2533
27181	12	57	38	2437	0	2544
27182	14	39	7	2502	0	2562
27183	13	13	2468	92	0	2586
27184	11	8	54	2463	0	2536
27185	2449	4	41	68	0	2562
27186	54	2469	11	52	0	2586
27187	2473	59	0	18	0	2550
27188	71	43	2420	7	0	2541
27189	55	12	55	2419	0	2541
27190	2507	8	43	67	0	2625
27191	2517	8	14	54	0	2593
27192	99	11	2443	21	0	2574
27193	59	13	58	2389	0	2519
27194	25	9	2347	52	0	2433
27195	2116	7	103	46	0	2272
27196	54	2301	49	23	0	2427
27197	2271	55	15	15	0	2356
27198	2269	40	16	14	0	2339
27199	93	2302	18	11	0	2424
27200	2274	49	7	17	0	2347
27201	64	35	2225	10	0	2334
27202	2224	9	50	18	0	2301
27203	62	12	46	2243	0	2363
27204	58	8	2243	67	0	2376
27205	26	12	58	2266	0	2362
27206	21	18	43	2250	0	2332
27207	36	6	12	2261	0	2315
27208	13	2242	23	98	0	2376
27209	2251	54	10	63	0	2378
27210	69	42	8	2237	0	2356
27211	49	2258	23	62	0	2392
27212	22	59	17	2112	0	2210
27213	24	2232	19	62	0	2337
27214	19	60	2208	58	0	2345
27215	14	41	58	2206	0	2319
27216	17	18	48	2279	0	2362
27217	24	15	2222	101	0	2362
27218	1979	23	55	64	0	2121
27219	58	2205	44	40	0	2347
27220	52	48	15	2189	0	2304
27221	26	40	21	2076	0	2163
27222	20	20	18	2056	0	2114
27223	29	2067	23	97	0	2216
27224	2006	62	21	71	0	2160
27225	65	44	2057	33	0	2199
27226	56	20	2066	33	0	2175
27227	24	12	98	2019	0	2153
27228	30	19	47	2105	0	2201
27229	2072	14	18	97	0	2201
27230	64	2082	28	59	0	2233
27231	52	58	18	2076	0	2204
27232	2017	44	23	74	0	2158
27233	86	13	14	1993	0	2106
27234	1986	20	18	70	0	2094
27235	83	12	1894	60	0	2049
27236	67	1918	66	24	0	2075
27237	1964	62	48	27	0	2101
27238	77	45	1946	29	0	2097
27239	1916	18	63	25	0	2022
27240	75	14	1942	30	0	2061
27241	1925	14	56	33	0	2028
27242	65	18	49	1921	0	2053
27243	1967	9	23	71	0	2070
27244	68	16	13	1968	0	2065
27245	55	12	16	1981	0	2064
27246	1937	20	16	98	0	2071
27247	64	1951	19	56	0	2090
27248	57	51	10	1991	0	2109
27249	1997	49	15	72	0	2133
27250	2033	21	12	50	0	2116
27251	94	18	4	1968	0	2084
27252	52	8	18	1968	0	2046
27253	1966	8	12	94	0	2080
27254	62	9	6	1996	0	2073
27255	40	8	10	1909	0	1967
27256	1837	11	11	79	0	1938
27257	54	3	9	1802	0	1868
27258	25	4	1597	52	0	1678
27259	1472	1	38	41	0	1552
27260	48	11	1608	12	0	1679
27261	24	6	1395	10	0	1435
27262	1150	3	23	6	0	1182
27263	15	1170	12	4	0	1201
27264	14	13	15	1083	0	1125
27265	7	6	2	1100	0	1115
27266	4	1	3	1182	0	1190
27267	6	1	0	1262	0	1269
27268	1230	2	3	27	0	1262
27269	1308	1	2	22	0	1333
27270	1327	2	1	9	0	1339
27271	51	3	1404	4	0	1462
27272	18	1	25	1520	0	1564
27273	11	2	15	1586	0	1614
27274	8	1	3	1512	0	1524
27275	3	1492	4	53	0	1552
27276	4	1532	4	24	0	1564
27277	1553	46	3	9	0	1611
27278	33	25	1	1580	0	1639
27279	23	4	3	1690	0	1720
27280	7	3	1	1766	0	1777
27281	5	3	1700	62	0	1770
27282	3	1	1694	36	0	1734
27283	1628	1	57	13	0	1699
27284	1728	2	27	7	0	1764
27285	62	2	2	1695	0	1761
27286	32	1716	9	32	0	1789
27287	11	33	1	1748	0	1793
27288	6	26	5	1746	0	1783
27289	5	4	1677	67	0	1753
27290	1644	2	33	34	0	1713
27291	40	3	30	1777	0	1850
27292	33	4	6	1754	0	1797
27293	1711	4	2	73	0	1790
27294	42	1773	4	41	0	1860
27295	1822	43	1	17	0	1883
27296	49	41	3	1733	0	1826
27297	39	1782	6	51	0	1878
27298	1802	45	4	44	0	1895
27299	50	37	4	1780	0	1871
27300	1773	6	3	53	0	1835
27301	1722	6	5	54	0	1787
27302	1770	1	6	15	0	1792
27303	80	1691	6	15	0	1792
27304	49	1713	9	8	0	1779
27305	12	76	9	1639	0	1736
27306	11	1716	8	48	0	1783
27307	1733	45	7	46	0	1831
27308	53	38	3	1730	0	1824
27309	1763	8	6	53	0	1830
27310	1782	4	9	47	0	1842
27311	97	4	5	1719	0	1825
27312	45	6	8	1800	0	1859
27313	1756	5	5	95	0	1861
27314	1832	11	6	57	0	1906
27315	1922	11	4	26	0	1963
27316	1971	5	4	27	0	2007
27317	2000	13	4	25	0	2042
27318	108	7	3	1922	0	2040
27319	61	12	4	1982	0	2059
27320	22	10	6	2027	0	2065
27321	1951	7	4	103	0	2065
27322	57	7	6	1926	0	1996
27323	60	1902	14	60	0	2036
27324	32	47	5	1961	0	2045
27325	1902	44	9	67	0	2022
27326	1912	13	9	56	0	1990
27327	96	19	1881	25	0	2021
27328	73	29	49	1748	0	1899
27329	22	1882	46	63	0	2013
27330	1900	50	9	58	0	2017
27331	62	1923	14	28	0	2027
27332	62	54	5	1948	0	2069
27333	1998	42	8	78	0	2126
27334	2019	14	8	67	0	2108
27335	114	1977	5	34	0	2130
27336	77	51	6	1953	0	2087
27337	37	54	1909	67	0	2067
27338	1801	17	68	70	0	1956
27339	73	15	1946	31	0	2065
27340	1943	14	50	27	0	2034
27341	1972	12	48	28	0	2060
27342	118	9	7	1939	0	2073
27343	2013	8	4	71	0	2096
27344	2002	17	3	67	0	2089
27345	2043	12	1	38	0	2094
27346	111	21	4	1947	0	2083
27347	1987	10	4	67	0	2068
27348	76	15	6	1971	0	2068
27349	62	16	5	1936	0	2019
27350	30	1985	10	103	0	2128
27351	37	50	0	1932	0	2019
27352	31	2016	7	59	0	2113
27353	1972	48	3	55	0	2078
27354	1975	45	5	25	0	2050
27355	114	12	2	1935	0	2063
27356	72	11	0	1965	0	2048
27357	1933	9	7	98	0	2047
27358	72	12	1880	63	0	2027
27359	1951	8	40	26	0	2025
27360	73	1	41	1904	0	2019
27361	69	14	1825	57	0	1965
27362	1809	4	46	65	0	1924
27363	1886	6	37	26	0	1955
27364	104	10	1860	24	0	1998
27365	1894	6	40	28	0	1968
27366	68	7	1901	24	0	2000
27367	60	1806	51	20	0	1937
27368	1786	32	42	18	0	1878
27369	1758	33	9	19	0	1819
27370	94	1698	12	13	0	1817
27371	51	1631	5	19	0	1706
27372	1448	45	24	14	0	1531
27373	1464	39	2	5	0	1510
27374	51	7	4	1490	0	1552
27375	37	8	1474	27	0	1546
27376	12	9	1435	34	0	1490
27377	1439	3	45	6	0	1493
27378	31	7	1485	13	0	1536
27379	1383	22	33	11	0	1449
27380	39	5	22	1347	0	1413
27381	30	3	3	1383	0	1419
27382	9	9	1384	42	0	1444
27383	1387	3	21	29	0	1440
27384	30	0	25	1422	0	1477
27385	29	3	4	1476	0	1512
27386	1461	2	4	47	0	1514
27387	1444	4	1	30	0	1479
27388	1485	2	4	15	0	1506
27389	50	1549	4	8	0	1611
27390	32	17	1462	8	0	1519
27391	1427	18	15	5	0	1465
27392	1505	2	17	2	0	1526
27393	35	1469	7	4	0	1515
27394	1452	12	5	7	0	1476
27395	22	11	3	1430	0	1466
27396	16	5	1472	15	0	1508
27397	1427	7	10	18	0	1462
27398	1495	2	12	9	0	1518
27399	1525	2	2	9	0	1538
27400	1522	3	2	4	0	1531
27401	30	4	0	1513	0	1547
27402	16	2	4	1523	0	1545
27403	1524	0	2	28	0	1554
27404	20	2	3	1543	0	1568
27405	17	0	8	1544	0	1569
27406	11	1529	5	22	0	1567
27407	10	13	1	1580	0	1604
27408	5	12	5	1575	0	1597
27409	12	2	1	1585	0	1600
27410	10	1	2	1571	0	1584
27411	5	1536	5	34	0	1580
27412	9	13	2	1528	0	1552
27413	8	13	4	1488	0	1513
27414	9	5	1435	32	0	1481
27415	3	1	1344	18	0	1366
27416	2	1344	25	3	0	1374
27417	1653	9	13	5	0	1680
27418	18	1691	2	0	0	1711
27419	25	13	2	1787	0	1827
27420	2	28	1851	28	0	1909
27421	2014	0	17	28	0	2059
27422	24	0	25	2088	0	2137
27423	2185	1	4	26	0	2216
27424	2184	3	1	34	0	2222
27425	52	2207	1	5	0	2265
27426	2219	23	3	7	0	2252
27427	27	2227	5	4	0	2263
27428	35	23	1	2281	0	2340
27429	3	2306	5	25	0	2339
27430	2	29	2256	42	0	2329
27431	2	2351	31	5	0	2389
27432	5	42	36	2235	0	2318
27433	2259	32	2	31	0	2324
27434	25	2341	3	36	0	2405
27435	33	24	2	2412	0	2471
27436	5	37	1	2489	0	2532
27437	3	11	2508	76	0	2598
27438	10	2	36	2546	0	2594
27439	5	5	2524	38	0	2572
27440	2366	2	35	47	0	2450
27441	43	5	2637	4	0	2689
27442	44	2631	40	9	0	2724
27443	7	41	40	2607	0	2695
27444	14	45	4	2609	0	2672
27445	8	6	2	2686	0	2702
27446	2625	5	4	86	0	2720
27447	42	10	1	2595	0	2648
27448	49	2655	9	43	0	2756
27449	2619	47	0	49	0	2715
27450	42	2570	7	11	0	2630
27451	47	44	4	2528	0	2623
27452	2515	51	2	45	0	2613
27453	41	2502	4	54	0	2601
27454	46	2567	8	8	0	2629
27455	2555	84	4	9	0	2652
27456	2595	49	5	17	0	2666
27457	87	8	2584	7	0	2686
27458	2646	7	41	8	0	2702
27459	45	9	2725	10	0	2789
27460	59	8	48	2677	0	2792
27461	6	6	2739	57	0	2808
27462	9	6	51	2743	0	2809
27463	9	10	2740	54	0	2813
27464	17	6	47	2647	0	2717
27465	7	8	55	2701	0	2771
27466	2621	9	4	109	0	2743
27467	56	9	2586	71	0	2722
27468	2479	16	50	14	0	2559
27469	55	13	2629	21	0	2718
27470	64	18	2558	17	0	2657
27471	14	10	97	2513	0	2634
27472	2561	11	62	55	0	2689
27473	58	2590	7	57	0	2712
27474	2592	53	6	18	0	2669
27475	2563	56	12	14	0	2645
27476	109	2526	9	19	0	2663
27477	2573	53	15	14	0	2655
27478	55	69	2602	23	0	2749
27479	66	8	59	2587	0	2720
27480	2635	6	60	63	0	2764
27481	48	2671	21	68	0	2808
27482	66	54	11	2748	0	2879
27483	22	56	18	2749	0	2845
27484	14	14	12	2822	0	2862
27485	15	8	21	2817	0	2861
27486	2693	6	12	116	0	2827
27487	2717	8	22	72	0	2819
27488	2818	9	16	32	0	2875
27489	2716	4	11	26	0	2757
27490	116	29	2665	17	0	2827
27491	2643	16	57	17	0	2733
27492	2729	13	61	15	0	2818
27493	111	2729	15	25	0	2880
27494	71	2842	17	14	0	2944
27495	28	107	14	2708	0	2857
27496	18	68	14	2775	0	2875
27497	24	17	2722	101	0	2864
27498	23	2750	57	63	0	2893
27499	25	51	59	2666	0	2801
27500	20	2821	23	56	0	2920
27501	22	49	15	2848	0	2934
27502	21	59	16	2786	0	2882
27503	17	2983	26	103	0	3129
27504	24	48	12	3042	0	3126
27505	23	65	3036	59	0	3183
27506	25	12	2998	71	0	3106
27507	2871	7	107	29	0	3014
27508	3094	9	64	20	0	3187
27509	112	3084	22	21	0	3239
27510	3171	46	11	24	0	3252
27511	70	60	12	3121	0	3263
27512	3135	12	13	59	0	3219
27513	62	3067	20	77	0	3226
27514	79	57	3012	21	0	3169
27515	2879	59	69	25	0	3032
27516	69	22	3323	23	0	3437
27517	61	14	2904	12	0	2991
27518	12	15	2934	18	0	2979
27519	12	2871	83	18	0	2984
27520	2725	51	102	16	0	2894
27521	2617	37	13	17	0	2684
27522	80	8	17	2583	0	2688
27523	54	5	8	2602	0	2669
27524	13	2639	13	79	0	2744
27525	2627	36	5	50	0	2718
27526	41	2735	12	18	0	2806
27527	48	2720	12	17	0	2797
27528	2692	59	6	15	0	2772
27529	42	33	16	2668	0	2759
27530	41	6	10	2774	0	2831
27531	16	7	9	2795	0	2827
27532	16	2760	6	59	0	2841
27533	2733	31	4	32	0	2800
27534	40	36	3	2691	0	2770
27535	36	2598	7	30	0	2671
27536	12	2536	7	35	0	2590
27537	11	36	8	2454	0	2509
27538	10	2495	10	19	0	2534
27539	9	19	8	2506	0	2542
27540	2437	30	5	25	0	2497
27541	17	11	2351	32	0	2411
27542	26	2417	18	8	0	2469
27543	10	21	22	2505	0	2558
27544	12	24	2545	23	0	2604
27545	2385	7	17	27	0	2436
27546	21	5	25	2626	0	2677
27547	2609	6	5	25	0	2645
27548	2560	5	3	29	0	2597
27549	39	2784	9	5	0	2837
27550	2896	18	3	11	0	2928
27551	2884	24	0	15	0	2923
27552	2985	3	2	14	0	3004
27553	42	7	2	2936	0	2987
27554	30	10	3	2915	0	2958
27555	13	7	2	2965	0	2987
27556	9	13	2929	40	0	2991
27557	8	2933	18	25	0	2984
27558	2849	8	17	11	0	2885
27559	9	2877	4	6	0	2896
27560	17	15	1	2887	0	2920
27561	11	14	2856	11	0	2892
27562	2402	8	8	23	0	2441
27563	11	2902	11	8	0	2932
27564	13	10	1	2890	0	2914
27565	8	10	4	2880	0	2902
27566	9	10	2845	20	0	2884
27567	4	2850	7	14	0	2875
27568	6	11	12	2854	0	2883
27569	9	8	4	2875	0	2896
27570	6	6	5	2885	0	2902
27571	2717	4	5	27	0	2753
27572	14	12	2798	16	0	2840
27573	14	2813	14	6	0	2847
27574	2789	6	12	10	0	2817
27575	10	2865	7	9	0	2891
27576	20	8	3	2836	0	2867
27577	4	2868	8	10	0	2890
27578	2739	10	2	11	0	2762
27579	2750	10	2	15	0	2777
27580	21	16	3	2958	0	2998
27581	12	8	2	3066	0	3088
27582	9	4	3	3150	0	3166
27583	9	14	3081	49	0	3153
27584	6	3133	29	35	0	3203
27585	8	27	22	3931	0	3988
27586	8	22	9	4030	0	4069
27587	3	12	4	4269	0	4288
27588	12	7	4	4180	0	4203
27589	7	10	4071	130	0	4218
27590	6	4078	72	81	0	4237
27591	8	68	60	4208	0	4344
27592	10	75	14	4444	0	4543
27593	23	30	4311	154	0	4518
27594	13	9	84	4097	0	4203
27595	10	4154	82	100	0	4346
27596	10	4359	26	89	0	4484
27597	15	158	10	4264	0	4447
27598	13	93	4168	97	0	4371
27599	3685	32	75	105	0	3897
27600	77	4069	75	44	0	4265
27601	73	90	4048	39	0	4250
27602	17	83	4175	28	0	4303
27603	12	3965	152	32	0	4161
27604	21	97	4110	23	0	4251
27605	11	85	101	3914	0	4111
27606	3884	18	92	99	0	4093
27607	4010	16	34	85	0	4145
27608	4057	26	19	31	0	4133
27609	4120	17	13	31	0	4181
27610	176	4110	17	28	0	4331
27611	4163	90	18	23	0	4294
27612	105	4261	25	22	0	4413
27613	101	112	4214	21	0	4448
27614	42	90	99	3989	0	4220
27615	19	4290	97	109	0	4515
27616	21	105	33	4118	0	4277
27617	4062	99	25	129	0	4315
27618	103	34	20	3924	0	4081
27619	93	4126	17	131	0	4367
27620	4131	107	14	119	0	4371
27621	120	88	4127	51	0	4386
27622	109	33	117	4116	0	4375
27623	35	26	91	4164	0	4316
27624	4023	35	30	192	0	4280
27625	106	4038	33	132	0	4309
27626	99	112	3979	58	0	4248
27627	33	106	111	3998	0	4248
27628	27	45	4027	123	0	4222
27629	24	3814	118	129	0	4085
27630	15	3965	110	50	0	4140
27631	3865	174	36	62	0	4137
27632	112	118	3854	50	0	4134
27633	3849	46	137	35	0	4067
27634	122	46	107	3601	0	3876
27635	104	3831	54	123	0	4112
27636	3819	113	50	123	0	4105
27637	115	111	3839	63	0	4128
27638	118	46	121	3774	0	4059
27639	52	44	106	3845	0	4047
27640	61	65	37	3708	0	3871
27641	45	3769	52	209	0	4075
27642	3639	131	30	132	0	3932
27643	129	3617	39	47	0	3832
27644	105	3674	39	34	0	3852
27645	47	199	36	3616	0	3898
27646	3584	107	38	138	0	3867
27647	3593	49	42	124	0	3808
27648	3650	48	38	75	0	3811
27649	217	3281	42	53	0	3593
27650	135	135	32	3270	0	3572
27651	74	114	3275	142	0	3605
27652	75	42	124	3262	0	3503
27653	53	59	105	3081	0	3298
27654	47	3235	43	225	0	3550
27655	3258	131	44	145	0	3578
27656	135	119	42	3079	0	3375
27657	109	3211	40	158	0	3518
27658	3214	140	46	136	0	3536
27659	141	143	3153	74	0	3511
27660	3201	61	134	58	0	3454
27661	169	3188	113	69	0	3539
27662	3330	135	52	54	0	3571
27663	3309	131	36	56	0	3532
27664	216	83	3194	50	0	3543
27665	3296	54	127	49	0	3526
27666	158	49	3350	51	0	3608
27667	136	54	3372	45	0	3607
27668	3269	45	204	56	0	3574
27669	3370	61	125	48	0	3604
27670	223	61	3298	48	0	3630
27671	148	33	155	3211	0	3547
27672	74	56	114	3061	0	3305
27673	64	3313	54	196	0	3627
27674	3283	119	52	131	0	3585
27675	3398	126	35	58	0	3617
27676	246	58	3319	46	0	3669
27677	3420	60	111	49	0	3640
27678	3443	50	102	41	0	3636
27679	217	3346	63	52	0	3678
27680	148	116	38	3096	0	3398
27681	85	98	33	2996	0	3212
27682	62	48	34	2986	0	3130
27683	2819	42	26	185	0	3072
27684	110	2787	29	129	0	3055
27685	67	84	15	1872	0	2038
27686	36	1978	21	63	0	2098
27687	49	69	10	1654	0	1782
27688	20	1764	11	43	0	1838
27689	25	1789	7	41	0	1862
27690	1676	54	15	30	0	1775
27691	1642	32	17	16	0	1707
27692	47	2	5	1430	0	1484
27693	24	6	8	1430	0	1468
27694	10	2	9	1451	0	1472
27695	14	9	6	1447	0	1476
27696	11	9	3	1431	0	1454
27697	11	1393	3	41	0	1448
27698	11	25	6	1420	0	1462
27699	9	21	4	1443	0	1477
27700	1393	2	6	44	0	1445
27701	32	6	4	1426	0	1468
27702	34	7	1	1467	0	1509
27703	11	10	1454	43	0	1518
27704	11	6	22	1429	0	1468
27705	11	2	19	1459	0	1491
27706	16	8	1456	49	0	1529
27707	9	1369	20	24	0	1422
27708	2	19	1291	8	0	1320
27709	7	18	1235	9	0	1269
27710	6	1157	23	2	0	1188
27711	1058	8	47	4	0	1117
27712	1027	6	0	1	0	1034
27713	9	3	1	963	0	976
27714	1003	1	1	3	0	1008
27715	6	3	1051	6	0	1066
27716	7	0	6	1053	0	1066
27717	2	5	1249	7	0	1263
27718	6	0	7	1240	0	1253
27719	10	1	7	1265	0	1283
27720	1	2	1	1276	0	1280
27721	1248	0	1	21	0	1270
27722	7	3	1	1293	0	1304
27723	1268	0	1	16	0	1285
27724	1288	3	2	14	0	1307
27725	21	1316	0	8	0	1345
27726	1304	14	0	11	0	1329
27727	15	1375	3	3	0	1396
27728	11	15	2	1342	0	1370
27729	6	10	1	1372	0	1389
27730	5	4	1	1389	0	1399
27731	4	3	1340	27	0	1374
27732	3	1345	17	15	0	1380
27733	3	14	13	1282	0	1312
27734	3	13	1	1274	0	1291
27735	1	1374	2	23	0	1400
27736	1370	13	2	16	0	1401
27737	13	1374	3	6	0	1396
27738	1344	17	2	5	0	1368
27739	13	1421	4	8	0	1446
27740	15	14	0	1357	0	1386
27741	6	1458	5	11	0	1480
27742	1445	15	1	20	0	1481
27743	1465	15	1	9	0	1490
27744	1476	5	5	5	0	1491
27745	1476	4	2	7	0	1489
27746	26	10	1483	7	0	1526
27747	1458	1	16	7	0	1482
27748	1548	4	12	13	0	1577
27749	1548	2	6	16	0	1572
27750	33	6	1521	6	0	1566
27751	1475	5	14	11	0	1505
27752	21	1524	12	7	0	1564
27753	1543	16	4	10	0	1573
27754	19	16	1795	13	0	1843
27755	1792	3	13	12	0	1820
27756	1839	3	13	13	0	1868
27757	26	1	4	1847	0	1878
27758	16	8	1810	21	0	1855
27759	1834	2	29	27	0	1892
27760	19	2	15	1887	0	1923
27761	22	6	6	1956	0	1990
27762	12	8	1968	32	0	2020
27763	1777	5	15	23	0	1820
27764	1969	2	13	13	0	1997
27765	25	2001	9	7	0	2042
27766	24	18	1	1958	0	2001
27767	10	13	3	1958	0	1984
27768	9	7	2	1946	0	1964
27769	10	2000	5	27	0	2042
27770	1985	15	2	24	0	2026
27771	21	14	3	1996	0	2034
27772	20	5	10	2004	0	2039
27773	1906	4	1	31	0	1942
27774	1870	0	5	19	0	1894
27775	31	3	6	1923	0	1963
27776	21	4	4	1932	0	1961
27777	14	7	1884	31	0	1936
27778	1719	3	15	18	0	1755
27779	23	1914	16	7	0	1960
27780	20	19	4	2046	0	2089
27781	9	14	4	2067	0	2094
27782	8	2161	3	36	0	2208
27783	6	23	5	2214	0	2248
27784	2487	24	6	32	0	2549
27785	54	3	2	2736	0	2795
27786	39	4	1	2782	0	2826
27787	18	2	3	2832	0	2855
27788	9	8	2720	106	0	2843
27789	10	2	52	2781	0	2845
27790	13	5	2806	77	0	2901
27791	6	2765	70	54	0	2895
27792	10	48	41	2733	0	2832
27793	4	43	17	2745	0	2809
27794	5	9	3	2810	0	2827
27795	3	9	4	2793	0	2809
27796	9	2	2	2882	0	2895
27797	2696	3	7	114	0	2820
27798	58	10	2748	66	0	2882
27799	47	2693	52	23	0	2815
27800	17	2847	49	13	0	2926
27801	8	95	13	2815	0	2931
27802	9	51	3	2893	0	2956
27803	10	16	6	2874	0	2906
27804	6	2833	5	109	0	2953
27805	6	57	5	2892	0	2960
27806	4	50	2780	77	0	2911
27807	6	2809	54	57	0	2926
27808	5	61	44	2840	0	2950
27809	2819	46	10	73	0	2948
27810	61	11	4	2874	0	2950
27811	42	10	4	2851	0	2907
27812	11	2770	9	106	0	2896
27813	9	2950	8	64	0	3031
27814	10	108	8	2883	0	3009
27815	6	54	1	2929	0	2990
27816	6	20	2846	118	0	2990
27817	4	7	52	2715	0	2778
27818	8	6	57	2720	0	2791
27819	6	9	15	2694	0	2724
27820	4	6	7	2773	0	2790
27821	2637	5	6	113	0	2761
27822	2640	7	3	75	0	2725
27823	93	7	6	2676	0	2782
27824	55	7	5	2732	0	2799
27825	2647	6	3	123	0	2779
27826	57	4	8	2853	0	2922
27827	55	14	2832	91	0	2992
27828	20	2860	66	74	0	3020
27829	14	63	57	2915	0	3049
27830	6	53	15	3009	0	3083
27831	2909	17	15	128	0	3069
27832	59	16	7	2981	0	3063
27833	57	10	6	3037	0	3110
27834	2950	10	9	136	0	3105
27835	60	13	12	3029	0	3114
27836	51	3010	11	102	0	3174
27837	23	65	6	3181	0	3275
27838	17	56	7	3248	0	3328
27839	14	17	14	3233	0	3278
27840	12	17	7	3293	0	3329
27841	15	23	3093	158	0	3289
27842	11	24	3106	106	0	3247
27843	13	17	113	3128	0	3271
27844	10	9	67	3115	0	3201
27845	6	3112	31	150	0	3299
27846	9	73	12	3069	0	3163
27847	8	3127	19	99	0	3253
27848	3008	89	6	96	0	3199
27849	71	3205	14	51	0	3341
27850	72	82	6	3353	0	3513
27851	25	68	5	3443	0	3541
27852	14	30	3322	151	0	3517
27853	3086	14	74	104	0	3278
27854	3089	20	58	53	0	3220
27855	128	3048	23	49	0	3248
27856	76	75	13	2974	0	3138
27857	25	69	3105	90	0	3289
27858	11	3165	73	99	0	3348
27859	3075	73	64	53	0	3265
27860	3114	63	21	45	0	3243
27861	135	23	2958	52	0	3168
27862	2990	9	70	52	0	3121
27863	96	13	62	2970	0	3141
27864	73	2987	24	96	0	3180
27865	2971	76	11	99	0	3157
27866	90	64	7	2996	0	3157
27867	3078	21	7	112	0	3218
27868	3130	12	11	104	0	3257
27869	134	15	12	3049	0	3210
27870	79	23	3063	106	0	3271
27871	3024	10	74	107	0	3215
27872	3143	11	65	48	0	3267
27873	3181	14	21	60	0	3276
27874	144	3203	20	51	0	3418
27875	94	80	10	3184	0	3368
27876	33	76	6	3436	0	3551
27877	30	36	3326	165	0	3557
27878	29	19	73	3262	0	3383
27879	12	3244	79	140	0	3475
27880	3135	68	17	99	0	3319
27881	75	3204	13	52	0	3344
27882	74	79	3110	30	0	3293
27883	35	3192	83	26	0	3336
27884	16	2910	60	30	0	3016
27885	22	80	20	2649	0	2771
27886	2654	45	7	48	0	2754
27887	2662	13	2	48	0	2725
27888	2646	4	4	24	0	2678
27889	82	2679	16	10	0	2787
27890	51	47	2582	9	0	2689
27891	2577	36	37	21	0	2671
27892	2677	12	33	16	0	2738
27893	71	2645	11	17	0	2744
27894	2711	41	10	17	0	2779
27895	55	40	7	2686	0	2788
27896	45	17	2885	51	0	2998
27897	2845	10	39	53	0	2947
27898	2923	3	40	27	0	2993
27899	3052	10	15	19	0	3096
27900	89	9	9	2955	0	3062
27901	59	12	5	3030	0	3106
27902	21	9	4	3118	0	3152
27903	11	3044	11	100	0	3166
27904	18	52	7	3074	0	3151
27905	14	50	8	3455	0	3527
27906	17	17	3448	112	0	3594
27907	21	11	64	3448	0	3544
27908	16	8	60	3543	0	3627
27909	25	7	8	3561	0	3601
27910	19	11	6	3550	0	3586
27911	12	3529	16	139	0	3696
27912	18	73	5	3606	0	3702
27913	19	67	6	3635	0	3727
27914	3574	13	7	140	0	3734
27915	87	13	3572	81	0	3753
27916	91	19	3533	20	0	3663
27917	3474	4	137	29	0	3644
27918	3617	8	112	20	0	3757
27919	151	12	19	3120	0	3302
27920	86	3551	13	64	0	3714
27921	3567	74	5	80	0	3726
27922	87	69	8	3483	0	3647
27923	73	3624	17	78	0	3792
27924	3650	69	10	84	0	3813
27925	74	3743	9	27	0	3853
27926	3622	68	5	17	0	3712
27927	3503	68	6	27	0	3604
27928	126	3402	16	18	0	3562
27929	93	70	5	3376	0	3544
27930	24	80	3324	85	0	3513
27931	17	12	68	3403	0	3500
27932	3334	12	64	89	0	3499
27933	71	21	3316	77	0	3485
27934	78	3383	68	39	0	3568
27935	27	68	61	3379	0	3535
27936	20	75	3349	69	0	3513
27937	11	3270	68	75	0	3424
27938	3233	64	81	43	0	3421
27939	63	59	10	3244	0	3376
27940	72	11	10	3256	0	3349
27941	17	9	10	3210	0	3246
27942	15	3212	18	114	0	3359
27943	3208	53	7	72	0	3340
27944	57	3247	12	29	0	3345
27945	64	3237	12	33	0	3346
27946	3230	108	10	14	0	3362
27947	3251	64	6	18	0	3339
27948	113	27	3166	20	0	3326
27949	3101	15	52	18	0	3186
27950	2975	13	60	21	0	3069
27951	117	8	10	2908	0	3043
27952	80	18	2858	61	0	3017
27953	24	11	54	2911	0	3000
27954	2868	14	54	72	0	3008
27955	65	14	2967	61	0	3107
27956	69	7	64	3227	0	3367
27957	25	16	60	3526	0	3627
27958	25	10	16	3779	0	3830
27959	3627	12	10	179	0	3828
27960	111	3620	15	111	0	3857
27961	3725	102	9	31	0	3867
27962	120	93	3633	17	0	3863
27963	100	20	98	3492	0	3710
27964	28	3715	96	107	0	3946
27965	3727	107	22	98	0	3954
27966	119	92	5	3733	0	3949
27967	96	29	3694	123	0	3942
27968	27	10	103	3743	0	3883
27969	3593	17	81	129	0	3820
27970	101	3623	26	109	0	3859
27971	90	114	13	3214	0	3431
27972	29	3629	24	81	0	3763
27973	3536	107	9	84	0	3736
27974	3563	83	16	23	0	3685
27975	175	3559	19	27	0	3780
27976	3517	92	9	22	0	3640
27977	108	78	10	3332	0	3528
27978	86	3513	10	99	0	3708
27979	3508	96	8	85	0	3697
27980	3569	78	11	19	0	3677
27981	172	3430	14	16	0	3632
27982	95	3435	13	18	0	3561
27983	3371	169	5	17	0	3562
27984	112	84	8	3350	0	3554
27985	3409	14	6	110	0	3539
27986	111	17	8	3395	0	3531
27987	94	21	3276	107	0	3498
27988	30	14	96	3359	0	3499
27989	3250	15	70	119	0	3454
27990	113	14	3240	79	0	3446
27991	90	12	100	3261	0	3463
27992	31	12	73	3370	0	3486
27993	24	12	3270	170	0	3476
27994	3114	14	92	95	0	3315
27995	105	12	75	3214	0	3406
27996	83	19	2956	107	0	3165
27997	2725	6	91	87	0	2909
27998	95	2853	78	56	0	3082
27999	75	2853	23	23	0	2974
28000	18	2952	20	18	0	3008
28001	18	151	2717	23	0	2909
28002	33	80	83	2663	0	2859
28003	19	24	2812	93	0	2948
28004	19	21	75	2477	0	2592
28005	10	2355	57	82	0	2504
28006	14	2398	14	70	0	2496
28007	16	143	8	2313	0	2480
28008	2279	49	7	92	0	2427
28009	74	10	9	2313	0	2406
28010	53	16	7	2253	0	2329
28011	22	2229	12	116	0	2379
28012	2200	71	9	51	0	2331
28013	69	2261	15	24	0	2369
28014	58	67	13	2176	0	2314
28015	25	46	6	2196	0	2273
28016	16	2203	22	107	0	2348
28017	22	69	10	2271	0	2372
28018	2231	52	3	86	0	2372
28019	86	29	12	2241	0	2368
28020	63	17	10	2240	0	2330
28021	37	2197	19	102	0	2355
28022	22	74	14	2252	0	2362
28023	2102	57	4	77	0	2240
28024	2098	32	10	59	0	2199
28025	2123	25	11	31	0	2190
28026	134	17	11	2071	0	2233
28027	65	17	1985	89	0	2156
28028	30	24	2041	62	0	2157
28029	27	25	103	2040	0	2195
28030	2050	19	53	86	0	2208
28031	81	27	12	2088	0	2208
28032	2158	23	7	82	0	2270
28033	92	10	16	2213	0	2331
28034	65	26	12	2162	0	2265
28035	2110	24	4	117	0	2255
28036	82	25	2074	67	0	2248
28037	2110	18	66	30	0	2224
28038	89	19	2109	34	0	2251
28039	71	12	76	2088	0	2247
28040	2086	24	48	84	0	2242
28041	87	28	2121	51	0	2287
28042	62	23	2113	28	0	2226
28043	2012	22	107	22	0	2163
28044	81	17	2115	29	0	2242
28045	56	2058	71	34	0	2219
28046	24	63	54	2143	0	2284
28047	2303	47	20	106	0	2476
28048	84	24	2396	65	0	2569
28049	2437	17	73	32	0	2559
28050	2490	14	54	27	0	2585
28051	2527	22	11	27	0	2587
28052	2541	16	17	47	0	2621
28053	119	26	20	2402	0	2567
28054	61	2438	19	76	0	2594
28055	2351	53	27	67	0	2498
28056	55	38	2008	24	0	2125
28057	18	1500	19	13	0	1550
28058	1347	7	11	7	0	1372
28059	12	1302	3	7	0	1324
28060	9	1347	6	33	0	1395
28061	46	20	19	1337	0	1422
28062	6	9	0	1369	0	1384
28063	2	5	1	1380	0	1388
28064	1391	1	0	23	0	1415
28065	1472	1	0	17	0	1490
28066	28	5	1	1491	0	1525
28067	18	0	2	1582	0	1602
28068	6	4	1675	35	0	1720
28069	1580	1	28	26	0	1635
28070	1722	1	26	7	0	1756
28071	54	5	2	1687	0	1748
28072	28	1	1	1731	0	1761
28073	7	5	1692	57	0	1761
28074	7	0	32	1707	0	1746
28075	4	4	1719	37	0	1764
28076	1	1651	34	31	0	1717
28077	3	31	1688	5	0	1727
28078	2	25	34	1641	0	1702
28079	0	7	1732	36	0	1775
28080	5	1	1741	29	0	1776
28081	1767	0	58	9	0	1834
28082	40	0	29	1947	0	2016
28083	36	5	1942	41	0	2024
28084	1784	0	35	45	0	1864
28085	46	3	1965	5	0	2019
28086	36	2	2125	15	0	2178
28087	8	2103	75	4	0	2190
28088	25	36	38	2074	0	2173
28089	4	37	2092	45	0	2178
28090	9	8	2112	37	0	2166
28091	4	1	73	2063	0	2141
28092	4	0	44	2032	0	2080
28093	8	2081	9	65	0	2163
28094	6	38	9	2110	0	2163
28095	2132	35	4	38	0	2209
28096	2146	6	2	38	0	2192
28097	2200	1	5	8	0	2214
28098	72	2	10	2133	0	2217
28099	44	2274	1	42	0	2361
28100	2266	38	6	40	0	2350
28101	41	2286	3	10	0	2340
28102	35	2258	4	4	0	2301
28103	7	2243	7	6	0	2263
28104	2206	59	6	6	0	2277
28105	41	34	6	2177	0	2258
28106	41	4	3	2152	0	2200
28107	6	2187	10	69	0	2272
28108	2155	34	7	34	0	2230
28109	41	33	2178	9	0	2261
28110	32	4	40	2195	0	2271
28111	2192	5	34	41	0	2272
28112	39	2257	8	38	0	2342
28113	2422	37	7	21	0	2487
28114	46	33	7	2542	0	2628
28115	38	2605	13	45	0	2701
28116	12	40	2527	41	0	2620
28117	2457	35	43	13	0	2548
28118	40	7	35	2604	0	2686
28119	2646	5	10	47	0	2708
28120	49	6	10	2625	0	2690
28121	40	2583	17	46	0	2686
28122	12	41	2638	41	0	2732
28123	18	36	2620	12	0	2686
28124	4	21	73	2647	0	2745
28125	2694	7	38	46	0	2785
28126	2701	7	7	42	0	2757
28127	70	6	12	2660	0	2748
28128	39	3	9	2728	0	2779
28129	2725	5	8	69	0	2807
28130	46	3	8	2785	0	2842
28131	2770	8	9	46	0	2833
28132	36	2654	14	40	0	2744
28133	2606	42	12	9	0	2669
28134	45	38	2637	10	0	2730
28135	41	7	46	2624	0	2718
28136	13	6	41	2629	0	2689
28137	13	8	11	2633	0	2665
28138	13	2560	12	76	0	2661
28139	10	2438	15	47	0	2510
28140	7	74	15	2577	0	2673
28141	11	48	2508	60	0	2627
28142	12	6	47	2519	0	2584
28143	13	8	39	2572	0	2632
28144	11	2522	13	96	0	2642
28145	2517	46	14	46	0	2623
28146	46	2472	15	36	0	2569
28147	45	2511	15	10	0	2581
28148	10	71	10	2366	0	2457
28149	19	40	7	2450	0	2516
28150	18	10	12	2523	0	2563
28151	19	6	8	2552	0	2585
28152	2407	8	8	88	0	2511
28153	43	2475	19	40	0	2577
28154	2549	49	11	11	0	2620
28155	2621	35	11	20	0	2687
28156	81	7	10	2583	0	2681
28157	47	11	7	2652	0	2717
28158	2592	5	7	79	0	2683
28159	2599	6	7	52	0	2664
28160	74	7	5	2548	0	2634
28161	51	7	4	2566	0	2628
28162	15	15	2531	76	0	2637
28163	21	2516	74	38	0	2649
28164	14	2719	35	14	0	2782
28165	2568	52	3	14	0	2637
28166	29	31	2794	17	0	2871
28167	27	12	2609	10	0	2658
28168	2302	8	30	13	0	2353
28169	2554	4	13	10	0	2581
28170	26	2952	10	6	0	2994
28171	15	3145	5	8	0	3173
28172	7	38	2	3185	0	3232
28173	3368	16	3	33	0	3420
28174	3403	4	4	29	0	3440
28175	3473	7	3	10	0	3493
28176	36	4	3	3453	0	3496
28177	23	7	4	3494	0	3528
28178	5	8	3476	33	0	3522
28179	5	5	3317	26	0	3353
28180	7	10	3451	6	0	3474
28181	11	34	24	3374	0	3443
28182	3324	3	5	24	0	3356
28183	14	7	3451	8	0	3480
28184	9	0	11	3403	0	3423
28185	3	3529	10	18	0	3560
28186	2	15	3	3535	0	3555
28187	6	7	0	3551	0	3564
28188	7	3	3628	32	0	3670
28189	2	2	19	3597	0	3620
28190	3684	1	12	28	0	3725
28191	29	12	3897	17	0	3955
28192	23	4	23	3882	0	3932
28193	7	9	4008	33	0	4057
28194	8	4027	33	24	0	4092
28195	12	31	4022	11	0	4076
28196	5	21	33	3777	0	3836
28197	4	6	23	3994	0	4027
28198	7	10	4095	57	0	4169
28199	4	3	32	4008	0	4047
28200	7	4	21	3977	0	4009
28201	9	4024	14	47	0	4094
28202	8	35	4094	31	0	4168
28203	10	26	31	4094	0	4161
28204	7	5	27	4190	0	4229
28205	2	4199	13	66	0	4280
28206	7	37	4	4267	0	4315
28207	4270	29	2	55	0	4356
28208	44	5	4	4289	0	4342
28209	32	11	4375	48	0	4466
28210	4154	1	42	46	0	4243
28211	4574	2	39	16	0	4631
28212	89	11	4640	12	0	4752
28213	4304	4	52	20	0	4380
28214	59	4481	48	9	0	4597
28215	50	45	14	4581	0	4690
28216	15	39	12	5227	0	5293
28217	14	9	7	5204	0	5234
28218	13	7	7	5303	0	5330
28219	9	3	5	5332	0	5349
28220	5182	4	9	143	0	5338
28221	80	8	5206	78	0	5372
28222	4957	5	76	38	0	5076
28223	82	13	5206	24	0	5325
28224	66	2	82	5128	0	5278
28225	5165	3	65	92	0	5325
28226	82	4	19	5089	0	5194
28227	65	5177	21	90	0	5353
28228	5327	68	16	74	0	5485
28229	91	63	11	5424	0	5589
28230	68	22	5274	89	0	5453
28231	4968	9	72	99	0	5148
28232	82	5693	70	32	0	5877
28233	75	84	5763	29	0	5951
28234	19	66	91	5765	0	5941
28235	42	14	71	5614	0	5741
28236	18	5816	24	140	0	5998
28237	19	89	5823	91	0	6022
28238	15	67	90	5798	0	5970
28239	23	27	6017	138	0	6205
28240	14	20	99	5965	0	6098
28241	22	6	81	6098	0	6207
28242	25	16	6100	172	0	6313
28243	16	13	89	6125	0	6243
28244	33	37	100	5062	0	5232
28245	26	6	33	6620	0	6685
28246	29	8	22	6668	0	6727
28247	6353	5	30	207	0	6595
28248	110	13	6379	125	0	6627
28249	6437	11	100	50	0	6598
28250	112	16	90	6716	0	6934
28251	105	9	25	6858	0	6997
28252	26	7	18	6811	0	6862
28253	19	6726	22	200	0	6967
28254	6778	96	15	132	0	7021
28255	113	91	23	6701	0	6928
28256	99	6821	37	119	0	7076
28257	44	99	19	6913	0	7075
28258	7023	91	21	155	0	7290
28259	7043	19	19	138	0	7219
28260	7107	26	22	55	0	7210
28261	196	7068	34	45	0	7343
28262	113	105	7150	49	0	7417
28263	7031	92	106	60	0	7289
28264	7255	22	103	70	0	7450
28265	181	7350	53	54	0	7638
28266	7246	96	26	61	0	7429
28267	7171	98	22	58	0	7349
28268	7276	28	29	57	0	7390
28269	199	7517	26	64	0	7806
28270	131	96	23	7373	0	7623
28271	7477	94	21	133	0	7725
28272	7629	28	27	121	0	7805
28273	7473	14	22	71	0	7580
28274	7540	14	21	62	0	7637
28275	234	18	15	7435	0	7702
28276	132	41	7373	144	0	7690
28277	56	25	120	7253	0	7454
28278	42	7336	114	177	0	7669
28279	36	107	23	7514	0	7680
28280	43	113	7557	163	0	7876
28281	7360	31	117	136	0	7644
28282	176	20	108	7727	0	8031
28283	7830	19	42	149	0	8040
28284	7891	25	39	147	0	8102
28285	237	20	23	8102	0	8382
28286	142	24	8095	153	0	8414
28287	67	28	7727	131	0	7953
28288	7078	27	218	63	0	7386
28289	160	7893	121	51	0	8225
28290	119	7892	47	55	0	8113
28291	58	8106	23	56	0	8243
28292	52	8330	23	48	0	8453
28293	8001	196	54	43	0	8294
28294	8035	97	39	38	0	8209
28295	8060	20	16	47	0	8143
28296	8142	26	12	55	0	8235
28297	224	24	10	7836	0	8094
28298	148	7925	22	122	0	8217
28299	7900	101	22	115	0	8138
28300	156	116	7996	37	0	8305
28301	118	7972	113	50	0	8253
28302	53	112	8003	68	0	8236
28303	7597	91	111	43	0	7842
28304	7995	28	86	48	0	8157
28305	8075	26	27	54	0	8182
28306	228	26	15	8024	0	8293
28307	135	29	8204	124	0	8492
28308	71	8197	109	112	0	8489
28309	7872	90	90	49	0	8101
28310	127	8105	32	43	0	8307
28311	112	7906	25	45	0	8088
28312	61	8067	17	31	0	8176
28313	49	8088	25	34	0	8196
28314	71	176	7599	33	0	7879
28315	38	7923	93	47	0	8101
28316	7258	83	52	26	0	7419
28317	94	68	9	7333	0	7504
28318	92	23	9	7495	0	7619
28319	7445	19	12	123	0	7599
28320	99	7483	21	68	0	7671
28321	95	81	7773	32	0	7981
28322	49	65	65	7731	0	7910
28323	46	27	52	7997	0	8122
28324	52	22	18	8094	0	8186
28325	43	42	7922	118	0	8125
28326	34	41	7967	62	0	8104
28327	55	17	112	7891	0	8075
28328	56	29	7954	64	0	8103
28329	44	27	7607	56	0	7734
28330	5928	25	127	52	0	6132
28331	75	7623	65	74	0	7837
28332	66	7533	27	25	0	7651
28333	47	7927	31	24	0	8029
28334	47	101	17	7447	0	7612
28335	28	7974	33	48	0	8083
28336	7969	59	19	55	0	8102
28337	75	70	8262	34	0	8441
28338	8125	23	61	25	0	8234
28339	82	20	63	8423	0	8588
28340	71	18	21	8381	0	8491
28341	28	8738	29	114	0	8909
28342	8623	68	19	83	0	8793
28343	8580	75	24	29	0	8708
28344	157	9299	23	24	0	9503
28345	78	90	15	8983	0	9166
28346	29	84	9167	91	0	9371
28347	22	31	9164	77	0	9294
28348	25	9273	156	30	0	9484
28349	9398	89	79	28	0	9594
28350	117	84	9543	12	0	9756
28351	82	19	110	9216	0	9427
28352	9497	15	85	117	0	9714
28353	9661	13	25	77	0	9776
28354	197	12084	30	15	0	12326
28355	97	12369	28	19	0	12513
28356	12269	290	14	29	0	12602
28357	187	151	12251	14	0	12603
28358	12011	27	172	71	0	12281
28359	12419	23	128	16	0	12586
28360	317	14	20	12303	0	12654
28361	147	31	12600	183	0	12961
28362	36	38	12385	129	0	12588
28363	11533	10	324	37	0	11904
28364	213	26	12469	22	0	12730
28365	11461	22	204	27	0	11714
28366	12101	17	134	22	0	12274
28367	299	12192	48	37	0	12576
28368	174	197	12172	24	0	12567
28369	36	12045	207	27	0	12315
28370	11663	196	141	19	0	12019
28371	203	153	11705	17	0	12078
28372	157	34	189	11014	0	11394
28373	51	31	11708	177	0	11967
28374	42	28	11647	132	0	11849
28375	57	28	11652	22	0	11759
28376	48	38	11614	30	0	11730
28377	60	11427	319	42	0	11848
28378	68	202	11536	17	0	11823
28379	54	11491	226	37	0	11808
28380	71	205	11189	42	0	11507
28381	10821	145	234	31	0	11231
28382	241	42	181	9852	0	10316
28383	179	11140	77	164	0	11560
28384	11052	186	53	132	0	11423
28385	10973	142	77	46	0	11238
28386	10621	58	71	38	0	10788
28387	10883	36	89	26	0	11034
28388	337	10784	83	21	0	11225
28389	10605	200	54	27	0	10886
28390	10774	158	75	21	0	11028
28391	323	10294	84	86	0	10787
28392	192	220	10208	31	0	10651
28393	104	155	224	9745	0	10228
28394	71	10351	206	173	0	10801
28395	81	225	10426	133	0	10865
28396	101	169	10528	37	0	10835
28397	92	10220	386	51	0	10749
28398	85	10397	231	45	0	10758
28399	87	10775	137	47	0	11046
28400	95	10590	109	34	0	10828
28401	10386	360	108	34	0	10888
28402	10463	217	97	38	0	10815
28403	394	102	10910	35	0	11441
28404	241	96	11168	38	0	11543
28405	138	80	389	10585	0	11192
28406	149	68	227	11031	0	11475
28407	154	84	105	11151	0	11494
28408	10889	92	117	336	0	11434
28409	318	11091	116	188	0	11713
28410	269	11445	109	60	0	11883
28411	153	11841	132	46	0	12172
28412	11410	444	113	46	0	12013
28413	11620	264	115	46	0	12045
28414	496	127	108	11349	0	12080
28415	11658	106	157	245	0	12166
28416	11667	118	146	181	0	12112
28417	503	131	134	11517	0	12285
28418	11656	147	137	281	0	12221
28419	395	11443	203	214	0	12255
28420	335	310	216	11312	0	12173
28421	205	280	11078	249	0	11812
28422	200	10993	399	211	0	11803
28423	195	362	11298	106	0	11961
28424	211	276	396	10260	0	11143
28425	204	11213	364	257	0	12038
28426	219	329	216	11075	0	11839
28427	207	269	228	11294	0	11998
28428	221	136	11237	432	0	12026
28429	202	141	11634	242	0	12219
28430	186	132	555	11237	0	12110
28431	192	134	366	10431	0	11123
28432	169	11404	230	431	0	12234
28433	10656	366	196	223	0	11441
28434	369	11155	229	109	0	11862
28435	313	11301	188	101	0	11903
28436	190	500	10742	111	0	11543
28437	128	10632	393	112	0	11265
28438	179	341	372	9502	0	10394
28439	175	10757	226	277	0	11435
28440	180	343	151	9956	0	10630
28441	130	10532	193	300	0	11155
28442	10253	386	144	219	0	11002
28443	368	10601	158	98	0	11225
28444	301	377	128	8763	0	9569
28445	185	9860	128	244	0	10417
28446	9559	380	174	186	0	10299
28447	9689	290	105	103	0	10187
28448	501	9629	118	118	0	10366
28449	9321	323	54	77	0	9775
28450	370	367	107	8805	0	9649
28451	263	154	9071	278	0	9766
28452	194	145	9065	204	0	9608
28453	158	8928	373	90	0	9549
28454	6121	135	93	65	0	6414
28455	6152	107	45	51	0	6355
28456	189	67	6082	49	0	6387
28457	119	40	6008	45	0	6212
28458	5497	43	186	50	0	5776
28459	5883	52	103	42	0	6080
28460	187	41	5783	47	0	6058
28461	5112	55	121	52	0	5340
28462	124	5478	95	53	0	5750
28463	88	5674	48	46	0	5856
28464	35	211	38	5457	0	5741
28465	26	121	44	5603	0	5794
28466	5563	57	41	191	0	5852
28467	5520	63	29	110	0	5722
28468	5560	56	36	61	0	5713
28469	196	68	22	5469	0	5755
28470	119	54	27	5385	0	5585
28471	56	5282	38	180	0	5556
28472	43	5461	37	115	0	5656
28473	46	5621	34	52	0	5753
28474	59	246	26	4968	0	5299
28475	54	5360	32	118	0	5564
28476	48	175	5116	96	0	5435
28477	4553	137	116	47	0	4853
28478	154	85	5168	38	0	5445
28479	127	74	5125	35	0	5361
28480	4691	65	186	48	0	4990
28481	142	5074	112	36	0	5364
28482	5142	140	37	51	0	5370
28483	5084	125	29	40	0	5278
28484	216	62	4923	43	0	5244
28485	139	59	5108	38	0	5344
28486	74	5065	189	50	0	5378
28487	65	149	5100	42	0	5356
28488	81	109	158	4857	0	5205
28489	72	69	117	4184	0	4442
28490	67	4978	65	174	0	5284
28491	90	5146	55	93	0	5384
28492	5045	215	46	54	0	5360
28493	5208	129	56	52	0	5445
28494	223	69	50	5111	0	5453
28495	157	68	45	5245	0	5515
28496	5122	53	51	197	0	5423
28497	5169	52	46	115	0	5382
28498	217	5173	51	53	0	5494
28499	4865	154	34	41	0	5094
28500	172	4744	36	45	0	4997
28501	115	4819	29	46	0	5009
28502	4748	189	62	35	0	5034
28503	4714	98	34	39	0	4885
28504	204	67	61	4342	0	4674
28505	4295	58	60	102	0	4515
28506	134	51	4150	95	0	4430
28507	103	4212	90	53	0	4458
28508	4105	102	99	43	0	4349
28509	123	94	4108	39	0	4364
28510	100	51	74	3424	0	3649
28511	53	3653	81	68	0	3855
28512	63	3756	33	49	0	3901
28513	3754	119	38	32	0	3943
28514	95	81	3663	18	0	3857
28515	3320	38	68	23	0	3449
28516	118	30	60	3470	0	3678
28517	80	24	3373	50	0	3527
28518	3087	22	72	55	0	3236
28519	82	3376	65	27	0	3550
28520	67	3764	49	18	0	3898
28521	3832	99	31	29	0	3991
28522	3785	60	21	21	0	3887
28523	3776	24	12	29	0	3841
28524	114	61	31	3599	0	3805
28525	84	98	20	3615	0	3817
28526	45	25	3637	80	0	3787
28527	34	24	3575	52	0	3685
28528	37	3580	77	28	0	3722
28529	26	41	36	3265	0	3368
28530	3209	37	13	45	0	3304
28531	45	3218	10	31	0	3304
28532	39	44	9	3255	0	3347
28533	3214	35	7	48	0	3304
28534	54	3216	15	36	0	3321
28535	48	3319	12	18	0	3397
28536	37	68	3149	13	0	3267
28537	3021	59	32	16	0	3128
28538	3166	16	26	15	0	3223
28539	51	16	3160	19	0	3246
28540	2856	7	26	10	0	2899
28541	32	8	3127	6	0	3173
28542	27	3068	32	8	0	3135
28543	21	21	25	3017	0	3084
28544	2951	22	11	24	0	3008
28545	21	2971	9	23	0	3024
28546	25	2903	11	8	0	2947
28547	2623	52	4	28	0	2707
28548	16	25	2837	14	0	2892
28549	2773	4	16	9	0	2802
28550	19	3086	15	14	0	3134
28551	22	14	2845	6	0	2887
28552	2830	16	42	5	0	2893
28553	2960	6	13	6	0	2985
28554	20	5	9	2900	0	2934
28555	23	9	2	2994	0	3028
28556	9	3051	5	24	0	3089
28557	13	13	3069	19	0	3114
28558	9	17	11	3105	0	3142
28559	2	18	3265	17	0	3302
28560	5	13	3270	30	0	3318
28561	6	5	40	3445	0	3496
28562	5	10	3544	21	0	3580
28563	12	8	3454	36	0	3510
28564	12	4	48	3275	0	3339
28565	12	7	3478	28	0	3525
28566	2935	7	30	35	0	3007
28567	26	3416	37	31	0	3510
28568	33	24	3451	6	0	3514
28569	14	33	3837	5	0	3889
28570	6	7	54	3620	0	3687
28571	3983	2	35	30	0	4050
28572	3987	6	9	30	0	4032
28573	4022	5	4	12	0	4043
28574	4093	2	3	10	0	4108
28575	53	3	6	3988	0	4050
28576	37	11	4073	22	0	4143
28577	3992	6	19	43	0	4060
28578	4215	3	33	7	0	4258
28579	4275	1	16	11	0	4303
28580	60	7	4135	7	0	4209
28581	3690	8	28	14	0	3740
28582	33	3	38	4442	0	4516
28583	36	4595	10	30	0	4671
28584	10	30	6	4335	0	4381
28585	3	4484	9	31	0	4527
28586	4377	33	5	37	0	4452
28587	40	42	4526	7	0	4615
28588	44	6	51	4333	0	4434
28589	4	4506	47	43	0	4600
28590	3	4617	13	38	0	4671
28591	4590	77	13	11	0	4691
28592	4609	46	5	7	0	4667
28593	91	14	4392	3	0	4500
28594	4433	2	57	8	0	4500
28595	57	2	44	4492	0	4595
28596	53	10	4719	49	0	4831
28597	18	10	4646	49	0	4723
28598	19	5	89	4695	0	4808
28599	5249	9	48	64	0	5370
28600	59	9	13	5305	0	5386
28601	61	2	11	5289	0	5363
28602	19	3	6	5304	0	5332
28603	17	5534	12	102	0	5665
28604	19	56	6	5640	0	5721
28605	5358	60	10	66	0	5494
28606	57	5598	19	63	0	5737
28607	74	60	7	5674	0	5815
28608	5542	67	5	70	0	5684
28609	71	5622	18	72	0	5783
28610	66	5749	13	8	0	5836
28611	13	134	11	5635	0	5793
28612	5457	72	8	80	0	5617
28613	79	11	5607	73	0	5770
28614	70	14	5573	14	0	5671
28615	5427	7	139	21	0	5594
28616	5874	6	74	18	0	5972
28617	156	6073	22	11	0	6262
28618	81	79	13	5930	0	6103
28619	25	80	6110	88	0	6303
28620	20	14	5785	94	0	5913
28621	12	19	6297	26	0	6354
28622	15	6223	181	15	0	6434
28623	14	6270	99	16	0	6399
28624	6181	166	13	20	0	6380
28625	108	98	6250	14	0	6470
28626	6073	15	104	17	0	6209
28627	6245	8	92	18	0	6363
28628	187	17	6390	27	0	6621
28629	98	6776	102	21	0	6997
28630	27	110	89	6503	0	6729
28631	28	108	6891	108	0	7135
28632	27	25	6629	100	0	6781
28633	6187	8	193	35	0	6423
28634	116	6875	112	20	0	7123
28635	115	112	16	6638	0	6881
28636	45	102	12	6531	0	6690
28637	31	6811	17	183	0	7042
28638	23	6971	35	107	0	7136
28639	27	7061	32	29	0	7149
28640	30	196	27	7106	0	7359
28641	7251	100	22	134	0	7507
28642	138	28	21	7397	0	7584
28643	120	31	7282	141	0	7574
28644	27	37	7272	122	0	7458
28645	40	19	231	7305	0	7595
28646	31	28	7551	138	0	7748
28647	28	7417	147	130	0	7722
28648	38	138	105	7817	0	8098
28649	8068	121	29	163	0	8381
28650	7985	35	31	138	0	8189
28651	272	8202	48	40	0	8562
28652	8572	169	30	46	0	8817
28653	8623	148	26	39	0	8836
28654	8789	28	34	42	0	8893
28655	309	43	7824	33	0	8209
28656	7956	22	141	48	0	8167
28657	179	8221	147	28	0	8575
28658	157	167	8253	26	0	8603
28659	41	148	8440	41	0	8670
28660	32	8393	283	54	0	8762
28661	8246	168	158	45	0	8617
28662	192	140	36	7876	0	8244
28663	143	8160	37	163	0	8503
28664	8279	172	32	149	0	8632
28665	185	142	31	8329	0	8687
28666	8381	35	34	189	0	8639
28667	181	36	49	8397	0	8663
28668	157	47	8255	181	0	8640
28669	59	44	8001	168	0	8272
28670	52	43	8243	40	0	8378
28671	45	44	304	7627	0	8020
28672	45	50	162	8141	0	8398
28673	64	38	8066	294	0	8462
28674	70	7938	204	155	0	8367
28675	8039	188	159	49	0	8435
28676	8137	158	61	31	0	8387
28677	318	8312	64	37	0	8731
28678	198	215	57	8179	0	8649
28679	71	170	8441	197	0	8879
28680	7898	47	223	170	0	8338
28681	222	48	8620	55	0	8945
28682	187	54	7927	22	0	8190
28683	73	46	8124	35	0	8278
28684	7477	49	323	46	0	7895
28685	229	53	8067	32	0	8381
28686	188	7752	218	47	0	8205
28687	84	8021	184	116	0	8405
28688	67	289	69	7712	0	8137
28689	80	172	59	7890	0	8201
28690	71	49	7845	306	0	8271
28691	7264	44	213	175	0	7696
28692	7874	45	168	60	0	8147
28693	314	34	76	7800	0	8224
28694	7761	32	73	177	0	8043
28695	194	7619	70	172	0	8055
28696	7498	190	45	60	0	7793
28697	208	7330	56	126	0	7720
28698	148	7359	62	64	0	7633
28699	7126	264	58	52	0	7500
28700	7126	141	53	50	0	7370
28701	7260	43	63	46	0	7412
28702	7309	29	83	53	0	7474
28703	305	40	6809	60	0	7214
28704	6759	33	212	35	0	7039
28705	209	41	158	6542	0	6950
28706	155	6775	80	160	0	7170
28707	6725	162	48	136	0	7071
28708	187	6740	65	58	0	7050
28709	6704	169	52	37	0	6962
28710	201	139	44	6549	0	6933
28711	164	45	51	6667	0	6927
28712	79	49	6514	257	0	6899
28713	76	34	6495	157	0	6762
28714	58	6504	280	62	0	6904
28715	6285	138	157	46	0	6626
28716	172	6348	65	52	0	6637
28717	161	6291	53	44	0	6549
28718	86	6521	54	42	0	6703
28719	89	250	6137	27	0	6503
28720	84	6348	139	34	0	6605
28721	5818	155	114	40	0	6127
28722	5815	134	49	37	0	6035
28723	247	49	45	5567	0	5908
28724	162	5622	56	131	0	5971
28725	90	5793	46	121	0	6050
28726	84	211	43	5654	0	5992
28727	88	138	5715	125	0	6066
28728	77	5501	132	114	0	5824
28729	79	164	105	5133	0	5481
28730	5099	127	40	128	0	5394
28731	5106	70	38	98	0	5312
28732	231	5209	41	46	0	5527
28733	5293	139	45	39	0	5516
28734	5250	109	43	40	0	5442
28735	242	54	45	5040	0	5381
28736	152	48	4999	120	0	5319
28737	72	5053	142	106	0	5373
28738	64	140	117	5010	0	5331
28739	56	129	4994	114	0	5293
28740	59	4909	118	94	0	5180
28741	4608	115	132	29	0	4884
28742	4705	104	31	30	0	4870
28743	172	62	24	4531	0	4789
28744	109	4614	32	98	0	4853
28745	57	121	4553	97	0	4828
28746	55	89	104	4467	0	4715
28747	48	53	4652	97	0	4850
28748	31	4061	91	78	0	4261
28749	59	90	49	3608	0	3806
28750	3569	50	28	58	0	3705
28751	67	3611	15	47	0	3740
28752	3315	61	11	27	0	3414
28753	3238	68	14	21	0	3341
28754	106	3263	10	27	0	3406
28755	77	107	13	3195	0	3392
28756	39	101	15	3180	0	3335
28757	33	3103	24	91	0	3251
28758	27	3204	29	55	0	3315
28759	31	80	43	2806	0	2960
28760	22	2962	19	47	0	3050
28761	2958	61	8	37	0	3064
28762	2911	49	12	18	0	2990
28763	80	31	2936	14	0	3061
28764	56	21	2923	12	0	3012
28765	2731	19	54	21	0	2825
28766	2965	12	44	27	0	3048
28767	59	3065	31	16	0	3171
28768	3064	44	19	20	0	3147
28769	3002	43	14	22	0	3081
28770	66	2990	14	17	0	3087
28771	3021	48	10	12	0	3091
28772	53	45	7	3602	0	3707
28773	42	32	8	3744	0	3826
28774	26	33	4076	101	0	4236
28775	17	3991	67	57	0	4132
28776	20	4133	47	19	0	4219
28777	3685	105	5	31	0	3826
28778	3792	47	3	18	0	3860
28779	3810	11	3	10	0	3834
28780	3968	6	4	10	0	3988
28781	88	16	3705	10	0	3819
28782	40	17	3890	7	0	3954
28783	8	3882	86	10	0	3986
28784	12	61	35	3837	0	3945
28785	18	38	4	3652	0	3712
28786	17	3874	5	76	0	3972
28787	23	61	3	3802	0	3889
28788	3742	33	5	49	0	3829
28789	64	3774	15	34	0	3887
28790	46	55	3831	11	0	3943
28791	10	3920	60	10	0	4000
28792	3869	59	40	12	0	3980
28793	56	43	3874	14	0	3987
28794	3723	13	59	18	0	3813
28795	3907	16	37	16	0	3976
28796	102	13	3911	8	0	4034
28797	48	21	3933	6	0	4008
28798	24	24	3894	7	0	3949
28799	3437	11	91	17	0	3556
28800	71	15	3880	15	0	3981
28801	48	3792	71	15	0	3926
28802	3776	55	41	20	0	3892
28803	70	46	3856	10	0	3982
28804	3639	14	69	16	0	3738
28805	64	28	3864	4	0	3960
28806	71	25	3988	10	0	4094
28807	34	3991	99	9	0	4133
28808	30	78	4003	4	0	4115
28809	37	44	3969	10	0	4060
28810	30	3584	109	13	0	3736
28811	3820	63	60	6	0	3949
28812	71	48	3933	11	0	4063
28813	58	31	76	3380	0	3545
28814	32	3920	54	52	0	4058
28815	3834	60	37	45	0	3976
28816	3852	54	22	21	0	3949
28817	109	19	3702	12	0	3842
28818	52	3681	86	15	0	3834
28819	28	3828	73	13	0	3942
28820	27	108	38	3468	0	3641
28821	41	3620	36	51	0	3748
28822	53	86	30	3260	0	3429
28823	57	55	29	3737	0	3878
28824	46	3779	46	91	0	3962
28825	40	69	47	3671	0	3827
28826	38	3801	42	58	0	3939
28827	29	84	3658	49	0	3820
28828	31	61	91	3614	0	3797
28829	37	52	57	3568	0	3714
28830	37	3687	36	112	0	3872
28831	42	3802	44	60	0	3948
28832	40	126	28	3419	0	3613
28833	53	3699	44	63	0	3859
28834	3571	91	43	62	0	3767
28835	87	72	39	3591	0	3789
28836	63	3652	53	69	0	3837
28837	3515	90	33	59	0	3697
28838	87	3512	43	24	0	3666
28839	68	95	3407	23	0	3593
28840	46	77	93	3315	0	3531
28841	3311	47	75	79	0	3512
28842	93	28	3489	57	0	3667
28843	60	49	99	3208	0	3416
28844	41	3446	80	66	0	3633
28845	57	89	3394	51	0	3591
28846	42	3563	104	18	0	3727
28847	3316	82	83	28	0	3509
28848	3391	79	54	15	0	3539
28849	126	3401	58	16	0	3601
28850	3423	78	58	26	0	3585
28851	86	76	3430	23	0	3615
28852	70	38	106	3289	0	3503
28853	42	50	77	3200	0	3369
28854	48	3383	56	112	0	3599
28855	3529	89	66	46	0	3730
28856	3611	74	41	18	0	3744
28857	110	47	3729	24	0	3910
28858	3676	36	95	31	0	3838
28859	3813	39	72	27	0	3951
28860	3931	41	46	33	0	4051
28861	125	57	31	3761	0	3974
28862	79	41	39	3719	0	3878
28863	42	3764	37	107	0	3950
28864	3601	105	41	60	0	3807
28865	3615	72	22	34	0	3743
28866	124	3623	29	23	0	3799
28867	69	85	30	3412	0	3596
28868	32	3477	25	76	0	3610
28869	24	3640	27	62	0	3753
28870	3389	112	23	35	0	3559
28871	88	88	3428	35	0	3639
28872	38	27	2566	16	0	2647
28873	14	2530	45	22	0	2611
28874	2124	28	18	10	0	2180
28875	28	24	2281	15	0	2348
28876	21	2081	21	11	0	2134
28877	2074	22	18	9	0	2123
28878	21	23	1943	5	0	1992
28879	15	6	15	1762	0	1798
28880	1868	0	17	18	0	1903
28881	17	4	1960	20	0	2001
28882	15	3	2216	6	0	2240
28883	2	5	2543	3	0	2553
28884	2	8	2543	3	0	2556
28885	2283	5	35	3	0	2326
28886	2724	4	37	4	0	2769
28887	42	2768	3	5	0	2818
28888	21	31	0	2725	0	2777
28889	5	22	2	2811	0	2840
28890	4	2770	8	49	0	2831
28891	2	36	4	2757	0	2799
28892	0	2881	12	30	0	2923
28893	4	2931	4	30	0	2969
28894	5	58	3	2879	0	2945
28895	9	28	2909	37	0	2983
28896	6	2971	40	27	0	3044
28897	3	41	27	2912	0	2983
28898	2989	29	3	37	0	3058
28899	41	9	3006	20	0	3076
28900	2929	5	40	12	0	2986
28901	3065	3	31	5	0	3104
28902	64	5	8	3030	0	3107
28903	30	10	3066	40	0	3146
28904	12	5	3020	28	0	3065
28905	8	3201	71	7	0	3287
28906	3	51	33	3095	0	3182
28907	9	32	3149	45	0	3235
28908	13	6	3192	37	0	3248
28909	5	3215	76	14	0	3310
28910	3255	44	35	13	0	3347
28911	3280	34	7	6	0	3327
28912	79	11	9	3445	0	3544
28913	34	10	3598	63	0	3705
28914	8	15	3597	41	0	3661
28915	8	3691	101	15	0	3815
28916	11	68	3742	14	0	3835
28917	15	42	3772	11	0	3840
28918	16	23	132	3214	0	3385
28919	7	12	3682	62	0	3763
28920	3372	5	71	42	0	3490
28921	61	11	49	3727	0	3848
28922	45	12	3866	67	0	3990
28923	17	3896	74	47	0	4034
28924	13	64	49	3921	0	4047
28925	11	47	4013	73	0	4144
28926	12	4139	76	50	0	4277
28927	12	77	51	3890	0	4030
28928	7	4272	26	73	0	4378
28929	17	77	27	4230	0	4351
28930	19	51	22	4271	0	4363
28931	20	23	4194	116	0	4353
28932	17	4271	88	56	0	4432
28933	15	81	55	4266	0	4417
28934	9	44	19	4326	0	4398
28935	16	19	23	4432	0	4490
28936	11	26	4307	121	0	4465
28937	5	4279	84	72	0	4440
28938	11	79	60	4237	0	4387
28939	11	56	4296	81	0	4444
28940	10	4275	90	71	0	4446
28941	11	85	64	4236	0	4396
28942	15	58	4382	85	0	4540
28943	10	4393	90	65	0	4558
28944	13	82	62	4229	0	4386
28945	18	51	30	4434	0	4533
28946	20	26	4655	127	0	4828
28947	4129	21	88	73	0	4311
28948	71	4699	72	31	0	4873
28949	4731	84	30	32	0	4877
28950	76	55	4709	28	0	4868
28951	4561	17	99	30	0	4707
28952	79	21	60	4602	0	4762
28953	45	19	39	4771	0	4874
28954	19	26	4731	118	0	4894
28955	4198	16	91	73	0	4378
28956	4495	22	84	27	0	4628
28957	108	4376	31	31	0	4546
28958	51	4585	26	33	0	4695
28959	4505	114	33	28	0	4680
28960	84	64	4553	28	0	4729
28961	42	4827	98	41	0	5008
28962	22	86	69	4794	0	4971
28963	16	60	38	4945	0	5059
28964	15	35	4905	139	0	5094
28965	4578	19	109	63	0	4769
28966	88	28	4999	32	0	5147
28967	4794	19	100	46	0	4959
28968	98	24	5111	25	0	5258
28969	58	5078	103	32	0	5271
28970	5109	91	71	36	0	5307
28971	5066	54	139	30	0	5289
28972	5055	30	31	33	0	5149
28973	5093	22	34	40	0	5189
28974	132	27	43	5049	0	5251
28975	68	27	4909	93	0	5097
28976	34	13	85	4751	0	4883
28977	21	4992	67	85	0	5165
28978	27	83	27	5046	0	5183
28979	18	53	5006	95	0	5172
28980	18	35	4985	58	0	5096
28981	27	17	121	4942	0	5107
28982	4735	17	84	94	0	4930
28983	4630	25	37	60	0	4752
28984	4662	22	24	32	0	4740
28985	116	20	4704	38	0	4878
28986	53	24	4659	26	0	4762
28987	19	4717	104	34	0	4874
28988	17	4809	55	32	0	4913
28989	4675	91	29	25	0	4820
28990	4744	57	21	21	0	4843
28991	91	5113	24	27	0	5255
28992	5105	64	12	28	0	5209
28993	5075	37	20	24	0	5156
28994	82	5125	33	12	0	5252
28995	5252	70	12	30	0	5364
28996	5153	45	14	23	0	5235
28997	92	5226	29	25	0	5372
28998	5239	67	20	19	0	5345
28999	5221	37	15	27	0	5300
29000	89	31	5317	21	0	5458
29001	61	18	5239	19	0	5337
29002	31	5271	95	14	0	5411
29003	21	5376	52	13	0	5462
29004	5323	80	56	24	0	5483
29005	5171	67	26	19	0	5283
29006	5129	24	12	17	0	5182
29007	98	5223	29	14	0	5364
29008	65	55	17	5284	0	5421
29009	39	37	5328	52	0	5456
29010	31	33	60	4970	0	5094
29011	25	5321	53	53	0	5452
29012	5227	45	15	31	0	5318
29013	61	5176	13	12	0	5262
29014	47	47	9	5054	0	5157
29015	5501	27	13	53	0	5594
29016	5533	12	16	31	0	5592
29017	90	16	5712	10	0	5828
29018	5737	14	52	16	0	5819
29019	6181	14	40	14	0	6249
29020	6277	19	11	10	0	6317
29021	119	13	12	5783	0	5927
29022	69	6013	20	54	0	6156
29023	40	58	12	6091	0	6201
29024	30	71	6100	64	0	6265
29025	38	6161	70	57	0	6326
29026	37	69	58	5966	0	6130
29027	27	73	6072	57	0	6229
29028	24	6017	77	60	0	6178
29029	30	66	65	5662	0	5823
29030	22	74	6005	56	0	6157
29031	5001	28	70	72	0	5171
29032	76	21	6080	14	0	6191
29033	92	20	6004	16	0	6132
29034	27	6053	113	16	0	6209
29035	33	59	69	5990	0	6151
29036	30	70	13	5582	0	5695
29037	22	5983	22	100	0	6127
29038	30	60	12	5894	0	5996
29039	6175	59	17	63	0	6314
29040	6188	26	14	59	0	6287
29041	128	35	5890	13	0	6066
29042	5880	10	59	24	0	5973
29043	6137	16	66	15	0	6234
29044	127	26	6202	20	0	6375
29045	84	6217	65	12	0	6378
29046	30	6022	76	13	0	6141
29047	47	133	13	5116	0	5309
29048	29	5959	18	60	0	6066
29049	46	68	5570	60	0	5744
29050	29	87	5891	10	0	6017
29051	22	5996	132	26	0	6176
29052	5972	78	77	14	0	6141
29053	6111	72	17	18	0	6218
29054	6149	29	18	15	0	6211
29055	6206	26	16	20	0	6268
29056	5895	24	15	20	0	5954
29057	135	5990	22	20	0	6167
29058	90	72	5908	11	0	6081
29059	40	72	67	5864	0	6043
29060	5683	16	78	76	0	5853
29061	70	5624	20	82	0	5796
29062	92	81	20	5555	0	5748
29063	28	81	5622	70	0	5801
29064	28	5511	66	77	0	5682
29065	24	5595	72	18	0	5709
29066	5413	117	19	51	0	5600
29067	60	5492	25	13	0	5590
29068	73	64	13	5171	0	5321
29069	5245	72	11	61	0	5389
29070	5289	14	13	69	0	5385
29071	5372	15	18	15	0	5420
29072	127	27	5200	12	0	5366
29073	76	5276	69	9	0	5430
29074	5319	61	63	18	0	5461
29075	72	70	14	5285	0	5441
29076	5382	15	19	66	0	5482
29077	67	5292	14	67	0	5440
29078	5475	64	8	14	0	5561
29079	5771	70	11	19	0	5871
29080	147	25	14	5719	0	5905
29081	94	22	5906	78	0	6100
29082	42	16	81	5979	0	6118
29083	5977	15	75	83	0	6150
29084	5988	15	21	85	0	6109
29085	159	5978	30	24	0	6191
29086	5791	81	10	22	0	5904
29087	94	5882	19	27	0	6022
29088	5977	83	12	24	0	6096
29089	5756	92	11	21	0	5880
29090	140	33	5855	25	0	6053
29091	91	5686	81	11	0	5869
29092	37	81	85	5661	0	5864
29093	35	80	19	5741	0	5875
29094	33	25	23	5506	0	5587
29095	23	5584	16	149	0	5772
29096	29	84	5570	81	0	5764
29097	33	84	5715	19	0	5851
29098	23	6966	158	32	0	7179
29099	6923	126	92	12	0	7153
29100	127	118	6904	27	0	7176
29101	6769	34	128	28	0	6959
29102	135	6862	111	39	0	7147
29103	132	144	7031	23	0	7330
29104	51	115	123	6889	0	7178
29105	34	38	7221	131	0	7424
29106	38	27	7290	122	0	7477
29107	58	21	221	6001	0	6301
29108	40	7037	149	99	0	7325
29109	35	7297	38	105	0	7475
29110	7212	230	29	26	0	7497
29111	156	144	7119	18	0	7437
29112	7068	38	122	25	0	7253
29113	7071	30	137	21	0	7259
29114	233	7097	37	13	0	7380
29115	6771	124	18	22	0	6935
29116	6786	99	13	18	0	6916
29117	6362	25	12	19	0	6418
29118	227	6195	20	12	0	6454
29119	123	5681	17	16	0	5837
29120	36	5960	19	10	0	6025
29121	5812	198	12	11	0	6033
29122	5823	103	12	16	0	5954
29123	185	28	5630	7	0	5850
29124	101	21	5652	6	0	5780
29125	5661	12	167	9	0	5849
29126	5821	13	85	15	0	5934
29127	5903	10	23	17	0	5953
29128	181	12	15	5699	0	5907
29129	94	17	11	5807	0	5929
29130	39	10	14	5962	0	6025
29131	23	11	18	5997	0	6049
29132	24	27	5651	178	0	5880
29133	14	20	5790	91	0	5915
29134	26	14	5834	30	0	5904
29135	25	17	5787	21	0	5850
29136	5480	17	174	11	0	5682
29137	108	5686	97	3	0	5894
29138	86	5864	36	10	0	5996
29139	5709	163	24	10	0	5906
29140	114	104	5678	17	0	5913
29141	96	35	5579	13	0	5723
29142	5294	31	161	23	0	5509
29143	5637	15	91	17	0	5760
29144	160	5596	35	18	0	5809
29145	107	87	21	5534	0	5749
29146	5666	72	19	93	0	5850
29147	5740	27	15	76	0	5858
29148	180	20	13	5497	0	5710
29149	106	5757	21	86	0	5970
29150	5711	101	14	83	0	5909
29151	123	94	5656	18	0	5891
29152	5546	23	106	19	0	5694
29153	121	5604	86	21	0	5832
29154	5699	103	27	27	0	5856
29155	5529	91	23	28	0	5671
29156	174	36	5569	16	0	5795
29157	100	28	5540	18	0	5686
29158	5428	18	185	12	0	5643
29159	5624	21	104	23	0	5772
29160	169	5765	47	14	0	5995
29161	112	101	29	5788	0	6030
29162	46	94	5867	98	0	6105
29163	5685	26	103	87	0	5901
29164	119	21	91	5986	0	6217
29165	103	13	34	6097	0	6247
29166	5987	24	29	174	0	6214
29167	107	6161	38	95	0	6401
29168	6251	102	28	37	0	6418
29169	6275	91	25	29	0	6420
29170	6349	27	28	21	0	6425
29171	196	6209	33	17	0	6455
29172	6268	104	20	12	0	6404
29173	138	88	27	6137	0	6390
29174	121	44	16	6259	0	6440
29175	71	32	6197	167	0	6467
29176	50	26	6145	92	0	6313
29177	44	6094	176	36	0	6350
29178	43	6248	98	16	0	6405
29179	59	145	5918	19	0	6141
29180	26	6002	101	13	0	6142
29181	5780	99	116	12	0	6007
29182	6027	72	20	19	0	6138
29183	6087	23	11	19	0	6140
29184	180	30	10	5740	0	5960
29185	111	11	12	5921	0	6055
29186	50	24	6068	152	0	6294
29187	32	6094	99	90	0	6315
29188	5905	91	117	25	0	6138
29189	102	6073	33	12	0	6220
29190	6064	99	13	14	0	6190
29191	6056	85	11	14	0	6166
29192	166	24	17	5860	0	6067
29193	106	13	22	5934	0	6075
29194	54	9	18	6086	0	6167
29195	28	23	5843	169	0	6063
29196	32	5700	87	104	0	5923
29197	24	5742	83	40	0	5889
29198	15	4107	11	11	0	4144
29199	15	4089	9	15	0	4128
29200	21	4175	12	19	0	4227
29201	3735	65	9	13	0	3822
29202	47	47	3997	10	0	4101
29203	43	3951	31	10	0	4035
29204	24	36	3798	13	0	3871
29205	11	3949	42	16	0	4018
29206	22	80	41	2816	0	2959
29207	21	38	12	3622	0	3693
29208	16	3803	11	49	0	3879
29209	3733	37	8	34	0	3812
29210	35	44	3694	11	0	3784
29211	37	3840	35	12	0	3924
29212	22	35	3823	13	0	3893
29213	14	40	27	3769	0	3850
29214	19	9	37	3578	0	3643
29215	19	3860	13	56	0	3948
29216	17	39	7	3917	0	3980
29217	18	47	11	3919	0	3995
29218	12	4007	15	58	0	4092
29219	16	37	3935	42	0	4030
29220	14	55	3897	22	0	3988
29221	3628	17	62	10	0	3717
29222	4023	17	40	8	0	4088
29223	66	13	13	3865	0	3957
29224	43	24	3859	40	0	3966
29225	23	17	30	3702	0	3772
29226	19	4032	45	36	0	4132
29227	14	50	3940	65	0	4069
29228	18	3990	39	24	0	4071
29229	25	48	3951	13	0	4037
29230	14	4007	44	18	0	4083
29231	3927	48	40	14	0	4029
29232	40	49	17	3918	0	4024
29233	44	18	18	3906	0	3986
29234	16	28	3928	67	0	4039
29235	20	30	3829	51	0	3930
29236	12	3976	77	23	0	4088
29237	3943	44	42	24	0	4053
29238	42	50	19	3860	0	3971
29239	43	29	4085	34	0	4191
29240	20	32	3924	36	0	4012
29241	3517	21	65	23	0	3626
29242	3918	24	45	23	0	4010
29243	63	33	4092	18	0	4206
29244	48	42	38	3845	0	3973
29245	19	4097	51	37	0	4204
29246	4062	41	19	37	0	4159
29247	34	4082	19	18	0	4153
29248	3864	31	12	15	0	3922
29249	25	3959	15	17	0	4016
29250	34	4000	16	16	0	4066
29251	19	53	11	3997	0	4080
29252	16	40	17	3963	0	4036
29253	10	4008	19	48	0	4085
29254	17	40	3868	34	0	3959
29255	15	48	3878	9	0	3950
29256	12	25	3953	25	0	4015
29257	3554	17	53	24	0	3648
29258	3901	19	32	18	0	3970
29259	42	4132	27	14	0	4215
29260	34	48	4011	15	0	4108
29261	18	52	38	3936	0	4044
29262	11	32	4332	31	0	4406
29263	11	22	4543	52	0	4628
29264	15	16	74	4738	0	4843
29265	15	20	49	5010	0	5094
29266	18	26	5366	118	0	5528
29267	4925	14	90	78	0	5107
29268	84	5530	94	27	0	5735
29269	90	5786	32	9	0	5917
29270	22	176	17	5560	0	5775
29271	5730	113	17	99	0	5959
29272	106	5995	21	89	0	6211
29273	5942	113	10	27	0	6092
29274	113	5970	20	13	0	6116
29275	6036	119	17	18	0	6190
29276	134	114	6024	9	0	6281
29277	114	45	6142	10	0	6311
29278	41	18	244	5894	0	6197
29279	22	23	5980	122	0	6147
29280	16	5734	143	103	0	5996
29281	13	5858	127	26	0	6024
29282	5787	208	34	12	0	6041
29283	119	119	19	5570	0	5827
29284	107	5889	24	106	0	6126
29285	5907	128	18	100	0	6153
29286	5763	118	6	24	0	5911
29287	5877	32	13	10	0	5932
29288	245	20	9	5693	0	5967
29289	131	19	7	5798	0	5955
29290	37	25	5736	213	0	6011
29291	40	18	5735	123	0	5916
29292	5639	10	216	34	0	5899
29293	134	8	122	5681	0	5945
29294	117	22	5702	141	0	5982
29295	5523	12	138	127	0	5800
29296	136	5903	123	29	0	6191
29297	6025	121	33	22	0	6201
29298	6016	110	20	24	0	6170
29299	6113	22	23	28	0	6186
29300	252	27	5800	12	0	6091
29301	5712	20	128	20	0	5880
29302	161	20	117	5462	0	5760
29303	148	5562	34	118	0	5862
29304	47	5866	32	104	0	6049
29305	5798	216	29	25	0	6068
29306	5876	128	24	23	0	6051
29307	5976	44	15	27	0	6062
29308	253	29	13	5692	0	5987
29309	158	30	14	5765	0	5967
29310	63	32	15	5604	0	5714
29311	55	5655	28	230	0	5968
29312	5575	135	21	134	0	5865
29313	5640	117	16	60	0	5833
29314	5783	39	19	45	0	5886
29315	262	38	5530	29	0	5859
29316	5591	21	131	36	0	5779
29317	186	35	116	5280	0	5617
29318	163	5479	34	126	0	5802
29319	5446	140	26	117	0	5729
29320	5435	125	25	38	0	5623
29321	266	43	5554	35	0	5898
29322	169	36	135	5331	0	5671
29323	64	5545	135	131	0	5875
29324	5730	145	41	120	0	6036
29325	185	128	31	5723	0	6067
29326	167	40	38	5757	0	6002
29327	60	35	28	5921	0	6044
29328	58	22	28	6079	0	6187
29329	45	41	5821	285	0	6192
29330	52	5824	153	166	0	6195
29331	49	156	129	5833	0	6167
29332	46	142	5874	175	0	6237
29333	5729	47	148	165	0	6089
29334	6020	43	138	53	0	6254
29335	301	30	45	5914	0	6290
29336	6063	29	34	174	0	6300
29337	6160	22	30	158	0	6370
29338	306	34	6130	81	0	6551
29339	176	6035	174	54	0	6439
29340	6098	158	145	49	0	6450
29341	206	133	44	6127	0	6510
29342	6362	40	38	179	0	6619
29343	222	34	40	6218	0	6514
29344	192	31	32	6270	0	6525
29345	92	34	6093	278	0	6497
29346	5440	37	157	189	0	5823
29347	206	6181	136	76	0	6599
29348	188	153	6207	67	0	6615
29349	66	6301	166	54	0	6587
29350	6158	175	141	45	0	6519
29351	207	136	37	6106	0	6486
29352	6205	44	30	173	0	6452
29353	202	6125	46	145	0	6518
29354	6351	167	23	65	0	6606
29355	6414	131	23	57	0	6625
29356	6476	37	31	46	0	6590
29357	6427	28	13	58	0	6526
29358	325	6142	26	56	0	6549
29359	6110	155	26	48	0	6339
29360	217	125	21	5957	0	6320
29361	187	72	25	5838	0	6122
29362	86	5399	38	239	0	5762
29363	82	5300	26	137	0	5545
29364	62	5188	21	54	0	5325
29365	4836	166	23	49	0	5074
29366	121	4374	15	34	0	4544
29367	99	3975	20	20	0	4114
29368	3942	119	36	36	0	4133
29369	3789	52	9	19	0	3869
29370	118	3856	20	14	0	4008
29371	3818	77	16	13	0	3924
29372	80	54	3670	14	0	3818
29373	3491	15	57	21	0	3584
29374	78	37	3586	26	0	3727
29375	56	3304	43	16	0	3419
29376	15	3379	30	23	0	3447
29377	67	60	40	3235	0	3402
29378	3437	25	14	48	0	3524
29379	3518	10	7	28	0	3563
29380	3562	21	12	16	0	3611
29381	3573	11	13	20	0	3617
29382	3481	23	10	17	0	3531
29383	75	22	3349	23	0	3469
29384	31	15	3240	26	0	3312
29385	3299	13	48	16	0	3376
29386	53	3417	22	12	0	3504
29387	3468	40	20	13	0	3541
29388	3625	28	6	21	0	3680
29389	3759	11	3	15	0	3788
29390	3788	17	4	12	0	3821
29391	3771	20	6	20	0	3817
29392	80	19	3707	19	0	3825
29393	3816	9	37	20	0	3882
29394	3852	18	23	24	0	3917
29395	73	32	3717	17	0	3839
29396	3553	27	39	23	0	3642
29397	3769	27	19	17	0	3832
29398	80	26	3921	11	0	4038
29399	39	35	3916	21	0	4011
29400	30	4037	62	18	0	4147
29401	36	45	38	4029	0	4148
29402	41	36	4033	47	0	4157
29403	4066	21	44	33	0	4164
29404	76	15	24	4443	0	4558
29405	49	27	4651	38	0	4765
29406	4495	13	52	34	0	4594
29407	4689	19	32	12	0	4752
29408	4696	21	11	19	0	4747
29409	86	4924	15	38	0	5063
29410	59	51	6	4694	0	4810
29411	41	4893	15	52	0	5001
29412	4931	42	12	36	0	5021
29413	4880	38	19	12	0	4949
29414	99	24	4850	9	0	4982
29415	51	4823	58	12	0	4944
29416	30	4880	44	9	0	4963
29417	30	72	21	4816	0	4939
29418	41	40	7	4859	0	4947
29419	4763	28	8	64	0	4863
29420	81	4801	13	41	0	4936
29421	67	4855	13	5	0	4940
29422	76	69	4755	7	0	4907
29423	40	4948	44	7	0	5039
29424	4791	45	30	9	0	4875
29425	58	43	4786	12	0	4899
29426	3986	12	31	34	0	4063
29427	44	21	4712	7	0	4784
29428	3661	3	38	31	0	3733
29429	36	4751	29	5	0	4821
29430	4835	37	7	6	0	4885
29431	46	32	4902	5	0	4985
29432	4764	8	36	10	0	4818
29433	4788	11	21	12	0	4832
29434	65	13	4954	5	0	5037
29435	4903	10	35	17	0	4965
29436	5122	8	22	9	0	5161
29437	5093	5	9	5	0	5112
29438	66	4928	14	7	0	5015
29439	5140	41	5	14	0	5200
29440	41	34	5356	2	0	5433
29441	35	5643	56	8	0	5742
29442	5785	42	33	10	0	5870
29443	5750	37	10	9	0	5806
29444	5883	10	5	12	0	5910
29445	101	5801	19	12	0	5933
29446	61	61	5	6847	0	6974
29447	17	61	6807	81	0	6966
29448	25	7	84	6792	0	6908
29449	19	19	7045	87	0	7170
29450	6442	7	81	85	0	6615
29451	92	7056	89	12	0	7249
29452	87	88	13	6802	0	6990
29453	21	7234	14	78	0	7347
29454	21	94	6	7159	0	7280
29455	16	79	11	7107	0	7213
29456	17	7524	16	152	0	7709
29457	15	101	13	7571	0	7700
29458	17	92	7	7802	0	7918
29459	21	7942	19	179	0	8161
29460	18	8154	17	123	0	8312
29461	22	196	7	8049	0	8274
29462	22	130	8063	119	0	8334
29463	16	8165	121	111	0	8413
29464	23	122	107	7988	0	8240
29465	37	117	8266	128	0	8548
29466	19	8353	128	120	0	8620
29467	8274	130	116	36	0	8556
29468	129	136	8301	23	0	8589
29469	8077	32	129	27	0	8265
29470	143	26	118	8168	0	8455
29471	133	19	21	8270	0	8443
29472	40	26	18	8336	0	8420
29473	32	28	8191	256	0	8507
29474	25	31	8190	151	0	8397
29475	7555	29	246	49	0	7879
29476	140	32	136	8244	0	8552
29477	137	27	8209	150	0	8523
29478	7892	24	142	151	0	8209
29479	148	31	124	8165	0	8468
29480	139	27	37	8210	0	8413
29481	41	28	31	8091	0	8191
29482	34	8151	30	256	0	8471
29483	43	140	22	7680	0	7885
29484	38	8064	36	145	0	8283
29485	37	8248	33	142	0	8460
29486	8001	248	23	58	0	8330
29487	7591	149	31	61	0	7832
29488	7931	58	21	43	0	8053
29489	247	7663	46	60	0	8016
29490	7711	151	36	45	0	7943
29491	7716	142	28	48	0	7934
29492	261	41	27	7499	0	7828
29493	157	37	31	7635	0	7860
29494	51	55	7483	259	0	7848
29495	33	7544	141	184	0	7902
29496	7431	144	146	86	0	7807
29497	7375	140	51	57	0	7623
29498	233	7361	46	70	0	7710
29499	7373	145	32	72	0	7622
29500	7206	154	41	57	0	7458
29501	250	83	32	6941	0	7306
29502	185	6997	51	162	0	7395
29503	72	7079	55	156	0	7362
29504	6780	242	30	78	0	7130
29505	149	150	27	6633	0	6959
29506	145	56	6602	171	0	6974
29507	6273	54	140	178	0	6645
29508	151	37	6758	86	0	7032
29509	143	6386	172	59	0	6760
29510	6398	151	131	75	0	6755
29511	148	152	6406	83	0	6789
29512	152	65	157	6385	0	6759
29513	68	63	6706	188	0	7025
29514	50	6733	164	188	0	7135
29515	70	170	142	6634	0	7016
29516	71	156	6667	178	0	7072
29517	6181	60	147	194	0	6582
29518	146	6702	150	101	0	7099
29519	165	168	39	6116	0	6488
29520	59	6783	51	193	0	7086
29521	6573	179	51	153	0	6956
29522	6535	153	31	87	0	6806
29523	245	6495	58	96	0	6894
29524	167	160	50	6201	0	6578
29525	84	6623	50	159	0	6916
29526	6411	162	54	159	0	6786
29527	195	158	6372	83	0	6808
29528	166	83	6276	64	0	6589
29529	77	6275	237	67	0	6656
29530	75	6339	162	68	0	6644
29531	77	236	52	6148	0	6513
29532	6199	142	49	161	0	6551
29533	6287	55	66	155	0	6563
29534	6186	47	44	79	0	6356
29535	265	6218	56	74	0	6613
29536	165	136	48	5826	0	6175
29537	88	6253	44	142	0	6527
29538	6223	129	53	147	0	6552
29539	175	134	46	6032	0	6387
29540	148	44	5697	149	0	6038
29541	59	5407	124	128	0	5718
29542	5216	106	107	54	0	5483
29543	133	108	5127	49	0	5417
29544	4919	52	86	61	0	5118
29545	117	5024	116	72	0	5329
29546	82	4075	28	23	0	4208
29547	3911	120	18	29	0	4078
29548	71	4066	18	26	0	4181
29549	3771	70	12	26	0	3879
29550	75	3785	24	14	0	3898
29551	3758	67	38	20	0	3883
29552	3752	63	16	18	0	3849
29553	110	38	3846	21	0	4015
29554	77	33	3759	15	0	3884
29555	34	3780	93	16	0	3923
29556	3585	46	48	19	0	3698
29557	52	45	3512	18	0	3627
29558	3037	48	42	12	0	3139
29559	39	15	24	3027	0	3105
29560	35	14	3064	16	0	3129
29561	17	11	2938	18	0	2984
29562	19	33	3077	13	0	3142
29563	10	3081	39	7	0	3137
29564	22	69	14	2911	0	3016
29565	2904	7	2	11	0	2924
29566	10	0	1	2971	0	2982
29567	2982	2	4	9	0	2997
29568	8	4	2	2991	0	3005
29569	3068	4	1	23	0	3096
29570	3096	1	7	14	0	3118
29571	3569	2	2	16	0	3589
29572	25	3759	2	4	0	3790
29573	21	32	3731	6	0	3790
29574	12	18	23	3761	0	3814
29575	32	46	44	2288	0	2410
29576	3	6	3	3921	0	3933
29577	5	4	2	3842	0	3853
29578	6	3748	4	53	0	3811
29579	9	29	3664	26	0	3728
29580	3	3770	31	7	0	3811
29581	3	39	22	3466	0	3530
29582	6	25	5	3828	0	3864
29583	8	13	4	3881	0	3906
29584	8	4	3	3857	0	3872
29585	5	3770	6	55	0	3836
29586	6	3835	10	29	0	3880
29587	9	82	3764	12	0	3867
29588	12	24	28	3842	0	3906
29589	6	12	30	3917	0	3965
29590	7	7	4	3993	0	4011
29591	4072	8	4	73	0	4157
29592	35	4090	9	38	0	4172
29593	33	35	4034	17	0	4119
29594	3992	31	42	11	0	4076
29595	43	10	30	4096	0	4179
29596	4162	7	6	45	0	4220
29597	47	6	7	4162	0	4222
29598	4191	5	2	46	0	4244
29599	38	9	5	4189	0	4241
29600	4170	6	13	39	0	4228
29601	50	15	4316	38	0	4419
29602	40	10	36	4183	0	4269
29603	16	4363	45	39	0	4463
29604	16	40	5	4548	0	4609
29605	4524	37	7	53	0	4621
29606	46	4607	15	46	0	4714
29607	50	44	6	4708	0	4808
29608	9	4713	16	43	0	4781
29609	19	48	2	4754	0	4823
29610	12	53	4	4762	0	4831
29611	11	13	4710	100	0	4834
29612	16	8	46	4623	0	4693
29613	9	16	4452	63	0	4540
29614	3	4334	60	71	0	4468
29615	4292	49	53	13	0	4407
29616	47	49	4365	23	0	4484
29617	4184	13	50	19	0	4266
29618	4532	13	49	28	0	4622
29619	101	6	11	4658	0	4776
29620	54	16	4949	67	0	5086
29621	4755	8	75	70	0	4908
29622	5237	7	59	30	0	5333
29623	131	7	12	5155	0	5305
29624	70	16	11	5169	0	5266
29625	21	5192	17	138	0	5368
29626	27	72	9	5118	0	5226
29627	14	5159	14	161	0	5348
29628	17	83	5124	79	0	5303
29629	10	59	74	5084	0	5227
29630	5036	12	57	90	0	5195
29631	5121	12	10	77	0	5220
29632	129	5075	14	25	0	5243
29633	71	76	12	5153	0	5312
29634	5223	58	11	91	0	5383
29635	80	5048	16	79	0	5223
29636	5101	87	5	34	0	5227
29637	93	65	8	5233	0	5399
29638	5482	17	7	101	0	5607
29639	107	25	5867	91	0	6090
29640	78	5963	117	24	0	6182
29641	5863	120	86	40	0	6109
29642	115	6147	22	31	0	6315
29643	6285	126	15	28	0	6454
29644	6411	94	10	46	0	6561
29645	209	57	6301	23	0	6590
29646	118	18	120	6163	0	6419
29647	6465	19	99	133	0	6716
29648	134	22	6501	113	0	6770
29649	6506	20	128	39	0	6693
29650	152	15	107	6550	0	6824
29651	128	29	6488	150	0	6795
29652	40	16	130	6456	0	6642
29653	6239	11	112	149	0	6511
29654	149	22	6501	126	0	6798
29655	118	18	133	6498	0	6767
29656	39	17	108	6551	0	6715
29657	6518	12	23	238	0	6791
29658	6483	10	16	139	0	6648
29659	237	6531	23	43	0	6834
29660	133	126	20	6486	0	6765
29661	43	119	23	6575	0	6760
29662	35	27	14	6566	0	6642
29663	6362	19	24	241	0	6646
29664	6444	25	20	139	0	6628
29665	266	9	13	6217	0	6505
29666	141	6178	28	138	0	6485
29667	59	133	20	5891	0	6103
29668	49	6335	24	126	0	6534
29669	6178	136	21	126	0	6461
29670	143	6148	38	45	0	6374
29671	5616	114	16	35	0	5781
29672	145	98	17	5455	0	5715
29673	5500	12	25	117	0	5654
29674	137	30	5501	117	0	5785
29675	118	5606	119	32	0	5875
29676	5547	109	104	43	0	5803
29677	5632	94	19	50	0	5795
29678	227	13	22	5340	0	5602
29679	115	5552	36	126	0	5829
29680	52	109	17	5821	0	5999
29681	40	97	18	5808	0	5963
29682	63	21	15	5875	0	5974
29683	5718	18	21	226	0	5983
29684	5789	22	12	130	0	5953
29685	241	15	20	5409	0	5685
29686	148	5594	20	137	0	5899
29687	5611	119	20	130	0	5880
29688	152	114	5616	35	0	5917
29689	132	24	107	5585	0	5848
29690	53	37	5758	143	0	5991
29691	54	22	111	5629	0	5816
29692	47	41	5874	135	0	6097
29693	65	27	115	5803	0	6010
29694	5803	30	96	154	0	6083
29695	5801	37	18	120	0	5976
29696	227	5705	27	52	0	6011
29697	5884	115	22	53	0	6074
29698	160	98	30	5810	0	6098
29699	140	41	19	5824	0	6024
29700	5810	32	32	224	0	6098
29701	142	50	5778	123	0	6093
29702	166	36	5841	66	0	6109
29703	71	39	6158	53	0	6321
29704	5729	25	178	67	0	5999
29705	140	37	6228	60	0	6465
29706	159	26	5938	60	0	6183
29707	5599	18	172	62	0	5851
29708	148	6177	96	40	0	6461
29709	127	97	32	6328	0	6584
29710	62	92	22	6478	0	6654
29711	62	36	6544	203	0	6845
29712	6426	27	107	128	0	6688
29713	6673	15	91	84	0	6863
29714	6446	17	46	71	0	6580
29715	184	22	6697	73	0	6976
29716	6383	19	109	66	0	6577
29717	140	31	6506	61	0	6738
29718	125	6496	107	63	0	6791
29719	66	6497	86	64	0	6713
29720	6107	132	26	62	0	6327
29721	97	6077	38	47	0	6259
29722	104	6135	32	71	0	6342
29723	6051	126	25	60	0	6262
29724	111	6127	37	47	0	6322
29725	6232	83	29	57	0	6401
29726	121	78	30	6485	0	6714
29727	106	23	42	6578	0	6749
29728	54	30	29	6622	0	6735
29729	62	32	30	6403	0	6527
29730	40	6463	41	163	0	6707
29731	6450	76	25	107	0	6658
29732	101	7092	47	45	0	7285
29733	112	7033	53	69	0	7267
29734	76	168	7417	41	0	7702
29735	6782	85	122	57	0	7046
29736	137	33	7785	27	0	7982
29737	149	38	7844	27	0	8058
29738	46	7662	189	34	0	7931
29739	26	7717	117	43	0	7903
29740	7327	186	51	29	0	7593
29741	105	7956	30	23	0	8114
29742	101	126	8203	17	0	8447
29743	22	7494	125	14	0	7655
29744	49	112	8119	18	0	8298
29745	19	107	7912	14	0	8052
29746	7396	39	229	13	0	7677
29747	123	25	8012	79	0	8239
29748	107	13	117	7600	0	7837
29749	7588	11	122	112	0	7833
29750	90	7624	46	116	0	7876
29751	114	99	7862	21	0	8096
29752	7749	96	110	20	0	7975
29753	119	22	110	7318	0	7569
29754	115	7235	31	81	0	7462
29755	31	102	7675	117	0	7925
29756	7312	94	116	26	0	7548
29757	119	30	7863	14	0	8026
29758	112	5	138	7611	0	7866
29759	31	18	7789	116	0	7954
29760	20	7	133	7637	0	7797
29761	7540	13	115	129	0	7797
29762	105	7685	40	121	0	7951
29763	7799	104	14	30	0	7947
29764	137	129	7770	16	0	8052
29765	128	23	118	7690	0	7959
29766	31	20	8070	123	0	8244
29767	7712	9	128	133	0	7982
29768	7924	9	132	28	0	8093
29769	239	7982	44	10	0	8275
29770	8197	119	18	11	0	8345
29771	8167	126	26	11	0	8330
29772	252	23	20	7916	0	8211
29773	151	20	8063	117	0	8351
29774	33	7638	142	127	0	7940
29775	39	124	130	7591	0	7884
29776	7725	134	27	118	0	8004
29777	128	42	7830	129	0	8129
29778	136	29	7798	25	0	7988
29779	36	16	7653	14	0	7719
29780	7240	10	259	23	0	7532
29781	132	28	7634	13	0	7807
29782	7275	8	150	18	0	7451
29783	154	20	7135	20	0	7329
29784	134	7409	147	21	0	7711
29785	39	124	133	7388	0	7684
29786	21	138	7446	126	0	7731
29787	30	7325	151	134	0	7640
29788	25	7477	153	27	0	7682
29789	24	249	38	7330	0	7641
29790	7236	148	29	128	0	7541
29791	147	40	25	7342	0	7554
29792	7089	24	31	149	0	7293
29793	147	34	27	7126	0	7334
29794	145	35	7054	147	0	7381
29795	44	31	7041	145	0	7261
29796	6717	19	266	48	0	7050
29797	6990	25	174	31	0	7220
29798	271	37	6891	22	0	7221
29799	6528	34	151	28	0	6741
29800	162	40	6883	23	0	7108
29801	163	6497	182	20	0	6862
29802	60	6473	191	16	0	6740
29803	45	6403	83	31	0	6562
29804	61	260	52	6123	0	6496
29805	6076	163	64	124	0	6427
29806	6164	44	62	137	0	6407
29807	287	41	51	6065	0	6444
29808	163	45	5687	141	0	6036
29809	55	43	164	5696	0	5958
29810	50	46	5660	160	0	5916
29811	54	30	189	5413	0	5686
29812	5280	19	179	159	0	5637
29813	5416	17	74	149	0	5656
29814	5469	22	67	51	0	5609
29815	5429	18	67	43	0	5557
29816	299	15	61	5142	0	5517
29817	195	20	58	5281	0	5554
29818	5198	32	59	248	0	5537
29819	5292	37	40	164	0	5533
29820	288	30	45	5170	0	5533
29821	211	23	35	5237	0	5506
29822	83	24	44	5193	0	5344
29823	71	33	46	5206	0	5356
29824	4986	26	56	291	0	5359
29825	171	30	4842	173	0	5216
29826	175	19	157	4501	0	4852
29827	4476	15	152	162	0	4805
29828	167	21	4446	171	0	4805
29829	170	20	153	4448	0	4791
29830	80	27	4427	158	0	4692
29831	70	4175	177	136	0	4558
29832	80	101	153	3560	0	3894
29833	3359	109	61	103	0	3632
29834	121	56	34	2965	0	3176
29835	121	2832	40	106	0	3099
29836	70	2744	32	90	0	2936
29837	40	2306	38	26	0	2410
29838	30	2206	45	28	0	2309
29839	1214	95	225	104	0	1638
29840	90	27	53	884	0	1054
29841	28	3	770	26	0	827
29842	14	5	24	721	0	764
29843	20	8	710	20	0	758
29844	711	2	18	27	0	758
29845	36	3	23	697	0	759
29846	33	4	7	714	0	758
29847	9	3	9	692	0	713
29848	10	3	6	695	0	714
29849	672	3	5	38	0	718
29850	678	2	6	30	0	716
29851	44	1	5	667	0	717
29852	607	5	1	30	0	643
29853	19	3	584	43	0	649
29854	27	573	18	23	0	641
29855	25	12	22	577	0	636
29856	18	18	11	546	0	593
29857	10	518	6	45	0	579
29858	18	11	8	544	0	581
29859	11	17	15	545	0	588
29860	525	3	12	46	0	586
29861	22	7	509	22	0	560
29862	17	9	482	10	0	518
29863	467	5	29	20	0	521
29864	27	7	423	10	0	467
29865	151	1	11	2	0	165
29866	131	0	14	9	0	154
29867	10	0	6	110	0	126
29868	3	4	95	8	0	110
29869	65	0	4	8	0	77
29870	10	63	5	1	0	79
29871	26	11	19	5	0	61
29872	0	0	0	0	0	0
29873	1	0	0	0	0	1
29874	1	0	0	0	0	1
29875	1	0	0	0	0	1
29876	1	0	0	0	0	1
29877	1	0	0	0	0	1
29878	1	0	0	0	0	1
29879	1	0	0	0	0	1
29880	1	0	0	0	0	1
29881	1	0	0	0	0	1
29882	1	0	0	0	0	1
29883	1	0	0	0	0	1
29884	1	0	0	0	0	1
29885	1	0	0	0	0	1
29886	1	0	0	0	0	1
29887	1	0	0	0	0	1
29888	1	0	0	0	0	1
29889	1	0	0	0	0	1
29890	1	0	0	0	0	1
29891	1	0	0	0	0	1
29892	1	0	0	0	0	1
29893	1	0	0	0	0	1
29894	1	0	0	0	0	1
29895	1	0	0	0	0	1
29896	1	0	0	0	0	1
29897	1	0	0	0	0	1
29898	1	0	0	0	0	1
29899	1	0	0	0	0	1
29900	1	0	0	0	0	1
